案	區	時間	同意票數	不同意票數	有效票數	無效票數	投票數	投票權人數	投票率(%)	有效同意票數對投票權人數百分比(%)	已送	應送
8	宜蘭縣冬山鄉	2018-11-24T22:14:51+08:00	10356	2967	13323	1137	14460	27101	53.36%	38.21%	25	39
8	宜蘭縣冬山鄉	2018-11-24T23:33:52+08:00	16770	4626	21396	1753	23149	43679	53%	38.39%	38	39
8	宜蘭縣冬山鄉	2018-11-24T23:10:57+08:00	15161	4193	19354	1607	20961	39278	53.37%	38.6%	35	39
8	宜蘭縣冬山鄉	2018-11-25T06:17:38+08:00	17407	4801	22208	1804	24012	45405	52.88%	38.34%	39	39
8	宜蘭縣冬山鄉	2018-11-24T22:28:42+08:00	11853	3303	15156	1277	16433	30612	53.68%	38.72%	28	39
8	宜蘭縣冬山鄉	2018-11-24T22:56:38+08:00	14662	4036	18698	1557	20255	38031	53.26%	38.55%	34	39
8	宜蘭縣冬山鄉	2018-11-24T23:07:21+08:00	15161	4193	19354	1607	20961	39278	53.37%	38.6%	35	39
8	宜蘭縣冬山鄉	2018-11-24T22:49:26+08:00	14323	3937	18260	1538	19798	37214	53.2%	38.49%	33	39
8	宜蘭縣冬山鄉	2018-11-24T22:53:17+08:00	14323	3937	18260	1538	19798	37214	53.2%	38.49%	33	39
8	宜蘭縣冬山鄉	2018-11-25T01:06:01+08:00	17407	4801	22208	1804	24012	45405	52.88%	38.34%	39	39
8	宜蘭縣冬山鄉	2018-11-24T22:32:20+08:00	12242	3410	15652	1310	16962	31591	53.69%	38.75%	29	39
8	宜蘭縣冬山鄉	2018-11-25T00:17:10+08:00	17407	4801	22208	1804	24012	45405	52.88%	38.34%	39	39
8	宜蘭縣冬山鄉	2018-11-25T00:08:06+08:00	16770	4626	21396	1753	23149	43679	53%	38.39%	38	39
8	宜蘭縣冬山鄉	2018-11-25T03:48:33+08:00	17407	4801	22208	1804	24012	45405	52.88%	38.34%	39	39
8	宜蘭縣冬山鄉	2018-11-24T23:29:48+08:00	16316	4491	20807	1709	22516	42244	53.3%	38.62%	37	39
8	宜蘭縣冬山鄉	2018-11-24T22:40:20+08:00	13740	3756	17496	1476	18972	35822	52.96%	38.36%	32	39
8	宜蘭縣冬山鄉	2018-11-25T06:22:46+08:00	17407	4801	22208	1804	24012	45405	52.88%	38.34%	39	39
8	宜蘭縣冬山鄉	2018-11-25T06:07:24+08:00	17407	4801	22208	1804	24012	45405	52.88%	38.34%	39	39
8	宜蘭縣冬山鄉	2018-11-24T23:00:18+08:00	15161	4193	19354	1607	20961	39278	53.37%	38.6%	35	39
8	宜蘭縣冬山鄉	2018-11-24T22:25:27+08:00	11853	3303	15156	1277	16433	30612	53.68%	38.72%	28	39
8	宜蘭縣冬山鄉	2018-11-25T03:42:50+08:00	17407	4801	22208	1804	24012	45405	52.88%	38.34%	39	39
8	宜蘭縣冬山鄉	2018-11-25T01:11:09+08:00	17407	4801	22208	1804	24012	45405	52.88%	38.34%	39	39
8	宜蘭縣冬山鄉	2018-11-24T23:14:43+08:00	15784	4356	20140	1658	21798	40749	53.49%	38.73%	36	39
8	宜蘭縣冬山鄉	2018-11-25T01:16:24+08:00	17407	4801	22208	1804	24012	45405	52.88%	38.34%	39	39
8	宜蘭縣冬山鄉	2018-11-24T23:54:29+08:00	16770	4626	21396	1753	23149	43679	53%	38.39%	38	39
8	宜蘭縣冬山鄉	2018-11-25T06:27:57+08:00	17407	4801	22208	1804	24012	45405	52.88%	38.34%	39	39
8	宜蘭縣冬山鄉	2018-11-25T03:31:01+08:00	17407	4801	22208	1804	24012	45405	52.88%	38.34%	39	39
8	宜蘭縣冬山鄉	2018-11-24T23:50:16+08:00	16770	4626	21396	1753	23149	43679	53%	38.39%	38	39
8	宜蘭縣冬山鄉	2018-11-25T00:56:15+08:00	17407	4801	22208	1804	24012	45405	52.88%	38.34%	39	39
8	宜蘭縣冬山鄉	2018-11-25T00:12:46+08:00	17407	4801	22208	1804	24012	45405	52.88%	38.34%	39	39
8	宜蘭縣冬山鄉	2018-11-24T23:37:50+08:00	16770	4626	21396	1753	23149	43679	53%	38.39%	38	39
8	宜蘭縣冬山鄉	2018-11-25T03:54:43+08:00	17407	4801	22208	1804	24012	45405	52.88%	38.34%	39	39
8	宜蘭縣冬山鄉	2018-11-24T23:03:49+08:00	15161	4193	19354	1607	20961	39278	53.37%	38.6%	35	39
8	宜蘭縣冬山鄉	2018-11-24T22:12:04+08:00	9887	2839	12726	1109	13835	25876	53.47%	38.21%	24	39
8	宜蘭縣冬山鄉	2018-11-24T23:22:25+08:00	15784	4356	20140	1658	21798	40749	53.49%	38.73%	36	39
8	宜蘭縣冬山鄉	2018-11-25T01:24:26+08:00	17407	4801	22208	1804	24012	45405	52.88%	38.34%	39	39
8	宜蘭縣冬山鄉	2018-11-24T23:42:03+08:00	16770	4626	21396	1753	23149	43679	53%	38.39%	38	39
8	宜蘭縣冬山鄉	2018-11-24T23:46:05+08:00	16770	4626	21396	1753	23149	43679	53%	38.39%	38	39
8	宜蘭縣冬山鄉	2018-11-25T04:01:31+08:00	17407	4801	22208	1804	24012	45405	52.88%	38.34%	39	39
8	宜蘭縣冬山鄉	2018-11-25T06:12:39+08:00	17407	4801	22208	1804	24012	45405	52.88%	38.34%	39	39
8	宜蘭縣冬山鄉	2018-11-24T22:21:48+08:00	11175	3096	14271	1210	15481	29086	53.22%	38.42%	27	39
8	宜蘭縣冬山鄉	2018-11-25T00:21:46+08:00	17407	4801	22208	1804	24012	45405	52.88%	38.34%	39	39
8	宜蘭縣冬山鄉	2018-11-25T01:01:03+08:00	17407	4801	22208	1804	24012	45405	52.88%	38.34%	39	39
8	宜蘭縣冬山鄉	2018-11-24T22:39:10+08:00	13180	3591	16771	1433	18204	34303	53.07%	38.42%	31	39
8	宜蘭縣冬山鄉	2018-11-24T22:35:46+08:00	12746	3453	16199	1378	17577	33056	53.17%	38.56%	30	39
8	宜蘭縣冬山鄉	2018-11-24T23:58:44+08:00	16770	4626	21396	1753	23149	43679	53%	38.39%	38	39
8	宜蘭縣冬山鄉	2018-11-24T23:18:29+08:00	15784	4356	20140	1658	21798	40749	53.49%	38.73%	36	39
8	宜蘭縣冬山鄉	2018-11-25T03:37:31+08:00	17407	4801	22208	1804	24012	45405	52.88%	38.34%	39	39
8	宜蘭縣冬山鄉	2018-11-24T22:18:21+08:00	10791	2971	13762	1171	14933	27985	53.36%	38.56%	26	39
8	宜蘭縣冬山鄉	2018-11-24T23:26:09+08:00	15784	4356	20140	1658	21798	40749	53.49%	38.73%	36	39
8	宜蘭縣冬山鄉	2018-11-25T00:03:37+08:00	16770	4626	21396	1753	23149	43679	53%	38.39%	38	39
8	宜蘭縣冬山鄉	2018-11-24T22:43:52+08:00	13740	3756	17496	1476	18972	35822	52.96%	38.36%	32	39
8	嘉義縣大林鎮	2018-11-24T23:07:18+08:00	7216	2406	9622	1192	10814	21790	49.63%	33.12%	22	25
8	嘉義縣大林鎮	2018-11-24T22:56:36+08:00	6711	2238	8949	1109	10058	20325	49.49%	33.02%	21	25
8	嘉義縣大林鎮	2018-11-25T01:24:24+08:00	9111	3032	12143	1408	13551	26922	50.33%	33.84%	25	25
8	嘉義縣大林鎮	2018-11-25T03:54:40+08:00	9111	3032	12143	1408	13551	26922	50.33%	33.84%	25	25
8	嘉義縣大林鎮	2018-11-25T06:17:36+08:00	9111	3032	12143	1408	13551	26922	50.33%	33.84%	25	25
8	嘉義縣大林鎮	2018-11-24T23:10:56+08:00	7216	2406	9622	1192	10814	21790	49.63%	33.12%	22	25
8	嘉義縣大林鎮	2018-11-25T03:37:29+08:00	9111	3032	12143	1408	13551	26922	50.33%	33.84%	25	25
8	嘉義縣大林鎮	2018-11-24T22:39:09+08:00	6711	2238	8949	1109	10058	20325	49.49%	33.02%	21	25
8	嘉義縣大林鎮	2018-11-25T03:30:59+08:00	9111	3032	12143	1408	13551	26922	50.33%	33.84%	25	25
8	嘉義縣大林鎮	2018-11-24T22:32:18+08:00	6711	2238	8949	1109	10058	20325	49.49%	33.02%	21	25
8	嘉義縣大林鎮	2018-11-24T23:42:01+08:00	8407	2814	11221	1319	12540	25099	49.96%	33.5%	24	25
8	嘉義縣大林鎮	2018-11-25T03:48:29+08:00	9111	3032	12143	1408	13551	26922	50.33%	33.84%	25	25
8	嘉義縣大林鎮	2018-11-24T23:00:17+08:00	6711	2238	8949	1109	10058	20325	49.49%	33.02%	21	25
8	嘉義縣大林鎮	2018-11-25T06:07:22+08:00	9111	3032	12143	1408	13551	26922	50.33%	33.84%	25	25
8	嘉義縣大林鎮	2018-11-25T00:21:44+08:00	9111	3032	12143	1408	13551	26922	50.33%	33.84%	25	25
8	嘉義縣大林鎮	2018-11-24T23:29:46+08:00	8407	2814	11221	1319	12540	25099	49.96%	33.5%	24	25
8	嘉義縣大林鎮	2018-11-24T22:40:18+08:00	6711	2238	8949	1109	10058	20325	49.49%	33.02%	21	25
8	嘉義縣大林鎮	2018-11-25T04:01:29+08:00	9111	3032	12143	1408	13551	26922	50.33%	33.84%	25	25
8	嘉義縣大林鎮	2018-11-25T01:11:07+08:00	9111	3032	12143	1408	13551	26922	50.33%	33.84%	25	25
8	嘉義縣大林鎮	2018-11-24T23:37:48+08:00	8407	2814	11221	1319	12540	25099	49.96%	33.5%	24	25
8	嘉義縣大林鎮	2018-11-24T22:43:50+08:00	6711	2238	8949	1109	10058	20325	49.49%	33.02%	21	25
8	嘉義縣大林鎮	2018-11-25T00:56:13+08:00	9111	3032	12143	1408	13551	26922	50.33%	33.84%	25	25
8	嘉義縣大林鎮	2018-11-24T23:54:27+08:00	8407	2814	11221	1319	12540	25099	49.96%	33.5%	24	25
8	嘉義縣大林鎮	2018-11-25T01:16:22+08:00	9111	3032	12143	1408	13551	26922	50.33%	33.84%	25	25
8	嘉義縣大林鎮	2018-11-25T00:03:34+08:00	8407	2814	11221	1319	12540	25099	49.96%	33.5%	24	25
8	嘉義縣大林鎮	2018-11-24T22:35:44+08:00	6711	2238	8949	1109	10058	20325	49.49%	33.02%	21	25
8	嘉義縣大林鎮	2018-11-25T01:01:01+08:00	9111	3032	12143	1408	13551	26922	50.33%	33.84%	25	25
8	嘉義縣大林鎮	2018-11-24T23:22:23+08:00	7910	2639	10549	1274	11823	23520	50.27%	33.63%	23	25
8	嘉義縣大林鎮	2018-11-24T22:49:24+08:00	6711	2238	8949	1109	10058	20325	49.49%	33.02%	21	25
8	嘉義縣大林鎮	2018-11-24T23:03:47+08:00	7216	2406	9622	1192	10814	21790	49.63%	33.12%	22	25
8	嘉義縣大林鎮	2018-11-24T22:28:40+08:00	6511	2162	8673	1028	9701	19609	49.47%	33.2%	20	25
8	嘉義縣大林鎮	2018-11-24T23:33:50+08:00	8407	2814	11221	1319	12540	25099	49.96%	33.5%	24	25
8	嘉義縣大林鎮	2018-11-24T22:12:02+08:00	5929	1954	7883	960	8843	18073	48.93%	32.81%	19	25
8	嘉義縣大林鎮	2018-11-25T00:08:04+08:00	8407	2814	11221	1319	12540	25099	49.96%	33.5%	24	25
8	嘉義縣大林鎮	2018-11-25T03:42:48+08:00	9111	3032	12143	1408	13551	26922	50.33%	33.84%	25	25
8	嘉義縣大林鎮	2018-11-24T22:53:15+08:00	6711	2238	8949	1109	10058	20325	49.49%	33.02%	21	25
8	嘉義縣大林鎮	2018-11-24T23:46:03+08:00	8407	2814	11221	1319	12540	25099	49.96%	33.5%	24	25
8	嘉義縣大林鎮	2018-11-25T00:17:07+08:00	9111	3032	12143	1408	13551	26922	50.33%	33.84%	25	25
8	嘉義縣大林鎮	2018-11-24T22:21:46+08:00	5929	1954	7883	960	8843	18073	48.93%	32.81%	19	25
8	嘉義縣大林鎮	2018-11-24T22:25:25+08:00	5929	1954	7883	960	8843	18073	48.93%	32.81%	19	25
8	嘉義縣大林鎮	2018-11-25T06:22:44+08:00	9111	3032	12143	1408	13551	26922	50.33%	33.84%	25	25
8	嘉義縣大林鎮	2018-11-25T06:12:36+08:00	9111	3032	12143	1408	13551	26922	50.33%	33.84%	25	25
8	嘉義縣大林鎮	2018-11-25T00:12:44+08:00	9111	3032	12143	1408	13551	26922	50.33%	33.84%	25	25
8	嘉義縣大林鎮	2018-11-24T23:26:06+08:00	8407	2814	11221	1319	12540	25099	49.96%	33.5%	24	25
8	嘉義縣大林鎮	2018-11-24T23:18:27+08:00	7216	2406	9622	1192	10814	21790	49.63%	33.12%	22	25
8	嘉義縣大林鎮	2018-11-24T23:50:14+08:00	8407	2814	11221	1319	12540	25099	49.96%	33.5%	24	25
8	嘉義縣大林鎮	2018-11-24T23:14:40+08:00	7216	2406	9622	1192	10814	21790	49.63%	33.12%	22	25
8	嘉義縣大林鎮	2018-11-24T22:18:19+08:00	5929	1954	7883	960	8843	18073	48.93%	32.81%	19	25
8	嘉義縣大林鎮	2018-11-24T23:58:42+08:00	8407	2814	11221	1319	12540	25099	49.96%	33.5%	24	25
8	嘉義縣大林鎮	2018-11-25T06:27:55+08:00	9111	3032	12143	1408	13551	26922	50.33%	33.84%	25	25
8	嘉義縣大林鎮	2018-11-24T22:14:48+08:00	5929	1954	7883	960	8843	18073	48.93%	32.81%	19	25
8	嘉義縣大林鎮	2018-11-25T01:05:59+08:00	9111	3032	12143	1408	13551	26922	50.33%	33.84%	25	25
8	金門縣金湖鎮	2018-11-24T23:26:10+08:00	7022	1386	8408	633	9041	24405	37.05%	28.77%	16	17
8	金門縣金湖鎮	2018-11-24T23:10:59+08:00	7022	1386	8408	633	9041	24405	37.05%	28.77%	16	17
8	金門縣金湖鎮	2018-11-24T22:49:27+08:00	6073	1175	7248	567	7815	21300	36.69%	28.51%	14	17
8	金門縣金湖鎮	2018-11-24T23:33:53+08:00	7022	1386	8408	633	9041	24405	37.05%	28.77%	16	17
8	金門縣金湖鎮	2018-11-24T22:12:06+08:00	4290	832	5122	393	5515	15212	36.25%	28.2%	10	17
8	金門縣金湖鎮	2018-11-24T22:56:39+08:00	6573	1282	7855	601	8456	23080	36.64%	28.48%	15	17
8	金門縣金湖鎮	2018-11-24T23:22:26+08:00	7022	1386	8408	633	9041	24405	37.05%	28.77%	16	17
8	金門縣金湖鎮	2018-11-24T22:28:43+08:00	5606	1092	6698	513	7211	19897	36.24%	28.18%	13	17
8	金門縣金湖鎮	2018-11-24T23:18:30+08:00	7022	1386	8408	633	9041	24405	37.05%	28.77%	16	17
8	金門縣金湖鎮	2018-11-24T23:37:52+08:00	7022	1386	8408	633	9041	24405	37.05%	28.77%	16	17
8	金門縣金湖鎮	2018-11-25T00:17:11+08:00	7443	1448	8891	688	9579	25915	36.96%	28.72%	17	17
8	金門縣金湖鎮	2018-11-24T22:32:21+08:00	6073	1175	7248	567	7815	21300	36.69%	28.51%	14	17
8	金門縣金湖鎮	2018-11-24T22:21:50+08:00	5606	1092	6698	513	7211	19897	36.24%	28.18%	13	17
8	金門縣金湖鎮	2018-11-25T04:01:33+08:00	7443	1448	8891	688	9579	25915	36.96%	28.72%	17	17
8	金門縣金湖鎮	2018-11-24T23:46:07+08:00	7443	1448	8891	688	9579	25915	36.96%	28.72%	17	17
8	金門縣金湖鎮	2018-11-24T22:53:18+08:00	6073	1175	7248	567	7815	21300	36.69%	28.51%	14	17
8	金門縣金湖鎮	2018-11-25T00:08:08+08:00	7443	1448	8891	688	9579	25915	36.96%	28.72%	17	17
8	金門縣金湖鎮	2018-11-24T22:25:28+08:00	5606	1092	6698	513	7211	19897	36.24%	28.18%	13	17
8	金門縣金湖鎮	2018-11-24T23:00:20+08:00	7022	1386	8408	633	9041	24405	37.05%	28.77%	16	17
8	金門縣金湖鎮	2018-11-25T06:22:48+08:00	7443	1448	8891	688	9579	25915	36.96%	28.72%	17	17
8	金門縣金湖鎮	2018-11-25T03:48:35+08:00	7443	1448	8891	688	9579	25915	36.96%	28.72%	17	17
8	金門縣金湖鎮	2018-11-24T23:14:44+08:00	7022	1386	8408	633	9041	24405	37.05%	28.77%	16	17
8	金門縣金湖鎮	2018-11-25T03:37:33+08:00	7443	1448	8891	688	9579	25915	36.96%	28.72%	17	17
8	金門縣金湖鎮	2018-11-24T22:18:23+08:00	4824	927	5751	437	6188	16983	36.44%	28.4%	11	17
8	金門縣金湖鎮	2018-11-24T23:50:18+08:00	7443	1448	8891	688	9579	25915	36.96%	28.72%	17	17
8	金門縣金湖鎮	2018-11-24T23:58:46+08:00	7443	1448	8891	688	9579	25915	36.96%	28.72%	17	17
8	金門縣金湖鎮	2018-11-25T00:12:48+08:00	7443	1448	8891	688	9579	25915	36.96%	28.72%	17	17
8	金門縣金湖鎮	2018-11-24T23:03:50+08:00	7022	1386	8408	633	9041	24405	37.05%	28.77%	16	17
8	金門縣金湖鎮	2018-11-24T22:39:12+08:00	6073	1175	7248	567	7815	21300	36.69%	28.51%	14	17
8	金門縣金湖鎮	2018-11-25T06:27:58+08:00	7443	1448	8891	688	9579	25915	36.96%	28.72%	17	17
8	金門縣金湖鎮	2018-11-25T06:17:40+08:00	7443	1448	8891	688	9579	25915	36.96%	28.72%	17	17
8	金門縣金湖鎮	2018-11-24T23:54:31+08:00	7443	1448	8891	688	9579	25915	36.96%	28.72%	17	17
8	金門縣金湖鎮	2018-11-24T22:14:52+08:00	4824	927	5751	437	6188	16983	36.44%	28.4%	11	17
8	金門縣金湖鎮	2018-11-25T01:24:28+08:00	7443	1448	8891	688	9579	25915	36.96%	28.72%	17	17
8	金門縣金湖鎮	2018-11-25T03:54:45+08:00	7443	1448	8891	688	9579	25915	36.96%	28.72%	17	17
8	金門縣金湖鎮	2018-11-24T23:07:22+08:00	7022	1386	8408	633	9041	24405	37.05%	28.77%	16	17
8	金門縣金湖鎮	2018-11-25T06:12:40+08:00	7443	1448	8891	688	9579	25915	36.96%	28.72%	17	17
8	金門縣金湖鎮	2018-11-24T23:29:50+08:00	7022	1386	8408	633	9041	24405	37.05%	28.77%	16	17
8	金門縣金湖鎮	2018-11-24T23:42:05+08:00	7443	1448	8891	688	9579	25915	36.96%	28.72%	17	17
8	金門縣金湖鎮	2018-11-25T01:06:03+08:00	7443	1448	8891	688	9579	25915	36.96%	28.72%	17	17
8	金門縣金湖鎮	2018-11-25T01:11:11+08:00	7443	1448	8891	688	9579	25915	36.96%	28.72%	17	17
8	金門縣金湖鎮	2018-11-25T00:21:47+08:00	7443	1448	8891	688	9579	25915	36.96%	28.72%	17	17
8	金門縣金湖鎮	2018-11-25T03:42:52+08:00	7443	1448	8891	688	9579	25915	36.96%	28.72%	17	17
8	金門縣金湖鎮	2018-11-25T06:07:26+08:00	7443	1448	8891	688	9579	25915	36.96%	28.72%	17	17
8	金門縣金湖鎮	2018-11-24T22:40:22+08:00	6073	1175	7248	567	7815	21300	36.69%	28.51%	14	17
8	金門縣金湖鎮	2018-11-25T00:56:17+08:00	7443	1448	8891	688	9579	25915	36.96%	28.72%	17	17
8	金門縣金湖鎮	2018-11-24T22:43:54+08:00	6073	1175	7248	567	7815	21300	36.69%	28.51%	14	17
8	金門縣金湖鎮	2018-11-25T03:31:03+08:00	7443	1448	8891	688	9579	25915	36.96%	28.72%	17	17
8	金門縣金湖鎮	2018-11-24T22:35:47+08:00	6073	1175	7248	567	7815	21300	36.69%	28.51%	14	17
8	金門縣金湖鎮	2018-11-25T01:01:05+08:00	7443	1448	8891	688	9579	25915	36.96%	28.72%	17	17
8	金門縣金湖鎮	2018-11-25T01:16:26+08:00	7443	1448	8891	688	9579	25915	36.96%	28.72%	17	17
8	金門縣金湖鎮	2018-11-25T00:03:39+08:00	7443	1448	8891	688	9579	25915	36.96%	28.72%	17	17
8	嘉義縣竹崎鄉	2018-11-24T23:07:18+08:00	9163	2984	12147	1185	13332	27108	49.18%	33.8%	33	36
8	嘉義縣竹崎鄉	2018-11-24T22:56:36+08:00	9163	2984	12147	1185	13332	27108	49.18%	33.8%	33	36
8	嘉義縣竹崎鄉	2018-11-25T01:24:24+08:00	10700	3474	14174	1401	15575	31228	49.88%	34.26%	36	36
8	嘉義縣竹崎鄉	2018-11-25T06:17:36+08:00	10700	3474	14174	1401	15575	31228	49.88%	34.26%	36	36
8	嘉義縣竹崎鄉	2018-11-24T23:10:56+08:00	9163	2984	12147	1185	13332	27108	49.18%	33.8%	33	36
8	嘉義縣竹崎鄉	2018-11-25T03:37:29+08:00	10700	3474	14174	1401	15575	31228	49.88%	34.26%	36	36
8	嘉義縣竹崎鄉	2018-11-24T22:39:09+08:00	8272	2725	10997	1118	12115	24691	49.07%	33.5%	31	36
8	嘉義縣竹崎鄉	2018-11-25T03:54:41+08:00	10700	3474	14174	1401	15575	31228	49.88%	34.26%	36	36
8	嘉義縣竹崎鄉	2018-11-25T03:30:59+08:00	10700	3474	14174	1401	15575	31228	49.88%	34.26%	36	36
8	嘉義縣竹崎鄉	2018-11-24T22:32:18+08:00	7713	2514	10227	1055	11282	23101	48.84%	33.39%	30	36
8	嘉義縣竹崎鄉	2018-11-25T03:48:29+08:00	10700	3474	14174	1401	15575	31228	49.88%	34.26%	36	36
8	嘉義縣竹崎鄉	2018-11-24T23:00:17+08:00	9163	2984	12147	1185	13332	27108	49.18%	33.8%	33	36
8	嘉義縣竹崎鄉	2018-11-25T00:21:44+08:00	10700	3474	14174	1401	15575	31228	49.88%	34.26%	36	36
8	嘉義縣竹崎鄉	2018-11-24T23:29:46+08:00	9473	3100	12573	1241	13814	27941	49.44%	33.9%	34	36
8	嘉義縣竹崎鄉	2018-11-25T06:07:23+08:00	10700	3474	14174	1401	15575	31228	49.88%	34.26%	36	36
8	嘉義縣竹崎鄉	2018-11-25T04:01:29+08:00	10700	3474	14174	1401	15575	31228	49.88%	34.26%	36	36
8	嘉義縣竹崎鄉	2018-11-25T01:11:07+08:00	10700	3474	14174	1401	15575	31228	49.88%	34.26%	36	36
8	嘉義縣竹崎鄉	2018-11-24T22:40:19+08:00	8272	2725	10997	1118	12115	24691	49.07%	33.5%	31	36
8	嘉義縣竹崎鄉	2018-11-24T22:43:50+08:00	8272	2725	10997	1118	12115	24691	49.07%	33.5%	31	36
8	嘉義縣竹崎鄉	2018-11-25T00:56:13+08:00	10700	3474	14174	1401	15575	31228	49.88%	34.26%	36	36
8	嘉義縣竹崎鄉	2018-11-24T23:54:27+08:00	10254	3337	13591	1317	14908	29936	49.8%	34.25%	35	36
8	嘉義縣竹崎鄉	2018-11-24T22:35:45+08:00	8272	2725	10997	1118	12115	24691	49.07%	33.5%	31	36
8	嘉義縣竹崎鄉	2018-11-25T01:16:22+08:00	10700	3474	14174	1401	15575	31228	49.88%	34.26%	36	36
8	嘉義縣竹崎鄉	2018-11-25T00:03:34+08:00	10254	3337	13591	1317	14908	29936	49.8%	34.25%	35	36
8	嘉義縣竹崎鄉	2018-11-24T23:37:49+08:00	9473	3100	12573	1241	13814	27941	49.44%	33.9%	34	36
8	嘉義縣竹崎鄉	2018-11-25T01:01:01+08:00	10700	3474	14174	1401	15575	31228	49.88%	34.26%	36	36
8	嘉義縣竹崎鄉	2018-11-24T23:22:23+08:00	9473	3100	12573	1241	13814	27941	49.44%	33.9%	34	36
8	嘉義縣竹崎鄉	2018-11-24T22:49:24+08:00	8272	2725	10997	1118	12115	24691	49.07%	33.5%	31	36
8	嘉義縣竹崎鄉	2018-11-24T23:03:47+08:00	9163	2984	12147	1185	13332	27108	49.18%	33.8%	33	36
8	嘉義縣竹崎鄉	2018-11-24T22:28:40+08:00	7713	2514	10227	1055	11282	23101	48.84%	33.39%	30	36
8	嘉義縣竹崎鄉	2018-11-24T23:33:50+08:00	9473	3100	12573	1241	13814	27941	49.44%	33.9%	34	36
8	嘉義縣竹崎鄉	2018-11-24T22:12:02+08:00	6082	1980	8062	783	8845	18437	47.97%	32.99%	26	36
8	嘉義縣竹崎鄉	2018-11-24T23:42:02+08:00	9473	3100	12573	1241	13814	27941	49.44%	33.9%	34	36
8	嘉義縣竹崎鄉	2018-11-25T00:08:05+08:00	10254	3337	13591	1317	14908	29936	49.8%	34.25%	35	36
8	嘉義縣竹崎鄉	2018-11-25T03:42:48+08:00	10700	3474	14174	1401	15575	31228	49.88%	34.26%	36	36
8	嘉義縣竹崎鄉	2018-11-24T22:53:15+08:00	8742	2858	11600	1137	12737	25901	49.18%	33.75%	32	36
8	嘉義縣竹崎鄉	2018-11-24T23:46:03+08:00	10254	3337	13591	1317	14908	29936	49.8%	34.25%	35	36
8	嘉義縣竹崎鄉	2018-11-25T06:12:37+08:00	10700	3474	14174	1401	15575	31228	49.88%	34.26%	36	36
8	嘉義縣竹崎鄉	2018-11-24T22:21:46+08:00	7465	2443	9908	1037	10945	22485	48.68%	33.2%	29	36
8	嘉義縣竹崎鄉	2018-11-24T22:25:25+08:00	7713	2514	10227	1055	11282	23101	48.84%	33.39%	30	36
8	嘉義縣竹崎鄉	2018-11-25T00:17:08+08:00	10254	3337	13591	1317	14908	29936	49.8%	34.25%	35	36
8	嘉義縣竹崎鄉	2018-11-25T06:22:45+08:00	10700	3474	14174	1401	15575	31228	49.88%	34.26%	36	36
8	嘉義縣竹崎鄉	2018-11-24T22:14:49+08:00	6602	2139	8741	860	9601	19886	48.28%	33.2%	27	36
8	嘉義縣竹崎鄉	2018-11-24T22:18:20+08:00	6602	2139	8741	860	9601	19886	48.28%	33.2%	27	36
8	嘉義縣竹崎鄉	2018-11-24T23:18:27+08:00	9163	2984	12147	1185	13332	27108	49.18%	33.8%	33	36
8	嘉義縣竹崎鄉	2018-11-24T23:58:42+08:00	10254	3337	13591	1317	14908	29936	49.8%	34.25%	35	36
8	嘉義縣竹崎鄉	2018-11-25T06:27:55+08:00	10700	3474	14174	1401	15575	31228	49.88%	34.26%	36	36
8	嘉義縣竹崎鄉	2018-11-24T23:26:07+08:00	9473	3100	12573	1241	13814	27941	49.44%	33.9%	34	36
8	嘉義縣竹崎鄉	2018-11-25T00:12:45+08:00	10254	3337	13591	1317	14908	29936	49.8%	34.25%	35	36
8	嘉義縣竹崎鄉	2018-11-25T01:05:59+08:00	10700	3474	14174	1401	15575	31228	49.88%	34.26%	36	36
8	嘉義縣竹崎鄉	2018-11-24T23:14:41+08:00	9163	2984	12147	1185	13332	27108	49.18%	33.8%	33	36
8	嘉義縣竹崎鄉	2018-11-24T23:50:15+08:00	10254	3337	13591	1317	14908	29936	49.8%	34.25%	35	36
8	高雄市燕巢區	2018-11-24T22:49:20+08:00	9452	3102	12554	1330	13884	24910	55.74%	37.94%	24	25
8	高雄市燕巢區	2018-11-25T03:37:21+08:00	9937	3265	13202	1399	14601	26012	56.13%	38.2%	25	25
8	高雄市燕巢區	2018-11-24T23:03:44+08:00	9937	3265	13202	1399	14601	26012	56.13%	38.2%	25	25
8	高雄市燕巢區	2018-11-24T23:58:37+08:00	9937	3265	13202	1399	14601	26012	56.13%	38.2%	25	25
8	高雄市燕巢區	2018-11-25T00:03:29+08:00	9937	3265	13202	1399	14601	26012	56.13%	38.2%	25	25
8	高雄市燕巢區	2018-11-25T00:56:09+08:00	9937	3265	13202	1399	14601	26012	56.13%	38.2%	25	25
8	高雄市燕巢區	2018-11-24T23:22:19+08:00	9937	3265	13202	1399	14601	26012	56.13%	38.2%	25	25
8	高雄市燕巢區	2018-11-25T03:42:44+08:00	9937	3265	13202	1399	14601	26012	56.13%	38.2%	25	25
8	高雄市燕巢區	2018-11-24T22:53:10+08:00	9937	3265	13202	1399	14601	26012	56.13%	38.2%	25	25
8	高雄市燕巢區	2018-11-25T00:08:00+08:00	9937	3265	13202	1399	14601	26012	56.13%	38.2%	25	25
8	高雄市燕巢區	2018-11-24T23:46:00+08:00	9937	3265	13202	1399	14601	26012	56.13%	38.2%	25	25
8	高雄市燕巢區	2018-11-25T01:00:56+08:00	9937	3265	13202	1399	14601	26012	56.13%	38.2%	25	25
8	高雄市燕巢區	2018-11-24T22:21:42+08:00	9452	3102	12554	1330	13884	24910	55.74%	37.94%	24	25
8	高雄市燕巢區	2018-11-25T06:12:33+08:00	9937	3265	13202	1399	14601	26012	56.13%	38.2%	25	25
8	高雄市燕巢區	2018-11-25T00:17:04+08:00	9937	3265	13202	1399	14601	26012	56.13%	38.2%	25	25
8	高雄市燕巢區	2018-11-25T06:22:41+08:00	9937	3265	13202	1399	14601	26012	56.13%	38.2%	25	25
8	高雄市燕巢區	2018-11-24T22:25:20+08:00	9452	3102	12554	1330	13884	24910	55.74%	37.94%	24	25
8	高雄市燕巢區	2018-11-24T23:18:23+08:00	9937	3265	13202	1399	14601	26012	56.13%	38.2%	25	25
8	高雄市燕巢區	2018-11-24T22:18:15+08:00	9452	3102	12554	1330	13884	24910	55.74%	37.94%	24	25
8	高雄市燕巢區	2018-11-24T22:14:44+08:00	9452	3102	12554	1330	13884	24910	55.74%	37.94%	24	25
8	高雄市燕巢區	2018-11-24T23:50:11+08:00	9937	3265	13202	1399	14601	26012	56.13%	38.2%	25	25
8	高雄市燕巢區	2018-11-25T01:05:54+08:00	9937	3265	13202	1399	14601	26012	56.13%	38.2%	25	25
8	高雄市燕巢區	2018-11-24T23:33:46+08:00	9937	3265	13202	1399	14601	26012	56.13%	38.2%	25	25
8	高雄市燕巢區	2018-11-25T06:27:51+08:00	9937	3265	13202	1399	14601	26012	56.13%	38.2%	25	25
8	高雄市燕巢區	2018-11-24T23:26:03+08:00	9937	3265	13202	1399	14601	26012	56.13%	38.2%	25	25
8	高雄市燕巢區	2018-11-25T03:54:36+08:00	9937	3265	13202	1399	14601	26012	56.13%	38.2%	25	25
8	高雄市燕巢區	2018-11-25T00:12:41+08:00	9937	3265	13202	1399	14601	26012	56.13%	38.2%	25	25
8	高雄市燕巢區	2018-11-25T01:24:20+08:00	9937	3265	13202	1399	14601	26012	56.13%	38.2%	25	25
8	高雄市燕巢區	2018-11-24T22:43:46+08:00	9452	3102	12554	1330	13884	24910	55.74%	37.94%	24	25
8	高雄市燕巢區	2018-11-25T06:17:32+08:00	9937	3265	13202	1399	14601	26012	56.13%	38.2%	25	25
8	高雄市燕巢區	2018-11-24T23:07:15+08:00	9937	3265	13202	1399	14601	26012	56.13%	38.2%	25	25
8	高雄市燕巢區	2018-11-24T22:39:05+08:00	9452	3102	12554	1330	13884	24910	55.74%	37.94%	24	25
8	高雄市燕巢區	2018-11-24T22:56:33+08:00	9937	3265	13202	1399	14601	26012	56.13%	38.2%	25	25
8	高雄市燕巢區	2018-11-24T23:14:36+08:00	9937	3265	13202	1399	14601	26012	56.13%	38.2%	25	25
8	高雄市燕巢區	2018-11-24T23:10:52+08:00	9937	3265	13202	1399	14601	26012	56.13%	38.2%	25	25
8	高雄市燕巢區	2018-11-25T03:48:25+08:00	9937	3265	13202	1399	14601	26012	56.13%	38.2%	25	25
8	高雄市燕巢區	2018-11-24T22:32:14+08:00	9452	3102	12554	1330	13884	24910	55.74%	37.94%	24	25
8	高雄市燕巢區	2018-11-25T03:30:54+08:00	9937	3265	13202	1399	14601	26012	56.13%	38.2%	25	25
8	高雄市燕巢區	2018-11-24T22:40:15+08:00	9452	3102	12554	1330	13884	24910	55.74%	37.94%	24	25
8	高雄市燕巢區	2018-11-25T00:21:40+08:00	9937	3265	13202	1399	14601	26012	56.13%	38.2%	25	25
8	高雄市燕巢區	2018-11-24T23:29:42+08:00	9937	3265	13202	1399	14601	26012	56.13%	38.2%	25	25
8	高雄市燕巢區	2018-11-25T01:11:02+08:00	9937	3265	13202	1399	14601	26012	56.13%	38.2%	25	25
8	高雄市燕巢區	2018-11-24T22:11:59+08:00	9452	3102	12554	1330	13884	24910	55.74%	37.94%	24	25
8	高雄市燕巢區	2018-11-24T23:00:14+08:00	9937	3265	13202	1399	14601	26012	56.13%	38.2%	25	25
8	高雄市燕巢區	2018-11-25T06:07:18+08:00	9937	3265	13202	1399	14601	26012	56.13%	38.2%	25	25
8	高雄市燕巢區	2018-11-25T04:01:24+08:00	9937	3265	13202	1399	14601	26012	56.13%	38.2%	25	25
8	高雄市燕巢區	2018-11-24T22:28:36+08:00	9452	3102	12554	1330	13884	24910	55.74%	37.94%	24	25
8	高雄市燕巢區	2018-11-24T23:54:23+08:00	9937	3265	13202	1399	14601	26012	56.13%	38.2%	25	25
8	高雄市燕巢區	2018-11-24T22:35:41+08:00	9452	3102	12554	1330	13884	24910	55.74%	37.94%	24	25
8	高雄市燕巢區	2018-11-24T23:37:45+08:00	9937	3265	13202	1399	14601	26012	56.13%	38.2%	25	25
8	高雄市燕巢區	2018-11-24T23:41:58+08:00	9937	3265	13202	1399	14601	26012	56.13%	38.2%	25	25
8	高雄市燕巢區	2018-11-25T01:16:17+08:00	9937	3265	13202	1399	14601	26012	56.13%	38.2%	25	25
8	高雄市美濃區	2018-11-24T22:49:20+08:00	13355	3817	17172	1861	19033	35311	53.9%	37.82%	32	32
8	高雄市美濃區	2018-11-24T23:03:44+08:00	13355	3817	17172	1861	19033	35311	53.9%	37.82%	32	32
8	高雄市美濃區	2018-11-24T23:58:38+08:00	13355	3817	17172	1861	19033	35311	53.9%	37.82%	32	32
8	高雄市美濃區	2018-11-24T23:22:19+08:00	13355	3817	17172	1861	19033	35311	53.9%	37.82%	32	32
8	高雄市美濃區	2018-11-25T03:42:44+08:00	13355	3817	17172	1861	19033	35311	53.9%	37.82%	32	32
8	高雄市美濃區	2018-11-25T01:00:57+08:00	13355	3817	17172	1861	19033	35311	53.9%	37.82%	32	32
8	高雄市美濃區	2018-11-24T22:53:11+08:00	13355	3817	17172	1861	19033	35311	53.9%	37.82%	32	32
8	高雄市美濃區	2018-11-24T23:46:00+08:00	13355	3817	17172	1861	19033	35311	53.9%	37.82%	32	32
8	高雄市美濃區	2018-11-25T00:08:01+08:00	13355	3817	17172	1861	19033	35311	53.9%	37.82%	32	32
8	高雄市美濃區	2018-11-24T22:21:42+08:00	12440	3536	15976	1790	17766	32621	54.46%	38.13%	30	32
8	高雄市美濃區	2018-11-25T06:12:33+08:00	13355	3817	17172	1861	19033	35311	53.9%	37.82%	32	32
8	高雄市美濃區	2018-11-25T00:17:04+08:00	13355	3817	17172	1861	19033	35311	53.9%	37.82%	32	32
8	高雄市美濃區	2018-11-24T22:25:20+08:00	12923	3699	16622	1827	18449	34059	54.17%	37.94%	31	32
8	高雄市美濃區	2018-11-24T23:18:24+08:00	13355	3817	17172	1861	19033	35311	53.9%	37.82%	32	32
8	高雄市美濃區	2018-11-25T01:05:55+08:00	13355	3817	17172	1861	19033	35311	53.9%	37.82%	32	32
8	高雄市美濃區	2018-11-24T23:50:11+08:00	13355	3817	17172	1861	19033	35311	53.9%	37.82%	32	32
8	高雄市美濃區	2018-11-24T22:14:45+08:00	11817	3353	15170	1731	16901	31072	54.39%	38.03%	29	32
8	高雄市美濃區	2018-11-24T23:33:46+08:00	13355	3817	17172	1861	19033	35311	53.9%	37.82%	32	32
8	高雄市美濃區	2018-11-25T06:27:51+08:00	13355	3817	17172	1861	19033	35311	53.9%	37.82%	32	32
8	高雄市美濃區	2018-11-24T23:26:03+08:00	13355	3817	17172	1861	19033	35311	53.9%	37.82%	32	32
8	高雄市美濃區	2018-11-25T03:54:36+08:00	13355	3817	17172	1861	19033	35311	53.9%	37.82%	32	32
8	高雄市美濃區	2018-11-25T00:12:41+08:00	13355	3817	17172	1861	19033	35311	53.9%	37.82%	32	32
8	高雄市美濃區	2018-11-25T01:24:20+08:00	13355	3817	17172	1861	19033	35311	53.9%	37.82%	32	32
8	高雄市美濃區	2018-11-24T22:43:46+08:00	12923	3699	16622	1827	18449	34059	54.17%	37.94%	31	32
8	高雄市美濃區	2018-11-25T06:17:32+08:00	13355	3817	17172	1861	19033	35311	53.9%	37.82%	32	32
8	高雄市美濃區	2018-11-25T03:37:22+08:00	13355	3817	17172	1861	19033	35311	53.9%	37.82%	32	32
8	高雄市美濃區	2018-11-24T23:07:15+08:00	13355	3817	17172	1861	19033	35311	53.9%	37.82%	32	32
8	高雄市美濃區	2018-11-24T22:39:05+08:00	12923	3699	16622	1827	18449	34059	54.17%	37.94%	31	32
8	高雄市美濃區	2018-11-24T23:10:53+08:00	13355	3817	17172	1861	19033	35311	53.9%	37.82%	32	32
8	高雄市美濃區	2018-11-24T22:56:33+08:00	13355	3817	17172	1861	19033	35311	53.9%	37.82%	32	32
8	高雄市美濃區	2018-11-24T23:14:36+08:00	13355	3817	17172	1861	19033	35311	53.9%	37.82%	32	32
8	高雄市美濃區	2018-11-25T03:48:25+08:00	13355	3817	17172	1861	19033	35311	53.9%	37.82%	32	32
8	高雄市美濃區	2018-11-25T03:30:55+08:00	13355	3817	17172	1861	19033	35311	53.9%	37.82%	32	32
8	高雄市美濃區	2018-11-24T22:32:15+08:00	12923	3699	16622	1827	18449	34059	54.17%	37.94%	31	32
8	高雄市美濃區	2018-11-24T22:40:15+08:00	12923	3699	16622	1827	18449	34059	54.17%	37.94%	31	32
8	高雄市美濃區	2018-11-25T04:01:25+08:00	13355	3817	17172	1861	19033	35311	53.9%	37.82%	32	32
8	高雄市美濃區	2018-11-24T22:11:59+08:00	11817	3353	15170	1731	16901	31072	54.39%	38.03%	29	32
8	高雄市美濃區	2018-11-24T23:00:14+08:00	13355	3817	17172	1861	19033	35311	53.9%	37.82%	32	32
8	高雄市美濃區	2018-11-25T06:07:19+08:00	13355	3817	17172	1861	19033	35311	53.9%	37.82%	32	32
8	高雄市美濃區	2018-11-25T01:11:03+08:00	13355	3817	17172	1861	19033	35311	53.9%	37.82%	32	32
8	高雄市美濃區	2018-11-24T23:29:43+08:00	13355	3817	17172	1861	19033	35311	53.9%	37.82%	32	32
8	高雄市美濃區	2018-11-25T00:21:41+08:00	13355	3817	17172	1861	19033	35311	53.9%	37.82%	32	32
8	高雄市美濃區	2018-11-25T06:22:42+08:00	13355	3817	17172	1861	19033	35311	53.9%	37.82%	32	32
8	高雄市美濃區	2018-11-24T22:28:36+08:00	12923	3699	16622	1827	18449	34059	54.17%	37.94%	31	32
8	高雄市美濃區	2018-11-25T00:56:10+08:00	13355	3817	17172	1861	19033	35311	53.9%	37.82%	32	32
8	高雄市美濃區	2018-11-24T22:18:16+08:00	11817	3353	15170	1731	16901	31072	54.39%	38.03%	29	32
8	高雄市美濃區	2018-11-24T23:54:24+08:00	13355	3817	17172	1861	19033	35311	53.9%	37.82%	32	32
8	高雄市美濃區	2018-11-24T22:35:41+08:00	12923	3699	16622	1827	18449	34059	54.17%	37.94%	31	32
8	高雄市美濃區	2018-11-25T01:16:18+08:00	13355	3817	17172	1861	19033	35311	53.9%	37.82%	32	32
8	高雄市美濃區	2018-11-24T23:37:45+08:00	13355	3817	17172	1861	19033	35311	53.9%	37.82%	32	32
8	高雄市美濃區	2018-11-24T23:41:58+08:00	13355	3817	17172	1861	19033	35311	53.9%	37.82%	32	32
8	高雄市美濃區	2018-11-25T00:03:30+08:00	13355	3817	17172	1861	19033	35311	53.9%	37.82%	32	32
8	花蓮縣吉安鄉	2018-11-24T22:14:51+08:00	7993	1934	9927	672	10599	20075	52.8%	39.82%	18	59
8	花蓮縣吉安鄉	2018-11-24T23:33:52+08:00	17893	4393	22286	1525	23811	45084	52.81%	39.69%	38	59
8	花蓮縣吉安鄉	2018-11-24T22:28:42+08:00	9462	2299	11761	770	12531	23719	52.83%	39.89%	21	59
8	花蓮縣吉安鄉	2018-11-24T22:56:38+08:00	12943	3160	16103	1082	17185	32294	53.21%	40.08%	28	59
8	花蓮縣吉安鄉	2018-11-24T23:07:21+08:00	14583	3552	18135	1214	19349	36334	53.25%	40.14%	31	59
8	花蓮縣吉安鄉	2018-11-24T22:49:26+08:00	12304	3006	15310	1034	16344	30862	52.96%	39.87%	27	59
8	花蓮縣吉安鄉	2018-11-24T23:10:58+08:00	14990	3661	18651	1251	19902	37393	53.22%	40.09%	32	59
8	花蓮縣吉安鄉	2018-11-25T06:17:39+08:00	28209	7124	35333	2515	37848	72116	52.48%	39.12%	59	59
8	花蓮縣吉安鄉	2018-11-24T22:53:17+08:00	12304	3006	15310	1034	16344	30862	52.96%	39.87%	27	59
8	花蓮縣吉安鄉	2018-11-25T00:08:07+08:00	21683	5426	27109	1820	28929	55119	52.48%	39.34%	46	59
8	花蓮縣吉安鄉	2018-11-24T22:32:20+08:00	10352	2522	12874	858	13732	25843	53.14%	40.06%	23	59
8	花蓮縣吉安鄉	2018-11-25T00:17:10+08:00	23164	5855	29019	2040	31059	59278	52.4%	39.08%	49	59
8	花蓮縣吉安鄉	2018-11-25T03:48:33+08:00	28209	7124	35333	2515	37848	72116	52.48%	39.12%	59	59
8	花蓮縣吉安鄉	2018-11-24T23:00:19+08:00	13540	3304	16844	1138	17982	33761	53.26%	40.11%	29	59
8	花蓮縣吉安鄉	2018-11-25T06:07:25+08:00	28209	7124	35333	2515	37848	72116	52.48%	39.12%	59	59
8	花蓮縣吉安鄉	2018-11-24T23:29:48+08:00	17015	4173	21188	1450	22638	42714	53%	39.83%	36	59
8	花蓮縣吉安鄉	2018-11-24T22:40:20+08:00	10352	2522	12874	858	13732	25843	53.14%	40.06%	23	59
8	花蓮縣吉安鄉	2018-11-25T06:22:46+08:00	28209	7124	35333	2515	37848	72116	52.48%	39.12%	59	59
8	花蓮縣吉安鄉	2018-11-24T22:25:27+08:00	9462	2299	11761	770	12531	23719	52.83%	39.89%	21	59
8	花蓮縣吉安鄉	2018-11-25T03:42:50+08:00	28209	7124	35333	2515	37848	72116	52.48%	39.12%	59	59
8	花蓮縣吉安鄉	2018-11-24T23:50:17+08:00	20084	5000	25084	1702	26786	50748	52.78%	39.58%	43	59
8	花蓮縣吉安鄉	2018-11-24T23:14:43+08:00	14990	3661	18651	1251	19902	37393	53.22%	40.09%	32	59
8	花蓮縣吉安鄉	2018-11-25T01:16:24+08:00	27139	6846	33985	2413	36398	69445	52.41%	39.08%	57	59
8	花蓮縣吉安鄉	2018-11-25T00:12:47+08:00	22175	5569	27744	1906	29650	56420	52.55%	39.3%	47	59
8	花蓮縣吉安鄉	2018-11-24T23:54:29+08:00	20675	5158	25833	1737	27570	52263	52.75%	39.56%	44	59
8	花蓮縣吉安鄉	2018-11-25T06:27:57+08:00	28209	7124	35333	2515	37848	72116	52.48%	39.12%	59	59
8	花蓮縣吉安鄉	2018-11-25T03:31:01+08:00	28209	7124	35333	2515	37848	72116	52.48%	39.12%	59	59
8	花蓮縣吉安鄉	2018-11-24T22:18:22+08:00	7993	1934	9927	672	10599	20075	52.8%	39.82%	18	59
8	花蓮縣吉安鄉	2018-11-25T03:37:32+08:00	28209	7124	35333	2515	37848	72116	52.48%	39.12%	59	59
8	花蓮縣吉安鄉	2018-11-25T00:56:15+08:00	26684	6729	33413	2376	35789	68310	52.39%	39.06%	56	59
8	花蓮縣吉安鄉	2018-11-24T23:37:50+08:00	18204	4509	22713	1562	24275	46110	52.65%	39.48%	39	59
8	花蓮縣吉安鄉	2018-11-25T01:24:27+08:00	27139	6846	33985	2413	36398	69445	52.41%	39.08%	57	59
8	花蓮縣吉安鄉	2018-11-25T03:54:43+08:00	28209	7124	35333	2515	37848	72116	52.48%	39.12%	59	59
8	花蓮縣吉安鄉	2018-11-24T23:03:49+08:00	14583	3552	18135	1214	19349	36334	53.25%	40.14%	31	59
8	花蓮縣吉安鄉	2018-11-24T22:12:04+08:00	7528	1838	9366	611	9977	18887	52.82%	39.86%	17	59
8	花蓮縣吉安鄉	2018-11-24T23:22:25+08:00	16550	4036	20586	1418	22004	41557	52.95%	39.82%	35	59
8	花蓮縣吉安鄉	2018-11-25T01:06:02+08:00	27139	6846	33985	2413	36398	69445	52.41%	39.08%	57	59
8	花蓮縣吉安鄉	2018-11-24T23:42:04+08:00	18689	4657	23346	1576	24922	47276	52.72%	39.53%	40	59
8	花蓮縣吉安鄉	2018-11-25T01:11:10+08:00	27139	6846	33985	2413	36398	69445	52.41%	39.08%	57	59
8	花蓮縣吉安鄉	2018-11-24T23:46:05+08:00	20084	5000	25084	1702	26786	50748	52.78%	39.58%	43	59
8	花蓮縣吉安鄉	2018-11-25T04:01:31+08:00	28209	7124	35333	2515	37848	72116	52.48%	39.12%	59	59
8	花蓮縣吉安鄉	2018-11-25T06:12:39+08:00	28209	7124	35333	2515	37848	72116	52.48%	39.12%	59	59
8	花蓮縣吉安鄉	2018-11-24T22:21:48+08:00	9462	2299	11761	770	12531	23719	52.83%	39.89%	21	59
8	花蓮縣吉安鄉	2018-11-25T00:21:46+08:00	23724	5987	29711	2076	31787	60598	52.46%	39.15%	50	59
8	花蓮縣吉安鄉	2018-11-25T01:01:04+08:00	26684	6729	33413	2376	35789	68310	52.39%	39.06%	56	59
8	花蓮縣吉安鄉	2018-11-24T22:35:46+08:00	10352	2522	12874	858	13732	25843	53.14%	40.06%	23	59
8	花蓮縣吉安鄉	2018-11-24T23:18:29+08:00	16550	4036	20586	1418	22004	41557	52.95%	39.82%	35	59
8	花蓮縣吉安鄉	2018-11-24T23:58:45+08:00	21683	5426	27109	1820	28929	55119	52.48%	39.34%	46	59
8	花蓮縣吉安鄉	2018-11-24T22:39:11+08:00	10352	2522	12874	858	13732	25843	53.14%	40.06%	23	59
8	花蓮縣吉安鄉	2018-11-24T23:26:09+08:00	17015	4173	21188	1450	22638	42714	53%	39.83%	36	59
8	花蓮縣吉安鄉	2018-11-25T00:03:37+08:00	21683	5426	27109	1820	28929	55119	52.48%	39.34%	46	59
8	花蓮縣吉安鄉	2018-11-24T22:43:52+08:00	10352	2522	12874	858	13732	25843	53.14%	40.06%	23	59
8	新竹市北區	2018-11-24T23:10:59+08:00	27965	8631	36596	2478	39074	71145	54.92%	39.31%	65	105
8	新竹市北區	2018-11-24T23:22:27+08:00	31995	9809	41804	2802	44606	81244	54.9%	39.38%	73	105
8	新竹市北區	2018-11-24T23:18:31+08:00	30947	9476	40423	2689	43112	78755	54.74%	39.3%	71	105
8	新竹市北區	2018-11-24T22:49:28+08:00	22732	7106	29838	2036	31874	57559	55.38%	39.49%	54	105
8	新竹市北區	2018-11-24T23:33:54+08:00	35559	10994	46553	3129	49682	90549	54.87%	39.27%	80	105
8	新竹市北區	2018-11-24T22:12:06+08:00	16619	5028	21647	1435	23082	41855	55.15%	39.71%	40	105
8	新竹市北區	2018-11-24T23:26:11+08:00	33060	10154	43214	2887	46101	83962	54.91%	39.37%	75	105
8	新竹市北區	2018-11-24T22:28:44+08:00	18942	5788	24730	1657	26387	47930	55.05%	39.52%	46	105
8	新竹市北區	2018-11-24T23:37:52+08:00	36741	11349	48090	3205	51295	93441	54.9%	39.32%	82	105
8	新竹市北區	2018-11-24T22:53:19+08:00	23604	7391	30995	2107	33102	60564	54.66%	38.97%	56	105
8	新竹市北區	2018-11-24T22:21:50+08:00	18131	5561	23692	1591	25283	45778	55.23%	39.61%	44	105
8	新竹市北區	2018-11-25T04:01:33+08:00	48668	14935	63603	4266	67869	123122	55.12%	39.53%	105	105
8	新竹市北區	2018-11-25T00:08:09+08:00	46893	14436	61329	4116	65445	119070	54.96%	39.38%	102	105
8	新竹市北區	2018-11-24T23:46:07+08:00	40192	12441	52633	3522	56155	102278	54.9%	39.3%	89	105
8	新竹市北區	2018-11-25T01:11:12+08:00	48668	14935	63603	4266	67869	123122	55.12%	39.53%	105	105
8	新竹市北區	2018-11-24T23:42:06+08:00	38408	11841	50249	3310	53559	97670	54.84%	39.32%	85	105
8	新竹市北區	2018-11-24T23:00:20+08:00	25294	7834	33128	2208	35336	64381	54.89%	39.29%	59	105
8	新竹市北區	2018-11-24T22:25:29+08:00	18672	5713	24385	1641	26026	47172	55.17%	39.58%	45	105
8	新竹市北區	2018-11-25T06:22:48+08:00	48668	14935	63603	4266	67869	123122	55.12%	39.53%	105	105
8	新竹市北區	2018-11-25T03:48:35+08:00	48668	14935	63603	4266	67869	123122	55.12%	39.53%	105	105
8	新竹市北區	2018-11-24T23:50:19+08:00	41336	12815	54151	3625	57776	105141	54.95%	39.31%	91	105
8	新竹市北區	2018-11-25T06:27:59+08:00	48668	14935	63603	4266	67869	123122	55.12%	39.53%	105	105
8	新竹市北區	2018-11-25T06:17:41+08:00	48668	14935	63603	4266	67869	123122	55.12%	39.53%	105	105
8	新竹市北區	2018-11-24T23:03:51+08:00	26701	8227	34928	2342	37270	67874	54.91%	39.34%	62	105
8	新竹市北區	2018-11-24T22:39:13+08:00	21307	6601	27908	1888	29796	54011	55.17%	39.45%	51	105
8	新竹市北區	2018-11-25T03:37:34+08:00	48668	14935	63603	4266	67869	123122	55.12%	39.53%	105	105
8	新竹市北區	2018-11-25T00:12:49+08:00	48668	14935	63603	4266	67869	123122	55.12%	39.53%	105	105
8	新竹市北區	2018-11-24T23:58:47+08:00	44774	13884	58658	3912	62570	113915	54.93%	39.3%	98	105
8	新竹市北區	2018-11-24T22:18:23+08:00	17160	5208	22368	1467	23835	43251	55.11%	39.68%	41	105
8	新竹市北區	2018-11-24T23:14:45+08:00	29401	9080	38481	2600	41081	75267	54.58%	39.06%	68	105
8	新竹市北區	2018-11-24T22:56:40+08:00	23604	7391	30995	2107	33102	60564	54.66%	38.97%	56	105
8	新竹市北區	2018-11-25T01:01:06+08:00	48668	14935	63603	4266	67869	123122	55.12%	39.53%	105	105
8	新竹市北區	2018-11-25T01:24:29+08:00	48668	14935	63603	4266	67869	123122	55.12%	39.53%	105	105
8	新竹市北區	2018-11-24T23:54:31+08:00	43209	13398	56607	3744	60351	109791	54.97%	39.36%	95	105
8	新竹市北區	2018-11-24T23:07:23+08:00	27634	8527	36161	2448	38609	70384	54.85%	39.26%	64	105
8	新竹市北區	2018-11-25T03:54:45+08:00	48668	14935	63603	4266	67869	123122	55.12%	39.53%	105	105
8	新竹市北區	2018-11-25T00:03:40+08:00	46893	14436	61329	4116	65445	119070	54.96%	39.38%	102	105
8	新竹市北區	2018-11-24T22:14:53+08:00	16619	5028	21647	1435	23082	41855	55.15%	39.71%	40	105
8	新竹市北區	2018-11-25T00:17:12+08:00	48668	14935	63603	4266	67869	123122	55.12%	39.53%	105	105
8	新竹市北區	2018-11-24T22:32:22+08:00	20426	6312	26738	1843	28581	51731	55.25%	39.49%	49	105
8	新竹市北區	2018-11-25T06:12:41+08:00	48668	14935	63603	4266	67869	123122	55.12%	39.53%	105	105
8	新竹市北區	2018-11-25T01:06:04+08:00	48668	14935	63603	4266	67869	123122	55.12%	39.53%	105	105
8	新竹市北區	2018-11-24T23:29:51+08:00	34060	10471	44531	2956	47487	86204	55.09%	39.51%	77	105
8	新竹市北區	2018-11-24T22:40:22+08:00	21307	6601	27908	1888	29796	54011	55.17%	39.45%	51	105
8	新竹市北區	2018-11-25T03:42:53+08:00	48668	14935	63603	4266	67869	123122	55.12%	39.53%	105	105
8	新竹市北區	2018-11-25T00:21:48+08:00	48668	14935	63603	4266	67869	123122	55.12%	39.53%	105	105
8	新竹市北區	2018-11-25T06:07:27+08:00	48668	14935	63603	4266	67869	123122	55.12%	39.53%	105	105
8	新竹市北區	2018-11-25T00:56:17+08:00	48668	14935	63603	4266	67869	123122	55.12%	39.53%	105	105
8	新竹市北區	2018-11-24T22:35:48+08:00	20426	6312	26738	1843	28581	51731	55.25%	39.49%	49	105
8	新竹市北區	2018-11-24T22:43:54+08:00	22732	7106	29838	2036	31874	57559	55.38%	39.49%	54	105
8	新竹市北區	2018-11-25T03:31:04+08:00	48668	14935	63603	4266	67869	123122	55.12%	39.53%	105	105
8	新竹市北區	2018-11-25T01:16:27+08:00	48668	14935	63603	4266	67869	123122	55.12%	39.53%	105	105
8	嘉義市	2018-11-24T23:10:59+08:00	69997	23727	93724	7528	101252	189405	53.46%	36.96%	155	177
8	嘉義市	2018-11-24T23:22:27+08:00	73991	25061	99052	8001	107053	200904	53.29%	36.83%	163	177
8	嘉義市	2018-11-24T23:18:31+08:00	73121	24777	97898	7891	105789	198366	53.33%	36.86%	161	177
8	嘉義市	2018-11-24T22:49:28+08:00	64149	21911	86060	6845	92905	174433	53.26%	36.78%	143	177
8	嘉義市	2018-11-24T23:33:54+08:00	75714	25707	101421	8211	109632	205531	53.34%	36.84%	166	177
8	嘉義市	2018-11-24T22:12:06+08:00	48150	16738	64888	5236	70124	130600	53.69%	36.87%	112	177
8	嘉義市	2018-11-24T23:26:11+08:00	74609	25300	99909	8051	107960	202456	53.33%	36.85%	164	177
8	嘉義市	2018-11-24T22:28:44+08:00	57769	19822	77591	6255	83846	157344	53.29%	36.72%	131	177
8	嘉義市	2018-11-24T23:37:52+08:00	76360	25913	102273	8300	110573	207362	53.32%	36.82%	167	177
8	嘉義市	2018-11-25T03:54:46+08:00	81506	27853	109359	8800	118159	221553	53.33%	36.79%	177	177
8	嘉義市	2018-11-24T22:53:19+08:00	65072	22226	87298	6984	94282	177061	53.25%	36.75%	145	177
8	嘉義市	2018-11-24T22:21:50+08:00	54595	18823	73418	5856	79274	148580	53.35%	36.74%	125	177
8	嘉義市	2018-11-25T04:01:33+08:00	81506	27853	109359	8800	118159	221553	53.33%	36.79%	177	177
8	嘉義市	2018-11-25T00:08:09+08:00	80970	27809	108779	8766	117545	220149	53.39%	36.78%	176	177
8	嘉義市	2018-11-24T23:46:07+08:00	77530	26135	103665	8382	112047	209986	53.36%	36.92%	169	177
8	嘉義市	2018-11-25T01:11:12+08:00	81506	27853	109359	8800	118159	221553	53.33%	36.79%	177	177
8	嘉義市	2018-11-24T23:42:06+08:00	76360	25913	102273	8300	110573	207362	53.32%	36.82%	167	177
8	嘉義市	2018-11-24T23:00:20+08:00	68325	23219	91544	7362	98906	185366	53.36%	36.86%	152	177
8	嘉義市	2018-11-24T22:25:29+08:00	56604	19461	76065	6162	82227	153892	53.43%	36.78%	129	177
8	嘉義市	2018-11-25T06:22:48+08:00	81506	27853	109359	8800	118159	221553	53.33%	36.79%	177	177
8	嘉義市	2018-11-25T03:48:35+08:00	81506	27853	109359	8800	118159	221553	53.33%	36.79%	177	177
8	嘉義市	2018-11-24T23:50:19+08:00	77530	26135	103665	8382	112047	209986	53.36%	36.92%	169	177
8	嘉義市	2018-11-25T06:27:59+08:00	81506	27853	109359	8800	118159	221553	53.33%	36.79%	177	177
8	嘉義市	2018-11-25T06:17:41+08:00	81506	27853	109359	8800	118159	221553	53.33%	36.79%	177	177
8	嘉義市	2018-11-24T23:03:51+08:00	69805	23704	93509	7506	101015	189145	53.41%	36.91%	155	177
8	嘉義市	2018-11-24T22:39:13+08:00	60934	20876	81810	6585	88395	165889	53.29%	36.73%	137	177
8	嘉義市	2018-11-25T03:37:34+08:00	81506	27853	109359	8800	118159	221553	53.33%	36.79%	177	177
8	嘉義市	2018-11-25T00:12:49+08:00	81506	27853	109359	8800	118159	221553	53.33%	36.79%	177	177
8	嘉義市	2018-11-24T23:58:47+08:00	78162	26339	104501	8469	112970	211613	53.39%	36.94%	170	177
8	嘉義市	2018-11-24T22:18:23+08:00	53090	18348	71438	5709	77147	144660	53.33%	36.7%	122	177
8	嘉義市	2018-11-24T23:14:45+08:00	70321	23854	94175	7553	101728	190540	53.39%	36.91%	156	177
8	嘉義市	2018-11-24T22:56:40+08:00	66328	22607	88935	7128	96063	180312	53.28%	36.79%	148	177
8	嘉義市	2018-11-25T01:01:06+08:00	81506	27853	109359	8800	118159	221553	53.33%	36.79%	177	177
8	嘉義市	2018-11-25T01:24:29+08:00	81506	27853	109359	8800	118159	221553	53.33%	36.79%	177	177
8	嘉義市	2018-11-24T23:54:31+08:00	77578	26143	103721	8392	112113	210046	53.38%	36.93%	169	177
8	嘉義市	2018-11-24T23:07:23+08:00	69481	23577	93058	7481	100539	188010	53.48%	36.96%	154	177
8	嘉義市	2018-11-25T00:03:40+08:00	80565	27667	108232	8760	116992	218966	53.43%	36.79%	175	177
8	嘉義市	2018-11-24T22:14:53+08:00	50171	17386	67557	5352	72909	136498	53.41%	36.76%	116	177
8	嘉義市	2018-11-25T00:17:12+08:00	81506	27853	109359	8800	118159	221553	53.33%	36.79%	177	177
8	嘉義市	2018-11-24T22:32:22+08:00	58121	19986	78107	6295	84402	158473	53.26%	36.68%	132	177
8	嘉義市	2018-11-25T06:12:41+08:00	81506	27853	109359	8800	118159	221553	53.33%	36.79%	177	177
8	嘉義市	2018-11-25T01:06:04+08:00	81506	27853	109359	8800	118159	221553	53.33%	36.79%	177	177
8	嘉義市	2018-11-24T23:29:51+08:00	74609	25300	99909	8051	107960	202456	53.33%	36.85%	164	177
8	嘉義市	2018-11-24T22:40:22+08:00	61868	21215	83083	6693	89776	168329	53.33%	36.75%	139	177
8	嘉義市	2018-11-25T03:42:53+08:00	81506	27853	109359	8800	118159	221553	53.33%	36.79%	177	177
8	嘉義市	2018-11-25T00:21:48+08:00	81506	27853	109359	8800	118159	221553	53.33%	36.79%	177	177
8	嘉義市	2018-11-25T06:07:27+08:00	81506	27853	109359	8800	118159	221553	53.33%	36.79%	177	177
8	嘉義市	2018-11-25T00:56:17+08:00	81506	27853	109359	8800	118159	221553	53.33%	36.79%	177	177
8	嘉義市	2018-11-24T22:35:48+08:00	59401	20358	79759	6448	86207	161593	53.35%	36.76%	134	177
8	嘉義市	2018-11-24T22:43:54+08:00	63540	21727	85267	6784	92051	172888	53.24%	36.75%	142	177
8	嘉義市	2018-11-25T03:31:04+08:00	81506	27853	109359	8800	118159	221553	53.33%	36.79%	177	177
8	嘉義市	2018-11-25T01:16:27+08:00	81506	27853	109359	8800	118159	221553	53.33%	36.79%	177	177
8	臺南市西港區	2018-11-25T03:37:19+08:00	6716	2122	8838	739	9577	21564	44.41%	31.14%	20	20
8	臺南市西港區	2018-11-24T22:49:18+08:00	6716	2122	8838	739	9577	21564	44.41%	31.14%	20	20
8	臺南市西港區	2018-11-24T23:14:34+08:00	6716	2122	8838	739	9577	21564	44.41%	31.14%	20	20
8	臺南市西港區	2018-11-24T22:56:31+08:00	6716	2122	8838	739	9577	21564	44.41%	31.14%	20	20
8	臺南市西港區	2018-11-25T00:03:27+08:00	6716	2122	8838	739	9577	21564	44.41%	31.14%	20	20
8	臺南市西港區	2018-11-24T22:43:45+08:00	6716	2122	8838	739	9577	21564	44.41%	31.14%	20	20
8	臺南市西港區	2018-11-25T00:56:07+08:00	6716	2122	8838	739	9577	21564	44.41%	31.14%	20	20
8	臺南市西港區	2018-11-24T23:03:42+08:00	6716	2122	8838	739	9577	21564	44.41%	31.14%	20	20
8	臺南市西港區	2018-11-24T23:10:51+08:00	6716	2122	8838	739	9577	21564	44.41%	31.14%	20	20
8	臺南市西港區	2018-11-25T06:17:30+08:00	6716	2122	8838	739	9577	21564	44.41%	31.14%	20	20
8	臺南市西港區	2018-11-24T23:58:36+08:00	6716	2122	8838	739	9577	21564	44.41%	31.14%	20	20
8	臺南市西港區	2018-11-24T23:22:17+08:00	6716	2122	8838	739	9577	21564	44.41%	31.14%	20	20
8	臺南市西港區	2018-11-25T03:42:42+08:00	6716	2122	8838	739	9577	21564	44.41%	31.14%	20	20
8	臺南市西港區	2018-11-25T06:22:40+08:00	6716	2122	8838	739	9577	21564	44.41%	31.14%	20	20
8	臺南市西港區	2018-11-24T23:29:41+08:00	6716	2122	8838	739	9577	21564	44.41%	31.14%	20	20
8	臺南市西港區	2018-11-24T22:25:18+08:00	6716	2122	8838	739	9577	21564	44.41%	31.14%	20	20
8	臺南市西港區	2018-11-25T01:11:00+08:00	6716	2122	8838	739	9577	21564	44.41%	31.14%	20	20
8	臺南市西港區	2018-11-25T00:17:02+08:00	6716	2122	8838	739	9577	21564	44.41%	31.14%	20	20
8	臺南市西港區	2018-11-25T06:12:32+08:00	6716	2122	8838	739	9577	21564	44.41%	31.14%	20	20
8	臺南市西港區	2018-11-25T00:07:58+08:00	6716	2122	8838	739	9577	21564	44.41%	31.14%	20	20
8	臺南市西港區	2018-11-25T00:12:40+08:00	6716	2122	8838	739	9577	21564	44.41%	31.14%	20	20
8	臺南市西港區	2018-11-24T22:14:43+08:00	6716	2122	8838	739	9577	21564	44.41%	31.14%	20	20
8	臺南市西港區	2018-11-24T23:26:02+08:00	6716	2122	8838	739	9577	21564	44.41%	31.14%	20	20
8	臺南市西港區	2018-11-25T06:27:50+08:00	6716	2122	8838	739	9577	21564	44.41%	31.14%	20	20
8	臺南市西港區	2018-11-24T23:18:22+08:00	6716	2122	8838	739	9577	21564	44.41%	31.14%	20	20
8	臺南市西港區	2018-11-25T01:05:53+08:00	6716	2122	8838	739	9577	21564	44.41%	31.14%	20	20
8	臺南市西港區	2018-11-24T23:54:19+08:00	6716	2122	8838	739	9577	21564	44.41%	31.14%	20	20
8	臺南市西港區	2018-11-24T22:28:34+08:00	6716	2122	8838	739	9577	21564	44.41%	31.14%	20	20
8	臺南市西港區	2018-11-24T22:18:14+08:00	6716	2122	8838	739	9577	21564	44.41%	31.14%	20	20
8	臺南市西港區	2018-11-25T01:24:18+08:00	6716	2122	8838	739	9577	21564	44.41%	31.14%	20	20
8	臺南市西港區	2018-11-24T23:50:09+08:00	6716	2122	8838	739	9577	21564	44.41%	31.14%	20	20
8	臺南市西港區	2018-11-24T22:39:03+08:00	6716	2122	8838	739	9577	21564	44.41%	31.14%	20	20
8	臺南市西港區	2018-11-24T23:07:13+08:00	6716	2122	8838	739	9577	21564	44.41%	31.14%	20	20
8	臺南市西港區	2018-11-25T01:00:54+08:00	6716	2122	8838	739	9577	21564	44.41%	31.14%	20	20
8	臺南市西港區	2018-11-24T22:32:13+08:00	6716	2122	8838	739	9577	21564	44.41%	31.14%	20	20
8	臺南市西港區	2018-11-25T03:48:23+08:00	6716	2122	8838	739	9577	21564	44.41%	31.14%	20	20
8	臺南市西港區	2018-11-24T23:00:09+08:00	6716	2122	8838	739	9577	21564	44.41%	31.14%	20	20
8	臺南市西港區	2018-11-25T00:21:38+08:00	6716	2122	8838	739	9577	21564	44.41%	31.14%	20	20
8	臺南市西港區	2018-11-25T03:30:52+08:00	6716	2122	8838	739	9577	21564	44.41%	31.14%	20	20
8	臺南市西港區	2018-11-24T22:53:08+08:00	6716	2122	8838	739	9577	21564	44.41%	31.14%	20	20
8	臺南市西港區	2018-11-25T06:07:17+08:00	6716	2122	8838	739	9577	21564	44.41%	31.14%	20	20
8	臺南市西港區	2018-11-24T22:11:57+08:00	6716	2122	8838	739	9577	21564	44.41%	31.14%	20	20
8	臺南市西港區	2018-11-24T22:40:14+08:00	6716	2122	8838	739	9577	21564	44.41%	31.14%	20	20
8	臺南市西港區	2018-11-25T04:01:23+08:00	6716	2122	8838	739	9577	21564	44.41%	31.14%	20	20
8	臺南市西港區	2018-11-24T22:21:40+08:00	6716	2122	8838	739	9577	21564	44.41%	31.14%	20	20
8	臺南市西港區	2018-11-24T23:41:57+08:00	6716	2122	8838	739	9577	21564	44.41%	31.14%	20	20
8	臺南市西港區	2018-11-24T23:33:44+08:00	6716	2122	8838	739	9577	21564	44.41%	31.14%	20	20
8	臺南市西港區	2018-11-25T03:54:34+08:00	6716	2122	8838	739	9577	21564	44.41%	31.14%	20	20
8	臺南市西港區	2018-11-25T01:16:16+08:00	6716	2122	8838	739	9577	21564	44.41%	31.14%	20	20
8	臺南市西港區	2018-11-24T23:45:58+08:00	6716	2122	8838	739	9577	21564	44.41%	31.14%	20	20
8	臺南市西港區	2018-11-24T22:35:40+08:00	6716	2122	8838	739	9577	21564	44.41%	31.14%	20	20
8	臺南市西港區	2018-11-24T23:37:44+08:00	6716	2122	8838	739	9577	21564	44.41%	31.14%	20	20
8	屏東縣來義鄉	2018-11-24T23:07:20+08:00	1786	407	2193	208	2401	4128	58.16%	43.27%	7	9
8	屏東縣來義鄉	2018-11-24T23:10:57+08:00	1786	407	2193	208	2401	4128	58.16%	43.27%	7	9
8	屏東縣來義鄉	2018-11-24T22:14:50+08:00	1091	213	1304	117	1421	2399	59.23%	45.48%	5	9
8	屏東縣來義鄉	2018-11-25T06:17:37+08:00	2576	642	3218	349	3567	6257	57.01%	41.17%	9	9
8	屏東縣來義鄉	2018-11-24T22:56:37+08:00	1091	213	1304	117	1421	2399	59.23%	45.48%	5	9
8	屏東縣來義鄉	2018-11-24T22:32:19+08:00	1091	213	1304	117	1421	2399	59.23%	45.48%	5	9
8	屏東縣來義鄉	2018-11-25T01:06:01+08:00	2576	642	3218	349	3567	6257	57.01%	41.17%	9	9
8	屏東縣來義鄉	2018-11-24T22:53:16+08:00	1091	213	1304	117	1421	2399	59.23%	45.48%	5	9
8	屏東縣來義鄉	2018-11-25T00:08:06+08:00	2190	484	2674	316	2990	5045	59.27%	43.41%	8	9
8	屏東縣來義鄉	2018-11-24T22:25:26+08:00	1091	213	1304	117	1421	2399	59.23%	45.48%	5	9
8	屏東縣來義鄉	2018-11-24T23:29:48+08:00	1786	407	2193	208	2401	4128	58.16%	43.27%	7	9
8	屏東縣來義鄉	2018-11-24T22:40:20+08:00	1091	213	1304	117	1421	2399	59.23%	45.48%	5	9
8	屏東縣來義鄉	2018-11-25T06:22:46+08:00	2576	642	3218	349	3567	6257	57.01%	41.17%	9	9
8	屏東縣來義鄉	2018-11-25T06:07:24+08:00	2576	642	3218	349	3567	6257	57.01%	41.17%	9	9
8	屏東縣來義鄉	2018-11-24T23:00:18+08:00	1091	213	1304	117	1421	2399	59.23%	45.48%	5	9
8	屏東縣來義鄉	2018-11-25T03:48:32+08:00	2576	642	3218	349	3567	6257	57.01%	41.17%	9	9
8	屏東縣來義鄉	2018-11-25T03:42:50+08:00	2576	642	3218	349	3567	6257	57.01%	41.17%	9	9
8	屏東縣來義鄉	2018-11-25T00:21:45+08:00	2190	484	2674	316	2990	5045	59.27%	43.41%	8	9
8	屏東縣來義鄉	2018-11-25T01:11:09+08:00	2576	642	3218	349	3567	6257	57.01%	41.17%	9	9
8	屏東縣來義鄉	2018-11-25T01:16:23+08:00	2576	642	3218	349	3567	6257	57.01%	41.17%	9	9
8	屏東縣來義鄉	2018-11-25T03:31:01+08:00	2576	642	3218	349	3567	6257	57.01%	41.17%	9	9
8	屏東縣來義鄉	2018-11-24T23:14:42+08:00	1786	407	2193	208	2401	4128	58.16%	43.27%	7	9
8	屏東縣來義鄉	2018-11-24T23:50:16+08:00	1786	407	2193	208	2401	4128	58.16%	43.27%	7	9
8	屏東縣來義鄉	2018-11-24T22:43:51+08:00	1091	213	1304	117	1421	2399	59.23%	45.48%	5	9
8	屏東縣來義鄉	2018-11-25T06:27:56+08:00	2576	642	3218	349	3567	6257	57.01%	41.17%	9	9
8	屏東縣來義鄉	2018-11-25T00:56:15+08:00	2576	642	3218	349	3567	6257	57.01%	41.17%	9	9
8	屏東縣來義鄉	2018-11-25T00:12:46+08:00	2190	484	2674	316	2990	5045	59.27%	43.41%	8	9
8	屏東縣來義鄉	2018-11-24T23:54:28+08:00	1786	407	2193	208	2401	4128	58.16%	43.27%	7	9
8	屏東縣來義鄉	2018-11-24T23:37:50+08:00	1786	407	2193	208	2401	4128	58.16%	43.27%	7	9
8	屏東縣來義鄉	2018-11-24T23:22:24+08:00	1786	407	2193	208	2401	4128	58.16%	43.27%	7	9
8	屏東縣來義鄉	2018-11-24T22:28:41+08:00	1091	213	1304	117	1421	2399	59.23%	45.48%	5	9
8	屏東縣來義鄉	2018-11-24T22:12:04+08:00	1091	213	1304	117	1421	2399	59.23%	45.48%	5	9
8	屏東縣來義鄉	2018-11-24T23:33:51+08:00	1786	407	2193	208	2401	4128	58.16%	43.27%	7	9
8	屏東縣來義鄉	2018-11-25T01:24:26+08:00	2576	642	3218	349	3567	6257	57.01%	41.17%	9	9
8	屏東縣來義鄉	2018-11-25T03:54:42+08:00	2576	642	3218	349	3567	6257	57.01%	41.17%	9	9
8	屏東縣來義鄉	2018-11-24T23:03:48+08:00	1393	311	1704	138	1842	3288	56.02%	42.37%	6	9
8	屏東縣來義鄉	2018-11-24T22:49:25+08:00	1091	213	1304	117	1421	2399	59.23%	45.48%	5	9
8	屏東縣來義鄉	2018-11-24T23:42:03+08:00	1786	407	2193	208	2401	4128	58.16%	43.27%	7	9
8	屏東縣來義鄉	2018-11-25T04:01:30+08:00	2576	642	3218	349	3567	6257	57.01%	41.17%	9	9
8	屏東縣來義鄉	2018-11-24T23:46:05+08:00	1786	407	2193	208	2401	4128	58.16%	43.27%	7	9
8	屏東縣來義鄉	2018-11-25T00:17:09+08:00	2190	484	2674	316	2990	5045	59.27%	43.41%	8	9
8	屏東縣來義鄉	2018-11-25T06:12:38+08:00	2576	642	3218	349	3567	6257	57.01%	41.17%	9	9
8	屏東縣來義鄉	2018-11-24T22:21:47+08:00	1091	213	1304	117	1421	2399	59.23%	45.48%	5	9
8	屏東縣來義鄉	2018-11-25T01:01:03+08:00	2576	642	3218	349	3567	6257	57.01%	41.17%	9	9
8	屏東縣來義鄉	2018-11-24T22:39:10+08:00	1091	213	1304	117	1421	2399	59.23%	45.48%	5	9
8	屏東縣來義鄉	2018-11-24T23:26:08+08:00	1786	407	2193	208	2401	4128	58.16%	43.27%	7	9
8	屏東縣來義鄉	2018-11-24T22:35:46+08:00	1091	213	1304	117	1421	2399	59.23%	45.48%	5	9
8	屏東縣來義鄉	2018-11-24T23:58:44+08:00	1786	407	2193	208	2401	4128	58.16%	43.27%	7	9
8	屏東縣來義鄉	2018-11-25T00:03:36+08:00	2190	484	2674	316	2990	5045	59.27%	43.41%	8	9
8	屏東縣來義鄉	2018-11-25T03:37:31+08:00	2576	642	3218	349	3567	6257	57.01%	41.17%	9	9
8	屏東縣來義鄉	2018-11-24T22:18:21+08:00	1091	213	1304	117	1421	2399	59.23%	45.48%	5	9
8	屏東縣來義鄉	2018-11-24T23:18:28+08:00	1786	407	2193	208	2401	4128	58.16%	43.27%	7	9
8	臺南市柳營區	2018-11-25T03:37:19+08:00	6048	1944	7992	1015	9007	18804	47.9%	32.16%	25	25
8	臺南市柳營區	2018-11-24T22:49:18+08:00	6048	1944	7992	1015	9007	18804	47.9%	32.16%	25	25
8	臺南市柳營區	2018-11-24T23:14:33+08:00	6048	1944	7992	1015	9007	18804	47.9%	32.16%	25	25
8	臺南市柳營區	2018-11-24T22:56:31+08:00	6048	1944	7992	1015	9007	18804	47.9%	32.16%	25	25
8	臺南市柳營區	2018-11-25T00:12:39+08:00	6048	1944	7992	1015	9007	18804	47.9%	32.16%	25	25
8	臺南市柳營區	2018-11-25T00:03:27+08:00	6048	1944	7992	1015	9007	18804	47.9%	32.16%	25	25
8	臺南市柳營區	2018-11-25T00:56:07+08:00	6048	1944	7992	1015	9007	18804	47.9%	32.16%	25	25
8	臺南市柳營區	2018-11-24T23:03:42+08:00	6048	1944	7992	1015	9007	18804	47.9%	32.16%	25	25
8	臺南市柳營區	2018-11-24T23:10:51+08:00	6048	1944	7992	1015	9007	18804	47.9%	32.16%	25	25
8	臺南市柳營區	2018-11-24T22:43:44+08:00	6048	1944	7992	1015	9007	18804	47.9%	32.16%	25	25
8	臺南市柳營區	2018-11-25T06:17:30+08:00	6048	1944	7992	1015	9007	18804	47.9%	32.16%	25	25
8	臺南市柳營區	2018-11-24T23:22:17+08:00	6048	1944	7992	1015	9007	18804	47.9%	32.16%	25	25
8	臺南市柳營區	2018-11-25T06:22:40+08:00	6048	1944	7992	1015	9007	18804	47.9%	32.16%	25	25
8	臺南市柳營區	2018-11-24T23:29:41+08:00	6048	1944	7992	1015	9007	18804	47.9%	32.16%	25	25
8	臺南市柳營區	2018-11-24T22:25:18+08:00	6048	1944	7992	1015	9007	18804	47.9%	32.16%	25	25
8	臺南市柳營區	2018-11-25T01:11:00+08:00	6048	1944	7992	1015	9007	18804	47.9%	32.16%	25	25
8	臺南市柳營區	2018-11-25T00:17:02+08:00	6048	1944	7992	1015	9007	18804	47.9%	32.16%	25	25
8	臺南市柳營區	2018-11-25T00:07:58+08:00	6048	1944	7992	1015	9007	18804	47.9%	32.16%	25	25
8	臺南市柳營區	2018-11-25T01:16:15+08:00	6048	1944	7992	1015	9007	18804	47.9%	32.16%	25	25
8	臺南市柳營區	2018-11-25T01:05:52+08:00	6048	1944	7992	1015	9007	18804	47.9%	32.16%	25	25
8	臺南市柳營區	2018-11-24T22:14:42+08:00	6048	1944	7992	1015	9007	18804	47.9%	32.16%	25	25
8	臺南市柳營區	2018-11-24T23:54:19+08:00	6048	1944	7992	1015	9007	18804	47.9%	32.16%	25	25
8	臺南市柳營區	2018-11-24T22:28:34+08:00	6048	1944	7992	1015	9007	18804	47.9%	32.16%	25	25
8	臺南市柳營區	2018-11-24T22:18:13+08:00	6048	1944	7992	1015	9007	18804	47.9%	32.16%	25	25
8	臺南市柳營區	2018-11-25T01:24:18+08:00	6048	1944	7992	1015	9007	18804	47.9%	32.16%	25	25
8	臺南市柳營區	2018-11-24T22:35:39+08:00	6048	1944	7992	1015	9007	18804	47.9%	32.16%	25	25
8	臺南市柳營區	2018-11-24T23:50:09+08:00	6048	1944	7992	1015	9007	18804	47.9%	32.16%	25	25
8	臺南市柳營區	2018-11-24T23:58:35+08:00	6048	1944	7992	1015	9007	18804	47.9%	32.16%	25	25
8	臺南市柳營區	2018-11-25T06:27:49+08:00	6048	1944	7992	1015	9007	18804	47.9%	32.16%	25	25
8	臺南市柳營區	2018-11-24T22:39:03+08:00	6048	1944	7992	1015	9007	18804	47.9%	32.16%	25	25
8	臺南市柳營區	2018-11-24T23:07:13+08:00	6048	1944	7992	1015	9007	18804	47.9%	32.16%	25	25
8	臺南市柳營區	2018-11-25T01:00:54+08:00	6048	1944	7992	1015	9007	18804	47.9%	32.16%	25	25
8	臺南市柳營區	2018-11-25T00:21:37+08:00	6048	1944	7992	1015	9007	18804	47.9%	32.16%	25	25
8	臺南市柳營區	2018-11-25T03:48:23+08:00	6048	1944	7992	1015	9007	18804	47.9%	32.16%	25	25
8	臺南市柳營區	2018-11-24T23:00:09+08:00	6048	1944	7992	1015	9007	18804	47.9%	32.16%	25	25
8	臺南市柳營區	2018-11-25T03:30:52+08:00	6048	1944	7992	1015	9007	18804	47.9%	32.16%	25	25
8	臺南市柳營區	2018-11-25T03:42:41+08:00	6048	1944	7992	1015	9007	18804	47.9%	32.16%	25	25
8	臺南市柳營區	2018-11-24T22:21:39+08:00	6048	1944	7992	1015	9007	18804	47.9%	32.16%	25	25
8	臺南市柳營區	2018-11-24T22:32:12+08:00	6048	1944	7992	1015	9007	18804	47.9%	32.16%	25	25
8	臺南市柳營區	2018-11-24T22:53:08+08:00	6048	1944	7992	1015	9007	18804	47.9%	32.16%	25	25
8	臺南市柳營區	2018-11-24T22:11:57+08:00	6048	1944	7992	1015	9007	18804	47.9%	32.16%	25	25
8	臺南市柳營區	2018-11-24T22:40:13+08:00	6048	1944	7992	1015	9007	18804	47.9%	32.16%	25	25
8	臺南市柳營區	2018-11-25T06:12:31+08:00	6048	1944	7992	1015	9007	18804	47.9%	32.16%	25	25
8	臺南市柳營區	2018-11-25T06:07:16+08:00	6048	1944	7992	1015	9007	18804	47.9%	32.16%	25	25
8	臺南市柳營區	2018-11-25T04:01:23+08:00	6048	1944	7992	1015	9007	18804	47.9%	32.16%	25	25
8	臺南市柳營區	2018-11-24T23:33:44+08:00	6048	1944	7992	1015	9007	18804	47.9%	32.16%	25	25
8	臺南市柳營區	2018-11-24T23:26:01+08:00	6048	1944	7992	1015	9007	18804	47.9%	32.16%	25	25
8	臺南市柳營區	2018-11-25T03:54:34+08:00	6048	1944	7992	1015	9007	18804	47.9%	32.16%	25	25
8	臺南市柳營區	2018-11-24T23:45:58+08:00	6048	1944	7992	1015	9007	18804	47.9%	32.16%	25	25
8	臺南市柳營區	2018-11-24T23:41:56+08:00	6048	1944	7992	1015	9007	18804	47.9%	32.16%	25	25
8	臺南市柳營區	2018-11-24T23:37:43+08:00	6048	1944	7992	1015	9007	18804	47.9%	32.16%	25	25
8	臺南市柳營區	2018-11-24T23:18:21+08:00	6048	1944	7992	1015	9007	18804	47.9%	32.16%	25	25
8	屏東縣南州鄉	2018-11-24T23:10:57+08:00	3279	1098	4377	555	4932	9479	52.03%	34.59%	11	11
8	屏東縣南州鄉	2018-11-24T23:07:19+08:00	3279	1098	4377	555	4932	9479	52.03%	34.59%	11	11
8	屏東縣南州鄉	2018-11-24T22:14:50+08:00	2535	829	3364	421	3785	7473	50.65%	33.92%	9	11
8	屏東縣南州鄉	2018-11-25T06:17:37+08:00	3279	1098	4377	555	4932	9479	52.03%	34.59%	11	11
8	屏東縣南州鄉	2018-11-24T22:56:37+08:00	3279	1098	4377	555	4932	9479	52.03%	34.59%	11	11
8	屏東縣南州鄉	2018-11-24T22:32:19+08:00	2918	964	3882	494	4376	8517	51.38%	34.26%	10	11
8	屏東縣南州鄉	2018-11-25T01:06:01+08:00	3279	1098	4377	555	4932	9479	52.03%	34.59%	11	11
8	屏東縣南州鄉	2018-11-24T22:53:16+08:00	3279	1098	4377	555	4932	9479	52.03%	34.59%	11	11
8	屏東縣南州鄉	2018-11-25T00:08:06+08:00	3279	1098	4377	555	4932	9479	52.03%	34.59%	11	11
8	屏東縣南州鄉	2018-11-24T22:25:26+08:00	2918	964	3882	494	4376	8517	51.38%	34.26%	10	11
8	屏東縣南州鄉	2018-11-25T01:11:08+08:00	3279	1098	4377	555	4932	9479	52.03%	34.59%	11	11
8	屏東縣南州鄉	2018-11-25T06:07:24+08:00	3279	1098	4377	555	4932	9479	52.03%	34.59%	11	11
8	屏東縣南州鄉	2018-11-24T23:00:18+08:00	3279	1098	4377	555	4932	9479	52.03%	34.59%	11	11
8	屏東縣南州鄉	2018-11-25T03:48:32+08:00	3279	1098	4377	555	4932	9479	52.03%	34.59%	11	11
8	屏東縣南州鄉	2018-11-24T22:40:19+08:00	2918	964	3882	494	4376	8517	51.38%	34.26%	10	11
8	屏東縣南州鄉	2018-11-24T23:29:47+08:00	3279	1098	4377	555	4932	9479	52.03%	34.59%	11	11
8	屏東縣南州鄉	2018-11-25T00:21:45+08:00	3279	1098	4377	555	4932	9479	52.03%	34.59%	11	11
8	屏東縣南州鄉	2018-11-25T03:31:00+08:00	3279	1098	4377	555	4932	9479	52.03%	34.59%	11	11
8	屏東縣南州鄉	2018-11-25T01:16:23+08:00	3279	1098	4377	555	4932	9479	52.03%	34.59%	11	11
8	屏東縣南州鄉	2018-11-25T00:56:14+08:00	3279	1098	4377	555	4932	9479	52.03%	34.59%	11	11
8	屏東縣南州鄉	2018-11-24T22:35:45+08:00	2918	964	3882	494	4376	8517	51.38%	34.26%	10	11
8	屏東縣南州鄉	2018-11-24T23:14:42+08:00	3279	1098	4377	555	4932	9479	52.03%	34.59%	11	11
8	屏東縣南州鄉	2018-11-24T23:50:16+08:00	3279	1098	4377	555	4932	9479	52.03%	34.59%	11	11
8	屏東縣南州鄉	2018-11-24T23:37:49+08:00	3279	1098	4377	555	4932	9479	52.03%	34.59%	11	11
8	屏東縣南州鄉	2018-11-24T22:43:51+08:00	2918	964	3882	494	4376	8517	51.38%	34.26%	10	11
8	屏東縣南州鄉	2018-11-25T06:27:56+08:00	3279	1098	4377	555	4932	9479	52.03%	34.59%	11	11
8	屏東縣南州鄉	2018-11-25T00:12:46+08:00	3279	1098	4377	555	4932	9479	52.03%	34.59%	11	11
8	屏東縣南州鄉	2018-11-24T23:54:28+08:00	3279	1098	4377	555	4932	9479	52.03%	34.59%	11	11
8	屏東縣南州鄉	2018-11-24T23:22:24+08:00	3279	1098	4377	555	4932	9479	52.03%	34.59%	11	11
8	屏東縣南州鄉	2018-11-24T22:28:41+08:00	2918	964	3882	494	4376	8517	51.38%	34.26%	10	11
8	屏東縣南州鄉	2018-11-24T22:12:03+08:00	2535	829	3364	421	3785	7473	50.65%	33.92%	9	11
8	屏東縣南州鄉	2018-11-24T23:33:51+08:00	3279	1098	4377	555	4932	9479	52.03%	34.59%	11	11
8	屏東縣南州鄉	2018-11-25T01:24:26+08:00	3279	1098	4377	555	4932	9479	52.03%	34.59%	11	11
8	屏東縣南州鄉	2018-11-25T03:54:42+08:00	3279	1098	4377	555	4932	9479	52.03%	34.59%	11	11
8	屏東縣南州鄉	2018-11-24T23:03:48+08:00	3279	1098	4377	555	4932	9479	52.03%	34.59%	11	11
8	屏東縣南州鄉	2018-11-24T22:49:25+08:00	3279	1098	4377	555	4932	9479	52.03%	34.59%	11	11
8	屏東縣南州鄉	2018-11-25T04:01:30+08:00	3279	1098	4377	555	4932	9479	52.03%	34.59%	11	11
8	屏東縣南州鄉	2018-11-25T03:42:49+08:00	3279	1098	4377	555	4932	9479	52.03%	34.59%	11	11
8	屏東縣南州鄉	2018-11-24T23:42:02+08:00	3279	1098	4377	555	4932	9479	52.03%	34.59%	11	11
8	屏東縣南州鄉	2018-11-24T23:46:04+08:00	3279	1098	4377	555	4932	9479	52.03%	34.59%	11	11
8	屏東縣南州鄉	2018-11-25T00:17:09+08:00	3279	1098	4377	555	4932	9479	52.03%	34.59%	11	11
8	屏東縣南州鄉	2018-11-25T06:12:37+08:00	3279	1098	4377	555	4932	9479	52.03%	34.59%	11	11
8	屏東縣南州鄉	2018-11-25T06:22:45+08:00	3279	1098	4377	555	4932	9479	52.03%	34.59%	11	11
8	屏東縣南州鄉	2018-11-24T22:21:47+08:00	2918	964	3882	494	4376	8517	51.38%	34.26%	10	11
8	屏東縣南州鄉	2018-11-24T22:39:10+08:00	2918	964	3882	494	4376	8517	51.38%	34.26%	10	11
8	屏東縣南州鄉	2018-11-24T23:26:08+08:00	3279	1098	4377	555	4932	9479	52.03%	34.59%	11	11
8	屏東縣南州鄉	2018-11-24T22:18:20+08:00	2535	829	3364	421	3785	7473	50.65%	33.92%	9	11
8	屏東縣南州鄉	2018-11-25T03:37:30+08:00	3279	1098	4377	555	4932	9479	52.03%	34.59%	11	11
8	屏東縣南州鄉	2018-11-24T23:58:43+08:00	3279	1098	4377	555	4932	9479	52.03%	34.59%	11	11
8	屏東縣南州鄉	2018-11-25T00:03:36+08:00	3279	1098	4377	555	4932	9479	52.03%	34.59%	11	11
8	屏東縣南州鄉	2018-11-25T01:01:02+08:00	3279	1098	4377	555	4932	9479	52.03%	34.59%	11	11
8	屏東縣南州鄉	2018-11-24T23:18:28+08:00	3279	1098	4377	555	4932	9479	52.03%	34.59%	11	11
8	基隆市中正區	2018-11-24T23:10:59+08:00	11017	3094	14111	1135	15246	32378	47.09%	34.03%	28	35
8	基隆市中正區	2018-11-24T22:49:27+08:00	10427	2896	13323	1049	14372	30625	46.93%	34.05%	27	35
8	基隆市中正區	2018-11-24T23:22:27+08:00	11360	3240	14600	1201	15801	33549	47.1%	33.86%	29	35
8	基隆市中正區	2018-11-24T23:18:31+08:00	11017	3094	14111	1135	15246	32378	47.09%	34.03%	28	35
8	基隆市中正區	2018-11-24T23:33:54+08:00	11711	3371	15082	1259	16341	34586	47.25%	33.86%	30	35
8	基隆市中正區	2018-11-24T22:12:06+08:00	8316	2354	10670	900	11570	24457	47.31%	34%	22	35
8	基隆市中正區	2018-11-24T23:26:11+08:00	11360	3240	14600	1201	15801	33549	47.1%	33.86%	29	35
8	基隆市中正區	2018-11-24T22:56:39+08:00	11017	3094	14111	1135	15246	32378	47.09%	34.03%	28	35
8	基隆市中正區	2018-11-24T22:28:44+08:00	9914	2785	12699	1030	13729	29212	47%	33.94%	26	35
8	基隆市中正區	2018-11-24T23:37:52+08:00	12273	3488	15761	1330	17091	36131	47.3%	33.97%	31	35
8	基隆市中正區	2018-11-24T22:53:19+08:00	11017	3094	14111	1135	15246	32378	47.09%	34.03%	28	35
8	基隆市中正區	2018-11-24T22:21:50+08:00	9914	2785	12699	1030	13729	29212	47%	33.94%	26	35
8	基隆市中正區	2018-11-25T04:01:33+08:00	15275	4267	19542	1538	21080	45545	46.28%	33.54%	35	35
8	基隆市中正區	2018-11-24T23:46:07+08:00	12273	3488	15761	1330	17091	36131	47.3%	33.97%	31	35
8	基隆市中正區	2018-11-25T01:11:12+08:00	15275	4267	19542	1538	21080	45545	46.28%	33.54%	35	35
8	基隆市中正區	2018-11-25T00:08:08+08:00	13119	3667	16786	1360	18146	38954	46.58%	33.68%	32	35
8	基隆市中正區	2018-11-24T23:00:20+08:00	11017	3094	14111	1135	15246	32378	47.09%	34.03%	28	35
8	基隆市中正區	2018-11-24T22:25:29+08:00	9914	2785	12699	1030	13729	29212	47%	33.94%	26	35
8	基隆市中正區	2018-11-25T06:22:48+08:00	15275	4267	19542	1538	21080	45545	46.28%	33.54%	35	35
8	基隆市中正區	2018-11-25T03:48:35+08:00	15275	4267	19542	1538	21080	45545	46.28%	33.54%	35	35
8	基隆市中正區	2018-11-25T06:27:59+08:00	15275	4267	19542	1538	21080	45545	46.28%	33.54%	35	35
8	基隆市中正區	2018-11-25T06:17:41+08:00	15275	4267	19542	1538	21080	45545	46.28%	33.54%	35	35
8	基隆市中正區	2018-11-24T22:39:13+08:00	10427	2896	13323	1049	14372	30625	46.93%	34.05%	27	35
8	基隆市中正區	2018-11-25T00:12:49+08:00	13119	3667	16786	1360	18146	38954	46.58%	33.68%	32	35
8	基隆市中正區	2018-11-25T03:37:33+08:00	15275	4267	19542	1538	21080	45545	46.28%	33.54%	35	35
8	基隆市中正區	2018-11-24T22:18:23+08:00	8688	2480	11168	925	12093	25719	47.02%	33.78%	23	35
8	基隆市中正區	2018-11-24T23:50:18+08:00	12273	3488	15761	1330	17091	36131	47.3%	33.97%	31	35
8	基隆市中正區	2018-11-24T23:14:45+08:00	11017	3094	14111	1135	15246	32378	47.09%	34.03%	28	35
8	基隆市中正區	2018-11-24T23:58:46+08:00	12273	3488	15761	1330	17091	36131	47.3%	33.97%	31	35
8	基隆市中正區	2018-11-24T23:03:50+08:00	11017	3094	14111	1135	15246	32378	47.09%	34.03%	28	35
8	基隆市中正區	2018-11-25T01:01:06+08:00	15275	4267	19542	1538	21080	45545	46.28%	33.54%	35	35
8	基隆市中正區	2018-11-25T01:24:29+08:00	15275	4267	19542	1538	21080	45545	46.28%	33.54%	35	35
8	基隆市中正區	2018-11-24T23:54:31+08:00	12273	3488	15761	1330	17091	36131	47.3%	33.97%	31	35
8	基隆市中正區	2018-11-25T03:54:45+08:00	15275	4267	19542	1538	21080	45545	46.28%	33.54%	35	35
8	基隆市中正區	2018-11-24T23:07:22+08:00	11017	3094	14111	1135	15246	32378	47.09%	34.03%	28	35
8	基隆市中正區	2018-11-24T22:14:53+08:00	8316	2354	10670	900	11570	24457	47.31%	34%	22	35
8	基隆市中正區	2018-11-25T06:12:40+08:00	15275	4267	19542	1538	21080	45545	46.28%	33.54%	35	35
8	基隆市中正區	2018-11-24T23:29:50+08:00	11711	3371	15082	1259	16341	34586	47.25%	33.86%	30	35
8	基隆市中正區	2018-11-25T00:17:12+08:00	13119	3667	16786	1360	18146	38954	46.58%	33.68%	32	35
8	基隆市中正區	2018-11-24T22:32:22+08:00	9914	2785	12699	1030	13729	29212	47%	33.94%	26	35
8	基隆市中正區	2018-11-24T23:42:05+08:00	12273	3488	15761	1330	17091	36131	47.3%	33.97%	31	35
8	基隆市中正區	2018-11-25T01:06:04+08:00	15275	4267	19542	1538	21080	45545	46.28%	33.54%	35	35
8	基隆市中正區	2018-11-25T00:21:47+08:00	14002	3880	17882	1408	19290	41619	46.35%	33.64%	33	35
8	基隆市中正區	2018-11-25T03:42:52+08:00	15275	4267	19542	1538	21080	45545	46.28%	33.54%	35	35
8	基隆市中正區	2018-11-25T06:07:26+08:00	15275	4267	19542	1538	21080	45545	46.28%	33.54%	35	35
8	基隆市中正區	2018-11-24T22:40:22+08:00	10427	2896	13323	1049	14372	30625	46.93%	34.05%	27	35
8	基隆市中正區	2018-11-25T00:56:17+08:00	15275	4267	19542	1538	21080	45545	46.28%	33.54%	35	35
8	基隆市中正區	2018-11-24T22:35:48+08:00	10427	2896	13323	1049	14372	30625	46.93%	34.05%	27	35
8	基隆市中正區	2018-11-24T22:43:54+08:00	10427	2896	13323	1049	14372	30625	46.93%	34.05%	27	35
8	基隆市中正區	2018-11-25T03:31:03+08:00	15275	4267	19542	1538	21080	45545	46.28%	33.54%	35	35
8	基隆市中正區	2018-11-25T01:16:26+08:00	15275	4267	19542	1538	21080	45545	46.28%	33.54%	35	35
8	基隆市中正區	2018-11-25T00:03:39+08:00	13119	3667	16786	1360	18146	38954	46.58%	33.68%	32	35
8	新竹縣尖石鄉	2018-11-24T22:12:00+08:00	797	213	1010	78	1088	2392	45.48%	33.32%	7	15
8	新竹縣尖石鄉	2018-11-24T22:39:06+08:00	1192	317	1509	102	1611	3950	40.78%	30.18%	9	15
8	新竹縣尖石鄉	2018-11-24T23:03:44+08:00	1694	482	2176	131	2307	5592	41.26%	30.29%	12	15
8	新竹縣尖石鄉	2018-11-24T23:22:20+08:00	1694	482	2176	131	2307	5592	41.26%	30.29%	12	15
8	新竹縣尖石鄉	2018-11-24T23:58:39+08:00	2066	609	2675	196	2871	6704	42.83%	30.82%	14	15
8	新竹縣尖石鄉	2018-11-24T22:49:21+08:00	1562	438	2000	122	2122	5118	41.46%	30.52%	11	15
8	新竹縣尖石鄉	2018-11-24T23:46:01+08:00	2066	609	2675	196	2871	6704	42.83%	30.82%	14	15
8	新竹縣尖石鄉	2018-11-25T03:48:26+08:00	2272	655	2927	202	3129	7364	42.49%	30.85%	15	15
8	新竹縣尖石鄉	2018-11-25T03:30:56+08:00	2272	655	2927	202	3129	7364	42.49%	30.85%	15	15
8	新竹縣尖石鄉	2018-11-25T03:42:45+08:00	2272	655	2927	202	3129	7364	42.49%	30.85%	15	15
8	新竹縣尖石鄉	2018-11-25T01:00:58+08:00	2272	655	2927	202	3129	7364	42.49%	30.85%	15	15
8	新竹縣尖石鄉	2018-11-25T00:08:01+08:00	2272	655	2927	202	3129	7364	42.49%	30.85%	15	15
8	新竹縣尖石鄉	2018-11-25T04:01:26+08:00	2272	655	2927	202	3129	7364	42.49%	30.85%	15	15
8	新竹縣尖石鄉	2018-11-24T22:25:21+08:00	1049	258	1307	86	1393	3165	44.01%	33.14%	8	15
8	新竹縣尖石鄉	2018-11-25T06:12:34+08:00	2272	655	2927	202	3129	7364	42.49%	30.85%	15	15
8	新竹縣尖石鄉	2018-11-24T22:40:16+08:00	1192	317	1509	102	1611	3950	40.78%	30.18%	9	15
8	新竹縣尖石鄉	2018-11-24T22:21:43+08:00	1049	258	1307	86	1393	3165	44.01%	33.14%	8	15
8	新竹縣尖石鄉	2018-11-25T00:17:05+08:00	2272	655	2927	202	3129	7364	42.49%	30.85%	15	15
8	新竹縣尖石鄉	2018-11-24T23:18:24+08:00	1694	482	2176	131	2307	5592	41.26%	30.29%	12	15
8	新竹縣尖石鄉	2018-11-24T23:37:46+08:00	2066	609	2675	196	2871	6704	42.83%	30.82%	14	15
8	新竹縣尖石鄉	2018-11-24T22:35:42+08:00	1192	317	1509	102	1611	3950	40.78%	30.18%	9	15
8	新竹縣尖石鄉	2018-11-25T03:54:37+08:00	2272	655	2927	202	3129	7364	42.49%	30.85%	15	15
8	新竹縣尖石鄉	2018-11-24T23:33:47+08:00	2066	609	2675	196	2871	6704	42.83%	30.82%	14	15
8	新竹縣尖石鄉	2018-11-24T23:26:04+08:00	1935	582	2517	190	2707	6205	43.63%	31.18%	13	15
8	新竹縣尖石鄉	2018-11-24T23:07:15+08:00	1694	482	2176	131	2307	5592	41.26%	30.29%	12	15
8	新竹縣尖石鄉	2018-11-24T23:14:37+08:00	1694	482	2176	131	2307	5592	41.26%	30.29%	12	15
8	新竹縣尖石鄉	2018-11-24T23:10:53+08:00	1694	482	2176	131	2307	5592	41.26%	30.29%	12	15
8	新竹縣尖石鄉	2018-11-25T06:17:33+08:00	2272	655	2927	202	3129	7364	42.49%	30.85%	15	15
8	新竹縣尖石鄉	2018-11-24T22:43:47+08:00	1379	382	1761	104	1865	4543	41.05%	30.35%	10	15
8	新竹縣尖石鄉	2018-11-25T01:24:21+08:00	2272	655	2927	202	3129	7364	42.49%	30.85%	15	15
8	新竹縣尖石鄉	2018-11-24T22:56:34+08:00	1562	438	2000	122	2122	5118	41.46%	30.52%	11	15
8	新竹縣尖石鄉	2018-11-25T03:37:24+08:00	2272	655	2927	202	3129	7364	42.49%	30.85%	15	15
8	新竹縣尖石鄉	2018-11-24T22:53:12+08:00	1562	438	2000	122	2122	5118	41.46%	30.52%	11	15
8	新竹縣尖石鄉	2018-11-24T22:32:15+08:00	1192	317	1509	102	1611	3950	40.78%	30.18%	9	15
8	新竹縣尖石鄉	2018-11-24T23:00:14+08:00	1562	438	2000	122	2122	5118	41.46%	30.52%	11	15
8	新竹縣尖石鄉	2018-11-25T01:11:03+08:00	2272	655	2927	202	3129	7364	42.49%	30.85%	15	15
8	新竹縣尖石鄉	2018-11-24T23:29:43+08:00	2066	609	2675	196	2871	6704	42.83%	30.82%	14	15
8	新竹縣尖石鄉	2018-11-25T00:21:41+08:00	2272	655	2927	202	3129	7364	42.49%	30.85%	15	15
8	新竹縣尖石鄉	2018-11-25T06:22:42+08:00	2272	655	2927	202	3129	7364	42.49%	30.85%	15	15
8	新竹縣尖石鄉	2018-11-25T06:07:20+08:00	2272	655	2927	202	3129	7364	42.49%	30.85%	15	15
8	新竹縣尖石鄉	2018-11-25T01:05:56+08:00	2272	655	2927	202	3129	7364	42.49%	30.85%	15	15
8	新竹縣尖石鄉	2018-11-24T23:54:24+08:00	2066	609	2675	196	2871	6704	42.83%	30.82%	14	15
8	新竹縣尖石鄉	2018-11-24T23:41:59+08:00	2066	609	2675	196	2871	6704	42.83%	30.82%	14	15
8	新竹縣尖石鄉	2018-11-25T01:16:18+08:00	2272	655	2927	202	3129	7364	42.49%	30.85%	15	15
8	新竹縣尖石鄉	2018-11-25T00:03:31+08:00	2272	655	2927	202	3129	7364	42.49%	30.85%	15	15
8	新竹縣尖石鄉	2018-11-24T22:14:46+08:00	797	213	1010	78	1088	2392	45.48%	33.32%	7	15
8	新竹縣尖石鄉	2018-11-25T06:27:52+08:00	2272	655	2927	202	3129	7364	42.49%	30.85%	15	15
8	新竹縣尖石鄉	2018-11-25T00:56:11+08:00	2272	655	2927	202	3129	7364	42.49%	30.85%	15	15
8	新竹縣尖石鄉	2018-11-24T22:18:17+08:00	1049	258	1307	86	1393	3165	44.01%	33.14%	8	15
8	新竹縣尖石鄉	2018-11-25T00:12:42+08:00	2272	655	2927	202	3129	7364	42.49%	30.85%	15	15
8	新竹縣尖石鄉	2018-11-24T22:28:37+08:00	1049	258	1307	86	1393	3165	44.01%	33.14%	8	15
8	新竹縣尖石鄉	2018-11-24T23:50:12+08:00	2066	609	2675	196	2871	6704	42.83%	30.82%	14	15
8	新竹縣竹東鎮	2018-11-24T22:39:06+08:00	17638	4804	22442	1458	23900	44789	53.36%	39.38%	45	72
8	新竹縣竹東鎮	2018-11-24T23:03:44+08:00	23664	6406	30070	1976	32046	60049	53.37%	39.41%	57	72
8	新竹縣竹東鎮	2018-11-24T23:22:20+08:00	26073	7061	33134	2133	35267	66099	53.35%	39.45%	62	72
8	新竹縣竹東鎮	2018-11-24T23:58:39+08:00	28549	7694	36243	2355	38598	72270	53.41%	39.5%	67	72
8	新竹縣竹東鎮	2018-11-24T22:49:21+08:00	20814	5676	26490	1711	28201	52967	53.24%	39.3%	51	72
8	新竹縣竹東鎮	2018-11-25T03:42:44+08:00	31275	8381	39656	2551	42207	78794	53.57%	39.69%	72	72
8	新竹縣竹東鎮	2018-11-24T23:46:01+08:00	28181	7578	35759	2313	38072	71395	53.33%	39.47%	66	72
8	新竹縣竹東鎮	2018-11-25T01:00:57+08:00	30616	8229	38845	2500	41345	77246	53.52%	39.63%	71	72
8	新竹縣竹東鎮	2018-11-25T03:48:26+08:00	31275	8381	39656	2551	42207	78794	53.57%	39.69%	72	72
8	新竹縣竹東鎮	2018-11-24T22:53:11+08:00	21379	5814	27193	1758	28951	54297	53.32%	39.37%	52	72
8	新竹縣竹東鎮	2018-11-25T00:08:01+08:00	29040	7823	36863	2391	39254	73615	53.32%	39.45%	68	72
8	新竹縣竹東鎮	2018-11-24T22:21:42+08:00	14941	4040	18981	1222	20203	37993	53.18%	39.33%	39	72
8	新竹縣竹東鎮	2018-11-25T04:01:26+08:00	31275	8381	39656	2551	42207	78794	53.57%	39.69%	72	72
8	新竹縣竹東鎮	2018-11-25T06:12:34+08:00	31275	8381	39656	2551	42207	78794	53.57%	39.69%	72	72
8	新竹縣竹東鎮	2018-11-24T22:40:16+08:00	18702	5119	23821	1520	25341	47654	53.18%	39.25%	47	72
8	新竹縣竹東鎮	2018-11-24T22:25:20+08:00	15435	4195	19630	1267	20897	39208	53.3%	39.37%	40	72
8	新竹縣竹東鎮	2018-11-25T00:17:05+08:00	29484	7922	37406	2429	39835	74681	53.34%	39.48%	69	72
8	新竹縣竹東鎮	2018-11-24T23:18:24+08:00	25224	6785	32009	2065	34074	63711	53.48%	39.59%	60	72
8	新竹縣竹東鎮	2018-11-24T23:37:46+08:00	27716	7459	35175	2271	37446	70255	53.3%	39.45%	65	72
8	新竹縣竹東鎮	2018-11-24T22:35:42+08:00	16955	4576	21531	1385	22916	43118	53.15%	39.32%	43	72
8	新竹縣竹東鎮	2018-11-25T03:54:37+08:00	31275	8381	39656	2551	42207	78794	53.57%	39.69%	72	72
8	新竹縣竹東鎮	2018-11-24T23:33:47+08:00	26554	7162	33716	2169	35885	67345	53.29%	39.43%	63	72
8	新竹縣竹東鎮	2018-11-25T01:05:55+08:00	30616	8229	38845	2500	41345	77246	53.52%	39.63%	71	72
8	新竹縣竹東鎮	2018-11-24T23:26:04+08:00	26073	7061	33134	2133	35267	66099	53.35%	39.45%	62	72
8	新竹縣竹東鎮	2018-11-24T22:14:45+08:00	12892	3494	16386	1062	17448	32846	53.12%	39.25%	34	72
8	新竹縣竹東鎮	2018-11-25T06:17:32+08:00	31275	8381	39656	2551	42207	78794	53.57%	39.69%	72	72
8	新竹縣竹東鎮	2018-11-25T03:37:22+08:00	31275	8381	39656	2551	42207	78794	53.57%	39.69%	72	72
8	新竹縣竹東鎮	2018-11-24T23:07:15+08:00	24195	6516	30711	1993	32704	61324	53.33%	39.45%	58	72
8	新竹縣竹東鎮	2018-11-24T23:10:53+08:00	24779	6646	31425	2028	33453	62628	53.42%	39.57%	59	72
8	新竹縣竹東鎮	2018-11-24T22:43:47+08:00	19770	5405	25175	1640	26815	50392	53.21%	39.23%	49	72
8	新竹縣竹東鎮	2018-11-24T22:56:33+08:00	21815	5925	27740	1811	29551	55330	53.41%	39.43%	53	72
8	新竹縣竹東鎮	2018-11-25T01:24:21+08:00	30616	8229	38845	2500	41345	77246	53.52%	39.63%	71	72
8	新竹縣竹東鎮	2018-11-24T23:14:36+08:00	25224	6785	32009	2065	34074	63711	53.48%	39.59%	60	72
8	新竹縣竹東鎮	2018-11-25T03:30:55+08:00	31275	8381	39656	2551	42207	78794	53.57%	39.69%	72	72
8	新竹縣竹東鎮	2018-11-24T22:32:15+08:00	15882	4310	20192	1295	21487	40440	53.13%	39.27%	41	72
8	新竹縣竹東鎮	2018-11-24T22:11:59+08:00	12892	3494	16386	1062	17448	32846	53.12%	39.25%	34	72
8	新竹縣竹東鎮	2018-11-24T23:00:14+08:00	22694	6163	28857	1886	30743	57505	53.46%	39.46%	55	72
8	新竹縣竹東鎮	2018-11-25T06:07:19+08:00	31275	8381	39656	2551	42207	78794	53.57%	39.69%	72	72
8	新竹縣竹東鎮	2018-11-25T01:11:03+08:00	30616	8229	38845	2500	41345	77246	53.52%	39.63%	71	72
8	新竹縣竹東鎮	2018-11-24T23:29:43+08:00	26554	7162	33716	2169	35885	67345	53.29%	39.43%	63	72
8	新竹縣竹東鎮	2018-11-25T00:21:41+08:00	29484	7922	37406	2429	39835	74681	53.34%	39.48%	69	72
8	新竹縣竹東鎮	2018-11-25T06:22:42+08:00	31275	8381	39656	2551	42207	78794	53.57%	39.69%	72	72
8	新竹縣竹東鎮	2018-11-25T00:56:10+08:00	30616	8229	38845	2500	41345	77246	53.52%	39.63%	71	72
8	新竹縣竹東鎮	2018-11-24T22:18:16+08:00	13688	3724	17412	1137	18549	35008	52.99%	39.1%	36	72
8	新竹縣竹東鎮	2018-11-24T23:54:24+08:00	28181	7578	35759	2313	38072	71395	53.33%	39.47%	66	72
8	新竹縣竹東鎮	2018-11-24T23:41:59+08:00	28181	7578	35759	2313	38072	71395	53.33%	39.47%	66	72
8	新竹縣竹東鎮	2018-11-25T01:16:18+08:00	30616	8229	38845	2500	41345	77246	53.52%	39.63%	71	72
8	新竹縣竹東鎮	2018-11-25T06:27:52+08:00	31275	8381	39656	2551	42207	78794	53.57%	39.69%	72	72
8	新竹縣竹東鎮	2018-11-25T00:12:42+08:00	29484	7922	37406	2429	39835	74681	53.34%	39.48%	69	72
8	新竹縣竹東鎮	2018-11-24T22:28:37+08:00	15435	4195	19630	1267	20897	39208	53.3%	39.37%	40	72
8	新竹縣竹東鎮	2018-11-25T00:03:30+08:00	28549	7694	36243	2355	38598	72270	53.41%	39.5%	67	72
8	新竹縣竹東鎮	2018-11-24T23:50:12+08:00	28181	7578	35759	2313	38072	71395	53.33%	39.47%	66	72
8	雲林縣褒忠鄉	2018-11-24T22:39:08+08:00	3862	1292	5154	541	5695	11381	50.04%	33.93%	14	14
8	雲林縣褒忠鄉	2018-11-25T03:37:28+08:00	3862	1292	5154	541	5695	11381	50.04%	33.93%	14	14
8	雲林縣褒忠鄉	2018-11-24T23:07:18+08:00	3862	1292	5154	541	5695	11381	50.04%	33.93%	14	14
8	雲林縣褒忠鄉	2018-11-25T01:24:24+08:00	3862	1292	5154	541	5695	11381	50.04%	33.93%	14	14
8	雲林縣褒忠鄉	2018-11-25T03:54:40+08:00	3862	1292	5154	541	5695	11381	50.04%	33.93%	14	14
8	雲林縣褒忠鄉	2018-11-24T22:32:18+08:00	3862	1292	5154	541	5695	11381	50.04%	33.93%	14	14
8	雲林縣褒忠鄉	2018-11-25T03:30:58+08:00	3862	1292	5154	541	5695	11381	50.04%	33.93%	14	14
8	雲林縣褒忠鄉	2018-11-24T23:42:01+08:00	3862	1292	5154	541	5695	11381	50.04%	33.93%	14	14
8	雲林縣褒忠鄉	2018-11-25T03:48:29+08:00	3862	1292	5154	541	5695	11381	50.04%	33.93%	14	14
8	雲林縣褒忠鄉	2018-11-24T22:21:45+08:00	3479	1151	4630	483	5113	10157	50.34%	34.25%	13	14
8	雲林縣褒忠鄉	2018-11-25T06:07:22+08:00	3862	1292	5154	541	5695	11381	50.04%	33.93%	14	14
8	雲林縣褒忠鄉	2018-11-25T04:01:28+08:00	3862	1292	5154	541	5695	11381	50.04%	33.93%	14	14
8	雲林縣褒忠鄉	2018-11-25T00:21:43+08:00	3862	1292	5154	541	5695	11381	50.04%	33.93%	14	14
8	雲林縣褒忠鄉	2018-11-24T23:29:46+08:00	3862	1292	5154	541	5695	11381	50.04%	33.93%	14	14
8	雲林縣褒忠鄉	2018-11-25T01:11:06+08:00	3862	1292	5154	541	5695	11381	50.04%	33.93%	14	14
8	雲林縣褒忠鄉	2018-11-24T22:40:18+08:00	3862	1292	5154	541	5695	11381	50.04%	33.93%	14	14
8	雲林縣褒忠鄉	2018-11-24T23:00:16+08:00	3862	1292	5154	541	5695	11381	50.04%	33.93%	14	14
8	雲林縣褒忠鄉	2018-11-24T23:37:48+08:00	3862	1292	5154	541	5695	11381	50.04%	33.93%	14	14
8	雲林縣褒忠鄉	2018-11-25T00:56:13+08:00	3862	1292	5154	541	5695	11381	50.04%	33.93%	14	14
8	雲林縣褒忠鄉	2018-11-24T23:33:49+08:00	3862	1292	5154	541	5695	11381	50.04%	33.93%	14	14
8	雲林縣褒忠鄉	2018-11-25T00:03:33+08:00	3862	1292	5154	541	5695	11381	50.04%	33.93%	14	14
8	雲林縣褒忠鄉	2018-11-24T22:35:44+08:00	3862	1292	5154	541	5695	11381	50.04%	33.93%	14	14
8	雲林縣褒忠鄉	2018-11-24T23:54:26+08:00	3862	1292	5154	541	5695	11381	50.04%	33.93%	14	14
8	雲林縣褒忠鄉	2018-11-25T01:01:01+08:00	3862	1292	5154	541	5695	11381	50.04%	33.93%	14	14
8	雲林縣褒忠鄉	2018-11-24T22:56:35+08:00	3862	1292	5154	541	5695	11381	50.04%	33.93%	14	14
8	雲林縣褒忠鄉	2018-11-25T06:17:35+08:00	3862	1292	5154	541	5695	11381	50.04%	33.93%	14	14
8	雲林縣褒忠鄉	2018-11-24T22:49:23+08:00	3862	1292	5154	541	5695	11381	50.04%	33.93%	14	14
8	雲林縣褒忠鄉	2018-11-24T23:22:22+08:00	3862	1292	5154	541	5695	11381	50.04%	33.93%	14	14
8	雲林縣褒忠鄉	2018-11-24T22:43:49+08:00	3862	1292	5154	541	5695	11381	50.04%	33.93%	14	14
8	雲林縣褒忠鄉	2018-11-24T23:03:46+08:00	3862	1292	5154	541	5695	11381	50.04%	33.93%	14	14
8	雲林縣褒忠鄉	2018-11-24T23:10:55+08:00	3862	1292	5154	541	5695	11381	50.04%	33.93%	14	14
8	雲林縣褒忠鄉	2018-11-24T22:12:02+08:00	3064	1030	4094	435	4529	9164	49.42%	33.44%	12	14
8	雲林縣褒忠鄉	2018-11-25T00:08:04+08:00	3862	1292	5154	541	5695	11381	50.04%	33.93%	14	14
8	雲林縣褒忠鄉	2018-11-25T03:42:47+08:00	3862	1292	5154	541	5695	11381	50.04%	33.93%	14	14
8	雲林縣褒忠鄉	2018-11-24T22:53:14+08:00	3862	1292	5154	541	5695	11381	50.04%	33.93%	14	14
8	雲林縣褒忠鄉	2018-11-24T23:46:03+08:00	3862	1292	5154	541	5695	11381	50.04%	33.93%	14	14
8	雲林縣褒忠鄉	2018-11-25T00:17:07+08:00	3862	1292	5154	541	5695	11381	50.04%	33.93%	14	14
8	雲林縣褒忠鄉	2018-11-25T06:22:44+08:00	3862	1292	5154	541	5695	11381	50.04%	33.93%	14	14
8	雲林縣褒忠鄉	2018-11-25T06:12:36+08:00	3862	1292	5154	541	5695	11381	50.04%	33.93%	14	14
8	雲林縣褒忠鄉	2018-11-24T22:25:24+08:00	3862	1292	5154	541	5695	11381	50.04%	33.93%	14	14
8	雲林縣褒忠鄉	2018-11-25T01:05:58+08:00	3862	1292	5154	541	5695	11381	50.04%	33.93%	14	14
8	雲林縣褒忠鄉	2018-11-25T00:12:44+08:00	3862	1292	5154	541	5695	11381	50.04%	33.93%	14	14
8	雲林縣褒忠鄉	2018-11-24T23:26:06+08:00	3862	1292	5154	541	5695	11381	50.04%	33.93%	14	14
8	雲林縣褒忠鄉	2018-11-25T06:27:54+08:00	3862	1292	5154	541	5695	11381	50.04%	33.93%	14	14
8	雲林縣褒忠鄉	2018-11-24T23:18:27+08:00	3862	1292	5154	541	5695	11381	50.04%	33.93%	14	14
8	雲林縣褒忠鄉	2018-11-24T23:50:14+08:00	3862	1292	5154	541	5695	11381	50.04%	33.93%	14	14
8	雲林縣褒忠鄉	2018-11-24T23:14:40+08:00	3862	1292	5154	541	5695	11381	50.04%	33.93%	14	14
8	雲林縣褒忠鄉	2018-11-24T22:18:19+08:00	3479	1151	4630	483	5113	10157	50.34%	34.25%	13	14
8	雲林縣褒忠鄉	2018-11-24T23:58:42+08:00	3862	1292	5154	541	5695	11381	50.04%	33.93%	14	14
8	雲林縣褒忠鄉	2018-11-24T22:28:39+08:00	3862	1292	5154	541	5695	11381	50.04%	33.93%	14	14
8	雲林縣褒忠鄉	2018-11-24T22:14:48+08:00	3479	1151	4630	483	5113	10157	50.34%	34.25%	13	14
8	雲林縣褒忠鄉	2018-11-25T01:16:21+08:00	3862	1292	5154	541	5695	11381	50.04%	33.93%	14	14
8	雲林縣土庫鎮	2018-11-24T22:39:08+08:00	8329	2817	11146	1490	12636	24412	51.76%	34.12%	29	29
8	雲林縣土庫鎮	2018-11-25T03:37:28+08:00	8329	2817	11146	1490	12636	24412	51.76%	34.12%	29	29
8	雲林縣土庫鎮	2018-11-25T01:24:23+08:00	8329	2817	11146	1490	12636	24412	51.76%	34.12%	29	29
8	雲林縣土庫鎮	2018-11-24T23:07:17+08:00	8329	2817	11146	1490	12636	24412	51.76%	34.12%	29	29
8	雲林縣土庫鎮	2018-11-24T22:12:01+08:00	7701	2607	10308	1393	11701	22762	51.41%	33.83%	27	29
8	雲林縣土庫鎮	2018-11-24T22:32:17+08:00	8329	2817	11146	1490	12636	24412	51.76%	34.12%	29	29
8	雲林縣土庫鎮	2018-11-25T03:48:28+08:00	8329	2817	11146	1490	12636	24412	51.76%	34.12%	29	29
8	雲林縣土庫鎮	2018-11-25T03:30:58+08:00	8329	2817	11146	1490	12636	24412	51.76%	34.12%	29	29
8	雲林縣土庫鎮	2018-11-24T23:42:01+08:00	8329	2817	11146	1490	12636	24412	51.76%	34.12%	29	29
8	雲林縣土庫鎮	2018-11-24T22:21:45+08:00	8329	2817	11146	1490	12636	24412	51.76%	34.12%	29	29
8	雲林縣土庫鎮	2018-11-25T06:07:22+08:00	8329	2817	11146	1490	12636	24412	51.76%	34.12%	29	29
8	雲林縣土庫鎮	2018-11-25T04:01:28+08:00	8329	2817	11146	1490	12636	24412	51.76%	34.12%	29	29
8	雲林縣土庫鎮	2018-11-25T00:21:43+08:00	8329	2817	11146	1490	12636	24412	51.76%	34.12%	29	29
8	雲林縣土庫鎮	2018-11-25T01:11:06+08:00	8329	2817	11146	1490	12636	24412	51.76%	34.12%	29	29
8	雲林縣土庫鎮	2018-11-24T22:40:18+08:00	8329	2817	11146	1490	12636	24412	51.76%	34.12%	29	29
8	雲林縣土庫鎮	2018-11-24T23:00:16+08:00	8329	2817	11146	1490	12636	24412	51.76%	34.12%	29	29
8	雲林縣土庫鎮	2018-11-24T23:37:48+08:00	8329	2817	11146	1490	12636	24412	51.76%	34.12%	29	29
8	雲林縣土庫鎮	2018-11-25T03:54:39+08:00	8329	2817	11146	1490	12636	24412	51.76%	34.12%	29	29
8	雲林縣土庫鎮	2018-11-25T01:01:00+08:00	8329	2817	11146	1490	12636	24412	51.76%	34.12%	29	29
8	雲林縣土庫鎮	2018-11-24T23:33:49+08:00	8329	2817	11146	1490	12636	24412	51.76%	34.12%	29	29
8	雲林縣土庫鎮	2018-11-25T00:03:33+08:00	8329	2817	11146	1490	12636	24412	51.76%	34.12%	29	29
8	雲林縣土庫鎮	2018-11-24T22:35:44+08:00	8329	2817	11146	1490	12636	24412	51.76%	34.12%	29	29
8	雲林縣土庫鎮	2018-11-24T23:54:26+08:00	8329	2817	11146	1490	12636	24412	51.76%	34.12%	29	29
8	雲林縣土庫鎮	2018-11-24T23:58:41+08:00	8329	2817	11146	1490	12636	24412	51.76%	34.12%	29	29
8	雲林縣土庫鎮	2018-11-25T00:56:12+08:00	8329	2817	11146	1490	12636	24412	51.76%	34.12%	29	29
8	雲林縣土庫鎮	2018-11-24T22:56:35+08:00	8329	2817	11146	1490	12636	24412	51.76%	34.12%	29	29
8	雲林縣土庫鎮	2018-11-25T06:17:35+08:00	8329	2817	11146	1490	12636	24412	51.76%	34.12%	29	29
8	雲林縣土庫鎮	2018-11-24T22:49:23+08:00	8329	2817	11146	1490	12636	24412	51.76%	34.12%	29	29
8	雲林縣土庫鎮	2018-11-24T23:22:22+08:00	8329	2817	11146	1490	12636	24412	51.76%	34.12%	29	29
8	雲林縣土庫鎮	2018-11-24T22:43:49+08:00	8329	2817	11146	1490	12636	24412	51.76%	34.12%	29	29
8	雲林縣土庫鎮	2018-11-24T23:03:46+08:00	8329	2817	11146	1490	12636	24412	51.76%	34.12%	29	29
8	雲林縣土庫鎮	2018-11-24T23:10:55+08:00	8329	2817	11146	1490	12636	24412	51.76%	34.12%	29	29
8	雲林縣土庫鎮	2018-11-25T00:08:04+08:00	8329	2817	11146	1490	12636	24412	51.76%	34.12%	29	29
8	雲林縣土庫鎮	2018-11-25T03:42:47+08:00	8329	2817	11146	1490	12636	24412	51.76%	34.12%	29	29
8	雲林縣土庫鎮	2018-11-24T22:53:14+08:00	8329	2817	11146	1490	12636	24412	51.76%	34.12%	29	29
8	雲林縣土庫鎮	2018-11-24T23:46:02+08:00	8329	2817	11146	1490	12636	24412	51.76%	34.12%	29	29
8	雲林縣土庫鎮	2018-11-25T00:17:07+08:00	8329	2817	11146	1490	12636	24412	51.76%	34.12%	29	29
8	雲林縣土庫鎮	2018-11-24T23:29:45+08:00	8329	2817	11146	1490	12636	24412	51.76%	34.12%	29	29
8	雲林縣土庫鎮	2018-11-25T06:22:44+08:00	8329	2817	11146	1490	12636	24412	51.76%	34.12%	29	29
8	雲林縣土庫鎮	2018-11-25T06:12:36+08:00	8329	2817	11146	1490	12636	24412	51.76%	34.12%	29	29
8	雲林縣土庫鎮	2018-11-24T22:25:24+08:00	8329	2817	11146	1490	12636	24412	51.76%	34.12%	29	29
8	雲林縣土庫鎮	2018-11-25T01:05:58+08:00	8329	2817	11146	1490	12636	24412	51.76%	34.12%	29	29
8	雲林縣土庫鎮	2018-11-25T00:12:44+08:00	8329	2817	11146	1490	12636	24412	51.76%	34.12%	29	29
8	雲林縣土庫鎮	2018-11-24T23:26:06+08:00	8329	2817	11146	1490	12636	24412	51.76%	34.12%	29	29
8	雲林縣土庫鎮	2018-11-24T22:18:18+08:00	8329	2817	11146	1490	12636	24412	51.76%	34.12%	29	29
8	雲林縣土庫鎮	2018-11-25T06:27:54+08:00	8329	2817	11146	1490	12636	24412	51.76%	34.12%	29	29
8	雲林縣土庫鎮	2018-11-24T23:50:14+08:00	8329	2817	11146	1490	12636	24412	51.76%	34.12%	29	29
8	雲林縣土庫鎮	2018-11-24T23:14:40+08:00	8329	2817	11146	1490	12636	24412	51.76%	34.12%	29	29
8	雲林縣土庫鎮	2018-11-24T22:28:39+08:00	8329	2817	11146	1490	12636	24412	51.76%	34.12%	29	29
8	雲林縣土庫鎮	2018-11-24T22:14:48+08:00	8329	2817	11146	1490	12636	24412	51.76%	34.12%	29	29
8	雲林縣土庫鎮	2018-11-25T01:16:21+08:00	8329	2817	11146	1490	12636	24412	51.76%	34.12%	29	29
8	雲林縣土庫鎮	2018-11-24T23:18:26+08:00	8329	2817	11146	1490	12636	24412	51.76%	34.12%	29	29
8	臺中市北區	2018-11-25T03:37:17+08:00	50598	14519	65117	4179	69296	124621	55.61%	40.6%	87	87
8	臺中市北區	2018-11-24T23:10:50+08:00	35863	10559	46422	3077	49499	88362	56.02%	40.59%	64	87
8	臺中市北區	2018-11-25T00:56:06+08:00	49229	14167	63396	4073	67469	120982	55.77%	40.69%	85	87
8	臺中市北區	2018-11-24T23:22:16+08:00	37145	10918	48063	3197	51260	91433	56.06%	40.63%	66	87
8	臺中市北區	2018-11-25T01:10:58+08:00	49229	14167	63396	4073	67469	120982	55.77%	40.69%	85	87
8	臺中市北區	2018-11-24T22:49:17+08:00	32452	9390	41842	2735	44577	79383	56.15%	40.88%	58	87
8	臺中市北區	2018-11-24T23:14:32+08:00	36458	10716	47174	3129	50303	89781	56.03%	40.61%	65	87
8	臺中市北區	2018-11-24T22:43:43+08:00	31934	9229	41163	2682	43845	78150	56.1%	40.86%	57	87
8	臺中市北區	2018-11-25T00:03:26+08:00	43438	12655	56093	3679	59772	106558	56.09%	40.76%	76	87
8	臺中市北區	2018-11-24T22:56:30+08:00	33042	9560	42602	2785	45387	80786	56.18%	40.9%	59	87
8	臺中市北區	2018-11-25T00:12:38+08:00	45410	13065	58475	3854	62329	111396	55.95%	40.76%	79	87
8	臺中市北區	2018-11-25T03:48:21+08:00	50598	14519	65117	4179	69296	124621	55.61%	40.6%	87	87
8	臺中市北區	2018-11-25T06:22:38+08:00	50598	14519	65117	4179	69296	124621	55.61%	40.6%	87	87
8	臺中市北區	2018-11-25T03:30:51+08:00	50598	14519	65117	4179	69296	124621	55.61%	40.6%	87	87
8	臺中市北區	2018-11-25T04:01:21+08:00	50598	14519	65117	4179	69296	124621	55.61%	40.6%	87	87
8	臺中市北區	2018-11-24T22:25:17+08:00	24112	7076	31188	2055	33243	59432	55.93%	40.57%	45	87
8	臺中市北區	2018-11-25T06:07:15+08:00	50598	14519	65117	4179	69296	124621	55.61%	40.6%	87	87
8	臺中市北區	2018-11-24T23:29:40+08:00	37145	10918	48063	3197	51260	91433	56.06%	40.63%	66	87
8	臺中市北區	2018-11-24T22:18:12+08:00	23148	6821	29969	2001	31970	57063	56.03%	40.57%	43	87
8	臺中市北區	2018-11-24T23:54:18+08:00	41939	12274	54213	3578	57791	103073	56.07%	40.69%	74	87
8	臺中市北區	2018-11-25T00:07:57+08:00	43438	12655	56093	3679	59772	106558	56.09%	40.76%	76	87
8	臺中市北區	2018-11-25T01:16:14+08:00	49229	14167	63396	4073	67469	120982	55.77%	40.69%	85	87
8	臺中市北區	2018-11-24T23:41:55+08:00	40579	11854	52433	3454	55887	99549	56.14%	40.76%	72	87
8	臺中市北區	2018-11-24T22:28:33+08:00	25726	7506	33232	2146	35378	63345	55.85%	40.61%	48	87
8	臺中市北區	2018-11-24T23:58:34+08:00	42578	12449	55027	3627	58654	104626	56.06%	40.7%	75	87
8	臺中市北區	2018-11-24T23:50:08+08:00	41939	12274	54213	3578	57791	103073	56.07%	40.69%	74	87
8	臺中市北區	2018-11-25T01:24:16+08:00	49877	14331	64208	4117	68325	122743	55.67%	40.64%	86	87
8	臺中市北區	2018-11-24T22:35:38+08:00	29553	8604	38157	2500	40657	72593	56.01%	40.71%	53	87
8	臺中市北區	2018-11-24T23:07:12+08:00	35246	10360	45606	3014	48620	86755	56.04%	40.63%	63	87
8	臺中市北區	2018-11-24T22:39:02+08:00	30293	8840	39133	2584	41717	74475	56.01%	40.68%	54	87
8	臺中市北區	2018-11-25T06:27:48+08:00	50598	14519	65117	4179	69296	124621	55.61%	40.6%	87	87
8	臺中市北區	2018-11-24T23:03:41+08:00	34403	9964	44367	2892	47259	84288	56.07%	40.82%	61	87
8	臺中市北區	2018-11-25T01:00:53+08:00	49229	14167	63396	4073	67469	120982	55.77%	40.69%	85	87
8	臺中市北區	2018-11-25T00:21:37+08:00	46156	13288	59444	3899	63343	113263	55.93%	40.75%	80	87
8	臺中市北區	2018-11-24T22:21:38+08:00	23647	6929	30576	2026	32602	58282	55.94%	40.57%	44	87
8	臺中市北區	2018-11-25T03:42:40+08:00	50598	14519	65117	4179	69296	124621	55.61%	40.6%	87	87
8	臺中市北區	2018-11-24T23:00:07+08:00	33042	9560	42602	2785	45387	80786	56.18%	40.9%	59	87
8	臺中市北區	2018-11-24T22:32:12+08:00	27186	7941	35127	2282	37409	66751	56.04%	40.73%	50	87
8	臺中市北區	2018-11-25T06:12:30+08:00	50598	14519	65117	4179	69296	124621	55.61%	40.6%	87	87
8	臺中市北區	2018-11-24T22:40:12+08:00	31227	9102	40329	2652	42981	76646	56.08%	40.74%	56	87
8	臺中市北區	2018-11-25T00:17:01+08:00	45410	13065	58475	3854	62329	111396	55.95%	40.76%	79	87
8	臺中市北區	2018-11-24T22:53:07+08:00	33042	9560	42602	2785	45387	80786	56.18%	40.9%	59	87
8	臺中市北區	2018-11-24T22:11:56+08:00	18845	5489	24334	1593	25927	46424	55.85%	40.59%	36	87
8	臺中市北區	2018-11-25T03:54:33+08:00	50598	14519	65117	4179	69296	124621	55.61%	40.6%	87	87
8	臺中市北區	2018-11-25T01:05:51+08:00	49229	14167	63396	4073	67469	120982	55.77%	40.69%	85	87
8	臺中市北區	2018-11-24T23:26:01+08:00	37145	10918	48063	3197	51260	91433	56.06%	40.63%	66	87
8	臺中市北區	2018-11-24T23:33:43+08:00	39025	11376	50401	3322	53723	95783	56.09%	40.74%	69	87
8	臺中市北區	2018-11-24T23:18:20+08:00	37145	10918	48063	3197	51260	91433	56.06%	40.63%	66	87
8	臺中市北區	2018-11-25T06:17:29+08:00	50598	14519	65117	4179	69296	124621	55.61%	40.6%	87	87
8	臺中市北區	2018-11-24T23:37:42+08:00	40579	11854	52433	3454	55887	99549	56.14%	40.76%	72	87
8	臺中市北區	2018-11-24T22:14:41+08:00	21451	6291	27742	1834	29576	52866	55.95%	40.58%	40	87
8	臺中市北區	2018-11-24T23:45:57+08:00	41939	12274	54213	3578	57791	103073	56.07%	40.69%	74	87
8	臺中市后里區	2018-11-24T23:10:50+08:00	18679	5157	23836	2124	25960	44962	57.74%	41.54%	37	37
8	臺中市后里區	2018-11-25T00:56:06+08:00	18679	5157	23836	2124	25960	44962	57.74%	41.54%	37	37
8	臺中市后里區	2018-11-24T23:14:33+08:00	18679	5157	23836	2124	25960	44962	57.74%	41.54%	37	37
8	臺中市后里區	2018-11-24T23:22:16+08:00	18679	5157	23836	2124	25960	44962	57.74%	41.54%	37	37
8	臺中市后里區	2018-11-25T00:12:39+08:00	18679	5157	23836	2124	25960	44962	57.74%	41.54%	37	37
8	臺中市后里區	2018-11-24T22:49:17+08:00	18679	5157	23836	2124	25960	44962	57.74%	41.54%	37	37
8	臺中市后里區	2018-11-25T03:37:18+08:00	18679	5157	23836	2124	25960	44962	57.74%	41.54%	37	37
8	臺中市后里區	2018-11-24T22:43:44+08:00	18679	5157	23836	2124	25960	44962	57.74%	41.54%	37	37
8	臺中市后里區	2018-11-25T00:03:26+08:00	18679	5157	23836	2124	25960	44962	57.74%	41.54%	37	37
8	臺中市后里區	2018-11-25T01:10:59+08:00	18679	5157	23836	2124	25960	44962	57.74%	41.54%	37	37
8	臺中市后里區	2018-11-24T22:56:30+08:00	18679	5157	23836	2124	25960	44962	57.74%	41.54%	37	37
8	臺中市后里區	2018-11-25T06:22:39+08:00	18679	5157	23836	2124	25960	44962	57.74%	41.54%	37	37
8	臺中市后里區	2018-11-25T03:30:51+08:00	18679	5157	23836	2124	25960	44962	57.74%	41.54%	37	37
8	臺中市后里區	2018-11-24T22:25:17+08:00	16184	4522	20706	1837	22543	38945	57.88%	41.56%	33	37
8	臺中市后里區	2018-11-24T23:29:40+08:00	18679	5157	23836	2124	25960	44962	57.74%	41.54%	37	37
8	臺中市后里區	2018-11-25T01:16:15+08:00	18679	5157	23836	2124	25960	44962	57.74%	41.54%	37	37
8	臺中市后里區	2018-11-24T23:54:18+08:00	18679	5157	23836	2124	25960	44962	57.74%	41.54%	37	37
8	臺中市后里區	2018-11-25T00:07:57+08:00	18679	5157	23836	2124	25960	44962	57.74%	41.54%	37	37
8	臺中市后里區	2018-11-24T22:14:42+08:00	14460	4079	18539	1640	20179	35081	57.52%	41.22%	30	37
8	臺中市后里區	2018-11-24T22:18:13+08:00	15017	4241	19258	1703	20961	36259	57.81%	41.42%	31	37
8	臺中市后里區	2018-11-24T22:28:33+08:00	16184	4522	20706	1837	22543	38945	57.88%	41.56%	33	37
8	臺中市后里區	2018-11-24T23:50:08+08:00	18679	5157	23836	2124	25960	44962	57.74%	41.54%	37	37
8	臺中市后里區	2018-11-24T23:07:12+08:00	18679	5157	23836	2124	25960	44962	57.74%	41.54%	37	37
8	臺中市后里區	2018-11-24T22:39:02+08:00	16931	4710	21641	1924	23565	40614	58.02%	41.69%	34	37
8	臺中市后里區	2018-11-25T01:24:17+08:00	18679	5157	23836	2124	25960	44962	57.74%	41.54%	37	37
8	臺中市后里區	2018-11-24T22:35:39+08:00	16184	4522	20706	1837	22543	38945	57.88%	41.56%	33	37
8	臺中市后里區	2018-11-24T23:58:35+08:00	18679	5157	23836	2124	25960	44962	57.74%	41.54%	37	37
8	臺中市后里區	2018-11-25T06:27:49+08:00	18679	5157	23836	2124	25960	44962	57.74%	41.54%	37	37
8	臺中市后里區	2018-11-24T23:03:41+08:00	18679	5157	23836	2124	25960	44962	57.74%	41.54%	37	37
8	臺中市后里區	2018-11-25T01:00:53+08:00	18679	5157	23836	2124	25960	44962	57.74%	41.54%	37	37
8	臺中市后里區	2018-11-24T23:00:08+08:00	18679	5157	23836	2124	25960	44962	57.74%	41.54%	37	37
8	臺中市后里區	2018-11-25T03:48:22+08:00	18679	5157	23836	2124	25960	44962	57.74%	41.54%	37	37
8	臺中市后里區	2018-11-25T00:21:37+08:00	18679	5157	23836	2124	25960	44962	57.74%	41.54%	37	37
8	臺中市后里區	2018-11-25T03:42:40+08:00	18679	5157	23836	2124	25960	44962	57.74%	41.54%	37	37
8	臺中市后里區	2018-11-24T22:21:39+08:00	16184	4522	20706	1837	22543	38945	57.88%	41.56%	33	37
8	臺中市后里區	2018-11-24T22:32:12+08:00	16184	4522	20706	1837	22543	38945	57.88%	41.56%	33	37
8	臺中市后里區	2018-11-25T04:01:22+08:00	18679	5157	23836	2124	25960	44962	57.74%	41.54%	37	37
8	臺中市后里區	2018-11-24T22:11:57+08:00	14047	3920	17967	1575	19542	33943	57.57%	41.38%	29	37
8	臺中市后里區	2018-11-25T00:17:01+08:00	18679	5157	23836	2124	25960	44962	57.74%	41.54%	37	37
8	臺中市后里區	2018-11-24T22:40:13+08:00	18163	5014	23177	2047	25224	43737	57.67%	41.53%	36	37
8	臺中市后里區	2018-11-24T22:53:07+08:00	18679	5157	23836	2124	25960	44962	57.74%	41.54%	37	37
8	臺中市后里區	2018-11-25T06:12:31+08:00	18679	5157	23836	2124	25960	44962	57.74%	41.54%	37	37
8	臺中市后里區	2018-11-25T06:07:16+08:00	18679	5157	23836	2124	25960	44962	57.74%	41.54%	37	37
8	臺中市后里區	2018-11-25T03:54:33+08:00	18679	5157	23836	2124	25960	44962	57.74%	41.54%	37	37
8	臺中市后里區	2018-11-25T01:05:51+08:00	18679	5157	23836	2124	25960	44962	57.74%	41.54%	37	37
8	臺中市后里區	2018-11-24T23:26:01+08:00	18679	5157	23836	2124	25960	44962	57.74%	41.54%	37	37
8	臺中市后里區	2018-11-24T23:33:43+08:00	18679	5157	23836	2124	25960	44962	57.74%	41.54%	37	37
8	臺中市后里區	2018-11-25T06:17:29+08:00	18679	5157	23836	2124	25960	44962	57.74%	41.54%	37	37
8	臺中市后里區	2018-11-24T23:41:56+08:00	18679	5157	23836	2124	25960	44962	57.74%	41.54%	37	37
8	臺中市后里區	2018-11-24T23:37:43+08:00	18679	5157	23836	2124	25960	44962	57.74%	41.54%	37	37
8	臺中市后里區	2018-11-24T23:18:21+08:00	18679	5157	23836	2124	25960	44962	57.74%	41.54%	37	37
8	臺中市后里區	2018-11-24T23:45:57+08:00	18679	5157	23836	2124	25960	44962	57.74%	41.54%	37	37
8	臺北市萬華區	2018-11-24T23:07:11+08:00	52644	17885	70529	6317	76846	139152	55.22%	37.83%	100	117
8	臺北市萬華區	2018-11-25T01:05:49+08:00	61941	21093	83034	7357	90391	164020	55.11%	37.76%	117	117
8	臺北市萬華區	2018-11-24T22:49:16+08:00	48142	16226	64368	5724	70092	126817	55.27%	37.96%	92	117
8	臺北市萬華區	2018-11-24T22:39:01+08:00	45290	15323	60613	5512	66125	119876	55.16%	37.78%	87	117
8	臺北市萬華區	2018-11-24T22:43:42+08:00	47582	16006	63588	5656	69244	125364	55.23%	37.96%	91	117
8	臺北市萬華區	2018-11-25T01:24:15+08:00	61941	21093	83034	7357	90391	164020	55.11%	37.76%	117	117
8	臺北市萬華區	2018-11-24T23:50:05+08:00	58290	19713	78003	6914	84917	153675	55.26%	37.93%	110	117
8	臺北市萬華區	2018-11-25T01:10:56+08:00	61941	21093	83034	7357	90391	164020	55.11%	37.76%	117	117
8	臺北市萬華區	2018-11-24T22:39:00+08:00	45290	15323	60613	5512	66125	119876	55.16%	37.78%	87	117
8	臺北市萬華區	2018-11-25T03:37:16+08:00	61941	21093	83034	7357	90391	164020	55.11%	37.76%	117	117
8	臺北市萬華區	2018-11-25T01:10:57+08:00	61941	21093	83034	7357	90391	164020	55.11%	37.76%	117	117
8	臺北市萬華區	2018-11-24T23:50:04+08:00	58290	19713	78003	6914	84917	153675	55.26%	37.93%	110	117
8	臺北市萬華區	2018-11-25T01:24:14+08:00	61941	21093	83034	7357	90391	164020	55.11%	37.76%	117	117
8	臺北市萬華區	2018-11-25T00:12:36+08:00	60302	20493	80795	7151	87946	159283	55.21%	37.86%	114	117
8	臺北市萬華區	2018-11-24T22:32:10+08:00	43268	14627	57895	5234	63129	114196	55.28%	37.89%	83	117
8	臺北市萬華區	2018-11-24T23:29:38+08:00	57296	19352	76648	6803	83451	150851	55.32%	37.98%	108	117
8	臺北市萬華區	2018-11-25T06:22:36+08:00	61941	21093	83034	7357	90391	164020	55.11%	37.76%	117	117
8	臺北市萬華區	2018-11-25T06:12:29+08:00	61941	21093	83034	7357	90391	164020	55.11%	37.76%	117	117
8	臺北市萬華區	2018-11-25T00:21:35+08:00	61412	20932	82344	7276	89620	162626	55.11%	37.76%	116	117
8	臺北市萬華區	2018-11-24T23:00:03+08:00	51661	17527	69188	6162	75350	136490	55.21%	37.85%	98	117
8	臺北市萬華區	2018-11-25T03:48:20+08:00	61941	21093	83034	7357	90391	164020	55.11%	37.76%	117	117
8	臺北市萬華區	2018-11-24T23:25:59+08:00	56784	19138	75922	6747	82669	149574	55.27%	37.96%	107	117
8	臺北市萬華區	2018-11-24T23:29:39+08:00	57296	19352	76648	6803	83451	150851	55.32%	37.98%	108	117
8	臺北市萬華區	2018-11-24T23:00:04+08:00	51661	17527	69188	6162	75350	136490	55.21%	37.85%	98	117
8	臺北市萬華區	2018-11-25T01:00:51+08:00	61941	21093	83034	7357	90391	164020	55.11%	37.76%	117	117
8	臺北市萬華區	2018-11-25T06:07:14+08:00	61941	21093	83034	7357	90391	164020	55.11%	37.76%	117	117
8	臺北市萬華區	2018-11-24T22:53:05+08:00	48681	16461	65142	5810	70952	128436	55.24%	37.9%	93	117
8	臺北市萬華區	2018-11-24T22:40:11+08:00	46599	15648	62247	5597	67844	122725	55.28%	37.97%	89	117
8	臺北市萬華區	2018-11-24T22:25:16+08:00	41604	14176	55780	5044	60824	109759	55.42%	37.9%	80	117
8	臺北市萬華區	2018-11-24T22:11:55+08:00	38126	13022	51148	4679	55827	101133	55.2%	37.7%	74	117
8	臺北市萬華區	2018-11-25T04:01:20+08:00	61941	21093	83034	7357	90391	164020	55.11%	37.76%	117	117
8	臺北市萬華區	2018-11-25T01:16:12+08:00	61941	21093	83034	7357	90391	164020	55.11%	37.76%	117	117
8	臺北市萬華區	2018-11-25T00:07:56+08:00	60302	20493	80795	7151	87946	159283	55.21%	37.86%	114	117
8	臺北市萬華區	2018-11-24T23:37:41+08:00	57296	19352	76648	6803	83451	150851	55.32%	37.98%	108	117
8	臺北市萬華區	2018-11-24T23:41:54+08:00	57296	19352	76648	6803	83451	150851	55.32%	37.98%	108	117
8	臺北市萬華區	2018-11-24T22:28:32+08:00	42736	14436	57172	5186	62358	112734	55.31%	37.91%	82	117
8	臺北市萬華區	2018-11-25T01:16:13+08:00	61941	21093	83034	7357	90391	164020	55.11%	37.76%	117	117
8	臺北市萬華區	2018-11-25T03:54:31+08:00	61941	21093	83034	7357	90391	164020	55.11%	37.76%	117	117
8	臺北市萬華區	2018-11-24T23:54:17+08:00	59305	20040	79345	7043	86388	156293	55.27%	37.94%	112	117
8	臺北市萬華區	2018-11-25T00:03:24+08:00	60302	20493	80795	7151	87946	159283	55.21%	37.86%	114	117
8	臺北市萬華區	2018-11-24T22:35:36+08:00	43857	14803	58660	5287	63947	115592	55.32%	37.94%	84	117
8	臺北市萬華區	2018-11-25T00:16:59+08:00	60859	20728	81587	7189	88776	161029	55.13%	37.79%	115	117
8	臺北市萬華區	2018-11-24T23:58:33+08:00	59810	20239	80049	7095	87144	157888	55.19%	37.88%	113	117
8	臺北市萬華區	2018-11-24T22:14:39+08:00	38849	13202	52051	4712	56763	102694	55.27%	37.83%	75	117
8	臺北市萬華區	2018-11-24T22:43:41+08:00	47582	16006	63588	5656	69244	125364	55.23%	37.96%	91	117
8	臺北市萬華區	2018-11-24T23:03:40+08:00	52221	17702	69923	6256	76179	137910	55.24%	37.87%	99	117
8	臺北市萬華區	2018-11-24T23:14:30+08:00	55613	18780	74393	6624	81017	146764	55.2%	37.89%	105	117
8	臺北市萬華區	2018-11-24T23:22:14+08:00	56784	19138	75922	6747	82669	149574	55.27%	37.96%	107	117
8	臺北市萬華區	2018-11-24T23:58:32+08:00	59810	20239	80049	7095	87144	157888	55.19%	37.88%	113	117
8	臺北市萬華區	2018-11-25T03:37:15+08:00	61941	21093	83034	7357	90391	164020	55.11%	37.76%	117	117
8	臺北市萬華區	2018-11-25T00:56:03+08:00	61941	21093	83034	7357	90391	164020	55.11%	37.76%	117	117
8	臺北市萬華區	2018-11-25T00:56:04+08:00	61941	21093	83034	7357	90391	164020	55.11%	37.76%	117	117
8	臺北市萬華區	2018-11-24T23:14:31+08:00	55613	18780	74393	6624	81017	146764	55.2%	37.89%	105	117
8	臺北市萬華區	2018-11-25T06:27:47+08:00	61941	21093	83034	7357	90391	164020	55.11%	37.76%	117	117
8	臺北市萬華區	2018-11-24T22:21:36+08:00	40394	13814	54208	4926	59134	106795	55.37%	37.82%	78	117
8	臺北市萬華區	2018-11-24T22:21:37+08:00	40394	13814	54208	4926	59134	106795	55.37%	37.82%	78	117
8	臺北市萬華區	2018-11-25T00:17:00+08:00	60859	20728	81587	7189	88776	161029	55.13%	37.79%	115	117
8	臺北市萬華區	2018-11-25T03:42:37+08:00	61941	21093	83034	7357	90391	164020	55.11%	37.76%	117	117
8	臺北市萬華區	2018-11-25T03:30:49+08:00	61941	21093	83034	7357	90391	164020	55.11%	37.76%	117	117
8	臺北市萬華區	2018-11-25T03:42:36+08:00	61941	21093	83034	7357	90391	164020	55.11%	37.76%	117	117
8	臺北市萬華區	2018-11-24T22:25:15+08:00	41604	14176	55780	5044	60824	109759	55.42%	37.9%	80	117
8	臺北市萬華區	2018-11-24T22:18:11+08:00	40394	13814	54208	4926	59134	106795	55.37%	37.82%	78	117
8	臺北市萬華區	2018-11-24T22:28:31+08:00	42736	14436	57172	5186	62358	112734	55.31%	37.91%	82	117
8	臺北市萬華區	2018-11-24T23:10:48+08:00	53908	18222	72130	6451	78581	142306	55.22%	37.88%	102	117
8	臺北市萬華區	2018-11-24T22:14:40+08:00	38849	13202	52051	4712	56763	102694	55.27%	37.83%	75	117
8	臺北市萬華區	2018-11-25T06:17:27+08:00	61941	21093	83034	7357	90391	164020	55.11%	37.76%	117	117
8	臺北市萬華區	2018-11-24T22:56:29+08:00	49955	16902	66857	5914	72771	131540	55.32%	37.98%	95	117
8	臺北市萬華區	2018-11-24T23:45:56+08:00	57785	19538	77323	6858	84181	152218	55.3%	37.96%	109	117
8	臺北市萬華區	2018-11-25T00:07:55+08:00	60302	20493	80795	7151	87946	159283	55.21%	37.86%	114	117
8	臺北市萬華區	2018-11-24T23:33:42+08:00	57296	19352	76648	6803	83451	150851	55.32%	37.98%	108	117
8	臺北市萬華區	2018-11-24T23:10:49+08:00	53908	18222	72130	6451	78581	142306	55.22%	37.88%	102	117
8	臺北市萬華區	2018-11-25T03:54:32+08:00	61941	21093	83034	7357	90391	164020	55.11%	37.76%	117	117
8	臺北市萬華區	2018-11-24T23:18:19+08:00	55613	18780	74393	6624	81017	146764	55.2%	37.89%	105	117
8	臺東縣延平鄉	2018-11-24T23:26:10+08:00	974	337	1311	199	1510	2930	51.54%	33.24%	5	5
8	臺東縣延平鄉	2018-11-24T22:49:27+08:00	813	268	1081	133	1214	2504	48.48%	32.47%	4	5
8	臺東縣延平鄉	2018-11-24T23:10:58+08:00	974	337	1311	199	1510	2930	51.54%	33.24%	5	5
8	臺東縣延平鄉	2018-11-24T23:33:53+08:00	974	337	1311	199	1510	2930	51.54%	33.24%	5	5
8	臺東縣延平鄉	2018-11-24T22:56:39+08:00	813	268	1081	133	1214	2504	48.48%	32.47%	4	5
8	臺東縣延平鄉	2018-11-24T23:22:26+08:00	974	337	1311	199	1510	2930	51.54%	33.24%	5	5
8	臺東縣延平鄉	2018-11-24T22:28:43+08:00	319	107	426	57	483	911	53.02%	35.02%	2	5
8	臺東縣延平鄉	2018-11-24T23:18:30+08:00	974	337	1311	199	1510	2930	51.54%	33.24%	5	5
8	臺東縣延平鄉	2018-11-25T00:17:11+08:00	974	337	1311	199	1510	2930	51.54%	33.24%	5	5
8	臺東縣延平鄉	2018-11-24T22:32:21+08:00	319	107	426	57	483	911	53.02%	35.02%	2	5
8	臺東縣延平鄉	2018-11-24T23:46:06+08:00	974	337	1311	199	1510	2930	51.54%	33.24%	5	5
8	臺東縣延平鄉	2018-11-25T00:08:07+08:00	974	337	1311	199	1510	2930	51.54%	33.24%	5	5
8	臺東縣延平鄉	2018-11-24T22:53:18+08:00	813	268	1081	133	1214	2504	48.48%	32.47%	4	5
8	臺東縣延平鄉	2018-11-25T04:01:32+08:00	974	337	1311	199	1510	2930	51.54%	33.24%	5	5
8	臺東縣延平鄉	2018-11-25T03:48:34+08:00	974	337	1311	199	1510	2930	51.54%	33.24%	5	5
8	臺東縣延平鄉	2018-11-24T23:00:19+08:00	974	337	1311	199	1510	2930	51.54%	33.24%	5	5
8	臺東縣延平鄉	2018-11-24T22:25:28+08:00	319	107	426	57	483	911	53.02%	35.02%	2	5
8	臺東縣延平鄉	2018-11-25T06:22:47+08:00	974	337	1311	199	1510	2930	51.54%	33.24%	5	5
8	臺東縣延平鄉	2018-11-25T03:42:51+08:00	974	337	1311	199	1510	2930	51.54%	33.24%	5	5
8	臺東縣延平鄉	2018-11-24T22:40:21+08:00	473	163	636	77	713	1490	47.85%	31.74%	3	5
8	臺東縣延平鄉	2018-11-24T23:29:49+08:00	974	337	1311	199	1510	2930	51.54%	33.24%	5	5
8	臺東縣延平鄉	2018-11-24T23:14:44+08:00	974	337	1311	199	1510	2930	51.54%	33.24%	5	5
8	臺東縣延平鄉	2018-11-24T23:50:17+08:00	974	337	1311	199	1510	2930	51.54%	33.24%	5	5
8	臺東縣延平鄉	2018-11-25T00:12:47+08:00	974	337	1311	199	1510	2930	51.54%	33.24%	5	5
8	臺東縣延平鄉	2018-11-25T01:16:25+08:00	974	337	1311	199	1510	2930	51.54%	33.24%	5	5
8	臺東縣延平鄉	2018-11-24T22:18:22+08:00	319	107	426	57	483	911	53.02%	35.02%	2	5
8	臺東縣延平鄉	2018-11-25T03:37:32+08:00	974	337	1311	199	1510	2930	51.54%	33.24%	5	5
8	臺東縣延平鄉	2018-11-24T22:39:12+08:00	473	163	636	77	713	1490	47.85%	31.74%	3	5
8	臺東縣延平鄉	2018-11-25T06:27:58+08:00	974	337	1311	199	1510	2930	51.54%	33.24%	5	5
8	臺東縣延平鄉	2018-11-25T06:17:40+08:00	974	337	1311	199	1510	2930	51.54%	33.24%	5	5
8	臺東縣延平鄉	2018-11-25T03:54:44+08:00	974	337	1311	199	1510	2930	51.54%	33.24%	5	5
8	臺東縣延平鄉	2018-11-24T23:03:49+08:00	974	337	1311	199	1510	2930	51.54%	33.24%	5	5
8	臺東縣延平鄉	2018-11-24T22:14:52+08:00	319	107	426	57	483	911	53.02%	35.02%	2	5
8	臺東縣延平鄉	2018-11-25T01:24:28+08:00	974	337	1311	199	1510	2930	51.54%	33.24%	5	5
8	臺東縣延平鄉	2018-11-24T23:37:51+08:00	974	337	1311	199	1510	2930	51.54%	33.24%	5	5
8	臺東縣延平鄉	2018-11-24T23:07:22+08:00	974	337	1311	199	1510	2930	51.54%	33.24%	5	5
8	臺東縣延平鄉	2018-11-24T22:12:05+08:00	319	107	426	57	483	911	53.02%	35.02%	2	5
8	臺東縣延平鄉	2018-11-24T23:54:30+08:00	974	337	1311	199	1510	2930	51.54%	33.24%	5	5
8	臺東縣延平鄉	2018-11-25T06:12:40+08:00	974	337	1311	199	1510	2930	51.54%	33.24%	5	5
8	臺東縣延平鄉	2018-11-24T23:42:04+08:00	974	337	1311	199	1510	2930	51.54%	33.24%	5	5
8	臺東縣延平鄉	2018-11-25T01:06:03+08:00	974	337	1311	199	1510	2930	51.54%	33.24%	5	5
8	臺東縣延平鄉	2018-11-25T01:11:11+08:00	974	337	1311	199	1510	2930	51.54%	33.24%	5	5
8	臺東縣延平鄉	2018-11-25T00:21:47+08:00	974	337	1311	199	1510	2930	51.54%	33.24%	5	5
8	臺東縣延平鄉	2018-11-25T06:07:26+08:00	974	337	1311	199	1510	2930	51.54%	33.24%	5	5
8	臺東縣延平鄉	2018-11-24T22:21:49+08:00	319	107	426	57	483	911	53.02%	35.02%	2	5
8	臺東縣延平鄉	2018-11-25T00:03:38+08:00	974	337	1311	199	1510	2930	51.54%	33.24%	5	5
8	臺東縣延平鄉	2018-11-24T22:43:53+08:00	473	163	636	77	713	1490	47.85%	31.74%	3	5
8	臺東縣延平鄉	2018-11-24T22:35:47+08:00	319	107	426	57	483	911	53.02%	35.02%	2	5
8	臺東縣延平鄉	2018-11-24T23:58:45+08:00	974	337	1311	199	1510	2930	51.54%	33.24%	5	5
8	臺東縣延平鄉	2018-11-25T01:01:05+08:00	974	337	1311	199	1510	2930	51.54%	33.24%	5	5
8	臺東縣延平鄉	2018-11-25T00:56:16+08:00	974	337	1311	199	1510	2930	51.54%	33.24%	5	5
8	臺東縣延平鄉	2018-11-25T03:31:02+08:00	974	337	1311	199	1510	2930	51.54%	33.24%	5	5
8	臺東縣關山鎮	2018-11-24T22:14:51+08:00	2662	701	3363	313	3676	7509	48.95%	35.45%	9	9
8	臺東縣關山鎮	2018-11-24T22:56:38+08:00	2662	701	3363	313	3676	7509	48.95%	35.45%	9	9
8	臺東縣關山鎮	2018-11-24T23:07:21+08:00	2662	701	3363	313	3676	7509	48.95%	35.45%	9	9
8	臺東縣關山鎮	2018-11-24T22:49:26+08:00	2662	701	3363	313	3676	7509	48.95%	35.45%	9	9
8	臺東縣關山鎮	2018-11-24T23:10:58+08:00	2662	701	3363	313	3676	7509	48.95%	35.45%	9	9
8	臺東縣關山鎮	2018-11-24T23:33:53+08:00	2662	701	3363	313	3676	7509	48.95%	35.45%	9	9
8	臺東縣關山鎮	2018-11-24T23:22:26+08:00	2662	701	3363	313	3676	7509	48.95%	35.45%	9	9
8	臺東縣關山鎮	2018-11-24T22:28:43+08:00	2662	701	3363	313	3676	7509	48.95%	35.45%	9	9
8	臺東縣關山鎮	2018-11-24T23:18:30+08:00	2662	701	3363	313	3676	7509	48.95%	35.45%	9	9
8	臺東縣關山鎮	2018-11-25T06:17:39+08:00	2662	701	3363	313	3676	7509	48.95%	35.45%	9	9
8	臺東縣關山鎮	2018-11-25T00:17:11+08:00	2662	701	3363	313	3676	7509	48.95%	35.45%	9	9
8	臺東縣關山鎮	2018-11-24T23:46:06+08:00	2662	701	3363	313	3676	7509	48.95%	35.45%	9	9
8	臺東縣關山鎮	2018-11-25T00:08:07+08:00	2662	701	3363	313	3676	7509	48.95%	35.45%	9	9
8	臺東縣關山鎮	2018-11-24T22:32:20+08:00	2662	701	3363	313	3676	7509	48.95%	35.45%	9	9
8	臺東縣關山鎮	2018-11-24T22:53:18+08:00	2662	701	3363	313	3676	7509	48.95%	35.45%	9	9
8	臺東縣關山鎮	2018-11-25T04:01:32+08:00	2662	701	3363	313	3676	7509	48.95%	35.45%	9	9
8	臺東縣關山鎮	2018-11-25T03:48:34+08:00	2662	701	3363	313	3676	7509	48.95%	35.45%	9	9
8	臺東縣關山鎮	2018-11-24T23:00:19+08:00	2662	701	3363	313	3676	7509	48.95%	35.45%	9	9
8	臺東縣關山鎮	2018-11-25T06:07:25+08:00	2662	701	3363	313	3676	7509	48.95%	35.45%	9	9
8	臺東縣關山鎮	2018-11-24T22:25:28+08:00	2662	701	3363	313	3676	7509	48.95%	35.45%	9	9
8	臺東縣關山鎮	2018-11-25T06:22:47+08:00	2662	701	3363	313	3676	7509	48.95%	35.45%	9	9
8	臺東縣關山鎮	2018-11-25T03:42:51+08:00	2662	701	3363	313	3676	7509	48.95%	35.45%	9	9
8	臺東縣關山鎮	2018-11-24T22:40:21+08:00	2662	701	3363	313	3676	7509	48.95%	35.45%	9	9
8	臺東縣關山鎮	2018-11-24T23:29:49+08:00	2662	701	3363	313	3676	7509	48.95%	35.45%	9	9
8	臺東縣關山鎮	2018-11-24T23:50:17+08:00	2662	701	3363	313	3676	7509	48.95%	35.45%	9	9
8	臺東縣關山鎮	2018-11-24T23:14:43+08:00	2662	701	3363	313	3676	7509	48.95%	35.45%	9	9
8	臺東縣關山鎮	2018-11-25T00:12:47+08:00	2662	701	3363	313	3676	7509	48.95%	35.45%	9	9
8	臺東縣關山鎮	2018-11-24T23:54:29+08:00	2662	701	3363	313	3676	7509	48.95%	35.45%	9	9
8	臺東縣關山鎮	2018-11-25T06:27:57+08:00	2662	701	3363	313	3676	7509	48.95%	35.45%	9	9
8	臺東縣關山鎮	2018-11-25T01:16:25+08:00	2662	701	3363	313	3676	7509	48.95%	35.45%	9	9
8	臺東縣關山鎮	2018-11-24T22:18:22+08:00	2662	701	3363	313	3676	7509	48.95%	35.45%	9	9
8	臺東縣關山鎮	2018-11-25T03:37:32+08:00	2662	701	3363	313	3676	7509	48.95%	35.45%	9	9
8	臺東縣關山鎮	2018-11-25T01:24:27+08:00	2662	701	3363	313	3676	7509	48.95%	35.45%	9	9
8	臺東縣關山鎮	2018-11-25T03:54:44+08:00	2662	701	3363	313	3676	7509	48.95%	35.45%	9	9
8	臺東縣關山鎮	2018-11-24T23:03:49+08:00	2662	701	3363	313	3676	7509	48.95%	35.45%	9	9
8	臺東縣關山鎮	2018-11-24T23:37:51+08:00	2662	701	3363	313	3676	7509	48.95%	35.45%	9	9
8	臺東縣關山鎮	2018-11-24T22:12:05+08:00	2662	701	3363	313	3676	7509	48.95%	35.45%	9	9
8	臺東縣關山鎮	2018-11-25T01:06:02+08:00	2662	701	3363	313	3676	7509	48.95%	35.45%	9	9
8	臺東縣關山鎮	2018-11-24T23:42:04+08:00	2662	701	3363	313	3676	7509	48.95%	35.45%	9	9
8	臺東縣關山鎮	2018-11-25T01:11:10+08:00	2662	701	3363	313	3676	7509	48.95%	35.45%	9	9
8	臺東縣關山鎮	2018-11-25T06:12:39+08:00	2662	701	3363	313	3676	7509	48.95%	35.45%	9	9
8	臺東縣關山鎮	2018-11-25T00:21:46+08:00	2662	701	3363	313	3676	7509	48.95%	35.45%	9	9
8	臺東縣關山鎮	2018-11-24T22:21:49+08:00	2662	701	3363	313	3676	7509	48.95%	35.45%	9	9
8	臺東縣關山鎮	2018-11-25T01:01:04+08:00	2662	701	3363	313	3676	7509	48.95%	35.45%	9	9
8	臺東縣關山鎮	2018-11-25T00:03:38+08:00	2662	701	3363	313	3676	7509	48.95%	35.45%	9	9
8	臺東縣關山鎮	2018-11-24T22:43:53+08:00	2662	701	3363	313	3676	7509	48.95%	35.45%	9	9
8	臺東縣關山鎮	2018-11-24T22:35:47+08:00	2662	701	3363	313	3676	7509	48.95%	35.45%	9	9
8	臺東縣關山鎮	2018-11-24T23:58:45+08:00	2662	701	3363	313	3676	7509	48.95%	35.45%	9	9
8	臺東縣關山鎮	2018-11-25T00:56:16+08:00	2662	701	3363	313	3676	7509	48.95%	35.45%	9	9
8	臺東縣關山鎮	2018-11-24T22:39:11+08:00	2662	701	3363	313	3676	7509	48.95%	35.45%	9	9
8	臺東縣關山鎮	2018-11-24T23:26:09+08:00	2662	701	3363	313	3676	7509	48.95%	35.45%	9	9
8	臺東縣關山鎮	2018-11-25T03:31:02+08:00	2662	701	3363	313	3676	7509	48.95%	35.45%	9	9
8	彰化縣	2018-11-25T03:37:26+08:00	427390	128963	556353	52105	608458	1066994	57.03%	40.06%	049	1
8	彰化縣	2018-11-24T23:07:16+08:00	281401	84449	365850	35502	401352	708183	56.67%	39.74%	729	1
8	彰化縣	2018-11-24T22:12:00+08:00	165774	49665	215439	21483	236922	421396	56.22%	39.34%	456	1
8	彰化縣	2018-11-24T22:39:07+08:00	224127	67224	291351	28726	320077	567755	56.38%	39.48%	596	1
8	彰化縣	2018-11-24T23:03:45+08:00	278286	83366	361652	35120	396772	700258	56.66%	39.74%	722	1
8	彰化縣	2018-11-24T23:22:21+08:00	316226	95079	411305	39739	451044	794620	56.76%	39.8%	809	1
8	彰化縣	2018-11-25T01:24:22+08:00	417081	125678	542759	50987	593746	1042333	56.96%	40.01%	027	1
8	彰化縣	2018-11-25T01:00:59+08:00	412181	124220	536401	50443	586844	1030295	56.96%	40.01%	016	1
8	彰化縣	2018-11-24T23:42:00+08:00	337494	101463	438957	42210	481167	847173	56.8%	39.84%	859	1
8	彰化縣	2018-11-25T03:30:56+08:00	427390	128963	556353	52105	608458	1066994	57.03%	40.06%	049	1
8	彰化縣	2018-11-24T22:32:16+08:00	211388	63427	274815	27147	301962	534724	56.47%	39.53%	565	1
8	彰化縣	2018-11-25T03:48:27+08:00	427390	128963	556353	52105	608458	1066994	57.03%	40.06%	049	1
8	彰化縣	2018-11-24T22:25:21+08:00	197679	59272	256951	25366	282317	499969	56.47%	39.54%	530	1
8	彰化縣	2018-11-25T04:01:27+08:00	427390	128963	556353	52105	608458	1066994	57.03%	40.06%	049	1
8	彰化縣	2018-11-24T22:21:43+08:00	192125	57421	249546	24662	274208	486014	56.42%	39.53%	517	1
8	彰化縣	2018-11-24T22:40:17+08:00	232400	69468	301868	29609	331477	587196	56.45%	39.58%	615	1
8	彰化縣	2018-11-25T00:21:42+08:00	383968	115883	499851	47279	547130	962216	56.86%	39.9%	956	1
8	彰化縣	2018-11-25T06:12:35+08:00	427390	128963	556353	52105	608458	1066994	57.03%	40.06%	049	1
8	彰化縣	2018-11-25T00:03:32+08:00	365695	110469	476164	45254	521418	917012	56.86%	39.88%	920	1
8	彰化縣	2018-11-24T23:58:40+08:00	361784	108837	470621	44786	515407	906718	56.84%	39.9%	911	1
8	彰化縣	2018-11-24T23:26:05+08:00	319547	96075	415622	40103	455725	802551	56.78%	39.82%	816	1
8	彰化縣	2018-11-24T23:37:47+08:00	334642	100597	435239	41855	477094	840137	56.79%	39.83%	852	1
8	彰化縣	2018-11-24T23:18:25+08:00	305186	91636	396822	38223	435045	766747	56.74%	39.8%	784	1
8	彰化縣	2018-11-24T22:35:43+08:00	218786	65566	284352	28042	312394	553902	56.4%	39.5%	582	1
8	彰化縣	2018-11-24T23:33:48+08:00	330902	99445	430347	41406	471753	830983	56.77%	39.82%	843	1
8	彰化縣	2018-11-25T03:54:38+08:00	427390	128963	556353	52105	608458	1066994	57.03%	40.06%	049	1
8	彰化縣	2018-11-24T22:43:48+08:00	239224	71505	310729	30562	341291	604651	56.44%	39.56%	632	1
8	彰化縣	2018-11-24T23:10:54+08:00	289393	86774	376167	36411	412578	727338	56.72%	39.79%	746	1
8	彰化縣	2018-11-25T06:17:34+08:00	427390	128963	556353	52105	608458	1066994	57.03%	40.06%	049	1
8	彰化縣	2018-11-24T22:56:34+08:00	263606	78866	342472	33318	375790	664363	56.56%	39.68%	688	1
8	彰化縣	2018-11-24T23:14:38+08:00	296210	88902	385112	37311	422423	744385	56.75%	39.79%	762	1
8	彰化縣	2018-11-24T22:49:22+08:00	252186	75431	327617	32031	359648	636395	56.51%	39.63%	662	1
8	彰化縣	2018-11-24T23:46:02+08:00	346445	104349	450794	43234	494028	869307	56.83%	39.85%	879	1
8	彰化縣	2018-11-25T00:08:02+08:00	368623	111334	479957	45601	525558	924171	56.87%	39.89%	925	1
8	彰化縣	2018-11-24T22:53:12+08:00	257646	77082	334728	32587	367315	649827	56.53%	39.65%	675	1
8	彰化縣	2018-11-25T03:42:46+08:00	427390	128963	556353	52105	608458	1066994	57.03%	40.06%	049	1
8	彰化縣	2018-11-25T06:22:43+08:00	427390	128963	556353	52105	608458	1066994	57.03%	40.06%	049	1
8	彰化縣	2018-11-24T23:29:44+08:00	321258	96579	417837	40315	458152	806896	56.78%	39.81%	821	1
8	彰化縣	2018-11-25T00:17:06+08:00	376963	113862	490825	46493	537318	944950	56.86%	39.89%	942	1
8	彰化縣	2018-11-25T01:11:04+08:00	414617	124966	539583	50749	590332	1036723	56.94%	39.99%	022	1
8	彰化縣	2018-11-25T06:07:20+08:00	427390	128963	556353	52105	608458	1066994	57.03%	40.06%	049	1
8	彰化縣	2018-11-24T23:00:15+08:00	268688	80479	349167	33955	383122	677020	56.59%	39.69%	700	1
8	彰化縣	2018-11-25T00:12:43+08:00	373920	113032	486952	46168	533120	937662	56.86%	39.88%	936	1
8	彰化縣	2018-11-24T22:28:38+08:00	205533	61586	267119	26409	293528	519728	56.48%	39.55%	549	1
8	彰化縣	2018-11-25T06:27:53+08:00	427390	128963	556353	52105	608458	1066994	57.03%	40.06%	049	1
8	彰化縣	2018-11-24T23:50:13+08:00	351553	105892	457445	43758	501203	881857	56.83%	39.87%	890	1
8	彰化縣	2018-11-24T23:54:25+08:00	354650	106790	461440	44111	505551	889388	56.84%	39.88%	897	1
8	彰化縣	2018-11-25T01:05:57+08:00	413024	124489	537513	50544	588057	1032406	56.96%	40.01%	018	1
8	彰化縣	2018-11-24T22:14:46+08:00	170792	51121	221913	22094	244007	434212	56.2%	39.33%	468	1
8	彰化縣	2018-11-25T00:56:11+08:00	411696	124077	535773	50379	586152	1029079	56.96%	40.01%	015	1
8	彰化縣	2018-11-24T22:18:17+08:00	179603	53630	233233	23127	256360	455746	56.25%	39.41%	488	1
8	彰化縣	2018-11-25T01:16:19+08:00	416029	125370	541399	50884	592283	1040082	56.95%	40%	025	1
8	臺中市烏日區	2018-11-24T23:10:50+08:00	22402	6450	28852	2371	31223	54084	57.73%	41.42%	36	40
8	臺中市烏日區	2018-11-25T00:56:06+08:00	25559	7417	32976	2718	35694	61705	57.85%	41.42%	40	40
8	臺中市烏日區	2018-11-24T23:14:33+08:00	22402	6450	28852	2371	31223	54084	57.73%	41.42%	36	40
8	臺中市烏日區	2018-11-24T23:22:16+08:00	24879	7194	32073	2624	34697	60131	57.7%	41.37%	39	40
8	臺中市烏日區	2018-11-24T22:56:31+08:00	22402	6450	28852	2371	31223	54084	57.73%	41.42%	36	40
8	臺中市烏日區	2018-11-25T00:12:39+08:00	25559	7417	32976	2718	35694	61705	57.85%	41.42%	40	40
8	臺中市烏日區	2018-11-24T22:49:17+08:00	22402	6450	28852	2371	31223	54084	57.73%	41.42%	36	40
8	臺中市烏日區	2018-11-25T03:37:18+08:00	25559	7417	32976	2718	35694	61705	57.85%	41.42%	40	40
8	臺中市烏日區	2018-11-24T22:43:44+08:00	20241	5866	26107	2202	28309	48768	58.05%	41.5%	33	40
8	臺中市烏日區	2018-11-25T00:03:26+08:00	25559	7417	32976	2718	35694	61705	57.85%	41.42%	40	40
8	臺中市烏日區	2018-11-25T01:10:59+08:00	25559	7417	32976	2718	35694	61705	57.85%	41.42%	40	40
8	臺中市烏日區	2018-11-25T06:22:39+08:00	25559	7417	32976	2718	35694	61705	57.85%	41.42%	40	40
8	臺中市烏日區	2018-11-24T22:25:17+08:00	17662	5174	22836	1966	24802	42589	58.24%	41.47%	29	40
8	臺中市烏日區	2018-11-24T23:29:40+08:00	25559	7417	32976	2718	35694	61705	57.85%	41.42%	40	40
8	臺中市烏日區	2018-11-25T00:17:02+08:00	25559	7417	32976	2718	35694	61705	57.85%	41.42%	40	40
8	臺中市烏日區	2018-11-25T00:07:58+08:00	25559	7417	32976	2718	35694	61705	57.85%	41.42%	40	40
8	臺中市烏日區	2018-11-25T01:16:15+08:00	25559	7417	32976	2718	35694	61705	57.85%	41.42%	40	40
8	臺中市烏日區	2018-11-25T01:05:52+08:00	25559	7417	32976	2718	35694	61705	57.85%	41.42%	40	40
8	臺中市烏日區	2018-11-24T22:14:42+08:00	14869	4416	19285	1642	20927	36024	58.09%	41.28%	25	40
8	臺中市烏日區	2018-11-24T23:54:19+08:00	25559	7417	32976	2718	35694	61705	57.85%	41.42%	40	40
8	臺中市烏日區	2018-11-24T22:28:34+08:00	17662	5174	22836	1966	24802	42589	58.24%	41.47%	29	40
8	臺中市烏日區	2018-11-24T22:18:13+08:00	15611	4607	20218	1741	21959	37846	58.02%	41.25%	26	40
8	臺中市烏日區	2018-11-25T01:24:17+08:00	25559	7417	32976	2718	35694	61705	57.85%	41.42%	40	40
8	臺中市烏日區	2018-11-24T22:35:39+08:00	18309	5395	23704	2041	25745	44297	58.12%	41.33%	30	40
8	臺中市烏日區	2018-11-24T23:50:09+08:00	25559	7417	32976	2718	35694	61705	57.85%	41.42%	40	40
8	臺中市烏日區	2018-11-24T23:58:35+08:00	25559	7417	32976	2718	35694	61705	57.85%	41.42%	40	40
8	臺中市烏日區	2018-11-25T06:27:49+08:00	25559	7417	32976	2718	35694	61705	57.85%	41.42%	40	40
8	臺中市烏日區	2018-11-24T22:39:03+08:00	19492	5674	25166	2143	27309	47077	58.01%	41.4%	32	40
8	臺中市烏日區	2018-11-24T23:03:41+08:00	22402	6450	28852	2371	31223	54084	57.73%	41.42%	36	40
8	臺中市烏日區	2018-11-24T23:07:13+08:00	22402	6450	28852	2371	31223	54084	57.73%	41.42%	36	40
8	臺中市烏日區	2018-11-25T01:00:53+08:00	25559	7417	32976	2718	35694	61705	57.85%	41.42%	40	40
8	臺中市烏日區	2018-11-24T23:00:08+08:00	22402	6450	28852	2371	31223	54084	57.73%	41.42%	36	40
8	臺中市烏日區	2018-11-25T03:48:22+08:00	25559	7417	32976	2718	35694	61705	57.85%	41.42%	40	40
8	臺中市烏日區	2018-11-25T00:21:37+08:00	25559	7417	32976	2718	35694	61705	57.85%	41.42%	40	40
8	臺中市烏日區	2018-11-25T03:30:52+08:00	25559	7417	32976	2718	35694	61705	57.85%	41.42%	40	40
8	臺中市烏日區	2018-11-25T03:42:41+08:00	25559	7417	32976	2718	35694	61705	57.85%	41.42%	40	40
8	臺中市烏日區	2018-11-24T22:21:39+08:00	17662	5174	22836	1966	24802	42589	58.24%	41.47%	29	40
8	臺中市烏日區	2018-11-24T22:32:12+08:00	17662	5174	22836	1966	24802	42589	58.24%	41.47%	29	40
8	臺中市烏日區	2018-11-24T22:53:08+08:00	22402	6450	28852	2371	31223	54084	57.73%	41.42%	36	40
8	臺中市烏日區	2018-11-25T04:01:22+08:00	25559	7417	32976	2718	35694	61705	57.85%	41.42%	40	40
8	臺中市烏日區	2018-11-24T22:11:57+08:00	14869	4416	19285	1642	20927	36024	58.09%	41.28%	25	40
8	臺中市烏日區	2018-11-24T22:40:13+08:00	20241	5866	26107	2202	28309	48768	58.05%	41.5%	33	40
8	臺中市烏日區	2018-11-25T06:12:31+08:00	25559	7417	32976	2718	35694	61705	57.85%	41.42%	40	40
8	臺中市烏日區	2018-11-25T06:07:16+08:00	25559	7417	32976	2718	35694	61705	57.85%	41.42%	40	40
8	臺中市烏日區	2018-11-24T23:33:44+08:00	25559	7417	32976	2718	35694	61705	57.85%	41.42%	40	40
8	臺中市烏日區	2018-11-24T23:26:01+08:00	24879	7194	32073	2624	34697	60131	57.7%	41.37%	39	40
8	臺中市烏日區	2018-11-25T03:54:34+08:00	25559	7417	32976	2718	35694	61705	57.85%	41.42%	40	40
8	臺中市烏日區	2018-11-24T23:45:58+08:00	25559	7417	32976	2718	35694	61705	57.85%	41.42%	40	40
8	臺中市烏日區	2018-11-25T06:17:29+08:00	25559	7417	32976	2718	35694	61705	57.85%	41.42%	40	40
8	臺中市烏日區	2018-11-24T23:41:56+08:00	25559	7417	32976	2718	35694	61705	57.85%	41.42%	40	40
8	臺中市烏日區	2018-11-24T23:37:43+08:00	25559	7417	32976	2718	35694	61705	57.85%	41.42%	40	40
8	臺中市烏日區	2018-11-24T23:18:21+08:00	22402	6450	28852	2371	31223	54084	57.73%	41.42%	36	40
8	屏東縣泰武鄉	2018-11-24T23:07:20+08:00	1791	580	2371	325	2696	4344	62.06%	41.23%	7	7
8	屏東縣泰武鄉	2018-11-24T23:10:57+08:00	1791	580	2371	325	2696	4344	62.06%	41.23%	7	7
8	屏東縣泰武鄉	2018-11-24T22:14:50+08:00	1508	488	1996	258	2254	3746	60.17%	40.26%	6	7
8	屏東縣泰武鄉	2018-11-25T06:17:37+08:00	1791	580	2371	325	2696	4344	62.06%	41.23%	7	7
8	屏東縣泰武鄉	2018-11-24T22:56:37+08:00	1791	580	2371	325	2696	4344	62.06%	41.23%	7	7
8	屏東縣泰武鄉	2018-11-24T22:32:19+08:00	1508	488	1996	258	2254	3746	60.17%	40.26%	6	7
8	屏東縣泰武鄉	2018-11-25T01:06:01+08:00	1791	580	2371	325	2696	4344	62.06%	41.23%	7	7
8	屏東縣泰武鄉	2018-11-24T22:53:16+08:00	1791	580	2371	325	2696	4344	62.06%	41.23%	7	7
8	屏東縣泰武鄉	2018-11-25T00:08:06+08:00	1791	580	2371	325	2696	4344	62.06%	41.23%	7	7
8	屏東縣泰武鄉	2018-11-24T22:25:26+08:00	1508	488	1996	258	2254	3746	60.17%	40.26%	6	7
8	屏東縣泰武鄉	2018-11-24T23:29:48+08:00	1791	580	2371	325	2696	4344	62.06%	41.23%	7	7
8	屏東縣泰武鄉	2018-11-24T22:40:20+08:00	1791	580	2371	325	2696	4344	62.06%	41.23%	7	7
8	屏東縣泰武鄉	2018-11-25T06:22:46+08:00	1791	580	2371	325	2696	4344	62.06%	41.23%	7	7
8	屏東縣泰武鄉	2018-11-25T06:07:24+08:00	1791	580	2371	325	2696	4344	62.06%	41.23%	7	7
8	屏東縣泰武鄉	2018-11-24T23:00:18+08:00	1791	580	2371	325	2696	4344	62.06%	41.23%	7	7
8	屏東縣泰武鄉	2018-11-25T03:48:32+08:00	1791	580	2371	325	2696	4344	62.06%	41.23%	7	7
8	屏東縣泰武鄉	2018-11-25T03:42:50+08:00	1791	580	2371	325	2696	4344	62.06%	41.23%	7	7
8	屏東縣泰武鄉	2018-11-25T00:21:45+08:00	1791	580	2371	325	2696	4344	62.06%	41.23%	7	7
8	屏東縣泰武鄉	2018-11-25T01:11:09+08:00	1791	580	2371	325	2696	4344	62.06%	41.23%	7	7
8	屏東縣泰武鄉	2018-11-25T03:31:00+08:00	1791	580	2371	325	2696	4344	62.06%	41.23%	7	7
8	屏東縣泰武鄉	2018-11-25T01:16:23+08:00	1791	580	2371	325	2696	4344	62.06%	41.23%	7	7
8	屏東縣泰武鄉	2018-11-24T23:14:42+08:00	1791	580	2371	325	2696	4344	62.06%	41.23%	7	7
8	屏東縣泰武鄉	2018-11-24T23:50:16+08:00	1791	580	2371	325	2696	4344	62.06%	41.23%	7	7
8	屏東縣泰武鄉	2018-11-24T22:43:51+08:00	1791	580	2371	325	2696	4344	62.06%	41.23%	7	7
8	屏東縣泰武鄉	2018-11-25T06:27:56+08:00	1791	580	2371	325	2696	4344	62.06%	41.23%	7	7
8	屏東縣泰武鄉	2018-11-25T00:56:15+08:00	1791	580	2371	325	2696	4344	62.06%	41.23%	7	7
8	屏東縣泰武鄉	2018-11-25T00:12:46+08:00	1791	580	2371	325	2696	4344	62.06%	41.23%	7	7
8	屏東縣泰武鄉	2018-11-24T23:54:28+08:00	1791	580	2371	325	2696	4344	62.06%	41.23%	7	7
8	屏東縣泰武鄉	2018-11-24T23:37:50+08:00	1791	580	2371	325	2696	4344	62.06%	41.23%	7	7
8	屏東縣泰武鄉	2018-11-24T23:22:24+08:00	1791	580	2371	325	2696	4344	62.06%	41.23%	7	7
8	屏東縣泰武鄉	2018-11-24T22:28:41+08:00	1508	488	1996	258	2254	3746	60.17%	40.26%	6	7
8	屏東縣泰武鄉	2018-11-24T22:12:04+08:00	1508	488	1996	258	2254	3746	60.17%	40.26%	6	7
8	屏東縣泰武鄉	2018-11-24T23:33:51+08:00	1791	580	2371	325	2696	4344	62.06%	41.23%	7	7
8	屏東縣泰武鄉	2018-11-25T01:24:26+08:00	1791	580	2371	325	2696	4344	62.06%	41.23%	7	7
8	屏東縣泰武鄉	2018-11-25T03:54:42+08:00	1791	580	2371	325	2696	4344	62.06%	41.23%	7	7
8	屏東縣泰武鄉	2018-11-24T23:03:48+08:00	1791	580	2371	325	2696	4344	62.06%	41.23%	7	7
8	屏東縣泰武鄉	2018-11-24T22:49:25+08:00	1791	580	2371	325	2696	4344	62.06%	41.23%	7	7
8	屏東縣泰武鄉	2018-11-24T23:42:03+08:00	1791	580	2371	325	2696	4344	62.06%	41.23%	7	7
8	屏東縣泰武鄉	2018-11-25T04:01:30+08:00	1791	580	2371	325	2696	4344	62.06%	41.23%	7	7
8	屏東縣泰武鄉	2018-11-24T23:46:05+08:00	1791	580	2371	325	2696	4344	62.06%	41.23%	7	7
8	屏東縣泰武鄉	2018-11-25T00:17:09+08:00	1791	580	2371	325	2696	4344	62.06%	41.23%	7	7
8	屏東縣泰武鄉	2018-11-25T06:12:38+08:00	1791	580	2371	325	2696	4344	62.06%	41.23%	7	7
8	屏東縣泰武鄉	2018-11-24T22:21:47+08:00	1508	488	1996	258	2254	3746	60.17%	40.26%	6	7
8	屏東縣泰武鄉	2018-11-25T01:01:03+08:00	1791	580	2371	325	2696	4344	62.06%	41.23%	7	7
8	屏東縣泰武鄉	2018-11-24T22:39:10+08:00	1508	488	1996	258	2254	3746	60.17%	40.26%	6	7
8	屏東縣泰武鄉	2018-11-24T23:26:08+08:00	1791	580	2371	325	2696	4344	62.06%	41.23%	7	7
8	屏東縣泰武鄉	2018-11-24T22:35:46+08:00	1508	488	1996	258	2254	3746	60.17%	40.26%	6	7
8	屏東縣泰武鄉	2018-11-24T23:58:44+08:00	1791	580	2371	325	2696	4344	62.06%	41.23%	7	7
8	屏東縣泰武鄉	2018-11-25T00:03:36+08:00	1791	580	2371	325	2696	4344	62.06%	41.23%	7	7
8	屏東縣泰武鄉	2018-11-25T03:37:31+08:00	1791	580	2371	325	2696	4344	62.06%	41.23%	7	7
8	屏東縣泰武鄉	2018-11-24T22:18:21+08:00	1508	488	1996	258	2254	3746	60.17%	40.26%	6	7
8	屏東縣泰武鄉	2018-11-24T23:18:28+08:00	1791	580	2371	325	2696	4344	62.06%	41.23%	7	7
8	宜蘭縣大同鄉	2018-11-24T22:14:51+08:00	1131	337	1468	205	1673	3358	49.82%	33.68%	8	10
8	宜蘭縣大同鄉	2018-11-24T23:33:52+08:00	1581	471	2052	273	2325	4935	47.11%	32.04%	10	10
8	宜蘭縣大同鄉	2018-11-24T23:10:57+08:00	1581	471	2052	273	2325	4935	47.11%	32.04%	10	10
8	宜蘭縣大同鄉	2018-11-25T06:17:38+08:00	1581	471	2052	273	2325	4935	47.11%	32.04%	10	10
8	宜蘭縣大同鄉	2018-11-24T22:28:42+08:00	1131	337	1468	205	1673	3358	49.82%	33.68%	8	10
8	宜蘭縣大同鄉	2018-11-24T22:56:38+08:00	1581	471	2052	273	2325	4935	47.11%	32.04%	10	10
8	宜蘭縣大同鄉	2018-11-24T23:07:21+08:00	1581	471	2052	273	2325	4935	47.11%	32.04%	10	10
8	宜蘭縣大同鄉	2018-11-24T22:49:26+08:00	1581	471	2052	273	2325	4935	47.11%	32.04%	10	10
8	宜蘭縣大同鄉	2018-11-24T22:53:17+08:00	1581	471	2052	273	2325	4935	47.11%	32.04%	10	10
8	宜蘭縣大同鄉	2018-11-24T22:32:20+08:00	1131	337	1468	205	1673	3358	49.82%	33.68%	8	10
8	宜蘭縣大同鄉	2018-11-25T00:17:10+08:00	1581	471	2052	273	2325	4935	47.11%	32.04%	10	10
8	宜蘭縣大同鄉	2018-11-25T00:08:06+08:00	1581	471	2052	273	2325	4935	47.11%	32.04%	10	10
8	宜蘭縣大同鄉	2018-11-25T03:48:33+08:00	1581	471	2052	273	2325	4935	47.11%	32.04%	10	10
8	宜蘭縣大同鄉	2018-11-25T06:07:25+08:00	1581	471	2052	273	2325	4935	47.11%	32.04%	10	10
8	宜蘭縣大同鄉	2018-11-24T23:29:48+08:00	1581	471	2052	273	2325	4935	47.11%	32.04%	10	10
8	宜蘭縣大同鄉	2018-11-24T22:40:20+08:00	1581	471	2052	273	2325	4935	47.11%	32.04%	10	10
8	宜蘭縣大同鄉	2018-11-25T06:22:46+08:00	1581	471	2052	273	2325	4935	47.11%	32.04%	10	10
8	宜蘭縣大同鄉	2018-11-24T23:00:18+08:00	1581	471	2052	273	2325	4935	47.11%	32.04%	10	10
8	宜蘭縣大同鄉	2018-11-24T22:25:27+08:00	1131	337	1468	205	1673	3358	49.82%	33.68%	8	10
8	宜蘭縣大同鄉	2018-11-25T03:42:50+08:00	1581	471	2052	273	2325	4935	47.11%	32.04%	10	10
8	宜蘭縣大同鄉	2018-11-25T01:11:09+08:00	1581	471	2052	273	2325	4935	47.11%	32.04%	10	10
8	宜蘭縣大同鄉	2018-11-24T23:14:43+08:00	1581	471	2052	273	2325	4935	47.11%	32.04%	10	10
8	宜蘭縣大同鄉	2018-11-25T01:16:24+08:00	1581	471	2052	273	2325	4935	47.11%	32.04%	10	10
8	宜蘭縣大同鄉	2018-11-24T23:54:29+08:00	1581	471	2052	273	2325	4935	47.11%	32.04%	10	10
8	宜蘭縣大同鄉	2018-11-25T06:27:57+08:00	1581	471	2052	273	2325	4935	47.11%	32.04%	10	10
8	宜蘭縣大同鄉	2018-11-25T03:31:01+08:00	1581	471	2052	273	2325	4935	47.11%	32.04%	10	10
8	宜蘭縣大同鄉	2018-11-24T23:50:16+08:00	1581	471	2052	273	2325	4935	47.11%	32.04%	10	10
8	宜蘭縣大同鄉	2018-11-25T00:56:15+08:00	1581	471	2052	273	2325	4935	47.11%	32.04%	10	10
8	宜蘭縣大同鄉	2018-11-25T00:12:46+08:00	1581	471	2052	273	2325	4935	47.11%	32.04%	10	10
8	宜蘭縣大同鄉	2018-11-24T23:37:50+08:00	1581	471	2052	273	2325	4935	47.11%	32.04%	10	10
8	宜蘭縣大同鄉	2018-11-25T01:24:27+08:00	1581	471	2052	273	2325	4935	47.11%	32.04%	10	10
8	宜蘭縣大同鄉	2018-11-25T03:54:43+08:00	1581	471	2052	273	2325	4935	47.11%	32.04%	10	10
8	宜蘭縣大同鄉	2018-11-24T23:03:49+08:00	1581	471	2052	273	2325	4935	47.11%	32.04%	10	10
8	宜蘭縣大同鄉	2018-11-24T22:12:04+08:00	1131	337	1468	205	1673	3358	49.82%	33.68%	8	10
8	宜蘭縣大同鄉	2018-11-24T23:22:25+08:00	1581	471	2052	273	2325	4935	47.11%	32.04%	10	10
8	宜蘭縣大同鄉	2018-11-25T01:06:02+08:00	1581	471	2052	273	2325	4935	47.11%	32.04%	10	10
8	宜蘭縣大同鄉	2018-11-24T23:42:03+08:00	1581	471	2052	273	2325	4935	47.11%	32.04%	10	10
8	宜蘭縣大同鄉	2018-11-24T23:46:05+08:00	1581	471	2052	273	2325	4935	47.11%	32.04%	10	10
8	宜蘭縣大同鄉	2018-11-25T04:01:31+08:00	1581	471	2052	273	2325	4935	47.11%	32.04%	10	10
8	宜蘭縣大同鄉	2018-11-25T06:12:39+08:00	1581	471	2052	273	2325	4935	47.11%	32.04%	10	10
8	宜蘭縣大同鄉	2018-11-24T22:21:48+08:00	1131	337	1468	205	1673	3358	49.82%	33.68%	8	10
8	宜蘭縣大同鄉	2018-11-25T00:21:46+08:00	1581	471	2052	273	2325	4935	47.11%	32.04%	10	10
8	宜蘭縣大同鄉	2018-11-25T01:01:03+08:00	1581	471	2052	273	2325	4935	47.11%	32.04%	10	10
8	宜蘭縣大同鄉	2018-11-24T22:35:46+08:00	1360	417	1777	254	2031	4251	47.78%	31.99%	9	10
8	宜蘭縣大同鄉	2018-11-24T23:58:44+08:00	1581	471	2052	273	2325	4935	47.11%	32.04%	10	10
8	宜蘭縣大同鄉	2018-11-24T23:18:29+08:00	1581	471	2052	273	2325	4935	47.11%	32.04%	10	10
8	宜蘭縣大同鄉	2018-11-25T03:37:31+08:00	1581	471	2052	273	2325	4935	47.11%	32.04%	10	10
8	宜蘭縣大同鄉	2018-11-24T22:18:21+08:00	1131	337	1468	205	1673	3358	49.82%	33.68%	8	10
8	宜蘭縣大同鄉	2018-11-24T22:39:11+08:00	1581	471	2052	273	2325	4935	47.11%	32.04%	10	10
8	宜蘭縣大同鄉	2018-11-24T23:26:09+08:00	1581	471	2052	273	2325	4935	47.11%	32.04%	10	10
8	宜蘭縣大同鄉	2018-11-25T00:03:37+08:00	1581	471	2052	273	2325	4935	47.11%	32.04%	10	10
8	宜蘭縣大同鄉	2018-11-24T22:43:52+08:00	1581	471	2052	273	2325	4935	47.11%	32.04%	10	10
8	宜蘭縣宜蘭市	2018-11-24T23:33:52+08:00	23673	6274	29947	2545	32492	57747	56.27%	40.99%	59	78
8	宜蘭縣宜蘭市	2018-11-24T23:07:20+08:00	21476	5666	27142	2318	29460	52308	56.32%	41.06%	54	78
8	宜蘭縣宜蘭市	2018-11-24T23:10:57+08:00	21476	5666	27142	2318	29460	52308	56.32%	41.06%	54	78
8	宜蘭縣宜蘭市	2018-11-25T06:17:38+08:00	32163	8747	40910	3586	44496	79167	56.21%	40.63%	78	78
8	宜蘭縣宜蘭市	2018-11-24T22:28:42+08:00	15812	4240	20052	1742	21794	38882	56.05%	40.67%	42	78
8	宜蘭縣宜蘭市	2018-11-24T22:14:50+08:00	13387	3639	17026	1486	18512	32942	56.2%	40.64%	36	78
8	宜蘭縣宜蘭市	2018-11-24T22:56:37+08:00	19177	5091	24268	2093	26361	47008	56.08%	40.8%	49	78
8	宜蘭縣宜蘭市	2018-11-25T01:06:01+08:00	32163	8747	40910	3586	44496	79167	56.21%	40.63%	78	78
8	宜蘭縣宜蘭市	2018-11-24T22:32:20+08:00	16315	4382	20697	1813	22510	40167	56.04%	40.62%	43	78
8	宜蘭縣宜蘭市	2018-11-24T22:53:16+08:00	19177	5091	24268	2093	26361	47008	56.08%	40.8%	49	78
8	宜蘭縣宜蘭市	2018-11-25T00:08:06+08:00	30309	8205	38514	3347	41861	74254	56.38%	40.82%	74	78
8	宜蘭縣宜蘭市	2018-11-24T23:29:48+08:00	22904	6048	28952	2451	31403	55886	56.19%	40.98%	57	78
8	宜蘭縣宜蘭市	2018-11-24T22:40:20+08:00	17478	4649	22127	1927	24054	42921	56.04%	40.72%	45	78
8	宜蘭縣宜蘭市	2018-11-25T06:22:46+08:00	32163	8747	40910	3586	44496	79167	56.21%	40.63%	78	78
8	宜蘭縣宜蘭市	2018-11-25T06:07:24+08:00	32163	8747	40910	3586	44496	79167	56.21%	40.63%	78	78
8	宜蘭縣宜蘭市	2018-11-24T23:00:18+08:00	20073	5284	25357	2179	27536	49066	56.12%	40.91%	51	78
8	宜蘭縣宜蘭市	2018-11-25T03:48:32+08:00	32163	8747	40910	3586	44496	79167	56.21%	40.63%	78	78
8	宜蘭縣宜蘭市	2018-11-24T22:25:27+08:00	15812	4240	20052	1742	21794	38882	56.05%	40.67%	42	78
8	宜蘭縣宜蘭市	2018-11-25T03:42:50+08:00	32163	8747	40910	3586	44496	79167	56.21%	40.63%	78	78
8	宜蘭縣宜蘭市	2018-11-25T01:11:09+08:00	32163	8747	40910	3586	44496	79167	56.21%	40.63%	78	78
8	宜蘭縣宜蘭市	2018-11-25T01:16:24+08:00	32163	8747	40910	3586	44496	79167	56.21%	40.63%	78	78
8	宜蘭縣宜蘭市	2018-11-25T03:31:01+08:00	32163	8747	40910	3586	44496	79167	56.21%	40.63%	78	78
8	宜蘭縣宜蘭市	2018-11-24T23:14:42+08:00	22442	5915	28357	2411	30768	54627	56.32%	41.08%	56	78
8	宜蘭縣宜蘭市	2018-11-24T23:50:16+08:00	27627	7438	35065	3037	38102	67536	56.42%	40.91%	68	78
8	宜蘭縣宜蘭市	2018-11-25T06:27:56+08:00	32163	8747	40910	3586	44496	79167	56.21%	40.63%	78	78
8	宜蘭縣宜蘭市	2018-11-25T00:56:15+08:00	32163	8747	40910	3586	44496	79167	56.21%	40.63%	78	78
8	宜蘭縣宜蘭市	2018-11-25T00:12:46+08:00	30774	8347	39121	3382	42503	75419	56.36%	40.8%	75	78
8	宜蘭縣宜蘭市	2018-11-24T23:54:28+08:00	27969	7535	35504	3087	38591	68430	56.39%	40.87%	69	78
8	宜蘭縣宜蘭市	2018-11-24T23:37:50+08:00	24112	6393	30505	2580	33085	58842	56.23%	40.98%	60	78
8	宜蘭縣宜蘭市	2018-11-24T22:12:04+08:00	12503	3337	15840	1359	17199	30733	55.96%	40.68%	34	78
8	宜蘭縣宜蘭市	2018-11-24T23:22:25+08:00	22904	6048	28952	2451	31403	55886	56.19%	40.98%	57	78
8	宜蘭縣宜蘭市	2018-11-25T01:24:26+08:00	32163	8747	40910	3586	44496	79167	56.21%	40.63%	78	78
8	宜蘭縣宜蘭市	2018-11-25T03:54:42+08:00	32163	8747	40910	3586	44496	79167	56.21%	40.63%	78	78
8	宜蘭縣宜蘭市	2018-11-24T23:03:48+08:00	21080	5533	26613	2270	28883	51342	56.26%	41.06%	53	78
8	宜蘭縣宜蘭市	2018-11-24T22:49:25+08:00	18649	4968	23617	2052	25669	45878	55.95%	40.65%	48	78
8	宜蘭縣宜蘭市	2018-11-24T23:42:03+08:00	25001	6626	31627	2681	34308	60940	56.3%	41.03%	62	78
8	宜蘭縣宜蘭市	2018-11-24T23:46:05+08:00	25734	6872	32606	2801	35407	62764	56.41%	41%	64	78
8	宜蘭縣宜蘭市	2018-11-25T04:01:31+08:00	32163	8747	40910	3586	44496	79167	56.21%	40.63%	78	78
8	宜蘭縣宜蘭市	2018-11-25T00:17:09+08:00	30774	8347	39121	3382	42503	75419	56.36%	40.8%	75	78
8	宜蘭縣宜蘭市	2018-11-24T22:21:48+08:00	15403	4139	19542	1704	21246	37936	56%	40.6%	41	78
8	宜蘭縣宜蘭市	2018-11-25T06:12:38+08:00	32163	8747	40910	3586	44496	79167	56.21%	40.63%	78	78
8	宜蘭縣宜蘭市	2018-11-25T00:21:46+08:00	31712	8598	40310	3509	43819	78005	56.17%	40.65%	77	78
8	宜蘭縣宜蘭市	2018-11-25T01:01:03+08:00	32163	8747	40910	3586	44496	79167	56.21%	40.63%	78	78
8	宜蘭縣宜蘭市	2018-11-24T22:39:10+08:00	17478	4649	22127	1927	24054	42921	56.04%	40.72%	45	78
8	宜蘭縣宜蘭市	2018-11-24T23:26:08+08:00	22904	6048	28952	2451	31403	55886	56.19%	40.98%	57	78
8	宜蘭縣宜蘭市	2018-11-24T22:35:46+08:00	17000	4526	21526	1867	23393	41707	56.09%	40.76%	44	78
8	宜蘭縣宜蘭市	2018-11-24T23:58:44+08:00	28394	7657	36051	3149	39200	69590	56.33%	40.8%	70	78
8	宜蘭縣宜蘭市	2018-11-24T23:18:29+08:00	22904	6048	28952	2451	31403	55886	56.19%	40.98%	57	78
8	宜蘭縣宜蘭市	2018-11-25T00:03:36+08:00	30309	8205	38514	3347	41861	74254	56.38%	40.82%	74	78
8	宜蘭縣宜蘭市	2018-11-25T03:37:31+08:00	32163	8747	40910	3586	44496	79167	56.21%	40.63%	78	78
8	宜蘭縣宜蘭市	2018-11-24T22:18:21+08:00	13753	3742	17495	1511	19006	33790	56.25%	40.7%	37	78
8	宜蘭縣宜蘭市	2018-11-24T22:43:52+08:00	17837	4734	22571	1989	24560	43826	56.04%	40.7%	46	78
8	連江縣莒光鄉	2018-11-24T23:26:10+08:00	610	124	734	43	777	1481	52.46%	41.19%	2	2
8	連江縣莒光鄉	2018-11-24T23:10:59+08:00	610	124	734	43	777	1481	52.46%	41.19%	2	2
8	連江縣莒光鄉	2018-11-24T22:49:27+08:00	610	124	734	43	777	1481	52.46%	41.19%	2	2
8	連江縣莒光鄉	2018-11-24T23:22:27+08:00	610	124	734	43	777	1481	52.46%	41.19%	2	2
8	連江縣莒光鄉	2018-11-24T23:18:31+08:00	610	124	734	43	777	1481	52.46%	41.19%	2	2
8	連江縣莒光鄉	2018-11-24T23:33:54+08:00	610	124	734	43	777	1481	52.46%	41.19%	2	2
8	連江縣莒光鄉	2018-11-24T22:12:06+08:00	0	0	0	0	0	0	0%	0%	0	2
8	連江縣莒光鄉	2018-11-24T22:56:39+08:00	610	124	734	43	777	1481	52.46%	41.19%	2	2
8	連江縣莒光鄉	2018-11-24T22:28:44+08:00	264	57	321	14	335	698	47.99%	37.82%	1	2
8	連江縣莒光鄉	2018-11-24T23:37:52+08:00	610	124	734	43	777	1481	52.46%	41.19%	2	2
8	連江縣莒光鄉	2018-11-24T22:53:19+08:00	610	124	734	43	777	1481	52.46%	41.19%	2	2
8	連江縣莒光鄉	2018-11-24T22:32:21+08:00	264	57	321	14	335	698	47.99%	37.82%	1	2
8	連江縣莒光鄉	2018-11-24T22:21:50+08:00	0	0	0	0	0	0	0%	0%	0	2
8	連江縣莒光鄉	2018-11-25T04:01:33+08:00	610	124	734	43	777	1481	52.46%	41.19%	2	2
8	連江縣莒光鄉	2018-11-24T23:46:07+08:00	610	124	734	43	777	1481	52.46%	41.19%	2	2
8	連江縣莒光鄉	2018-11-25T00:08:08+08:00	610	124	734	43	777	1481	52.46%	41.19%	2	2
8	連江縣莒光鄉	2018-11-24T23:00:20+08:00	610	124	734	43	777	1481	52.46%	41.19%	2	2
8	連江縣莒光鄉	2018-11-24T22:25:29+08:00	0	0	0	0	0	0	0%	0%	0	2
8	連江縣莒光鄉	2018-11-25T06:22:48+08:00	610	124	734	43	777	1481	52.46%	41.19%	2	2
8	連江縣莒光鄉	2018-11-25T03:48:35+08:00	610	124	734	43	777	1481	52.46%	41.19%	2	2
8	連江縣莒光鄉	2018-11-25T06:17:41+08:00	610	124	734	43	777	1481	52.46%	41.19%	2	2
8	連江縣莒光鄉	2018-11-24T22:39:13+08:00	610	124	734	43	777	1481	52.46%	41.19%	2	2
8	連江縣莒光鄉	2018-11-25T00:12:49+08:00	610	124	734	43	777	1481	52.46%	41.19%	2	2
8	連江縣莒光鄉	2018-11-25T03:37:33+08:00	610	124	734	43	777	1481	52.46%	41.19%	2	2
8	連江縣莒光鄉	2018-11-24T22:18:23+08:00	0	0	0	0	0	0	0%	0%	0	2
8	連江縣莒光鄉	2018-11-24T23:50:18+08:00	610	124	734	43	777	1481	52.46%	41.19%	2	2
8	連江縣莒光鄉	2018-11-24T23:14:45+08:00	610	124	734	43	777	1481	52.46%	41.19%	2	2
8	連江縣莒光鄉	2018-11-24T23:58:46+08:00	610	124	734	43	777	1481	52.46%	41.19%	2	2
8	連江縣莒光鄉	2018-11-24T23:03:50+08:00	610	124	734	43	777	1481	52.46%	41.19%	2	2
8	連江縣莒光鄉	2018-11-25T01:01:06+08:00	610	124	734	43	777	1481	52.46%	41.19%	2	2
8	連江縣莒光鄉	2018-11-25T06:27:58+08:00	610	124	734	43	777	1481	52.46%	41.19%	2	2
8	連江縣莒光鄉	2018-11-25T01:24:29+08:00	610	124	734	43	777	1481	52.46%	41.19%	2	2
8	連江縣莒光鄉	2018-11-24T23:54:31+08:00	610	124	734	43	777	1481	52.46%	41.19%	2	2
8	連江縣莒光鄉	2018-11-25T03:54:45+08:00	610	124	734	43	777	1481	52.46%	41.19%	2	2
8	連江縣莒光鄉	2018-11-24T23:07:22+08:00	610	124	734	43	777	1481	52.46%	41.19%	2	2
8	連江縣莒光鄉	2018-11-24T22:14:53+08:00	0	0	0	0	0	0	0%	0%	0	2
8	連江縣莒光鄉	2018-11-25T06:12:40+08:00	610	124	734	43	777	1481	52.46%	41.19%	2	2
8	連江縣莒光鄉	2018-11-24T23:29:50+08:00	610	124	734	43	777	1481	52.46%	41.19%	2	2
8	連江縣莒光鄉	2018-11-25T00:17:12+08:00	610	124	734	43	777	1481	52.46%	41.19%	2	2
8	連江縣莒光鄉	2018-11-24T23:42:05+08:00	610	124	734	43	777	1481	52.46%	41.19%	2	2
8	連江縣莒光鄉	2018-11-25T01:06:04+08:00	610	124	734	43	777	1481	52.46%	41.19%	2	2
8	連江縣莒光鄉	2018-11-25T01:11:11+08:00	610	124	734	43	777	1481	52.46%	41.19%	2	2
8	連江縣莒光鄉	2018-11-25T00:21:47+08:00	610	124	734	43	777	1481	52.46%	41.19%	2	2
8	連江縣莒光鄉	2018-11-25T03:42:52+08:00	610	124	734	43	777	1481	52.46%	41.19%	2	2
8	連江縣莒光鄉	2018-11-25T06:07:26+08:00	610	124	734	43	777	1481	52.46%	41.19%	2	2
8	連江縣莒光鄉	2018-11-24T22:40:22+08:00	610	124	734	43	777	1481	52.46%	41.19%	2	2
8	連江縣莒光鄉	2018-11-25T00:56:17+08:00	610	124	734	43	777	1481	52.46%	41.19%	2	2
8	連江縣莒光鄉	2018-11-24T22:35:48+08:00	610	124	734	43	777	1481	52.46%	41.19%	2	2
8	連江縣莒光鄉	2018-11-24T22:43:54+08:00	610	124	734	43	777	1481	52.46%	41.19%	2	2
8	連江縣莒光鄉	2018-11-25T03:31:03+08:00	610	124	734	43	777	1481	52.46%	41.19%	2	2
8	連江縣莒光鄉	2018-11-25T01:16:26+08:00	610	124	734	43	777	1481	52.46%	41.19%	2	2
8	連江縣莒光鄉	2018-11-25T00:03:39+08:00	610	124	734	43	777	1481	52.46%	41.19%	2	2
8	高雄市那瑪夏區	2018-11-24T23:03:44+08:00	603	205	808	100	908	1815	50.03%	33.22%	3	4
8	高雄市那瑪夏區	2018-11-24T23:22:20+08:00	603	205	808	100	908	1815	50.03%	33.22%	3	4
8	高雄市那瑪夏區	2018-11-24T22:49:21+08:00	603	205	808	100	908	1815	50.03%	33.22%	3	4
8	高雄市那瑪夏區	2018-11-24T23:58:38+08:00	603	205	808	100	908	1815	50.03%	33.22%	3	4
8	高雄市那瑪夏區	2018-11-25T03:42:44+08:00	937	275	1212	160	1372	2424	56.6%	38.66%	4	4
8	高雄市那瑪夏區	2018-11-25T01:00:57+08:00	937	275	1212	160	1372	2424	56.6%	38.66%	4	4
8	高雄市那瑪夏區	2018-11-25T03:48:26+08:00	937	275	1212	160	1372	2424	56.6%	38.66%	4	4
8	高雄市那瑪夏區	2018-11-24T22:53:11+08:00	603	205	808	100	908	1815	50.03%	33.22%	3	4
8	高雄市那瑪夏區	2018-11-24T23:46:00+08:00	603	205	808	100	908	1815	50.03%	33.22%	3	4
8	高雄市那瑪夏區	2018-11-25T00:08:01+08:00	603	205	808	100	908	1815	50.03%	33.22%	3	4
8	高雄市那瑪夏區	2018-11-24T22:21:42+08:00	603	205	808	100	908	1815	50.03%	33.22%	3	4
8	高雄市那瑪夏區	2018-11-25T06:12:34+08:00	937	275	1212	160	1372	2424	56.6%	38.66%	4	4
8	高雄市那瑪夏區	2018-11-25T00:17:04+08:00	937	275	1212	160	1372	2424	56.6%	38.66%	4	4
8	高雄市那瑪夏區	2018-11-24T22:25:20+08:00	603	205	808	100	908	1815	50.03%	33.22%	3	4
8	高雄市那瑪夏區	2018-11-24T23:18:24+08:00	603	205	808	100	908	1815	50.03%	33.22%	3	4
8	高雄市那瑪夏區	2018-11-24T23:37:46+08:00	603	205	808	100	908	1815	50.03%	33.22%	3	4
8	高雄市那瑪夏區	2018-11-25T03:54:37+08:00	937	275	1212	160	1372	2424	56.6%	38.66%	4	4
8	高雄市那瑪夏區	2018-11-24T23:33:47+08:00	603	205	808	100	908	1815	50.03%	33.22%	3	4
8	高雄市那瑪夏區	2018-11-25T01:05:55+08:00	937	275	1212	160	1372	2424	56.6%	38.66%	4	4
8	高雄市那瑪夏區	2018-11-24T23:50:11+08:00	603	205	808	100	908	1815	50.03%	33.22%	3	4
8	高雄市那瑪夏區	2018-11-24T23:26:04+08:00	603	205	808	100	908	1815	50.03%	33.22%	3	4
8	高雄市那瑪夏區	2018-11-24T22:14:45+08:00	262	95	357	64	421	585	71.97%	44.79%	1	4
8	高雄市那瑪夏區	2018-11-25T06:17:32+08:00	937	275	1212	160	1372	2424	56.6%	38.66%	4	4
8	高雄市那瑪夏區	2018-11-25T03:37:22+08:00	937	275	1212	160	1372	2424	56.6%	38.66%	4	4
8	高雄市那瑪夏區	2018-11-24T23:07:15+08:00	603	205	808	100	908	1815	50.03%	33.22%	3	4
8	高雄市那瑪夏區	2018-11-24T22:39:05+08:00	603	205	808	100	908	1815	50.03%	33.22%	3	4
8	高雄市那瑪夏區	2018-11-24T23:10:53+08:00	603	205	808	100	908	1815	50.03%	33.22%	3	4
8	高雄市那瑪夏區	2018-11-24T22:43:47+08:00	603	205	808	100	908	1815	50.03%	33.22%	3	4
8	高雄市那瑪夏區	2018-11-24T22:56:33+08:00	603	205	808	100	908	1815	50.03%	33.22%	3	4
8	高雄市那瑪夏區	2018-11-25T01:24:21+08:00	937	275	1212	160	1372	2424	56.6%	38.66%	4	4
8	高雄市那瑪夏區	2018-11-24T23:14:36+08:00	603	205	808	100	908	1815	50.03%	33.22%	3	4
8	高雄市那瑪夏區	2018-11-25T03:30:55+08:00	937	275	1212	160	1372	2424	56.6%	38.66%	4	4
8	高雄市那瑪夏區	2018-11-24T22:32:15+08:00	603	205	808	100	908	1815	50.03%	33.22%	3	4
8	高雄市那瑪夏區	2018-11-24T22:40:15+08:00	603	205	808	100	908	1815	50.03%	33.22%	3	4
8	高雄市那瑪夏區	2018-11-25T04:01:25+08:00	937	275	1212	160	1372	2424	56.6%	38.66%	4	4
8	高雄市那瑪夏區	2018-11-24T22:11:59+08:00	262	95	357	64	421	585	71.97%	44.79%	1	4
8	高雄市那瑪夏區	2018-11-24T23:00:14+08:00	603	205	808	100	908	1815	50.03%	33.22%	3	4
8	高雄市那瑪夏區	2018-11-25T06:07:19+08:00	937	275	1212	160	1372	2424	56.6%	38.66%	4	4
8	高雄市那瑪夏區	2018-11-25T01:11:03+08:00	937	275	1212	160	1372	2424	56.6%	38.66%	4	4
8	高雄市那瑪夏區	2018-11-24T23:29:43+08:00	603	205	808	100	908	1815	50.03%	33.22%	3	4
8	高雄市那瑪夏區	2018-11-25T00:21:41+08:00	937	275	1212	160	1372	2424	56.6%	38.66%	4	4
8	高雄市那瑪夏區	2018-11-25T06:22:42+08:00	937	275	1212	160	1372	2424	56.6%	38.66%	4	4
8	高雄市那瑪夏區	2018-11-25T00:56:10+08:00	937	275	1212	160	1372	2424	56.6%	38.66%	4	4
8	高雄市那瑪夏區	2018-11-24T22:18:16+08:00	262	95	357	64	421	585	71.97%	44.79%	1	4
8	高雄市那瑪夏區	2018-11-24T23:54:24+08:00	603	205	808	100	908	1815	50.03%	33.22%	3	4
8	高雄市那瑪夏區	2018-11-24T22:35:41+08:00	603	205	808	100	908	1815	50.03%	33.22%	3	4
8	高雄市那瑪夏區	2018-11-25T01:16:18+08:00	937	275	1212	160	1372	2424	56.6%	38.66%	4	4
8	高雄市那瑪夏區	2018-11-24T23:41:58+08:00	603	205	808	100	908	1815	50.03%	33.22%	3	4
8	高雄市那瑪夏區	2018-11-25T06:27:52+08:00	937	275	1212	160	1372	2424	56.6%	38.66%	4	4
8	高雄市那瑪夏區	2018-11-25T00:12:42+08:00	937	275	1212	160	1372	2424	56.6%	38.66%	4	4
8	高雄市那瑪夏區	2018-11-24T22:28:37+08:00	603	205	808	100	908	1815	50.03%	33.22%	3	4
8	高雄市那瑪夏區	2018-11-25T00:03:30+08:00	603	205	808	100	908	1815	50.03%	33.22%	3	4
8	高雄市彌陀區	2018-11-24T22:49:20+08:00	6672	2280	8952	1100	10052	16487	60.97%	40.47%	18	18
8	高雄市彌陀區	2018-11-24T23:03:44+08:00	6672	2280	8952	1100	10052	16487	60.97%	40.47%	18	18
8	高雄市彌陀區	2018-11-25T00:56:09+08:00	6672	2280	8952	1100	10052	16487	60.97%	40.47%	18	18
8	高雄市彌陀區	2018-11-24T23:58:38+08:00	6672	2280	8952	1100	10052	16487	60.97%	40.47%	18	18
8	高雄市彌陀區	2018-11-24T23:22:19+08:00	6672	2280	8952	1100	10052	16487	60.97%	40.47%	18	18
8	高雄市彌陀區	2018-11-25T03:42:44+08:00	6672	2280	8952	1100	10052	16487	60.97%	40.47%	18	18
8	高雄市彌陀區	2018-11-25T01:00:57+08:00	6672	2280	8952	1100	10052	16487	60.97%	40.47%	18	18
8	高雄市彌陀區	2018-11-24T22:53:11+08:00	6672	2280	8952	1100	10052	16487	60.97%	40.47%	18	18
8	高雄市彌陀區	2018-11-24T23:46:00+08:00	6672	2280	8952	1100	10052	16487	60.97%	40.47%	18	18
8	高雄市彌陀區	2018-11-25T00:08:01+08:00	6672	2280	8952	1100	10052	16487	60.97%	40.47%	18	18
8	高雄市彌陀區	2018-11-24T22:21:42+08:00	6672	2280	8952	1100	10052	16487	60.97%	40.47%	18	18
8	高雄市彌陀區	2018-11-25T06:12:33+08:00	6672	2280	8952	1100	10052	16487	60.97%	40.47%	18	18
8	高雄市彌陀區	2018-11-25T00:17:04+08:00	6672	2280	8952	1100	10052	16487	60.97%	40.47%	18	18
8	高雄市彌陀區	2018-11-25T06:22:41+08:00	6672	2280	8952	1100	10052	16487	60.97%	40.47%	18	18
8	高雄市彌陀區	2018-11-24T22:25:20+08:00	6672	2280	8952	1100	10052	16487	60.97%	40.47%	18	18
8	高雄市彌陀區	2018-11-24T23:18:23+08:00	6672	2280	8952	1100	10052	16487	60.97%	40.47%	18	18
8	高雄市彌陀區	2018-11-25T01:05:55+08:00	6672	2280	8952	1100	10052	16487	60.97%	40.47%	18	18
8	高雄市彌陀區	2018-11-24T23:50:11+08:00	6672	2280	8952	1100	10052	16487	60.97%	40.47%	18	18
8	高雄市彌陀區	2018-11-24T22:14:45+08:00	6672	2280	8952	1100	10052	16487	60.97%	40.47%	18	18
8	高雄市彌陀區	2018-11-24T23:33:46+08:00	6672	2280	8952	1100	10052	16487	60.97%	40.47%	18	18
8	高雄市彌陀區	2018-11-25T06:27:51+08:00	6672	2280	8952	1100	10052	16487	60.97%	40.47%	18	18
8	高雄市彌陀區	2018-11-24T23:26:03+08:00	6672	2280	8952	1100	10052	16487	60.97%	40.47%	18	18
8	高雄市彌陀區	2018-11-25T03:54:36+08:00	6672	2280	8952	1100	10052	16487	60.97%	40.47%	18	18
8	高雄市彌陀區	2018-11-25T00:12:41+08:00	6672	2280	8952	1100	10052	16487	60.97%	40.47%	18	18
8	高雄市彌陀區	2018-11-25T01:24:20+08:00	6672	2280	8952	1100	10052	16487	60.97%	40.47%	18	18
8	高雄市彌陀區	2018-11-24T22:43:46+08:00	6672	2280	8952	1100	10052	16487	60.97%	40.47%	18	18
8	高雄市彌陀區	2018-11-25T06:17:32+08:00	6672	2280	8952	1100	10052	16487	60.97%	40.47%	18	18
8	高雄市彌陀區	2018-11-25T03:37:22+08:00	6672	2280	8952	1100	10052	16487	60.97%	40.47%	18	18
8	高雄市彌陀區	2018-11-24T23:07:15+08:00	6672	2280	8952	1100	10052	16487	60.97%	40.47%	18	18
8	高雄市彌陀區	2018-11-24T22:39:05+08:00	6672	2280	8952	1100	10052	16487	60.97%	40.47%	18	18
8	高雄市彌陀區	2018-11-24T23:10:53+08:00	6672	2280	8952	1100	10052	16487	60.97%	40.47%	18	18
8	高雄市彌陀區	2018-11-24T22:56:33+08:00	6672	2280	8952	1100	10052	16487	60.97%	40.47%	18	18
8	高雄市彌陀區	2018-11-24T23:14:36+08:00	6672	2280	8952	1100	10052	16487	60.97%	40.47%	18	18
8	高雄市彌陀區	2018-11-25T03:48:25+08:00	6672	2280	8952	1100	10052	16487	60.97%	40.47%	18	18
8	高雄市彌陀區	2018-11-24T22:32:14+08:00	6672	2280	8952	1100	10052	16487	60.97%	40.47%	18	18
8	高雄市彌陀區	2018-11-25T03:30:55+08:00	6672	2280	8952	1100	10052	16487	60.97%	40.47%	18	18
8	高雄市彌陀區	2018-11-24T22:40:15+08:00	6672	2280	8952	1100	10052	16487	60.97%	40.47%	18	18
8	高雄市彌陀區	2018-11-25T00:21:40+08:00	6672	2280	8952	1100	10052	16487	60.97%	40.47%	18	18
8	高雄市彌陀區	2018-11-24T23:29:42+08:00	6672	2280	8952	1100	10052	16487	60.97%	40.47%	18	18
8	高雄市彌陀區	2018-11-25T01:11:02+08:00	6672	2280	8952	1100	10052	16487	60.97%	40.47%	18	18
8	高雄市彌陀區	2018-11-25T04:01:25+08:00	6672	2280	8952	1100	10052	16487	60.97%	40.47%	18	18
8	高雄市彌陀區	2018-11-24T22:11:59+08:00	6672	2280	8952	1100	10052	16487	60.97%	40.47%	18	18
8	高雄市彌陀區	2018-11-24T23:00:14+08:00	6672	2280	8952	1100	10052	16487	60.97%	40.47%	18	18
8	高雄市彌陀區	2018-11-25T06:07:19+08:00	6672	2280	8952	1100	10052	16487	60.97%	40.47%	18	18
8	高雄市彌陀區	2018-11-24T22:28:36+08:00	6672	2280	8952	1100	10052	16487	60.97%	40.47%	18	18
8	高雄市彌陀區	2018-11-24T22:18:16+08:00	6672	2280	8952	1100	10052	16487	60.97%	40.47%	18	18
8	高雄市彌陀區	2018-11-24T23:54:23+08:00	6672	2280	8952	1100	10052	16487	60.97%	40.47%	18	18
8	高雄市彌陀區	2018-11-24T22:35:41+08:00	6672	2280	8952	1100	10052	16487	60.97%	40.47%	18	18
8	高雄市彌陀區	2018-11-24T23:37:45+08:00	6672	2280	8952	1100	10052	16487	60.97%	40.47%	18	18
8	高雄市彌陀區	2018-11-24T23:41:58+08:00	6672	2280	8952	1100	10052	16487	60.97%	40.47%	18	18
8	高雄市彌陀區	2018-11-25T00:03:30+08:00	6672	2280	8952	1100	10052	16487	60.97%	40.47%	18	18
8	高雄市彌陀區	2018-11-25T01:16:17+08:00	6672	2280	8952	1100	10052	16487	60.97%	40.47%	18	18
8	臺南市東區	2018-11-25T00:56:08+08:00	55131	19375	74506	5670	80176	148881	53.85%	37.03%	91	93
8	臺南市東區	2018-11-24T23:14:34+08:00	44963	15847	60810	4532	65342	121819	53.64%	36.91%	75	93
8	臺南市東區	2018-11-24T23:03:43+08:00	41807	14677	56484	4241	60725	113307	53.59%	36.9%	70	93
8	臺南市東區	2018-11-24T23:58:37+08:00	51420	18145	69565	5183	74748	138864	53.83%	37.03%	85	93
8	臺南市東區	2018-11-25T06:17:31+08:00	56699	19840	76539	5810	82349	153359	53.7%	36.97%	93	93
8	臺南市東區	2018-11-24T23:22:18+08:00	48201	16995	65196	4806	70002	130224	53.76%	37.01%	80	93
8	臺南市東區	2018-11-24T22:43:45+08:00	33271	11642	44913	3392	48305	89978	53.69%	36.98%	56	93
8	臺南市東區	2018-11-25T03:37:20+08:00	56699	19840	76539	5810	82349	153359	53.7%	36.97%	93	93
8	臺南市東區	2018-11-24T22:49:19+08:00	35412	12391	47803	3659	51462	95981	53.62%	36.89%	60	93
8	臺南市東區	2018-11-25T00:03:28+08:00	52457	18498	70955	5364	76319	141745	53.84%	37.01%	87	93
8	臺南市東區	2018-11-25T03:42:42+08:00	56699	19840	76539	5810	82349	153359	53.7%	36.97%	93	93
8	臺南市東區	2018-11-24T22:25:19+08:00	27042	9515	36557	2845	39402	73452	53.64%	36.82%	45	93
8	臺南市東區	2018-11-25T06:22:40+08:00	56699	19840	76539	5810	82349	153359	53.7%	36.97%	93	93
8	臺南市東區	2018-11-25T00:17:03+08:00	53551	18897	72448	5491	77939	144727	53.85%	37%	89	93
8	臺南市東區	2018-11-25T01:11:01+08:00	55811	19569	75380	5746	81126	150996	53.73%	36.96%	92	93
8	臺南市東區	2018-11-24T23:29:41+08:00	49904	17629	67533	5033	72566	134993	53.76%	36.97%	83	93
8	臺南市東區	2018-11-25T06:12:32+08:00	56699	19840	76539	5810	82349	153359	53.7%	36.97%	93	93
8	臺南市東區	2018-11-24T23:50:10+08:00	51420	18145	69565	5183	74748	138864	53.83%	37.03%	85	93
8	臺南市東區	2018-11-25T00:12:40+08:00	52961	18689	71650	5441	77091	143172	53.85%	36.99%	88	93
8	臺南市東區	2018-11-24T22:28:35+08:00	27644	9686	37330	2888	40218	74986	53.63%	36.87%	46	93
8	臺南市東區	2018-11-24T22:14:43+08:00	22748	8027	30775	2410	33185	61782	53.71%	36.82%	38	93
8	臺南市東區	2018-11-24T23:26:02+08:00	48828	17227	66055	4871	70926	131948	53.75%	37.01%	81	93
8	臺南市東區	2018-11-24T23:54:20+08:00	51420	18145	69565	5183	74748	138864	53.83%	37.03%	85	93
8	臺南市東區	2018-11-25T06:27:50+08:00	56699	19840	76539	5810	82349	153359	53.7%	36.97%	93	93
8	臺南市東區	2018-11-25T00:07:59+08:00	52457	18498	70955	5364	76319	141745	53.84%	37.01%	87	93
8	臺南市東區	2018-11-24T23:18:22+08:00	45480	16034	61514	4585	66099	123336	53.59%	36.87%	76	93
8	臺南市東區	2018-11-25T01:05:53+08:00	55811	19569	75380	5746	81126	150996	53.73%	36.96%	92	93
8	臺南市東區	2018-11-24T22:18:14+08:00	24346	8613	32959	2601	35560	66189	53.72%	36.78%	41	93
8	臺南市東區	2018-11-24T22:56:32+08:00	38828	13527	52355	3960	56315	104708	53.78%	37.08%	65	93
8	臺南市東區	2018-11-25T01:24:19+08:00	56699	19840	76539	5810	82349	153359	53.7%	36.97%	93	93
8	臺南市東區	2018-11-24T22:39:04+08:00	29610	10463	40073	3095	43168	80428	53.67%	36.82%	50	93
8	臺南市東區	2018-11-24T23:10:52+08:00	43480	15321	58801	4396	63197	117775	53.66%	36.92%	73	93
8	臺南市東區	2018-11-24T23:07:14+08:00	42452	14923	57375	4311	61686	115071	53.61%	36.89%	71	93
8	臺南市東區	2018-11-25T00:21:39+08:00	54247	19116	73363	5622	78985	146794	53.81%	36.95%	90	93
8	臺南市東區	2018-11-24T22:32:13+08:00	27644	9686	37330	2888	40218	74986	53.63%	36.87%	46	93
8	臺南市東區	2018-11-25T03:30:53+08:00	56699	19840	76539	5810	82349	153359	53.7%	36.97%	93	93
8	臺南市東區	2018-11-25T03:48:24+08:00	56699	19840	76539	5810	82349	153359	53.7%	36.97%	93	93
8	臺南市東區	2018-11-25T01:00:55+08:00	55811	19569	75380	5746	81126	150996	53.73%	36.96%	92	93
8	臺南市東區	2018-11-24T23:00:13+08:00	39869	13956	53825	4081	57906	107588	53.82%	37.06%	67	93
8	臺南市東區	2018-11-25T06:07:17+08:00	56699	19840	76539	5810	82349	153359	53.7%	36.97%	93	93
8	臺南市東區	2018-11-24T22:21:41+08:00	27042	9515	36557	2845	39402	73452	53.64%	36.82%	45	93
8	臺南市東區	2018-11-24T22:53:09+08:00	37342	13046	50388	3808	54196	101032	53.64%	36.96%	63	93
8	臺南市東區	2018-11-24T22:40:14+08:00	31787	11129	42916	3244	46160	85971	53.69%	36.97%	53	93
8	臺南市東區	2018-11-24T22:11:58+08:00	21261	7600	28861	2318	31179	57800	53.94%	36.78%	36	93
8	臺南市東區	2018-11-25T04:01:23+08:00	56699	19840	76539	5810	82349	153359	53.7%	36.97%	93	93
8	臺南市東區	2018-11-24T23:41:57+08:00	50506	17851	68357	5116	73473	136622	53.78%	36.97%	84	93
8	臺南市東區	2018-11-25T01:16:16+08:00	56699	19840	76539	5810	82349	153359	53.7%	36.97%	93	93
8	臺南市東區	2018-11-24T22:35:40+08:00	28667	10098	38765	3040	41805	77930	53.64%	36.79%	48	93
8	臺南市東區	2018-11-25T03:54:35+08:00	56699	19840	76539	5810	82349	153359	53.7%	36.97%	93	93
8	臺南市東區	2018-11-24T23:33:45+08:00	50506	17851	68357	5116	73473	136622	53.78%	36.97%	84	93
8	臺南市東區	2018-11-24T23:37:44+08:00	50506	17851	68357	5116	73473	136622	53.78%	36.97%	84	93
8	臺南市東區	2018-11-24T23:45:59+08:00	51420	18145	69565	5183	74748	138864	53.83%	37.03%	85	93
8	屏東縣枋寮鄉	2018-11-24T23:10:57+08:00	6387	2102	8489	1294	9783	18640	52.48%	34.27%	20	22
8	屏東縣枋寮鄉	2018-11-24T23:07:19+08:00	6387	2102	8489	1294	9783	18640	52.48%	34.27%	20	22
8	屏東縣枋寮鄉	2018-11-24T22:14:50+08:00	5390	1805	7195	1126	8321	15862	52.46%	33.98%	18	22
8	屏東縣枋寮鄉	2018-11-25T06:17:37+08:00	7292	2451	9743	1469	11212	21394	52.41%	34.08%	22	22
8	屏東縣枋寮鄉	2018-11-25T01:24:25+08:00	7292	2451	9743	1469	11212	21394	52.41%	34.08%	22	22
8	屏東縣枋寮鄉	2018-11-24T22:56:37+08:00	6387	2102	8489	1294	9783	18640	52.48%	34.27%	20	22
8	屏東縣枋寮鄉	2018-11-24T22:32:19+08:00	5809	1942	7751	1224	8975	17138	52.37%	33.9%	19	22
8	屏東縣枋寮鄉	2018-11-24T22:53:16+08:00	6387	2102	8489	1294	9783	18640	52.48%	34.27%	20	22
8	屏東縣枋寮鄉	2018-11-25T01:06:00+08:00	7292	2451	9743	1469	11212	21394	52.41%	34.08%	22	22
8	屏東縣枋寮鄉	2018-11-24T22:25:26+08:00	5809	1942	7751	1224	8975	17138	52.37%	33.9%	19	22
8	屏東縣枋寮鄉	2018-11-24T23:00:17+08:00	6387	2102	8489	1294	9783	18640	52.48%	34.27%	20	22
8	屏東縣枋寮鄉	2018-11-25T01:11:08+08:00	7292	2451	9743	1469	11212	21394	52.41%	34.08%	22	22
8	屏東縣枋寮鄉	2018-11-25T06:07:24+08:00	7292	2451	9743	1469	11212	21394	52.41%	34.08%	22	22
8	屏東縣枋寮鄉	2018-11-24T22:40:19+08:00	5809	1942	7751	1224	8975	17138	52.37%	33.9%	19	22
8	屏東縣枋寮鄉	2018-11-24T23:29:47+08:00	6861	2282	9143	1380	10523	20007	52.6%	34.29%	21	22
8	屏東縣枋寮鄉	2018-11-25T00:21:45+08:00	7292	2451	9743	1469	11212	21394	52.41%	34.08%	22	22
8	屏東縣枋寮鄉	2018-11-25T03:31:00+08:00	7292	2451	9743	1469	11212	21394	52.41%	34.08%	22	22
8	屏東縣枋寮鄉	2018-11-25T01:16:23+08:00	7292	2451	9743	1469	11212	21394	52.41%	34.08%	22	22
8	屏東縣枋寮鄉	2018-11-25T00:03:35+08:00	7292	2451	9743	1469	11212	21394	52.41%	34.08%	22	22
8	屏東縣枋寮鄉	2018-11-25T00:56:14+08:00	7292	2451	9743	1469	11212	21394	52.41%	34.08%	22	22
8	屏東縣枋寮鄉	2018-11-24T22:35:45+08:00	5809	1942	7751	1224	8975	17138	52.37%	33.9%	19	22
8	屏東縣枋寮鄉	2018-11-24T23:14:42+08:00	6387	2102	8489	1294	9783	18640	52.48%	34.27%	20	22
8	屏東縣枋寮鄉	2018-11-24T23:37:49+08:00	7292	2451	9743	1469	11212	21394	52.41%	34.08%	22	22
8	屏東縣枋寮鄉	2018-11-24T22:43:51+08:00	6387	2102	8489	1294	9783	18640	52.48%	34.27%	20	22
8	屏東縣枋寮鄉	2018-11-25T06:27:56+08:00	7292	2451	9743	1469	11212	21394	52.41%	34.08%	22	22
8	屏東縣枋寮鄉	2018-11-25T00:12:46+08:00	7292	2451	9743	1469	11212	21394	52.41%	34.08%	22	22
8	屏東縣枋寮鄉	2018-11-24T23:54:28+08:00	7292	2451	9743	1469	11212	21394	52.41%	34.08%	22	22
8	屏東縣枋寮鄉	2018-11-24T23:22:24+08:00	6861	2282	9143	1380	10523	20007	52.6%	34.29%	21	22
8	屏東縣枋寮鄉	2018-11-24T22:28:41+08:00	5809	1942	7751	1224	8975	17138	52.37%	33.9%	19	22
8	屏東縣枋寮鄉	2018-11-24T22:12:03+08:00	5390	1805	7195	1126	8321	15862	52.46%	33.98%	18	22
8	屏東縣枋寮鄉	2018-11-24T23:33:51+08:00	7292	2451	9743	1469	11212	21394	52.41%	34.08%	22	22
8	屏東縣枋寮鄉	2018-11-25T03:54:42+08:00	7292	2451	9743	1469	11212	21394	52.41%	34.08%	22	22
8	屏東縣枋寮鄉	2018-11-24T23:03:48+08:00	6387	2102	8489	1294	9783	18640	52.48%	34.27%	20	22
8	屏東縣枋寮鄉	2018-11-24T22:49:25+08:00	6387	2102	8489	1294	9783	18640	52.48%	34.27%	20	22
8	屏東縣枋寮鄉	2018-11-25T04:01:30+08:00	7292	2451	9743	1469	11212	21394	52.41%	34.08%	22	22
8	屏東縣枋寮鄉	2018-11-25T03:42:49+08:00	7292	2451	9743	1469	11212	21394	52.41%	34.08%	22	22
8	屏東縣枋寮鄉	2018-11-24T23:42:02+08:00	7292	2451	9743	1469	11212	21394	52.41%	34.08%	22	22
8	屏東縣枋寮鄉	2018-11-25T00:08:05+08:00	7292	2451	9743	1469	11212	21394	52.41%	34.08%	22	22
8	屏東縣枋寮鄉	2018-11-24T23:46:04+08:00	7292	2451	9743	1469	11212	21394	52.41%	34.08%	22	22
8	屏東縣枋寮鄉	2018-11-25T00:17:09+08:00	7292	2451	9743	1469	11212	21394	52.41%	34.08%	22	22
8	屏東縣枋寮鄉	2018-11-25T06:12:37+08:00	7292	2451	9743	1469	11212	21394	52.41%	34.08%	22	22
8	屏東縣枋寮鄉	2018-11-25T06:22:45+08:00	7292	2451	9743	1469	11212	21394	52.41%	34.08%	22	22
8	屏東縣枋寮鄉	2018-11-24T22:21:47+08:00	5809	1942	7751	1224	8975	17138	52.37%	33.9%	19	22
8	屏東縣枋寮鄉	2018-11-25T03:48:31+08:00	7292	2451	9743	1469	11212	21394	52.41%	34.08%	22	22
8	屏東縣枋寮鄉	2018-11-24T22:39:10+08:00	5809	1942	7751	1224	8975	17138	52.37%	33.9%	19	22
8	屏東縣枋寮鄉	2018-11-24T22:18:20+08:00	5809	1942	7751	1224	8975	17138	52.37%	33.9%	19	22
8	屏東縣枋寮鄉	2018-11-25T03:37:30+08:00	7292	2451	9743	1469	11212	21394	52.41%	34.08%	22	22
8	屏東縣枋寮鄉	2018-11-24T23:58:43+08:00	7292	2451	9743	1469	11212	21394	52.41%	34.08%	22	22
8	屏東縣枋寮鄉	2018-11-24T23:26:07+08:00	6861	2282	9143	1380	10523	20007	52.6%	34.29%	21	22
8	屏東縣枋寮鄉	2018-11-25T01:01:02+08:00	7292	2451	9743	1469	11212	21394	52.41%	34.08%	22	22
8	屏東縣枋寮鄉	2018-11-24T23:18:28+08:00	6387	2102	8489	1294	9783	18640	52.48%	34.27%	20	22
8	屏東縣枋寮鄉	2018-11-24T23:50:15+08:00	7292	2451	9743	1469	11212	21394	52.41%	34.08%	22	22
8	臺南市山上區	2018-11-25T03:37:19+08:00	1824	635	2459	302	2761	6511	42.41%	28.01%	9	9
8	臺南市山上區	2018-11-25T00:56:08+08:00	1824	635	2459	302	2761	6511	42.41%	28.01%	9	9
8	臺南市山上區	2018-11-24T22:49:18+08:00	1824	635	2459	302	2761	6511	42.41%	28.01%	9	9
8	臺南市山上區	2018-11-24T23:14:34+08:00	1824	635	2459	302	2761	6511	42.41%	28.01%	9	9
8	臺南市山上區	2018-11-24T22:43:45+08:00	1824	635	2459	302	2761	6511	42.41%	28.01%	9	9
8	臺南市山上區	2018-11-24T23:03:42+08:00	1824	635	2459	302	2761	6511	42.41%	28.01%	9	9
8	臺南市山上區	2018-11-24T23:10:51+08:00	1824	635	2459	302	2761	6511	42.41%	28.01%	9	9
8	臺南市山上區	2018-11-25T00:03:28+08:00	1824	635	2459	302	2761	6511	42.41%	28.01%	9	9
8	臺南市山上區	2018-11-25T06:17:30+08:00	1824	635	2459	302	2761	6511	42.41%	28.01%	9	9
8	臺南市山上區	2018-11-24T23:58:36+08:00	1824	635	2459	302	2761	6511	42.41%	28.01%	9	9
8	臺南市山上區	2018-11-24T23:22:17+08:00	1824	635	2459	302	2761	6511	42.41%	28.01%	9	9
8	臺南市山上區	2018-11-25T03:42:42+08:00	1824	635	2459	302	2761	6511	42.41%	28.01%	9	9
8	臺南市山上區	2018-11-25T06:22:40+08:00	1824	635	2459	302	2761	6511	42.41%	28.01%	9	9
8	臺南市山上區	2018-11-24T23:29:41+08:00	1824	635	2459	302	2761	6511	42.41%	28.01%	9	9
8	臺南市山上區	2018-11-24T22:25:18+08:00	1824	635	2459	302	2761	6511	42.41%	28.01%	9	9
8	臺南市山上區	2018-11-25T01:11:00+08:00	1824	635	2459	302	2761	6511	42.41%	28.01%	9	9
8	臺南市山上區	2018-11-25T00:17:02+08:00	1824	635	2459	302	2761	6511	42.41%	28.01%	9	9
8	臺南市山上區	2018-11-25T06:12:32+08:00	1824	635	2459	302	2761	6511	42.41%	28.01%	9	9
8	臺南市山上區	2018-11-25T00:12:40+08:00	1824	635	2459	302	2761	6511	42.41%	28.01%	9	9
8	臺南市山上區	2018-11-24T22:28:35+08:00	1824	635	2459	302	2761	6511	42.41%	28.01%	9	9
8	臺南市山上區	2018-11-24T22:14:43+08:00	1824	635	2459	302	2761	6511	42.41%	28.01%	9	9
8	臺南市山上區	2018-11-24T23:26:02+08:00	1824	635	2459	302	2761	6511	42.41%	28.01%	9	9
8	臺南市山上區	2018-11-24T23:54:20+08:00	1824	635	2459	302	2761	6511	42.41%	28.01%	9	9
8	臺南市山上區	2018-11-25T06:27:50+08:00	1824	635	2459	302	2761	6511	42.41%	28.01%	9	9
8	臺南市山上區	2018-11-25T00:07:59+08:00	1824	635	2459	302	2761	6511	42.41%	28.01%	9	9
8	臺南市山上區	2018-11-24T23:18:22+08:00	1824	635	2459	302	2761	6511	42.41%	28.01%	9	9
8	臺南市山上區	2018-11-25T01:05:53+08:00	1824	635	2459	302	2761	6511	42.41%	28.01%	9	9
8	臺南市山上區	2018-11-24T22:18:14+08:00	1824	635	2459	302	2761	6511	42.41%	28.01%	9	9
8	臺南市山上區	2018-11-25T01:24:18+08:00	1824	635	2459	302	2761	6511	42.41%	28.01%	9	9
8	臺南市山上區	2018-11-24T22:56:32+08:00	1824	635	2459	302	2761	6511	42.41%	28.01%	9	9
8	臺南市山上區	2018-11-24T23:50:09+08:00	1824	635	2459	302	2761	6511	42.41%	28.01%	9	9
8	臺南市山上區	2018-11-24T22:39:04+08:00	1824	635	2459	302	2761	6511	42.41%	28.01%	9	9
8	臺南市山上區	2018-11-24T23:07:14+08:00	1824	635	2459	302	2761	6511	42.41%	28.01%	9	9
8	臺南市山上區	2018-11-24T22:32:13+08:00	1824	635	2459	302	2761	6511	42.41%	28.01%	9	9
8	臺南市山上區	2018-11-25T03:30:53+08:00	1824	635	2459	302	2761	6511	42.41%	28.01%	9	9
8	臺南市山上區	2018-11-25T03:48:23+08:00	1824	635	2459	302	2761	6511	42.41%	28.01%	9	9
8	臺南市山上區	2018-11-25T01:00:55+08:00	1824	635	2459	302	2761	6511	42.41%	28.01%	9	9
8	臺南市山上區	2018-11-24T23:00:09+08:00	1824	635	2459	302	2761	6511	42.41%	28.01%	9	9
8	臺南市山上區	2018-11-25T00:21:38+08:00	1824	635	2459	302	2761	6511	42.41%	28.01%	9	9
8	臺南市山上區	2018-11-25T06:07:17+08:00	1824	635	2459	302	2761	6511	42.41%	28.01%	9	9
8	臺南市山上區	2018-11-24T22:53:09+08:00	1824	635	2459	302	2761	6511	42.41%	28.01%	9	9
8	臺南市山上區	2018-11-24T22:40:14+08:00	1824	635	2459	302	2761	6511	42.41%	28.01%	9	9
8	臺南市山上區	2018-11-24T22:11:58+08:00	1824	635	2459	302	2761	6511	42.41%	28.01%	9	9
8	臺南市山上區	2018-11-25T04:01:23+08:00	1824	635	2459	302	2761	6511	42.41%	28.01%	9	9
8	臺南市山上區	2018-11-24T22:21:40+08:00	1824	635	2459	302	2761	6511	42.41%	28.01%	9	9
8	臺南市山上區	2018-11-24T23:41:57+08:00	1824	635	2459	302	2761	6511	42.41%	28.01%	9	9
8	臺南市山上區	2018-11-25T01:16:16+08:00	1824	635	2459	302	2761	6511	42.41%	28.01%	9	9
8	臺南市山上區	2018-11-24T22:35:40+08:00	1824	635	2459	302	2761	6511	42.41%	28.01%	9	9
8	臺南市山上區	2018-11-25T03:54:35+08:00	1824	635	2459	302	2761	6511	42.41%	28.01%	9	9
8	臺南市山上區	2018-11-24T23:33:45+08:00	1824	635	2459	302	2761	6511	42.41%	28.01%	9	9
8	臺南市山上區	2018-11-24T23:37:44+08:00	1824	635	2459	302	2761	6511	42.41%	28.01%	9	9
8	臺南市山上區	2018-11-24T23:45:59+08:00	1824	635	2459	302	2761	6511	42.41%	28.01%	9	9
8	屏東縣長治鄉	2018-11-24T22:56:36+08:00	9433	3174	12607	1667	14274	26256	54.36%	35.93%	22	22
8	屏東縣長治鄉	2018-11-25T06:17:36+08:00	9433	3174	12607	1667	14274	26256	54.36%	35.93%	22	22
8	屏東縣長治鄉	2018-11-24T23:07:19+08:00	9433	3174	12607	1667	14274	26256	54.36%	35.93%	22	22
8	屏東縣長治鄉	2018-11-24T23:10:56+08:00	9433	3174	12607	1667	14274	26256	54.36%	35.93%	22	22
8	屏東縣長治鄉	2018-11-24T22:39:09+08:00	9433	3174	12607	1667	14274	26256	54.36%	35.93%	22	22
8	屏東縣長治鄉	2018-11-25T01:24:25+08:00	9433	3174	12607	1667	14274	26256	54.36%	35.93%	22	22
8	屏東縣長治鄉	2018-11-25T03:54:41+08:00	9433	3174	12607	1667	14274	26256	54.36%	35.93%	22	22
8	屏東縣長治鄉	2018-11-24T22:32:19+08:00	9034	2996	12030	1550	13580	25014	54.29%	36.12%	21	22
8	屏東縣長治鄉	2018-11-25T01:06:00+08:00	9433	3174	12607	1667	14274	26256	54.36%	35.93%	22	22
8	屏東縣長治鄉	2018-11-24T22:25:26+08:00	8599	2831	11430	1473	12903	23809	54.19%	36.12%	20	22
8	屏東縣長治鄉	2018-11-24T23:00:17+08:00	9433	3174	12607	1667	14274	26256	54.36%	35.93%	22	22
8	屏東縣長治鄉	2018-11-25T00:21:44+08:00	9433	3174	12607	1667	14274	26256	54.36%	35.93%	22	22
8	屏東縣長治鄉	2018-11-25T01:11:08+08:00	9433	3174	12607	1667	14274	26256	54.36%	35.93%	22	22
8	屏東縣長治鄉	2018-11-25T06:07:23+08:00	9433	3174	12607	1667	14274	26256	54.36%	35.93%	22	22
8	屏東縣長治鄉	2018-11-24T22:40:19+08:00	9433	3174	12607	1667	14274	26256	54.36%	35.93%	22	22
8	屏東縣長治鄉	2018-11-24T23:29:47+08:00	9433	3174	12607	1667	14274	26256	54.36%	35.93%	22	22
8	屏東縣長治鄉	2018-11-25T03:31:00+08:00	9433	3174	12607	1667	14274	26256	54.36%	35.93%	22	22
8	屏東縣長治鄉	2018-11-25T00:03:35+08:00	9433	3174	12607	1667	14274	26256	54.36%	35.93%	22	22
8	屏東縣長治鄉	2018-11-25T00:56:14+08:00	9433	3174	12607	1667	14274	26256	54.36%	35.93%	22	22
8	屏東縣長治鄉	2018-11-24T23:54:27+08:00	9433	3174	12607	1667	14274	26256	54.36%	35.93%	22	22
8	屏東縣長治鄉	2018-11-24T22:35:45+08:00	9433	3174	12607	1667	14274	26256	54.36%	35.93%	22	22
8	屏東縣長治鄉	2018-11-25T01:16:22+08:00	9433	3174	12607	1667	14274	26256	54.36%	35.93%	22	22
8	屏東縣長治鄉	2018-11-24T23:37:49+08:00	9433	3174	12607	1667	14274	26256	54.36%	35.93%	22	22
8	屏東縣長治鄉	2018-11-24T22:43:51+08:00	9433	3174	12607	1667	14274	26256	54.36%	35.93%	22	22
8	屏東縣長治鄉	2018-11-24T23:22:24+08:00	9433	3174	12607	1667	14274	26256	54.36%	35.93%	22	22
8	屏東縣長治鄉	2018-11-24T22:28:41+08:00	9034	2996	12030	1550	13580	25014	54.29%	36.12%	21	22
8	屏東縣長治鄉	2018-11-24T22:49:24+08:00	9433	3174	12607	1667	14274	26256	54.36%	35.93%	22	22
8	屏東縣長治鄉	2018-11-24T22:12:03+08:00	7412	2410	9822	1309	11131	20382	54.61%	36.37%	18	22
8	屏東縣長治鄉	2018-11-24T23:33:51+08:00	9433	3174	12607	1667	14274	26256	54.36%	35.93%	22	22
8	屏東縣長治鄉	2018-11-24T23:03:47+08:00	9433	3174	12607	1667	14274	26256	54.36%	35.93%	22	22
8	屏東縣長治鄉	2018-11-25T04:01:30+08:00	9433	3174	12607	1667	14274	26256	54.36%	35.93%	22	22
8	屏東縣長治鄉	2018-11-25T03:42:49+08:00	9433	3174	12607	1667	14274	26256	54.36%	35.93%	22	22
8	屏東縣長治鄉	2018-11-24T23:42:02+08:00	9433	3174	12607	1667	14274	26256	54.36%	35.93%	22	22
8	屏東縣長治鄉	2018-11-25T00:08:05+08:00	9433	3174	12607	1667	14274	26256	54.36%	35.93%	22	22
8	屏東縣長治鄉	2018-11-24T22:53:15+08:00	9433	3174	12607	1667	14274	26256	54.36%	35.93%	22	22
8	屏東縣長治鄉	2018-11-24T23:46:04+08:00	9433	3174	12607	1667	14274	26256	54.36%	35.93%	22	22
8	屏東縣長治鄉	2018-11-25T06:12:37+08:00	9433	3174	12607	1667	14274	26256	54.36%	35.93%	22	22
8	屏東縣長治鄉	2018-11-24T22:21:46+08:00	8001	2636	10637	1388	12025	22195	54.18%	36.05%	19	22
8	屏東縣長治鄉	2018-11-25T00:17:08+08:00	9433	3174	12607	1667	14274	26256	54.36%	35.93%	22	22
8	屏東縣長治鄉	2018-11-25T06:22:45+08:00	9433	3174	12607	1667	14274	26256	54.36%	35.93%	22	22
8	屏東縣長治鄉	2018-11-25T03:48:31+08:00	9433	3174	12607	1667	14274	26256	54.36%	35.93%	22	22
8	屏東縣長治鄉	2018-11-24T22:14:49+08:00	7412	2410	9822	1309	11131	20382	54.61%	36.37%	18	22
8	屏東縣長治鄉	2018-11-24T22:18:20+08:00	8001	2636	10637	1388	12025	22195	54.18%	36.05%	19	22
8	屏東縣長治鄉	2018-11-25T03:37:30+08:00	9433	3174	12607	1667	14274	26256	54.36%	35.93%	22	22
8	屏東縣長治鄉	2018-11-24T23:58:43+08:00	9433	3174	12607	1667	14274	26256	54.36%	35.93%	22	22
8	屏東縣長治鄉	2018-11-25T06:27:55+08:00	9433	3174	12607	1667	14274	26256	54.36%	35.93%	22	22
8	屏東縣長治鄉	2018-11-24T23:26:07+08:00	9433	3174	12607	1667	14274	26256	54.36%	35.93%	22	22
8	屏東縣長治鄉	2018-11-25T00:12:45+08:00	9433	3174	12607	1667	14274	26256	54.36%	35.93%	22	22
8	屏東縣長治鄉	2018-11-25T01:01:02+08:00	9433	3174	12607	1667	14274	26256	54.36%	35.93%	22	22
8	屏東縣長治鄉	2018-11-24T23:18:28+08:00	9433	3174	12607	1667	14274	26256	54.36%	35.93%	22	22
8	屏東縣長治鄉	2018-11-24T23:14:41+08:00	9433	3174	12607	1667	14274	26256	54.36%	35.93%	22	22
8	屏東縣長治鄉	2018-11-24T23:50:15+08:00	9433	3174	12607	1667	14274	26256	54.36%	35.93%	22	22
8	桃園市楊梅區	2018-11-25T03:37:17+08:00	51985	13752	65737	3973	69710	137917	50.54%	37.69%	82	82
8	桃園市楊梅區	2018-11-24T22:39:01+08:00	28993	7646	36639	2296	38935	76326	51.01%	37.99%	49	82
8	桃園市楊梅區	2018-11-25T01:10:58+08:00	51169	13580	64749	3937	68686	135691	50.62%	37.71%	81	82
8	桃園市楊梅區	2018-11-25T00:12:37+08:00	49511	13216	62727	3818	66545	131190	50.72%	37.74%	79	82
8	桃園市楊梅區	2018-11-24T22:49:17+08:00	31140	8189	39329	2434	41763	81940	50.97%	38%	52	82
8	桃園市楊梅區	2018-11-24T23:14:32+08:00	35820	9569	45389	2835	48224	94030	51.29%	38.09%	59	82
8	桃園市楊梅區	2018-11-24T22:43:43+08:00	29709	7840	37549	2332	39881	78208	50.99%	37.99%	50	82
8	桃園市楊梅區	2018-11-24T22:56:30+08:00	33394	8894	42288	2622	44910	87611	51.26%	38.12%	55	82
8	桃園市楊梅區	2018-11-25T06:22:37+08:00	51985	13752	65737	3973	69710	137917	50.54%	37.69%	82	82
8	桃園市楊梅區	2018-11-25T03:30:50+08:00	51985	13752	65737	3973	69710	137917	50.54%	37.69%	82	82
8	桃園市楊梅區	2018-11-25T03:48:21+08:00	51985	13752	65737	3973	69710	137917	50.54%	37.69%	82	82
8	桃園市楊梅區	2018-11-24T22:32:11+08:00	28423	7468	35891	2232	38123	74877	50.91%	37.96%	48	82
8	桃園市楊梅區	2018-11-24T23:29:39+08:00	39240	10497	49737	3068	52805	102721	51.41%	38.2%	64	82
8	桃園市楊梅區	2018-11-25T04:01:21+08:00	51985	13752	65737	3973	69710	137917	50.54%	37.69%	82	82
8	桃園市楊梅區	2018-11-24T22:25:16+08:00	27661	7262	34923	2199	37122	72966	50.88%	37.91%	47	82
8	桃園市楊梅區	2018-11-25T06:07:15+08:00	51985	13752	65737	3973	69710	137917	50.54%	37.69%	82	82
8	桃園市楊梅區	2018-11-25T00:07:56+08:00	48013	12849	60862	3739	64601	127244	50.77%	37.73%	77	82
8	桃園市楊梅區	2018-11-24T22:18:12+08:00	25433	6688	32121	1972	34093	67230	50.71%	37.83%	43	82
8	桃園市楊梅區	2018-11-24T23:54:18+08:00	45926	12259	58185	3554	61739	121294	50.9%	37.86%	74	82
8	桃園市楊梅區	2018-11-25T01:16:14+08:00	51985	13752	65737	3973	69710	137917	50.54%	37.69%	82	82
8	桃園市楊梅區	2018-11-24T23:41:55+08:00	42700	11378	54078	3353	57431	112018	51.27%	38.12%	69	82
8	桃園市楊梅區	2018-11-24T22:28:33+08:00	27661	7262	34923	2199	37122	72966	50.88%	37.91%	47	82
8	桃園市楊梅區	2018-11-24T23:58:34+08:00	46597	12430	59027	3629	62656	123155	50.88%	37.84%	75	82
8	桃園市楊梅區	2018-11-24T23:22:15+08:00	37060	9942	47002	2886	49888	97286	51.28%	38.09%	61	82
8	桃園市楊梅區	2018-11-25T01:24:16+08:00	51985	13752	65737	3973	69710	137917	50.54%	37.69%	82	82
8	桃園市楊梅區	2018-11-24T22:35:38+08:00	28423	7468	35891	2232	38123	74877	50.91%	37.96%	48	82
8	桃園市楊梅區	2018-11-24T23:07:12+08:00	35820	9569	45389	2835	48224	94030	51.29%	38.09%	59	82
8	桃園市楊梅區	2018-11-25T00:56:05+08:00	50382	13405	63787	3856	67643	133401	50.71%	37.77%	80	82
8	桃園市楊梅區	2018-11-25T06:27:48+08:00	51985	13752	65737	3973	69710	137917	50.54%	37.69%	82	82
8	桃園市楊梅區	2018-11-24T23:50:07+08:00	45172	12072	57244	3514	60758	118996	51.06%	37.96%	73	82
8	桃園市楊梅區	2018-11-25T00:03:25+08:00	47325	12644	59969	3678	63647	125256	50.81%	37.78%	76	82
8	桃園市楊梅區	2018-11-24T23:03:41+08:00	35162	9411	44573	2813	47386	92473	51.24%	38.02%	58	82
8	桃園市楊梅區	2018-11-24T23:00:06+08:00	33964	9080	43044	2683	45727	89162	51.29%	38.09%	56	82
8	桃園市楊梅區	2018-11-25T00:21:36+08:00	49511	13216	62727	3818	66545	131190	50.72%	37.74%	79	82
8	桃園市楊梅區	2018-11-25T01:00:52+08:00	51169	13580	64749	3937	68686	135691	50.62%	37.71%	81	82
8	桃園市楊梅區	2018-11-24T22:21:37+08:00	26998	7068	34066	2123	36189	71208	50.82%	37.91%	46	82
8	桃園市楊梅區	2018-11-25T06:12:30+08:00	51985	13752	65737	3973	69710	137917	50.54%	37.69%	82	82
8	桃園市楊梅區	2018-11-24T22:53:06+08:00	31938	8371	40309	2491	42800	83883	51.02%	38.07%	53	82
8	桃園市楊梅區	2018-11-24T22:40:12+08:00	28993	7646	36639	2296	38935	76326	51.01%	37.99%	49	82
8	桃園市楊梅區	2018-11-25T03:42:39+08:00	51985	13752	65737	3973	69710	137917	50.54%	37.69%	82	82
8	桃園市楊梅區	2018-11-25T00:17:01+08:00	49511	13216	62727	3818	66545	131190	50.72%	37.74%	79	82
8	桃園市楊梅區	2018-11-24T22:11:56+08:00	23730	6219	29949	1838	31787	63042	50.42%	37.64%	40	82
8	桃園市楊梅區	2018-11-24T23:33:43+08:00	40739	10903	51642	3181	54823	106795	51.33%	38.15%	66	82
8	桃園市楊梅區	2018-11-24T23:18:20+08:00	35820	9569	45389	2835	48224	94030	51.29%	38.09%	59	82
8	桃園市楊梅區	2018-11-24T23:37:42+08:00	42115	11221	53336	3298	56634	110361	51.32%	38.16%	68	82
8	桃園市楊梅區	2018-11-24T22:14:41+08:00	24823	6519	31342	1972	33314	65814	50.62%	37.72%	42	82
8	桃園市楊梅區	2018-11-25T01:05:50+08:00	51169	13580	64749	3937	68686	135691	50.62%	37.71%	81	82
8	桃園市楊梅區	2018-11-24T23:26:00+08:00	38528	10334	48862	3007	51869	101134	51.29%	38.1%	63	82
8	桃園市楊梅區	2018-11-24T23:10:49+08:00	35820	9569	45389	2835	48224	94030	51.29%	38.09%	59	82
8	桃園市楊梅區	2018-11-25T03:54:32+08:00	51985	13752	65737	3973	69710	137917	50.54%	37.69%	82	82
8	桃園市楊梅區	2018-11-25T06:17:28+08:00	51985	13752	65737	3973	69710	137917	50.54%	37.69%	82	82
8	桃園市楊梅區	2018-11-24T23:45:57+08:00	43822	11691	55513	3440	58953	115090	51.22%	38.08%	71	82
8	高雄市前金區	2018-11-24T23:03:43+08:00	8976	3222	12198	910	13108	22147	59.19%	40.53%	21	22
8	高雄市前金區	2018-11-24T23:58:37+08:00	9714	3464	13178	953	14131	23928	59.06%	40.6%	22	22
8	高雄市前金區	2018-11-25T06:17:31+08:00	9714	3464	13178	953	14131	23928	59.06%	40.6%	22	22
8	高雄市前金區	2018-11-24T23:22:18+08:00	8976	3222	12198	910	13108	22147	59.19%	40.53%	21	22
8	高雄市前金區	2018-11-25T00:03:29+08:00	9714	3464	13178	953	14131	23928	59.06%	40.6%	22	22
8	高雄市前金區	2018-11-24T23:14:35+08:00	8976	3222	12198	910	13108	22147	59.19%	40.53%	21	22
8	高雄市前金區	2018-11-25T03:37:20+08:00	9714	3464	13178	953	14131	23928	59.06%	40.6%	22	22
8	高雄市前金區	2018-11-25T00:56:09+08:00	9714	3464	13178	953	14131	23928	59.06%	40.6%	22	22
8	高雄市前金區	2018-11-24T22:49:19+08:00	7774	2851	10625	811	11436	19244	59.43%	40.4%	19	22
8	高雄市前金區	2018-11-25T03:42:43+08:00	9714	3464	13178	953	14131	23928	59.06%	40.6%	22	22
8	高雄市前金區	2018-11-24T22:53:10+08:00	7774	2851	10625	811	11436	19244	59.43%	40.4%	19	22
8	高雄市前金區	2018-11-25T00:08:00+08:00	9714	3464	13178	953	14131	23928	59.06%	40.6%	22	22
8	高雄市前金區	2018-11-25T01:00:56+08:00	9714	3464	13178	953	14131	23928	59.06%	40.6%	22	22
8	高雄市前金區	2018-11-24T22:25:19+08:00	7774	2851	10625	811	11436	19244	59.43%	40.4%	19	22
8	高雄市前金區	2018-11-25T06:12:33+08:00	9714	3464	13178	953	14131	23928	59.06%	40.6%	22	22
8	高雄市前金區	2018-11-25T00:17:03+08:00	9714	3464	13178	953	14131	23928	59.06%	40.6%	22	22
8	高雄市前金區	2018-11-25T06:22:41+08:00	9714	3464	13178	953	14131	23928	59.06%	40.6%	22	22
8	高雄市前金區	2018-11-24T23:18:23+08:00	8976	3222	12198	910	13108	22147	59.19%	40.53%	21	22
8	高雄市前金區	2018-11-24T23:50:10+08:00	9714	3464	13178	953	14131	23928	59.06%	40.6%	22	22
8	高雄市前金區	2018-11-24T22:18:15+08:00	7124	2627	9751	781	10532	17570	59.94%	40.55%	18	22
8	高雄市前金區	2018-11-24T22:28:35+08:00	7774	2851	10625	811	11436	19244	59.43%	40.4%	19	22
8	高雄市前金區	2018-11-24T22:14:44+08:00	7124	2627	9751	781	10532	17570	59.94%	40.55%	18	22
8	高雄市前金區	2018-11-25T01:05:54+08:00	9714	3464	13178	953	14131	23928	59.06%	40.6%	22	22
8	高雄市前金區	2018-11-24T23:54:21+08:00	9714	3464	13178	953	14131	23928	59.06%	40.6%	22	22
8	高雄市前金區	2018-11-24T23:33:46+08:00	8976	3222	12198	910	13108	22147	59.19%	40.53%	21	22
8	高雄市前金區	2018-11-25T06:27:51+08:00	9714	3464	13178	953	14131	23928	59.06%	40.6%	22	22
8	高雄市前金區	2018-11-24T23:26:03+08:00	8976	3222	12198	910	13108	22147	59.19%	40.53%	21	22
8	高雄市前金區	2018-11-25T03:54:36+08:00	9714	3464	13178	953	14131	23928	59.06%	40.6%	22	22
8	高雄市前金區	2018-11-25T00:12:41+08:00	9714	3464	13178	953	14131	23928	59.06%	40.6%	22	22
8	高雄市前金區	2018-11-24T22:56:32+08:00	8204	3009	11213	835	12048	20341	59.23%	40.33%	20	22
8	高雄市前金區	2018-11-24T22:43:46+08:00	7774	2851	10625	811	11436	19244	59.43%	40.4%	19	22
8	高雄市前金區	2018-11-25T01:24:19+08:00	9714	3464	13178	953	14131	23928	59.06%	40.6%	22	22
8	高雄市前金區	2018-11-24T22:39:04+08:00	7774	2851	10625	811	11436	19244	59.43%	40.4%	19	22
8	高雄市前金區	2018-11-24T23:10:52+08:00	8976	3222	12198	910	13108	22147	59.19%	40.53%	21	22
8	高雄市前金區	2018-11-24T23:07:14+08:00	8976	3222	12198	910	13108	22147	59.19%	40.53%	21	22
8	高雄市前金區	2018-11-25T00:21:39+08:00	9714	3464	13178	953	14131	23928	59.06%	40.6%	22	22
8	高雄市前金區	2018-11-24T22:32:14+08:00	7774	2851	10625	811	11436	19244	59.43%	40.4%	19	22
8	高雄市前金區	2018-11-25T03:30:54+08:00	9714	3464	13178	953	14131	23928	59.06%	40.6%	22	22
8	高雄市前金區	2018-11-25T03:48:24+08:00	9714	3464	13178	953	14131	23928	59.06%	40.6%	22	22
8	高雄市前金區	2018-11-24T22:40:15+08:00	7774	2851	10625	811	11436	19244	59.43%	40.4%	19	22
8	高雄市前金區	2018-11-24T23:29:42+08:00	8976	3222	12198	910	13108	22147	59.19%	40.53%	21	22
8	高雄市前金區	2018-11-25T01:11:02+08:00	9714	3464	13178	953	14131	23928	59.06%	40.6%	22	22
8	高雄市前金區	2018-11-24T23:00:13+08:00	8204	3009	11213	835	12048	20341	59.23%	40.33%	20	22
8	高雄市前金區	2018-11-24T22:21:41+08:00	7774	2851	10625	811	11436	19244	59.43%	40.4%	19	22
8	高雄市前金區	2018-11-25T06:07:18+08:00	9714	3464	13178	953	14131	23928	59.06%	40.6%	22	22
8	高雄市前金區	2018-11-24T22:11:58+08:00	7124	2627	9751	781	10532	17570	59.94%	40.55%	18	22
8	高雄市前金區	2018-11-25T04:01:24+08:00	9714	3464	13178	953	14131	23928	59.06%	40.6%	22	22
8	高雄市前金區	2018-11-24T23:41:57+08:00	8976	3222	12198	910	13108	22147	59.19%	40.53%	21	22
8	高雄市前金區	2018-11-24T23:37:45+08:00	8976	3222	12198	910	13108	22147	59.19%	40.53%	21	22
8	高雄市前金區	2018-11-24T22:35:40+08:00	7774	2851	10625	811	11436	19244	59.43%	40.4%	19	22
8	高雄市前金區	2018-11-24T23:45:59+08:00	9714	3464	13178	953	14131	23928	59.06%	40.6%	22	22
8	高雄市前金區	2018-11-25T01:16:17+08:00	9714	3464	13178	953	14131	23928	59.06%	40.6%	22	22
8	高雄市仁武區	2018-11-24T22:49:20+08:00	21950	7002	28952	2036	30988	53747	57.66%	40.84%	36	47
8	高雄市仁武區	2018-11-25T03:37:21+08:00	30136	9368	39504	2644	42148	73611	57.26%	40.94%	47	47
8	高雄市仁武區	2018-11-24T23:03:43+08:00	22773	7260	30033	2123	32156	55570	57.87%	40.98%	37	47
8	高雄市仁武區	2018-11-24T23:58:37+08:00	25356	7910	33266	2288	35554	61589	57.73%	41.17%	40	47
8	高雄市仁武區	2018-11-25T00:03:29+08:00	25356	7910	33266	2288	35554	61589	57.73%	41.17%	40	47
8	高雄市仁武區	2018-11-25T00:56:09+08:00	28748	8966	37714	2525	40239	70315	57.23%	40.88%	45	47
8	高雄市仁武區	2018-11-24T23:22:19+08:00	24442	7760	32202	2231	34433	59597	57.78%	41.01%	39	47
8	高雄市仁武區	2018-11-25T03:42:43+08:00	30136	9368	39504	2644	42148	73611	57.26%	40.94%	47	47
8	高雄市仁武區	2018-11-24T22:53:10+08:00	21950	7002	28952	2036	30988	53747	57.66%	40.84%	36	47
8	高雄市仁武區	2018-11-25T00:08:00+08:00	25356	7910	33266	2288	35554	61589	57.73%	41.17%	40	47
8	高雄市仁武區	2018-11-24T23:46:00+08:00	24442	7760	32202	2231	34433	59597	57.78%	41.01%	39	47
8	高雄市仁武區	2018-11-25T01:00:56+08:00	28748	8966	37714	2525	40239	70315	57.23%	40.88%	45	47
8	高雄市仁武區	2018-11-25T06:12:33+08:00	30136	9368	39504	2644	42148	73611	57.26%	40.94%	47	47
8	高雄市仁武區	2018-11-25T00:17:04+08:00	27126	8484	35610	2402	38012	65776	57.79%	41.24%	42	47
8	高雄市仁武區	2018-11-25T06:22:41+08:00	30136	9368	39504	2644	42148	73611	57.26%	40.94%	47	47
8	高雄市仁武區	2018-11-24T22:25:20+08:00	17974	5754	23728	1721	25449	43685	58.26%	41.14%	30	47
8	高雄市仁武區	2018-11-24T23:18:23+08:00	24442	7760	32202	2231	34433	59597	57.78%	41.01%	39	47
8	高雄市仁武區	2018-11-24T22:18:15+08:00	16509	5304	21813	1644	23457	40310	58.19%	40.96%	28	47
8	高雄市仁武區	2018-11-24T22:14:44+08:00	15650	5045	20695	1597	22292	38395	58.06%	40.76%	27	47
8	高雄市仁武區	2018-11-24T23:50:11+08:00	24442	7760	32202	2231	34433	59597	57.78%	41.01%	39	47
8	高雄市仁武區	2018-11-25T01:05:54+08:00	28748	8966	37714	2525	40239	70315	57.23%	40.88%	45	47
8	高雄市仁武區	2018-11-24T23:33:46+08:00	24442	7760	32202	2231	34433	59597	57.78%	41.01%	39	47
8	高雄市仁武區	2018-11-25T06:27:51+08:00	30136	9368	39504	2644	42148	73611	57.26%	40.94%	47	47
8	高雄市仁武區	2018-11-24T23:26:03+08:00	24442	7760	32202	2231	34433	59597	57.78%	41.01%	39	47
8	高雄市仁武區	2018-11-25T03:54:36+08:00	30136	9368	39504	2644	42148	73611	57.26%	40.94%	47	47
8	高雄市仁武區	2018-11-25T00:12:41+08:00	25356	7910	33266	2288	35554	61589	57.73%	41.17%	40	47
8	高雄市仁武區	2018-11-25T01:24:20+08:00	29248	9135	38383	2572	40955	71719	57.1%	40.78%	46	47
8	高雄市仁武區	2018-11-24T22:43:46+08:00	21247	6799	28046	1954	30000	51870	57.84%	40.96%	35	47
8	高雄市仁武區	2018-11-25T06:17:32+08:00	30136	9368	39504	2644	42148	73611	57.26%	40.94%	47	47
8	高雄市仁武區	2018-11-24T22:39:05+08:00	21247	6799	28046	1954	30000	51870	57.84%	40.96%	35	47
8	高雄市仁武區	2018-11-24T22:56:33+08:00	21950	7002	28952	2036	30988	53747	57.66%	40.84%	36	47
8	高雄市仁武區	2018-11-24T23:14:36+08:00	22773	7260	30033	2123	32156	55570	57.87%	40.98%	37	47
8	高雄市仁武區	2018-11-24T23:10:52+08:00	22773	7260	30033	2123	32156	55570	57.87%	40.98%	37	47
8	高雄市仁武區	2018-11-24T23:07:14+08:00	22773	7260	30033	2123	32156	55570	57.87%	40.98%	37	47
8	高雄市仁武區	2018-11-25T03:48:25+08:00	30136	9368	39504	2644	42148	73611	57.26%	40.94%	47	47
8	高雄市仁武區	2018-11-24T22:32:14+08:00	20419	6527	26946	1891	28837	49703	58.02%	41.08%	34	47
8	高雄市仁武區	2018-11-25T03:30:54+08:00	30136	9368	39504	2644	42148	73611	57.26%	40.94%	47	47
8	高雄市仁武區	2018-11-24T22:40:15+08:00	21247	6799	28046	1954	30000	51870	57.84%	40.96%	35	47
8	高雄市仁武區	2018-11-25T00:21:40+08:00	27126	8484	35610	2402	38012	65776	57.79%	41.24%	42	47
8	高雄市仁武區	2018-11-24T23:29:42+08:00	24442	7760	32202	2231	34433	59597	57.78%	41.01%	39	47
8	高雄市仁武區	2018-11-25T01:11:02+08:00	28748	8966	37714	2525	40239	70315	57.23%	40.88%	45	47
8	高雄市仁武區	2018-11-24T23:00:13+08:00	21950	7002	28952	2036	30988	53747	57.66%	40.84%	36	47
8	高雄市仁武區	2018-11-24T22:11:59+08:00	15650	5045	20695	1597	22292	38395	58.06%	40.76%	27	47
8	高雄市仁武區	2018-11-24T22:21:41+08:00	17974	5754	23728	1721	25449	43685	58.26%	41.14%	30	47
8	高雄市仁武區	2018-11-25T06:07:18+08:00	30136	9368	39504	2644	42148	73611	57.26%	40.94%	47	47
8	高雄市仁武區	2018-11-25T04:01:24+08:00	30136	9368	39504	2644	42148	73611	57.26%	40.94%	47	47
8	高雄市仁武區	2018-11-24T22:28:36+08:00	19123	6190	25313	1808	27121	46572	58.23%	41.06%	32	47
8	高雄市仁武區	2018-11-24T22:35:41+08:00	20419	6527	26946	1891	28837	49703	58.02%	41.08%	34	47
8	高雄市仁武區	2018-11-24T23:37:45+08:00	24442	7760	32202	2231	34433	59597	57.78%	41.01%	39	47
8	高雄市仁武區	2018-11-24T23:41:58+08:00	24442	7760	32202	2231	34433	59597	57.78%	41.01%	39	47
8	高雄市仁武區	2018-11-24T23:54:22+08:00	24442	7760	32202	2231	34433	59597	57.78%	41.01%	39	47
8	高雄市仁武區	2018-11-25T01:16:17+08:00	28748	8966	37714	2525	40239	70315	57.23%	40.88%	45	47
8	苗栗縣西湖鄉	2018-11-25T03:37:26+08:00	2586	661	3247	278	3525	6382	55.23%	40.52%	9	9
8	苗栗縣西湖鄉	2018-11-24T23:07:16+08:00	2586	661	3247	278	3525	6382	55.23%	40.52%	9	9
8	苗栗縣西湖鄉	2018-11-24T22:12:00+08:00	2586	661	3247	278	3525	6382	55.23%	40.52%	9	9
8	苗栗縣西湖鄉	2018-11-24T22:39:06+08:00	2586	661	3247	278	3525	6382	55.23%	40.52%	9	9
8	苗栗縣西湖鄉	2018-11-24T23:03:45+08:00	2586	661	3247	278	3525	6382	55.23%	40.52%	9	9
8	苗栗縣西湖鄉	2018-11-24T22:49:21+08:00	2586	661	3247	278	3525	6382	55.23%	40.52%	9	9
8	苗栗縣西湖鄉	2018-11-24T23:22:21+08:00	2586	661	3247	278	3525	6382	55.23%	40.52%	9	9
8	苗栗縣西湖鄉	2018-11-25T01:24:22+08:00	2586	661	3247	278	3525	6382	55.23%	40.52%	9	9
8	苗栗縣西湖鄉	2018-11-24T23:46:01+08:00	2586	661	3247	278	3525	6382	55.23%	40.52%	9	9
8	苗栗縣西湖鄉	2018-11-24T23:42:00+08:00	2586	661	3247	278	3525	6382	55.23%	40.52%	9	9
8	苗栗縣西湖鄉	2018-11-25T03:30:56+08:00	2586	661	3247	278	3525	6382	55.23%	40.52%	9	9
8	苗栗縣西湖鄉	2018-11-25T03:42:45+08:00	2586	661	3247	278	3525	6382	55.23%	40.52%	9	9
8	苗栗縣西湖鄉	2018-11-24T22:32:16+08:00	2586	661	3247	278	3525	6382	55.23%	40.52%	9	9
8	苗栗縣西湖鄉	2018-11-25T03:48:27+08:00	2586	661	3247	278	3525	6382	55.23%	40.52%	9	9
8	苗栗縣西湖鄉	2018-11-25T01:00:58+08:00	2586	661	3247	278	3525	6382	55.23%	40.52%	9	9
8	苗栗縣西湖鄉	2018-11-24T22:25:21+08:00	2586	661	3247	278	3525	6382	55.23%	40.52%	9	9
8	苗栗縣西湖鄉	2018-11-25T06:12:34+08:00	2586	661	3247	278	3525	6382	55.23%	40.52%	9	9
8	苗栗縣西湖鄉	2018-11-25T04:01:27+08:00	2586	661	3247	278	3525	6382	55.23%	40.52%	9	9
8	苗栗縣西湖鄉	2018-11-24T22:21:43+08:00	2586	661	3247	278	3525	6382	55.23%	40.52%	9	9
8	苗栗縣西湖鄉	2018-11-24T22:40:17+08:00	2586	661	3247	278	3525	6382	55.23%	40.52%	9	9
8	苗栗縣西湖鄉	2018-11-25T00:21:42+08:00	2586	661	3247	278	3525	6382	55.23%	40.52%	9	9
8	苗栗縣西湖鄉	2018-11-24T23:37:46+08:00	2586	661	3247	278	3525	6382	55.23%	40.52%	9	9
8	苗栗縣西湖鄉	2018-11-24T22:35:42+08:00	2586	661	3247	278	3525	6382	55.23%	40.52%	9	9
8	苗栗縣西湖鄉	2018-11-24T23:58:40+08:00	2586	661	3247	278	3525	6382	55.23%	40.52%	9	9
8	苗栗縣西湖鄉	2018-11-24T23:26:05+08:00	2586	661	3247	278	3525	6382	55.23%	40.52%	9	9
8	苗栗縣西湖鄉	2018-11-24T23:18:25+08:00	2586	661	3247	278	3525	6382	55.23%	40.52%	9	9
8	苗栗縣西湖鄉	2018-11-24T23:33:48+08:00	2586	661	3247	278	3525	6382	55.23%	40.52%	9	9
8	苗栗縣西湖鄉	2018-11-25T03:54:38+08:00	2586	661	3247	278	3525	6382	55.23%	40.52%	9	9
8	苗栗縣西湖鄉	2018-11-24T22:43:48+08:00	2586	661	3247	278	3525	6382	55.23%	40.52%	9	9
8	苗栗縣西湖鄉	2018-11-24T23:10:54+08:00	2586	661	3247	278	3525	6382	55.23%	40.52%	9	9
8	苗栗縣西湖鄉	2018-11-24T23:14:37+08:00	2586	661	3247	278	3525	6382	55.23%	40.52%	9	9
8	苗栗縣西湖鄉	2018-11-25T06:17:33+08:00	2586	661	3247	278	3525	6382	55.23%	40.52%	9	9
8	苗栗縣西湖鄉	2018-11-24T22:56:34+08:00	2586	661	3247	278	3525	6382	55.23%	40.52%	9	9
8	苗栗縣西湖鄉	2018-11-25T00:08:02+08:00	2586	661	3247	278	3525	6382	55.23%	40.52%	9	9
8	苗栗縣西湖鄉	2018-11-24T22:53:12+08:00	2586	661	3247	278	3525	6382	55.23%	40.52%	9	9
8	苗栗縣西湖鄉	2018-11-25T06:22:43+08:00	2586	661	3247	278	3525	6382	55.23%	40.52%	9	9
8	苗栗縣西湖鄉	2018-11-24T23:29:44+08:00	2586	661	3247	278	3525	6382	55.23%	40.52%	9	9
8	苗栗縣西湖鄉	2018-11-25T00:17:06+08:00	2586	661	3247	278	3525	6382	55.23%	40.52%	9	9
8	苗栗縣西湖鄉	2018-11-25T01:11:04+08:00	2586	661	3247	278	3525	6382	55.23%	40.52%	9	9
8	苗栗縣西湖鄉	2018-11-25T06:07:20+08:00	2586	661	3247	278	3525	6382	55.23%	40.52%	9	9
8	苗栗縣西湖鄉	2018-11-24T23:00:15+08:00	2586	661	3247	278	3525	6382	55.23%	40.52%	9	9
8	苗栗縣西湖鄉	2018-11-25T00:12:43+08:00	2586	661	3247	278	3525	6382	55.23%	40.52%	9	9
8	苗栗縣西湖鄉	2018-11-24T22:28:38+08:00	2586	661	3247	278	3525	6382	55.23%	40.52%	9	9
8	苗栗縣西湖鄉	2018-11-25T01:05:56+08:00	2586	661	3247	278	3525	6382	55.23%	40.52%	9	9
8	苗栗縣西湖鄉	2018-11-25T06:27:53+08:00	2586	661	3247	278	3525	6382	55.23%	40.52%	9	9
8	苗栗縣西湖鄉	2018-11-25T00:03:31+08:00	2586	661	3247	278	3525	6382	55.23%	40.52%	9	9
8	苗栗縣西湖鄉	2018-11-24T23:54:25+08:00	2586	661	3247	278	3525	6382	55.23%	40.52%	9	9
8	苗栗縣西湖鄉	2018-11-24T22:14:46+08:00	2586	661	3247	278	3525	6382	55.23%	40.52%	9	9
8	苗栗縣西湖鄉	2018-11-25T00:56:11+08:00	2586	661	3247	278	3525	6382	55.23%	40.52%	9	9
8	苗栗縣西湖鄉	2018-11-24T22:18:17+08:00	2586	661	3247	278	3525	6382	55.23%	40.52%	9	9
8	苗栗縣西湖鄉	2018-11-25T01:16:19+08:00	2586	661	3247	278	3525	6382	55.23%	40.52%	9	9
8	苗栗縣西湖鄉	2018-11-24T23:50:12+08:00	2586	661	3247	278	3525	6382	55.23%	40.52%	9	9
8	苗栗縣竹南鎮	2018-11-24T23:07:16+08:00	24590	6927	31517	2273	33790	60048	56.27%	40.95%	55	61
8	苗栗縣竹南鎮	2018-11-24T22:12:00+08:00	13213	3649	16862	1198	18060	32071	56.31%	41.2%	32	61
8	苗栗縣竹南鎮	2018-11-24T22:39:06+08:00	19468	5479	24947	1787	26734	47436	56.36%	41.04%	45	61
8	苗栗縣竹南鎮	2018-11-24T23:22:20+08:00	25777	7227	33004	2351	35355	62911	56.2%	40.97%	57	61
8	苗栗縣竹南鎮	2018-11-24T23:58:39+08:00	27453	7617	35070	2463	37533	67040	55.99%	40.95%	60	61
8	苗栗縣竹南鎮	2018-11-24T23:03:45+08:00	24113	6784	30897	2222	33119	58929	56.2%	40.92%	54	61
8	苗栗縣竹南鎮	2018-11-24T22:49:21+08:00	21526	5997	27523	1951	29474	52227	56.43%	41.22%	49	61
8	苗栗縣竹南鎮	2018-11-24T23:46:01+08:00	27044	7494	34538	2428	36966	65967	56.04%	41%	59	61
8	苗栗縣竹南鎮	2018-11-25T03:48:26+08:00	28011	7800	35811	2497	38308	68528	55.9%	40.88%	61	61
8	苗栗縣竹南鎮	2018-11-25T03:30:56+08:00	28011	7800	35811	2497	38308	68528	55.9%	40.88%	61	61
8	苗栗縣竹南鎮	2018-11-25T03:42:45+08:00	28011	7800	35811	2497	38308	68528	55.9%	40.88%	61	61
8	苗栗縣竹南鎮	2018-11-24T22:32:16+08:00	17964	4986	22950	1618	24568	43626	56.32%	41.18%	42	61
8	苗栗縣竹南鎮	2018-11-25T01:00:58+08:00	28011	7800	35811	2497	38308	68528	55.9%	40.88%	61	61
8	苗栗縣竹南鎮	2018-11-25T04:01:26+08:00	28011	7800	35811	2497	38308	68528	55.9%	40.88%	61	61
8	苗栗縣竹南鎮	2018-11-24T22:25:21+08:00	16437	4576	21013	1491	22504	40116	56.1%	40.97%	39	61
8	苗栗縣竹南鎮	2018-11-25T06:12:34+08:00	28011	7800	35811	2497	38308	68528	55.9%	40.88%	61	61
8	苗栗縣竹南鎮	2018-11-24T22:40:16+08:00	19876	5594	25470	1808	27278	48602	56.13%	40.9%	46	61
8	苗栗縣竹南鎮	2018-11-24T22:21:43+08:00	15952	4405	20357	1447	21804	38794	56.2%	41.12%	38	61
8	苗栗縣竹南鎮	2018-11-25T00:17:05+08:00	27453	7617	35070	2463	37533	67040	55.99%	40.95%	60	61
8	苗栗縣竹南鎮	2018-11-24T23:18:24+08:00	25218	7084	32302	2310	34612	61618	56.17%	40.93%	56	61
8	苗栗縣竹南鎮	2018-11-24T23:37:46+08:00	27044	7494	34538	2428	36966	65967	56.04%	41%	59	61
8	苗栗縣竹南鎮	2018-11-24T22:35:42+08:00	18843	5304	24147	1752	25899	45983	56.32%	40.98%	44	61
8	苗栗縣竹南鎮	2018-11-25T03:54:37+08:00	28011	7800	35811	2497	38308	68528	55.9%	40.88%	61	61
8	苗栗縣竹南鎮	2018-11-24T23:33:47+08:00	27044	7494	34538	2428	36966	65967	56.04%	41%	59	61
8	苗栗縣竹南鎮	2018-11-24T23:26:04+08:00	25777	7227	33004	2351	35355	62911	56.2%	40.97%	57	61
8	苗栗縣竹南鎮	2018-11-24T23:10:54+08:00	24590	6927	31517	2273	33790	60048	56.27%	40.95%	55	61
8	苗栗縣竹南鎮	2018-11-24T23:14:37+08:00	24590	6927	31517	2273	33790	60048	56.27%	40.95%	55	61
8	苗栗縣竹南鎮	2018-11-25T06:17:33+08:00	28011	7800	35811	2497	38308	68528	55.9%	40.88%	61	61
8	苗栗縣竹南鎮	2018-11-24T22:43:47+08:00	20464	5749	26213	1856	28069	49943	56.2%	40.97%	47	61
8	苗栗縣竹南鎮	2018-11-25T01:24:21+08:00	28011	7800	35811	2497	38308	68528	55.9%	40.88%	61	61
8	苗栗縣竹南鎮	2018-11-24T22:56:34+08:00	22015	6115	28130	1997	30127	53480	56.33%	41.16%	50	61
8	苗栗縣竹南鎮	2018-11-25T03:37:24+08:00	28011	7800	35811	2497	38308	68528	55.9%	40.88%	61	61
8	苗栗縣竹南鎮	2018-11-25T00:08:02+08:00	27453	7617	35070	2463	37533	67040	55.99%	40.95%	60	61
8	苗栗縣竹南鎮	2018-11-24T22:53:12+08:00	21526	5997	27523	1951	29474	52227	56.43%	41.22%	49	61
8	苗栗縣竹南鎮	2018-11-25T01:11:04+08:00	28011	7800	35811	2497	38308	68528	55.9%	40.88%	61	61
8	苗栗縣竹南鎮	2018-11-24T23:29:43+08:00	25777	7227	33004	2351	35355	62911	56.2%	40.97%	57	61
8	苗栗縣竹南鎮	2018-11-25T00:21:41+08:00	27453	7617	35070	2463	37533	67040	55.99%	40.95%	60	61
8	苗栗縣竹南鎮	2018-11-25T06:22:42+08:00	28011	7800	35811	2497	38308	68528	55.9%	40.88%	61	61
8	苗栗縣竹南鎮	2018-11-25T06:07:20+08:00	28011	7800	35811	2497	38308	68528	55.9%	40.88%	61	61
8	苗栗縣竹南鎮	2018-11-24T23:00:15+08:00	23063	6448	29511	2116	31627	56330	56.15%	40.94%	52	61
8	苗栗縣竹南鎮	2018-11-25T01:05:56+08:00	28011	7800	35811	2497	38308	68528	55.9%	40.88%	61	61
8	苗栗縣竹南鎮	2018-11-24T23:54:24+08:00	27453	7617	35070	2463	37533	67040	55.99%	40.95%	60	61
8	苗栗縣竹南鎮	2018-11-24T23:41:59+08:00	27044	7494	34538	2428	36966	65967	56.04%	41%	59	61
8	苗栗縣竹南鎮	2018-11-25T00:03:31+08:00	27453	7617	35070	2463	37533	67040	55.99%	40.95%	60	61
8	苗栗縣竹南鎮	2018-11-24T22:14:46+08:00	13656	3801	17457	1238	18695	33372	56.02%	40.92%	33	61
8	苗栗縣竹南鎮	2018-11-25T06:27:52+08:00	28011	7800	35811	2497	38308	68528	55.9%	40.88%	61	61
8	苗栗縣竹南鎮	2018-11-25T00:56:11+08:00	27453	7617	35070	2463	37533	67040	55.99%	40.95%	60	61
8	苗栗縣竹南鎮	2018-11-24T22:18:17+08:00	14772	4091	18863	1303	20166	36066	55.91%	40.96%	35	61
8	苗栗縣竹南鎮	2018-11-25T00:12:42+08:00	27453	7617	35070	2463	37533	67040	55.99%	40.95%	60	61
8	苗栗縣竹南鎮	2018-11-24T22:28:37+08:00	17964	4986	22950	1618	24568	43626	56.32%	41.18%	42	61
8	苗栗縣竹南鎮	2018-11-25T01:16:19+08:00	28011	7800	35811	2497	38308	68528	55.9%	40.88%	61	61
8	苗栗縣竹南鎮	2018-11-24T23:50:12+08:00	27453	7617	35070	2463	37533	67040	55.99%	40.95%	60	61
8	南投縣仁愛鄉	2018-11-24T22:39:08+08:00	2998	750	3748	357	4105	7967	51.53%	37.63%	19	25
8	南投縣仁愛鄉	2018-11-25T03:37:28+08:00	4953	1158	6111	535	6646	12589	52.79%	39.34%	25	25
8	南投縣仁愛鄉	2018-11-25T01:24:23+08:00	4953	1158	6111	535	6646	12589	52.79%	39.34%	25	25
8	南投縣仁愛鄉	2018-11-24T23:07:17+08:00	3899	960	4859	441	5300	10291	51.5%	37.89%	22	25
8	南投縣仁愛鄉	2018-11-24T22:12:01+08:00	2459	648	3107	330	3437	6606	52.03%	37.22%	17	25
8	南投縣仁愛鄉	2018-11-24T22:32:17+08:00	2747	711	3458	345	3803	7558	50.32%	36.35%	18	25
8	南投縣仁愛鄉	2018-11-25T03:48:28+08:00	4953	1158	6111	535	6646	12589	52.79%	39.34%	25	25
8	南投縣仁愛鄉	2018-11-25T03:30:58+08:00	4953	1158	6111	535	6646	12589	52.79%	39.34%	25	25
8	南投縣仁愛鄉	2018-11-24T23:42:01+08:00	4357	1026	5383	481	5864	11180	52.45%	38.97%	23	25
8	南投縣仁愛鄉	2018-11-24T22:21:45+08:00	2747	711	3458	345	3803	7558	50.32%	36.35%	18	25
8	南投縣仁愛鄉	2018-11-25T04:01:28+08:00	4953	1158	6111	535	6646	12589	52.79%	39.34%	25	25
8	南投縣仁愛鄉	2018-11-25T00:21:43+08:00	4682	1087	5769	496	6265	12080	51.86%	38.76%	24	25
8	南投縣仁愛鄉	2018-11-25T01:11:06+08:00	4953	1158	6111	535	6646	12589	52.79%	39.34%	25	25
8	南投縣仁愛鄉	2018-11-24T22:40:18+08:00	3304	833	4137	406	4543	8639	52.59%	38.25%	20	25
8	南投縣仁愛鄉	2018-11-24T23:00:16+08:00	3704	925	4629	435	5064	9612	52.68%	38.54%	21	25
8	南投縣仁愛鄉	2018-11-25T06:12:35+08:00	4953	1158	6111	535	6646	12589	52.79%	39.34%	25	25
8	南投縣仁愛鄉	2018-11-25T03:54:39+08:00	4953	1158	6111	535	6646	12589	52.79%	39.34%	25	25
8	南投縣仁愛鄉	2018-11-25T01:01:00+08:00	4953	1158	6111	535	6646	12589	52.79%	39.34%	25	25
8	南投縣仁愛鄉	2018-11-24T23:33:49+08:00	3899	960	4859	441	5300	10291	51.5%	37.89%	22	25
8	南投縣仁愛鄉	2018-11-25T00:03:33+08:00	4682	1087	5769	496	6265	12080	51.86%	38.76%	24	25
8	南投縣仁愛鄉	2018-11-24T23:37:47+08:00	4357	1026	5383	481	5864	11180	52.45%	38.97%	23	25
8	南投縣仁愛鄉	2018-11-24T22:35:43+08:00	2747	711	3458	345	3803	7558	50.32%	36.35%	18	25
8	南投縣仁愛鄉	2018-11-24T23:54:26+08:00	4357	1026	5383	481	5864	11180	52.45%	38.97%	23	25
8	南投縣仁愛鄉	2018-11-24T23:58:41+08:00	4357	1026	5383	481	5864	11180	52.45%	38.97%	23	25
8	南投縣仁愛鄉	2018-11-25T00:56:12+08:00	4953	1158	6111	535	6646	12589	52.79%	39.34%	25	25
8	南投縣仁愛鄉	2018-11-24T22:56:35+08:00	3304	833	4137	406	4543	8639	52.59%	38.25%	20	25
8	南投縣仁愛鄉	2018-11-25T06:17:35+08:00	4953	1158	6111	535	6646	12589	52.79%	39.34%	25	25
8	南投縣仁愛鄉	2018-11-24T22:49:23+08:00	3304	833	4137	406	4543	8639	52.59%	38.25%	20	25
8	南投縣仁愛鄉	2018-11-24T23:14:39+08:00	3899	960	4859	441	5300	10291	51.5%	37.89%	22	25
8	南投縣仁愛鄉	2018-11-24T23:22:22+08:00	3899	960	4859	441	5300	10291	51.5%	37.89%	22	25
8	南投縣仁愛鄉	2018-11-24T22:43:49+08:00	3304	833	4137	406	4543	8639	52.59%	38.25%	20	25
8	南投縣仁愛鄉	2018-11-24T23:03:46+08:00	3899	960	4859	441	5300	10291	51.5%	37.89%	22	25
8	南投縣仁愛鄉	2018-11-24T23:10:55+08:00	3899	960	4859	441	5300	10291	51.5%	37.89%	22	25
8	南投縣仁愛鄉	2018-11-25T00:08:03+08:00	4682	1087	5769	496	6265	12080	51.86%	38.76%	24	25
8	南投縣仁愛鄉	2018-11-25T03:42:47+08:00	4953	1158	6111	535	6646	12589	52.79%	39.34%	25	25
8	南投縣仁愛鄉	2018-11-24T22:53:14+08:00	3304	833	4137	406	4543	8639	52.59%	38.25%	20	25
8	南投縣仁愛鄉	2018-11-24T23:46:02+08:00	4357	1026	5383	481	5864	11180	52.45%	38.97%	23	25
8	南投縣仁愛鄉	2018-11-25T00:17:07+08:00	4682	1087	5769	496	6265	12080	51.86%	38.76%	24	25
8	南投縣仁愛鄉	2018-11-24T23:29:45+08:00	3899	960	4859	441	5300	10291	51.5%	37.89%	22	25
8	南投縣仁愛鄉	2018-11-25T06:22:44+08:00	4953	1158	6111	535	6646	12589	52.79%	39.34%	25	25
8	南投縣仁愛鄉	2018-11-25T06:07:21+08:00	4953	1158	6111	535	6646	12589	52.79%	39.34%	25	25
8	南投縣仁愛鄉	2018-11-24T22:25:23+08:00	2747	711	3458	345	3803	7558	50.32%	36.35%	18	25
8	南投縣仁愛鄉	2018-11-25T01:05:58+08:00	4953	1158	6111	535	6646	12589	52.79%	39.34%	25	25
8	南投縣仁愛鄉	2018-11-25T00:12:44+08:00	4682	1087	5769	496	6265	12080	51.86%	38.76%	24	25
8	南投縣仁愛鄉	2018-11-24T23:26:06+08:00	3899	960	4859	441	5300	10291	51.5%	37.89%	22	25
8	南投縣仁愛鄉	2018-11-24T22:14:47+08:00	2459	648	3107	330	3437	6606	52.03%	37.22%	17	25
8	南投縣仁愛鄉	2018-11-24T22:18:18+08:00	2747	711	3458	345	3803	7558	50.32%	36.35%	18	25
8	南投縣仁愛鄉	2018-11-25T06:27:54+08:00	4953	1158	6111	535	6646	12589	52.79%	39.34%	25	25
8	南投縣仁愛鄉	2018-11-24T23:50:14+08:00	4357	1026	5383	481	5864	11180	52.45%	38.97%	23	25
8	南投縣仁愛鄉	2018-11-24T22:28:39+08:00	2747	711	3458	345	3803	7558	50.32%	36.35%	18	25
8	南投縣仁愛鄉	2018-11-25T01:16:21+08:00	4953	1158	6111	535	6646	12589	52.79%	39.34%	25	25
8	南投縣仁愛鄉	2018-11-24T23:18:26+08:00	3899	960	4859	441	5300	10291	51.5%	37.89%	22	25
8	南投縣草屯鎮	2018-11-25T01:24:23+08:00	35497	9226	44723	3042	47765	82922	57.6%	42.81%	76	76
8	南投縣草屯鎮	2018-11-24T22:39:07+08:00	20784	5564	26348	1815	28163	48517	58.05%	42.84%	46	76
8	南投縣草屯鎮	2018-11-24T23:07:17+08:00	30661	7997	38658	2666	41324	71682	57.65%	42.77%	67	76
8	南投縣草屯鎮	2018-11-24T22:12:01+08:00	16028	4218	20246	1426	21672	36784	58.92%	43.57%	36	76
8	南投縣草屯鎮	2018-11-25T03:37:27+08:00	35497	9226	44723	3042	47765	82922	57.6%	42.81%	76	76
8	南投縣草屯鎮	2018-11-24T22:32:17+08:00	19280	5128	24408	1682	26090	44965	58.02%	42.88%	43	76
8	南投縣草屯鎮	2018-11-25T03:30:57+08:00	35497	9226	44723	3042	47765	82922	57.6%	42.81%	76	76
8	南投縣草屯鎮	2018-11-25T03:48:28+08:00	35497	9226	44723	3042	47765	82922	57.6%	42.81%	76	76
8	南投縣草屯鎮	2018-11-25T01:00:59+08:00	35497	9226	44723	3042	47765	82922	57.6%	42.81%	76	76
8	南投縣草屯鎮	2018-11-24T23:42:01+08:00	34255	8933	43188	2938	46126	80272	57.46%	42.67%	74	76
8	南投縣草屯鎮	2018-11-25T04:01:28+08:00	35497	9226	44723	3042	47765	82922	57.6%	42.81%	76	76
8	南投縣草屯鎮	2018-11-25T00:21:43+08:00	34860	9067	43927	2981	46908	81599	57.49%	42.72%	75	76
8	南投縣草屯鎮	2018-11-24T22:21:44+08:00	17818	4749	22567	1552	24119	41503	58.11%	42.93%	40	76
8	南投縣草屯鎮	2018-11-24T23:00:16+08:00	27744	7309	35053	2412	37465	64975	57.66%	42.7%	61	76
8	南投縣草屯鎮	2018-11-24T22:40:17+08:00	21812	5782	27594	1911	29505	50852	58.02%	42.89%	48	76
8	南投縣草屯鎮	2018-11-25T06:12:35+08:00	35497	9226	44723	3042	47765	82922	57.6%	42.81%	76	76
8	南投縣草屯鎮	2018-11-25T00:03:32+08:00	34860	9067	43927	2981	46908	81599	57.49%	42.72%	75	76
8	南投縣草屯鎮	2018-11-25T03:54:39+08:00	35497	9226	44723	3042	47765	82922	57.6%	42.81%	76	76
8	南投縣草屯鎮	2018-11-24T23:33:49+08:00	34255	8933	43188	2938	46126	80272	57.46%	42.67%	74	76
8	南投縣草屯鎮	2018-11-24T23:26:05+08:00	34255	8933	43188	2938	46126	80272	57.46%	42.67%	74	76
8	南投縣草屯鎮	2018-11-24T23:37:47+08:00	34255	8933	43188	2938	46126	80272	57.46%	42.67%	74	76
8	南投縣草屯鎮	2018-11-24T22:35:43+08:00	20344	5453	25797	1781	27578	47552	58%	42.78%	45	76
8	南投縣草屯鎮	2018-11-24T23:54:26+08:00	34860	9067	43927	2981	46908	81599	57.49%	42.72%	75	76
8	南投縣草屯鎮	2018-11-24T23:58:41+08:00	34860	9067	43927	2981	46908	81599	57.49%	42.72%	75	76
8	南投縣草屯鎮	2018-11-25T00:56:12+08:00	35497	9226	44723	3042	47765	82922	57.6%	42.81%	76	76
8	南投縣草屯鎮	2018-11-24T22:56:35+08:00	25847	6804	32651	2248	34899	60414	57.77%	42.78%	57	76
8	南投縣草屯鎮	2018-11-24T23:14:39+08:00	33104	8644	41748	2832	44580	77454	57.56%	42.74%	72	76
8	南投縣草屯鎮	2018-11-24T23:22:22+08:00	34255	8933	43188	2938	46126	80272	57.46%	42.67%	74	76
8	南投縣草屯鎮	2018-11-25T06:17:34+08:00	35497	9226	44723	3042	47765	82922	57.6%	42.81%	76	76
8	南投縣草屯鎮	2018-11-24T22:43:49+08:00	22203	5910	28113	1940	30053	51784	58.04%	42.88%	49	76
8	南投縣草屯鎮	2018-11-24T23:03:46+08:00	30166	7880	38046	2635	40681	70561	57.65%	42.75%	66	76
8	南投縣草屯鎮	2018-11-24T23:10:55+08:00	31601	8262	39863	2715	42578	74057	57.49%	42.67%	69	76
8	南投縣草屯鎮	2018-11-24T22:49:22+08:00	24091	6266	30357	2081	32438	55964	57.96%	43.05%	53	76
8	南投縣草屯鎮	2018-11-25T00:08:03+08:00	34860	9067	43927	2981	46908	81599	57.49%	42.72%	75	76
8	南投縣草屯鎮	2018-11-24T22:53:13+08:00	25372	6672	32044	2189	34233	59308	57.72%	42.78%	56	76
8	南投縣草屯鎮	2018-11-24T23:46:02+08:00	34255	8933	43188	2938	46126	80272	57.46%	42.67%	74	76
8	南投縣草屯鎮	2018-11-25T03:42:46+08:00	35497	9226	44723	3042	47765	82922	57.6%	42.81%	76	76
8	南投縣草屯鎮	2018-11-25T01:11:05+08:00	35497	9226	44723	3042	47765	82922	57.6%	42.81%	76	76
8	南投縣草屯鎮	2018-11-25T06:07:21+08:00	35497	9226	44723	3042	47765	82922	57.6%	42.81%	76	76
8	南投縣草屯鎮	2018-11-25T06:22:43+08:00	35497	9226	44723	3042	47765	82922	57.6%	42.81%	76	76
8	南投縣草屯鎮	2018-11-24T23:29:44+08:00	34255	8933	43188	2938	46126	80272	57.46%	42.67%	74	76
8	南投縣草屯鎮	2018-11-25T00:17:06+08:00	34860	9067	43927	2981	46908	81599	57.49%	42.72%	75	76
8	南投縣草屯鎮	2018-11-24T22:25:23+08:00	18346	4880	23226	1601	24827	42686	58.16%	42.98%	41	76
8	南投縣草屯鎮	2018-11-25T00:12:43+08:00	34860	9067	43927	2981	46908	81599	57.49%	42.72%	75	76
8	南投縣草屯鎮	2018-11-24T22:28:38+08:00	18802	5025	23827	1658	25485	43827	58.15%	42.9%	42	76
8	南投縣草屯鎮	2018-11-24T22:14:47+08:00	16028	4218	20246	1426	21672	36784	58.92%	43.57%	36	76
8	南投縣草屯鎮	2018-11-24T22:18:18+08:00	16302	4309	20611	1451	22062	37661	58.58%	43.29%	37	76
8	南投縣草屯鎮	2018-11-25T06:27:54+08:00	35497	9226	44723	3042	47765	82922	57.6%	42.81%	76	76
8	南投縣草屯鎮	2018-11-24T23:50:13+08:00	34255	8933	43188	2938	46126	80272	57.46%	42.67%	74	76
8	南投縣草屯鎮	2018-11-25T01:16:20+08:00	35497	9226	44723	3042	47765	82922	57.6%	42.81%	76	76
8	南投縣草屯鎮	2018-11-25T01:05:57+08:00	35497	9226	44723	3042	47765	82922	57.6%	42.81%	76	76
8	南投縣草屯鎮	2018-11-24T23:18:26+08:00	33769	8802	42571	2877	45448	78896	57.6%	42.8%	73	76
8	屏東縣瑪家鄉	2018-11-24T23:07:20+08:00	2043	579	2622	230	2852	4606	61.92%	44.36%	7	8
8	屏東縣瑪家鄉	2018-11-24T23:10:57+08:00	2043	579	2622	230	2852	4606	61.92%	44.36%	7	8
8	屏東縣瑪家鄉	2018-11-24T22:14:50+08:00	1671	483	2154	211	2365	3706	63.82%	45.09%	6	8
8	屏東縣瑪家鄉	2018-11-25T06:17:37+08:00	2346	681	3027	252	3279	5663	57.9%	41.43%	8	8
8	屏東縣瑪家鄉	2018-11-24T22:56:37+08:00	2043	579	2622	230	2852	4606	61.92%	44.36%	7	8
8	屏東縣瑪家鄉	2018-11-24T22:32:19+08:00	2043	579	2622	230	2852	4606	61.92%	44.36%	7	8
8	屏東縣瑪家鄉	2018-11-25T01:06:01+08:00	2346	681	3027	252	3279	5663	57.9%	41.43%	8	8
8	屏東縣瑪家鄉	2018-11-24T22:53:16+08:00	2043	579	2622	230	2852	4606	61.92%	44.36%	7	8
8	屏東縣瑪家鄉	2018-11-25T00:08:06+08:00	2346	681	3027	252	3279	5663	57.9%	41.43%	8	8
8	屏東縣瑪家鄉	2018-11-24T22:25:26+08:00	2043	579	2622	230	2852	4606	61.92%	44.36%	7	8
8	屏東縣瑪家鄉	2018-11-24T23:29:48+08:00	2043	579	2622	230	2852	4606	61.92%	44.36%	7	8
8	屏東縣瑪家鄉	2018-11-25T01:11:08+08:00	2346	681	3027	252	3279	5663	57.9%	41.43%	8	8
8	屏東縣瑪家鄉	2018-11-24T22:40:20+08:00	2043	579	2622	230	2852	4606	61.92%	44.36%	7	8
8	屏東縣瑪家鄉	2018-11-25T06:22:46+08:00	2346	681	3027	252	3279	5663	57.9%	41.43%	8	8
8	屏東縣瑪家鄉	2018-11-25T06:07:24+08:00	2346	681	3027	252	3279	5663	57.9%	41.43%	8	8
8	屏東縣瑪家鄉	2018-11-24T23:00:18+08:00	2043	579	2622	230	2852	4606	61.92%	44.36%	7	8
8	屏東縣瑪家鄉	2018-11-25T03:48:32+08:00	2346	681	3027	252	3279	5663	57.9%	41.43%	8	8
8	屏東縣瑪家鄉	2018-11-25T00:21:45+08:00	2346	681	3027	252	3279	5663	57.9%	41.43%	8	8
8	屏東縣瑪家鄉	2018-11-25T03:31:00+08:00	2346	681	3027	252	3279	5663	57.9%	41.43%	8	8
8	屏東縣瑪家鄉	2018-11-25T01:16:23+08:00	2346	681	3027	252	3279	5663	57.9%	41.43%	8	8
8	屏東縣瑪家鄉	2018-11-25T00:56:14+08:00	2346	681	3027	252	3279	5663	57.9%	41.43%	8	8
8	屏東縣瑪家鄉	2018-11-24T23:14:42+08:00	2043	579	2622	230	2852	4606	61.92%	44.36%	7	8
8	屏東縣瑪家鄉	2018-11-24T23:50:16+08:00	2043	579	2622	230	2852	4606	61.92%	44.36%	7	8
8	屏東縣瑪家鄉	2018-11-24T22:43:51+08:00	2043	579	2622	230	2852	4606	61.92%	44.36%	7	8
8	屏東縣瑪家鄉	2018-11-25T06:27:56+08:00	2346	681	3027	252	3279	5663	57.9%	41.43%	8	8
8	屏東縣瑪家鄉	2018-11-25T00:12:46+08:00	2346	681	3027	252	3279	5663	57.9%	41.43%	8	8
8	屏東縣瑪家鄉	2018-11-24T23:54:28+08:00	2043	579	2622	230	2852	4606	61.92%	44.36%	7	8
8	屏東縣瑪家鄉	2018-11-24T23:37:50+08:00	2043	579	2622	230	2852	4606	61.92%	44.36%	7	8
8	屏東縣瑪家鄉	2018-11-24T23:22:24+08:00	2043	579	2622	230	2852	4606	61.92%	44.36%	7	8
8	屏東縣瑪家鄉	2018-11-24T22:28:41+08:00	2043	579	2622	230	2852	4606	61.92%	44.36%	7	8
8	屏東縣瑪家鄉	2018-11-24T22:12:04+08:00	1671	483	2154	211	2365	3706	63.82%	45.09%	6	8
8	屏東縣瑪家鄉	2018-11-24T23:33:51+08:00	2043	579	2622	230	2852	4606	61.92%	44.36%	7	8
8	屏東縣瑪家鄉	2018-11-25T01:24:26+08:00	2346	681	3027	252	3279	5663	57.9%	41.43%	8	8
8	屏東縣瑪家鄉	2018-11-25T03:54:42+08:00	2346	681	3027	252	3279	5663	57.9%	41.43%	8	8
8	屏東縣瑪家鄉	2018-11-24T23:03:48+08:00	2043	579	2622	230	2852	4606	61.92%	44.36%	7	8
8	屏東縣瑪家鄉	2018-11-24T22:49:25+08:00	2043	579	2622	230	2852	4606	61.92%	44.36%	7	8
8	屏東縣瑪家鄉	2018-11-24T23:42:03+08:00	2043	579	2622	230	2852	4606	61.92%	44.36%	7	8
8	屏東縣瑪家鄉	2018-11-25T04:01:30+08:00	2346	681	3027	252	3279	5663	57.9%	41.43%	8	8
8	屏東縣瑪家鄉	2018-11-24T23:46:05+08:00	2043	579	2622	230	2852	4606	61.92%	44.36%	7	8
8	屏東縣瑪家鄉	2018-11-25T03:42:49+08:00	2346	681	3027	252	3279	5663	57.9%	41.43%	8	8
8	屏東縣瑪家鄉	2018-11-25T00:17:09+08:00	2346	681	3027	252	3279	5663	57.9%	41.43%	8	8
8	屏東縣瑪家鄉	2018-11-25T06:12:38+08:00	2346	681	3027	252	3279	5663	57.9%	41.43%	8	8
8	屏東縣瑪家鄉	2018-11-24T22:21:47+08:00	2043	579	2622	230	2852	4606	61.92%	44.36%	7	8
8	屏東縣瑪家鄉	2018-11-25T01:01:03+08:00	2346	681	3027	252	3279	5663	57.9%	41.43%	8	8
8	屏東縣瑪家鄉	2018-11-24T22:39:10+08:00	2043	579	2622	230	2852	4606	61.92%	44.36%	7	8
8	屏東縣瑪家鄉	2018-11-24T23:26:08+08:00	2043	579	2622	230	2852	4606	61.92%	44.36%	7	8
8	屏東縣瑪家鄉	2018-11-24T22:35:46+08:00	2043	579	2622	230	2852	4606	61.92%	44.36%	7	8
8	屏東縣瑪家鄉	2018-11-24T23:58:44+08:00	2043	579	2622	230	2852	4606	61.92%	44.36%	7	8
8	屏東縣瑪家鄉	2018-11-25T00:03:36+08:00	2346	681	3027	252	3279	5663	57.9%	41.43%	8	8
8	屏東縣瑪家鄉	2018-11-25T03:37:31+08:00	2346	681	3027	252	3279	5663	57.9%	41.43%	8	8
8	屏東縣瑪家鄉	2018-11-24T22:18:21+08:00	1671	483	2154	211	2365	3706	63.82%	45.09%	6	8
8	屏東縣瑪家鄉	2018-11-24T23:18:28+08:00	2043	579	2622	230	2852	4606	61.92%	44.36%	7	8
8	臺東縣成功鎮	2018-11-24T22:14:51+08:00	3042	960	4002	661	4663	9695	48.1%	31.38%	15	17
8	臺東縣成功鎮	2018-11-24T22:56:38+08:00	3042	960	4002	661	4663	9695	48.1%	31.38%	15	17
8	臺東縣成功鎮	2018-11-24T23:07:21+08:00	3507	1075	4582	771	5353	11060	48.4%	31.71%	16	17
8	臺東縣成功鎮	2018-11-24T22:49:26+08:00	3042	960	4002	661	4663	9695	48.1%	31.38%	15	17
8	臺東縣成功鎮	2018-11-24T23:10:58+08:00	3507	1075	4582	771	5353	11060	48.4%	31.71%	16	17
8	臺東縣成功鎮	2018-11-24T23:33:53+08:00	4010	1193	5203	869	6072	12426	48.87%	32.27%	17	17
8	臺東縣成功鎮	2018-11-24T23:22:26+08:00	4010	1193	5203	869	6072	12426	48.87%	32.27%	17	17
8	臺東縣成功鎮	2018-11-24T22:28:43+08:00	3042	960	4002	661	4663	9695	48.1%	31.38%	15	17
8	臺東縣成功鎮	2018-11-24T23:18:30+08:00	4010	1193	5203	869	6072	12426	48.87%	32.27%	17	17
8	臺東縣成功鎮	2018-11-25T06:17:39+08:00	4010	1193	5203	869	6072	12426	48.87%	32.27%	17	17
8	臺東縣成功鎮	2018-11-24T22:53:17+08:00	3042	960	4002	661	4663	9695	48.1%	31.38%	15	17
8	臺東縣成功鎮	2018-11-24T23:46:06+08:00	4010	1193	5203	869	6072	12426	48.87%	32.27%	17	17
8	臺東縣成功鎮	2018-11-25T00:08:07+08:00	4010	1193	5203	869	6072	12426	48.87%	32.27%	17	17
8	臺東縣成功鎮	2018-11-24T22:32:20+08:00	3042	960	4002	661	4663	9695	48.1%	31.38%	15	17
8	臺東縣成功鎮	2018-11-25T00:17:10+08:00	4010	1193	5203	869	6072	12426	48.87%	32.27%	17	17
8	臺東縣成功鎮	2018-11-25T04:01:32+08:00	4010	1193	5203	869	6072	12426	48.87%	32.27%	17	17
8	臺東縣成功鎮	2018-11-25T03:48:34+08:00	4010	1193	5203	869	6072	12426	48.87%	32.27%	17	17
8	臺東縣成功鎮	2018-11-24T23:00:19+08:00	3042	960	4002	661	4663	9695	48.1%	31.38%	15	17
8	臺東縣成功鎮	2018-11-25T06:07:25+08:00	4010	1193	5203	869	6072	12426	48.87%	32.27%	17	17
8	臺東縣成功鎮	2018-11-24T22:25:28+08:00	3042	960	4002	661	4663	9695	48.1%	31.38%	15	17
8	臺東縣成功鎮	2018-11-25T06:22:47+08:00	4010	1193	5203	869	6072	12426	48.87%	32.27%	17	17
8	臺東縣成功鎮	2018-11-25T03:42:51+08:00	4010	1193	5203	869	6072	12426	48.87%	32.27%	17	17
8	臺東縣成功鎮	2018-11-24T22:40:21+08:00	3042	960	4002	661	4663	9695	48.1%	31.38%	15	17
8	臺東縣成功鎮	2018-11-24T23:29:49+08:00	4010	1193	5203	869	6072	12426	48.87%	32.27%	17	17
8	臺東縣成功鎮	2018-11-24T23:50:17+08:00	4010	1193	5203	869	6072	12426	48.87%	32.27%	17	17
8	臺東縣成功鎮	2018-11-24T23:14:43+08:00	3507	1075	4582	771	5353	11060	48.4%	31.71%	16	17
8	臺東縣成功鎮	2018-11-25T00:12:47+08:00	4010	1193	5203	869	6072	12426	48.87%	32.27%	17	17
8	臺東縣成功鎮	2018-11-24T23:54:29+08:00	4010	1193	5203	869	6072	12426	48.87%	32.27%	17	17
8	臺東縣成功鎮	2018-11-25T06:27:57+08:00	4010	1193	5203	869	6072	12426	48.87%	32.27%	17	17
8	臺東縣成功鎮	2018-11-25T01:16:25+08:00	4010	1193	5203	869	6072	12426	48.87%	32.27%	17	17
8	臺東縣成功鎮	2018-11-24T22:18:22+08:00	3042	960	4002	661	4663	9695	48.1%	31.38%	15	17
8	臺東縣成功鎮	2018-11-25T03:37:32+08:00	4010	1193	5203	869	6072	12426	48.87%	32.27%	17	17
8	臺東縣成功鎮	2018-11-25T01:24:27+08:00	4010	1193	5203	869	6072	12426	48.87%	32.27%	17	17
8	臺東縣成功鎮	2018-11-25T03:54:44+08:00	4010	1193	5203	869	6072	12426	48.87%	32.27%	17	17
8	臺東縣成功鎮	2018-11-24T23:03:49+08:00	3042	960	4002	661	4663	9695	48.1%	31.38%	15	17
8	臺東縣成功鎮	2018-11-24T23:37:51+08:00	4010	1193	5203	869	6072	12426	48.87%	32.27%	17	17
8	臺東縣成功鎮	2018-11-24T22:12:05+08:00	3042	960	4002	661	4663	9695	48.1%	31.38%	15	17
8	臺東縣成功鎮	2018-11-25T01:06:02+08:00	4010	1193	5203	869	6072	12426	48.87%	32.27%	17	17
8	臺東縣成功鎮	2018-11-24T23:42:04+08:00	4010	1193	5203	869	6072	12426	48.87%	32.27%	17	17
8	臺東縣成功鎮	2018-11-25T01:11:10+08:00	4010	1193	5203	869	6072	12426	48.87%	32.27%	17	17
8	臺東縣成功鎮	2018-11-25T06:12:39+08:00	4010	1193	5203	869	6072	12426	48.87%	32.27%	17	17
8	臺東縣成功鎮	2018-11-25T00:21:46+08:00	4010	1193	5203	869	6072	12426	48.87%	32.27%	17	17
8	臺東縣成功鎮	2018-11-24T22:21:49+08:00	3042	960	4002	661	4663	9695	48.1%	31.38%	15	17
8	臺東縣成功鎮	2018-11-25T01:01:04+08:00	4010	1193	5203	869	6072	12426	48.87%	32.27%	17	17
8	臺東縣成功鎮	2018-11-25T00:03:38+08:00	4010	1193	5203	869	6072	12426	48.87%	32.27%	17	17
8	臺東縣成功鎮	2018-11-24T22:43:53+08:00	3042	960	4002	661	4663	9695	48.1%	31.38%	15	17
8	臺東縣成功鎮	2018-11-24T22:35:47+08:00	3042	960	4002	661	4663	9695	48.1%	31.38%	15	17
8	臺東縣成功鎮	2018-11-24T23:58:45+08:00	4010	1193	5203	869	6072	12426	48.87%	32.27%	17	17
8	臺東縣成功鎮	2018-11-25T00:56:16+08:00	4010	1193	5203	869	6072	12426	48.87%	32.27%	17	17
8	臺東縣成功鎮	2018-11-24T22:39:11+08:00	3042	960	4002	661	4663	9695	48.1%	31.38%	15	17
8	臺東縣成功鎮	2018-11-24T23:26:09+08:00	4010	1193	5203	869	6072	12426	48.87%	32.27%	17	17
8	臺東縣成功鎮	2018-11-25T03:31:02+08:00	4010	1193	5203	869	6072	12426	48.87%	32.27%	17	17
8	臺東縣海端鄉	2018-11-24T23:26:10+08:00	1129	391	1520	212	1732	3278	52.84%	34.44%	6	6
8	臺東縣海端鄉	2018-11-24T22:49:27+08:00	1129	391	1520	212	1732	3278	52.84%	34.44%	6	6
8	臺東縣海端鄉	2018-11-24T23:10:58+08:00	1129	391	1520	212	1732	3278	52.84%	34.44%	6	6
8	臺東縣海端鄉	2018-11-24T23:33:53+08:00	1129	391	1520	212	1732	3278	52.84%	34.44%	6	6
8	臺東縣海端鄉	2018-11-24T22:56:39+08:00	1129	391	1520	212	1732	3278	52.84%	34.44%	6	6
8	臺東縣海端鄉	2018-11-24T23:22:26+08:00	1129	391	1520	212	1732	3278	52.84%	34.44%	6	6
8	臺東縣海端鄉	2018-11-24T22:28:43+08:00	818	282	1100	152	1252	2307	54.27%	35.46%	5	6
8	臺東縣海端鄉	2018-11-24T23:18:30+08:00	1129	391	1520	212	1732	3278	52.84%	34.44%	6	6
8	臺東縣海端鄉	2018-11-25T00:17:11+08:00	1129	391	1520	212	1732	3278	52.84%	34.44%	6	6
8	臺東縣海端鄉	2018-11-24T22:32:21+08:00	818	282	1100	152	1252	2307	54.27%	35.46%	5	6
8	臺東縣海端鄉	2018-11-24T23:46:06+08:00	1129	391	1520	212	1732	3278	52.84%	34.44%	6	6
8	臺東縣海端鄉	2018-11-25T00:08:07+08:00	1129	391	1520	212	1732	3278	52.84%	34.44%	6	6
8	臺東縣海端鄉	2018-11-24T22:53:18+08:00	1129	391	1520	212	1732	3278	52.84%	34.44%	6	6
8	臺東縣海端鄉	2018-11-25T04:01:32+08:00	1129	391	1520	212	1732	3278	52.84%	34.44%	6	6
8	臺東縣海端鄉	2018-11-25T03:48:34+08:00	1129	391	1520	212	1732	3278	52.84%	34.44%	6	6
8	臺東縣海端鄉	2018-11-24T23:00:19+08:00	1129	391	1520	212	1732	3278	52.84%	34.44%	6	6
8	臺東縣海端鄉	2018-11-24T22:25:28+08:00	818	282	1100	152	1252	2307	54.27%	35.46%	5	6
8	臺東縣海端鄉	2018-11-25T06:22:47+08:00	1129	391	1520	212	1732	3278	52.84%	34.44%	6	6
8	臺東縣海端鄉	2018-11-25T03:42:51+08:00	1129	391	1520	212	1732	3278	52.84%	34.44%	6	6
8	臺東縣海端鄉	2018-11-24T22:40:21+08:00	818	282	1100	152	1252	2307	54.27%	35.46%	5	6
8	臺東縣海端鄉	2018-11-24T23:29:49+08:00	1129	391	1520	212	1732	3278	52.84%	34.44%	6	6
8	臺東縣海端鄉	2018-11-24T23:14:44+08:00	1129	391	1520	212	1732	3278	52.84%	34.44%	6	6
8	臺東縣海端鄉	2018-11-24T23:50:17+08:00	1129	391	1520	212	1732	3278	52.84%	34.44%	6	6
8	臺東縣海端鄉	2018-11-25T00:12:47+08:00	1129	391	1520	212	1732	3278	52.84%	34.44%	6	6
8	臺東縣海端鄉	2018-11-25T01:16:25+08:00	1129	391	1520	212	1732	3278	52.84%	34.44%	6	6
8	臺東縣海端鄉	2018-11-24T22:18:22+08:00	818	282	1100	152	1252	2307	54.27%	35.46%	5	6
8	臺東縣海端鄉	2018-11-25T03:37:32+08:00	1129	391	1520	212	1732	3278	52.84%	34.44%	6	6
8	臺東縣海端鄉	2018-11-24T22:39:12+08:00	818	282	1100	152	1252	2307	54.27%	35.46%	5	6
8	臺東縣海端鄉	2018-11-25T06:27:58+08:00	1129	391	1520	212	1732	3278	52.84%	34.44%	6	6
8	臺東縣海端鄉	2018-11-25T06:17:40+08:00	1129	391	1520	212	1732	3278	52.84%	34.44%	6	6
8	臺東縣海端鄉	2018-11-25T03:54:44+08:00	1129	391	1520	212	1732	3278	52.84%	34.44%	6	6
8	臺東縣海端鄉	2018-11-24T23:03:49+08:00	1129	391	1520	212	1732	3278	52.84%	34.44%	6	6
8	臺東縣海端鄉	2018-11-24T22:14:52+08:00	650	228	878	111	989	1810	54.64%	35.91%	4	6
8	臺東縣海端鄉	2018-11-25T01:24:28+08:00	1129	391	1520	212	1732	3278	52.84%	34.44%	6	6
8	臺東縣海端鄉	2018-11-24T23:37:51+08:00	1129	391	1520	212	1732	3278	52.84%	34.44%	6	6
8	臺東縣海端鄉	2018-11-24T23:07:22+08:00	1129	391	1520	212	1732	3278	52.84%	34.44%	6	6
8	臺東縣海端鄉	2018-11-24T22:12:05+08:00	650	228	878	111	989	1810	54.64%	35.91%	4	6
8	臺東縣海端鄉	2018-11-24T23:54:30+08:00	1129	391	1520	212	1732	3278	52.84%	34.44%	6	6
8	臺東縣海端鄉	2018-11-25T06:12:40+08:00	1129	391	1520	212	1732	3278	52.84%	34.44%	6	6
8	臺東縣海端鄉	2018-11-24T23:42:04+08:00	1129	391	1520	212	1732	3278	52.84%	34.44%	6	6
8	臺東縣海端鄉	2018-11-25T01:06:03+08:00	1129	391	1520	212	1732	3278	52.84%	34.44%	6	6
8	臺東縣海端鄉	2018-11-25T01:11:11+08:00	1129	391	1520	212	1732	3278	52.84%	34.44%	6	6
8	臺東縣海端鄉	2018-11-25T00:21:47+08:00	1129	391	1520	212	1732	3278	52.84%	34.44%	6	6
8	臺東縣海端鄉	2018-11-25T06:07:26+08:00	1129	391	1520	212	1732	3278	52.84%	34.44%	6	6
8	臺東縣海端鄉	2018-11-24T22:21:49+08:00	818	282	1100	152	1252	2307	54.27%	35.46%	5	6
8	臺東縣海端鄉	2018-11-25T00:03:38+08:00	1129	391	1520	212	1732	3278	52.84%	34.44%	6	6
8	臺東縣海端鄉	2018-11-24T22:43:53+08:00	1129	391	1520	212	1732	3278	52.84%	34.44%	6	6
8	臺東縣海端鄉	2018-11-24T22:35:47+08:00	818	282	1100	152	1252	2307	54.27%	35.46%	5	6
8	臺東縣海端鄉	2018-11-24T23:58:45+08:00	1129	391	1520	212	1732	3278	52.84%	34.44%	6	6
8	臺東縣海端鄉	2018-11-25T01:01:05+08:00	1129	391	1520	212	1732	3278	52.84%	34.44%	6	6
8	臺東縣海端鄉	2018-11-25T00:56:16+08:00	1129	391	1520	212	1732	3278	52.84%	34.44%	6	6
8	臺東縣海端鄉	2018-11-25T03:31:02+08:00	1129	391	1520	212	1732	3278	52.84%	34.44%	6	6
8	臺中市大安區	2018-11-24T23:10:50+08:00	6763	1921	8684	1010	9694	16520	58.68%	40.94%	16	16
8	臺中市大安區	2018-11-25T00:56:06+08:00	6763	1921	8684	1010	9694	16520	58.68%	40.94%	16	16
8	臺中市大安區	2018-11-24T23:14:33+08:00	6763	1921	8684	1010	9694	16520	58.68%	40.94%	16	16
8	臺中市大安區	2018-11-24T23:22:16+08:00	6763	1921	8684	1010	9694	16520	58.68%	40.94%	16	16
8	臺中市大安區	2018-11-24T22:56:31+08:00	6763	1921	8684	1010	9694	16520	58.68%	40.94%	16	16
8	臺中市大安區	2018-11-25T00:12:39+08:00	6763	1921	8684	1010	9694	16520	58.68%	40.94%	16	16
8	臺中市大安區	2018-11-24T22:49:17+08:00	6763	1921	8684	1010	9694	16520	58.68%	40.94%	16	16
8	臺中市大安區	2018-11-25T03:37:18+08:00	6763	1921	8684	1010	9694	16520	58.68%	40.94%	16	16
8	臺中市大安區	2018-11-24T22:43:44+08:00	6763	1921	8684	1010	9694	16520	58.68%	40.94%	16	16
8	臺中市大安區	2018-11-25T00:03:26+08:00	6763	1921	8684	1010	9694	16520	58.68%	40.94%	16	16
8	臺中市大安區	2018-11-25T01:10:59+08:00	6763	1921	8684	1010	9694	16520	58.68%	40.94%	16	16
8	臺中市大安區	2018-11-25T06:22:39+08:00	6763	1921	8684	1010	9694	16520	58.68%	40.94%	16	16
8	臺中市大安區	2018-11-25T03:30:51+08:00	6763	1921	8684	1010	9694	16520	58.68%	40.94%	16	16
8	臺中市大安區	2018-11-24T22:25:17+08:00	6763	1921	8684	1010	9694	16520	58.68%	40.94%	16	16
8	臺中市大安區	2018-11-24T23:29:40+08:00	6763	1921	8684	1010	9694	16520	58.68%	40.94%	16	16
8	臺中市大安區	2018-11-25T00:17:02+08:00	6763	1921	8684	1010	9694	16520	58.68%	40.94%	16	16
8	臺中市大安區	2018-11-25T00:07:58+08:00	6763	1921	8684	1010	9694	16520	58.68%	40.94%	16	16
8	臺中市大安區	2018-11-25T01:16:15+08:00	6763	1921	8684	1010	9694	16520	58.68%	40.94%	16	16
8	臺中市大安區	2018-11-25T01:05:52+08:00	6763	1921	8684	1010	9694	16520	58.68%	40.94%	16	16
8	臺中市大安區	2018-11-24T22:14:42+08:00	6763	1921	8684	1010	9694	16520	58.68%	40.94%	16	16
8	臺中市大安區	2018-11-24T23:54:19+08:00	6763	1921	8684	1010	9694	16520	58.68%	40.94%	16	16
8	臺中市大安區	2018-11-24T22:28:34+08:00	6763	1921	8684	1010	9694	16520	58.68%	40.94%	16	16
8	臺中市大安區	2018-11-24T22:18:13+08:00	6763	1921	8684	1010	9694	16520	58.68%	40.94%	16	16
8	臺中市大安區	2018-11-24T22:39:02+08:00	6763	1921	8684	1010	9694	16520	58.68%	40.94%	16	16
8	臺中市大安區	2018-11-25T01:24:17+08:00	6763	1921	8684	1010	9694	16520	58.68%	40.94%	16	16
8	臺中市大安區	2018-11-24T22:35:39+08:00	6763	1921	8684	1010	9694	16520	58.68%	40.94%	16	16
8	臺中市大安區	2018-11-24T23:50:09+08:00	6763	1921	8684	1010	9694	16520	58.68%	40.94%	16	16
8	臺中市大安區	2018-11-24T23:58:35+08:00	6763	1921	8684	1010	9694	16520	58.68%	40.94%	16	16
8	臺中市大安區	2018-11-25T06:27:49+08:00	6763	1921	8684	1010	9694	16520	58.68%	40.94%	16	16
8	臺中市大安區	2018-11-24T23:03:41+08:00	6763	1921	8684	1010	9694	16520	58.68%	40.94%	16	16
8	臺中市大安區	2018-11-24T23:07:13+08:00	6763	1921	8684	1010	9694	16520	58.68%	40.94%	16	16
8	臺中市大安區	2018-11-25T01:00:53+08:00	6763	1921	8684	1010	9694	16520	58.68%	40.94%	16	16
8	臺中市大安區	2018-11-24T23:00:08+08:00	6763	1921	8684	1010	9694	16520	58.68%	40.94%	16	16
8	臺中市大安區	2018-11-25T03:48:22+08:00	6763	1921	8684	1010	9694	16520	58.68%	40.94%	16	16
8	臺中市大安區	2018-11-25T00:21:37+08:00	6763	1921	8684	1010	9694	16520	58.68%	40.94%	16	16
8	臺中市大安區	2018-11-25T03:42:41+08:00	6763	1921	8684	1010	9694	16520	58.68%	40.94%	16	16
8	臺中市大安區	2018-11-24T22:21:39+08:00	6763	1921	8684	1010	9694	16520	58.68%	40.94%	16	16
8	臺中市大安區	2018-11-24T22:32:12+08:00	6763	1921	8684	1010	9694	16520	58.68%	40.94%	16	16
8	臺中市大安區	2018-11-24T22:53:08+08:00	6763	1921	8684	1010	9694	16520	58.68%	40.94%	16	16
8	臺中市大安區	2018-11-25T04:01:22+08:00	6763	1921	8684	1010	9694	16520	58.68%	40.94%	16	16
8	臺中市大安區	2018-11-24T22:11:57+08:00	6763	1921	8684	1010	9694	16520	58.68%	40.94%	16	16
8	臺中市大安區	2018-11-24T22:40:13+08:00	6763	1921	8684	1010	9694	16520	58.68%	40.94%	16	16
8	臺中市大安區	2018-11-25T06:12:31+08:00	6763	1921	8684	1010	9694	16520	58.68%	40.94%	16	16
8	臺中市大安區	2018-11-25T06:07:16+08:00	6763	1921	8684	1010	9694	16520	58.68%	40.94%	16	16
8	臺中市大安區	2018-11-24T23:33:44+08:00	6763	1921	8684	1010	9694	16520	58.68%	40.94%	16	16
8	臺中市大安區	2018-11-24T23:26:01+08:00	6763	1921	8684	1010	9694	16520	58.68%	40.94%	16	16
8	臺中市大安區	2018-11-25T03:54:34+08:00	6763	1921	8684	1010	9694	16520	58.68%	40.94%	16	16
8	臺中市大安區	2018-11-24T23:45:58+08:00	6763	1921	8684	1010	9694	16520	58.68%	40.94%	16	16
8	臺中市大安區	2018-11-25T06:17:29+08:00	6763	1921	8684	1010	9694	16520	58.68%	40.94%	16	16
8	臺中市大安區	2018-11-24T23:41:56+08:00	6763	1921	8684	1010	9694	16520	58.68%	40.94%	16	16
8	臺中市大安區	2018-11-24T23:37:43+08:00	6763	1921	8684	1010	9694	16520	58.68%	40.94%	16	16
8	臺中市大安區	2018-11-24T23:18:21+08:00	6763	1921	8684	1010	9694	16520	58.68%	40.94%	16	16
8	彰化縣彰化市	2018-11-25T03:37:26+08:00	81200	25213	106413	8530	114943	190995	60.18%	42.51%	184	184
8	彰化縣彰化市	2018-11-24T23:07:16+08:00	32388	10284	42672	3467	46139	76506	60.31%	42.33%	79	184
8	彰化縣彰化市	2018-11-24T22:12:00+08:00	8525	2996	11521	950	12471	19972	62.44%	42.68%	23	184
8	彰化縣彰化市	2018-11-24T22:39:07+08:00	19735	6546	26281	2194	28475	46974	60.62%	42.01%	50	184
8	彰化縣彰化市	2018-11-24T23:03:45+08:00	31884	10098	41982	3441	45423	75279	60.34%	42.35%	78	184
8	彰化縣彰化市	2018-11-24T23:22:21+08:00	38545	12206	50751	4168	54919	90987	60.36%	42.36%	92	184
8	彰化縣彰化市	2018-11-25T01:24:22+08:00	72919	22574	95493	7699	103192	171263	60.25%	42.58%	166	184
8	彰化縣彰化市	2018-11-25T01:00:59+08:00	70455	21862	92317	7461	99778	165653	60.23%	42.53%	161	184
8	彰化縣彰化市	2018-11-24T23:42:00+08:00	42680	13528	56208	4627	60835	100602	60.47%	42.42%	102	184
8	彰化縣彰化市	2018-11-25T03:30:56+08:00	81200	25213	106413	8530	114943	190995	60.18%	42.51%	184	184
8	彰化縣彰化市	2018-11-24T22:32:16+08:00	17839	5889	23728	1974	25702	41858	61.4%	42.62%	45	184
8	彰化縣彰化市	2018-11-25T03:48:27+08:00	81200	25213	106413	8530	114943	190995	60.18%	42.51%	184	184
8	彰化縣彰化市	2018-11-25T04:01:27+08:00	81200	25213	106413	8530	114943	190995	60.18%	42.51%	184	184
8	彰化縣彰化市	2018-11-24T22:21:44+08:00	13805	4510	18315	1472	19787	32015	61.81%	43.12%	35	184
8	彰化縣彰化市	2018-11-24T22:40:17+08:00	21372	6888	28260	2357	30617	50511	60.61%	42.31%	53	184
8	彰化縣彰化市	2018-11-25T00:21:42+08:00	53937	16970	70907	5706	76613	126681	60.48%	42.58%	126	184
8	彰化縣彰化市	2018-11-25T06:12:35+08:00	81200	25213	106413	8530	114943	190995	60.18%	42.51%	184	184
8	彰化縣彰化市	2018-11-25T00:03:32+08:00	50736	15961	66697	5447	72144	119241	60.5%	42.55%	119	184
8	彰化縣彰化市	2018-11-24T23:58:40+08:00	50270	15826	66096	5402	71498	118129	60.53%	42.56%	118	184
8	彰化縣彰化市	2018-11-24T23:26:05+08:00	39153	12377	51530	4223	55753	92349	60.37%	42.4%	93	184
8	彰化縣彰化市	2018-11-24T23:37:47+08:00	41914	13273	55187	4508	59695	98863	60.38%	42.4%	100	184
8	彰化縣彰化市	2018-11-24T23:18:25+08:00	36781	11605	48386	3932	52318	86786	60.28%	42.38%	88	184
8	彰化縣彰化市	2018-11-24T22:35:43+08:00	18915	6283	25198	2100	27298	45053	60.59%	41.98%	48	184
8	彰化縣彰化市	2018-11-24T23:33:48+08:00	40448	12866	53314	4368	57682	95598	60.34%	42.31%	97	184
8	彰化縣彰化市	2018-11-25T03:54:38+08:00	81200	25213	106413	8530	114943	190995	60.18%	42.51%	184	184
8	彰化縣彰化市	2018-11-24T22:43:48+08:00	23537	7483	31020	2584	33604	55714	60.32%	42.25%	59	184
8	彰化縣彰化市	2018-11-24T23:10:54+08:00	33738	10650	44388	3554	47942	79455	60.34%	42.46%	81	184
8	彰化縣彰化市	2018-11-25T06:17:34+08:00	81200	25213	106413	8530	114943	190995	60.18%	42.51%	184	184
8	彰化縣彰化市	2018-11-24T22:56:34+08:00	29095	9169	38264	3152	41416	68607	60.37%	42.41%	72	184
8	彰化縣彰化市	2018-11-24T23:14:38+08:00	35439	11191	46630	3764	50394	83595	60.28%	42.39%	85	184
8	彰化縣彰化市	2018-11-24T22:49:22+08:00	27501	8685	36186	2977	39163	64861	60.38%	42.4%	68	184
8	彰化縣彰化市	2018-11-24T23:46:02+08:00	45417	14404	59821	4903	64724	107046	60.46%	42.43%	108	184
8	彰化縣彰化市	2018-11-25T00:08:02+08:00	50736	15961	66697	5447	72144	119241	60.5%	42.55%	119	184
8	彰化縣彰化市	2018-11-24T22:53:12+08:00	27867	8785	36652	3018	39670	65661	60.42%	42.44%	69	184
8	彰化縣彰化市	2018-11-25T03:42:46+08:00	81200	25213	106413	8530	114943	190995	60.18%	42.51%	184	184
8	彰化縣彰化市	2018-11-24T22:25:22+08:00	15696	5155	20851	1708	22559	36695	61.48%	42.77%	39	184
8	彰化縣彰化市	2018-11-25T06:22:43+08:00	81200	25213	106413	8530	114943	190995	60.18%	42.51%	184	184
8	彰化縣彰化市	2018-11-24T23:29:44+08:00	39153	12377	51530	4223	55753	92349	60.37%	42.4%	93	184
8	彰化縣彰化市	2018-11-25T00:17:06+08:00	52163	16412	68575	5531	74106	122592	60.45%	42.55%	122	184
8	彰化縣彰化市	2018-11-25T01:11:04+08:00	70455	21862	92317	7461	99778	165653	60.23%	42.53%	161	184
8	彰化縣彰化市	2018-11-25T06:07:20+08:00	81200	25213	106413	8530	114943	190995	60.18%	42.51%	184	184
8	彰化縣彰化市	2018-11-24T23:00:15+08:00	30372	9623	39995	3261	43256	71665	60.36%	42.38%	75	184
8	彰化縣彰化市	2018-11-25T00:12:43+08:00	51667	16297	67964	5504	73468	121444	60.5%	42.54%	121	184
8	彰化縣彰化市	2018-11-24T22:28:38+08:00	16570	5459	22029	1800	23829	38794	61.42%	42.71%	41	184
8	彰化縣彰化市	2018-11-25T06:27:53+08:00	81200	25213	106413	8530	114943	190995	60.18%	42.51%	184	184
8	彰化縣彰化市	2018-11-24T23:50:13+08:00	46845	14855	61700	5062	66762	110229	60.57%	42.5%	111	184
8	彰化縣彰化市	2018-11-24T23:54:25+08:00	47794	15117	62911	5191	68102	112502	60.53%	42.48%	113	184
8	彰化縣彰化市	2018-11-25T01:05:57+08:00	70455	21862	92317	7461	99778	165653	60.23%	42.53%	161	184
8	彰化縣彰化市	2018-11-24T22:14:46+08:00	8949	3117	12066	994	13060	20945	62.35%	42.73%	24	184
8	彰化縣彰化市	2018-11-25T00:56:11+08:00	70455	21862	92317	7461	99778	165653	60.23%	42.53%	161	184
8	彰化縣彰化市	2018-11-24T22:18:17+08:00	10299	3529	13828	1094	14922	23889	62.46%	43.11%	27	184
8	彰化縣彰化市	2018-11-25T01:16:19+08:00	71867	22266	94133	7596	101729	169012	60.19%	42.52%	164	184
8	連江縣北竿鄉	2018-11-24T23:26:10+08:00	903	142	1045	59	1104	2125	51.95%	42.49%	2	2
8	連江縣北竿鄉	2018-11-24T23:10:59+08:00	0	0	0	0	0	0	0%	0%	0	2
8	連江縣北竿鄉	2018-11-24T22:49:27+08:00	0	0	0	0	0	0	0%	0%	0	2
8	連江縣北竿鄉	2018-11-24T23:22:27+08:00	903	142	1045	59	1104	2125	51.95%	42.49%	2	2
8	連江縣北竿鄉	2018-11-24T23:18:31+08:00	657	108	765	49	814	1515	53.73%	43.37%	1	2
8	連江縣北竿鄉	2018-11-24T23:33:54+08:00	903	142	1045	59	1104	2125	51.95%	42.49%	2	2
8	連江縣北竿鄉	2018-11-24T22:12:06+08:00	0	0	0	0	0	0	0%	0%	0	2
8	連江縣北竿鄉	2018-11-24T22:56:39+08:00	0	0	0	0	0	0	0%	0%	0	2
8	連江縣北竿鄉	2018-11-24T22:28:44+08:00	0	0	0	0	0	0	0%	0%	0	2
8	連江縣北竿鄉	2018-11-24T23:37:52+08:00	903	142	1045	59	1104	2125	51.95%	42.49%	2	2
8	連江縣北竿鄉	2018-11-24T22:53:19+08:00	0	0	0	0	0	0	0%	0%	0	2
8	連江縣北竿鄉	2018-11-25T00:17:11+08:00	903	142	1045	59	1104	2125	51.95%	42.49%	2	2
8	連江縣北竿鄉	2018-11-24T22:32:21+08:00	0	0	0	0	0	0	0%	0%	0	2
8	連江縣北竿鄉	2018-11-24T22:21:50+08:00	0	0	0	0	0	0	0%	0%	0	2
8	連江縣北竿鄉	2018-11-25T04:01:33+08:00	903	142	1045	59	1104	2125	51.95%	42.49%	2	2
8	連江縣北竿鄉	2018-11-24T23:46:07+08:00	903	142	1045	59	1104	2125	51.95%	42.49%	2	2
8	連江縣北竿鄉	2018-11-25T00:08:08+08:00	903	142	1045	59	1104	2125	51.95%	42.49%	2	2
8	連江縣北竿鄉	2018-11-24T23:00:20+08:00	0	0	0	0	0	0	0%	0%	0	2
8	連江縣北竿鄉	2018-11-24T22:25:29+08:00	0	0	0	0	0	0	0%	0%	0	2
8	連江縣北竿鄉	2018-11-25T06:22:48+08:00	903	142	1045	59	1104	2125	51.95%	42.49%	2	2
8	連江縣北竿鄉	2018-11-25T03:48:35+08:00	903	142	1045	59	1104	2125	51.95%	42.49%	2	2
8	連江縣北竿鄉	2018-11-25T06:17:41+08:00	903	142	1045	59	1104	2125	51.95%	42.49%	2	2
8	連江縣北竿鄉	2018-11-24T22:39:13+08:00	0	0	0	0	0	0	0%	0%	0	2
8	連江縣北竿鄉	2018-11-25T00:12:49+08:00	903	142	1045	59	1104	2125	51.95%	42.49%	2	2
8	連江縣北竿鄉	2018-11-25T03:37:33+08:00	903	142	1045	59	1104	2125	51.95%	42.49%	2	2
8	連江縣北竿鄉	2018-11-24T22:18:23+08:00	0	0	0	0	0	0	0%	0%	0	2
8	連江縣北竿鄉	2018-11-24T23:50:18+08:00	903	142	1045	59	1104	2125	51.95%	42.49%	2	2
8	連江縣北竿鄉	2018-11-24T23:14:45+08:00	0	0	0	0	0	0	0%	0%	0	2
8	連江縣北竿鄉	2018-11-24T23:58:46+08:00	903	142	1045	59	1104	2125	51.95%	42.49%	2	2
8	連江縣北竿鄉	2018-11-24T23:03:50+08:00	0	0	0	0	0	0	0%	0%	0	2
8	連江縣北竿鄉	2018-11-25T01:01:06+08:00	903	142	1045	59	1104	2125	51.95%	42.49%	2	2
8	連江縣北竿鄉	2018-11-25T06:27:58+08:00	903	142	1045	59	1104	2125	51.95%	42.49%	2	2
8	連江縣北竿鄉	2018-11-25T01:24:29+08:00	903	142	1045	59	1104	2125	51.95%	42.49%	2	2
8	連江縣北竿鄉	2018-11-24T23:54:31+08:00	903	142	1045	59	1104	2125	51.95%	42.49%	2	2
8	連江縣北竿鄉	2018-11-25T03:54:45+08:00	903	142	1045	59	1104	2125	51.95%	42.49%	2	2
8	連江縣北竿鄉	2018-11-24T23:07:22+08:00	0	0	0	0	0	0	0%	0%	0	2
8	連江縣北竿鄉	2018-11-24T22:14:53+08:00	0	0	0	0	0	0	0%	0%	0	2
8	連江縣北竿鄉	2018-11-25T06:12:40+08:00	903	142	1045	59	1104	2125	51.95%	42.49%	2	2
8	連江縣北竿鄉	2018-11-24T23:29:50+08:00	903	142	1045	59	1104	2125	51.95%	42.49%	2	2
8	連江縣北竿鄉	2018-11-24T23:42:05+08:00	903	142	1045	59	1104	2125	51.95%	42.49%	2	2
8	連江縣北竿鄉	2018-11-25T01:06:04+08:00	903	142	1045	59	1104	2125	51.95%	42.49%	2	2
8	連江縣北竿鄉	2018-11-25T01:11:11+08:00	903	142	1045	59	1104	2125	51.95%	42.49%	2	2
8	連江縣北竿鄉	2018-11-25T00:21:47+08:00	903	142	1045	59	1104	2125	51.95%	42.49%	2	2
8	連江縣北竿鄉	2018-11-25T03:42:52+08:00	903	142	1045	59	1104	2125	51.95%	42.49%	2	2
8	連江縣北竿鄉	2018-11-25T06:07:26+08:00	903	142	1045	59	1104	2125	51.95%	42.49%	2	2
8	連江縣北竿鄉	2018-11-24T22:40:22+08:00	0	0	0	0	0	0	0%	0%	0	2
8	連江縣北竿鄉	2018-11-25T00:56:17+08:00	903	142	1045	59	1104	2125	51.95%	42.49%	2	2
8	連江縣北竿鄉	2018-11-24T22:35:48+08:00	0	0	0	0	0	0	0%	0%	0	2
8	連江縣北竿鄉	2018-11-24T22:43:54+08:00	0	0	0	0	0	0	0%	0%	0	2
8	連江縣北竿鄉	2018-11-25T03:31:03+08:00	903	142	1045	59	1104	2125	51.95%	42.49%	2	2
8	連江縣北竿鄉	2018-11-25T01:16:26+08:00	903	142	1045	59	1104	2125	51.95%	42.49%	2	2
8	連江縣北竿鄉	2018-11-25T00:03:39+08:00	903	142	1045	59	1104	2125	51.95%	42.49%	2	2
8	高雄市梓官區	2018-11-24T22:49:20+08:00	10294	3642	13936	1425	15361	26438	58.1%	38.94%	25	28
8	高雄市梓官區	2018-11-24T23:03:44+08:00	10294	3642	13936	1425	15361	26438	58.1%	38.94%	25	28
8	高雄市梓官區	2018-11-24T23:58:38+08:00	10738	3801	14539	1467	16006	27698	57.79%	38.77%	26	28
8	高雄市梓官區	2018-11-24T23:22:19+08:00	10738	3801	14539	1467	16006	27698	57.79%	38.77%	26	28
8	高雄市梓官區	2018-11-25T03:42:44+08:00	11955	4135	16090	1564	17654	31025	56.9%	38.53%	28	28
8	高雄市梓官區	2018-11-25T01:00:57+08:00	11341	3997	15338	1517	16855	29293	57.54%	38.72%	27	28
8	高雄市梓官區	2018-11-24T22:53:11+08:00	10294	3642	13936	1425	15361	26438	58.1%	38.94%	25	28
8	高雄市梓官區	2018-11-24T23:46:00+08:00	10738	3801	14539	1467	16006	27698	57.79%	38.77%	26	28
8	高雄市梓官區	2018-11-25T00:08:01+08:00	11341	3997	15338	1517	16855	29293	57.54%	38.72%	27	28
8	高雄市梓官區	2018-11-24T22:21:42+08:00	10294	3642	13936	1425	15361	26438	58.1%	38.94%	25	28
8	高雄市梓官區	2018-11-25T06:12:33+08:00	11955	4135	16090	1564	17654	31025	56.9%	38.53%	28	28
8	高雄市梓官區	2018-11-25T00:17:04+08:00	11341	3997	15338	1517	16855	29293	57.54%	38.72%	27	28
8	高雄市梓官區	2018-11-25T06:22:41+08:00	11955	4135	16090	1564	17654	31025	56.9%	38.53%	28	28
8	高雄市梓官區	2018-11-24T22:25:20+08:00	10294	3642	13936	1425	15361	26438	58.1%	38.94%	25	28
8	高雄市梓官區	2018-11-24T23:18:23+08:00	10738	3801	14539	1467	16006	27698	57.79%	38.77%	26	28
8	高雄市梓官區	2018-11-25T01:05:55+08:00	11341	3997	15338	1517	16855	29293	57.54%	38.72%	27	28
8	高雄市梓官區	2018-11-24T23:50:11+08:00	10738	3801	14539	1467	16006	27698	57.79%	38.77%	26	28
8	高雄市梓官區	2018-11-24T22:14:45+08:00	10294	3642	13936	1425	15361	26438	58.1%	38.94%	25	28
8	高雄市梓官區	2018-11-24T23:33:46+08:00	10738	3801	14539	1467	16006	27698	57.79%	38.77%	26	28
8	高雄市梓官區	2018-11-25T06:27:51+08:00	11955	4135	16090	1564	17654	31025	56.9%	38.53%	28	28
8	高雄市梓官區	2018-11-24T23:26:03+08:00	10738	3801	14539	1467	16006	27698	57.79%	38.77%	26	28
8	高雄市梓官區	2018-11-25T03:54:36+08:00	11955	4135	16090	1564	17654	31025	56.9%	38.53%	28	28
8	高雄市梓官區	2018-11-25T00:12:41+08:00	11341	3997	15338	1517	16855	29293	57.54%	38.72%	27	28
8	高雄市梓官區	2018-11-25T01:24:20+08:00	11341	3997	15338	1517	16855	29293	57.54%	38.72%	27	28
8	高雄市梓官區	2018-11-24T22:43:46+08:00	10294	3642	13936	1425	15361	26438	58.1%	38.94%	25	28
8	高雄市梓官區	2018-11-25T06:17:32+08:00	11955	4135	16090	1564	17654	31025	56.9%	38.53%	28	28
8	高雄市梓官區	2018-11-25T03:37:22+08:00	11955	4135	16090	1564	17654	31025	56.9%	38.53%	28	28
8	高雄市梓官區	2018-11-24T23:07:15+08:00	10294	3642	13936	1425	15361	26438	58.1%	38.94%	25	28
8	高雄市梓官區	2018-11-24T22:39:05+08:00	10294	3642	13936	1425	15361	26438	58.1%	38.94%	25	28
8	高雄市梓官區	2018-11-24T23:10:53+08:00	10294	3642	13936	1425	15361	26438	58.1%	38.94%	25	28
8	高雄市梓官區	2018-11-24T22:56:33+08:00	10294	3642	13936	1425	15361	26438	58.1%	38.94%	25	28
8	高雄市梓官區	2018-11-24T23:14:36+08:00	10294	3642	13936	1425	15361	26438	58.1%	38.94%	25	28
8	高雄市梓官區	2018-11-25T03:48:25+08:00	11955	4135	16090	1564	17654	31025	56.9%	38.53%	28	28
8	高雄市梓官區	2018-11-24T22:32:14+08:00	10294	3642	13936	1425	15361	26438	58.1%	38.94%	25	28
8	高雄市梓官區	2018-11-25T03:30:55+08:00	11955	4135	16090	1564	17654	31025	56.9%	38.53%	28	28
8	高雄市梓官區	2018-11-24T22:40:15+08:00	10294	3642	13936	1425	15361	26438	58.1%	38.94%	25	28
8	高雄市梓官區	2018-11-24T23:29:42+08:00	10738	3801	14539	1467	16006	27698	57.79%	38.77%	26	28
8	高雄市梓官區	2018-11-25T01:11:02+08:00	11341	3997	15338	1517	16855	29293	57.54%	38.72%	27	28
8	高雄市梓官區	2018-11-25T04:01:25+08:00	11955	4135	16090	1564	17654	31025	56.9%	38.53%	28	28
8	高雄市梓官區	2018-11-24T22:11:59+08:00	9880	3516	13396	1319	14715	25418	57.89%	38.87%	24	28
8	高雄市梓官區	2018-11-24T23:00:14+08:00	10294	3642	13936	1425	15361	26438	58.1%	38.94%	25	28
8	高雄市梓官區	2018-11-25T06:07:19+08:00	11955	4135	16090	1564	17654	31025	56.9%	38.53%	28	28
8	高雄市梓官區	2018-11-25T00:21:41+08:00	11341	3997	15338	1517	16855	29293	57.54%	38.72%	27	28
8	高雄市梓官區	2018-11-24T22:28:36+08:00	10294	3642	13936	1425	15361	26438	58.1%	38.94%	25	28
8	高雄市梓官區	2018-11-25T00:56:10+08:00	11341	3997	15338	1517	16855	29293	57.54%	38.72%	27	28
8	高雄市梓官區	2018-11-24T22:18:16+08:00	10294	3642	13936	1425	15361	26438	58.1%	38.94%	25	28
8	高雄市梓官區	2018-11-24T23:54:24+08:00	10738	3801	14539	1467	16006	27698	57.79%	38.77%	26	28
8	高雄市梓官區	2018-11-24T22:35:41+08:00	10294	3642	13936	1425	15361	26438	58.1%	38.94%	25	28
8	高雄市梓官區	2018-11-25T01:16:18+08:00	11341	3997	15338	1517	16855	29293	57.54%	38.72%	27	28
8	高雄市梓官區	2018-11-24T23:37:45+08:00	10738	3801	14539	1467	16006	27698	57.79%	38.77%	26	28
8	高雄市梓官區	2018-11-24T23:41:58+08:00	10738	3801	14539	1467	16006	27698	57.79%	38.77%	26	28
8	高雄市梓官區	2018-11-25T00:03:30+08:00	10738	3801	14539	1467	16006	27698	57.79%	38.77%	26	28
8	宜蘭縣	2018-11-24T23:07:20+08:00	129341	37838	167179	17279	184458	335960	54.9%	38.5%	358	399
8	宜蘭縣	2018-11-24T23:10:57+08:00	129769	37995	167764	17334	185098	337190	54.89%	38.49%	359	399
8	宜蘭縣	2018-11-25T06:17:38+08:00	148910	43259	192169	19570	211739	386089	54.84%	38.57%	399	399
8	宜蘭縣	2018-11-24T22:28:42+08:00	107685	31787	139472	14636	154108	281037	54.84%	38.32%	309	399
8	宜蘭縣	2018-11-24T22:14:50+08:00	97177	28840	126017	13408	139425	254690	54.74%	38.16%	287	399
8	宜蘭縣	2018-11-24T22:56:37+08:00	123035	36105	159140	16520	175660	320422	54.82%	38.4%	344	399
8	宜蘭縣	2018-11-24T22:32:19+08:00	110148	32468	142616	14908	157524	287083	54.87%	38.37%	314	399
8	宜蘭縣	2018-11-25T01:06:01+08:00	148910	43259	192169	19570	211739	386089	54.84%	38.57%	399	399
8	宜蘭縣	2018-11-24T22:53:16+08:00	120707	35386	156093	16186	172279	314600	54.76%	38.37%	339	399
8	宜蘭縣	2018-11-25T00:08:06+08:00	146001	42459	188460	19198	207658	378488	54.87%	38.57%	393	399
8	宜蘭縣	2018-11-24T23:29:48+08:00	135322	39493	174815	17969	192784	351493	54.85%	38.5%	370	399
8	宜蘭縣	2018-11-24T22:40:20+08:00	115321	33869	149190	15561	164751	301045	54.73%	38.31%	326	399
8	宜蘭縣	2018-11-25T06:22:46+08:00	148910	43259	192169	19570	211739	386089	54.84%	38.57%	399	399
8	宜蘭縣	2018-11-25T06:07:24+08:00	148910	43259	192169	19570	211739	386089	54.84%	38.57%	399	399
8	宜蘭縣	2018-11-24T23:00:18+08:00	124889	36602	161491	16720	178211	324921	54.85%	38.44%	348	399
8	宜蘭縣	2018-11-25T03:48:32+08:00	148910	43259	192169	19570	211739	386089	54.84%	38.57%	399	399
8	宜蘭縣	2018-11-24T22:25:27+08:00	107216	31640	138856	14563	153419	279749	54.84%	38.33%	308	399
8	宜蘭縣	2018-11-25T03:42:50+08:00	148910	43259	192169	19570	211739	386089	54.84%	38.57%	399	399
8	宜蘭縣	2018-11-25T00:21:45+08:00	148459	43110	191569	19493	211062	384927	54.83%	38.57%	398	399
8	宜蘭縣	2018-11-25T01:11:09+08:00	148910	43259	192169	19570	211739	386089	54.84%	38.57%	399	399
8	宜蘭縣	2018-11-25T01:16:23+08:00	148910	43259	192169	19570	211739	386089	54.84%	38.57%	399	399
8	宜蘭縣	2018-11-25T03:31:01+08:00	148910	43259	192169	19570	211739	386089	54.84%	38.57%	399	399
8	宜蘭縣	2018-11-24T23:14:42+08:00	131358	38407	169765	17478	187243	340980	54.91%	38.52%	362	399
8	宜蘭縣	2018-11-24T23:50:16+08:00	143319	41692	185011	18888	203899	371770	54.85%	38.55%	387	399
8	宜蘭縣	2018-11-25T06:27:56+08:00	148910	43259	192169	19570	211739	386089	54.84%	38.57%	399	399
8	宜蘭縣	2018-11-25T00:56:15+08:00	148910	43259	192169	19570	211739	386089	54.84%	38.57%	399	399
8	宜蘭縣	2018-11-25T00:12:46+08:00	147521	42859	190380	19366	209746	382341	54.86%	38.58%	396	399
8	宜蘭縣	2018-11-24T23:54:28+08:00	143661	41789	185450	18938	204388	372664	54.85%	38.55%	388	399
8	宜蘭縣	2018-11-24T23:37:50+08:00	138561	40323	178884	18273	197157	359830	54.79%	38.51%	377	399
8	宜蘭縣	2018-11-24T22:12:04+08:00	94349	27952	122301	13015	135316	247409	54.69%	38.13%	280	399
8	宜蘭縣	2018-11-24T23:33:51+08:00	137646	40083	177729	18189	195918	357429	54.81%	38.51%	375	399
8	宜蘭縣	2018-11-24T23:22:25+08:00	133875	39092	172967	17735	190702	347560	54.87%	38.52%	367	399
8	宜蘭縣	2018-11-25T01:24:26+08:00	148910	43259	192169	19570	211739	386089	54.84%	38.57%	399	399
8	宜蘭縣	2018-11-25T03:54:42+08:00	148910	43259	192169	19570	211739	386089	54.84%	38.57%	399	399
8	宜蘭縣	2018-11-24T23:03:48+08:00	128490	37589	166079	17176	183255	333804	54.9%	38.49%	356	399
8	宜蘭縣	2018-11-24T22:49:25+08:00	120179	35263	155442	16145	171587	313470	54.74%	38.34%	338	399
8	宜蘭縣	2018-11-24T23:42:03+08:00	139450	40556	180006	18374	198380	361928	54.81%	38.53%	379	399
8	宜蘭縣	2018-11-24T23:46:05+08:00	141426	41126	182552	18652	201204	366998	54.82%	38.54%	383	399
8	宜蘭縣	2018-11-25T04:01:31+08:00	148910	43259	192169	19570	211739	386089	54.84%	38.57%	399	399
8	宜蘭縣	2018-11-25T00:17:09+08:00	147521	42859	190380	19366	209746	382341	54.86%	38.58%	396	399
8	宜蘭縣	2018-11-25T06:12:38+08:00	148910	43259	192169	19570	211739	386089	54.84%	38.57%	399	399
8	宜蘭縣	2018-11-24T22:21:47+08:00	103992	30700	134692	14250	148942	271789	54.8%	38.26%	302	399
8	宜蘭縣	2018-11-25T01:01:03+08:00	148910	43259	192169	19570	211739	386089	54.84%	38.57%	399	399
8	宜蘭縣	2018-11-24T22:39:10+08:00	114243	33572	147815	15459	163274	298387	54.72%	38.29%	324	399
8	宜蘭縣	2018-11-24T23:26:08+08:00	134284	39203	173487	17827	191314	348642	54.87%	38.52%	368	399
8	宜蘭縣	2018-11-24T22:35:46+08:00	112570	33107	145677	15288	160965	293919	54.77%	38.3%	320	399
8	宜蘭縣	2018-11-24T23:58:44+08:00	144086	41911	185997	19000	204997	373824	54.84%	38.54%	389	399
8	宜蘭縣	2018-11-24T23:18:29+08:00	133875	39092	172967	17735	190702	347560	54.87%	38.52%	367	399
8	宜蘭縣	2018-11-25T00:03:36+08:00	146001	42459	188460	19198	207658	378488	54.87%	38.57%	393	399
8	宜蘭縣	2018-11-25T03:37:31+08:00	148910	43259	192169	19570	211739	386089	54.84%	38.57%	399	399
8	宜蘭縣	2018-11-24T22:18:21+08:00	99060	29239	128299	13626	141925	259166	54.76%	38.22%	291	399
8	宜蘭縣	2018-11-24T22:43:52+08:00	116687	34267	150954	15753	166707	304664	54.72%	38.3%	330	399
8	宜蘭縣三星鄉	2018-11-24T22:14:51+08:00	5780	1803	7583	914	8497	16376	51.89%	35.3%	19	21
8	宜蘭縣三星鄉	2018-11-24T23:33:52+08:00	6724	2119	8843	1029	9872	19051	51.82%	35.29%	21	21
8	宜蘭縣三星鄉	2018-11-24T23:10:57+08:00	6724	2119	8843	1029	9872	19051	51.82%	35.29%	21	21
8	宜蘭縣三星鄉	2018-11-25T06:17:38+08:00	6724	2119	8843	1029	9872	19051	51.82%	35.29%	21	21
8	宜蘭縣三星鄉	2018-11-24T22:28:42+08:00	6296	1962	8258	974	9232	17821	51.8%	35.33%	20	21
8	宜蘭縣三星鄉	2018-11-24T22:56:38+08:00	6296	1962	8258	974	9232	17821	51.8%	35.33%	20	21
8	宜蘭縣三星鄉	2018-11-24T23:07:21+08:00	6296	1962	8258	974	9232	17821	51.8%	35.33%	20	21
8	宜蘭縣三星鄉	2018-11-24T22:49:26+08:00	6296	1962	8258	974	9232	17821	51.8%	35.33%	20	21
8	宜蘭縣三星鄉	2018-11-24T22:53:17+08:00	6296	1962	8258	974	9232	17821	51.8%	35.33%	20	21
8	宜蘭縣三星鄉	2018-11-24T22:32:20+08:00	6296	1962	8258	974	9232	17821	51.8%	35.33%	20	21
8	宜蘭縣三星鄉	2018-11-25T00:17:10+08:00	6724	2119	8843	1029	9872	19051	51.82%	35.29%	21	21
8	宜蘭縣三星鄉	2018-11-25T00:08:06+08:00	6724	2119	8843	1029	9872	19051	51.82%	35.29%	21	21
8	宜蘭縣三星鄉	2018-11-25T03:48:33+08:00	6724	2119	8843	1029	9872	19051	51.82%	35.29%	21	21
8	宜蘭縣三星鄉	2018-11-25T06:07:25+08:00	6724	2119	8843	1029	9872	19051	51.82%	35.29%	21	21
8	宜蘭縣三星鄉	2018-11-24T23:29:48+08:00	6724	2119	8843	1029	9872	19051	51.82%	35.29%	21	21
8	宜蘭縣三星鄉	2018-11-24T22:40:20+08:00	6296	1962	8258	974	9232	17821	51.8%	35.33%	20	21
8	宜蘭縣三星鄉	2018-11-25T06:22:46+08:00	6724	2119	8843	1029	9872	19051	51.82%	35.29%	21	21
8	宜蘭縣三星鄉	2018-11-24T23:00:18+08:00	6296	1962	8258	974	9232	17821	51.8%	35.33%	20	21
8	宜蘭縣三星鄉	2018-11-24T22:25:27+08:00	6296	1962	8258	974	9232	17821	51.8%	35.33%	20	21
8	宜蘭縣三星鄉	2018-11-25T03:42:50+08:00	6724	2119	8843	1029	9872	19051	51.82%	35.29%	21	21
8	宜蘭縣三星鄉	2018-11-25T01:11:09+08:00	6724	2119	8843	1029	9872	19051	51.82%	35.29%	21	21
8	宜蘭縣三星鄉	2018-11-24T23:14:43+08:00	6724	2119	8843	1029	9872	19051	51.82%	35.29%	21	21
8	宜蘭縣三星鄉	2018-11-25T01:16:24+08:00	6724	2119	8843	1029	9872	19051	51.82%	35.29%	21	21
8	宜蘭縣三星鄉	2018-11-24T23:54:29+08:00	6724	2119	8843	1029	9872	19051	51.82%	35.29%	21	21
8	宜蘭縣三星鄉	2018-11-25T06:27:57+08:00	6724	2119	8843	1029	9872	19051	51.82%	35.29%	21	21
8	宜蘭縣三星鄉	2018-11-25T03:31:01+08:00	6724	2119	8843	1029	9872	19051	51.82%	35.29%	21	21
8	宜蘭縣三星鄉	2018-11-24T23:50:16+08:00	6724	2119	8843	1029	9872	19051	51.82%	35.29%	21	21
8	宜蘭縣三星鄉	2018-11-25T00:56:15+08:00	6724	2119	8843	1029	9872	19051	51.82%	35.29%	21	21
8	宜蘭縣三星鄉	2018-11-25T00:12:46+08:00	6724	2119	8843	1029	9872	19051	51.82%	35.29%	21	21
8	宜蘭縣三星鄉	2018-11-24T23:37:50+08:00	6724	2119	8843	1029	9872	19051	51.82%	35.29%	21	21
8	宜蘭縣三星鄉	2018-11-25T01:24:27+08:00	6724	2119	8843	1029	9872	19051	51.82%	35.29%	21	21
8	宜蘭縣三星鄉	2018-11-25T03:54:43+08:00	6724	2119	8843	1029	9872	19051	51.82%	35.29%	21	21
8	宜蘭縣三星鄉	2018-11-24T23:03:49+08:00	6296	1962	8258	974	9232	17821	51.8%	35.33%	20	21
8	宜蘭縣三星鄉	2018-11-24T22:12:04+08:00	5306	1669	6975	826	7801	14955	52.16%	35.48%	18	21
8	宜蘭縣三星鄉	2018-11-24T23:22:25+08:00	6724	2119	8843	1029	9872	19051	51.82%	35.29%	21	21
8	宜蘭縣三星鄉	2018-11-25T01:06:02+08:00	6724	2119	8843	1029	9872	19051	51.82%	35.29%	21	21
8	宜蘭縣三星鄉	2018-11-24T23:42:03+08:00	6724	2119	8843	1029	9872	19051	51.82%	35.29%	21	21
8	宜蘭縣三星鄉	2018-11-24T23:46:05+08:00	6724	2119	8843	1029	9872	19051	51.82%	35.29%	21	21
8	宜蘭縣三星鄉	2018-11-25T04:01:31+08:00	6724	2119	8843	1029	9872	19051	51.82%	35.29%	21	21
8	宜蘭縣三星鄉	2018-11-25T06:12:39+08:00	6724	2119	8843	1029	9872	19051	51.82%	35.29%	21	21
8	宜蘭縣三星鄉	2018-11-24T22:21:48+08:00	5780	1803	7583	914	8497	16376	51.89%	35.3%	19	21
8	宜蘭縣三星鄉	2018-11-25T00:21:46+08:00	6724	2119	8843	1029	9872	19051	51.82%	35.29%	21	21
8	宜蘭縣三星鄉	2018-11-25T01:01:03+08:00	6724	2119	8843	1029	9872	19051	51.82%	35.29%	21	21
8	宜蘭縣三星鄉	2018-11-24T22:35:46+08:00	6296	1962	8258	974	9232	17821	51.8%	35.33%	20	21
8	宜蘭縣三星鄉	2018-11-24T23:58:44+08:00	6724	2119	8843	1029	9872	19051	51.82%	35.29%	21	21
8	宜蘭縣三星鄉	2018-11-24T23:18:29+08:00	6724	2119	8843	1029	9872	19051	51.82%	35.29%	21	21
8	宜蘭縣三星鄉	2018-11-25T03:37:31+08:00	6724	2119	8843	1029	9872	19051	51.82%	35.29%	21	21
8	宜蘭縣三星鄉	2018-11-24T22:18:21+08:00	5780	1803	7583	914	8497	16376	51.89%	35.3%	19	21
8	宜蘭縣三星鄉	2018-11-24T22:39:11+08:00	6296	1962	8258	974	9232	17821	51.8%	35.33%	20	21
8	宜蘭縣三星鄉	2018-11-24T23:26:09+08:00	6724	2119	8843	1029	9872	19051	51.82%	35.29%	21	21
8	宜蘭縣三星鄉	2018-11-25T00:03:37+08:00	6724	2119	8843	1029	9872	19051	51.82%	35.29%	21	21
8	宜蘭縣三星鄉	2018-11-24T22:43:52+08:00	6296	1962	8258	974	9232	17821	51.8%	35.33%	20	21
8	桃園市蘆竹區	2018-11-25T03:37:17+08:00	46150	14602	60752	4314	65066	129252	50.34%	35.71%	76	76
8	桃園市蘆竹區	2018-11-24T22:39:01+08:00	33964	10879	44843	3427	48270	94734	50.95%	35.85%	59	76
8	桃園市蘆竹區	2018-11-25T01:10:58+08:00	46150	14602	60752	4314	65066	129252	50.34%	35.71%	76	76
8	桃園市蘆竹區	2018-11-25T00:12:37+08:00	46150	14602	60752	4314	65066	129252	50.34%	35.71%	76	76
8	桃園市蘆竹區	2018-11-24T22:49:17+08:00	36173	11504	47677	3588	51265	100756	50.88%	35.9%	62	76
8	桃園市蘆竹區	2018-11-24T23:14:32+08:00	40293	12746	53039	3874	56913	112297	50.68%	35.88%	68	76
8	桃園市蘆竹區	2018-11-24T22:43:43+08:00	34587	11065	45652	3459	49111	96367	50.96%	35.89%	60	76
8	桃園市蘆竹區	2018-11-24T22:56:30+08:00	37523	11950	49473	3707	53180	104366	50.96%	35.95%	64	76
8	桃園市蘆竹區	2018-11-25T06:22:37+08:00	46150	14602	60752	4314	65066	129252	50.34%	35.71%	76	76
8	桃園市蘆竹區	2018-11-25T03:30:50+08:00	46150	14602	60752	4314	65066	129252	50.34%	35.71%	76	76
8	桃園市蘆竹區	2018-11-25T03:48:21+08:00	46150	14602	60752	4314	65066	129252	50.34%	35.71%	76	76
8	桃園市蘆竹區	2018-11-24T22:32:11+08:00	32182	10236	42418	3138	45556	89343	50.99%	36.02%	56	76
8	桃園市蘆竹區	2018-11-24T23:29:39+08:00	42178	13332	55510	4029	59539	117590	50.63%	35.87%	71	76
8	桃園市蘆竹區	2018-11-25T04:01:21+08:00	46150	14602	60752	4314	65066	129252	50.34%	35.71%	76	76
8	桃園市蘆竹區	2018-11-24T22:25:16+08:00	30753	9824	40577	3050	43627	85607	50.96%	35.92%	54	76
8	桃園市蘆竹區	2018-11-25T06:07:15+08:00	46150	14602	60752	4314	65066	129252	50.34%	35.71%	76	76
8	桃園市蘆竹區	2018-11-24T22:18:12+08:00	28289	8989	37278	2775	40053	77939	51.39%	36.3%	50	76
8	桃園市蘆竹區	2018-11-24T23:54:18+08:00	45158	14337	59495	4260	63755	126525	50.39%	35.69%	75	76
8	桃園市蘆竹區	2018-11-25T00:07:57+08:00	46150	14602	60752	4314	65066	129252	50.34%	35.71%	76	76
8	桃園市蘆竹區	2018-11-25T01:16:14+08:00	46150	14602	60752	4314	65066	129252	50.34%	35.71%	76	76
8	桃園市蘆竹區	2018-11-24T23:41:55+08:00	42935	13598	56533	4095	60628	119779	50.62%	35.85%	72	76
8	桃園市蘆竹區	2018-11-24T22:28:33+08:00	31372	10003	41375	3095	44470	87165	51.02%	35.99%	55	76
8	桃園市蘆竹區	2018-11-24T23:58:34+08:00	46150	14602	60752	4314	65066	129252	50.34%	35.71%	76	76
8	桃園市蘆竹區	2018-11-24T23:22:15+08:00	41522	13122	54644	3986	58630	115697	50.68%	35.89%	70	76
8	桃園市蘆竹區	2018-11-25T01:24:16+08:00	46150	14602	60752	4314	65066	129252	50.34%	35.71%	76	76
8	桃園市蘆竹區	2018-11-24T22:35:38+08:00	32697	10400	43097	3210	46307	90966	50.91%	35.94%	57	76
8	桃園市蘆竹區	2018-11-24T23:07:12+08:00	39357	12483	51840	3823	55663	109775	50.71%	35.85%	67	76
8	桃園市蘆竹區	2018-11-25T00:56:05+08:00	46150	14602	60752	4314	65066	129252	50.34%	35.71%	76	76
8	桃園市蘆竹區	2018-11-25T06:27:48+08:00	46150	14602	60752	4314	65066	129252	50.34%	35.71%	76	76
8	桃園市蘆竹區	2018-11-24T23:50:07+08:00	44396	14087	58483	4201	62684	124121	50.5%	35.77%	74	76
8	桃園市蘆竹區	2018-11-25T00:03:25+08:00	46150	14602	60752	4314	65066	129252	50.34%	35.71%	76	76
8	桃園市蘆竹區	2018-11-24T23:03:41+08:00	39357	12483	51840	3823	55663	109775	50.71%	35.85%	67	76
8	桃園市蘆竹區	2018-11-24T23:00:06+08:00	38138	12111	50249	3747	53996	106113	50.89%	35.94%	65	76
8	桃園市蘆竹區	2018-11-25T00:21:36+08:00	46150	14602	60752	4314	65066	129252	50.34%	35.71%	76	76
8	桃園市蘆竹區	2018-11-25T01:00:52+08:00	46150	14602	60752	4314	65066	129252	50.34%	35.71%	76	76
8	桃園市蘆竹區	2018-11-24T22:21:37+08:00	29515	9448	38963	2927	41890	81800	51.21%	36.08%	52	76
8	桃園市蘆竹區	2018-11-25T06:12:30+08:00	46150	14602	60752	4314	65066	129252	50.34%	35.71%	76	76
8	桃園市蘆竹區	2018-11-24T22:53:06+08:00	37523	11950	49473	3707	53180	104366	50.96%	35.95%	64	76
8	桃園市蘆竹區	2018-11-24T22:40:12+08:00	34587	11065	45652	3459	49111	96367	50.96%	35.89%	60	76
8	桃園市蘆竹區	2018-11-25T03:42:39+08:00	46150	14602	60752	4314	65066	129252	50.34%	35.71%	76	76
8	桃園市蘆竹區	2018-11-25T00:17:01+08:00	46150	14602	60752	4314	65066	129252	50.34%	35.71%	76	76
8	桃園市蘆竹區	2018-11-24T22:11:56+08:00	26455	8448	34903	2629	37532	73318	51.19%	36.08%	47	76
8	桃園市蘆竹區	2018-11-24T23:33:43+08:00	42935	13598	56533	4095	60628	119779	50.62%	35.85%	72	76
8	桃園市蘆竹區	2018-11-24T23:18:20+08:00	40293	12746	53039	3874	56913	112297	50.68%	35.88%	68	76
8	桃園市蘆竹區	2018-11-24T23:37:42+08:00	42935	13598	56533	4095	60628	119779	50.62%	35.85%	72	76
8	桃園市蘆竹區	2018-11-24T22:14:41+08:00	27163	8623	35786	2676	38462	75063	51.24%	36.19%	48	76
8	桃園市蘆竹區	2018-11-25T01:05:50+08:00	46150	14602	60752	4314	65066	129252	50.34%	35.71%	76	76
8	桃園市蘆竹區	2018-11-24T23:26:00+08:00	41522	13122	54644	3986	58630	115697	50.68%	35.89%	70	76
8	桃園市蘆竹區	2018-11-24T23:10:49+08:00	39357	12483	51840	3823	55663	109775	50.71%	35.85%	67	76
8	桃園市蘆竹區	2018-11-25T03:54:32+08:00	46150	14602	60752	4314	65066	129252	50.34%	35.71%	76	76
8	桃園市蘆竹區	2018-11-25T06:17:28+08:00	46150	14602	60752	4314	65066	129252	50.34%	35.71%	76	76
8	桃園市蘆竹區	2018-11-24T23:45:57+08:00	42935	13598	56533	4095	60628	119779	50.62%	35.85%	72	76
8	屏東縣麟洛鄉	2018-11-24T22:56:36+08:00	3838	1289	5127	451	5578	9970	55.95%	38.5%	10	10
8	屏東縣麟洛鄉	2018-11-25T06:17:36+08:00	3838	1289	5127	451	5578	9970	55.95%	38.5%	10	10
8	屏東縣麟洛鄉	2018-11-24T23:07:19+08:00	3838	1289	5127	451	5578	9970	55.95%	38.5%	10	10
8	屏東縣麟洛鄉	2018-11-24T23:10:56+08:00	3838	1289	5127	451	5578	9970	55.95%	38.5%	10	10
8	屏東縣麟洛鄉	2018-11-24T22:39:09+08:00	3838	1289	5127	451	5578	9970	55.95%	38.5%	10	10
8	屏東縣麟洛鄉	2018-11-25T01:24:25+08:00	3838	1289	5127	451	5578	9970	55.95%	38.5%	10	10
8	屏東縣麟洛鄉	2018-11-25T03:54:41+08:00	3838	1289	5127	451	5578	9970	55.95%	38.5%	10	10
8	屏東縣麟洛鄉	2018-11-24T22:32:19+08:00	3838	1289	5127	451	5578	9970	55.95%	38.5%	10	10
8	屏東縣麟洛鄉	2018-11-25T01:06:00+08:00	3838	1289	5127	451	5578	9970	55.95%	38.5%	10	10
8	屏東縣麟洛鄉	2018-11-24T22:25:26+08:00	3838	1289	5127	451	5578	9970	55.95%	38.5%	10	10
8	屏東縣麟洛鄉	2018-11-24T23:00:17+08:00	3838	1289	5127	451	5578	9970	55.95%	38.5%	10	10
8	屏東縣麟洛鄉	2018-11-25T01:11:08+08:00	3838	1289	5127	451	5578	9970	55.95%	38.5%	10	10
8	屏東縣麟洛鄉	2018-11-25T06:07:23+08:00	3838	1289	5127	451	5578	9970	55.95%	38.5%	10	10
8	屏東縣麟洛鄉	2018-11-24T22:40:19+08:00	3838	1289	5127	451	5578	9970	55.95%	38.5%	10	10
8	屏東縣麟洛鄉	2018-11-24T23:29:47+08:00	3838	1289	5127	451	5578	9970	55.95%	38.5%	10	10
8	屏東縣麟洛鄉	2018-11-25T00:21:45+08:00	3838	1289	5127	451	5578	9970	55.95%	38.5%	10	10
8	屏東縣麟洛鄉	2018-11-25T03:31:00+08:00	3838	1289	5127	451	5578	9970	55.95%	38.5%	10	10
8	屏東縣麟洛鄉	2018-11-25T00:03:35+08:00	3838	1289	5127	451	5578	9970	55.95%	38.5%	10	10
8	屏東縣麟洛鄉	2018-11-25T00:56:14+08:00	3838	1289	5127	451	5578	9970	55.95%	38.5%	10	10
8	屏東縣麟洛鄉	2018-11-24T23:54:27+08:00	3838	1289	5127	451	5578	9970	55.95%	38.5%	10	10
8	屏東縣麟洛鄉	2018-11-24T22:35:45+08:00	3838	1289	5127	451	5578	9970	55.95%	38.5%	10	10
8	屏東縣麟洛鄉	2018-11-25T01:16:22+08:00	3838	1289	5127	451	5578	9970	55.95%	38.5%	10	10
8	屏東縣麟洛鄉	2018-11-24T23:37:49+08:00	3838	1289	5127	451	5578	9970	55.95%	38.5%	10	10
8	屏東縣麟洛鄉	2018-11-24T22:43:51+08:00	3838	1289	5127	451	5578	9970	55.95%	38.5%	10	10
8	屏東縣麟洛鄉	2018-11-24T23:22:24+08:00	3838	1289	5127	451	5578	9970	55.95%	38.5%	10	10
8	屏東縣麟洛鄉	2018-11-24T22:28:41+08:00	3838	1289	5127	451	5578	9970	55.95%	38.5%	10	10
8	屏東縣麟洛鄉	2018-11-24T22:49:24+08:00	3838	1289	5127	451	5578	9970	55.95%	38.5%	10	10
8	屏東縣麟洛鄉	2018-11-24T22:12:03+08:00	3249	1112	4361	424	4785	8584	55.74%	37.85%	9	10
8	屏東縣麟洛鄉	2018-11-24T23:33:51+08:00	3838	1289	5127	451	5578	9970	55.95%	38.5%	10	10
8	屏東縣麟洛鄉	2018-11-24T23:03:47+08:00	3838	1289	5127	451	5578	9970	55.95%	38.5%	10	10
8	屏東縣麟洛鄉	2018-11-25T04:01:30+08:00	3838	1289	5127	451	5578	9970	55.95%	38.5%	10	10
8	屏東縣麟洛鄉	2018-11-25T03:42:49+08:00	3838	1289	5127	451	5578	9970	55.95%	38.5%	10	10
8	屏東縣麟洛鄉	2018-11-24T23:42:02+08:00	3838	1289	5127	451	5578	9970	55.95%	38.5%	10	10
8	屏東縣麟洛鄉	2018-11-25T00:08:05+08:00	3838	1289	5127	451	5578	9970	55.95%	38.5%	10	10
8	屏東縣麟洛鄉	2018-11-24T22:53:15+08:00	3838	1289	5127	451	5578	9970	55.95%	38.5%	10	10
8	屏東縣麟洛鄉	2018-11-24T23:46:04+08:00	3838	1289	5127	451	5578	9970	55.95%	38.5%	10	10
8	屏東縣麟洛鄉	2018-11-25T06:12:37+08:00	3838	1289	5127	451	5578	9970	55.95%	38.5%	10	10
8	屏東縣麟洛鄉	2018-11-24T22:21:46+08:00	3838	1289	5127	451	5578	9970	55.95%	38.5%	10	10
8	屏東縣麟洛鄉	2018-11-25T00:17:08+08:00	3838	1289	5127	451	5578	9970	55.95%	38.5%	10	10
8	屏東縣麟洛鄉	2018-11-25T06:22:45+08:00	3838	1289	5127	451	5578	9970	55.95%	38.5%	10	10
8	屏東縣麟洛鄉	2018-11-25T03:48:31+08:00	3838	1289	5127	451	5578	9970	55.95%	38.5%	10	10
8	屏東縣麟洛鄉	2018-11-24T22:14:49+08:00	3249	1112	4361	424	4785	8584	55.74%	37.85%	9	10
8	屏東縣麟洛鄉	2018-11-24T22:18:20+08:00	3249	1112	4361	424	4785	8584	55.74%	37.85%	9	10
8	屏東縣麟洛鄉	2018-11-25T03:37:30+08:00	3838	1289	5127	451	5578	9970	55.95%	38.5%	10	10
8	屏東縣麟洛鄉	2018-11-24T23:58:43+08:00	3838	1289	5127	451	5578	9970	55.95%	38.5%	10	10
8	屏東縣麟洛鄉	2018-11-25T06:27:55+08:00	3838	1289	5127	451	5578	9970	55.95%	38.5%	10	10
8	屏東縣麟洛鄉	2018-11-24T23:26:07+08:00	3838	1289	5127	451	5578	9970	55.95%	38.5%	10	10
8	屏東縣麟洛鄉	2018-11-25T00:12:45+08:00	3838	1289	5127	451	5578	9970	55.95%	38.5%	10	10
8	屏東縣麟洛鄉	2018-11-25T01:01:02+08:00	3838	1289	5127	451	5578	9970	55.95%	38.5%	10	10
8	屏東縣麟洛鄉	2018-11-24T23:18:28+08:00	3838	1289	5127	451	5578	9970	55.95%	38.5%	10	10
8	屏東縣麟洛鄉	2018-11-24T23:14:41+08:00	3838	1289	5127	451	5578	9970	55.95%	38.5%	10	10
8	屏東縣麟洛鄉	2018-11-24T23:50:15+08:00	3838	1289	5127	451	5578	9970	55.95%	38.5%	10	10
8	臺南市玉井區	2018-11-25T03:37:19+08:00	4041	1204	5245	549	5794	12357	46.89%	32.7%	16	16
8	臺南市玉井區	2018-11-25T00:56:08+08:00	4041	1204	5245	549	5794	12357	46.89%	32.7%	16	16
8	臺南市玉井區	2018-11-24T22:49:18+08:00	3829	1124	4953	519	5472	11659	46.93%	32.84%	15	16
8	臺南市玉井區	2018-11-24T23:14:34+08:00	4041	1204	5245	549	5794	12357	46.89%	32.7%	16	16
8	臺南市玉井區	2018-11-24T23:22:18+08:00	4041	1204	5245	549	5794	12357	46.89%	32.7%	16	16
8	臺南市玉井區	2018-11-24T22:43:45+08:00	3829	1124	4953	519	5472	11659	46.93%	32.84%	15	16
8	臺南市玉井區	2018-11-24T23:03:42+08:00	4041	1204	5245	549	5794	12357	46.89%	32.7%	16	16
8	臺南市玉井區	2018-11-24T23:10:51+08:00	4041	1204	5245	549	5794	12357	46.89%	32.7%	16	16
8	臺南市玉井區	2018-11-25T00:03:28+08:00	4041	1204	5245	549	5794	12357	46.89%	32.7%	16	16
8	臺南市玉井區	2018-11-25T06:17:30+08:00	4041	1204	5245	549	5794	12357	46.89%	32.7%	16	16
8	臺南市玉井區	2018-11-24T23:58:36+08:00	4041	1204	5245	549	5794	12357	46.89%	32.7%	16	16
8	臺南市玉井區	2018-11-25T03:42:42+08:00	4041	1204	5245	549	5794	12357	46.89%	32.7%	16	16
8	臺南市玉井區	2018-11-25T06:22:40+08:00	4041	1204	5245	549	5794	12357	46.89%	32.7%	16	16
8	臺南市玉井區	2018-11-25T01:11:01+08:00	4041	1204	5245	549	5794	12357	46.89%	32.7%	16	16
8	臺南市玉井區	2018-11-24T23:29:41+08:00	4041	1204	5245	549	5794	12357	46.89%	32.7%	16	16
8	臺南市玉井區	2018-11-24T22:25:18+08:00	4041	1204	5245	549	5794	12357	46.89%	32.7%	16	16
8	臺南市玉井區	2018-11-25T00:17:02+08:00	4041	1204	5245	549	5794	12357	46.89%	32.7%	16	16
8	臺南市玉井區	2018-11-25T06:12:32+08:00	4041	1204	5245	549	5794	12357	46.89%	32.7%	16	16
8	臺南市玉井區	2018-11-25T00:12:40+08:00	4041	1204	5245	549	5794	12357	46.89%	32.7%	16	16
8	臺南市玉井區	2018-11-24T22:28:35+08:00	4041	1204	5245	549	5794	12357	46.89%	32.7%	16	16
8	臺南市玉井區	2018-11-24T22:14:43+08:00	4041	1204	5245	549	5794	12357	46.89%	32.7%	16	16
8	臺南市玉井區	2018-11-24T23:26:02+08:00	4041	1204	5245	549	5794	12357	46.89%	32.7%	16	16
8	臺南市玉井區	2018-11-24T23:54:20+08:00	4041	1204	5245	549	5794	12357	46.89%	32.7%	16	16
8	臺南市玉井區	2018-11-25T06:27:50+08:00	4041	1204	5245	549	5794	12357	46.89%	32.7%	16	16
8	臺南市玉井區	2018-11-25T00:07:59+08:00	4041	1204	5245	549	5794	12357	46.89%	32.7%	16	16
8	臺南市玉井區	2018-11-24T23:18:22+08:00	4041	1204	5245	549	5794	12357	46.89%	32.7%	16	16
8	臺南市玉井區	2018-11-25T01:05:53+08:00	4041	1204	5245	549	5794	12357	46.89%	32.7%	16	16
8	臺南市玉井區	2018-11-24T22:18:14+08:00	4041	1204	5245	549	5794	12357	46.89%	32.7%	16	16
8	臺南市玉井區	2018-11-25T01:24:18+08:00	4041	1204	5245	549	5794	12357	46.89%	32.7%	16	16
8	臺南市玉井區	2018-11-24T22:56:32+08:00	3829	1124	4953	519	5472	11659	46.93%	32.84%	15	16
8	臺南市玉井區	2018-11-24T23:50:09+08:00	4041	1204	5245	549	5794	12357	46.89%	32.7%	16	16
8	臺南市玉井區	2018-11-24T22:39:04+08:00	4041	1204	5245	549	5794	12357	46.89%	32.7%	16	16
8	臺南市玉井區	2018-11-24T23:07:14+08:00	4041	1204	5245	549	5794	12357	46.89%	32.7%	16	16
8	臺南市玉井區	2018-11-24T22:32:13+08:00	4041	1204	5245	549	5794	12357	46.89%	32.7%	16	16
8	臺南市玉井區	2018-11-25T03:30:53+08:00	4041	1204	5245	549	5794	12357	46.89%	32.7%	16	16
8	臺南市玉井區	2018-11-25T03:48:23+08:00	4041	1204	5245	549	5794	12357	46.89%	32.7%	16	16
8	臺南市玉井區	2018-11-25T01:00:55+08:00	4041	1204	5245	549	5794	12357	46.89%	32.7%	16	16
8	臺南市玉井區	2018-11-24T23:00:09+08:00	3829	1124	4953	519	5472	11659	46.93%	32.84%	15	16
8	臺南市玉井區	2018-11-25T00:21:38+08:00	4041	1204	5245	549	5794	12357	46.89%	32.7%	16	16
8	臺南市玉井區	2018-11-25T06:07:17+08:00	4041	1204	5245	549	5794	12357	46.89%	32.7%	16	16
8	臺南市玉井區	2018-11-24T22:53:09+08:00	3829	1124	4953	519	5472	11659	46.93%	32.84%	15	16
8	臺南市玉井區	2018-11-24T22:40:14+08:00	4041	1204	5245	549	5794	12357	46.89%	32.7%	16	16
8	臺南市玉井區	2018-11-24T22:11:58+08:00	4041	1204	5245	549	5794	12357	46.89%	32.7%	16	16
8	臺南市玉井區	2018-11-25T04:01:23+08:00	4041	1204	5245	549	5794	12357	46.89%	32.7%	16	16
8	臺南市玉井區	2018-11-24T22:21:40+08:00	4041	1204	5245	549	5794	12357	46.89%	32.7%	16	16
8	臺南市玉井區	2018-11-24T23:41:57+08:00	4041	1204	5245	549	5794	12357	46.89%	32.7%	16	16
8	臺南市玉井區	2018-11-25T01:16:16+08:00	4041	1204	5245	549	5794	12357	46.89%	32.7%	16	16
8	臺南市玉井區	2018-11-24T22:35:40+08:00	4041	1204	5245	549	5794	12357	46.89%	32.7%	16	16
8	臺南市玉井區	2018-11-25T03:54:35+08:00	4041	1204	5245	549	5794	12357	46.89%	32.7%	16	16
8	臺南市玉井區	2018-11-24T23:33:45+08:00	4041	1204	5245	549	5794	12357	46.89%	32.7%	16	16
8	臺南市玉井區	2018-11-24T23:37:44+08:00	4041	1204	5245	549	5794	12357	46.89%	32.7%	16	16
8	臺南市玉井區	2018-11-24T23:45:59+08:00	4041	1204	5245	549	5794	12357	46.89%	32.7%	16	16
8	屏東縣新園鄉	2018-11-24T23:10:57+08:00	10269	3577	13846	2072	15918	30706	51.84%	33.44%	28	28
8	屏東縣新園鄉	2018-11-24T23:07:19+08:00	10269	3577	13846	2072	15918	30706	51.84%	33.44%	28	28
8	屏東縣新園鄉	2018-11-24T22:14:50+08:00	10269	3577	13846	2072	15918	30706	51.84%	33.44%	28	28
8	屏東縣新園鄉	2018-11-25T06:17:37+08:00	10269	3577	13846	2072	15918	30706	51.84%	33.44%	28	28
8	屏東縣新園鄉	2018-11-25T01:24:25+08:00	10269	3577	13846	2072	15918	30706	51.84%	33.44%	28	28
8	屏東縣新園鄉	2018-11-24T22:56:37+08:00	10269	3577	13846	2072	15918	30706	51.84%	33.44%	28	28
8	屏東縣新園鄉	2018-11-24T22:32:19+08:00	10269	3577	13846	2072	15918	30706	51.84%	33.44%	28	28
8	屏東縣新園鄉	2018-11-24T22:53:16+08:00	10269	3577	13846	2072	15918	30706	51.84%	33.44%	28	28
8	屏東縣新園鄉	2018-11-25T01:06:00+08:00	10269	3577	13846	2072	15918	30706	51.84%	33.44%	28	28
8	屏東縣新園鄉	2018-11-24T22:25:26+08:00	10269	3577	13846	2072	15918	30706	51.84%	33.44%	28	28
8	屏東縣新園鄉	2018-11-25T01:11:08+08:00	10269	3577	13846	2072	15918	30706	51.84%	33.44%	28	28
8	屏東縣新園鄉	2018-11-25T06:07:24+08:00	10269	3577	13846	2072	15918	30706	51.84%	33.44%	28	28
8	屏東縣新園鄉	2018-11-24T23:00:18+08:00	10269	3577	13846	2072	15918	30706	51.84%	33.44%	28	28
8	屏東縣新園鄉	2018-11-25T03:48:32+08:00	10269	3577	13846	2072	15918	30706	51.84%	33.44%	28	28
8	屏東縣新園鄉	2018-11-24T22:40:19+08:00	10269	3577	13846	2072	15918	30706	51.84%	33.44%	28	28
8	屏東縣新園鄉	2018-11-24T23:29:47+08:00	10269	3577	13846	2072	15918	30706	51.84%	33.44%	28	28
8	屏東縣新園鄉	2018-11-25T00:21:45+08:00	10269	3577	13846	2072	15918	30706	51.84%	33.44%	28	28
8	屏東縣新園鄉	2018-11-25T03:31:00+08:00	10269	3577	13846	2072	15918	30706	51.84%	33.44%	28	28
8	屏東縣新園鄉	2018-11-25T01:16:23+08:00	10269	3577	13846	2072	15918	30706	51.84%	33.44%	28	28
8	屏東縣新園鄉	2018-11-25T00:03:35+08:00	10269	3577	13846	2072	15918	30706	51.84%	33.44%	28	28
8	屏東縣新園鄉	2018-11-25T00:56:14+08:00	10269	3577	13846	2072	15918	30706	51.84%	33.44%	28	28
8	屏東縣新園鄉	2018-11-24T22:35:45+08:00	10269	3577	13846	2072	15918	30706	51.84%	33.44%	28	28
8	屏東縣新園鄉	2018-11-24T23:14:42+08:00	10269	3577	13846	2072	15918	30706	51.84%	33.44%	28	28
8	屏東縣新園鄉	2018-11-24T23:50:16+08:00	10269	3577	13846	2072	15918	30706	51.84%	33.44%	28	28
8	屏東縣新園鄉	2018-11-24T23:37:49+08:00	10269	3577	13846	2072	15918	30706	51.84%	33.44%	28	28
8	屏東縣新園鄉	2018-11-24T22:43:51+08:00	10269	3577	13846	2072	15918	30706	51.84%	33.44%	28	28
8	屏東縣新園鄉	2018-11-25T06:27:56+08:00	10269	3577	13846	2072	15918	30706	51.84%	33.44%	28	28
8	屏東縣新園鄉	2018-11-25T00:12:46+08:00	10269	3577	13846	2072	15918	30706	51.84%	33.44%	28	28
8	屏東縣新園鄉	2018-11-24T23:54:28+08:00	10269	3577	13846	2072	15918	30706	51.84%	33.44%	28	28
8	屏東縣新園鄉	2018-11-24T23:22:24+08:00	10269	3577	13846	2072	15918	30706	51.84%	33.44%	28	28
8	屏東縣新園鄉	2018-11-24T22:28:41+08:00	10269	3577	13846	2072	15918	30706	51.84%	33.44%	28	28
8	屏東縣新園鄉	2018-11-24T22:12:03+08:00	10269	3577	13846	2072	15918	30706	51.84%	33.44%	28	28
8	屏東縣新園鄉	2018-11-24T23:33:51+08:00	10269	3577	13846	2072	15918	30706	51.84%	33.44%	28	28
8	屏東縣新園鄉	2018-11-25T03:54:42+08:00	10269	3577	13846	2072	15918	30706	51.84%	33.44%	28	28
8	屏東縣新園鄉	2018-11-24T23:03:48+08:00	10269	3577	13846	2072	15918	30706	51.84%	33.44%	28	28
8	屏東縣新園鄉	2018-11-24T22:49:25+08:00	10269	3577	13846	2072	15918	30706	51.84%	33.44%	28	28
8	屏東縣新園鄉	2018-11-25T04:01:30+08:00	10269	3577	13846	2072	15918	30706	51.84%	33.44%	28	28
8	屏東縣新園鄉	2018-11-25T03:42:49+08:00	10269	3577	13846	2072	15918	30706	51.84%	33.44%	28	28
8	屏東縣新園鄉	2018-11-24T23:42:02+08:00	10269	3577	13846	2072	15918	30706	51.84%	33.44%	28	28
8	屏東縣新園鄉	2018-11-25T00:08:05+08:00	10269	3577	13846	2072	15918	30706	51.84%	33.44%	28	28
8	屏東縣新園鄉	2018-11-24T23:46:04+08:00	10269	3577	13846	2072	15918	30706	51.84%	33.44%	28	28
8	屏東縣新園鄉	2018-11-25T00:17:09+08:00	10269	3577	13846	2072	15918	30706	51.84%	33.44%	28	28
8	屏東縣新園鄉	2018-11-25T06:12:37+08:00	10269	3577	13846	2072	15918	30706	51.84%	33.44%	28	28
8	屏東縣新園鄉	2018-11-25T06:22:45+08:00	10269	3577	13846	2072	15918	30706	51.84%	33.44%	28	28
8	屏東縣新園鄉	2018-11-24T22:21:47+08:00	10269	3577	13846	2072	15918	30706	51.84%	33.44%	28	28
8	屏東縣新園鄉	2018-11-24T22:39:10+08:00	10269	3577	13846	2072	15918	30706	51.84%	33.44%	28	28
8	屏東縣新園鄉	2018-11-24T22:18:20+08:00	10269	3577	13846	2072	15918	30706	51.84%	33.44%	28	28
8	屏東縣新園鄉	2018-11-25T03:37:30+08:00	10269	3577	13846	2072	15918	30706	51.84%	33.44%	28	28
8	屏東縣新園鄉	2018-11-24T23:58:43+08:00	10269	3577	13846	2072	15918	30706	51.84%	33.44%	28	28
8	屏東縣新園鄉	2018-11-24T23:26:07+08:00	10269	3577	13846	2072	15918	30706	51.84%	33.44%	28	28
8	屏東縣新園鄉	2018-11-25T01:01:02+08:00	10269	3577	13846	2072	15918	30706	51.84%	33.44%	28	28
8	屏東縣新園鄉	2018-11-24T23:18:28+08:00	10269	3577	13846	2072	15918	30706	51.84%	33.44%	28	28
8	臺南市南區	2018-11-25T00:56:08+08:00	36014	13298	49312	4974	54286	108650	49.96%	33.15%	80	80
8	臺南市南區	2018-11-24T23:03:43+08:00	30704	11605	42309	4373	46682	93655	49.84%	32.78%	71	80
8	臺南市南區	2018-11-24T23:58:37+08:00	35339	13049	48388	4866	53254	106876	49.83%	33.07%	79	80
8	臺南市南區	2018-11-25T06:17:31+08:00	36014	13298	49312	4974	54286	108650	49.96%	33.15%	80	80
8	臺南市南區	2018-11-24T23:22:18+08:00	32313	12131	44444	4532	48976	98359	49.79%	32.85%	74	80
8	臺南市南區	2018-11-24T22:43:45+08:00	26901	10110	37011	3888	40899	82145	49.79%	32.75%	63	80
8	臺南市南區	2018-11-24T23:14:35+08:00	31795	11927	43722	4483	48205	96578	49.91%	32.92%	73	80
8	臺南市南區	2018-11-25T03:37:20+08:00	36014	13298	49312	4974	54286	108650	49.96%	33.15%	80	80
8	臺南市南區	2018-11-24T22:49:19+08:00	27987	10509	38496	4007	42503	84953	50.03%	32.94%	65	80
8	臺南市南區	2018-11-25T00:03:28+08:00	35339	13049	48388	4866	53254	106876	49.83%	33.07%	79	80
8	臺南市南區	2018-11-25T03:42:42+08:00	36014	13298	49312	4974	54286	108650	49.96%	33.15%	80	80
8	臺南市南區	2018-11-24T22:25:19+08:00	22315	8475	30790	3326	34116	68200	50.02%	32.72%	54	80
8	臺南市南區	2018-11-25T06:22:40+08:00	36014	13298	49312	4974	54286	108650	49.96%	33.15%	80	80
8	臺南市南區	2018-11-25T00:17:03+08:00	36014	13298	49312	4974	54286	108650	49.96%	33.15%	80	80
8	臺南市南區	2018-11-25T01:11:01+08:00	36014	13298	49312	4974	54286	108650	49.96%	33.15%	80	80
8	臺南市南區	2018-11-25T06:12:32+08:00	36014	13298	49312	4974	54286	108650	49.96%	33.15%	80	80
8	臺南市南區	2018-11-24T23:50:10+08:00	35339	13049	48388	4866	53254	106876	49.83%	33.07%	79	80
8	臺南市南區	2018-11-24T22:18:15+08:00	21318	8142	29460	3222	32682	64811	50.43%	32.89%	52	80
8	臺南市南區	2018-11-25T00:12:40+08:00	36014	13298	49312	4974	54286	108650	49.96%	33.15%	80	80
8	臺南市南區	2018-11-24T22:28:35+08:00	22920	8664	31584	3369	34953	70185	49.8%	32.66%	55	80
8	臺南市南區	2018-11-24T22:14:43+08:00	20325	7773	28098	3069	31167	61962	50.3%	32.8%	50	80
8	臺南市南區	2018-11-24T23:26:02+08:00	33001	12348	45349	4631	49980	100530	49.72%	32.83%	75	80
8	臺南市南區	2018-11-24T23:54:20+08:00	35339	13049	48388	4866	53254	106876	49.83%	33.07%	79	80
8	臺南市南區	2018-11-25T06:27:50+08:00	36014	13298	49312	4974	54286	108650	49.96%	33.15%	80	80
8	臺南市南區	2018-11-25T00:07:59+08:00	36014	13298	49312	4974	54286	108650	49.96%	33.15%	80	80
8	臺南市南區	2018-11-24T23:18:22+08:00	31795	11927	43722	4483	48205	96578	49.91%	32.92%	73	80
8	臺南市南區	2018-11-25T01:05:53+08:00	36014	13298	49312	4974	54286	108650	49.96%	33.15%	80	80
8	臺南市南區	2018-11-24T22:56:32+08:00	28797	10840	39637	4122	43759	87420	50.06%	32.94%	67	80
8	臺南市南區	2018-11-25T01:24:19+08:00	36014	13298	49312	4974	54286	108650	49.96%	33.15%	80	80
8	臺南市南區	2018-11-24T22:39:04+08:00	25533	9596	35129	3725	38854	77758	49.97%	32.84%	60	80
8	臺南市南區	2018-11-24T23:10:52+08:00	31313	11749	43062	4417	47479	95113	49.92%	32.92%	72	80
8	臺南市南區	2018-11-24T23:07:14+08:00	31313	11749	43062	4417	47479	95113	49.92%	32.92%	72	80
8	臺南市南區	2018-11-25T00:21:39+08:00	36014	13298	49312	4974	54286	108650	49.96%	33.15%	80	80
8	臺南市南區	2018-11-24T22:32:13+08:00	23403	8845	32248	3475	35723	71649	49.86%	32.66%	56	80
8	臺南市南區	2018-11-25T03:30:53+08:00	36014	13298	49312	4974	54286	108650	49.96%	33.15%	80	80
8	臺南市南區	2018-11-25T03:48:24+08:00	36014	13298	49312	4974	54286	108650	49.96%	33.15%	80	80
8	臺南市南區	2018-11-25T01:00:55+08:00	36014	13298	49312	4974	54286	108650	49.96%	33.15%	80	80
8	臺南市南區	2018-11-24T23:29:42+08:00	33001	12348	45349	4631	49980	100530	49.72%	32.83%	75	80
8	臺南市南區	2018-11-24T23:00:13+08:00	28797	10840	39637	4122	43759	87420	50.06%	32.94%	67	80
8	臺南市南區	2018-11-25T06:07:17+08:00	36014	13298	49312	4974	54286	108650	49.96%	33.15%	80	80
8	臺南市南區	2018-11-24T22:21:41+08:00	21864	8331	30195	3255	33450	66867	50.02%	32.7%	53	80
8	臺南市南區	2018-11-24T22:53:09+08:00	28361	10683	39044	4046	43090	86157	50.01%	32.92%	66	80
8	臺南市南區	2018-11-24T22:40:14+08:00	26431	9922	36353	3845	40198	80575	49.89%	32.8%	62	80
8	臺南市南區	2018-11-24T22:11:58+08:00	20325	7773	28098	3069	31167	61962	50.3%	32.8%	50	80
8	臺南市南區	2018-11-25T04:01:24+08:00	36014	13298	49312	4974	54286	108650	49.96%	33.15%	80	80
8	臺南市南區	2018-11-24T23:41:57+08:00	35339	13049	48388	4866	53254	106876	49.83%	33.07%	79	80
8	臺南市南區	2018-11-25T01:16:16+08:00	36014	13298	49312	4974	54286	108650	49.96%	33.15%	80	80
8	臺南市南區	2018-11-24T22:35:40+08:00	25050	9416	34466	3679	38145	76272	50.01%	32.84%	59	80
8	臺南市南區	2018-11-25T03:54:35+08:00	36014	13298	49312	4974	54286	108650	49.96%	33.15%	80	80
8	臺南市南區	2018-11-24T23:33:45+08:00	34607	12903	47510	4825	52335	104936	49.87%	32.98%	78	80
8	臺南市南區	2018-11-24T23:37:44+08:00	35339	13049	48388	4866	53254	106876	49.83%	33.07%	79	80
8	臺南市南區	2018-11-24T23:45:59+08:00	35339	13049	48388	4866	53254	106876	49.83%	33.07%	79	80
8	南投縣埔里鎮	2018-11-25T01:24:23+08:00	29379	7062	36441	2913	39354	68763	57.23%	42.73%	68	68
8	南投縣埔里鎮	2018-11-24T22:39:07+08:00	27433	6556	33989	2727	36716	64122	57.26%	42.78%	64	68
8	南投縣埔里鎮	2018-11-24T23:07:17+08:00	28356	6813	35169	2812	37981	66157	57.41%	42.86%	66	68
8	南投縣埔里鎮	2018-11-24T22:12:01+08:00	25969	6198	32167	2524	34691	60324	57.51%	43.05%	61	68
8	南投縣埔里鎮	2018-11-25T03:37:27+08:00	29379	7062	36441	2913	39354	68763	57.23%	42.73%	68	68
8	南投縣埔里鎮	2018-11-24T22:32:17+08:00	27433	6556	33989	2727	36716	64122	57.26%	42.78%	64	68
8	南投縣埔里鎮	2018-11-25T03:30:57+08:00	29379	7062	36441	2913	39354	68763	57.23%	42.73%	68	68
8	南投縣埔里鎮	2018-11-25T03:48:28+08:00	29379	7062	36441	2913	39354	68763	57.23%	42.73%	68	68
8	南投縣埔里鎮	2018-11-25T01:00:59+08:00	29379	7062	36441	2913	39354	68763	57.23%	42.73%	68	68
8	南投縣埔里鎮	2018-11-24T23:42:00+08:00	28356	6813	35169	2812	37981	66157	57.41%	42.86%	66	68
8	南投縣埔里鎮	2018-11-25T04:01:28+08:00	29379	7062	36441	2913	39354	68763	57.23%	42.73%	68	68
8	南投縣埔里鎮	2018-11-24T22:21:44+08:00	26945	6439	33384	2682	36066	62839	57.39%	42.88%	63	68
8	南投縣埔里鎮	2018-11-24T23:00:16+08:00	28356	6813	35169	2812	37981	66157	57.41%	42.86%	66	68
8	南投縣埔里鎮	2018-11-24T22:40:17+08:00	27433	6556	33989	2727	36716	64122	57.26%	42.78%	64	68
8	南投縣埔里鎮	2018-11-25T00:21:42+08:00	29379	7062	36441	2913	39354	68763	57.23%	42.73%	68	68
8	南投縣埔里鎮	2018-11-25T06:12:35+08:00	29379	7062	36441	2913	39354	68763	57.23%	42.73%	68	68
8	南投縣埔里鎮	2018-11-25T00:03:32+08:00	28356	6813	35169	2812	37981	66157	57.41%	42.86%	66	68
8	南投縣埔里鎮	2018-11-25T03:54:39+08:00	29379	7062	36441	2913	39354	68763	57.23%	42.73%	68	68
8	南投縣埔里鎮	2018-11-24T23:33:49+08:00	28356	6813	35169	2812	37981	66157	57.41%	42.86%	66	68
8	南投縣埔里鎮	2018-11-24T23:26:05+08:00	28356	6813	35169	2812	37981	66157	57.41%	42.86%	66	68
8	南投縣埔里鎮	2018-11-24T23:37:47+08:00	28356	6813	35169	2812	37981	66157	57.41%	42.86%	66	68
8	南投縣埔里鎮	2018-11-24T22:35:43+08:00	27433	6556	33989	2727	36716	64122	57.26%	42.78%	64	68
8	南投縣埔里鎮	2018-11-24T23:54:26+08:00	28356	6813	35169	2812	37981	66157	57.41%	42.86%	66	68
8	南投縣埔里鎮	2018-11-24T23:58:41+08:00	28356	6813	35169	2812	37981	66157	57.41%	42.86%	66	68
8	南投縣埔里鎮	2018-11-25T00:56:12+08:00	29379	7062	36441	2913	39354	68763	57.23%	42.73%	68	68
8	南投縣埔里鎮	2018-11-24T22:56:35+08:00	27891	6672	34563	2769	37332	65228	57.23%	42.76%	65	68
8	南投縣埔里鎮	2018-11-24T23:14:39+08:00	28356	6813	35169	2812	37981	66157	57.41%	42.86%	66	68
8	南投縣埔里鎮	2018-11-24T23:22:22+08:00	28356	6813	35169	2812	37981	66157	57.41%	42.86%	66	68
8	南投縣埔里鎮	2018-11-25T06:17:34+08:00	29379	7062	36441	2913	39354	68763	57.23%	42.73%	68	68
8	南投縣埔里鎮	2018-11-24T22:43:49+08:00	27891	6672	34563	2769	37332	65228	57.23%	42.76%	65	68
8	南投縣埔里鎮	2018-11-24T23:03:46+08:00	28356	6813	35169	2812	37981	66157	57.41%	42.86%	66	68
8	南投縣埔里鎮	2018-11-24T23:10:55+08:00	28356	6813	35169	2812	37981	66157	57.41%	42.86%	66	68
8	南投縣埔里鎮	2018-11-24T22:49:22+08:00	27891	6672	34563	2769	37332	65228	57.23%	42.76%	65	68
8	南投縣埔里鎮	2018-11-25T00:08:03+08:00	28911	6935	35846	2849	38695	67439	57.38%	42.87%	67	68
8	南投縣埔里鎮	2018-11-24T22:53:13+08:00	27891	6672	34563	2769	37332	65228	57.23%	42.76%	65	68
8	南投縣埔里鎮	2018-11-24T23:46:02+08:00	28356	6813	35169	2812	37981	66157	57.41%	42.86%	66	68
8	南投縣埔里鎮	2018-11-25T03:42:46+08:00	29379	7062	36441	2913	39354	68763	57.23%	42.73%	68	68
8	南投縣埔里鎮	2018-11-25T01:11:05+08:00	29379	7062	36441	2913	39354	68763	57.23%	42.73%	68	68
8	南投縣埔里鎮	2018-11-24T22:25:22+08:00	27433	6556	33989	2727	36716	64122	57.26%	42.78%	64	68
8	南投縣埔里鎮	2018-11-25T06:07:21+08:00	29379	7062	36441	2913	39354	68763	57.23%	42.73%	68	68
8	南投縣埔里鎮	2018-11-25T06:22:43+08:00	29379	7062	36441	2913	39354	68763	57.23%	42.73%	68	68
8	南投縣埔里鎮	2018-11-24T23:29:44+08:00	28356	6813	35169	2812	37981	66157	57.41%	42.86%	66	68
8	南投縣埔里鎮	2018-11-25T00:17:06+08:00	29379	7062	36441	2913	39354	68763	57.23%	42.73%	68	68
8	南投縣埔里鎮	2018-11-25T00:12:43+08:00	28911	6935	35846	2849	38695	67439	57.38%	42.87%	67	68
8	南投縣埔里鎮	2018-11-24T22:28:38+08:00	27433	6556	33989	2727	36716	64122	57.26%	42.78%	64	68
8	南投縣埔里鎮	2018-11-24T22:14:47+08:00	25969	6198	32167	2524	34691	60324	57.51%	43.05%	61	68
8	南投縣埔里鎮	2018-11-25T06:27:53+08:00	29379	7062	36441	2913	39354	68763	57.23%	42.73%	68	68
8	南投縣埔里鎮	2018-11-24T22:18:18+08:00	25969	6198	32167	2524	34691	60324	57.51%	43.05%	61	68
8	南投縣埔里鎮	2018-11-24T23:50:13+08:00	28356	6813	35169	2812	37981	66157	57.41%	42.86%	66	68
8	南投縣埔里鎮	2018-11-25T01:16:20+08:00	29379	7062	36441	2913	39354	68763	57.23%	42.73%	68	68
8	南投縣埔里鎮	2018-11-25T01:05:57+08:00	29379	7062	36441	2913	39354	68763	57.23%	42.73%	68	68
8	南投縣埔里鎮	2018-11-24T23:18:26+08:00	28356	6813	35169	2812	37981	66157	57.41%	42.86%	66	68
8	南投縣信義鄉	2018-11-24T22:39:08+08:00	3828	1015	4843	815	5658	9407	60.15%	40.69%	16	20
8	南投縣信義鄉	2018-11-25T03:37:28+08:00	5078	1353	6431	1055	7486	13299	56.29%	38.18%	20	20
8	南投縣信義鄉	2018-11-25T01:24:23+08:00	5078	1353	6431	1055	7486	13299	56.29%	38.18%	20	20
8	南投縣信義鄉	2018-11-24T23:07:17+08:00	4343	1156	5499	881	6380	10903	58.52%	39.83%	18	20
8	南投縣信義鄉	2018-11-24T22:12:01+08:00	2750	754	3504	540	4044	7018	57.62%	39.18%	13	20
8	南投縣信義鄉	2018-11-24T22:32:17+08:00	3461	917	4378	643	5021	8478	59.22%	40.82%	15	20
8	南投縣信義鄉	2018-11-25T03:48:28+08:00	5078	1353	6431	1055	7486	13299	56.29%	38.18%	20	20
8	南投縣信義鄉	2018-11-25T03:30:58+08:00	5078	1353	6431	1055	7486	13299	56.29%	38.18%	20	20
8	南投縣信義鄉	2018-11-24T23:42:01+08:00	4343	1156	5499	881	6380	10903	58.52%	39.83%	18	20
8	南投縣信義鄉	2018-11-24T22:21:45+08:00	2992	824	3816	574	4390	7578	57.93%	39.48%	14	20
8	南投縣信義鄉	2018-11-25T04:01:28+08:00	5078	1353	6431	1055	7486	13299	56.29%	38.18%	20	20
8	南投縣信義鄉	2018-11-25T00:21:43+08:00	5078	1353	6431	1055	7486	13299	56.29%	38.18%	20	20
8	南投縣信義鄉	2018-11-25T01:11:06+08:00	5078	1353	6431	1055	7486	13299	56.29%	38.18%	20	20
8	南投縣信義鄉	2018-11-24T22:40:18+08:00	3828	1015	4843	815	5658	9407	60.15%	40.69%	16	20
8	南投縣信義鄉	2018-11-24T23:00:16+08:00	4343	1156	5499	881	6380	10903	58.52%	39.83%	18	20
8	南投縣信義鄉	2018-11-25T06:12:35+08:00	5078	1353	6431	1055	7486	13299	56.29%	38.18%	20	20
8	南投縣信義鄉	2018-11-25T03:54:39+08:00	5078	1353	6431	1055	7486	13299	56.29%	38.18%	20	20
8	南投縣信義鄉	2018-11-25T01:01:00+08:00	5078	1353	6431	1055	7486	13299	56.29%	38.18%	20	20
8	南投縣信義鄉	2018-11-24T23:33:49+08:00	4343	1156	5499	881	6380	10903	58.52%	39.83%	18	20
8	南投縣信義鄉	2018-11-25T00:03:33+08:00	4343	1156	5499	881	6380	10903	58.52%	39.83%	18	20
8	南投縣信義鄉	2018-11-24T23:37:47+08:00	4343	1156	5499	881	6380	10903	58.52%	39.83%	18	20
8	南投縣信義鄉	2018-11-24T22:35:43+08:00	3828	1015	4843	815	5658	9407	60.15%	40.69%	16	20
8	南投縣信義鄉	2018-11-24T23:54:26+08:00	4343	1156	5499	881	6380	10903	58.52%	39.83%	18	20
8	南投縣信義鄉	2018-11-24T23:58:41+08:00	4343	1156	5499	881	6380	10903	58.52%	39.83%	18	20
8	南投縣信義鄉	2018-11-25T00:56:12+08:00	5078	1353	6431	1055	7486	13299	56.29%	38.18%	20	20
8	南投縣信義鄉	2018-11-24T22:56:35+08:00	4037	1075	5112	849	5961	9924	60.07%	40.68%	17	20
8	南投縣信義鄉	2018-11-25T06:17:35+08:00	5078	1353	6431	1055	7486	13299	56.29%	38.18%	20	20
8	南投縣信義鄉	2018-11-24T22:49:23+08:00	4037	1075	5112	849	5961	9924	60.07%	40.68%	17	20
8	南投縣信義鄉	2018-11-24T23:14:39+08:00	4343	1156	5499	881	6380	10903	58.52%	39.83%	18	20
8	南投縣信義鄉	2018-11-24T23:22:22+08:00	4343	1156	5499	881	6380	10903	58.52%	39.83%	18	20
8	南投縣信義鄉	2018-11-24T22:43:49+08:00	3828	1015	4843	815	5658	9407	60.15%	40.69%	16	20
8	南投縣信義鄉	2018-11-24T23:03:46+08:00	4343	1156	5499	881	6380	10903	58.52%	39.83%	18	20
8	南投縣信義鄉	2018-11-24T23:10:55+08:00	4343	1156	5499	881	6380	10903	58.52%	39.83%	18	20
8	南投縣信義鄉	2018-11-25T00:08:03+08:00	4801	1299	6100	1040	7140	11923	59.88%	40.27%	19	20
8	南投縣信義鄉	2018-11-25T03:42:47+08:00	5078	1353	6431	1055	7486	13299	56.29%	38.18%	20	20
8	南投縣信義鄉	2018-11-24T22:53:14+08:00	4037	1075	5112	849	5961	9924	60.07%	40.68%	17	20
8	南投縣信義鄉	2018-11-24T23:46:02+08:00	4343	1156	5499	881	6380	10903	58.52%	39.83%	18	20
8	南投縣信義鄉	2018-11-25T00:17:07+08:00	4801	1299	6100	1040	7140	11923	59.88%	40.27%	19	20
8	南投縣信義鄉	2018-11-24T23:29:45+08:00	4343	1156	5499	881	6380	10903	58.52%	39.83%	18	20
8	南投縣信義鄉	2018-11-25T06:22:44+08:00	5078	1353	6431	1055	7486	13299	56.29%	38.18%	20	20
8	南投縣信義鄉	2018-11-25T06:07:21+08:00	5078	1353	6431	1055	7486	13299	56.29%	38.18%	20	20
8	南投縣信義鄉	2018-11-24T22:25:23+08:00	2992	824	3816	574	4390	7578	57.93%	39.48%	14	20
8	南投縣信義鄉	2018-11-25T01:05:58+08:00	5078	1353	6431	1055	7486	13299	56.29%	38.18%	20	20
8	南投縣信義鄉	2018-11-25T00:12:44+08:00	4801	1299	6100	1040	7140	11923	59.88%	40.27%	19	20
8	南投縣信義鄉	2018-11-24T23:26:06+08:00	4343	1156	5499	881	6380	10903	58.52%	39.83%	18	20
8	南投縣信義鄉	2018-11-24T22:14:47+08:00	2750	754	3504	540	4044	7018	57.62%	39.18%	13	20
8	南投縣信義鄉	2018-11-24T22:18:18+08:00	2750	754	3504	540	4044	7018	57.62%	39.18%	13	20
8	南投縣信義鄉	2018-11-25T06:27:54+08:00	5078	1353	6431	1055	7486	13299	56.29%	38.18%	20	20
8	南投縣信義鄉	2018-11-24T23:50:13+08:00	4343	1156	5499	881	6380	10903	58.52%	39.83%	18	20
8	南投縣信義鄉	2018-11-25T01:16:20+08:00	5078	1353	6431	1055	7486	13299	56.29%	38.18%	20	20
8	南投縣信義鄉	2018-11-24T22:28:39+08:00	2992	824	3816	574	4390	7578	57.93%	39.48%	14	20
8	南投縣信義鄉	2018-11-24T23:18:26+08:00	4343	1156	5499	881	6380	10903	58.52%	39.83%	18	20
8	苗栗縣頭份市	2018-11-24T23:07:16+08:00	29837	7977	37814	2513	40327	71650	56.28%	41.64%	62	71
8	苗栗縣頭份市	2018-11-24T22:12:00+08:00	19201	5178	24379	1635	26014	46524	55.92%	41.27%	42	71
8	苗栗縣頭份市	2018-11-24T22:39:06+08:00	24370	6527	30897	2067	32964	58639	56.22%	41.56%	52	71
8	苗栗縣頭份市	2018-11-24T23:22:20+08:00	32738	8700	41438	2736	44174	78688	56.14%	41.6%	67	71
8	苗栗縣頭份市	2018-11-24T23:58:39+08:00	34955	9243	44198	2893	47091	83617	56.32%	41.8%	71	71
8	苗栗縣頭份市	2018-11-24T23:03:45+08:00	29453	7843	37296	2479	39775	70702	56.26%	41.66%	61	71
8	苗栗縣頭份市	2018-11-24T22:49:21+08:00	27209	7289	34498	2305	36803	65544	56.15%	41.51%	57	71
8	苗栗縣頭份市	2018-11-24T23:46:01+08:00	34455	9117	43572	2857	46429	82476	56.29%	41.78%	70	71
8	苗栗縣頭份市	2018-11-25T03:48:26+08:00	34955	9243	44198	2893	47091	83617	56.32%	41.8%	71	71
8	苗栗縣頭份市	2018-11-25T03:30:56+08:00	34955	9243	44198	2893	47091	83617	56.32%	41.8%	71	71
8	苗栗縣頭份市	2018-11-25T03:42:45+08:00	34955	9243	44198	2893	47091	83617	56.32%	41.8%	71	71
8	苗栗縣頭份市	2018-11-24T22:32:16+08:00	23893	6407	30300	2006	32306	57510	56.17%	41.55%	51	71
8	苗栗縣頭份市	2018-11-25T01:00:58+08:00	34955	9243	44198	2893	47091	83617	56.32%	41.8%	71	71
8	苗栗縣頭份市	2018-11-25T04:01:26+08:00	34955	9243	44198	2893	47091	83617	56.32%	41.8%	71	71
8	苗栗縣頭份市	2018-11-24T22:25:21+08:00	23373	6257	29630	1978	31608	56224	56.22%	41.57%	50	71
8	苗栗縣頭份市	2018-11-25T06:12:34+08:00	34955	9243	44198	2893	47091	83617	56.32%	41.8%	71	71
8	苗栗縣頭份市	2018-11-24T22:40:16+08:00	24974	6656	31630	2099	33729	59965	56.25%	41.65%	53	71
8	苗栗縣頭份市	2018-11-24T22:21:43+08:00	22472	6052	28524	1920	30444	54197	56.17%	41.46%	48	71
8	苗栗縣頭份市	2018-11-25T00:17:05+08:00	34955	9243	44198	2893	47091	83617	56.32%	41.8%	71	71
8	苗栗縣頭份市	2018-11-24T23:18:24+08:00	31381	8398	39779	2634	42413	75439	56.22%	41.6%	65	71
8	苗栗縣頭份市	2018-11-24T23:37:46+08:00	33886	8955	42841	2817	45658	81138	56.27%	41.76%	69	71
8	苗栗縣頭份市	2018-11-24T22:35:42+08:00	24370	6527	30897	2067	32964	58639	56.22%	41.56%	52	71
8	苗栗縣頭份市	2018-11-25T03:54:37+08:00	34955	9243	44198	2893	47091	83617	56.32%	41.8%	71	71
8	苗栗縣頭份市	2018-11-24T23:33:47+08:00	33886	8955	42841	2817	45658	81138	56.27%	41.76%	69	71
8	苗栗縣頭份市	2018-11-24T23:26:04+08:00	33305	8827	42132	2777	44909	79874	56.22%	41.7%	68	71
8	苗栗縣頭份市	2018-11-24T23:10:54+08:00	30670	8224	38894	2587	41481	73680	56.3%	41.63%	64	71
8	苗栗縣頭份市	2018-11-24T23:14:37+08:00	31381	8398	39779	2634	42413	75439	56.22%	41.6%	65	71
8	苗栗縣頭份市	2018-11-25T06:17:33+08:00	34955	9243	44198	2893	47091	83617	56.32%	41.8%	71	71
8	苗栗縣頭份市	2018-11-24T22:43:47+08:00	26126	6949	33075	2194	35269	62908	56.06%	41.53%	55	71
8	苗栗縣頭份市	2018-11-25T01:24:21+08:00	34955	9243	44198	2893	47091	83617	56.32%	41.8%	71	71
8	苗栗縣頭份市	2018-11-24T22:56:34+08:00	27678	7382	35060	2331	37391	66560	56.18%	41.58%	58	71
8	苗栗縣頭份市	2018-11-25T03:37:24+08:00	34955	9243	44198	2893	47091	83617	56.32%	41.8%	71	71
8	苗栗縣頭份市	2018-11-25T00:08:02+08:00	34955	9243	44198	2893	47091	83617	56.32%	41.8%	71	71
8	苗栗縣頭份市	2018-11-24T22:53:12+08:00	27678	7382	35060	2331	37391	66560	56.18%	41.58%	58	71
8	苗栗縣頭份市	2018-11-25T01:11:04+08:00	34955	9243	44198	2893	47091	83617	56.32%	41.8%	71	71
8	苗栗縣頭份市	2018-11-24T23:29:43+08:00	33305	8827	42132	2777	44909	79874	56.22%	41.7%	68	71
8	苗栗縣頭份市	2018-11-25T00:21:41+08:00	34955	9243	44198	2893	47091	83617	56.32%	41.8%	71	71
8	苗栗縣頭份市	2018-11-25T06:22:42+08:00	34955	9243	44198	2893	47091	83617	56.32%	41.8%	71	71
8	苗栗縣頭份市	2018-11-25T06:07:20+08:00	34955	9243	44198	2893	47091	83617	56.32%	41.8%	71	71
8	苗栗縣頭份市	2018-11-24T23:00:15+08:00	28839	7689	36528	2447	38975	69432	56.13%	41.54%	60	71
8	苗栗縣頭份市	2018-11-25T01:05:56+08:00	34955	9243	44198	2893	47091	83617	56.32%	41.8%	71	71
8	苗栗縣頭份市	2018-11-24T23:41:59+08:00	33886	8955	42841	2817	45658	81138	56.27%	41.76%	69	71
8	苗栗縣頭份市	2018-11-25T00:03:31+08:00	34955	9243	44198	2893	47091	83617	56.32%	41.8%	71	71
8	苗栗縣頭份市	2018-11-24T23:54:25+08:00	34455	9117	43572	2857	46429	82476	56.29%	41.78%	70	71
8	苗栗縣頭份市	2018-11-24T22:14:46+08:00	19201	5178	24379	1635	26014	46524	55.92%	41.27%	42	71
8	苗栗縣頭份市	2018-11-25T06:27:52+08:00	34955	9243	44198	2893	47091	83617	56.32%	41.8%	71	71
8	苗栗縣頭份市	2018-11-25T00:56:11+08:00	34955	9243	44198	2893	47091	83617	56.32%	41.8%	71	71
8	苗栗縣頭份市	2018-11-24T22:18:17+08:00	20986	5646	26632	1813	28445	50676	56.13%	41.41%	45	71
8	苗栗縣頭份市	2018-11-25T00:12:42+08:00	34955	9243	44198	2893	47091	83617	56.32%	41.8%	71	71
8	苗栗縣頭份市	2018-11-24T22:28:37+08:00	23893	6407	30300	2006	32306	57510	56.17%	41.55%	51	71
8	苗栗縣頭份市	2018-11-25T01:16:19+08:00	34955	9243	44198	2893	47091	83617	56.32%	41.8%	71	71
8	苗栗縣頭份市	2018-11-24T23:50:12+08:00	34455	9117	43572	2857	46429	82476	56.29%	41.78%	70	71
8	苗栗縣造橋鄉	2018-11-25T03:37:26+08:00	4538	1279	5817	587	6404	11027	58.08%	41.15%	12	12
8	苗栗縣造橋鄉	2018-11-24T23:07:16+08:00	4538	1279	5817	587	6404	11027	58.08%	41.15%	12	12
8	苗栗縣造橋鄉	2018-11-24T22:12:00+08:00	4538	1279	5817	587	6404	11027	58.08%	41.15%	12	12
8	苗栗縣造橋鄉	2018-11-24T22:39:06+08:00	4538	1279	5817	587	6404	11027	58.08%	41.15%	12	12
8	苗栗縣造橋鄉	2018-11-24T23:03:45+08:00	4538	1279	5817	587	6404	11027	58.08%	41.15%	12	12
8	苗栗縣造橋鄉	2018-11-24T23:22:21+08:00	4538	1279	5817	587	6404	11027	58.08%	41.15%	12	12
8	苗栗縣造橋鄉	2018-11-25T01:24:22+08:00	4538	1279	5817	587	6404	11027	58.08%	41.15%	12	12
8	苗栗縣造橋鄉	2018-11-24T23:46:01+08:00	4538	1279	5817	587	6404	11027	58.08%	41.15%	12	12
8	苗栗縣造橋鄉	2018-11-24T23:42:00+08:00	4538	1279	5817	587	6404	11027	58.08%	41.15%	12	12
8	苗栗縣造橋鄉	2018-11-25T03:30:56+08:00	4538	1279	5817	587	6404	11027	58.08%	41.15%	12	12
8	苗栗縣造橋鄉	2018-11-25T03:42:45+08:00	4538	1279	5817	587	6404	11027	58.08%	41.15%	12	12
8	苗栗縣造橋鄉	2018-11-24T22:32:16+08:00	4538	1279	5817	587	6404	11027	58.08%	41.15%	12	12
8	苗栗縣造橋鄉	2018-11-25T03:48:27+08:00	4538	1279	5817	587	6404	11027	58.08%	41.15%	12	12
8	苗栗縣造橋鄉	2018-11-25T01:00:58+08:00	4538	1279	5817	587	6404	11027	58.08%	41.15%	12	12
8	苗栗縣造橋鄉	2018-11-24T22:25:21+08:00	4538	1279	5817	587	6404	11027	58.08%	41.15%	12	12
8	苗栗縣造橋鄉	2018-11-25T06:12:34+08:00	4538	1279	5817	587	6404	11027	58.08%	41.15%	12	12
8	苗栗縣造橋鄉	2018-11-25T04:01:27+08:00	4538	1279	5817	587	6404	11027	58.08%	41.15%	12	12
8	苗栗縣造橋鄉	2018-11-24T22:21:43+08:00	4538	1279	5817	587	6404	11027	58.08%	41.15%	12	12
8	苗栗縣造橋鄉	2018-11-24T22:40:17+08:00	4538	1279	5817	587	6404	11027	58.08%	41.15%	12	12
8	苗栗縣造橋鄉	2018-11-25T00:21:42+08:00	4538	1279	5817	587	6404	11027	58.08%	41.15%	12	12
8	苗栗縣造橋鄉	2018-11-24T23:37:46+08:00	4538	1279	5817	587	6404	11027	58.08%	41.15%	12	12
8	苗栗縣造橋鄉	2018-11-24T22:35:42+08:00	4538	1279	5817	587	6404	11027	58.08%	41.15%	12	12
8	苗栗縣造橋鄉	2018-11-24T23:58:40+08:00	4538	1279	5817	587	6404	11027	58.08%	41.15%	12	12
8	苗栗縣造橋鄉	2018-11-24T23:26:05+08:00	4538	1279	5817	587	6404	11027	58.08%	41.15%	12	12
8	苗栗縣造橋鄉	2018-11-24T23:18:25+08:00	4538	1279	5817	587	6404	11027	58.08%	41.15%	12	12
8	苗栗縣造橋鄉	2018-11-24T23:33:48+08:00	4538	1279	5817	587	6404	11027	58.08%	41.15%	12	12
8	苗栗縣造橋鄉	2018-11-25T03:54:38+08:00	4538	1279	5817	587	6404	11027	58.08%	41.15%	12	12
8	苗栗縣造橋鄉	2018-11-24T22:43:48+08:00	4538	1279	5817	587	6404	11027	58.08%	41.15%	12	12
8	苗栗縣造橋鄉	2018-11-24T23:10:54+08:00	4538	1279	5817	587	6404	11027	58.08%	41.15%	12	12
8	苗栗縣造橋鄉	2018-11-25T06:17:33+08:00	4538	1279	5817	587	6404	11027	58.08%	41.15%	12	12
8	苗栗縣造橋鄉	2018-11-24T22:56:34+08:00	4538	1279	5817	587	6404	11027	58.08%	41.15%	12	12
8	苗栗縣造橋鄉	2018-11-24T23:14:38+08:00	4538	1279	5817	587	6404	11027	58.08%	41.15%	12	12
8	苗栗縣造橋鄉	2018-11-24T22:49:22+08:00	4538	1279	5817	587	6404	11027	58.08%	41.15%	12	12
8	苗栗縣造橋鄉	2018-11-25T00:08:02+08:00	4538	1279	5817	587	6404	11027	58.08%	41.15%	12	12
8	苗栗縣造橋鄉	2018-11-24T22:53:12+08:00	4538	1279	5817	587	6404	11027	58.08%	41.15%	12	12
8	苗栗縣造橋鄉	2018-11-25T06:22:43+08:00	4538	1279	5817	587	6404	11027	58.08%	41.15%	12	12
8	苗栗縣造橋鄉	2018-11-24T23:29:44+08:00	4538	1279	5817	587	6404	11027	58.08%	41.15%	12	12
8	苗栗縣造橋鄉	2018-11-25T00:17:06+08:00	4538	1279	5817	587	6404	11027	58.08%	41.15%	12	12
8	苗栗縣造橋鄉	2018-11-25T01:11:04+08:00	4538	1279	5817	587	6404	11027	58.08%	41.15%	12	12
8	苗栗縣造橋鄉	2018-11-25T06:07:20+08:00	4538	1279	5817	587	6404	11027	58.08%	41.15%	12	12
8	苗栗縣造橋鄉	2018-11-24T23:00:15+08:00	4538	1279	5817	587	6404	11027	58.08%	41.15%	12	12
8	苗栗縣造橋鄉	2018-11-25T00:12:43+08:00	4538	1279	5817	587	6404	11027	58.08%	41.15%	12	12
8	苗栗縣造橋鄉	2018-11-24T22:28:38+08:00	4538	1279	5817	587	6404	11027	58.08%	41.15%	12	12
8	苗栗縣造橋鄉	2018-11-25T01:05:56+08:00	4538	1279	5817	587	6404	11027	58.08%	41.15%	12	12
8	苗栗縣造橋鄉	2018-11-25T06:27:53+08:00	4538	1279	5817	587	6404	11027	58.08%	41.15%	12	12
8	苗栗縣造橋鄉	2018-11-25T00:03:31+08:00	4538	1279	5817	587	6404	11027	58.08%	41.15%	12	12
8	苗栗縣造橋鄉	2018-11-24T23:54:25+08:00	4538	1279	5817	587	6404	11027	58.08%	41.15%	12	12
8	苗栗縣造橋鄉	2018-11-24T22:14:46+08:00	4538	1279	5817	587	6404	11027	58.08%	41.15%	12	12
8	苗栗縣造橋鄉	2018-11-25T00:56:11+08:00	4538	1279	5817	587	6404	11027	58.08%	41.15%	12	12
8	苗栗縣造橋鄉	2018-11-24T22:18:17+08:00	4538	1279	5817	587	6404	11027	58.08%	41.15%	12	12
8	苗栗縣造橋鄉	2018-11-25T01:16:19+08:00	4538	1279	5817	587	6404	11027	58.08%	41.15%	12	12
8	苗栗縣造橋鄉	2018-11-24T23:50:12+08:00	4538	1279	5817	587	6404	11027	58.08%	41.15%	12	12
8	高雄市大社區	2018-11-24T22:49:20+08:00	10415	3851	14266	1329	15595	27074	57.6%	38.47%	22	24
8	高雄市大社區	2018-11-25T03:37:21+08:00	11407	4150	15557	1432	16989	30046	56.54%	37.97%	24	24
8	高雄市大社區	2018-11-24T23:03:43+08:00	10415	3851	14266	1329	15595	27074	57.6%	38.47%	22	24
8	高雄市大社區	2018-11-24T23:58:37+08:00	11035	4012	15047	1369	16416	28930	56.74%	38.14%	23	24
8	高雄市大社區	2018-11-25T00:03:29+08:00	11035	4012	15047	1369	16416	28930	56.74%	38.14%	23	24
8	高雄市大社區	2018-11-25T00:56:09+08:00	11035	4012	15047	1369	16416	28930	56.74%	38.14%	23	24
8	高雄市大社區	2018-11-24T23:22:19+08:00	11035	4012	15047	1369	16416	28930	56.74%	38.14%	23	24
8	高雄市大社區	2018-11-25T03:42:43+08:00	11407	4150	15557	1432	16989	30046	56.54%	37.97%	24	24
8	高雄市大社區	2018-11-24T22:53:10+08:00	10415	3851	14266	1329	15595	27074	57.6%	38.47%	22	24
8	高雄市大社區	2018-11-25T00:08:00+08:00	11035	4012	15047	1369	16416	28930	56.74%	38.14%	23	24
8	高雄市大社區	2018-11-24T23:46:00+08:00	11035	4012	15047	1369	16416	28930	56.74%	38.14%	23	24
8	高雄市大社區	2018-11-25T01:00:56+08:00	11035	4012	15047	1369	16416	28930	56.74%	38.14%	23	24
8	高雄市大社區	2018-11-24T22:25:19+08:00	10415	3851	14266	1329	15595	27074	57.6%	38.47%	22	24
8	高雄市大社區	2018-11-25T06:12:33+08:00	11407	4150	15557	1432	16989	30046	56.54%	37.97%	24	24
8	高雄市大社區	2018-11-25T00:17:04+08:00	11035	4012	15047	1369	16416	28930	56.74%	38.14%	23	24
8	高雄市大社區	2018-11-25T06:22:41+08:00	11407	4150	15557	1432	16989	30046	56.54%	37.97%	24	24
8	高雄市大社區	2018-11-24T23:18:23+08:00	10415	3851	14266	1329	15595	27074	57.6%	38.47%	22	24
8	高雄市大社區	2018-11-24T22:18:15+08:00	10415	3851	14266	1329	15595	27074	57.6%	38.47%	22	24
8	高雄市大社區	2018-11-24T22:14:44+08:00	10415	3851	14266	1329	15595	27074	57.6%	38.47%	22	24
8	高雄市大社區	2018-11-24T23:50:11+08:00	11035	4012	15047	1369	16416	28930	56.74%	38.14%	23	24
8	高雄市大社區	2018-11-25T01:05:54+08:00	11035	4012	15047	1369	16416	28930	56.74%	38.14%	23	24
8	高雄市大社區	2018-11-24T23:33:46+08:00	11035	4012	15047	1369	16416	28930	56.74%	38.14%	23	24
8	高雄市大社區	2018-11-25T06:27:51+08:00	11407	4150	15557	1432	16989	30046	56.54%	37.97%	24	24
8	高雄市大社區	2018-11-24T23:26:03+08:00	11035	4012	15047	1369	16416	28930	56.74%	38.14%	23	24
8	高雄市大社區	2018-11-25T03:54:36+08:00	11407	4150	15557	1432	16989	30046	56.54%	37.97%	24	24
8	高雄市大社區	2018-11-25T00:12:41+08:00	11035	4012	15047	1369	16416	28930	56.74%	38.14%	23	24
8	高雄市大社區	2018-11-25T01:24:20+08:00	11035	4012	15047	1369	16416	28930	56.74%	38.14%	23	24
8	高雄市大社區	2018-11-24T22:43:46+08:00	10415	3851	14266	1329	15595	27074	57.6%	38.47%	22	24
8	高雄市大社區	2018-11-25T06:17:32+08:00	11407	4150	15557	1432	16989	30046	56.54%	37.97%	24	24
8	高雄市大社區	2018-11-24T22:39:05+08:00	10415	3851	14266	1329	15595	27074	57.6%	38.47%	22	24
8	高雄市大社區	2018-11-24T22:56:33+08:00	10415	3851	14266	1329	15595	27074	57.6%	38.47%	22	24
8	高雄市大社區	2018-11-24T23:14:36+08:00	10415	3851	14266	1329	15595	27074	57.6%	38.47%	22	24
8	高雄市大社區	2018-11-24T23:10:52+08:00	10415	3851	14266	1329	15595	27074	57.6%	38.47%	22	24
8	高雄市大社區	2018-11-24T23:07:14+08:00	10415	3851	14266	1329	15595	27074	57.6%	38.47%	22	24
8	高雄市大社區	2018-11-25T03:48:25+08:00	11407	4150	15557	1432	16989	30046	56.54%	37.97%	24	24
8	高雄市大社區	2018-11-24T22:32:14+08:00	10415	3851	14266	1329	15595	27074	57.6%	38.47%	22	24
8	高雄市大社區	2018-11-25T03:30:54+08:00	11407	4150	15557	1432	16989	30046	56.54%	37.97%	24	24
8	高雄市大社區	2018-11-24T22:40:15+08:00	10415	3851	14266	1329	15595	27074	57.6%	38.47%	22	24
8	高雄市大社區	2018-11-25T00:21:40+08:00	11035	4012	15047	1369	16416	28930	56.74%	38.14%	23	24
8	高雄市大社區	2018-11-24T23:29:42+08:00	11035	4012	15047	1369	16416	28930	56.74%	38.14%	23	24
8	高雄市大社區	2018-11-25T01:11:02+08:00	11035	4012	15047	1369	16416	28930	56.74%	38.14%	23	24
8	高雄市大社區	2018-11-24T23:00:13+08:00	10415	3851	14266	1329	15595	27074	57.6%	38.47%	22	24
8	高雄市大社區	2018-11-24T22:11:59+08:00	10415	3851	14266	1329	15595	27074	57.6%	38.47%	22	24
8	高雄市大社區	2018-11-24T22:21:41+08:00	10415	3851	14266	1329	15595	27074	57.6%	38.47%	22	24
8	高雄市大社區	2018-11-25T06:07:18+08:00	11407	4150	15557	1432	16989	30046	56.54%	37.97%	24	24
8	高雄市大社區	2018-11-25T04:01:24+08:00	11407	4150	15557	1432	16989	30046	56.54%	37.97%	24	24
8	高雄市大社區	2018-11-24T22:28:36+08:00	10415	3851	14266	1329	15595	27074	57.6%	38.47%	22	24
8	高雄市大社區	2018-11-24T22:35:41+08:00	10415	3851	14266	1329	15595	27074	57.6%	38.47%	22	24
8	高雄市大社區	2018-11-24T23:37:45+08:00	11035	4012	15047	1369	16416	28930	56.74%	38.14%	23	24
8	高雄市大社區	2018-11-24T23:41:58+08:00	11035	4012	15047	1369	16416	28930	56.74%	38.14%	23	24
8	高雄市大社區	2018-11-24T23:54:22+08:00	11035	4012	15047	1369	16416	28930	56.74%	38.14%	23	24
8	高雄市大社區	2018-11-25T01:16:17+08:00	11035	4012	15047	1369	16416	28930	56.74%	38.14%	23	24
8	高雄市新興區	2018-11-24T23:03:43+08:00	16899	6355	23254	1787	25041	41989	59.64%	40.25%	40	42
8	高雄市新興區	2018-11-24T23:58:37+08:00	17858	6745	24603	1859	26462	44355	59.66%	40.26%	42	42
8	高雄市新興區	2018-11-25T06:17:31+08:00	17858	6745	24603	1859	26462	44355	59.66%	40.26%	42	42
8	高雄市新興區	2018-11-24T23:22:18+08:00	17345	6519	23864	1818	25682	43038	59.67%	40.3%	41	42
8	高雄市新興區	2018-11-25T00:03:29+08:00	17858	6745	24603	1859	26462	44355	59.66%	40.26%	42	42
8	高雄市新興區	2018-11-24T23:14:35+08:00	17345	6519	23864	1818	25682	43038	59.67%	40.3%	41	42
8	高雄市新興區	2018-11-25T03:37:20+08:00	17858	6745	24603	1859	26462	44355	59.66%	40.26%	42	42
8	高雄市新興區	2018-11-25T00:56:09+08:00	17858	6745	24603	1859	26462	44355	59.66%	40.26%	42	42
8	高雄市新興區	2018-11-24T22:49:19+08:00	16899	6355	23254	1787	25041	41989	59.64%	40.25%	40	42
8	高雄市新興區	2018-11-25T03:42:43+08:00	17858	6745	24603	1859	26462	44355	59.66%	40.26%	42	42
8	高雄市新興區	2018-11-24T22:53:10+08:00	16899	6355	23254	1787	25041	41989	59.64%	40.25%	40	42
8	高雄市新興區	2018-11-25T00:08:00+08:00	17858	6745	24603	1859	26462	44355	59.66%	40.26%	42	42
8	高雄市新興區	2018-11-25T01:00:56+08:00	17858	6745	24603	1859	26462	44355	59.66%	40.26%	42	42
8	高雄市新興區	2018-11-24T22:25:19+08:00	16016	6020	22036	1731	23767	39653	59.94%	40.39%	38	42
8	高雄市新興區	2018-11-25T06:12:33+08:00	17858	6745	24603	1859	26462	44355	59.66%	40.26%	42	42
8	高雄市新興區	2018-11-25T00:17:03+08:00	17858	6745	24603	1859	26462	44355	59.66%	40.26%	42	42
8	高雄市新興區	2018-11-25T01:11:01+08:00	17858	6745	24603	1859	26462	44355	59.66%	40.26%	42	42
8	高雄市新興區	2018-11-25T06:22:41+08:00	17858	6745	24603	1859	26462	44355	59.66%	40.26%	42	42
8	高雄市新興區	2018-11-24T23:18:23+08:00	17345	6519	23864	1818	25682	43038	59.67%	40.3%	41	42
8	高雄市新興區	2018-11-24T23:50:10+08:00	17858	6745	24603	1859	26462	44355	59.66%	40.26%	42	42
8	高雄市新興區	2018-11-24T22:18:15+08:00	14515	5404	19919	1541	21460	35862	59.84%	40.47%	35	42
8	高雄市新興區	2018-11-24T22:28:35+08:00	16016	6020	22036	1731	23767	39653	59.94%	40.39%	38	42
8	高雄市新興區	2018-11-24T22:14:44+08:00	14515	5404	19919	1541	21460	35862	59.84%	40.47%	35	42
8	高雄市新興區	2018-11-25T01:05:54+08:00	17858	6745	24603	1859	26462	44355	59.66%	40.26%	42	42
8	高雄市新興區	2018-11-24T23:54:21+08:00	17858	6745	24603	1859	26462	44355	59.66%	40.26%	42	42
8	高雄市新興區	2018-11-24T23:33:46+08:00	17858	6745	24603	1859	26462	44355	59.66%	40.26%	42	42
8	高雄市新興區	2018-11-25T06:27:51+08:00	17858	6745	24603	1859	26462	44355	59.66%	40.26%	42	42
8	高雄市新興區	2018-11-24T23:26:03+08:00	17858	6745	24603	1859	26462	44355	59.66%	40.26%	42	42
8	高雄市新興區	2018-11-25T00:12:41+08:00	17858	6745	24603	1859	26462	44355	59.66%	40.26%	42	42
8	高雄市新興區	2018-11-24T22:56:32+08:00	16899	6355	23254	1787	25041	41989	59.64%	40.25%	40	42
8	高雄市新興區	2018-11-24T22:43:46+08:00	16899	6355	23254	1787	25041	41989	59.64%	40.25%	40	42
8	高雄市新興區	2018-11-25T01:24:19+08:00	17858	6745	24603	1859	26462	44355	59.66%	40.26%	42	42
8	高雄市新興區	2018-11-24T22:39:04+08:00	16424	6206	22630	1768	24398	40888	59.67%	40.17%	39	42
8	高雄市新興區	2018-11-24T23:10:52+08:00	17345	6519	23864	1818	25682	43038	59.67%	40.3%	41	42
8	高雄市新興區	2018-11-24T23:07:14+08:00	16899	6355	23254	1787	25041	41989	59.64%	40.25%	40	42
8	高雄市新興區	2018-11-25T00:21:39+08:00	17858	6745	24603	1859	26462	44355	59.66%	40.26%	42	42
8	高雄市新興區	2018-11-24T22:32:14+08:00	16424	6206	22630	1768	24398	40888	59.67%	40.17%	39	42
8	高雄市新興區	2018-11-25T03:30:54+08:00	17858	6745	24603	1859	26462	44355	59.66%	40.26%	42	42
8	高雄市新興區	2018-11-25T03:48:24+08:00	17858	6745	24603	1859	26462	44355	59.66%	40.26%	42	42
8	高雄市新興區	2018-11-24T22:40:15+08:00	16899	6355	23254	1787	25041	41989	59.64%	40.25%	40	42
8	高雄市新興區	2018-11-24T23:29:42+08:00	17858	6745	24603	1859	26462	44355	59.66%	40.26%	42	42
8	高雄市新興區	2018-11-24T23:00:13+08:00	16899	6355	23254	1787	25041	41989	59.64%	40.25%	40	42
8	高雄市新興區	2018-11-24T22:21:41+08:00	16016	6020	22036	1731	23767	39653	59.94%	40.39%	38	42
8	高雄市新興區	2018-11-25T06:07:18+08:00	17858	6745	24603	1859	26462	44355	59.66%	40.26%	42	42
8	高雄市新興區	2018-11-24T22:11:58+08:00	14515	5404	19919	1541	21460	35862	59.84%	40.47%	35	42
8	高雄市新興區	2018-11-25T04:01:24+08:00	17858	6745	24603	1859	26462	44355	59.66%	40.26%	42	42
8	高雄市新興區	2018-11-24T23:41:57+08:00	17858	6745	24603	1859	26462	44355	59.66%	40.26%	42	42
8	高雄市新興區	2018-11-24T23:37:45+08:00	17858	6745	24603	1859	26462	44355	59.66%	40.26%	42	42
8	高雄市新興區	2018-11-24T22:35:40+08:00	16424	6206	22630	1768	24398	40888	59.67%	40.17%	39	42
8	高雄市新興區	2018-11-25T03:54:35+08:00	17858	6745	24603	1859	26462	44355	59.66%	40.26%	42	42
8	高雄市新興區	2018-11-24T23:45:59+08:00	17858	6745	24603	1859	26462	44355	59.66%	40.26%	42	42
8	高雄市新興區	2018-11-25T01:16:17+08:00	17858	6745	24603	1859	26462	44355	59.66%	40.26%	42	42
8	澎湖縣七美鄉	2018-11-24T23:26:10+08:00	667	211	878	114	992	3374	29.4%	19.77%	6	6
8	澎湖縣七美鄉	2018-11-24T23:10:59+08:00	667	211	878	114	992	3374	29.4%	19.77%	6	6
8	澎湖縣七美鄉	2018-11-24T22:49:27+08:00	667	211	878	114	992	3374	29.4%	19.77%	6	6
8	澎湖縣七美鄉	2018-11-24T23:33:53+08:00	667	211	878	114	992	3374	29.4%	19.77%	6	6
8	澎湖縣七美鄉	2018-11-24T22:12:06+08:00	446	147	593	84	677	2203	30.73%	20.25%	5	6
8	澎湖縣七美鄉	2018-11-24T22:56:39+08:00	667	211	878	114	992	3374	29.4%	19.77%	6	6
8	澎湖縣七美鄉	2018-11-24T23:22:26+08:00	667	211	878	114	992	3374	29.4%	19.77%	6	6
8	澎湖縣七美鄉	2018-11-24T22:28:43+08:00	446	147	593	84	677	2203	30.73%	20.25%	5	6
8	澎湖縣七美鄉	2018-11-24T23:18:30+08:00	667	211	878	114	992	3374	29.4%	19.77%	6	6
8	澎湖縣七美鄉	2018-11-25T00:17:11+08:00	667	211	878	114	992	3374	29.4%	19.77%	6	6
8	澎湖縣七美鄉	2018-11-24T22:32:21+08:00	446	147	593	84	677	2203	30.73%	20.25%	5	6
8	澎湖縣七美鄉	2018-11-24T23:46:06+08:00	667	211	878	114	992	3374	29.4%	19.77%	6	6
8	澎湖縣七美鄉	2018-11-24T22:53:18+08:00	667	211	878	114	992	3374	29.4%	19.77%	6	6
8	澎湖縣七美鄉	2018-11-25T00:08:08+08:00	667	211	878	114	992	3374	29.4%	19.77%	6	6
8	澎湖縣七美鄉	2018-11-25T04:01:32+08:00	667	211	878	114	992	3374	29.4%	19.77%	6	6
8	澎湖縣七美鄉	2018-11-25T03:48:34+08:00	667	211	878	114	992	3374	29.4%	19.77%	6	6
8	澎湖縣七美鄉	2018-11-24T22:25:28+08:00	446	147	593	84	677	2203	30.73%	20.25%	5	6
8	澎湖縣七美鄉	2018-11-24T23:00:20+08:00	667	211	878	114	992	3374	29.4%	19.77%	6	6
8	澎湖縣七美鄉	2018-11-25T06:22:48+08:00	667	211	878	114	992	3374	29.4%	19.77%	6	6
8	澎湖縣七美鄉	2018-11-24T22:40:21+08:00	667	211	878	114	992	3374	29.4%	19.77%	6	6
8	澎湖縣七美鄉	2018-11-24T23:14:44+08:00	667	211	878	114	992	3374	29.4%	19.77%	6	6
8	澎湖縣七美鄉	2018-11-25T03:37:33+08:00	667	211	878	114	992	3374	29.4%	19.77%	6	6
8	澎湖縣七美鄉	2018-11-24T22:18:23+08:00	446	147	593	84	677	2203	30.73%	20.25%	5	6
8	澎湖縣七美鄉	2018-11-24T23:50:18+08:00	667	211	878	114	992	3374	29.4%	19.77%	6	6
8	澎湖縣七美鄉	2018-11-24T23:58:46+08:00	667	211	878	114	992	3374	29.4%	19.77%	6	6
8	澎湖縣七美鄉	2018-11-25T00:12:48+08:00	667	211	878	114	992	3374	29.4%	19.77%	6	6
8	澎湖縣七美鄉	2018-11-24T23:03:50+08:00	667	211	878	114	992	3374	29.4%	19.77%	6	6
8	澎湖縣七美鄉	2018-11-24T22:39:12+08:00	667	211	878	114	992	3374	29.4%	19.77%	6	6
8	澎湖縣七美鄉	2018-11-25T06:27:58+08:00	667	211	878	114	992	3374	29.4%	19.77%	6	6
8	澎湖縣七美鄉	2018-11-25T06:17:40+08:00	667	211	878	114	992	3374	29.4%	19.77%	6	6
8	澎湖縣七美鄉	2018-11-24T22:14:52+08:00	446	147	593	84	677	2203	30.73%	20.25%	5	6
8	澎湖縣七美鄉	2018-11-25T01:24:28+08:00	667	211	878	114	992	3374	29.4%	19.77%	6	6
8	澎湖縣七美鄉	2018-11-25T03:54:45+08:00	667	211	878	114	992	3374	29.4%	19.77%	6	6
8	澎湖縣七美鄉	2018-11-24T23:37:51+08:00	667	211	878	114	992	3374	29.4%	19.77%	6	6
8	澎湖縣七美鄉	2018-11-24T23:07:22+08:00	667	211	878	114	992	3374	29.4%	19.77%	6	6
8	澎湖縣七美鄉	2018-11-24T23:54:30+08:00	667	211	878	114	992	3374	29.4%	19.77%	6	6
8	澎湖縣七美鄉	2018-11-25T06:12:40+08:00	667	211	878	114	992	3374	29.4%	19.77%	6	6
8	澎湖縣七美鄉	2018-11-24T23:29:50+08:00	667	211	878	114	992	3374	29.4%	19.77%	6	6
8	澎湖縣七美鄉	2018-11-24T23:42:05+08:00	667	211	878	114	992	3374	29.4%	19.77%	6	6
8	澎湖縣七美鄉	2018-11-25T01:06:03+08:00	667	211	878	114	992	3374	29.4%	19.77%	6	6
8	澎湖縣七美鄉	2018-11-25T01:11:11+08:00	667	211	878	114	992	3374	29.4%	19.77%	6	6
8	澎湖縣七美鄉	2018-11-25T00:21:47+08:00	667	211	878	114	992	3374	29.4%	19.77%	6	6
8	澎湖縣七美鄉	2018-11-25T03:42:52+08:00	667	211	878	114	992	3374	29.4%	19.77%	6	6
8	澎湖縣七美鄉	2018-11-25T06:07:26+08:00	667	211	878	114	992	3374	29.4%	19.77%	6	6
8	澎湖縣七美鄉	2018-11-24T22:21:49+08:00	446	147	593	84	677	2203	30.73%	20.25%	5	6
8	澎湖縣七美鄉	2018-11-25T00:56:17+08:00	667	211	878	114	992	3374	29.4%	19.77%	6	6
8	澎湖縣七美鄉	2018-11-24T22:43:54+08:00	667	211	878	114	992	3374	29.4%	19.77%	6	6
8	澎湖縣七美鄉	2018-11-25T03:31:03+08:00	667	211	878	114	992	3374	29.4%	19.77%	6	6
8	澎湖縣七美鄉	2018-11-24T22:35:47+08:00	446	147	593	84	677	2203	30.73%	20.25%	5	6
8	澎湖縣七美鄉	2018-11-25T01:01:05+08:00	667	211	878	114	992	3374	29.4%	19.77%	6	6
8	澎湖縣七美鄉	2018-11-25T01:16:26+08:00	667	211	878	114	992	3374	29.4%	19.77%	6	6
8	澎湖縣七美鄉	2018-11-25T00:03:39+08:00	667	211	878	114	992	3374	29.4%	19.77%	6	6
8	高雄市旗山區	2018-11-24T22:49:20+08:00	11993	3911	15904	1580	17484	31996	54.64%	37.48%	35	35
8	高雄市旗山區	2018-11-24T23:03:44+08:00	11993	3911	15904	1580	17484	31996	54.64%	37.48%	35	35
8	高雄市旗山區	2018-11-24T23:58:38+08:00	11993	3911	15904	1580	17484	31996	54.64%	37.48%	35	35
8	高雄市旗山區	2018-11-24T23:22:19+08:00	11993	3911	15904	1580	17484	31996	54.64%	37.48%	35	35
8	高雄市旗山區	2018-11-25T03:42:44+08:00	11993	3911	15904	1580	17484	31996	54.64%	37.48%	35	35
8	高雄市旗山區	2018-11-25T01:00:57+08:00	11993	3911	15904	1580	17484	31996	54.64%	37.48%	35	35
8	高雄市旗山區	2018-11-24T22:53:11+08:00	11993	3911	15904	1580	17484	31996	54.64%	37.48%	35	35
8	高雄市旗山區	2018-11-24T23:46:00+08:00	11993	3911	15904	1580	17484	31996	54.64%	37.48%	35	35
8	高雄市旗山區	2018-11-25T00:08:01+08:00	11993	3911	15904	1580	17484	31996	54.64%	37.48%	35	35
8	高雄市旗山區	2018-11-24T22:21:42+08:00	11485	3735	15220	1520	16740	30667	54.59%	37.45%	34	35
8	高雄市旗山區	2018-11-25T06:12:33+08:00	11993	3911	15904	1580	17484	31996	54.64%	37.48%	35	35
8	高雄市旗山區	2018-11-25T00:17:04+08:00	11993	3911	15904	1580	17484	31996	54.64%	37.48%	35	35
8	高雄市旗山區	2018-11-24T22:25:20+08:00	11485	3735	15220	1520	16740	30667	54.59%	37.45%	34	35
8	高雄市旗山區	2018-11-24T23:18:24+08:00	11993	3911	15904	1580	17484	31996	54.64%	37.48%	35	35
8	高雄市旗山區	2018-11-25T01:05:55+08:00	11993	3911	15904	1580	17484	31996	54.64%	37.48%	35	35
8	高雄市旗山區	2018-11-24T23:50:11+08:00	11993	3911	15904	1580	17484	31996	54.64%	37.48%	35	35
8	高雄市旗山區	2018-11-24T22:14:45+08:00	11231	3636	14867	1500	16367	29779	54.96%	37.71%	33	35
8	高雄市旗山區	2018-11-24T23:33:46+08:00	11993	3911	15904	1580	17484	31996	54.64%	37.48%	35	35
8	高雄市旗山區	2018-11-25T06:27:51+08:00	11993	3911	15904	1580	17484	31996	54.64%	37.48%	35	35
8	高雄市旗山區	2018-11-24T23:26:03+08:00	11993	3911	15904	1580	17484	31996	54.64%	37.48%	35	35
8	高雄市旗山區	2018-11-25T03:54:36+08:00	11993	3911	15904	1580	17484	31996	54.64%	37.48%	35	35
8	高雄市旗山區	2018-11-25T00:12:41+08:00	11993	3911	15904	1580	17484	31996	54.64%	37.48%	35	35
8	高雄市旗山區	2018-11-25T01:24:20+08:00	11993	3911	15904	1580	17484	31996	54.64%	37.48%	35	35
8	高雄市旗山區	2018-11-24T22:43:46+08:00	11993	3911	15904	1580	17484	31996	54.64%	37.48%	35	35
8	高雄市旗山區	2018-11-25T06:17:32+08:00	11993	3911	15904	1580	17484	31996	54.64%	37.48%	35	35
8	高雄市旗山區	2018-11-25T03:37:22+08:00	11993	3911	15904	1580	17484	31996	54.64%	37.48%	35	35
8	高雄市旗山區	2018-11-24T23:07:15+08:00	11993	3911	15904	1580	17484	31996	54.64%	37.48%	35	35
8	高雄市旗山區	2018-11-24T22:39:05+08:00	11993	3911	15904	1580	17484	31996	54.64%	37.48%	35	35
8	高雄市旗山區	2018-11-24T23:10:53+08:00	11993	3911	15904	1580	17484	31996	54.64%	37.48%	35	35
8	高雄市旗山區	2018-11-24T22:56:33+08:00	11993	3911	15904	1580	17484	31996	54.64%	37.48%	35	35
8	高雄市旗山區	2018-11-24T23:14:36+08:00	11993	3911	15904	1580	17484	31996	54.64%	37.48%	35	35
8	高雄市旗山區	2018-11-25T03:48:25+08:00	11993	3911	15904	1580	17484	31996	54.64%	37.48%	35	35
8	高雄市旗山區	2018-11-24T22:32:14+08:00	11993	3911	15904	1580	17484	31996	54.64%	37.48%	35	35
8	高雄市旗山區	2018-11-25T03:30:55+08:00	11993	3911	15904	1580	17484	31996	54.64%	37.48%	35	35
8	高雄市旗山區	2018-11-24T22:40:15+08:00	11993	3911	15904	1580	17484	31996	54.64%	37.48%	35	35
8	高雄市旗山區	2018-11-25T01:11:02+08:00	11993	3911	15904	1580	17484	31996	54.64%	37.48%	35	35
8	高雄市旗山區	2018-11-25T04:01:25+08:00	11993	3911	15904	1580	17484	31996	54.64%	37.48%	35	35
8	高雄市旗山區	2018-11-24T22:11:59+08:00	11231	3636	14867	1500	16367	29779	54.96%	37.71%	33	35
8	高雄市旗山區	2018-11-24T23:00:14+08:00	11993	3911	15904	1580	17484	31996	54.64%	37.48%	35	35
8	高雄市旗山區	2018-11-25T06:07:19+08:00	11993	3911	15904	1580	17484	31996	54.64%	37.48%	35	35
8	高雄市旗山區	2018-11-24T23:29:43+08:00	11993	3911	15904	1580	17484	31996	54.64%	37.48%	35	35
8	高雄市旗山區	2018-11-25T00:21:41+08:00	11993	3911	15904	1580	17484	31996	54.64%	37.48%	35	35
8	高雄市旗山區	2018-11-25T06:22:42+08:00	11993	3911	15904	1580	17484	31996	54.64%	37.48%	35	35
8	高雄市旗山區	2018-11-24T22:28:36+08:00	11993	3911	15904	1580	17484	31996	54.64%	37.48%	35	35
8	高雄市旗山區	2018-11-25T00:56:10+08:00	11993	3911	15904	1580	17484	31996	54.64%	37.48%	35	35
8	高雄市旗山區	2018-11-24T22:18:16+08:00	11231	3636	14867	1500	16367	29779	54.96%	37.71%	33	35
8	高雄市旗山區	2018-11-24T23:54:24+08:00	11993	3911	15904	1580	17484	31996	54.64%	37.48%	35	35
8	高雄市旗山區	2018-11-24T22:35:41+08:00	11993	3911	15904	1580	17484	31996	54.64%	37.48%	35	35
8	高雄市旗山區	2018-11-25T01:16:18+08:00	11993	3911	15904	1580	17484	31996	54.64%	37.48%	35	35
8	高雄市旗山區	2018-11-24T23:37:45+08:00	11993	3911	15904	1580	17484	31996	54.64%	37.48%	35	35
8	高雄市旗山區	2018-11-24T23:41:58+08:00	11993	3911	15904	1580	17484	31996	54.64%	37.48%	35	35
8	高雄市旗山區	2018-11-25T00:03:30+08:00	11993	3911	15904	1580	17484	31996	54.64%	37.48%	35	35
8	高雄市橋頭區	2018-11-24T22:49:20+08:00	12959	4449	17408	1836	19244	31474	61.14%	41.17%	30	31
8	高雄市橋頭區	2018-11-25T03:37:21+08:00	13387	4597	17984	1877	19861	32565	60.99%	41.11%	31	31
8	高雄市橋頭區	2018-11-24T23:03:44+08:00	12959	4449	17408	1836	19244	31474	61.14%	41.17%	30	31
8	高雄市橋頭區	2018-11-24T23:58:37+08:00	13387	4597	17984	1877	19861	32565	60.99%	41.11%	31	31
8	高雄市橋頭區	2018-11-25T00:03:29+08:00	13387	4597	17984	1877	19861	32565	60.99%	41.11%	31	31
8	高雄市橋頭區	2018-11-25T00:56:09+08:00	13387	4597	17984	1877	19861	32565	60.99%	41.11%	31	31
8	高雄市橋頭區	2018-11-24T23:22:19+08:00	12959	4449	17408	1836	19244	31474	61.14%	41.17%	30	31
8	高雄市橋頭區	2018-11-25T03:42:44+08:00	13387	4597	17984	1877	19861	32565	60.99%	41.11%	31	31
8	高雄市橋頭區	2018-11-25T03:42:43+08:00	13387	4597	17984	1877	19861	32565	60.99%	41.11%	31	31
8	高雄市橋頭區	2018-11-24T22:53:10+08:00	12959	4449	17408	1836	19244	31474	61.14%	41.17%	30	31
8	高雄市橋頭區	2018-11-25T00:08:00+08:00	13387	4597	17984	1877	19861	32565	60.99%	41.11%	31	31
8	高雄市橋頭區	2018-11-24T23:46:00+08:00	12959	4449	17408	1836	19244	31474	61.14%	41.17%	30	31
8	高雄市橋頭區	2018-11-25T01:00:56+08:00	13387	4597	17984	1877	19861	32565	60.99%	41.11%	31	31
8	高雄市橋頭區	2018-11-25T06:12:33+08:00	13387	4597	17984	1877	19861	32565	60.99%	41.11%	31	31
8	高雄市橋頭區	2018-11-25T00:17:04+08:00	13387	4597	17984	1877	19861	32565	60.99%	41.11%	31	31
8	高雄市橋頭區	2018-11-25T06:22:41+08:00	13387	4597	17984	1877	19861	32565	60.99%	41.11%	31	31
8	高雄市橋頭區	2018-11-24T22:25:20+08:00	11818	4120	15938	1714	17652	28964	60.94%	40.8%	28	31
8	高雄市橋頭區	2018-11-24T23:18:23+08:00	12959	4449	17408	1836	19244	31474	61.14%	41.17%	30	31
8	高雄市橋頭區	2018-11-24T22:18:15+08:00	11352	3913	15265	1606	16871	27709	60.89%	40.97%	27	31
8	高雄市橋頭區	2018-11-24T22:14:44+08:00	11352	3913	15265	1606	16871	27709	60.89%	40.97%	27	31
8	高雄市橋頭區	2018-11-24T23:50:11+08:00	12959	4449	17408	1836	19244	31474	61.14%	41.17%	30	31
8	高雄市橋頭區	2018-11-25T01:05:54+08:00	13387	4597	17984	1877	19861	32565	60.99%	41.11%	31	31
8	高雄市橋頭區	2018-11-24T23:33:46+08:00	12959	4449	17408	1836	19244	31474	61.14%	41.17%	30	31
8	高雄市橋頭區	2018-11-25T06:27:51+08:00	13387	4597	17984	1877	19861	32565	60.99%	41.11%	31	31
8	高雄市橋頭區	2018-11-24T23:26:03+08:00	12959	4449	17408	1836	19244	31474	61.14%	41.17%	30	31
8	高雄市橋頭區	2018-11-25T03:54:36+08:00	13387	4597	17984	1877	19861	32565	60.99%	41.11%	31	31
8	高雄市橋頭區	2018-11-25T00:12:41+08:00	13387	4597	17984	1877	19861	32565	60.99%	41.11%	31	31
8	高雄市橋頭區	2018-11-25T01:24:20+08:00	13387	4597	17984	1877	19861	32565	60.99%	41.11%	31	31
8	高雄市橋頭區	2018-11-24T22:43:46+08:00	12341	4293	16634	1799	18433	30208	61.02%	40.85%	29	31
8	高雄市橋頭區	2018-11-25T06:17:32+08:00	13387	4597	17984	1877	19861	32565	60.99%	41.11%	31	31
8	高雄市橋頭區	2018-11-24T23:07:15+08:00	12959	4449	17408	1836	19244	31474	61.14%	41.17%	30	31
8	高雄市橋頭區	2018-11-24T22:39:05+08:00	12341	4293	16634	1799	18433	30208	61.02%	40.85%	29	31
8	高雄市橋頭區	2018-11-24T22:56:33+08:00	12959	4449	17408	1836	19244	31474	61.14%	41.17%	30	31
8	高雄市橋頭區	2018-11-24T23:14:36+08:00	12959	4449	17408	1836	19244	31474	61.14%	41.17%	30	31
8	高雄市橋頭區	2018-11-24T23:10:52+08:00	12959	4449	17408	1836	19244	31474	61.14%	41.17%	30	31
8	高雄市橋頭區	2018-11-25T03:48:25+08:00	13387	4597	17984	1877	19861	32565	60.99%	41.11%	31	31
8	高雄市橋頭區	2018-11-24T22:32:14+08:00	11818	4120	15938	1714	17652	28964	60.94%	40.8%	28	31
8	高雄市橋頭區	2018-11-25T03:30:54+08:00	13387	4597	17984	1877	19861	32565	60.99%	41.11%	31	31
8	高雄市橋頭區	2018-11-24T22:40:15+08:00	12341	4293	16634	1799	18433	30208	61.02%	40.85%	29	31
8	高雄市橋頭區	2018-11-25T00:21:40+08:00	13387	4597	17984	1877	19861	32565	60.99%	41.11%	31	31
8	高雄市橋頭區	2018-11-24T23:29:42+08:00	12959	4449	17408	1836	19244	31474	61.14%	41.17%	30	31
8	高雄市橋頭區	2018-11-25T01:11:02+08:00	13387	4597	17984	1877	19861	32565	60.99%	41.11%	31	31
8	高雄市橋頭區	2018-11-24T23:00:13+08:00	12959	4449	17408	1836	19244	31474	61.14%	41.17%	30	31
8	高雄市橋頭區	2018-11-24T22:11:59+08:00	11352	3913	15265	1606	16871	27709	60.89%	40.97%	27	31
8	高雄市橋頭區	2018-11-24T22:21:41+08:00	11818	4120	15938	1714	17652	28964	60.94%	40.8%	28	31
8	高雄市橋頭區	2018-11-25T06:07:18+08:00	13387	4597	17984	1877	19861	32565	60.99%	41.11%	31	31
8	高雄市橋頭區	2018-11-25T04:01:24+08:00	13387	4597	17984	1877	19861	32565	60.99%	41.11%	31	31
8	高雄市橋頭區	2018-11-24T22:28:36+08:00	11818	4120	15938	1714	17652	28964	60.94%	40.8%	28	31
8	高雄市橋頭區	2018-11-24T22:35:41+08:00	12341	4293	16634	1799	18433	30208	61.02%	40.85%	29	31
8	高雄市橋頭區	2018-11-24T23:37:45+08:00	12959	4449	17408	1836	19244	31474	61.14%	41.17%	30	31
8	高雄市橋頭區	2018-11-24T23:41:58+08:00	12959	4449	17408	1836	19244	31474	61.14%	41.17%	30	31
8	高雄市橋頭區	2018-11-24T23:54:22+08:00	12959	4449	17408	1836	19244	31474	61.14%	41.17%	30	31
8	高雄市橋頭區	2018-11-25T01:16:17+08:00	13387	4597	17984	1877	19861	32565	60.99%	41.11%	31	31
8	嘉義縣梅山鄉	2018-11-24T23:07:18+08:00	6169	2019	8188	1035	9223	17083	53.99%	36.11%	22	22
8	嘉義縣梅山鄉	2018-11-24T22:56:36+08:00	6169	2019	8188	1035	9223	17083	53.99%	36.11%	22	22
8	嘉義縣梅山鄉	2018-11-25T06:17:36+08:00	6169	2019	8188	1035	9223	17083	53.99%	36.11%	22	22
8	嘉義縣梅山鄉	2018-11-24T23:10:56+08:00	6169	2019	8188	1035	9223	17083	53.99%	36.11%	22	22
8	嘉義縣梅山鄉	2018-11-25T03:37:29+08:00	6169	2019	8188	1035	9223	17083	53.99%	36.11%	22	22
8	嘉義縣梅山鄉	2018-11-24T22:39:09+08:00	5956	1983	7939	981	8920	16650	53.57%	35.77%	21	22
8	嘉義縣梅山鄉	2018-11-25T01:24:25+08:00	6169	2019	8188	1035	9223	17083	53.99%	36.11%	22	22
8	嘉義縣梅山鄉	2018-11-25T03:54:41+08:00	6169	2019	8188	1035	9223	17083	53.99%	36.11%	22	22
8	嘉義縣梅山鄉	2018-11-25T03:30:59+08:00	6169	2019	8188	1035	9223	17083	53.99%	36.11%	22	22
8	嘉義縣梅山鄉	2018-11-24T22:32:18+08:00	5293	1770	7063	910	7973	14823	53.79%	35.71%	20	22
8	嘉義縣梅山鄉	2018-11-24T23:00:17+08:00	6169	2019	8188	1035	9223	17083	53.99%	36.11%	22	22
8	嘉義縣梅山鄉	2018-11-25T00:21:44+08:00	6169	2019	8188	1035	9223	17083	53.99%	36.11%	22	22
8	嘉義縣梅山鄉	2018-11-24T23:29:46+08:00	6169	2019	8188	1035	9223	17083	53.99%	36.11%	22	22
8	嘉義縣梅山鄉	2018-11-25T06:07:23+08:00	6169	2019	8188	1035	9223	17083	53.99%	36.11%	22	22
8	嘉義縣梅山鄉	2018-11-25T04:01:29+08:00	6169	2019	8188	1035	9223	17083	53.99%	36.11%	22	22
8	嘉義縣梅山鄉	2018-11-25T01:11:07+08:00	6169	2019	8188	1035	9223	17083	53.99%	36.11%	22	22
8	嘉義縣梅山鄉	2018-11-24T22:40:19+08:00	6169	2019	8188	1035	9223	17083	53.99%	36.11%	22	22
8	嘉義縣梅山鄉	2018-11-24T22:43:50+08:00	6169	2019	8188	1035	9223	17083	53.99%	36.11%	22	22
8	嘉義縣梅山鄉	2018-11-25T00:56:13+08:00	6169	2019	8188	1035	9223	17083	53.99%	36.11%	22	22
8	嘉義縣梅山鄉	2018-11-24T23:54:27+08:00	6169	2019	8188	1035	9223	17083	53.99%	36.11%	22	22
8	嘉義縣梅山鄉	2018-11-24T22:35:45+08:00	5956	1983	7939	981	8920	16650	53.57%	35.77%	21	22
8	嘉義縣梅山鄉	2018-11-25T01:16:22+08:00	6169	2019	8188	1035	9223	17083	53.99%	36.11%	22	22
8	嘉義縣梅山鄉	2018-11-25T00:03:34+08:00	6169	2019	8188	1035	9223	17083	53.99%	36.11%	22	22
8	嘉義縣梅山鄉	2018-11-24T23:37:49+08:00	6169	2019	8188	1035	9223	17083	53.99%	36.11%	22	22
8	嘉義縣梅山鄉	2018-11-25T01:01:01+08:00	6169	2019	8188	1035	9223	17083	53.99%	36.11%	22	22
8	嘉義縣梅山鄉	2018-11-24T23:22:23+08:00	6169	2019	8188	1035	9223	17083	53.99%	36.11%	22	22
8	嘉義縣梅山鄉	2018-11-24T22:49:24+08:00	6169	2019	8188	1035	9223	17083	53.99%	36.11%	22	22
8	嘉義縣梅山鄉	2018-11-24T23:03:47+08:00	6169	2019	8188	1035	9223	17083	53.99%	36.11%	22	22
8	嘉義縣梅山鄉	2018-11-24T22:28:40+08:00	5293	1770	7063	910	7973	14823	53.79%	35.71%	20	22
8	嘉義縣梅山鄉	2018-11-24T23:33:50+08:00	6169	2019	8188	1035	9223	17083	53.99%	36.11%	22	22
8	嘉義縣梅山鄉	2018-11-24T22:12:02+08:00	3813	1317	5130	654	5784	10898	53.07%	34.99%	16	22
8	嘉義縣梅山鄉	2018-11-24T23:42:02+08:00	6169	2019	8188	1035	9223	17083	53.99%	36.11%	22	22
8	嘉義縣梅山鄉	2018-11-25T00:08:05+08:00	6169	2019	8188	1035	9223	17083	53.99%	36.11%	22	22
8	嘉義縣梅山鄉	2018-11-25T03:42:48+08:00	6169	2019	8188	1035	9223	17083	53.99%	36.11%	22	22
8	嘉義縣梅山鄉	2018-11-24T22:53:15+08:00	6169	2019	8188	1035	9223	17083	53.99%	36.11%	22	22
8	嘉義縣梅山鄉	2018-11-24T23:46:03+08:00	6169	2019	8188	1035	9223	17083	53.99%	36.11%	22	22
8	嘉義縣梅山鄉	2018-11-25T06:12:37+08:00	6169	2019	8188	1035	9223	17083	53.99%	36.11%	22	22
8	嘉義縣梅山鄉	2018-11-25T03:48:30+08:00	6169	2019	8188	1035	9223	17083	53.99%	36.11%	22	22
8	嘉義縣梅山鄉	2018-11-24T22:21:46+08:00	4861	1640	6501	847	7348	13634	53.89%	35.65%	19	22
8	嘉義縣梅山鄉	2018-11-24T22:25:25+08:00	5293	1770	7063	910	7973	14823	53.79%	35.71%	20	22
8	嘉義縣梅山鄉	2018-11-25T00:17:08+08:00	6169	2019	8188	1035	9223	17083	53.99%	36.11%	22	22
8	嘉義縣梅山鄉	2018-11-25T06:22:45+08:00	6169	2019	8188	1035	9223	17083	53.99%	36.11%	22	22
8	嘉義縣梅山鄉	2018-11-24T22:14:49+08:00	4105	1399	5504	727	6231	11610	53.67%	35.36%	17	22
8	嘉義縣梅山鄉	2018-11-24T22:18:20+08:00	4320	1480	5800	766	6566	12246	53.62%	35.28%	18	22
8	嘉義縣梅山鄉	2018-11-24T23:18:27+08:00	6169	2019	8188	1035	9223	17083	53.99%	36.11%	22	22
8	嘉義縣梅山鄉	2018-11-24T23:58:42+08:00	6169	2019	8188	1035	9223	17083	53.99%	36.11%	22	22
8	嘉義縣梅山鄉	2018-11-25T06:27:55+08:00	6169	2019	8188	1035	9223	17083	53.99%	36.11%	22	22
8	嘉義縣梅山鄉	2018-11-24T23:26:07+08:00	6169	2019	8188	1035	9223	17083	53.99%	36.11%	22	22
8	嘉義縣梅山鄉	2018-11-25T00:12:45+08:00	6169	2019	8188	1035	9223	17083	53.99%	36.11%	22	22
8	嘉義縣梅山鄉	2018-11-25T01:05:59+08:00	6169	2019	8188	1035	9223	17083	53.99%	36.11%	22	22
8	嘉義縣梅山鄉	2018-11-24T23:14:41+08:00	6169	2019	8188	1035	9223	17083	53.99%	36.11%	22	22
8	嘉義縣梅山鄉	2018-11-24T23:50:15+08:00	6169	2019	8188	1035	9223	17083	53.99%	36.11%	22	22
8	金門縣金沙鎮	2018-11-24T23:26:10+08:00	5095	960	6055	505	6560	18560	35.34%	27.45%	13	13
8	金門縣金沙鎮	2018-11-24T23:10:59+08:00	5095	960	6055	505	6560	18560	35.34%	27.45%	13	13
8	金門縣金沙鎮	2018-11-24T22:49:27+08:00	5095	960	6055	505	6560	18560	35.34%	27.45%	13	13
8	金門縣金沙鎮	2018-11-24T23:33:53+08:00	5095	960	6055	505	6560	18560	35.34%	27.45%	13	13
8	金門縣金沙鎮	2018-11-24T22:12:06+08:00	4093	782	4875	400	5275	15033	35.09%	27.23%	11	13
8	金門縣金沙鎮	2018-11-24T22:56:39+08:00	5095	960	6055	505	6560	18560	35.34%	27.45%	13	13
8	金門縣金沙鎮	2018-11-24T23:22:26+08:00	5095	960	6055	505	6560	18560	35.34%	27.45%	13	13
8	金門縣金沙鎮	2018-11-24T22:28:43+08:00	4093	782	4875	400	5275	15033	35.09%	27.23%	11	13
8	金門縣金沙鎮	2018-11-24T23:18:30+08:00	5095	960	6055	505	6560	18560	35.34%	27.45%	13	13
8	金門縣金沙鎮	2018-11-24T23:37:52+08:00	5095	960	6055	505	6560	18560	35.34%	27.45%	13	13
8	金門縣金沙鎮	2018-11-25T00:17:11+08:00	5095	960	6055	505	6560	18560	35.34%	27.45%	13	13
8	金門縣金沙鎮	2018-11-24T22:32:21+08:00	4093	782	4875	400	5275	15033	35.09%	27.23%	11	13
8	金門縣金沙鎮	2018-11-24T22:21:50+08:00	4093	782	4875	400	5275	15033	35.09%	27.23%	11	13
8	金門縣金沙鎮	2018-11-24T23:46:07+08:00	5095	960	6055	505	6560	18560	35.34%	27.45%	13	13
8	金門縣金沙鎮	2018-11-24T22:53:18+08:00	5095	960	6055	505	6560	18560	35.34%	27.45%	13	13
8	金門縣金沙鎮	2018-11-25T00:08:08+08:00	5095	960	6055	505	6560	18560	35.34%	27.45%	13	13
8	金門縣金沙鎮	2018-11-25T04:01:32+08:00	5095	960	6055	505	6560	18560	35.34%	27.45%	13	13
8	金門縣金沙鎮	2018-11-24T22:25:28+08:00	4093	782	4875	400	5275	15033	35.09%	27.23%	11	13
8	金門縣金沙鎮	2018-11-24T23:00:20+08:00	5095	960	6055	505	6560	18560	35.34%	27.45%	13	13
8	金門縣金沙鎮	2018-11-25T06:22:48+08:00	5095	960	6055	505	6560	18560	35.34%	27.45%	13	13
8	金門縣金沙鎮	2018-11-25T03:48:35+08:00	5095	960	6055	505	6560	18560	35.34%	27.45%	13	13
8	金門縣金沙鎮	2018-11-24T23:14:44+08:00	5095	960	6055	505	6560	18560	35.34%	27.45%	13	13
8	金門縣金沙鎮	2018-11-25T03:37:33+08:00	5095	960	6055	505	6560	18560	35.34%	27.45%	13	13
8	金門縣金沙鎮	2018-11-24T22:18:23+08:00	4093	782	4875	400	5275	15033	35.09%	27.23%	11	13
8	金門縣金沙鎮	2018-11-24T23:50:18+08:00	5095	960	6055	505	6560	18560	35.34%	27.45%	13	13
8	金門縣金沙鎮	2018-11-24T23:58:46+08:00	5095	960	6055	505	6560	18560	35.34%	27.45%	13	13
8	金門縣金沙鎮	2018-11-25T00:12:48+08:00	5095	960	6055	505	6560	18560	35.34%	27.45%	13	13
8	金門縣金沙鎮	2018-11-24T23:03:50+08:00	5095	960	6055	505	6560	18560	35.34%	27.45%	13	13
8	金門縣金沙鎮	2018-11-24T22:39:12+08:00	4093	782	4875	400	5275	15033	35.09%	27.23%	11	13
8	金門縣金沙鎮	2018-11-25T06:27:58+08:00	5095	960	6055	505	6560	18560	35.34%	27.45%	13	13
8	金門縣金沙鎮	2018-11-25T06:17:40+08:00	5095	960	6055	505	6560	18560	35.34%	27.45%	13	13
8	金門縣金沙鎮	2018-11-24T22:14:52+08:00	4093	782	4875	400	5275	15033	35.09%	27.23%	11	13
8	金門縣金沙鎮	2018-11-25T01:24:28+08:00	5095	960	6055	505	6560	18560	35.34%	27.45%	13	13
8	金門縣金沙鎮	2018-11-25T03:54:45+08:00	5095	960	6055	505	6560	18560	35.34%	27.45%	13	13
8	金門縣金沙鎮	2018-11-24T23:07:22+08:00	5095	960	6055	505	6560	18560	35.34%	27.45%	13	13
8	金門縣金沙鎮	2018-11-24T23:54:30+08:00	5095	960	6055	505	6560	18560	35.34%	27.45%	13	13
8	金門縣金沙鎮	2018-11-25T06:12:40+08:00	5095	960	6055	505	6560	18560	35.34%	27.45%	13	13
8	金門縣金沙鎮	2018-11-24T23:29:50+08:00	5095	960	6055	505	6560	18560	35.34%	27.45%	13	13
8	金門縣金沙鎮	2018-11-24T23:42:05+08:00	5095	960	6055	505	6560	18560	35.34%	27.45%	13	13
8	金門縣金沙鎮	2018-11-25T01:06:03+08:00	5095	960	6055	505	6560	18560	35.34%	27.45%	13	13
8	金門縣金沙鎮	2018-11-25T01:11:11+08:00	5095	960	6055	505	6560	18560	35.34%	27.45%	13	13
8	金門縣金沙鎮	2018-11-25T00:21:47+08:00	5095	960	6055	505	6560	18560	35.34%	27.45%	13	13
8	金門縣金沙鎮	2018-11-25T03:42:52+08:00	5095	960	6055	505	6560	18560	35.34%	27.45%	13	13
8	金門縣金沙鎮	2018-11-25T06:07:26+08:00	5095	960	6055	505	6560	18560	35.34%	27.45%	13	13
8	金門縣金沙鎮	2018-11-24T22:40:22+08:00	4612	869	5481	454	5935	17036	34.84%	27.07%	12	13
8	金門縣金沙鎮	2018-11-25T00:56:17+08:00	5095	960	6055	505	6560	18560	35.34%	27.45%	13	13
8	金門縣金沙鎮	2018-11-24T22:43:54+08:00	4612	869	5481	454	5935	17036	34.84%	27.07%	12	13
8	金門縣金沙鎮	2018-11-25T03:31:03+08:00	5095	960	6055	505	6560	18560	35.34%	27.45%	13	13
8	金門縣金沙鎮	2018-11-24T22:35:47+08:00	4093	782	4875	400	5275	15033	35.09%	27.23%	11	13
8	金門縣金沙鎮	2018-11-25T01:01:05+08:00	5095	960	6055	505	6560	18560	35.34%	27.45%	13	13
8	金門縣金沙鎮	2018-11-25T01:16:26+08:00	5095	960	6055	505	6560	18560	35.34%	27.45%	13	13
8	金門縣金沙鎮	2018-11-25T00:03:39+08:00	5095	960	6055	505	6560	18560	35.34%	27.45%	13	13
8	宜蘭縣五結鄉	2018-11-24T22:14:51+08:00	8231	2410	10641	1015	11656	21782	53.51%	37.79%	23	33
8	宜蘭縣五結鄉	2018-11-24T23:33:52+08:00	12719	3647	16366	1528	17894	33586	53.28%	37.87%	32	33
8	宜蘭縣五結鄉	2018-11-24T23:10:57+08:00	12172	3548	15720	1503	17223	32270	53.37%	37.72%	31	33
8	宜蘭縣五結鄉	2018-11-25T06:17:38+08:00	13195	3768	16963	1577	18540	34892	53.14%	37.82%	33	33
8	宜蘭縣五結鄉	2018-11-24T22:28:42+08:00	9392	2761	12153	1157	13310	24898	53.46%	37.72%	25	33
8	宜蘭縣五結鄉	2018-11-24T22:56:38+08:00	11311	3323	14634	1398	16032	30014	53.42%	37.69%	29	33
8	宜蘭縣五結鄉	2018-11-24T23:07:21+08:00	12172	3548	15720	1503	17223	32270	53.37%	37.72%	31	33
8	宜蘭縣五結鄉	2018-11-24T22:49:26+08:00	10893	3206	14099	1329	15428	28954	53.28%	37.62%	28	33
8	宜蘭縣五結鄉	2018-11-24T22:53:17+08:00	10893	3206	14099	1329	15428	28954	53.28%	37.62%	28	33
8	宜蘭縣五結鄉	2018-11-25T01:06:01+08:00	13195	3768	16963	1577	18540	34892	53.14%	37.82%	33	33
8	宜蘭縣五結鄉	2018-11-24T22:32:20+08:00	9836	2911	12747	1206	13953	26118	53.42%	37.66%	26	33
8	宜蘭縣五結鄉	2018-11-25T00:17:10+08:00	13195	3768	16963	1577	18540	34892	53.14%	37.82%	33	33
8	宜蘭縣五結鄉	2018-11-25T00:08:06+08:00	13195	3768	16963	1577	18540	34892	53.14%	37.82%	33	33
8	宜蘭縣五結鄉	2018-11-25T03:48:33+08:00	13195	3768	16963	1577	18540	34892	53.14%	37.82%	33	33
8	宜蘭縣五結鄉	2018-11-24T23:29:48+08:00	12719	3647	16366	1528	17894	33586	53.28%	37.87%	32	33
8	宜蘭縣五結鄉	2018-11-24T22:40:20+08:00	10376	3061	13437	1243	14680	27441	53.5%	37.81%	27	33
8	宜蘭縣五結鄉	2018-11-25T06:22:46+08:00	13195	3768	16963	1577	18540	34892	53.14%	37.82%	33	33
8	宜蘭縣五結鄉	2018-11-25T06:07:24+08:00	13195	3768	16963	1577	18540	34892	53.14%	37.82%	33	33
8	宜蘭縣五結鄉	2018-11-24T23:00:18+08:00	11311	3323	14634	1398	16032	30014	53.42%	37.69%	29	33
8	宜蘭縣五結鄉	2018-11-24T22:25:27+08:00	9392	2761	12153	1157	13310	24898	53.46%	37.72%	25	33
8	宜蘭縣五結鄉	2018-11-25T03:42:50+08:00	13195	3768	16963	1577	18540	34892	53.14%	37.82%	33	33
8	宜蘭縣五結鄉	2018-11-25T01:11:09+08:00	13195	3768	16963	1577	18540	34892	53.14%	37.82%	33	33
8	宜蘭縣五結鄉	2018-11-24T23:14:43+08:00	12172	3548	15720	1503	17223	32270	53.37%	37.72%	31	33
8	宜蘭縣五結鄉	2018-11-25T01:16:24+08:00	13195	3768	16963	1577	18540	34892	53.14%	37.82%	33	33
8	宜蘭縣五結鄉	2018-11-24T23:54:29+08:00	13195	3768	16963	1577	18540	34892	53.14%	37.82%	33	33
8	宜蘭縣五結鄉	2018-11-25T06:27:57+08:00	13195	3768	16963	1577	18540	34892	53.14%	37.82%	33	33
8	宜蘭縣五結鄉	2018-11-25T03:31:01+08:00	13195	3768	16963	1577	18540	34892	53.14%	37.82%	33	33
8	宜蘭縣五結鄉	2018-11-24T23:50:16+08:00	13195	3768	16963	1577	18540	34892	53.14%	37.82%	33	33
8	宜蘭縣五結鄉	2018-11-25T00:56:15+08:00	13195	3768	16963	1577	18540	34892	53.14%	37.82%	33	33
8	宜蘭縣五結鄉	2018-11-25T00:12:46+08:00	13195	3768	16963	1577	18540	34892	53.14%	37.82%	33	33
8	宜蘭縣五結鄉	2018-11-24T23:37:50+08:00	13195	3768	16963	1577	18540	34892	53.14%	37.82%	33	33
8	宜蘭縣五結鄉	2018-11-25T01:24:27+08:00	13195	3768	16963	1577	18540	34892	53.14%	37.82%	33	33
8	宜蘭縣五結鄉	2018-11-25T03:54:43+08:00	13195	3768	16963	1577	18540	34892	53.14%	37.82%	33	33
8	宜蘭縣五結鄉	2018-11-24T23:03:49+08:00	11717	3432	15149	1448	16597	31080	53.4%	37.7%	30	33
8	宜蘭縣五結鄉	2018-11-24T22:12:04+08:00	8231	2410	10641	1015	11656	21782	53.51%	37.79%	23	33
8	宜蘭縣五結鄉	2018-11-24T23:22:25+08:00	12719	3647	16366	1528	17894	33586	53.28%	37.87%	32	33
8	宜蘭縣五結鄉	2018-11-24T23:42:03+08:00	13195	3768	16963	1577	18540	34892	53.14%	37.82%	33	33
8	宜蘭縣五結鄉	2018-11-24T23:46:05+08:00	13195	3768	16963	1577	18540	34892	53.14%	37.82%	33	33
8	宜蘭縣五結鄉	2018-11-25T04:01:31+08:00	13195	3768	16963	1577	18540	34892	53.14%	37.82%	33	33
8	宜蘭縣五結鄉	2018-11-25T06:12:39+08:00	13195	3768	16963	1577	18540	34892	53.14%	37.82%	33	33
8	宜蘭縣五結鄉	2018-11-24T22:21:48+08:00	9392	2761	12153	1157	13310	24898	53.46%	37.72%	25	33
8	宜蘭縣五結鄉	2018-11-25T00:21:46+08:00	13195	3768	16963	1577	18540	34892	53.14%	37.82%	33	33
8	宜蘭縣五結鄉	2018-11-25T01:01:03+08:00	13195	3768	16963	1577	18540	34892	53.14%	37.82%	33	33
8	宜蘭縣五結鄉	2018-11-24T22:35:46+08:00	9836	2911	12747	1206	13953	26118	53.42%	37.66%	26	33
8	宜蘭縣五結鄉	2018-11-24T23:58:44+08:00	13195	3768	16963	1577	18540	34892	53.14%	37.82%	33	33
8	宜蘭縣五結鄉	2018-11-24T23:18:29+08:00	12719	3647	16366	1528	17894	33586	53.28%	37.87%	32	33
8	宜蘭縣五結鄉	2018-11-25T03:37:31+08:00	13195	3768	16963	1577	18540	34892	53.14%	37.82%	33	33
8	宜蘭縣五結鄉	2018-11-24T22:18:21+08:00	8812	2575	11387	1101	12488	23332	53.52%	37.77%	24	33
8	宜蘭縣五結鄉	2018-11-24T22:39:11+08:00	10376	3061	13437	1243	14680	27441	53.5%	37.81%	27	33
8	宜蘭縣五結鄉	2018-11-24T23:26:09+08:00	12719	3647	16366	1528	17894	33586	53.28%	37.87%	32	33
8	宜蘭縣五結鄉	2018-11-25T00:03:37+08:00	13195	3768	16963	1577	18540	34892	53.14%	37.82%	33	33
8	宜蘭縣五結鄉	2018-11-24T22:43:52+08:00	10376	3061	13437	1243	14680	27441	53.5%	37.81%	27	33
8	嘉義縣民雄鄉	2018-11-24T23:07:18+08:00	8551	3018	11569	1394	12963	24721	52.44%	34.59%	21	45
8	嘉義縣民雄鄉	2018-11-24T22:56:36+08:00	7466	2641	10107	1254	11361	21703	52.35%	34.4%	19	45
8	嘉義縣民雄鄉	2018-11-25T01:24:24+08:00	20960	7411	28371	3217	31588	59589	53.01%	35.17%	44	45
8	嘉義縣民雄鄉	2018-11-25T03:54:40+08:00	21538	7626	29164	3313	32477	61209	53.06%	35.19%	45	45
8	嘉義縣民雄鄉	2018-11-25T06:17:36+08:00	21538	7626	29164	3313	32477	61209	53.06%	35.19%	45	45
8	嘉義縣民雄鄉	2018-11-24T23:10:56+08:00	8551	3018	11569	1394	12963	24721	52.44%	34.59%	21	45
8	嘉義縣民雄鄉	2018-11-25T03:37:29+08:00	21538	7626	29164	3313	32477	61209	53.06%	35.19%	45	45
8	嘉義縣民雄鄉	2018-11-24T22:39:09+08:00	6286	2247	8533	1097	9630	18453	52.19%	34.06%	17	45
8	嘉義縣民雄鄉	2018-11-25T03:30:59+08:00	21538	7626	29164	3313	32477	61209	53.06%	35.19%	45	45
8	嘉義縣民雄鄉	2018-11-24T22:32:18+08:00	5966	2140	8106	1051	9157	17510	52.3%	34.07%	16	45
8	嘉義縣民雄鄉	2018-11-24T23:42:01+08:00	13143	4722	17865	2132	19997	37825	52.87%	34.75%	30	45
8	嘉義縣民雄鄉	2018-11-25T03:48:29+08:00	21538	7626	29164	3313	32477	61209	53.06%	35.19%	45	45
8	嘉義縣民雄鄉	2018-11-24T23:00:17+08:00	8004	2837	10841	1328	12169	23138	52.59%	34.59%	20	45
8	嘉義縣民雄鄉	2018-11-25T06:07:22+08:00	21538	7626	29164	3313	32477	61209	53.06%	35.19%	45	45
8	嘉義縣民雄鄉	2018-11-25T00:21:44+08:00	17032	6101	23133	2688	25821	48437	53.31%	35.16%	37	45
8	嘉義縣民雄鄉	2018-11-24T23:29:46+08:00	11192	4024	15216	1867	17083	32407	52.71%	34.54%	26	45
8	嘉義縣民雄鄉	2018-11-24T22:40:18+08:00	6286	2247	8533	1097	9630	18453	52.19%	34.06%	17	45
8	嘉義縣民雄鄉	2018-11-25T04:01:29+08:00	21538	7626	29164	3313	32477	61209	53.06%	35.19%	45	45
8	嘉義縣民雄鄉	2018-11-25T01:11:07+08:00	20351	7232	27583	3158	30741	57977	53.02%	35.1%	43	45
8	嘉義縣民雄鄉	2018-11-24T23:37:48+08:00	12051	4304	16355	1972	18327	34658	52.88%	34.77%	28	45
8	嘉義縣民雄鄉	2018-11-24T22:43:50+08:00	6286	2247	8533	1097	9630	18453	52.19%	34.06%	17	45
8	嘉義縣民雄鄉	2018-11-25T00:56:13+08:00	18591	6623	25214	2931	28145	53103	53%	35.01%	40	45
8	嘉義縣民雄鄉	2018-11-24T23:54:27+08:00	14603	5143	19746	2317	22063	41555	53.09%	35.14%	33	45
8	嘉義縣民雄鄉	2018-11-25T01:16:22+08:00	20351	7232	27583	3158	30741	57977	53.02%	35.1%	43	45
8	嘉義縣民雄鄉	2018-11-25T00:03:34+08:00	15722	5589	21311	2442	23753	44558	53.31%	35.28%	35	45
8	嘉義縣民雄鄉	2018-11-24T22:35:44+08:00	6286	2247	8533	1097	9630	18453	52.19%	34.06%	17	45
8	嘉義縣民雄鄉	2018-11-25T01:01:01+08:00	19027	6775	25802	3027	28829	54305	53.09%	35.04%	41	45
8	嘉義縣民雄鄉	2018-11-24T23:22:23+08:00	10047	3557	13604	1605	15209	28938	52.56%	34.72%	24	45
8	嘉義縣民雄鄉	2018-11-24T22:49:24+08:00	6286	2247	8533	1097	9630	18453	52.19%	34.06%	17	45
8	嘉義縣民雄鄉	2018-11-24T23:03:47+08:00	8551	3018	11569	1394	12963	24721	52.44%	34.59%	21	45
8	嘉義縣民雄鄉	2018-11-24T22:28:40+08:00	5568	1953	7521	953	8474	16215	52.26%	34.34%	15	45
8	嘉義縣民雄鄉	2018-11-24T23:33:50+08:00	12051	4304	16355	1972	18327	34658	52.88%	34.77%	28	45
8	嘉義縣民雄鄉	2018-11-24T22:12:02+08:00	3158	1099	4257	516	4773	9357	51.01%	33.75%	10	45
8	嘉義縣民雄鄉	2018-11-25T00:08:04+08:00	16330	5820	22150	2556	24706	46433	53.21%	35.17%	36	45
8	嘉義縣民雄鄉	2018-11-25T03:42:48+08:00	21538	7626	29164	3313	32477	61209	53.06%	35.19%	45	45
8	嘉義縣民雄鄉	2018-11-24T22:53:15+08:00	6831	2429	9260	1164	10424	19929	52.31%	34.28%	18	45
8	嘉義縣民雄鄉	2018-11-24T23:46:03+08:00	14089	4989	19078	2255	21333	40288	52.95%	34.97%	32	45
8	嘉義縣民雄鄉	2018-11-25T00:17:07+08:00	17032	6101	23133	2688	25821	48437	53.31%	35.16%	37	45
8	嘉義縣民雄鄉	2018-11-24T22:21:46+08:00	4619	1608	6227	746	6973	13486	51.71%	34.25%	13	45
8	嘉義縣民雄鄉	2018-11-24T22:25:25+08:00	5008	1744	6752	814	7566	14586	51.87%	34.33%	14	45
8	嘉義縣民雄鄉	2018-11-25T06:22:44+08:00	21538	7626	29164	3313	32477	61209	53.06%	35.19%	45	45
8	嘉義縣民雄鄉	2018-11-25T06:12:36+08:00	21538	7626	29164	3313	32477	61209	53.06%	35.19%	45	45
8	嘉義縣民雄鄉	2018-11-25T00:12:44+08:00	17032	6101	23133	2688	25821	48437	53.31%	35.16%	37	45
8	嘉義縣民雄鄉	2018-11-24T23:26:06+08:00	10683	3798	14481	1696	16177	30656	52.77%	34.85%	25	45
8	嘉義縣民雄鄉	2018-11-24T23:18:27+08:00	10047	3557	13604	1605	15209	28938	52.56%	34.72%	24	45
8	嘉義縣民雄鄉	2018-11-24T23:50:14+08:00	14089	4989	19078	2255	21333	40288	52.95%	34.97%	32	45
8	嘉義縣民雄鄉	2018-11-24T23:14:40+08:00	9070	3195	12265	1443	13708	26027	52.67%	34.85%	22	45
8	嘉義縣民雄鄉	2018-11-24T22:18:19+08:00	3669	1309	4978	588	5566	11077	50.25%	33.12%	11	45
8	嘉義縣民雄鄉	2018-11-24T23:58:42+08:00	14603	5143	19746	2317	22063	41555	53.09%	35.14%	33	45
8	嘉義縣民雄鄉	2018-11-25T06:27:55+08:00	21538	7626	29164	3313	32477	61209	53.06%	35.19%	45	45
8	嘉義縣民雄鄉	2018-11-24T22:14:48+08:00	3158	1099	4257	516	4773	9357	51.01%	33.75%	10	45
8	嘉義縣民雄鄉	2018-11-25T01:05:59+08:00	20351	7232	27583	3158	30741	57977	53.02%	35.1%	43	45
8	新竹市香山區	2018-11-24T23:10:59+08:00	20986	6185	27171	1875	29046	52122	55.73%	40.26%	45	55
8	新竹市香山區	2018-11-24T23:22:27+08:00	24436	7041	31477	2180	33657	59892	56.2%	40.8%	51	55
8	新竹市香山區	2018-11-24T23:18:31+08:00	23685	6938	30623	2130	32753	58428	56.06%	40.54%	50	55
8	新竹市香山區	2018-11-24T22:49:28+08:00	17285	5115	22400	1543	23943	42895	55.82%	40.3%	38	55
8	新竹市香山區	2018-11-24T23:33:54+08:00	24858	7139	31997	2221	34218	61115	55.99%	40.67%	52	55
8	新竹市香山區	2018-11-24T22:12:06+08:00	13838	4058	17896	1218	19114	34706	55.07%	39.87%	30	55
8	新竹市香山區	2018-11-24T23:26:11+08:00	24436	7041	31477	2180	33657	59892	56.2%	40.8%	51	55
8	新竹市香山區	2018-11-24T22:28:44+08:00	14732	4343	19075	1286	20361	36932	55.13%	39.89%	32	55
8	新竹市香山區	2018-11-24T23:37:52+08:00	25777	7394	33171	2292	35463	63269	56.05%	40.74%	54	55
8	新竹市香山區	2018-11-25T03:54:46+08:00	26341	7542	33883	2329	36212	64896	55.8%	40.59%	55	55
8	新竹市香山區	2018-11-24T22:53:19+08:00	17889	5265	23154	1593	24747	44232	55.95%	40.44%	39	55
8	新竹市香山區	2018-11-24T22:21:50+08:00	14732	4343	19075	1286	20361	36932	55.13%	39.89%	32	55
8	新竹市香山區	2018-11-25T04:01:33+08:00	26341	7542	33883	2329	36212	64896	55.8%	40.59%	55	55
8	新竹市香山區	2018-11-25T00:08:09+08:00	26341	7542	33883	2329	36212	64896	55.8%	40.59%	55	55
8	新竹市香山區	2018-11-24T23:46:07+08:00	25777	7394	33171	2292	35463	63269	56.05%	40.74%	54	55
8	新竹市香山區	2018-11-25T01:11:12+08:00	26341	7542	33883	2329	36212	64896	55.8%	40.59%	55	55
8	新竹市香山區	2018-11-24T23:42:06+08:00	25777	7394	33171	2292	35463	63269	56.05%	40.74%	54	55
8	新竹市香山區	2018-11-24T23:00:20+08:00	18399	5419	23818	1629	25447	45420	56.03%	40.51%	40	55
8	新竹市香山區	2018-11-24T22:25:29+08:00	14732	4343	19075	1286	20361	36932	55.13%	39.89%	32	55
8	新竹市香山區	2018-11-25T06:22:48+08:00	26341	7542	33883	2329	36212	64896	55.8%	40.59%	55	55
8	新竹市香山區	2018-11-25T03:48:35+08:00	26341	7542	33883	2329	36212	64896	55.8%	40.59%	55	55
8	新竹市香山區	2018-11-24T23:50:19+08:00	26341	7542	33883	2329	36212	64896	55.8%	40.59%	55	55
8	新竹市香山區	2018-11-25T06:27:59+08:00	26341	7542	33883	2329	36212	64896	55.8%	40.59%	55	55
8	新竹市香山區	2018-11-25T06:17:41+08:00	26341	7542	33883	2329	36212	64896	55.8%	40.59%	55	55
8	新竹市香山區	2018-11-24T23:03:51+08:00	18838	5554	24392	1680	26072	46506	56.06%	40.51%	41	55
8	新竹市香山區	2018-11-24T22:39:13+08:00	16018	4726	20744	1399	22143	40009	55.35%	40.04%	35	55
8	新竹市香山區	2018-11-25T03:37:34+08:00	26341	7542	33883	2329	36212	64896	55.8%	40.59%	55	55
8	新竹市香山區	2018-11-25T00:12:49+08:00	26341	7542	33883	2329	36212	64896	55.8%	40.59%	55	55
8	新竹市香山區	2018-11-24T23:58:47+08:00	26341	7542	33883	2329	36212	64896	55.8%	40.59%	55	55
8	新竹市香山區	2018-11-24T22:18:23+08:00	14732	4343	19075	1286	20361	36932	55.13%	39.89%	32	55
8	新竹市香山區	2018-11-24T23:14:45+08:00	21394	6313	27707	1908	29615	53136	55.73%	40.26%	46	55
8	新竹市香山區	2018-11-24T22:56:40+08:00	18399	5419	23818	1629	25447	45420	56.03%	40.51%	40	55
8	新竹市香山區	2018-11-25T01:01:06+08:00	26341	7542	33883	2329	36212	64896	55.8%	40.59%	55	55
8	新竹市香山區	2018-11-25T01:24:29+08:00	26341	7542	33883	2329	36212	64896	55.8%	40.59%	55	55
8	新竹市香山區	2018-11-24T23:54:31+08:00	26341	7542	33883	2329	36212	64896	55.8%	40.59%	55	55
8	新竹市香山區	2018-11-24T23:07:23+08:00	20113	5907	26020	1804	27824	49716	55.97%	40.46%	43	55
8	新竹市香山區	2018-11-25T00:03:40+08:00	26341	7542	33883	2329	36212	64896	55.8%	40.59%	55	55
8	新竹市香山區	2018-11-24T22:14:53+08:00	14363	4241	18604	1251	19855	36042	55.09%	39.85%	31	55
8	新竹市香山區	2018-11-25T00:17:12+08:00	26341	7542	33883	2329	36212	64896	55.8%	40.59%	55	55
8	新竹市香山區	2018-11-24T22:32:22+08:00	14732	4343	19075	1286	20361	36932	55.13%	39.89%	32	55
8	新竹市香山區	2018-11-25T06:12:41+08:00	26341	7542	33883	2329	36212	64896	55.8%	40.59%	55	55
8	新竹市香山區	2018-11-25T01:06:04+08:00	26341	7542	33883	2329	36212	64896	55.8%	40.59%	55	55
8	新竹市香山區	2018-11-24T23:29:51+08:00	24858	7139	31997	2221	34218	61115	55.99%	40.67%	52	55
8	新竹市香山區	2018-11-24T22:40:22+08:00	16505	4866	21371	1458	22829	41032	55.64%	40.22%	36	55
8	新竹市香山區	2018-11-25T03:42:53+08:00	26341	7542	33883	2329	36212	64896	55.8%	40.59%	55	55
8	新竹市香山區	2018-11-25T00:21:48+08:00	26341	7542	33883	2329	36212	64896	55.8%	40.59%	55	55
8	新竹市香山區	2018-11-25T06:07:27+08:00	26341	7542	33883	2329	36212	64896	55.8%	40.59%	55	55
8	新竹市香山區	2018-11-25T00:56:17+08:00	26341	7542	33883	2329	36212	64896	55.8%	40.59%	55	55
8	新竹市香山區	2018-11-24T22:35:48+08:00	15207	4460	19667	1311	20978	37908	55.34%	40.12%	33	55
8	新竹市香山區	2018-11-24T22:43:54+08:00	16505	4866	21371	1458	22829	41032	55.64%	40.22%	36	55
8	新竹市香山區	2018-11-25T03:31:04+08:00	26341	7542	33883	2329	36212	64896	55.8%	40.59%	55	55
8	新竹市香山區	2018-11-25T01:16:27+08:00	26341	7542	33883	2329	36212	64896	55.8%	40.59%	55	55
8	屏東縣佳冬鄉	2018-11-24T23:10:57+08:00	5317	1854	7171	1101	8272	17063	48.48%	31.16%	16	16
8	屏東縣佳冬鄉	2018-11-24T23:07:19+08:00	5317	1854	7171	1101	8272	17063	48.48%	31.16%	16	16
8	屏東縣佳冬鄉	2018-11-24T22:14:50+08:00	4934	1732	6666	1015	7681	15703	48.91%	31.42%	15	16
8	屏東縣佳冬鄉	2018-11-25T06:17:37+08:00	5317	1854	7171	1101	8272	17063	48.48%	31.16%	16	16
8	屏東縣佳冬鄉	2018-11-24T22:56:37+08:00	5317	1854	7171	1101	8272	17063	48.48%	31.16%	16	16
8	屏東縣佳冬鄉	2018-11-24T22:32:19+08:00	5317	1854	7171	1101	8272	17063	48.48%	31.16%	16	16
8	屏東縣佳冬鄉	2018-11-25T01:06:01+08:00	5317	1854	7171	1101	8272	17063	48.48%	31.16%	16	16
8	屏東縣佳冬鄉	2018-11-24T22:53:16+08:00	5317	1854	7171	1101	8272	17063	48.48%	31.16%	16	16
8	屏東縣佳冬鄉	2018-11-25T00:08:06+08:00	5317	1854	7171	1101	8272	17063	48.48%	31.16%	16	16
8	屏東縣佳冬鄉	2018-11-24T22:25:26+08:00	4934	1732	6666	1015	7681	15703	48.91%	31.42%	15	16
8	屏東縣佳冬鄉	2018-11-25T01:11:08+08:00	5317	1854	7171	1101	8272	17063	48.48%	31.16%	16	16
8	屏東縣佳冬鄉	2018-11-24T22:40:20+08:00	5317	1854	7171	1101	8272	17063	48.48%	31.16%	16	16
8	屏東縣佳冬鄉	2018-11-25T06:07:24+08:00	5317	1854	7171	1101	8272	17063	48.48%	31.16%	16	16
8	屏東縣佳冬鄉	2018-11-24T23:00:18+08:00	5317	1854	7171	1101	8272	17063	48.48%	31.16%	16	16
8	屏東縣佳冬鄉	2018-11-25T03:48:32+08:00	5317	1854	7171	1101	8272	17063	48.48%	31.16%	16	16
8	屏東縣佳冬鄉	2018-11-24T23:29:47+08:00	5317	1854	7171	1101	8272	17063	48.48%	31.16%	16	16
8	屏東縣佳冬鄉	2018-11-25T00:21:45+08:00	5317	1854	7171	1101	8272	17063	48.48%	31.16%	16	16
8	屏東縣佳冬鄉	2018-11-25T03:31:00+08:00	5317	1854	7171	1101	8272	17063	48.48%	31.16%	16	16
8	屏東縣佳冬鄉	2018-11-25T01:16:23+08:00	5317	1854	7171	1101	8272	17063	48.48%	31.16%	16	16
8	屏東縣佳冬鄉	2018-11-25T00:56:14+08:00	5317	1854	7171	1101	8272	17063	48.48%	31.16%	16	16
8	屏東縣佳冬鄉	2018-11-24T22:35:45+08:00	5317	1854	7171	1101	8272	17063	48.48%	31.16%	16	16
8	屏東縣佳冬鄉	2018-11-24T23:14:42+08:00	5317	1854	7171	1101	8272	17063	48.48%	31.16%	16	16
8	屏東縣佳冬鄉	2018-11-24T23:50:16+08:00	5317	1854	7171	1101	8272	17063	48.48%	31.16%	16	16
8	屏東縣佳冬鄉	2018-11-24T23:37:49+08:00	5317	1854	7171	1101	8272	17063	48.48%	31.16%	16	16
8	屏東縣佳冬鄉	2018-11-24T22:43:51+08:00	5317	1854	7171	1101	8272	17063	48.48%	31.16%	16	16
8	屏東縣佳冬鄉	2018-11-25T06:27:56+08:00	5317	1854	7171	1101	8272	17063	48.48%	31.16%	16	16
8	屏東縣佳冬鄉	2018-11-25T00:12:46+08:00	5317	1854	7171	1101	8272	17063	48.48%	31.16%	16	16
8	屏東縣佳冬鄉	2018-11-24T23:54:28+08:00	5317	1854	7171	1101	8272	17063	48.48%	31.16%	16	16
8	屏東縣佳冬鄉	2018-11-24T23:22:24+08:00	5317	1854	7171	1101	8272	17063	48.48%	31.16%	16	16
8	屏東縣佳冬鄉	2018-11-24T22:28:41+08:00	4934	1732	6666	1015	7681	15703	48.91%	31.42%	15	16
8	屏東縣佳冬鄉	2018-11-24T22:12:03+08:00	4934	1732	6666	1015	7681	15703	48.91%	31.42%	15	16
8	屏東縣佳冬鄉	2018-11-24T23:33:51+08:00	5317	1854	7171	1101	8272	17063	48.48%	31.16%	16	16
8	屏東縣佳冬鄉	2018-11-25T01:24:26+08:00	5317	1854	7171	1101	8272	17063	48.48%	31.16%	16	16
8	屏東縣佳冬鄉	2018-11-25T03:54:42+08:00	5317	1854	7171	1101	8272	17063	48.48%	31.16%	16	16
8	屏東縣佳冬鄉	2018-11-24T23:03:48+08:00	5317	1854	7171	1101	8272	17063	48.48%	31.16%	16	16
8	屏東縣佳冬鄉	2018-11-24T22:49:25+08:00	5317	1854	7171	1101	8272	17063	48.48%	31.16%	16	16
8	屏東縣佳冬鄉	2018-11-24T23:42:03+08:00	5317	1854	7171	1101	8272	17063	48.48%	31.16%	16	16
8	屏東縣佳冬鄉	2018-11-25T04:01:30+08:00	5317	1854	7171	1101	8272	17063	48.48%	31.16%	16	16
8	屏東縣佳冬鄉	2018-11-25T03:42:49+08:00	5317	1854	7171	1101	8272	17063	48.48%	31.16%	16	16
8	屏東縣佳冬鄉	2018-11-24T23:46:04+08:00	5317	1854	7171	1101	8272	17063	48.48%	31.16%	16	16
8	屏東縣佳冬鄉	2018-11-25T00:17:09+08:00	5317	1854	7171	1101	8272	17063	48.48%	31.16%	16	16
8	屏東縣佳冬鄉	2018-11-25T06:12:37+08:00	5317	1854	7171	1101	8272	17063	48.48%	31.16%	16	16
8	屏東縣佳冬鄉	2018-11-25T06:22:45+08:00	5317	1854	7171	1101	8272	17063	48.48%	31.16%	16	16
8	屏東縣佳冬鄉	2018-11-24T22:21:47+08:00	4934	1732	6666	1015	7681	15703	48.91%	31.42%	15	16
8	屏東縣佳冬鄉	2018-11-24T22:39:10+08:00	5317	1854	7171	1101	8272	17063	48.48%	31.16%	16	16
8	屏東縣佳冬鄉	2018-11-24T23:26:08+08:00	5317	1854	7171	1101	8272	17063	48.48%	31.16%	16	16
8	屏東縣佳冬鄉	2018-11-24T22:18:20+08:00	4934	1732	6666	1015	7681	15703	48.91%	31.42%	15	16
8	屏東縣佳冬鄉	2018-11-25T03:37:30+08:00	5317	1854	7171	1101	8272	17063	48.48%	31.16%	16	16
8	屏東縣佳冬鄉	2018-11-24T23:58:43+08:00	5317	1854	7171	1101	8272	17063	48.48%	31.16%	16	16
8	屏東縣佳冬鄉	2018-11-25T00:03:36+08:00	5317	1854	7171	1101	8272	17063	48.48%	31.16%	16	16
8	屏東縣佳冬鄉	2018-11-25T01:01:02+08:00	5317	1854	7171	1101	8272	17063	48.48%	31.16%	16	16
8	屏東縣佳冬鄉	2018-11-24T23:18:28+08:00	5317	1854	7171	1101	8272	17063	48.48%	31.16%	16	16
8	臺南市後壁區	2018-11-25T03:37:19+08:00	5961	2055	8016	1231	9247	20841	44.37%	28.6%	29	29
8	臺南市後壁區	2018-11-24T22:49:18+08:00	5961	2055	8016	1231	9247	20841	44.37%	28.6%	29	29
8	臺南市後壁區	2018-11-24T23:14:33+08:00	5961	2055	8016	1231	9247	20841	44.37%	28.6%	29	29
8	臺南市後壁區	2018-11-24T22:56:31+08:00	5961	2055	8016	1231	9247	20841	44.37%	28.6%	29	29
8	臺南市後壁區	2018-11-25T00:12:39+08:00	5961	2055	8016	1231	9247	20841	44.37%	28.6%	29	29
8	臺南市後壁區	2018-11-25T00:03:27+08:00	5961	2055	8016	1231	9247	20841	44.37%	28.6%	29	29
8	臺南市後壁區	2018-11-25T00:56:07+08:00	5961	2055	8016	1231	9247	20841	44.37%	28.6%	29	29
8	臺南市後壁區	2018-11-24T23:03:42+08:00	5961	2055	8016	1231	9247	20841	44.37%	28.6%	29	29
8	臺南市後壁區	2018-11-24T23:10:51+08:00	5961	2055	8016	1231	9247	20841	44.37%	28.6%	29	29
8	臺南市後壁區	2018-11-24T22:43:44+08:00	5961	2055	8016	1231	9247	20841	44.37%	28.6%	29	29
8	臺南市後壁區	2018-11-25T06:17:30+08:00	5961	2055	8016	1231	9247	20841	44.37%	28.6%	29	29
8	臺南市後壁區	2018-11-24T23:58:36+08:00	5961	2055	8016	1231	9247	20841	44.37%	28.6%	29	29
8	臺南市後壁區	2018-11-24T23:22:17+08:00	5961	2055	8016	1231	9247	20841	44.37%	28.6%	29	29
8	臺南市後壁區	2018-11-25T06:22:40+08:00	5961	2055	8016	1231	9247	20841	44.37%	28.6%	29	29
8	臺南市後壁區	2018-11-24T23:29:41+08:00	5961	2055	8016	1231	9247	20841	44.37%	28.6%	29	29
8	臺南市後壁區	2018-11-24T22:25:18+08:00	5961	2055	8016	1231	9247	20841	44.37%	28.6%	29	29
8	臺南市後壁區	2018-11-25T01:11:00+08:00	5961	2055	8016	1231	9247	20841	44.37%	28.6%	29	29
8	臺南市後壁區	2018-11-25T00:17:02+08:00	5961	2055	8016	1231	9247	20841	44.37%	28.6%	29	29
8	臺南市後壁區	2018-11-25T00:07:58+08:00	5961	2055	8016	1231	9247	20841	44.37%	28.6%	29	29
8	臺南市後壁區	2018-11-25T01:16:15+08:00	5961	2055	8016	1231	9247	20841	44.37%	28.6%	29	29
8	臺南市後壁區	2018-11-25T01:05:52+08:00	5961	2055	8016	1231	9247	20841	44.37%	28.6%	29	29
8	臺南市後壁區	2018-11-24T22:14:42+08:00	5961	2055	8016	1231	9247	20841	44.37%	28.6%	29	29
8	臺南市後壁區	2018-11-24T23:54:19+08:00	5961	2055	8016	1231	9247	20841	44.37%	28.6%	29	29
8	臺南市後壁區	2018-11-24T22:28:34+08:00	5961	2055	8016	1231	9247	20841	44.37%	28.6%	29	29
8	臺南市後壁區	2018-11-24T22:18:14+08:00	5961	2055	8016	1231	9247	20841	44.37%	28.6%	29	29
8	臺南市後壁區	2018-11-25T01:24:18+08:00	5961	2055	8016	1231	9247	20841	44.37%	28.6%	29	29
8	臺南市後壁區	2018-11-24T22:35:39+08:00	5961	2055	8016	1231	9247	20841	44.37%	28.6%	29	29
8	臺南市後壁區	2018-11-24T23:50:09+08:00	5961	2055	8016	1231	9247	20841	44.37%	28.6%	29	29
8	臺南市後壁區	2018-11-25T06:27:49+08:00	5961	2055	8016	1231	9247	20841	44.37%	28.6%	29	29
8	臺南市後壁區	2018-11-24T22:39:03+08:00	5961	2055	8016	1231	9247	20841	44.37%	28.6%	29	29
8	臺南市後壁區	2018-11-24T23:07:13+08:00	5961	2055	8016	1231	9247	20841	44.37%	28.6%	29	29
8	臺南市後壁區	2018-11-25T01:00:54+08:00	5961	2055	8016	1231	9247	20841	44.37%	28.6%	29	29
8	臺南市後壁區	2018-11-25T00:21:37+08:00	5961	2055	8016	1231	9247	20841	44.37%	28.6%	29	29
8	臺南市後壁區	2018-11-24T22:32:13+08:00	5961	2055	8016	1231	9247	20841	44.37%	28.6%	29	29
8	臺南市後壁區	2018-11-25T03:48:23+08:00	5961	2055	8016	1231	9247	20841	44.37%	28.6%	29	29
8	臺南市後壁區	2018-11-24T23:00:09+08:00	5961	2055	8016	1231	9247	20841	44.37%	28.6%	29	29
8	臺南市後壁區	2018-11-25T03:30:52+08:00	5961	2055	8016	1231	9247	20841	44.37%	28.6%	29	29
8	臺南市後壁區	2018-11-25T03:42:41+08:00	5961	2055	8016	1231	9247	20841	44.37%	28.6%	29	29
8	臺南市後壁區	2018-11-24T22:21:39+08:00	5961	2055	8016	1231	9247	20841	44.37%	28.6%	29	29
8	臺南市後壁區	2018-11-24T22:53:08+08:00	5961	2055	8016	1231	9247	20841	44.37%	28.6%	29	29
8	臺南市後壁區	2018-11-24T22:11:57+08:00	5961	2055	8016	1231	9247	20841	44.37%	28.6%	29	29
8	臺南市後壁區	2018-11-24T22:40:13+08:00	5961	2055	8016	1231	9247	20841	44.37%	28.6%	29	29
8	臺南市後壁區	2018-11-25T06:12:31+08:00	5961	2055	8016	1231	9247	20841	44.37%	28.6%	29	29
8	臺南市後壁區	2018-11-25T06:07:16+08:00	5961	2055	8016	1231	9247	20841	44.37%	28.6%	29	29
8	臺南市後壁區	2018-11-25T04:01:23+08:00	5961	2055	8016	1231	9247	20841	44.37%	28.6%	29	29
8	臺南市後壁區	2018-11-24T23:33:44+08:00	5961	2055	8016	1231	9247	20841	44.37%	28.6%	29	29
8	臺南市後壁區	2018-11-24T23:26:01+08:00	5961	2055	8016	1231	9247	20841	44.37%	28.6%	29	29
8	臺南市後壁區	2018-11-25T03:54:34+08:00	5961	2055	8016	1231	9247	20841	44.37%	28.6%	29	29
8	臺南市後壁區	2018-11-24T23:45:58+08:00	5961	2055	8016	1231	9247	20841	44.37%	28.6%	29	29
8	臺南市後壁區	2018-11-24T23:41:56+08:00	5961	2055	8016	1231	9247	20841	44.37%	28.6%	29	29
8	臺南市後壁區	2018-11-24T23:37:43+08:00	5961	2055	8016	1231	9247	20841	44.37%	28.6%	29	29
8	臺南市後壁區	2018-11-24T23:18:21+08:00	5961	2055	8016	1231	9247	20841	44.37%	28.6%	29	29
8	屏東縣春日鄉	2018-11-24T23:07:20+08:00	739	233	972	61	1033	3923	26.33%	18.84%	6	6
8	屏東縣春日鄉	2018-11-24T23:10:57+08:00	739	233	972	61	1033	3923	26.33%	18.84%	6	6
8	屏東縣春日鄉	2018-11-24T22:14:50+08:00	739	233	972	61	1033	3923	26.33%	18.84%	6	6
8	屏東縣春日鄉	2018-11-25T06:17:37+08:00	739	233	972	61	1033	3923	26.33%	18.84%	6	6
8	屏東縣春日鄉	2018-11-24T22:56:37+08:00	739	233	972	61	1033	3923	26.33%	18.84%	6	6
8	屏東縣春日鄉	2018-11-24T22:32:19+08:00	739	233	972	61	1033	3923	26.33%	18.84%	6	6
8	屏東縣春日鄉	2018-11-25T01:06:01+08:00	739	233	972	61	1033	3923	26.33%	18.84%	6	6
8	屏東縣春日鄉	2018-11-24T22:53:16+08:00	739	233	972	61	1033	3923	26.33%	18.84%	6	6
8	屏東縣春日鄉	2018-11-25T00:08:06+08:00	739	233	972	61	1033	3923	26.33%	18.84%	6	6
8	屏東縣春日鄉	2018-11-24T22:25:26+08:00	739	233	972	61	1033	3923	26.33%	18.84%	6	6
8	屏東縣春日鄉	2018-11-24T23:29:48+08:00	739	233	972	61	1033	3923	26.33%	18.84%	6	6
8	屏東縣春日鄉	2018-11-24T22:40:20+08:00	739	233	972	61	1033	3923	26.33%	18.84%	6	6
8	屏東縣春日鄉	2018-11-25T06:22:46+08:00	739	233	972	61	1033	3923	26.33%	18.84%	6	6
8	屏東縣春日鄉	2018-11-25T06:07:24+08:00	739	233	972	61	1033	3923	26.33%	18.84%	6	6
8	屏東縣春日鄉	2018-11-24T23:00:18+08:00	739	233	972	61	1033	3923	26.33%	18.84%	6	6
8	屏東縣春日鄉	2018-11-25T03:48:32+08:00	739	233	972	61	1033	3923	26.33%	18.84%	6	6
8	屏東縣春日鄉	2018-11-25T03:42:50+08:00	739	233	972	61	1033	3923	26.33%	18.84%	6	6
8	屏東縣春日鄉	2018-11-25T00:21:45+08:00	739	233	972	61	1033	3923	26.33%	18.84%	6	6
8	屏東縣春日鄉	2018-11-25T01:11:09+08:00	739	233	972	61	1033	3923	26.33%	18.84%	6	6
8	屏東縣春日鄉	2018-11-25T01:16:23+08:00	739	233	972	61	1033	3923	26.33%	18.84%	6	6
8	屏東縣春日鄉	2018-11-25T03:31:01+08:00	739	233	972	61	1033	3923	26.33%	18.84%	6	6
8	屏東縣春日鄉	2018-11-24T23:14:42+08:00	739	233	972	61	1033	3923	26.33%	18.84%	6	6
8	屏東縣春日鄉	2018-11-24T23:50:16+08:00	739	233	972	61	1033	3923	26.33%	18.84%	6	6
8	屏東縣春日鄉	2018-11-25T06:27:56+08:00	739	233	972	61	1033	3923	26.33%	18.84%	6	6
8	屏東縣春日鄉	2018-11-25T00:56:15+08:00	739	233	972	61	1033	3923	26.33%	18.84%	6	6
8	屏東縣春日鄉	2018-11-25T00:12:46+08:00	739	233	972	61	1033	3923	26.33%	18.84%	6	6
8	屏東縣春日鄉	2018-11-24T23:54:28+08:00	739	233	972	61	1033	3923	26.33%	18.84%	6	6
8	屏東縣春日鄉	2018-11-24T23:37:50+08:00	739	233	972	61	1033	3923	26.33%	18.84%	6	6
8	屏東縣春日鄉	2018-11-24T23:22:24+08:00	739	233	972	61	1033	3923	26.33%	18.84%	6	6
8	屏東縣春日鄉	2018-11-24T22:28:41+08:00	739	233	972	61	1033	3923	26.33%	18.84%	6	6
8	屏東縣春日鄉	2018-11-24T22:12:04+08:00	739	233	972	61	1033	3923	26.33%	18.84%	6	6
8	屏東縣春日鄉	2018-11-24T23:33:51+08:00	739	233	972	61	1033	3923	26.33%	18.84%	6	6
8	屏東縣春日鄉	2018-11-25T01:24:26+08:00	739	233	972	61	1033	3923	26.33%	18.84%	6	6
8	屏東縣春日鄉	2018-11-25T03:54:42+08:00	739	233	972	61	1033	3923	26.33%	18.84%	6	6
8	屏東縣春日鄉	2018-11-24T23:03:48+08:00	739	233	972	61	1033	3923	26.33%	18.84%	6	6
8	屏東縣春日鄉	2018-11-24T22:49:25+08:00	739	233	972	61	1033	3923	26.33%	18.84%	6	6
8	屏東縣春日鄉	2018-11-24T23:42:03+08:00	739	233	972	61	1033	3923	26.33%	18.84%	6	6
8	屏東縣春日鄉	2018-11-25T04:01:30+08:00	739	233	972	61	1033	3923	26.33%	18.84%	6	6
8	屏東縣春日鄉	2018-11-24T23:46:05+08:00	739	233	972	61	1033	3923	26.33%	18.84%	6	6
8	屏東縣春日鄉	2018-11-25T00:17:09+08:00	739	233	972	61	1033	3923	26.33%	18.84%	6	6
8	屏東縣春日鄉	2018-11-25T06:12:38+08:00	739	233	972	61	1033	3923	26.33%	18.84%	6	6
8	屏東縣春日鄉	2018-11-24T22:21:47+08:00	739	233	972	61	1033	3923	26.33%	18.84%	6	6
8	屏東縣春日鄉	2018-11-25T01:01:03+08:00	739	233	972	61	1033	3923	26.33%	18.84%	6	6
8	屏東縣春日鄉	2018-11-24T22:39:10+08:00	739	233	972	61	1033	3923	26.33%	18.84%	6	6
8	屏東縣春日鄉	2018-11-24T23:26:08+08:00	739	233	972	61	1033	3923	26.33%	18.84%	6	6
8	屏東縣春日鄉	2018-11-24T22:35:46+08:00	739	233	972	61	1033	3923	26.33%	18.84%	6	6
8	屏東縣春日鄉	2018-11-24T23:58:44+08:00	739	233	972	61	1033	3923	26.33%	18.84%	6	6
8	屏東縣春日鄉	2018-11-25T00:03:36+08:00	739	233	972	61	1033	3923	26.33%	18.84%	6	6
8	屏東縣春日鄉	2018-11-25T03:37:31+08:00	739	233	972	61	1033	3923	26.33%	18.84%	6	6
8	屏東縣春日鄉	2018-11-24T22:18:21+08:00	739	233	972	61	1033	3923	26.33%	18.84%	6	6
8	屏東縣春日鄉	2018-11-24T23:18:28+08:00	739	233	972	61	1033	3923	26.33%	18.84%	6	6
8	屏東縣春日鄉	2018-11-24T22:43:52+08:00	739	233	972	61	1033	3923	26.33%	18.84%	6	6
8	臺南市七股區	2018-11-25T03:37:19+08:00	5675	1847	7522	899	8421	19950	42.21%	28.45%	24	24
8	臺南市七股區	2018-11-24T22:49:18+08:00	5675	1847	7522	899	8421	19950	42.21%	28.45%	24	24
8	臺南市七股區	2018-11-24T23:14:34+08:00	5675	1847	7522	899	8421	19950	42.21%	28.45%	24	24
8	臺南市七股區	2018-11-24T22:56:31+08:00	5675	1847	7522	899	8421	19950	42.21%	28.45%	24	24
8	臺南市七股區	2018-11-25T00:03:27+08:00	5675	1847	7522	899	8421	19950	42.21%	28.45%	24	24
8	臺南市七股區	2018-11-24T22:43:45+08:00	5675	1847	7522	899	8421	19950	42.21%	28.45%	24	24
8	臺南市七股區	2018-11-25T00:56:07+08:00	5675	1847	7522	899	8421	19950	42.21%	28.45%	24	24
8	臺南市七股區	2018-11-24T23:03:42+08:00	5675	1847	7522	899	8421	19950	42.21%	28.45%	24	24
8	臺南市七股區	2018-11-24T23:10:51+08:00	5675	1847	7522	899	8421	19950	42.21%	28.45%	24	24
8	臺南市七股區	2018-11-25T06:17:30+08:00	5675	1847	7522	899	8421	19950	42.21%	28.45%	24	24
8	臺南市七股區	2018-11-24T23:58:36+08:00	5675	1847	7522	899	8421	19950	42.21%	28.45%	24	24
8	臺南市七股區	2018-11-24T23:22:17+08:00	5675	1847	7522	899	8421	19950	42.21%	28.45%	24	24
8	臺南市七股區	2018-11-25T03:42:42+08:00	5675	1847	7522	899	8421	19950	42.21%	28.45%	24	24
8	臺南市七股區	2018-11-25T06:22:40+08:00	5675	1847	7522	899	8421	19950	42.21%	28.45%	24	24
8	臺南市七股區	2018-11-24T23:29:41+08:00	5675	1847	7522	899	8421	19950	42.21%	28.45%	24	24
8	臺南市七股區	2018-11-24T22:25:18+08:00	5238	1719	6957	799	7756	18775	41.31%	27.9%	23	24
8	臺南市七股區	2018-11-25T01:11:00+08:00	5675	1847	7522	899	8421	19950	42.21%	28.45%	24	24
8	臺南市七股區	2018-11-25T00:17:02+08:00	5675	1847	7522	899	8421	19950	42.21%	28.45%	24	24
8	臺南市七股區	2018-11-25T06:12:32+08:00	5675	1847	7522	899	8421	19950	42.21%	28.45%	24	24
8	臺南市七股區	2018-11-25T00:07:58+08:00	5675	1847	7522	899	8421	19950	42.21%	28.45%	24	24
8	臺南市七股區	2018-11-25T00:12:40+08:00	5675	1847	7522	899	8421	19950	42.21%	28.45%	24	24
8	臺南市七股區	2018-11-24T22:14:43+08:00	4745	1584	6329	756	7085	17117	41.39%	27.72%	22	24
8	臺南市七股區	2018-11-24T23:26:02+08:00	5675	1847	7522	899	8421	19950	42.21%	28.45%	24	24
8	臺南市七股區	2018-11-25T06:27:50+08:00	5675	1847	7522	899	8421	19950	42.21%	28.45%	24	24
8	臺南市七股區	2018-11-24T23:18:22+08:00	5675	1847	7522	899	8421	19950	42.21%	28.45%	24	24
8	臺南市七股區	2018-11-25T01:05:53+08:00	5675	1847	7522	899	8421	19950	42.21%	28.45%	24	24
8	臺南市七股區	2018-11-24T23:54:19+08:00	5675	1847	7522	899	8421	19950	42.21%	28.45%	24	24
8	臺南市七股區	2018-11-24T22:28:34+08:00	5238	1719	6957	799	7756	18775	41.31%	27.9%	23	24
8	臺南市七股區	2018-11-24T22:18:14+08:00	4745	1584	6329	756	7085	17117	41.39%	27.72%	22	24
8	臺南市七股區	2018-11-25T01:24:18+08:00	5675	1847	7522	899	8421	19950	42.21%	28.45%	24	24
8	臺南市七股區	2018-11-24T23:50:09+08:00	5675	1847	7522	899	8421	19950	42.21%	28.45%	24	24
8	臺南市七股區	2018-11-24T22:39:03+08:00	5238	1719	6957	799	7756	18775	41.31%	27.9%	23	24
8	臺南市七股區	2018-11-24T23:07:13+08:00	5675	1847	7522	899	8421	19950	42.21%	28.45%	24	24
8	臺南市七股區	2018-11-24T22:32:13+08:00	5238	1719	6957	799	7756	18775	41.31%	27.9%	23	24
8	臺南市七股區	2018-11-25T03:48:23+08:00	5675	1847	7522	899	8421	19950	42.21%	28.45%	24	24
8	臺南市七股區	2018-11-25T01:00:55+08:00	5675	1847	7522	899	8421	19950	42.21%	28.45%	24	24
8	臺南市七股區	2018-11-24T23:00:09+08:00	5675	1847	7522	899	8421	19950	42.21%	28.45%	24	24
8	臺南市七股區	2018-11-25T00:21:38+08:00	5675	1847	7522	899	8421	19950	42.21%	28.45%	24	24
8	臺南市七股區	2018-11-25T03:30:52+08:00	5675	1847	7522	899	8421	19950	42.21%	28.45%	24	24
8	臺南市七股區	2018-11-24T22:53:08+08:00	5675	1847	7522	899	8421	19950	42.21%	28.45%	24	24
8	臺南市七股區	2018-11-25T06:07:17+08:00	5675	1847	7522	899	8421	19950	42.21%	28.45%	24	24
8	臺南市七股區	2018-11-24T22:11:57+08:00	4745	1584	6329	756	7085	17117	41.39%	27.72%	22	24
8	臺南市七股區	2018-11-24T22:40:14+08:00	5238	1719	6957	799	7756	18775	41.31%	27.9%	23	24
8	臺南市七股區	2018-11-25T04:01:23+08:00	5675	1847	7522	899	8421	19950	42.21%	28.45%	24	24
8	臺南市七股區	2018-11-24T22:21:40+08:00	5238	1719	6957	799	7756	18775	41.31%	27.9%	23	24
8	臺南市七股區	2018-11-24T23:41:57+08:00	5675	1847	7522	899	8421	19950	42.21%	28.45%	24	24
8	臺南市七股區	2018-11-25T03:54:34+08:00	5675	1847	7522	899	8421	19950	42.21%	28.45%	24	24
8	臺南市七股區	2018-11-25T01:16:16+08:00	5675	1847	7522	899	8421	19950	42.21%	28.45%	24	24
8	臺南市七股區	2018-11-24T23:45:58+08:00	5675	1847	7522	899	8421	19950	42.21%	28.45%	24	24
8	臺南市七股區	2018-11-24T22:35:40+08:00	5238	1719	6957	799	7756	18775	41.31%	27.9%	23	24
8	臺南市七股區	2018-11-24T23:33:45+08:00	5675	1847	7522	899	8421	19950	42.21%	28.45%	24	24
8	臺南市七股區	2018-11-24T23:37:44+08:00	5675	1847	7522	899	8421	19950	42.21%	28.45%	24	24
8	嘉義市東區	2018-11-24T23:10:59+08:00	31110	10516	41626	3027	44653	83097	53.74%	37.44%	70	81
8	嘉義市東區	2018-11-24T23:22:27+08:00	33154	11251	44405	3331	47736	89278	53.47%	37.14%	74	81
8	嘉義市東區	2018-11-24T23:18:31+08:00	32685	11106	43791	3284	47075	87849	53.59%	37.21%	73	81
8	嘉義市東區	2018-11-24T22:49:28+08:00	28800	9819	38619	2776	41395	77110	53.68%	37.35%	65	81
8	嘉義市東區	2018-11-24T23:33:54+08:00	34358	11706	46064	3453	49517	92512	53.52%	37.14%	76	81
8	嘉義市東區	2018-11-24T22:12:06+08:00	22688	7855	30543	2218	32761	60385	54.25%	37.57%	53	81
8	嘉義市東區	2018-11-24T23:26:11+08:00	33772	11490	45262	3381	48643	90830	53.55%	37.18%	75	81
8	嘉義市東區	2018-11-24T22:28:44+08:00	25725	8832	34557	2527	37084	68753	53.94%	37.42%	59	81
8	嘉義市東區	2018-11-24T23:37:52+08:00	35004	11912	46916	3542	50458	94343	53.48%	37.1%	77	81
8	嘉義市東區	2018-11-25T03:54:46+08:00	37194	12843	50037	3705	53742	100647	53.4%	36.95%	81	81
8	嘉義市東區	2018-11-24T22:53:19+08:00	28800	9819	38619	2776	41395	77110	53.68%	37.35%	65	81
8	嘉義市東區	2018-11-24T22:21:50+08:00	24714	8473	33187	2412	35599	65692	54.19%	37.62%	57	81
8	嘉義市東區	2018-11-25T04:01:33+08:00	37194	12843	50037	3705	53742	100647	53.4%	36.95%	81	81
8	嘉義市東區	2018-11-25T00:08:09+08:00	36658	12799	49457	3671	53128	99243	53.53%	36.94%	80	81
8	嘉義市東區	2018-11-24T23:46:07+08:00	35610	11962	47572	3564	51136	95609	53.48%	37.25%	78	81
8	嘉義市東區	2018-11-25T01:11:12+08:00	37194	12843	50037	3705	53742	100647	53.4%	36.95%	81	81
8	嘉義市東區	2018-11-24T23:42:06+08:00	35004	11912	46916	3542	50458	94343	53.48%	37.1%	77	81
8	嘉義市東區	2018-11-24T23:00:20+08:00	30234	10225	40459	2943	43402	80722	53.77%	37.45%	68	81
8	嘉義市東區	2018-11-24T22:25:29+08:00	25179	8654	33833	2503	36336	66930	54.29%	37.62%	58	81
8	嘉義市東區	2018-11-25T06:22:48+08:00	37194	12843	50037	3705	53742	100647	53.4%	36.95%	81	81
8	嘉義市東區	2018-11-25T03:48:35+08:00	37194	12843	50037	3705	53742	100647	53.4%	36.95%	81	81
8	嘉義市東區	2018-11-24T23:50:19+08:00	35610	11962	47572	3564	51136	95609	53.48%	37.25%	78	81
8	嘉義市東區	2018-11-25T06:27:59+08:00	37194	12843	50037	3705	53742	100647	53.4%	36.95%	81	81
8	嘉義市東區	2018-11-25T06:17:41+08:00	37194	12843	50037	3705	53742	100647	53.4%	36.95%	81	81
8	嘉義市東區	2018-11-24T23:03:51+08:00	30594	10366	40960	2980	43940	81702	53.78%	37.45%	69	81
8	嘉義市東區	2018-11-24T22:39:13+08:00	27464	9366	36830	2686	39516	73325	53.89%	37.46%	62	81
8	嘉義市東區	2018-11-24T22:18:24+08:00	24140	8306	32446	2369	34815	64272	54.17%	37.56%	56	81
8	嘉義市東區	2018-11-25T03:37:34+08:00	37194	12843	50037	3705	53742	100647	53.4%	36.95%	81	81
8	嘉義市東區	2018-11-25T00:12:49+08:00	37194	12843	50037	3705	53742	100647	53.4%	36.95%	81	81
8	嘉義市東區	2018-11-24T23:58:47+08:00	35610	11962	47572	3564	51136	95609	53.48%	37.25%	78	81
8	嘉義市東區	2018-11-24T23:14:45+08:00	31110	10516	41626	3027	44653	83097	53.74%	37.44%	70	81
8	嘉義市東區	2018-11-24T22:56:40+08:00	29653	10076	39729	2893	42622	79294	53.75%	37.4%	67	81
8	嘉義市東區	2018-11-25T01:01:06+08:00	37194	12843	50037	3705	53742	100647	53.4%	36.95%	81	81
8	嘉義市東區	2018-11-25T01:24:29+08:00	37194	12843	50037	3705	53742	100647	53.4%	36.95%	81	81
8	嘉義市東區	2018-11-24T23:54:31+08:00	35026	11766	46792	3487	50279	94042	53.46%	37.25%	77	81
8	嘉義市東區	2018-11-24T23:07:23+08:00	30594	10366	40960	2980	43940	81702	53.78%	37.45%	69	81
8	嘉義市東區	2018-11-25T00:03:40+08:00	36658	12799	49457	3671	53128	99243	53.53%	36.94%	80	81
8	嘉義市東區	2018-11-24T22:14:53+08:00	23125	7973	31098	2239	33337	61477	54.23%	37.62%	54	81
8	嘉義市東區	2018-11-25T00:17:12+08:00	37194	12843	50037	3705	53742	100647	53.4%	36.95%	81	81
8	嘉義市東區	2018-11-24T22:32:22+08:00	25725	8832	34557	2527	37084	68753	53.94%	37.42%	59	81
8	嘉義市東區	2018-11-25T06:12:41+08:00	37194	12843	50037	3705	53742	100647	53.4%	36.95%	81	81
8	嘉義市東區	2018-11-25T01:06:04+08:00	37194	12843	50037	3705	53742	100647	53.4%	36.95%	81	81
8	嘉義市東區	2018-11-24T23:29:51+08:00	33772	11490	45262	3381	48643	90830	53.55%	37.18%	75	81
8	嘉義市東區	2018-11-24T22:40:22+08:00	27825	9524	37349	2715	40064	74405	53.85%	37.4%	63	81
8	嘉義市東區	2018-11-25T03:42:53+08:00	37194	12843	50037	3705	53742	100647	53.4%	36.95%	81	81
8	嘉義市東區	2018-11-25T00:21:48+08:00	37194	12843	50037	3705	53742	100647	53.4%	36.95%	81	81
8	嘉義市東區	2018-11-25T06:07:27+08:00	37194	12843	50037	3705	53742	100647	53.4%	36.95%	81	81
8	嘉義市東區	2018-11-25T00:56:17+08:00	37194	12843	50037	3705	53742	100647	53.4%	36.95%	81	81
8	嘉義市東區	2018-11-24T22:35:48+08:00	26422	8997	35419	2592	38011	70324	54.05%	37.57%	60	81
8	嘉義市東區	2018-11-24T22:43:54+08:00	28800	9819	38619	2776	41395	77110	53.68%	37.35%	65	81
8	嘉義市東區	2018-11-25T03:31:04+08:00	37194	12843	50037	3705	53742	100647	53.4%	36.95%	81	81
8	嘉義市東區	2018-11-25T01:16:27+08:00	37194	12843	50037	3705	53742	100647	53.4%	36.95%	81	81
8	花蓮縣新城鄉	2018-11-24T22:14:51+08:00	3658	963	4621	386	5007	9159	54.67%	39.94%	12	19
8	花蓮縣新城鄉	2018-11-24T23:33:52+08:00	6061	1614	7675	653	8328	15424	53.99%	39.3%	18	19
8	花蓮縣新城鄉	2018-11-24T22:28:42+08:00	4001	1040	5041	409	5450	10044	54.26%	39.83%	13	19
8	花蓮縣新城鄉	2018-11-24T22:56:38+08:00	5167	1397	6564	569	7133	13160	54.2%	39.26%	16	19
8	花蓮縣新城鄉	2018-11-24T23:07:21+08:00	5167	1397	6564	569	7133	13160	54.2%	39.26%	16	19
8	花蓮縣新城鄉	2018-11-24T22:49:26+08:00	4641	1251	5892	502	6394	11797	54.2%	39.34%	15	19
8	花蓮縣新城鄉	2018-11-24T23:10:58+08:00	5167	1397	6564	569	7133	13160	54.2%	39.26%	16	19
8	花蓮縣新城鄉	2018-11-25T06:17:39+08:00	6668	1798	8466	699	9165	17029	53.82%	39.16%	19	19
8	花蓮縣新城鄉	2018-11-24T22:53:17+08:00	5167	1397	6564	569	7133	13160	54.2%	39.26%	16	19
8	花蓮縣新城鄉	2018-11-25T00:08:07+08:00	6061	1614	7675	653	8328	15424	53.99%	39.3%	18	19
8	花蓮縣新城鄉	2018-11-24T22:32:20+08:00	4001	1040	5041	409	5450	10044	54.26%	39.83%	13	19
8	花蓮縣新城鄉	2018-11-25T00:17:10+08:00	6061	1614	7675	653	8328	15424	53.99%	39.3%	18	19
8	花蓮縣新城鄉	2018-11-25T03:48:33+08:00	6668	1798	8466	699	9165	17029	53.82%	39.16%	19	19
8	花蓮縣新城鄉	2018-11-24T23:00:19+08:00	5167	1397	6564	569	7133	13160	54.2%	39.26%	16	19
8	花蓮縣新城鄉	2018-11-25T06:07:25+08:00	6668	1798	8466	699	9165	17029	53.82%	39.16%	19	19
8	花蓮縣新城鄉	2018-11-24T23:29:48+08:00	5643	1512	7155	615	7770	14354	54.13%	39.31%	17	19
8	花蓮縣新城鄉	2018-11-24T22:40:20+08:00	4219	1131	5350	454	5804	10634	54.58%	39.67%	14	19
8	花蓮縣新城鄉	2018-11-25T06:22:46+08:00	6668	1798	8466	699	9165	17029	53.82%	39.16%	19	19
8	花蓮縣新城鄉	2018-11-24T22:25:27+08:00	4001	1040	5041	409	5450	10044	54.26%	39.83%	13	19
8	花蓮縣新城鄉	2018-11-25T03:42:50+08:00	6668	1798	8466	699	9165	17029	53.82%	39.16%	19	19
8	花蓮縣新城鄉	2018-11-24T23:50:17+08:00	6061	1614	7675	653	8328	15424	53.99%	39.3%	18	19
8	花蓮縣新城鄉	2018-11-24T23:14:43+08:00	5167	1397	6564	569	7133	13160	54.2%	39.26%	16	19
8	花蓮縣新城鄉	2018-11-25T01:16:24+08:00	6668	1798	8466	699	9165	17029	53.82%	39.16%	19	19
8	花蓮縣新城鄉	2018-11-25T00:12:47+08:00	6061	1614	7675	653	8328	15424	53.99%	39.3%	18	19
8	花蓮縣新城鄉	2018-11-24T23:54:29+08:00	6061	1614	7675	653	8328	15424	53.99%	39.3%	18	19
8	花蓮縣新城鄉	2018-11-25T06:27:57+08:00	6668	1798	8466	699	9165	17029	53.82%	39.16%	19	19
8	花蓮縣新城鄉	2018-11-25T03:31:01+08:00	6668	1798	8466	699	9165	17029	53.82%	39.16%	19	19
8	花蓮縣新城鄉	2018-11-25T03:37:32+08:00	6668	1798	8466	699	9165	17029	53.82%	39.16%	19	19
8	花蓮縣新城鄉	2018-11-25T00:56:15+08:00	6668	1798	8466	699	9165	17029	53.82%	39.16%	19	19
8	花蓮縣新城鄉	2018-11-24T23:37:50+08:00	6061	1614	7675	653	8328	15424	53.99%	39.3%	18	19
8	花蓮縣新城鄉	2018-11-25T01:24:27+08:00	6668	1798	8466	699	9165	17029	53.82%	39.16%	19	19
8	花蓮縣新城鄉	2018-11-25T03:54:43+08:00	6668	1798	8466	699	9165	17029	53.82%	39.16%	19	19
8	花蓮縣新城鄉	2018-11-24T23:03:49+08:00	5167	1397	6564	569	7133	13160	54.2%	39.26%	16	19
8	花蓮縣新城鄉	2018-11-24T22:12:04+08:00	3658	963	4621	386	5007	9159	54.67%	39.94%	12	19
8	花蓮縣新城鄉	2018-11-24T23:22:25+08:00	5643	1512	7155	615	7770	14354	54.13%	39.31%	17	19
8	花蓮縣新城鄉	2018-11-25T01:06:02+08:00	6668	1798	8466	699	9165	17029	53.82%	39.16%	19	19
8	花蓮縣新城鄉	2018-11-24T23:42:04+08:00	6061	1614	7675	653	8328	15424	53.99%	39.3%	18	19
8	花蓮縣新城鄉	2018-11-25T01:11:10+08:00	6668	1798	8466	699	9165	17029	53.82%	39.16%	19	19
8	花蓮縣新城鄉	2018-11-24T23:46:05+08:00	6061	1614	7675	653	8328	15424	53.99%	39.3%	18	19
8	花蓮縣新城鄉	2018-11-25T04:01:31+08:00	6668	1798	8466	699	9165	17029	53.82%	39.16%	19	19
8	花蓮縣新城鄉	2018-11-25T06:12:39+08:00	6668	1798	8466	699	9165	17029	53.82%	39.16%	19	19
8	花蓮縣新城鄉	2018-11-24T22:21:48+08:00	4001	1040	5041	409	5450	10044	54.26%	39.83%	13	19
8	花蓮縣新城鄉	2018-11-25T00:21:46+08:00	6061	1614	7675	653	8328	15424	53.99%	39.3%	18	19
8	花蓮縣新城鄉	2018-11-25T01:01:04+08:00	6668	1798	8466	699	9165	17029	53.82%	39.16%	19	19
8	花蓮縣新城鄉	2018-11-24T22:35:46+08:00	4219	1131	5350	454	5804	10634	54.58%	39.67%	14	19
8	花蓮縣新城鄉	2018-11-24T23:18:29+08:00	5643	1512	7155	615	7770	14354	54.13%	39.31%	17	19
8	花蓮縣新城鄉	2018-11-24T23:58:45+08:00	6061	1614	7675	653	8328	15424	53.99%	39.3%	18	19
8	花蓮縣新城鄉	2018-11-24T22:18:21+08:00	3658	963	4621	386	5007	9159	54.67%	39.94%	12	19
8	花蓮縣新城鄉	2018-11-24T22:39:11+08:00	4219	1131	5350	454	5804	10634	54.58%	39.67%	14	19
8	花蓮縣新城鄉	2018-11-24T23:26:09+08:00	5643	1512	7155	615	7770	14354	54.13%	39.31%	17	19
8	花蓮縣新城鄉	2018-11-25T00:03:37+08:00	6061	1614	7675	653	8328	15424	53.99%	39.3%	18	19
8	花蓮縣新城鄉	2018-11-24T22:43:52+08:00	4219	1131	5350	454	5804	10634	54.58%	39.67%	14	19
8	雲林縣西螺鎮	2018-11-24T22:39:08+08:00	8702	2890	11592	1421	13013	24442	53.24%	35.6%	24	34
8	雲林縣西螺鎮	2018-11-25T03:37:28+08:00	13352	4447	17799	2186	19985	38142	52.4%	35.01%	34	34
8	雲林縣西螺鎮	2018-11-25T01:24:23+08:00	13352	4447	17799	2186	19985	38142	52.4%	35.01%	34	34
8	雲林縣西螺鎮	2018-11-24T23:07:17+08:00	11726	3869	15595	1862	17457	33342	52.36%	35.17%	30	34
8	雲林縣西螺鎮	2018-11-24T22:12:01+08:00	5496	1805	7301	847	8148	15261	53.39%	36.01%	17	34
8	雲林縣西螺鎮	2018-11-24T22:32:17+08:00	8179	2702	10881	1351	12232	22926	53.35%	35.68%	23	34
8	雲林縣西螺鎮	2018-11-25T03:48:28+08:00	13352	4447	17799	2186	19985	38142	52.4%	35.01%	34	34
8	雲林縣西螺鎮	2018-11-25T03:30:58+08:00	13352	4447	17799	2186	19985	38142	52.4%	35.01%	34	34
8	雲林縣西螺鎮	2018-11-24T23:42:01+08:00	13352	4447	17799	2186	19985	38142	52.4%	35.01%	34	34
8	雲林縣西螺鎮	2018-11-24T22:21:45+08:00	7176	2392	9568	1240	10808	20287	53.28%	35.37%	21	34
8	雲林縣西螺鎮	2018-11-25T06:07:22+08:00	13352	4447	17799	2186	19985	38142	52.4%	35.01%	34	34
8	雲林縣西螺鎮	2018-11-25T04:01:28+08:00	13352	4447	17799	2186	19985	38142	52.4%	35.01%	34	34
8	雲林縣西螺鎮	2018-11-25T00:21:43+08:00	13352	4447	17799	2186	19985	38142	52.4%	35.01%	34	34
8	雲林縣西螺鎮	2018-11-25T01:11:06+08:00	13352	4447	17799	2186	19985	38142	52.4%	35.01%	34	34
8	雲林縣西螺鎮	2018-11-24T22:40:18+08:00	9249	3075	12324	1489	13813	26032	53.06%	35.53%	25	34
8	雲林縣西螺鎮	2018-11-24T23:00:16+08:00	11035	3680	14715	1761	16476	31601	52.14%	34.92%	29	34
8	雲林縣西螺鎮	2018-11-24T23:37:48+08:00	12777	4243	17020	2079	19099	36564	52.23%	34.94%	33	34
8	雲林縣西螺鎮	2018-11-25T03:54:39+08:00	13352	4447	17799	2186	19985	38142	52.4%	35.01%	34	34
8	雲林縣西螺鎮	2018-11-25T01:01:00+08:00	13352	4447	17799	2186	19985	38142	52.4%	35.01%	34	34
8	雲林縣西螺鎮	2018-11-24T23:33:49+08:00	12777	4243	17020	2079	19099	36564	52.23%	34.94%	33	34
8	雲林縣西螺鎮	2018-11-25T00:03:33+08:00	13352	4447	17799	2186	19985	38142	52.4%	35.01%	34	34
8	雲林縣西螺鎮	2018-11-24T22:35:43+08:00	8179	2702	10881	1351	12232	22926	53.35%	35.68%	23	34
8	雲林縣西螺鎮	2018-11-24T23:54:26+08:00	13352	4447	17799	2186	19985	38142	52.4%	35.01%	34	34
8	雲林縣西螺鎮	2018-11-24T23:58:41+08:00	13352	4447	17799	2186	19985	38142	52.4%	35.01%	34	34
8	雲林縣西螺鎮	2018-11-25T00:56:12+08:00	13352	4447	17799	2186	19985	38142	52.4%	35.01%	34	34
8	雲林縣西螺鎮	2018-11-24T22:56:35+08:00	11035	3680	14715	1761	16476	31601	52.14%	34.92%	29	34
8	雲林縣西螺鎮	2018-11-25T06:17:35+08:00	13352	4447	17799	2186	19985	38142	52.4%	35.01%	34	34
8	雲林縣西螺鎮	2018-11-24T22:49:23+08:00	9634	3219	12853	1543	14396	27336	52.66%	35.24%	26	34
8	雲林縣西螺鎮	2018-11-24T23:22:22+08:00	12503	4140	16643	2032	18675	35698	52.31%	35.02%	32	34
8	雲林縣西螺鎮	2018-11-24T22:43:49+08:00	9634	3219	12853	1543	14396	27336	52.66%	35.24%	26	34
8	雲林縣西螺鎮	2018-11-24T23:03:46+08:00	11726	3869	15595	1862	17457	33342	52.36%	35.17%	30	34
8	雲林縣西螺鎮	2018-11-24T23:10:55+08:00	11726	3869	15595	1862	17457	33342	52.36%	35.17%	30	34
8	雲林縣西螺鎮	2018-11-25T00:08:03+08:00	13352	4447	17799	2186	19985	38142	52.4%	35.01%	34	34
8	雲林縣西螺鎮	2018-11-25T03:42:47+08:00	13352	4447	17799	2186	19985	38142	52.4%	35.01%	34	34
8	雲林縣西螺鎮	2018-11-24T22:53:14+08:00	10515	3509	14024	1701	15725	30149	52.16%	34.88%	28	34
8	雲林縣西螺鎮	2018-11-24T23:46:02+08:00	13352	4447	17799	2186	19985	38142	52.4%	35.01%	34	34
8	雲林縣西螺鎮	2018-11-25T00:17:07+08:00	13352	4447	17799	2186	19985	38142	52.4%	35.01%	34	34
8	雲林縣西螺鎮	2018-11-24T23:29:45+08:00	12777	4243	17020	2079	19099	36564	52.23%	34.94%	33	34
8	雲林縣西螺鎮	2018-11-25T06:22:44+08:00	13352	4447	17799	2186	19985	38142	52.4%	35.01%	34	34
8	雲林縣西螺鎮	2018-11-25T06:12:36+08:00	13352	4447	17799	2186	19985	38142	52.4%	35.01%	34	34
8	雲林縣西螺鎮	2018-11-24T22:25:24+08:00	7797	2593	10390	1297	11687	21912	53.34%	35.58%	22	34
8	雲林縣西螺鎮	2018-11-25T01:05:58+08:00	13352	4447	17799	2186	19985	38142	52.4%	35.01%	34	34
8	雲林縣西螺鎮	2018-11-25T00:12:44+08:00	13352	4447	17799	2186	19985	38142	52.4%	35.01%	34	34
8	雲林縣西螺鎮	2018-11-24T23:26:06+08:00	12777	4243	17020	2079	19099	36564	52.23%	34.94%	33	34
8	雲林縣西螺鎮	2018-11-24T22:18:18+08:00	5846	1910	7756	908	8664	16232	53.38%	36.02%	18	34
8	雲林縣西螺鎮	2018-11-25T06:27:54+08:00	13352	4447	17799	2186	19985	38142	52.4%	35.01%	34	34
8	雲林縣西螺鎮	2018-11-24T23:50:14+08:00	13352	4447	17799	2186	19985	38142	52.4%	35.01%	34	34
8	雲林縣西螺鎮	2018-11-24T23:14:40+08:00	11726	3869	15595	1862	17457	33342	52.36%	35.17%	30	34
8	雲林縣西螺鎮	2018-11-24T22:28:39+08:00	8179	2702	10881	1351	12232	22926	53.35%	35.68%	23	34
8	雲林縣西螺鎮	2018-11-24T22:14:48+08:00	5496	1805	7301	847	8148	15261	53.39%	36.01%	17	34
8	雲林縣西螺鎮	2018-11-25T01:16:21+08:00	13352	4447	17799	2186	19985	38142	52.4%	35.01%	34	34
8	雲林縣西螺鎮	2018-11-24T23:18:26+08:00	12071	3990	16061	1930	17991	34325	52.41%	35.17%	31	34
8	雲林縣東勢鄉	2018-11-24T22:39:08+08:00	3609	1228	4837	747	5584	11706	47.7%	30.83%	14	15
8	雲林縣東勢鄉	2018-11-25T03:37:28+08:00	4190	1419	5609	843	6452	13239	48.73%	31.65%	15	15
8	雲林縣東勢鄉	2018-11-24T23:07:18+08:00	4190	1419	5609	843	6452	13239	48.73%	31.65%	15	15
8	雲林縣東勢鄉	2018-11-25T01:24:24+08:00	4190	1419	5609	843	6452	13239	48.73%	31.65%	15	15
8	雲林縣東勢鄉	2018-11-25T03:54:40+08:00	4190	1419	5609	843	6452	13239	48.73%	31.65%	15	15
8	雲林縣東勢鄉	2018-11-24T22:32:18+08:00	3609	1228	4837	747	5584	11706	47.7%	30.83%	14	15
8	雲林縣東勢鄉	2018-11-25T03:30:58+08:00	4190	1419	5609	843	6452	13239	48.73%	31.65%	15	15
8	雲林縣東勢鄉	2018-11-24T23:42:01+08:00	4190	1419	5609	843	6452	13239	48.73%	31.65%	15	15
8	雲林縣東勢鄉	2018-11-25T03:48:29+08:00	4190	1419	5609	843	6452	13239	48.73%	31.65%	15	15
8	雲林縣東勢鄉	2018-11-24T22:21:45+08:00	3284	1121	4405	692	5097	10684	47.71%	30.74%	13	15
8	雲林縣東勢鄉	2018-11-25T06:07:22+08:00	4190	1419	5609	843	6452	13239	48.73%	31.65%	15	15
8	雲林縣東勢鄉	2018-11-25T04:01:28+08:00	4190	1419	5609	843	6452	13239	48.73%	31.65%	15	15
8	雲林縣東勢鄉	2018-11-25T00:21:43+08:00	4190	1419	5609	843	6452	13239	48.73%	31.65%	15	15
8	雲林縣東勢鄉	2018-11-25T01:11:06+08:00	4190	1419	5609	843	6452	13239	48.73%	31.65%	15	15
8	雲林縣東勢鄉	2018-11-24T22:40:18+08:00	3609	1228	4837	747	5584	11706	47.7%	30.83%	14	15
8	雲林縣東勢鄉	2018-11-24T23:00:16+08:00	4190	1419	5609	843	6452	13239	48.73%	31.65%	15	15
8	雲林縣東勢鄉	2018-11-24T23:37:48+08:00	4190	1419	5609	843	6452	13239	48.73%	31.65%	15	15
8	雲林縣東勢鄉	2018-11-25T00:56:13+08:00	4190	1419	5609	843	6452	13239	48.73%	31.65%	15	15
8	雲林縣東勢鄉	2018-11-25T01:01:00+08:00	4190	1419	5609	843	6452	13239	48.73%	31.65%	15	15
8	雲林縣東勢鄉	2018-11-24T23:33:49+08:00	4190	1419	5609	843	6452	13239	48.73%	31.65%	15	15
8	雲林縣東勢鄉	2018-11-25T00:03:33+08:00	4190	1419	5609	843	6452	13239	48.73%	31.65%	15	15
8	雲林縣東勢鄉	2018-11-24T22:35:44+08:00	3609	1228	4837	747	5584	11706	47.7%	30.83%	14	15
8	雲林縣東勢鄉	2018-11-24T23:54:26+08:00	4190	1419	5609	843	6452	13239	48.73%	31.65%	15	15
8	雲林縣東勢鄉	2018-11-24T22:56:35+08:00	4190	1419	5609	843	6452	13239	48.73%	31.65%	15	15
8	雲林縣東勢鄉	2018-11-25T06:17:35+08:00	4190	1419	5609	843	6452	13239	48.73%	31.65%	15	15
8	雲林縣東勢鄉	2018-11-24T22:49:23+08:00	3609	1228	4837	747	5584	11706	47.7%	30.83%	14	15
8	雲林縣東勢鄉	2018-11-24T23:22:22+08:00	4190	1419	5609	843	6452	13239	48.73%	31.65%	15	15
8	雲林縣東勢鄉	2018-11-24T22:43:49+08:00	3609	1228	4837	747	5584	11706	47.7%	30.83%	14	15
8	雲林縣東勢鄉	2018-11-24T23:03:46+08:00	4190	1419	5609	843	6452	13239	48.73%	31.65%	15	15
8	雲林縣東勢鄉	2018-11-24T23:10:55+08:00	4190	1419	5609	843	6452	13239	48.73%	31.65%	15	15
8	雲林縣東勢鄉	2018-11-24T22:12:02+08:00	3284	1121	4405	692	5097	10684	47.71%	30.74%	13	15
8	雲林縣東勢鄉	2018-11-25T00:08:04+08:00	4190	1419	5609	843	6452	13239	48.73%	31.65%	15	15
8	雲林縣東勢鄉	2018-11-25T03:42:47+08:00	4190	1419	5609	843	6452	13239	48.73%	31.65%	15	15
8	雲林縣東勢鄉	2018-11-24T22:53:14+08:00	4190	1419	5609	843	6452	13239	48.73%	31.65%	15	15
8	雲林縣東勢鄉	2018-11-24T23:46:03+08:00	4190	1419	5609	843	6452	13239	48.73%	31.65%	15	15
8	雲林縣東勢鄉	2018-11-25T00:17:07+08:00	4190	1419	5609	843	6452	13239	48.73%	31.65%	15	15
8	雲林縣東勢鄉	2018-11-24T23:29:45+08:00	4190	1419	5609	843	6452	13239	48.73%	31.65%	15	15
8	雲林縣東勢鄉	2018-11-25T06:22:44+08:00	4190	1419	5609	843	6452	13239	48.73%	31.65%	15	15
8	雲林縣東勢鄉	2018-11-25T06:12:36+08:00	4190	1419	5609	843	6452	13239	48.73%	31.65%	15	15
8	雲林縣東勢鄉	2018-11-24T22:25:24+08:00	3284	1121	4405	692	5097	10684	47.71%	30.74%	13	15
8	雲林縣東勢鄉	2018-11-25T01:05:58+08:00	4190	1419	5609	843	6452	13239	48.73%	31.65%	15	15
8	雲林縣東勢鄉	2018-11-25T00:12:44+08:00	4190	1419	5609	843	6452	13239	48.73%	31.65%	15	15
8	雲林縣東勢鄉	2018-11-24T23:26:06+08:00	4190	1419	5609	843	6452	13239	48.73%	31.65%	15	15
8	雲林縣東勢鄉	2018-11-25T06:27:54+08:00	4190	1419	5609	843	6452	13239	48.73%	31.65%	15	15
8	雲林縣東勢鄉	2018-11-24T23:50:14+08:00	4190	1419	5609	843	6452	13239	48.73%	31.65%	15	15
8	雲林縣東勢鄉	2018-11-24T23:14:40+08:00	4190	1419	5609	843	6452	13239	48.73%	31.65%	15	15
8	雲林縣東勢鄉	2018-11-24T22:18:19+08:00	3284	1121	4405	692	5097	10684	47.71%	30.74%	13	15
8	雲林縣東勢鄉	2018-11-24T23:58:42+08:00	4190	1419	5609	843	6452	13239	48.73%	31.65%	15	15
8	雲林縣東勢鄉	2018-11-24T22:28:39+08:00	3609	1228	4837	747	5584	11706	47.7%	30.83%	14	15
8	雲林縣東勢鄉	2018-11-24T22:14:48+08:00	3284	1121	4405	692	5097	10684	47.71%	30.74%	13	15
8	雲林縣東勢鄉	2018-11-25T01:16:21+08:00	4190	1419	5609	843	6452	13239	48.73%	31.65%	15	15
8	雲林縣東勢鄉	2018-11-24T23:18:26+08:00	4190	1419	5609	843	6452	13239	48.73%	31.65%	15	15
8	基隆市	2018-11-24T23:10:59+08:00	93259	27027	120286	8671	128957	252417	51.09%	36.95%	217	257
8	基隆市	2018-11-24T22:49:27+08:00	83652	24448	108100	7923	116023	226306	51.27%	36.96%	199	257
8	基隆市	2018-11-24T23:22:27+08:00	97383	28110	125493	8974	134467	263246	51.08%	36.99%	224	257
8	基隆市	2018-11-24T23:18:31+08:00	96328	27843	124171	8863	133034	260174	51.13%	37.02%	222	257
8	基隆市	2018-11-24T23:33:54+08:00	101725	29300	131025	9319	140344	274939	51.05%	37%	231	257
8	基隆市	2018-11-24T22:12:06+08:00	63016	18478	81494	6163	87657	171268	51.18%	36.79%	158	257
8	基隆市	2018-11-24T23:26:11+08:00	98962	28533	127495	9097	136592	267550	51.05%	36.99%	227	257
8	基隆市	2018-11-24T22:56:39+08:00	86853	25313	112166	8175	120341	234943	51.22%	36.97%	205	257
8	基隆市	2018-11-24T22:28:44+08:00	74184	21892	96076	7252	103328	202374	51.06%	36.66%	182	257
8	基隆市	2018-11-24T23:37:52+08:00	103104	29686	132790	9476	142266	278890	51.01%	36.97%	234	257
8	基隆市	2018-11-24T22:53:19+08:00	85185	24916	110101	8095	118196	230555	51.27%	36.95%	202	257
8	基隆市	2018-11-24T22:21:50+08:00	71898	21113	93011	7031	100042	196094	51.02%	36.67%	177	257
8	基隆市	2018-11-25T04:01:33+08:00	118570	33570	152140	10546	162686	320030	50.83%	37.05%	257	257
8	基隆市	2018-11-24T23:46:07+08:00	105171	30193	135364	9576	144940	284461	50.95%	36.97%	237	257
8	基隆市	2018-11-25T01:11:12+08:00	118038	33419	151457	10504	161961	318630	50.83%	37.05%	256	257
8	基隆市	2018-11-25T00:08:08+08:00	109129	31101	140230	9867	150097	294756	50.92%	37.02%	243	257
8	基隆市	2018-11-24T23:00:20+08:00	88027	25624	113651	8242	121893	238445	51.12%	36.92%	207	257
8	基隆市	2018-11-24T22:25:29+08:00	73239	21641	94880	7182	102062	199976	51.04%	36.62%	180	257
8	基隆市	2018-11-25T06:22:48+08:00	118570	33570	152140	10546	162686	320030	50.83%	37.05%	257	257
8	基隆市	2018-11-25T03:48:35+08:00	118570	33570	152140	10546	162686	320030	50.83%	37.05%	257	257
8	基隆市	2018-11-25T06:17:41+08:00	118570	33570	152140	10546	162686	320030	50.83%	37.05%	257	257
8	基隆市	2018-11-24T22:39:13+08:00	76541	22497	99038	7405	106443	208490	51.05%	36.71%	186	257
8	基隆市	2018-11-25T00:12:49+08:00	110372	31430	141802	9942	151744	297873	50.94%	37.05%	245	257
8	基隆市	2018-11-25T03:37:33+08:00	118570	33570	152140	10546	162686	320030	50.83%	37.05%	257	257
8	基隆市	2018-11-24T22:18:23+08:00	68653	20237	88890	6703	95593	187053	51.1%	36.7%	170	257
8	基隆市	2018-11-24T23:50:18+08:00	106986	30586	137572	9755	147327	288796	51.01%	37.05%	240	257
8	基隆市	2018-11-24T23:14:45+08:00	95044	27482	122526	8789	131315	257003	51.09%	36.98%	220	257
8	基隆市	2018-11-24T23:58:46+08:00	107596	30748	138344	9809	148153	290365	51.02%	37.06%	241	257
8	基隆市	2018-11-24T23:03:50+08:00	89982	26144	116126	8418	124544	243483	51.15%	36.96%	211	257
8	基隆市	2018-11-25T01:01:06+08:00	118038	33419	151457	10504	161961	318630	50.83%	37.05%	256	257
8	基隆市	2018-11-25T06:27:58+08:00	118570	33570	152140	10546	162686	320030	50.83%	37.05%	257	257
8	基隆市	2018-11-25T01:24:29+08:00	118570	33570	152140	10546	162686	320030	50.83%	37.05%	257	257
8	基隆市	2018-11-24T23:54:31+08:00	106986	30586	137572	9755	147327	288796	51.01%	37.05%	240	257
8	基隆市	2018-11-25T03:54:45+08:00	118570	33570	152140	10546	162686	320030	50.83%	37.05%	257	257
8	基隆市	2018-11-24T23:07:22+08:00	92008	26705	118713	8558	127271	249414	51.03%	36.89%	215	257
8	基隆市	2018-11-24T22:14:53+08:00	64679	19060	83739	6341	90080	175846	51.23%	36.78%	162	257
8	基隆市	2018-11-25T06:12:40+08:00	118570	33570	152140	10546	162686	320030	50.83%	37.05%	257	257
8	基隆市	2018-11-24T23:29:50+08:00	101019	29085	130104	9258	139362	272977	51.05%	37.01%	230	257
8	基隆市	2018-11-25T00:17:12+08:00	111812	31818	143630	10049	153679	301760	50.93%	37.05%	247	257
8	基隆市	2018-11-24T22:32:22+08:00	74699	22014	96713	7272	103985	203752	51.04%	36.66%	183	257
8	基隆市	2018-11-24T23:42:05+08:00	103723	29841	133564	9509	143073	280813	50.95%	36.94%	235	257
8	基隆市	2018-11-25T01:06:04+08:00	118038	33419	151457	10504	161961	318630	50.83%	37.05%	256	257
8	基隆市	2018-11-25T00:21:47+08:00	114608	32403	147011	10217	157228	309040	50.88%	37.09%	251	257
8	基隆市	2018-11-25T03:42:52+08:00	118570	33570	152140	10546	162686	320030	50.83%	37.05%	257	257
8	基隆市	2018-11-25T06:07:26+08:00	118570	33570	152140	10546	162686	320030	50.83%	37.05%	257	257
8	基隆市	2018-11-24T22:40:22+08:00	77374	22748	100122	7479	107601	210625	51.09%	36.74%	188	257
8	基隆市	2018-11-25T00:56:17+08:00	118038	33419	151457	10504	161961	318630	50.83%	37.05%	256	257
8	基隆市	2018-11-24T22:35:48+08:00	75848	22311	98159	7344	105503	206887	51%	36.66%	185	257
8	基隆市	2018-11-24T22:43:54+08:00	79579	23331	102910	7641	110551	215968	51.19%	36.85%	192	257
8	基隆市	2018-11-25T03:31:03+08:00	118570	33570	152140	10546	162686	320030	50.83%	37.05%	257	257
8	基隆市	2018-11-25T01:16:26+08:00	118570	33570	152140	10546	162686	320030	50.83%	37.05%	257	257
8	基隆市	2018-11-25T00:03:39+08:00	108442	30927	139369	9839	149208	293188	50.89%	36.99%	242	257
8	新竹縣新埔鎮	2018-11-24T22:39:06+08:00	9651	2607	12258	957	13215	23779	55.57%	40.59%	25	30
8	新竹縣新埔鎮	2018-11-24T23:03:44+08:00	11353	3113	14466	1124	15590	27877	55.92%	40.73%	29	30
8	新竹縣新埔鎮	2018-11-24T23:22:20+08:00	11786	3223	15009	1170	16179	28894	55.99%	40.79%	30	30
8	新竹縣新埔鎮	2018-11-24T23:58:39+08:00	11786	3223	15009	1170	16179	28894	55.99%	40.79%	30	30
8	新竹縣新埔鎮	2018-11-24T22:49:21+08:00	10941	2999	13940	1098	15038	27039	55.62%	40.46%	28	30
8	新竹縣新埔鎮	2018-11-25T03:42:44+08:00	11786	3223	15009	1170	16179	28894	55.99%	40.79%	30	30
8	新竹縣新埔鎮	2018-11-24T23:46:01+08:00	11786	3223	15009	1170	16179	28894	55.99%	40.79%	30	30
8	新竹縣新埔鎮	2018-11-25T01:00:57+08:00	11786	3223	15009	1170	16179	28894	55.99%	40.79%	30	30
8	新竹縣新埔鎮	2018-11-25T03:48:26+08:00	11786	3223	15009	1170	16179	28894	55.99%	40.79%	30	30
8	新竹縣新埔鎮	2018-11-24T22:53:11+08:00	11353	3113	14466	1124	15590	27877	55.92%	40.73%	29	30
8	新竹縣新埔鎮	2018-11-25T00:08:01+08:00	11786	3223	15009	1170	16179	28894	55.99%	40.79%	30	30
8	新竹縣新埔鎮	2018-11-24T22:21:42+08:00	9133	2456	11589	908	12497	22350	55.91%	40.86%	24	30
8	新竹縣新埔鎮	2018-11-25T04:01:26+08:00	11786	3223	15009	1170	16179	28894	55.99%	40.79%	30	30
8	新竹縣新埔鎮	2018-11-25T06:12:34+08:00	11786	3223	15009	1170	16179	28894	55.99%	40.79%	30	30
8	新竹縣新埔鎮	2018-11-24T22:40:16+08:00	10129	2767	12896	1017	13913	24901	55.87%	40.68%	26	30
8	新竹縣新埔鎮	2018-11-24T22:25:20+08:00	9133	2456	11589	908	12497	22350	55.91%	40.86%	24	30
8	新竹縣新埔鎮	2018-11-25T00:17:05+08:00	11786	3223	15009	1170	16179	28894	55.99%	40.79%	30	30
8	新竹縣新埔鎮	2018-11-24T23:18:24+08:00	11353	3113	14466	1124	15590	27877	55.92%	40.73%	29	30
8	新竹縣新埔鎮	2018-11-24T23:37:46+08:00	11786	3223	15009	1170	16179	28894	55.99%	40.79%	30	30
8	新竹縣新埔鎮	2018-11-24T22:35:42+08:00	9133	2456	11589	908	12497	22350	55.91%	40.86%	24	30
8	新竹縣新埔鎮	2018-11-25T03:54:37+08:00	11786	3223	15009	1170	16179	28894	55.99%	40.79%	30	30
8	新竹縣新埔鎮	2018-11-24T23:33:47+08:00	11786	3223	15009	1170	16179	28894	55.99%	40.79%	30	30
8	新竹縣新埔鎮	2018-11-25T01:05:55+08:00	11786	3223	15009	1170	16179	28894	55.99%	40.79%	30	30
8	新竹縣新埔鎮	2018-11-24T23:26:04+08:00	11786	3223	15009	1170	16179	28894	55.99%	40.79%	30	30
8	新竹縣新埔鎮	2018-11-24T22:14:45+08:00	7684	2069	9753	764	10517	18787	55.98%	40.9%	21	30
8	新竹縣新埔鎮	2018-11-25T06:17:32+08:00	11786	3223	15009	1170	16179	28894	55.99%	40.79%	30	30
8	新竹縣新埔鎮	2018-11-25T03:37:22+08:00	11786	3223	15009	1170	16179	28894	55.99%	40.79%	30	30
8	新竹縣新埔鎮	2018-11-24T23:07:15+08:00	11353	3113	14466	1124	15590	27877	55.92%	40.73%	29	30
8	新竹縣新埔鎮	2018-11-24T23:14:37+08:00	11353	3113	14466	1124	15590	27877	55.92%	40.73%	29	30
8	新竹縣新埔鎮	2018-11-24T23:10:53+08:00	11353	3113	14466	1124	15590	27877	55.92%	40.73%	29	30
8	新竹縣新埔鎮	2018-11-24T22:43:47+08:00	10496	2868	13364	1054	14418	25879	55.71%	40.56%	27	30
8	新竹縣新埔鎮	2018-11-24T22:56:33+08:00	11353	3113	14466	1124	15590	27877	55.92%	40.73%	29	30
8	新竹縣新埔鎮	2018-11-25T01:24:21+08:00	11786	3223	15009	1170	16179	28894	55.99%	40.79%	30	30
8	新竹縣新埔鎮	2018-11-25T03:30:55+08:00	11786	3223	15009	1170	16179	28894	55.99%	40.79%	30	30
8	新竹縣新埔鎮	2018-11-24T22:32:15+08:00	9133	2456	11589	908	12497	22350	55.91%	40.86%	24	30
8	新竹縣新埔鎮	2018-11-24T22:11:59+08:00	7684	2069	9753	764	10517	18787	55.98%	40.9%	21	30
8	新竹縣新埔鎮	2018-11-24T23:00:14+08:00	11353	3113	14466	1124	15590	27877	55.92%	40.73%	29	30
8	新竹縣新埔鎮	2018-11-25T06:07:19+08:00	11786	3223	15009	1170	16179	28894	55.99%	40.79%	30	30
8	新竹縣新埔鎮	2018-11-25T01:11:03+08:00	11786	3223	15009	1170	16179	28894	55.99%	40.79%	30	30
8	新竹縣新埔鎮	2018-11-24T23:29:43+08:00	11786	3223	15009	1170	16179	28894	55.99%	40.79%	30	30
8	新竹縣新埔鎮	2018-11-25T00:21:41+08:00	11786	3223	15009	1170	16179	28894	55.99%	40.79%	30	30
8	新竹縣新埔鎮	2018-11-25T06:22:42+08:00	11786	3223	15009	1170	16179	28894	55.99%	40.79%	30	30
8	新竹縣新埔鎮	2018-11-25T00:56:10+08:00	11786	3223	15009	1170	16179	28894	55.99%	40.79%	30	30
8	新竹縣新埔鎮	2018-11-24T22:18:16+08:00	8153	2197	10350	818	11168	19999	55.84%	40.77%	22	30
8	新竹縣新埔鎮	2018-11-24T23:54:24+08:00	11786	3223	15009	1170	16179	28894	55.99%	40.79%	30	30
8	新竹縣新埔鎮	2018-11-24T23:41:59+08:00	11786	3223	15009	1170	16179	28894	55.99%	40.79%	30	30
8	新竹縣新埔鎮	2018-11-25T01:16:18+08:00	11786	3223	15009	1170	16179	28894	55.99%	40.79%	30	30
8	新竹縣新埔鎮	2018-11-25T06:27:52+08:00	11786	3223	15009	1170	16179	28894	55.99%	40.79%	30	30
8	新竹縣新埔鎮	2018-11-25T00:12:42+08:00	11786	3223	15009	1170	16179	28894	55.99%	40.79%	30	30
8	新竹縣新埔鎮	2018-11-24T22:28:37+08:00	9133	2456	11589	908	12497	22350	55.91%	40.86%	24	30
8	新竹縣新埔鎮	2018-11-25T00:03:30+08:00	11786	3223	15009	1170	16179	28894	55.99%	40.79%	30	30
8	新竹縣新埔鎮	2018-11-24T23:50:12+08:00	11786	3223	15009	1170	16179	28894	55.99%	40.79%	30	30
8	新竹縣五峰鄉	2018-11-24T23:07:16+08:00	724	208	932	49	981	2388	41.08%	30.32%	4	6
8	新竹縣五峰鄉	2018-11-24T22:12:00+08:00	250	78	328	29	357	672	53.13%	37.2%	1	6
8	新竹縣五峰鄉	2018-11-24T22:39:06+08:00	401	117	518	36	554	1266	43.76%	31.67%	2	6
8	新竹縣五峰鄉	2018-11-24T23:22:20+08:00	724	208	932	49	981	2388	41.08%	30.32%	4	6
8	新竹縣五峰鄉	2018-11-24T23:58:39+08:00	998	276	1274	75	1349	3284	41.08%	30.39%	5	6
8	新竹縣五峰鄉	2018-11-24T23:03:45+08:00	724	208	932	49	981	2388	41.08%	30.32%	4	6
8	新竹縣五峰鄉	2018-11-24T22:49:21+08:00	508	147	655	45	700	1661	42.14%	30.58%	3	6
8	新竹縣五峰鄉	2018-11-24T23:46:01+08:00	724	208	932	49	981	2388	41.08%	30.32%	4	6
8	新竹縣五峰鄉	2018-11-25T03:48:26+08:00	1217	347	1564	87	1651	3997	41.31%	30.45%	6	6
8	新竹縣五峰鄉	2018-11-25T03:30:56+08:00	1217	347	1564	87	1651	3997	41.31%	30.45%	6	6
8	新竹縣五峰鄉	2018-11-25T03:42:45+08:00	1217	347	1564	87	1651	3997	41.31%	30.45%	6	6
8	新竹縣五峰鄉	2018-11-25T01:00:58+08:00	1217	347	1564	87	1651	3997	41.31%	30.45%	6	6
8	新竹縣五峰鄉	2018-11-25T00:08:01+08:00	998	276	1274	75	1349	3284	41.08%	30.39%	5	6
8	新竹縣五峰鄉	2018-11-25T04:01:26+08:00	1217	347	1564	87	1651	3997	41.31%	30.45%	6	6
8	新竹縣五峰鄉	2018-11-24T22:25:21+08:00	401	117	518	36	554	1266	43.76%	31.67%	2	6
8	新竹縣五峰鄉	2018-11-25T06:12:34+08:00	1217	347	1564	87	1651	3997	41.31%	30.45%	6	6
8	新竹縣五峰鄉	2018-11-24T22:40:16+08:00	401	117	518	36	554	1266	43.76%	31.67%	2	6
8	新竹縣五峰鄉	2018-11-24T22:21:43+08:00	401	117	518	36	554	1266	43.76%	31.67%	2	6
8	新竹縣五峰鄉	2018-11-25T00:17:05+08:00	998	276	1274	75	1349	3284	41.08%	30.39%	5	6
8	新竹縣五峰鄉	2018-11-24T23:18:24+08:00	724	208	932	49	981	2388	41.08%	30.32%	4	6
8	新竹縣五峰鄉	2018-11-24T23:37:46+08:00	724	208	932	49	981	2388	41.08%	30.32%	4	6
8	新竹縣五峰鄉	2018-11-24T22:35:42+08:00	401	117	518	36	554	1266	43.76%	31.67%	2	6
8	新竹縣五峰鄉	2018-11-25T03:54:37+08:00	1217	347	1564	87	1651	3997	41.31%	30.45%	6	6
8	新竹縣五峰鄉	2018-11-24T23:33:47+08:00	724	208	932	49	981	2388	41.08%	30.32%	4	6
8	新竹縣五峰鄉	2018-11-24T23:26:04+08:00	724	208	932	49	981	2388	41.08%	30.32%	4	6
8	新竹縣五峰鄉	2018-11-24T23:14:37+08:00	724	208	932	49	981	2388	41.08%	30.32%	4	6
8	新竹縣五峰鄉	2018-11-24T23:10:53+08:00	724	208	932	49	981	2388	41.08%	30.32%	4	6
8	新竹縣五峰鄉	2018-11-25T06:17:33+08:00	1217	347	1564	87	1651	3997	41.31%	30.45%	6	6
8	新竹縣五峰鄉	2018-11-24T22:43:47+08:00	508	147	655	45	700	1661	42.14%	30.58%	3	6
8	新竹縣五峰鄉	2018-11-25T01:24:21+08:00	1217	347	1564	87	1651	3997	41.31%	30.45%	6	6
8	新竹縣五峰鄉	2018-11-24T22:56:34+08:00	724	208	932	49	981	2388	41.08%	30.32%	4	6
8	新竹縣五峰鄉	2018-11-25T03:37:24+08:00	1217	347	1564	87	1651	3997	41.31%	30.45%	6	6
8	新竹縣五峰鄉	2018-11-24T22:53:12+08:00	508	147	655	45	700	1661	42.14%	30.58%	3	6
8	新竹縣五峰鄉	2018-11-24T22:32:15+08:00	401	117	518	36	554	1266	43.76%	31.67%	2	6
8	新竹縣五峰鄉	2018-11-24T23:00:14+08:00	724	208	932	49	981	2388	41.08%	30.32%	4	6
8	新竹縣五峰鄉	2018-11-25T01:11:03+08:00	1217	347	1564	87	1651	3997	41.31%	30.45%	6	6
8	新竹縣五峰鄉	2018-11-24T23:29:43+08:00	724	208	932	49	981	2388	41.08%	30.32%	4	6
8	新竹縣五峰鄉	2018-11-25T00:21:41+08:00	998	276	1274	75	1349	3284	41.08%	30.39%	5	6
8	新竹縣五峰鄉	2018-11-25T06:22:42+08:00	1217	347	1564	87	1651	3997	41.31%	30.45%	6	6
8	新竹縣五峰鄉	2018-11-25T06:07:20+08:00	1217	347	1564	87	1651	3997	41.31%	30.45%	6	6
8	新竹縣五峰鄉	2018-11-25T01:05:56+08:00	1217	347	1564	87	1651	3997	41.31%	30.45%	6	6
8	新竹縣五峰鄉	2018-11-24T23:54:24+08:00	998	276	1274	75	1349	3284	41.08%	30.39%	5	6
8	新竹縣五峰鄉	2018-11-24T23:41:59+08:00	724	208	932	49	981	2388	41.08%	30.32%	4	6
8	新竹縣五峰鄉	2018-11-25T01:16:18+08:00	1217	347	1564	87	1651	3997	41.31%	30.45%	6	6
8	新竹縣五峰鄉	2018-11-25T00:03:31+08:00	998	276	1274	75	1349	3284	41.08%	30.39%	5	6
8	新竹縣五峰鄉	2018-11-24T22:14:46+08:00	250	78	328	29	357	672	53.13%	37.2%	1	6
8	新竹縣五峰鄉	2018-11-25T06:27:52+08:00	1217	347	1564	87	1651	3997	41.31%	30.45%	6	6
8	新竹縣五峰鄉	2018-11-25T00:56:11+08:00	1217	347	1564	87	1651	3997	41.31%	30.45%	6	6
8	新竹縣五峰鄉	2018-11-24T22:18:17+08:00	401	117	518	36	554	1266	43.76%	31.67%	2	6
8	新竹縣五峰鄉	2018-11-25T00:12:42+08:00	998	276	1274	75	1349	3284	41.08%	30.39%	5	6
8	新竹縣五峰鄉	2018-11-24T22:28:37+08:00	401	117	518	36	554	1266	43.76%	31.67%	2	6
8	新竹縣五峰鄉	2018-11-24T23:50:12+08:00	998	276	1274	75	1349	3284	41.08%	30.39%	5	6
8	臺中市梧棲區	2018-11-24T23:10:50+08:00	18726	5879	24605	2163	26768	47040	56.9%	39.81%	36	36
8	臺中市梧棲區	2018-11-25T00:56:06+08:00	18726	5879	24605	2163	26768	47040	56.9%	39.81%	36	36
8	臺中市梧棲區	2018-11-24T23:14:33+08:00	18726	5879	24605	2163	26768	47040	56.9%	39.81%	36	36
8	臺中市梧棲區	2018-11-24T23:22:16+08:00	18726	5879	24605	2163	26768	47040	56.9%	39.81%	36	36
8	臺中市梧棲區	2018-11-25T00:12:39+08:00	18726	5879	24605	2163	26768	47040	56.9%	39.81%	36	36
8	臺中市梧棲區	2018-11-24T22:49:17+08:00	17692	5591	23283	2048	25331	44455	56.98%	39.8%	34	36
8	臺中市梧棲區	2018-11-25T03:37:18+08:00	18726	5879	24605	2163	26768	47040	56.9%	39.81%	36	36
8	臺中市梧棲區	2018-11-24T22:43:43+08:00	17692	5591	23283	2048	25331	44455	56.98%	39.8%	34	36
8	臺中市梧棲區	2018-11-25T00:03:26+08:00	18726	5879	24605	2163	26768	47040	56.9%	39.81%	36	36
8	臺中市梧棲區	2018-11-25T01:10:59+08:00	18726	5879	24605	2163	26768	47040	56.9%	39.81%	36	36
8	臺中市梧棲區	2018-11-24T22:56:30+08:00	18153	5723	23876	2095	25971	45590	56.97%	39.82%	35	36
8	臺中市梧棲區	2018-11-25T06:22:39+08:00	18726	5879	24605	2163	26768	47040	56.9%	39.81%	36	36
8	臺中市梧棲區	2018-11-25T03:30:51+08:00	18726	5879	24605	2163	26768	47040	56.9%	39.81%	36	36
8	臺中市梧棲區	2018-11-24T22:25:17+08:00	17692	5591	23283	2048	25331	44455	56.98%	39.8%	34	36
8	臺中市梧棲區	2018-11-24T23:29:40+08:00	18726	5879	24605	2163	26768	47040	56.9%	39.81%	36	36
8	臺中市梧棲區	2018-11-25T01:16:15+08:00	18726	5879	24605	2163	26768	47040	56.9%	39.81%	36	36
8	臺中市梧棲區	2018-11-24T23:54:18+08:00	18726	5879	24605	2163	26768	47040	56.9%	39.81%	36	36
8	臺中市梧棲區	2018-11-25T00:07:57+08:00	18726	5879	24605	2163	26768	47040	56.9%	39.81%	36	36
8	臺中市梧棲區	2018-11-24T22:14:42+08:00	15876	4978	20854	1850	22704	39518	57.45%	40.17%	31	36
8	臺中市梧棲區	2018-11-24T22:18:13+08:00	16417	5133	21550	1905	23455	40917	57.32%	40.12%	32	36
8	臺中市梧棲區	2018-11-24T22:28:33+08:00	17692	5591	23283	2048	25331	44455	56.98%	39.8%	34	36
8	臺中市梧棲區	2018-11-24T23:50:08+08:00	18726	5879	24605	2163	26768	47040	56.9%	39.81%	36	36
8	臺中市梧棲區	2018-11-25T01:24:16+08:00	18726	5879	24605	2163	26768	47040	56.9%	39.81%	36	36
8	臺中市梧棲區	2018-11-24T23:07:12+08:00	18726	5879	24605	2163	26768	47040	56.9%	39.81%	36	36
8	臺中市梧棲區	2018-11-24T22:39:02+08:00	17692	5591	23283	2048	25331	44455	56.98%	39.8%	34	36
8	臺中市梧棲區	2018-11-25T06:27:48+08:00	18726	5879	24605	2163	26768	47040	56.9%	39.81%	36	36
8	臺中市梧棲區	2018-11-24T22:35:39+08:00	17692	5591	23283	2048	25331	44455	56.98%	39.8%	34	36
8	臺中市梧棲區	2018-11-24T23:58:35+08:00	18726	5879	24605	2163	26768	47040	56.9%	39.81%	36	36
8	臺中市梧棲區	2018-11-24T23:03:41+08:00	18153	5723	23876	2095	25971	45590	56.97%	39.82%	35	36
8	臺中市梧棲區	2018-11-25T01:00:53+08:00	18726	5879	24605	2163	26768	47040	56.9%	39.81%	36	36
8	臺中市梧棲區	2018-11-24T23:00:08+08:00	18153	5723	23876	2095	25971	45590	56.97%	39.82%	35	36
8	臺中市梧棲區	2018-11-25T03:48:22+08:00	18726	5879	24605	2163	26768	47040	56.9%	39.81%	36	36
8	臺中市梧棲區	2018-11-25T00:21:37+08:00	18726	5879	24605	2163	26768	47040	56.9%	39.81%	36	36
8	臺中市梧棲區	2018-11-25T03:42:40+08:00	18726	5879	24605	2163	26768	47040	56.9%	39.81%	36	36
8	臺中市梧棲區	2018-11-24T22:21:39+08:00	17060	5346	22406	1987	24393	42713	57.11%	39.94%	33	36
8	臺中市梧棲區	2018-11-24T22:32:12+08:00	17692	5591	23283	2048	25331	44455	56.98%	39.8%	34	36
8	臺中市梧棲區	2018-11-25T04:01:22+08:00	18726	5879	24605	2163	26768	47040	56.9%	39.81%	36	36
8	臺中市梧棲區	2018-11-25T00:17:01+08:00	18726	5879	24605	2163	26768	47040	56.9%	39.81%	36	36
8	臺中市梧棲區	2018-11-24T22:40:13+08:00	17692	5591	23283	2048	25331	44455	56.98%	39.8%	34	36
8	臺中市梧棲區	2018-11-24T22:53:07+08:00	18153	5723	23876	2095	25971	45590	56.97%	39.82%	35	36
8	臺中市梧棲區	2018-11-25T06:12:31+08:00	18726	5879	24605	2163	26768	47040	56.9%	39.81%	36	36
8	臺中市梧棲區	2018-11-24T22:11:56+08:00	15876	4978	20854	1850	22704	39518	57.45%	40.17%	31	36
8	臺中市梧棲區	2018-11-25T06:07:16+08:00	18726	5879	24605	2163	26768	47040	56.9%	39.81%	36	36
8	臺中市梧棲區	2018-11-25T03:54:33+08:00	18726	5879	24605	2163	26768	47040	56.9%	39.81%	36	36
8	臺中市梧棲區	2018-11-25T01:05:51+08:00	18726	5879	24605	2163	26768	47040	56.9%	39.81%	36	36
8	臺中市梧棲區	2018-11-24T23:26:01+08:00	18726	5879	24605	2163	26768	47040	56.9%	39.81%	36	36
8	臺中市梧棲區	2018-11-24T23:33:43+08:00	18726	5879	24605	2163	26768	47040	56.9%	39.81%	36	36
8	臺中市梧棲區	2018-11-25T06:17:29+08:00	18726	5879	24605	2163	26768	47040	56.9%	39.81%	36	36
8	臺中市梧棲區	2018-11-24T23:41:56+08:00	18726	5879	24605	2163	26768	47040	56.9%	39.81%	36	36
8	臺中市梧棲區	2018-11-24T23:37:43+08:00	18726	5879	24605	2163	26768	47040	56.9%	39.81%	36	36
8	臺中市梧棲區	2018-11-24T23:18:21+08:00	18726	5879	24605	2163	26768	47040	56.9%	39.81%	36	36
8	臺中市梧棲區	2018-11-24T23:45:57+08:00	18726	5879	24605	2163	26768	47040	56.9%	39.81%	36	36
8	臺中市西區	2018-11-25T03:37:17+08:00	39299	12191	51490	3481	54971	95040	57.84%	41.35%	66	66
8	臺中市西區	2018-11-24T23:10:50+08:00	36632	11387	48019	3254	51273	88725	57.79%	41.29%	62	66
8	臺中市西區	2018-11-25T00:56:06+08:00	39299	12191	51490	3481	54971	95040	57.84%	41.35%	66	66
8	臺中市西區	2018-11-24T23:22:16+08:00	37348	11584	48932	3304	52236	90338	57.82%	41.34%	63	66
8	臺中市西區	2018-11-25T01:10:58+08:00	39299	12191	51490	3481	54971	95040	57.84%	41.35%	66	66
8	臺中市西區	2018-11-25T00:12:37+08:00	39299	12191	51490	3481	54971	95040	57.84%	41.35%	66	66
8	臺中市西區	2018-11-24T22:49:17+08:00	34832	10808	45640	3105	48745	84144	57.93%	41.4%	59	66
8	臺中市西區	2018-11-24T23:14:32+08:00	37348	11584	48932	3304	52236	90338	57.82%	41.34%	63	66
8	臺中市西區	2018-11-24T22:43:43+08:00	34163	10586	44749	3062	47811	82608	57.88%	41.36%	58	66
8	臺中市西區	2018-11-25T00:03:26+08:00	38694	12011	50705	3419	54124	93586	57.83%	41.35%	65	66
8	臺中市西區	2018-11-24T22:56:30+08:00	35436	11009	46445	3138	49583	85649	57.89%	41.37%	60	66
8	臺中市西區	2018-11-25T03:48:21+08:00	39299	12191	51490	3481	54971	95040	57.84%	41.35%	66	66
8	臺中市西區	2018-11-25T06:22:38+08:00	39299	12191	51490	3481	54971	95040	57.84%	41.35%	66	66
8	臺中市西區	2018-11-25T03:30:51+08:00	39299	12191	51490	3481	54971	95040	57.84%	41.35%	66	66
8	臺中市西區	2018-11-25T04:01:21+08:00	39299	12191	51490	3481	54971	95040	57.84%	41.35%	66	66
8	臺中市西區	2018-11-24T22:25:17+08:00	29378	9080	38458	2681	41139	70952	57.98%	41.41%	51	66
8	臺中市西區	2018-11-25T06:07:15+08:00	39299	12191	51490	3481	54971	95040	57.84%	41.35%	66	66
8	臺中市西區	2018-11-24T23:29:40+08:00	38025	11755	49780	3345	53125	91768	57.89%	41.44%	64	66
8	臺中市西區	2018-11-24T22:18:12+08:00	25802	7868	33670	2326	35996	62006	58.05%	41.61%	45	66
8	臺中市西區	2018-11-24T23:54:18+08:00	38694	12011	50705	3419	54124	93586	57.83%	41.35%	65	66
8	臺中市西區	2018-11-25T00:07:57+08:00	39299	12191	51490	3481	54971	95040	57.84%	41.35%	66	66
8	臺中市西區	2018-11-25T01:16:14+08:00	39299	12191	51490	3481	54971	95040	57.84%	41.35%	66	66
8	臺中市西區	2018-11-24T23:41:55+08:00	38025	11755	49780	3345	53125	91768	57.89%	41.44%	64	66
8	臺中市西區	2018-11-24T22:28:33+08:00	30594	9446	40040	2759	42799	73791	58%	41.46%	53	66
8	臺中市西區	2018-11-24T23:58:34+08:00	38694	12011	50705	3419	54124	93586	57.83%	41.35%	65	66
8	臺中市西區	2018-11-24T23:50:08+08:00	38694	12011	50705	3419	54124	93586	57.83%	41.35%	65	66
8	臺中市西區	2018-11-25T01:24:16+08:00	39299	12191	51490	3481	54971	95040	57.84%	41.35%	66	66
8	臺中市西區	2018-11-24T22:35:38+08:00	31948	9944	41892	2881	44773	77140	58.04%	41.42%	55	66
8	臺中市西區	2018-11-24T23:07:12+08:00	36632	11387	48019	3254	51273	88725	57.79%	41.29%	62	66
8	臺中市西區	2018-11-24T22:39:02+08:00	32660	10191	42851	2938	45789	79092	57.89%	41.29%	56	66
8	臺中市西區	2018-11-25T06:27:48+08:00	39299	12191	51490	3481	54971	95040	57.84%	41.35%	66	66
8	臺中市西區	2018-11-24T23:03:41+08:00	36632	11387	48019	3254	51273	88725	57.79%	41.29%	62	66
8	臺中市西區	2018-11-25T01:00:53+08:00	39299	12191	51490	3481	54971	95040	57.84%	41.35%	66	66
8	臺中市西區	2018-11-25T00:21:37+08:00	39299	12191	51490	3481	54971	95040	57.84%	41.35%	66	66
8	臺中市西區	2018-11-24T22:21:38+08:00	28848	8927	37775	2636	40411	69777	57.91%	41.34%	50	66
8	臺中市西區	2018-11-25T03:42:40+08:00	39299	12191	51490	3481	54971	95040	57.84%	41.35%	66	66
8	臺中市西區	2018-11-24T23:00:07+08:00	35436	11009	46445	3138	49583	85649	57.89%	41.37%	60	66
8	臺中市西區	2018-11-24T22:32:12+08:00	31172	9667	40839	2814	43653	75219	58.03%	41.44%	54	66
8	臺中市西區	2018-11-25T06:12:30+08:00	39299	12191	51490	3481	54971	95040	57.84%	41.35%	66	66
8	臺中市西區	2018-11-24T22:40:12+08:00	32660	10191	42851	2938	45789	79092	57.89%	41.29%	56	66
8	臺中市西區	2018-11-25T00:17:01+08:00	39299	12191	51490	3481	54971	95040	57.84%	41.35%	66	66
8	臺中市西區	2018-11-24T22:53:07+08:00	35436	11009	46445	3138	49583	85649	57.89%	41.37%	60	66
8	臺中市西區	2018-11-24T22:11:56+08:00	24519	7396	31915	2196	34111	58825	57.99%	41.68%	43	66
8	臺中市西區	2018-11-25T03:54:33+08:00	39299	12191	51490	3481	54971	95040	57.84%	41.35%	66	66
8	臺中市西區	2018-11-25T01:05:51+08:00	39299	12191	51490	3481	54971	95040	57.84%	41.35%	66	66
8	臺中市西區	2018-11-24T23:26:01+08:00	38025	11755	49780	3345	53125	91768	57.89%	41.44%	64	66
8	臺中市西區	2018-11-24T23:33:43+08:00	38025	11755	49780	3345	53125	91768	57.89%	41.44%	64	66
8	臺中市西區	2018-11-24T23:18:20+08:00	37348	11584	48932	3304	52236	90338	57.82%	41.34%	63	66
8	臺中市西區	2018-11-25T06:17:29+08:00	39299	12191	51490	3481	54971	95040	57.84%	41.35%	66	66
8	臺中市西區	2018-11-24T23:37:42+08:00	38025	11755	49780	3345	53125	91768	57.89%	41.44%	64	66
8	臺中市西區	2018-11-24T22:14:41+08:00	25213	7676	32889	2259	35148	60607	57.99%	41.6%	44	66
8	臺中市西區	2018-11-24T23:45:57+08:00	38694	12011	50705	3419	54124	93586	57.83%	41.35%	65	66
8	臺北市大同區	2018-11-24T23:07:11+08:00	30020	12007	42027	3739	45766	79840	57.32%	37.6%	62	82
8	臺北市大同區	2018-11-25T01:05:49+08:00	39404	15844	55248	4945	60193	104675	57.5%	37.64%	80	82
8	臺北市大同區	2018-11-24T22:49:16+08:00	26544	10554	37098	3360	40458	70796	57.15%	37.49%	55	82
8	臺北市大同區	2018-11-24T22:39:01+08:00	22871	9161	32032	2933	34965	60140	58.14%	38.03%	48	82
8	臺北市大同區	2018-11-24T22:43:42+08:00	24437	9679	34116	3133	37249	65037	57.27%	37.57%	51	82
8	臺北市大同區	2018-11-24T23:50:05+08:00	33045	13176	46221	4202	50423	87914	57.35%	37.59%	68	82
8	臺北市大同區	2018-11-25T01:10:56+08:00	39404	15844	55248	4945	60193	104675	57.5%	37.64%	80	82
8	臺北市大同區	2018-11-24T22:39:00+08:00	22871	9161	32032	2933	34965	60140	58.14%	38.03%	48	82
8	臺北市大同區	2018-11-25T03:37:16+08:00	40451	16258	56709	5064	61773	107557	57.43%	37.61%	82	82
8	臺北市大同區	2018-11-25T01:10:57+08:00	39404	15844	55248	4945	60193	104675	57.5%	37.64%	80	82
8	臺北市大同區	2018-11-24T23:50:04+08:00	33045	13176	46221	4202	50423	87914	57.35%	37.59%	68	82
8	臺北市大同區	2018-11-25T01:24:14+08:00	40451	16258	56709	5064	61773	107557	57.43%	37.61%	82	82
8	臺北市大同區	2018-11-25T00:12:36+08:00	34549	13822	48371	4353	52724	91831	57.41%	37.62%	71	82
8	臺北市大同區	2018-11-24T22:32:10+08:00	22355	8992	31347	2902	34249	58776	58.27%	38.03%	47	82
8	臺北市大同區	2018-11-24T23:29:38+08:00	32053	12752	44805	4022	48827	85269	57.26%	37.59%	66	82
8	臺北市大同區	2018-11-25T06:22:36+08:00	40451	16258	56709	5064	61773	107557	57.43%	37.61%	82	82
8	臺北市大同區	2018-11-25T06:12:29+08:00	40451	16258	56709	5064	61773	107557	57.43%	37.61%	82	82
8	臺北市大同區	2018-11-25T00:21:35+08:00	36598	14658	51256	4575	55831	97669	57.16%	37.47%	75	82
8	臺北市大同區	2018-11-24T23:00:03+08:00	28044	11160	39204	3543	42747	74669	57.25%	37.56%	58	82
8	臺北市大同區	2018-11-25T03:48:20+08:00	40451	16258	56709	5064	61773	107557	57.43%	37.61%	82	82
8	臺北市大同區	2018-11-24T23:25:59+08:00	32053	12752	44805	4022	48827	85269	57.26%	37.59%	66	82
8	臺北市大同區	2018-11-24T23:29:39+08:00	32053	12752	44805	4022	48827	85269	57.26%	37.59%	66	82
8	臺北市大同區	2018-11-24T23:00:04+08:00	28044	11160	39204	3543	42747	74669	57.25%	37.56%	58	82
8	臺北市大同區	2018-11-25T01:00:51+08:00	39404	15844	55248	4945	60193	104675	57.5%	37.64%	80	82
8	臺北市大同區	2018-11-25T06:07:14+08:00	40451	16258	56709	5064	61773	107557	57.43%	37.61%	82	82
8	臺北市大同區	2018-11-24T22:53:05+08:00	27541	10963	38504	3508	42012	73321	57.3%	37.56%	57	82
8	臺北市大同區	2018-11-24T22:40:11+08:00	23887	9495	33382	3048	36430	62578	58.22%	38.17%	50	82
8	臺北市大同區	2018-11-24T22:25:16+08:00	20717	8359	29076	2703	31779	54534	58.27%	37.99%	44	82
8	臺北市大同區	2018-11-24T22:11:55+08:00	18257	7395	25652	2489	28141	47982	58.65%	38.05%	39	82
8	臺北市大同區	2018-11-25T04:01:20+08:00	40451	16258	56709	5064	61773	107557	57.43%	37.61%	82	82
8	臺北市大同區	2018-11-25T01:16:12+08:00	39404	15844	55248	4945	60193	104675	57.5%	37.64%	80	82
8	臺北市大同區	2018-11-25T00:07:56+08:00	34549	13822	48371	4353	52724	91831	57.41%	37.62%	71	82
8	臺北市大同區	2018-11-24T23:37:41+08:00	32590	12973	45563	4115	49678	86653	57.33%	37.61%	67	82
8	臺北市大同區	2018-11-24T23:41:54+08:00	33045	13176	46221	4202	50423	87914	57.35%	37.59%	68	82
8	臺北市大同區	2018-11-24T22:28:32+08:00	21873	8774	30647	2822	33469	57520	58.19%	38.03%	46	82
8	臺北市大同區	2018-11-25T01:16:13+08:00	39404	15844	55248	4945	60193	104675	57.5%	37.64%	80	82
8	臺北市大同區	2018-11-25T03:54:31+08:00	40451	16258	56709	5064	61773	107557	57.43%	37.61%	82	82
8	臺北市大同區	2018-11-24T23:33:41+08:00	32053	12752	44805	4022	48827	85269	57.26%	37.59%	66	82
8	臺北市大同區	2018-11-24T23:54:17+08:00	33550	13370	46920	4239	51159	89203	57.35%	37.61%	69	82
8	臺北市大同區	2018-11-25T00:03:24+08:00	34549	13822	48371	4353	52724	91831	57.41%	37.62%	71	82
8	臺北市大同區	2018-11-24T22:35:36+08:00	22355	8992	31347	2902	34249	58776	58.27%	38.03%	47	82
8	臺北市大同區	2018-11-25T00:16:59+08:00	35524	14201	49725	4439	54164	94626	57.24%	37.54%	73	82
8	臺北市大同區	2018-11-24T23:58:33+08:00	34549	13822	48371	4353	52724	91831	57.41%	37.62%	71	82
8	臺北市大同區	2018-11-24T22:14:39+08:00	19643	7937	27580	2605	30185	51748	58.33%	37.96%	42	82
8	臺北市大同區	2018-11-24T22:43:41+08:00	24437	9679	34116	3133	37249	65037	57.27%	37.57%	51	82
8	臺北市大同區	2018-11-24T23:03:40+08:00	30020	12007	42027	3739	45766	79840	57.32%	37.6%	62	82
8	臺北市大同區	2018-11-24T23:14:30+08:00	31573	12552	44125	3935	48060	83940	57.26%	37.61%	65	82
8	臺北市大同區	2018-11-24T23:22:14+08:00	31573	12552	44125	3935	48060	83940	57.26%	37.61%	65	82
8	臺北市大同區	2018-11-24T23:58:32+08:00	34549	13822	48371	4353	52724	91831	57.41%	37.62%	71	82
8	臺北市大同區	2018-11-25T03:37:15+08:00	40451	16258	56709	5064	61773	107557	57.43%	37.61%	82	82
8	臺北市大同區	2018-11-25T00:56:03+08:00	39404	15844	55248	4945	60193	104675	57.5%	37.64%	80	82
8	臺北市大同區	2018-11-25T00:56:04+08:00	39404	15844	55248	4945	60193	104675	57.5%	37.64%	80	82
8	臺北市大同區	2018-11-24T23:14:31+08:00	31573	12552	44125	3935	48060	83940	57.26%	37.61%	65	82
8	臺北市大同區	2018-11-25T06:27:47+08:00	40451	16258	56709	5064	61773	107557	57.43%	37.61%	82	82
8	臺北市大同區	2018-11-24T22:21:36+08:00	20717	8359	29076	2703	31779	54534	58.27%	37.99%	44	82
8	臺北市大同區	2018-11-25T00:17:00+08:00	35524	14201	49725	4439	54164	94626	57.24%	37.54%	73	82
8	臺北市大同區	2018-11-25T03:42:37+08:00	40451	16258	56709	5064	61773	107557	57.43%	37.61%	82	82
8	臺北市大同區	2018-11-25T03:30:49+08:00	40451	16258	56709	5064	61773	107557	57.43%	37.61%	82	82
8	臺北市大同區	2018-11-25T03:42:36+08:00	40451	16258	56709	5064	61773	107557	57.43%	37.61%	82	82
8	臺北市大同區	2018-11-24T22:25:15+08:00	20717	8359	29076	2703	31779	54534	58.27%	37.99%	44	82
8	臺北市大同區	2018-11-24T22:18:11+08:00	19643	7937	27580	2605	30185	51748	58.33%	37.96%	42	82
8	臺北市大同區	2018-11-24T22:28:31+08:00	21873	8774	30647	2822	33469	57520	58.19%	38.03%	46	82
8	臺北市大同區	2018-11-24T23:10:48+08:00	30020	12007	42027	3739	45766	79840	57.32%	37.6%	62	82
8	臺北市大同區	2018-11-24T22:14:40+08:00	19643	7937	27580	2605	30185	51748	58.33%	37.96%	42	82
8	臺北市大同區	2018-11-25T06:17:27+08:00	40451	16258	56709	5064	61773	107557	57.43%	37.61%	82	82
8	臺北市大同區	2018-11-24T22:56:29+08:00	28044	11160	39204	3543	42747	74669	57.25%	37.56%	58	82
8	臺北市大同區	2018-11-24T23:45:56+08:00	33045	13176	46221	4202	50423	87914	57.35%	37.59%	68	82
8	臺北市大同區	2018-11-25T00:07:55+08:00	34549	13822	48371	4353	52724	91831	57.41%	37.62%	71	82
8	臺北市大同區	2018-11-24T23:33:42+08:00	32053	12752	44805	4022	48827	85269	57.26%	37.59%	66	82
8	臺北市大同區	2018-11-24T23:10:49+08:00	30020	12007	42027	3739	45766	79840	57.32%	37.6%	62	82
8	臺北市大同區	2018-11-25T03:54:32+08:00	40451	16258	56709	5064	61773	107557	57.43%	37.61%	82	82
8	臺北市大同區	2018-11-24T23:18:19+08:00	31573	12552	44125	3935	48060	83940	57.26%	37.61%	65	82
8	連江縣	2018-11-24T23:26:10+08:00	1997	344	2341	118	2459	4744	51.83%	42.1%	5	9
8	連江縣	2018-11-24T23:10:59+08:00	1094	202	1296	59	1355	2619	51.74%	41.77%	3	9
8	連江縣	2018-11-24T22:49:27+08:00	1094	202	1296	59	1355	2619	51.74%	41.77%	3	9
8	連江縣	2018-11-24T23:22:27+08:00	1997	344	2341	118	2459	4744	51.83%	42.1%	5	9
8	連江縣	2018-11-24T23:18:31+08:00	1751	310	2061	108	2169	4134	52.47%	42.36%	4	9
8	連江縣	2018-11-24T23:33:54+08:00	1997	344	2341	118	2459	4744	51.83%	42.1%	5	9
8	連江縣	2018-11-24T22:12:06+08:00	0	0	0	0	0	0	0%	0%	0	9
8	連江縣	2018-11-24T22:56:39+08:00	1094	202	1296	59	1355	2619	51.74%	41.77%	3	9
8	連江縣	2018-11-24T22:28:43+08:00	264	57	321	14	335	698	47.99%	37.82%	1	9
8	連江縣	2018-11-24T23:37:52+08:00	1997	344	2341	118	2459	4744	51.83%	42.1%	5	9
8	連江縣	2018-11-24T22:53:19+08:00	1094	202	1296	59	1355	2619	51.74%	41.77%	3	9
8	連江縣	2018-11-25T00:17:11+08:00	1997	344	2341	118	2459	4744	51.83%	42.1%	5	9
8	連江縣	2018-11-24T22:32:21+08:00	264	57	321	14	335	698	47.99%	37.82%	1	9
8	連江縣	2018-11-24T22:21:50+08:00	0	0	0	0	0	0	0%	0%	0	9
8	連江縣	2018-11-25T04:01:33+08:00	4705	769	5474	257	5731	11205	51.15%	41.99%	9	9
8	連江縣	2018-11-24T23:46:07+08:00	1997	344	2341	118	2459	4744	51.83%	42.1%	5	9
8	連江縣	2018-11-25T00:08:08+08:00	1997	344	2341	118	2459	4744	51.83%	42.1%	5	9
8	連江縣	2018-11-24T23:00:20+08:00	1094	202	1296	59	1355	2619	51.74%	41.77%	3	9
8	連江縣	2018-11-24T22:25:29+08:00	0	0	0	0	0	0	0%	0%	0	9
8	連江縣	2018-11-25T06:22:48+08:00	4705	769	5474	257	5731	11205	51.15%	41.99%	9	9
8	連江縣	2018-11-25T03:48:35+08:00	4705	769	5474	257	5731	11205	51.15%	41.99%	9	9
8	連江縣	2018-11-24T22:39:13+08:00	610	124	734	43	777	1481	52.46%	41.19%	2	9
8	連江縣	2018-11-25T00:12:49+08:00	1997	344	2341	118	2459	4744	51.83%	42.1%	5	9
8	連江縣	2018-11-25T03:37:33+08:00	4705	769	5474	257	5731	11205	51.15%	41.99%	9	9
8	連江縣	2018-11-24T22:18:23+08:00	0	0	0	0	0	0	0%	0%	0	9
8	連江縣	2018-11-24T23:50:18+08:00	1997	344	2341	118	2459	4744	51.83%	42.1%	5	9
8	連江縣	2018-11-24T23:14:45+08:00	1094	202	1296	59	1355	2619	51.74%	41.77%	3	9
8	連江縣	2018-11-24T23:58:46+08:00	1997	344	2341	118	2459	4744	51.83%	42.1%	5	9
8	連江縣	2018-11-24T23:03:50+08:00	1094	202	1296	59	1355	2619	51.74%	41.77%	3	9
8	連江縣	2018-11-25T06:27:58+08:00	4705	769	5474	257	5731	11205	51.15%	41.99%	9	9
8	連江縣	2018-11-25T06:17:40+08:00	4705	769	5474	257	5731	11205	51.15%	41.99%	9	9
8	連江縣	2018-11-24T23:54:31+08:00	1997	344	2341	118	2459	4744	51.83%	42.1%	5	9
8	連江縣	2018-11-24T22:14:52+08:00	0	0	0	0	0	0	0%	0%	0	9
8	連江縣	2018-11-25T01:24:28+08:00	4705	769	5474	257	5731	11205	51.15%	41.99%	9	9
8	連江縣	2018-11-25T03:54:45+08:00	4705	769	5474	257	5731	11205	51.15%	41.99%	9	9
8	連江縣	2018-11-24T23:07:22+08:00	1094	202	1296	59	1355	2619	51.74%	41.77%	3	9
8	連江縣	2018-11-25T06:12:40+08:00	4705	769	5474	257	5731	11205	51.15%	41.99%	9	9
8	連江縣	2018-11-24T23:29:50+08:00	1997	344	2341	118	2459	4744	51.83%	42.1%	5	9
8	連江縣	2018-11-24T23:42:05+08:00	1997	344	2341	118	2459	4744	51.83%	42.1%	5	9
8	連江縣	2018-11-25T01:06:04+08:00	4015	691	4706	231	4937	9662	51.1%	41.55%	8	9
8	連江縣	2018-11-25T01:11:11+08:00	4705	769	5474	257	5731	11205	51.15%	41.99%	9	9
8	連江縣	2018-11-25T00:21:47+08:00	1997	344	2341	118	2459	4744	51.83%	42.1%	5	9
8	連江縣	2018-11-25T03:42:52+08:00	4705	769	5474	257	5731	11205	51.15%	41.99%	9	9
8	連江縣	2018-11-25T06:07:26+08:00	4705	769	5474	257	5731	11205	51.15%	41.99%	9	9
8	連江縣	2018-11-24T22:40:22+08:00	610	124	734	43	777	1481	52.46%	41.19%	2	9
8	連江縣	2018-11-25T00:56:17+08:00	2827	483	3310	162	3472	6711	51.74%	42.12%	6	9
8	連江縣	2018-11-24T22:35:48+08:00	610	124	734	43	777	1481	52.46%	41.19%	2	9
8	連江縣	2018-11-24T22:43:54+08:00	1094	202	1296	59	1355	2619	51.74%	41.77%	3	9
8	連江縣	2018-11-25T03:31:03+08:00	4705	769	5474	257	5731	11205	51.15%	41.99%	9	9
8	連江縣	2018-11-25T01:01:05+08:00	4015	691	4706	231	4937	9662	51.1%	41.55%	8	9
8	連江縣	2018-11-25T01:16:26+08:00	4705	769	5474	257	5731	11205	51.15%	41.99%	9	9
8	連江縣	2018-11-25T00:03:39+08:00	1997	344	2341	118	2459	4744	51.83%	42.1%	5	9
8	雲林縣水林鄉	2018-11-24T22:39:08+08:00	6110	2137	8247	1214	9461	22508	42.03%	27.15%	26	26
8	雲林縣水林鄉	2018-11-24T23:07:18+08:00	6110	2137	8247	1214	9461	22508	42.03%	27.15%	26	26
8	雲林縣水林鄉	2018-11-24T22:56:36+08:00	6110	2137	8247	1214	9461	22508	42.03%	27.15%	26	26
8	雲林縣水林鄉	2018-11-25T01:24:24+08:00	6110	2137	8247	1214	9461	22508	42.03%	27.15%	26	26
8	雲林縣水林鄉	2018-11-25T03:54:40+08:00	6110	2137	8247	1214	9461	22508	42.03%	27.15%	26	26
8	雲林縣水林鄉	2018-11-25T03:37:29+08:00	6110	2137	8247	1214	9461	22508	42.03%	27.15%	26	26
8	雲林縣水林鄉	2018-11-24T22:32:18+08:00	6110	2137	8247	1214	9461	22508	42.03%	27.15%	26	26
8	雲林縣水林鄉	2018-11-25T03:30:58+08:00	6110	2137	8247	1214	9461	22508	42.03%	27.15%	26	26
8	雲林縣水林鄉	2018-11-24T23:42:01+08:00	6110	2137	8247	1214	9461	22508	42.03%	27.15%	26	26
8	雲林縣水林鄉	2018-11-25T03:48:29+08:00	6110	2137	8247	1214	9461	22508	42.03%	27.15%	26	26
8	雲林縣水林鄉	2018-11-24T22:21:45+08:00	6110	2137	8247	1214	9461	22508	42.03%	27.15%	26	26
8	雲林縣水林鄉	2018-11-25T06:07:22+08:00	6110	2137	8247	1214	9461	22508	42.03%	27.15%	26	26
8	雲林縣水林鄉	2018-11-25T00:21:44+08:00	6110	2137	8247	1214	9461	22508	42.03%	27.15%	26	26
8	雲林縣水林鄉	2018-11-24T23:29:46+08:00	6110	2137	8247	1214	9461	22508	42.03%	27.15%	26	26
8	雲林縣水林鄉	2018-11-24T22:40:18+08:00	6110	2137	8247	1214	9461	22508	42.03%	27.15%	26	26
8	雲林縣水林鄉	2018-11-25T04:01:29+08:00	6110	2137	8247	1214	9461	22508	42.03%	27.15%	26	26
8	雲林縣水林鄉	2018-11-24T23:00:16+08:00	6110	2137	8247	1214	9461	22508	42.03%	27.15%	26	26
8	雲林縣水林鄉	2018-11-25T01:11:07+08:00	6110	2137	8247	1214	9461	22508	42.03%	27.15%	26	26
8	雲林縣水林鄉	2018-11-24T23:37:48+08:00	6110	2137	8247	1214	9461	22508	42.03%	27.15%	26	26
8	雲林縣水林鄉	2018-11-24T22:43:50+08:00	6110	2137	8247	1214	9461	22508	42.03%	27.15%	26	26
8	雲林縣水林鄉	2018-11-25T00:56:13+08:00	6110	2137	8247	1214	9461	22508	42.03%	27.15%	26	26
8	雲林縣水林鄉	2018-11-24T23:54:27+08:00	6110	2137	8247	1214	9461	22508	42.03%	27.15%	26	26
8	雲林縣水林鄉	2018-11-25T01:16:22+08:00	6110	2137	8247	1214	9461	22508	42.03%	27.15%	26	26
8	雲林縣水林鄉	2018-11-25T00:03:34+08:00	6110	2137	8247	1214	9461	22508	42.03%	27.15%	26	26
8	雲林縣水林鄉	2018-11-24T22:35:44+08:00	6110	2137	8247	1214	9461	22508	42.03%	27.15%	26	26
8	雲林縣水林鄉	2018-11-25T01:01:01+08:00	6110	2137	8247	1214	9461	22508	42.03%	27.15%	26	26
8	雲林縣水林鄉	2018-11-24T23:22:23+08:00	6110	2137	8247	1214	9461	22508	42.03%	27.15%	26	26
8	雲林縣水林鄉	2018-11-25T06:17:35+08:00	6110	2137	8247	1214	9461	22508	42.03%	27.15%	26	26
8	雲林縣水林鄉	2018-11-24T22:49:23+08:00	6110	2137	8247	1214	9461	22508	42.03%	27.15%	26	26
8	雲林縣水林鄉	2018-11-24T23:03:47+08:00	6110	2137	8247	1214	9461	22508	42.03%	27.15%	26	26
8	雲林縣水林鄉	2018-11-24T22:28:40+08:00	6110	2137	8247	1214	9461	22508	42.03%	27.15%	26	26
8	雲林縣水林鄉	2018-11-24T23:10:55+08:00	6110	2137	8247	1214	9461	22508	42.03%	27.15%	26	26
8	雲林縣水林鄉	2018-11-24T23:33:50+08:00	6110	2137	8247	1214	9461	22508	42.03%	27.15%	26	26
8	雲林縣水林鄉	2018-11-24T22:12:02+08:00	5791	2053	7844	1117	8961	21453	41.77%	26.99%	25	26
8	雲林縣水林鄉	2018-11-25T00:08:04+08:00	6110	2137	8247	1214	9461	22508	42.03%	27.15%	26	26
8	雲林縣水林鄉	2018-11-24T22:53:14+08:00	6110	2137	8247	1214	9461	22508	42.03%	27.15%	26	26
8	雲林縣水林鄉	2018-11-25T03:42:48+08:00	6110	2137	8247	1214	9461	22508	42.03%	27.15%	26	26
8	雲林縣水林鄉	2018-11-24T23:46:03+08:00	6110	2137	8247	1214	9461	22508	42.03%	27.15%	26	26
8	雲林縣水林鄉	2018-11-25T00:17:07+08:00	6110	2137	8247	1214	9461	22508	42.03%	27.15%	26	26
8	雲林縣水林鄉	2018-11-24T22:25:25+08:00	6110	2137	8247	1214	9461	22508	42.03%	27.15%	26	26
8	雲林縣水林鄉	2018-11-25T06:22:44+08:00	6110	2137	8247	1214	9461	22508	42.03%	27.15%	26	26
8	雲林縣水林鄉	2018-11-25T06:12:36+08:00	6110	2137	8247	1214	9461	22508	42.03%	27.15%	26	26
8	雲林縣水林鄉	2018-11-25T00:12:44+08:00	6110	2137	8247	1214	9461	22508	42.03%	27.15%	26	26
8	雲林縣水林鄉	2018-11-24T23:26:06+08:00	6110	2137	8247	1214	9461	22508	42.03%	27.15%	26	26
8	雲林縣水林鄉	2018-11-24T23:18:27+08:00	6110	2137	8247	1214	9461	22508	42.03%	27.15%	26	26
8	雲林縣水林鄉	2018-11-24T23:50:14+08:00	6110	2137	8247	1214	9461	22508	42.03%	27.15%	26	26
8	雲林縣水林鄉	2018-11-24T23:14:40+08:00	6110	2137	8247	1214	9461	22508	42.03%	27.15%	26	26
8	雲林縣水林鄉	2018-11-24T22:18:19+08:00	6110	2137	8247	1214	9461	22508	42.03%	27.15%	26	26
8	雲林縣水林鄉	2018-11-24T23:58:42+08:00	6110	2137	8247	1214	9461	22508	42.03%	27.15%	26	26
8	雲林縣水林鄉	2018-11-25T06:27:55+08:00	6110	2137	8247	1214	9461	22508	42.03%	27.15%	26	26
8	雲林縣水林鄉	2018-11-24T22:14:48+08:00	5791	2053	7844	1117	8961	21453	41.77%	26.99%	25	26
8	雲林縣水林鄉	2018-11-25T01:05:59+08:00	6110	2137	8247	1214	9461	22508	42.03%	27.15%	26	26
8	宜蘭縣南澳鄉	2018-11-24T22:14:51+08:00	426	111	537	55	592	919	64.42%	46.35%	2	7
8	宜蘭縣南澳鄉	2018-11-24T23:33:52+08:00	1569	339	1908	145	2053	3682	55.76%	42.61%	6	7
8	宜蘭縣南澳鄉	2018-11-25T06:17:38+08:00	1987	422	2409	227	2636	4644	56.76%	42.79%	7	7
8	宜蘭縣南澳鄉	2018-11-24T22:28:42+08:00	426	111	537	55	592	919	64.42%	46.35%	2	7
8	宜蘭縣南澳鄉	2018-11-24T22:56:38+08:00	1081	261	1342	120	1462	2472	59.14%	43.73%	5	7
8	宜蘭縣南澳鄉	2018-11-24T23:07:21+08:00	1081	261	1342	120	1462	2472	59.14%	43.73%	5	7
8	宜蘭縣南澳鄉	2018-11-24T22:49:26+08:00	1081	261	1342	120	1462	2472	59.14%	43.73%	5	7
8	宜蘭縣南澳鄉	2018-11-24T23:10:58+08:00	1081	261	1342	120	1462	2472	59.14%	43.73%	5	7
8	宜蘭縣南澳鄉	2018-11-24T22:53:17+08:00	1081	261	1342	120	1462	2472	59.14%	43.73%	5	7
8	宜蘭縣南澳鄉	2018-11-24T22:32:20+08:00	426	111	537	55	592	919	64.42%	46.35%	2	7
8	宜蘭縣南澳鄉	2018-11-25T00:17:10+08:00	1987	422	2409	227	2636	4644	56.76%	42.79%	7	7
8	宜蘭縣南澳鄉	2018-11-25T00:08:06+08:00	1569	339	1908	145	2053	3682	55.76%	42.61%	6	7
8	宜蘭縣南澳鄉	2018-11-25T03:48:33+08:00	1987	422	2409	227	2636	4644	56.76%	42.79%	7	7
8	宜蘭縣南澳鄉	2018-11-25T06:07:25+08:00	1987	422	2409	227	2636	4644	56.76%	42.79%	7	7
8	宜蘭縣南澳鄉	2018-11-24T23:29:48+08:00	1081	261	1342	120	1462	2472	59.14%	43.73%	5	7
8	宜蘭縣南澳鄉	2018-11-24T22:40:20+08:00	426	111	537	55	592	919	64.42%	46.35%	2	7
8	宜蘭縣南澳鄉	2018-11-25T06:22:46+08:00	1987	422	2409	227	2636	4644	56.76%	42.79%	7	7
8	宜蘭縣南澳鄉	2018-11-24T23:00:18+08:00	1081	261	1342	120	1462	2472	59.14%	43.73%	5	7
8	宜蘭縣南澳鄉	2018-11-24T22:25:27+08:00	426	111	537	55	592	919	64.42%	46.35%	2	7
8	宜蘭縣南澳鄉	2018-11-25T03:42:50+08:00	1987	422	2409	227	2636	4644	56.76%	42.79%	7	7
8	宜蘭縣南澳鄉	2018-11-25T01:11:09+08:00	1987	422	2409	227	2636	4644	56.76%	42.79%	7	7
8	宜蘭縣南澳鄉	2018-11-24T23:14:43+08:00	1081	261	1342	120	1462	2472	59.14%	43.73%	5	7
8	宜蘭縣南澳鄉	2018-11-25T01:16:24+08:00	1987	422	2409	227	2636	4644	56.76%	42.79%	7	7
8	宜蘭縣南澳鄉	2018-11-24T23:54:29+08:00	1569	339	1908	145	2053	3682	55.76%	42.61%	6	7
8	宜蘭縣南澳鄉	2018-11-25T06:27:57+08:00	1987	422	2409	227	2636	4644	56.76%	42.79%	7	7
8	宜蘭縣南澳鄉	2018-11-25T03:31:01+08:00	1987	422	2409	227	2636	4644	56.76%	42.79%	7	7
8	宜蘭縣南澳鄉	2018-11-24T23:50:16+08:00	1569	339	1908	145	2053	3682	55.76%	42.61%	6	7
8	宜蘭縣南澳鄉	2018-11-25T00:56:15+08:00	1987	422	2409	227	2636	4644	56.76%	42.79%	7	7
8	宜蘭縣南澳鄉	2018-11-25T00:12:46+08:00	1987	422	2409	227	2636	4644	56.76%	42.79%	7	7
8	宜蘭縣南澳鄉	2018-11-24T23:37:50+08:00	1569	339	1908	145	2053	3682	55.76%	42.61%	6	7
8	宜蘭縣南澳鄉	2018-11-25T01:24:27+08:00	1987	422	2409	227	2636	4644	56.76%	42.79%	7	7
8	宜蘭縣南澳鄉	2018-11-25T03:54:43+08:00	1987	422	2409	227	2636	4644	56.76%	42.79%	7	7
8	宜蘭縣南澳鄉	2018-11-24T23:03:49+08:00	1081	261	1342	120	1462	2472	59.14%	43.73%	5	7
8	宜蘭縣南澳鄉	2018-11-24T22:12:04+08:00	178	34	212	12	224	444	50.45%	40.09%	1	7
8	宜蘭縣南澳鄉	2018-11-24T23:22:25+08:00	1081	261	1342	120	1462	2472	59.14%	43.73%	5	7
8	宜蘭縣南澳鄉	2018-11-25T01:06:02+08:00	1987	422	2409	227	2636	4644	56.76%	42.79%	7	7
8	宜蘭縣南澳鄉	2018-11-24T23:42:03+08:00	1569	339	1908	145	2053	3682	55.76%	42.61%	6	7
8	宜蘭縣南澳鄉	2018-11-24T23:46:05+08:00	1569	339	1908	145	2053	3682	55.76%	42.61%	6	7
8	宜蘭縣南澳鄉	2018-11-25T04:01:31+08:00	1987	422	2409	227	2636	4644	56.76%	42.79%	7	7
8	宜蘭縣南澳鄉	2018-11-25T06:12:39+08:00	1987	422	2409	227	2636	4644	56.76%	42.79%	7	7
8	宜蘭縣南澳鄉	2018-11-24T22:21:48+08:00	426	111	537	55	592	919	64.42%	46.35%	2	7
8	宜蘭縣南澳鄉	2018-11-25T00:21:46+08:00	1987	422	2409	227	2636	4644	56.76%	42.79%	7	7
8	宜蘭縣南澳鄉	2018-11-25T01:01:03+08:00	1987	422	2409	227	2636	4644	56.76%	42.79%	7	7
8	宜蘭縣南澳鄉	2018-11-24T22:35:46+08:00	426	111	537	55	592	919	64.42%	46.35%	2	7
8	宜蘭縣南澳鄉	2018-11-24T23:58:44+08:00	1569	339	1908	145	2053	3682	55.76%	42.61%	6	7
8	宜蘭縣南澳鄉	2018-11-24T23:18:29+08:00	1081	261	1342	120	1462	2472	59.14%	43.73%	5	7
8	宜蘭縣南澳鄉	2018-11-25T03:37:31+08:00	1987	422	2409	227	2636	4644	56.76%	42.79%	7	7
8	宜蘭縣南澳鄉	2018-11-24T22:18:21+08:00	426	111	537	55	592	919	64.42%	46.35%	2	7
8	宜蘭縣南澳鄉	2018-11-24T22:39:11+08:00	426	111	537	55	592	919	64.42%	46.35%	2	7
8	宜蘭縣南澳鄉	2018-11-24T23:26:09+08:00	1081	261	1342	120	1462	2472	59.14%	43.73%	5	7
8	宜蘭縣南澳鄉	2018-11-25T00:03:37+08:00	1569	339	1908	145	2053	3682	55.76%	42.61%	6	7
8	宜蘭縣南澳鄉	2018-11-24T22:43:52+08:00	540	141	681	62	743	1330	55.86%	40.6%	3	7
8	宜蘭縣羅東鎮	2018-11-24T23:33:52+08:00	22118	6560	28678	2656	31334	54440	57.56%	40.63%	48	50
8	宜蘭縣羅東鎮	2018-11-24T23:10:57+08:00	20373	6055	26428	2444	28872	50137	57.59%	40.63%	45	50
8	宜蘭縣羅東鎮	2018-11-25T06:17:38+08:00	23361	6884	30245	2814	33059	57686	57.31%	40.5%	50	50
8	宜蘭縣羅東鎮	2018-11-24T22:28:42+08:00	16789	5003	21792	1971	23763	41448	57.33%	40.51%	38	50
8	宜蘭縣羅東鎮	2018-11-24T23:07:21+08:00	20373	6055	26428	2444	28872	50137	57.59%	40.63%	45	50
8	宜蘭縣羅東鎮	2018-11-24T22:14:50+08:00	13521	4048	17569	1576	19145	33471	57.2%	40.4%	32	50
8	宜蘭縣羅東鎮	2018-11-24T22:56:37+08:00	20373	6055	26428	2444	28872	50137	57.59%	40.63%	45	50
8	宜蘭縣羅東鎮	2018-11-25T01:06:01+08:00	23361	6884	30245	2814	33059	57686	57.31%	40.5%	50	50
8	宜蘭縣羅東鎮	2018-11-24T22:32:20+08:00	17916	5285	23201	2090	25291	44010	57.47%	40.71%	40	50
8	宜蘭縣羅東鎮	2018-11-24T22:53:16+08:00	19327	5700	25027	2272	27299	47452	57.53%	40.73%	43	50
8	宜蘭縣羅東鎮	2018-11-25T00:17:10+08:00	23361	6884	30245	2814	33059	57686	57.31%	40.5%	50	50
8	宜蘭縣羅東鎮	2018-11-25T00:08:06+08:00	23361	6884	30245	2814	33059	57686	57.31%	40.5%	50	50
8	宜蘭縣羅東鎮	2018-11-24T23:29:48+08:00	21505	6409	27914	2599	30513	53010	57.56%	40.57%	47	50
8	宜蘭縣羅東鎮	2018-11-24T22:40:20+08:00	18434	5417	23851	2149	26000	45149	57.59%	40.83%	41	50
8	宜蘭縣羅東鎮	2018-11-25T06:22:46+08:00	23361	6884	30245	2814	33059	57686	57.31%	40.5%	50	50
8	宜蘭縣羅東鎮	2018-11-25T06:07:24+08:00	23361	6884	30245	2814	33059	57686	57.31%	40.5%	50	50
8	宜蘭縣羅東鎮	2018-11-24T23:00:18+08:00	20373	6055	26428	2444	28872	50137	57.59%	40.63%	45	50
8	宜蘭縣羅東鎮	2018-11-25T03:48:32+08:00	23361	6884	30245	2814	33059	57686	57.31%	40.5%	50	50
8	宜蘭縣羅東鎮	2018-11-24T22:25:27+08:00	16320	4856	21176	1898	23074	40160	57.46%	40.64%	37	50
8	宜蘭縣羅東鎮	2018-11-25T03:42:50+08:00	23361	6884	30245	2814	33059	57686	57.31%	40.5%	50	50
8	宜蘭縣羅東鎮	2018-11-25T01:11:09+08:00	23361	6884	30245	2814	33059	57686	57.31%	40.5%	50	50
8	宜蘭縣羅東鎮	2018-11-25T01:16:24+08:00	23361	6884	30245	2814	33059	57686	57.31%	40.5%	50	50
8	宜蘭縣羅東鎮	2018-11-25T03:31:01+08:00	23361	6884	30245	2814	33059	57686	57.31%	40.5%	50	50
8	宜蘭縣羅東鎮	2018-11-24T23:14:42+08:00	20373	6055	26428	2444	28872	50137	57.59%	40.63%	45	50
8	宜蘭縣羅東鎮	2018-11-24T23:50:16+08:00	23361	6884	30245	2814	33059	57686	57.31%	40.5%	50	50
8	宜蘭縣羅東鎮	2018-11-25T06:27:56+08:00	23361	6884	30245	2814	33059	57686	57.31%	40.5%	50	50
8	宜蘭縣羅東鎮	2018-11-25T00:56:15+08:00	23361	6884	30245	2814	33059	57686	57.31%	40.5%	50	50
8	宜蘭縣羅東鎮	2018-11-25T00:12:46+08:00	23361	6884	30245	2814	33059	57686	57.31%	40.5%	50	50
8	宜蘭縣羅東鎮	2018-11-24T23:54:28+08:00	23361	6884	30245	2814	33059	57686	57.31%	40.5%	50	50
8	宜蘭縣羅東鎮	2018-11-24T23:37:50+08:00	22118	6560	28678	2656	31334	54440	57.56%	40.63%	48	50
8	宜蘭縣羅東鎮	2018-11-24T22:12:04+08:00	13163	3932	17095	1521	18616	32499	57.28%	40.5%	31	50
8	宜蘭縣羅東鎮	2018-11-24T23:22:25+08:00	21505	6409	27914	2599	30513	53010	57.56%	40.57%	47	50
8	宜蘭縣羅東鎮	2018-11-25T01:24:26+08:00	23361	6884	30245	2814	33059	57686	57.31%	40.5%	50	50
8	宜蘭縣羅東鎮	2018-11-25T03:54:42+08:00	23361	6884	30245	2814	33059	57686	57.31%	40.5%	50	50
8	宜蘭縣羅東鎮	2018-11-24T23:03:48+08:00	20373	6055	26428	2444	28872	50137	57.59%	40.63%	45	50
8	宜蘭縣羅東鎮	2018-11-24T22:49:25+08:00	19327	5700	25027	2272	27299	47452	57.53%	40.73%	43	50
8	宜蘭縣羅東鎮	2018-11-24T23:42:03+08:00	22118	6560	28678	2656	31334	54440	57.56%	40.63%	48	50
8	宜蘭縣羅東鎮	2018-11-24T23:46:05+08:00	23361	6884	30245	2814	33059	57686	57.31%	40.5%	50	50
8	宜蘭縣羅東鎮	2018-11-25T04:01:31+08:00	23361	6884	30245	2814	33059	57686	57.31%	40.5%	50	50
8	宜蘭縣羅東鎮	2018-11-24T22:21:48+08:00	15123	4530	19653	1777	21430	37242	57.54%	40.61%	35	50
8	宜蘭縣羅東鎮	2018-11-25T06:12:38+08:00	23361	6884	30245	2814	33059	57686	57.31%	40.5%	50	50
8	宜蘭縣羅東鎮	2018-11-25T00:21:46+08:00	23361	6884	30245	2814	33059	57686	57.31%	40.5%	50	50
8	宜蘭縣羅東鎮	2018-11-25T01:01:03+08:00	23361	6884	30245	2814	33059	57686	57.31%	40.5%	50	50
8	宜蘭縣羅東鎮	2018-11-24T22:39:10+08:00	17916	5285	23201	2090	25291	44010	57.47%	40.71%	40	50
8	宜蘭縣羅東鎮	2018-11-24T23:26:08+08:00	21505	6409	27914	2599	30513	53010	57.56%	40.57%	47	50
8	宜蘭縣羅東鎮	2018-11-24T22:35:46+08:00	17916	5285	23201	2090	25291	44010	57.47%	40.71%	40	50
8	宜蘭縣羅東鎮	2018-11-24T23:58:44+08:00	23361	6884	30245	2814	33059	57686	57.31%	40.5%	50	50
8	宜蘭縣羅東鎮	2018-11-24T23:18:29+08:00	21505	6409	27914	2599	30513	53010	57.56%	40.57%	47	50
8	宜蘭縣羅東鎮	2018-11-25T00:03:36+08:00	23361	6884	30245	2814	33059	57686	57.31%	40.5%	50	50
8	宜蘭縣羅東鎮	2018-11-25T03:37:31+08:00	23361	6884	30245	2814	33059	57686	57.31%	40.5%	50	50
8	宜蘭縣羅東鎮	2018-11-24T22:18:21+08:00	13521	4048	17569	1576	19145	33471	57.2%	40.4%	32	50
8	宜蘭縣羅東鎮	2018-11-24T22:43:52+08:00	19327	5700	25027	2272	27299	47452	57.53%	40.73%	43	50
8	臺中市石岡區	2018-11-24T23:10:50+08:00	5359	1555	6914	695	7609	12880	59.08%	41.61%	10	10
8	臺中市石岡區	2018-11-25T00:56:06+08:00	5359	1555	6914	695	7609	12880	59.08%	41.61%	10	10
8	臺中市石岡區	2018-11-24T23:14:33+08:00	5359	1555	6914	695	7609	12880	59.08%	41.61%	10	10
8	臺中市石岡區	2018-11-24T23:22:16+08:00	5359	1555	6914	695	7609	12880	59.08%	41.61%	10	10
8	臺中市石岡區	2018-11-24T22:56:31+08:00	5359	1555	6914	695	7609	12880	59.08%	41.61%	10	10
8	臺中市石岡區	2018-11-25T00:12:39+08:00	5359	1555	6914	695	7609	12880	59.08%	41.61%	10	10
8	臺中市石岡區	2018-11-24T22:49:17+08:00	5359	1555	6914	695	7609	12880	59.08%	41.61%	10	10
8	臺中市石岡區	2018-11-25T03:37:18+08:00	5359	1555	6914	695	7609	12880	59.08%	41.61%	10	10
8	臺中市石岡區	2018-11-24T22:43:44+08:00	5359	1555	6914	695	7609	12880	59.08%	41.61%	10	10
8	臺中市石岡區	2018-11-25T00:03:26+08:00	5359	1555	6914	695	7609	12880	59.08%	41.61%	10	10
8	臺中市石岡區	2018-11-25T01:10:59+08:00	5359	1555	6914	695	7609	12880	59.08%	41.61%	10	10
8	臺中市石岡區	2018-11-25T06:22:39+08:00	5359	1555	6914	695	7609	12880	59.08%	41.61%	10	10
8	臺中市石岡區	2018-11-25T03:30:51+08:00	5359	1555	6914	695	7609	12880	59.08%	41.61%	10	10
8	臺中市石岡區	2018-11-24T22:25:17+08:00	5359	1555	6914	695	7609	12880	59.08%	41.61%	10	10
8	臺中市石岡區	2018-11-24T23:29:40+08:00	5359	1555	6914	695	7609	12880	59.08%	41.61%	10	10
8	臺中市石岡區	2018-11-25T00:07:58+08:00	5359	1555	6914	695	7609	12880	59.08%	41.61%	10	10
8	臺中市石岡區	2018-11-25T01:16:15+08:00	5359	1555	6914	695	7609	12880	59.08%	41.61%	10	10
8	臺中市石岡區	2018-11-25T01:05:52+08:00	5359	1555	6914	695	7609	12880	59.08%	41.61%	10	10
8	臺中市石岡區	2018-11-24T22:14:42+08:00	5359	1555	6914	695	7609	12880	59.08%	41.61%	10	10
8	臺中市石岡區	2018-11-24T23:54:19+08:00	5359	1555	6914	695	7609	12880	59.08%	41.61%	10	10
8	臺中市石岡區	2018-11-24T22:28:34+08:00	5359	1555	6914	695	7609	12880	59.08%	41.61%	10	10
8	臺中市石岡區	2018-11-24T22:18:13+08:00	5359	1555	6914	695	7609	12880	59.08%	41.61%	10	10
8	臺中市石岡區	2018-11-24T23:50:08+08:00	5359	1555	6914	695	7609	12880	59.08%	41.61%	10	10
8	臺中市石岡區	2018-11-24T22:39:02+08:00	5359	1555	6914	695	7609	12880	59.08%	41.61%	10	10
8	臺中市石岡區	2018-11-25T01:24:17+08:00	5359	1555	6914	695	7609	12880	59.08%	41.61%	10	10
8	臺中市石岡區	2018-11-24T22:35:39+08:00	5359	1555	6914	695	7609	12880	59.08%	41.61%	10	10
8	臺中市石岡區	2018-11-24T23:58:35+08:00	5359	1555	6914	695	7609	12880	59.08%	41.61%	10	10
8	臺中市石岡區	2018-11-25T06:27:49+08:00	5359	1555	6914	695	7609	12880	59.08%	41.61%	10	10
8	臺中市石岡區	2018-11-24T23:03:41+08:00	5359	1555	6914	695	7609	12880	59.08%	41.61%	10	10
8	臺中市石岡區	2018-11-24T23:07:13+08:00	5359	1555	6914	695	7609	12880	59.08%	41.61%	10	10
8	臺中市石岡區	2018-11-25T01:00:53+08:00	5359	1555	6914	695	7609	12880	59.08%	41.61%	10	10
8	臺中市石岡區	2018-11-24T23:00:08+08:00	5359	1555	6914	695	7609	12880	59.08%	41.61%	10	10
8	臺中市石岡區	2018-11-25T03:48:22+08:00	5359	1555	6914	695	7609	12880	59.08%	41.61%	10	10
8	臺中市石岡區	2018-11-25T00:21:37+08:00	5359	1555	6914	695	7609	12880	59.08%	41.61%	10	10
8	臺中市石岡區	2018-11-25T03:42:41+08:00	5359	1555	6914	695	7609	12880	59.08%	41.61%	10	10
8	臺中市石岡區	2018-11-24T22:21:39+08:00	5359	1555	6914	695	7609	12880	59.08%	41.61%	10	10
8	臺中市石岡區	2018-11-24T22:32:12+08:00	5359	1555	6914	695	7609	12880	59.08%	41.61%	10	10
8	臺中市石岡區	2018-11-24T22:53:08+08:00	5359	1555	6914	695	7609	12880	59.08%	41.61%	10	10
8	臺中市石岡區	2018-11-25T04:01:22+08:00	5359	1555	6914	695	7609	12880	59.08%	41.61%	10	10
8	臺中市石岡區	2018-11-24T22:11:57+08:00	5359	1555	6914	695	7609	12880	59.08%	41.61%	10	10
8	臺中市石岡區	2018-11-25T00:17:01+08:00	5359	1555	6914	695	7609	12880	59.08%	41.61%	10	10
8	臺中市石岡區	2018-11-24T22:40:13+08:00	5359	1555	6914	695	7609	12880	59.08%	41.61%	10	10
8	臺中市石岡區	2018-11-25T06:12:31+08:00	5359	1555	6914	695	7609	12880	59.08%	41.61%	10	10
8	臺中市石岡區	2018-11-25T06:07:16+08:00	5359	1555	6914	695	7609	12880	59.08%	41.61%	10	10
8	臺中市石岡區	2018-11-24T23:33:44+08:00	5359	1555	6914	695	7609	12880	59.08%	41.61%	10	10
8	臺中市石岡區	2018-11-25T03:54:33+08:00	5359	1555	6914	695	7609	12880	59.08%	41.61%	10	10
8	臺中市石岡區	2018-11-24T23:26:01+08:00	5359	1555	6914	695	7609	12880	59.08%	41.61%	10	10
8	臺中市石岡區	2018-11-25T06:17:29+08:00	5359	1555	6914	695	7609	12880	59.08%	41.61%	10	10
8	臺中市石岡區	2018-11-24T23:41:56+08:00	5359	1555	6914	695	7609	12880	59.08%	41.61%	10	10
8	臺中市石岡區	2018-11-24T23:37:43+08:00	5359	1555	6914	695	7609	12880	59.08%	41.61%	10	10
8	臺中市石岡區	2018-11-24T23:18:21+08:00	5359	1555	6914	695	7609	12880	59.08%	41.61%	10	10
8	臺中市石岡區	2018-11-24T23:45:57+08:00	5359	1555	6914	695	7609	12880	59.08%	41.61%	10	10
8	臺東縣大武鄉	2018-11-24T23:26:10+08:00	1270	429	1699	441	2140	4132	51.79%	30.74%	5	6
8	臺東縣大武鄉	2018-11-24T22:49:27+08:00	840	296	1136	284	1420	2658	53.42%	31.6%	4	6
8	臺東縣大武鄉	2018-11-24T23:10:58+08:00	1270	429	1699	441	2140	4132	51.79%	30.74%	5	6
8	臺東縣大武鄉	2018-11-24T23:33:53+08:00	1270	429	1699	441	2140	4132	51.79%	30.74%	5	6
8	臺東縣大武鄉	2018-11-24T22:56:39+08:00	840	296	1136	284	1420	2658	53.42%	31.6%	4	6
8	臺東縣大武鄉	2018-11-24T23:22:26+08:00	1270	429	1699	441	2140	4132	51.79%	30.74%	5	6
8	臺東縣大武鄉	2018-11-24T22:28:43+08:00	203	82	285	95	380	763	49.8%	26.61%	2	6
8	臺東縣大武鄉	2018-11-24T23:18:30+08:00	1270	429	1699	441	2140	4132	51.79%	30.74%	5	6
8	臺東縣大武鄉	2018-11-25T00:17:11+08:00	1577	542	2119	555	2674	5266	50.78%	29.95%	6	6
8	臺東縣大武鄉	2018-11-24T22:32:21+08:00	203	82	285	95	380	763	49.8%	26.61%	2	6
8	臺東縣大武鄉	2018-11-24T23:46:06+08:00	1577	542	2119	555	2674	5266	50.78%	29.95%	6	6
8	臺東縣大武鄉	2018-11-25T00:08:07+08:00	1577	542	2119	555	2674	5266	50.78%	29.95%	6	6
8	臺東縣大武鄉	2018-11-24T22:53:18+08:00	840	296	1136	284	1420	2658	53.42%	31.6%	4	6
8	臺東縣大武鄉	2018-11-25T04:01:32+08:00	1577	542	2119	555	2674	5266	50.78%	29.95%	6	6
8	臺東縣大武鄉	2018-11-25T03:48:34+08:00	1577	542	2119	555	2674	5266	50.78%	29.95%	6	6
8	臺東縣大武鄉	2018-11-24T23:00:19+08:00	840	296	1136	284	1420	2658	53.42%	31.6%	4	6
8	臺東縣大武鄉	2018-11-24T22:25:28+08:00	203	82	285	95	380	763	49.8%	26.61%	2	6
8	臺東縣大武鄉	2018-11-25T06:22:47+08:00	1577	542	2119	555	2674	5266	50.78%	29.95%	6	6
8	臺東縣大武鄉	2018-11-25T03:42:51+08:00	1577	542	2119	555	2674	5266	50.78%	29.95%	6	6
8	臺東縣大武鄉	2018-11-24T22:40:21+08:00	645	231	876	213	1089	2090	52.11%	30.86%	3	6
8	臺東縣大武鄉	2018-11-24T23:29:49+08:00	1270	429	1699	441	2140	4132	51.79%	30.74%	5	6
8	臺東縣大武鄉	2018-11-24T23:14:44+08:00	1270	429	1699	441	2140	4132	51.79%	30.74%	5	6
8	臺東縣大武鄉	2018-11-24T23:50:17+08:00	1577	542	2119	555	2674	5266	50.78%	29.95%	6	6
8	臺東縣大武鄉	2018-11-25T00:12:47+08:00	1577	542	2119	555	2674	5266	50.78%	29.95%	6	6
8	臺東縣大武鄉	2018-11-25T01:16:25+08:00	1577	542	2119	555	2674	5266	50.78%	29.95%	6	6
8	臺東縣大武鄉	2018-11-24T22:18:22+08:00	203	82	285	95	380	763	49.8%	26.61%	2	6
8	臺東縣大武鄉	2018-11-25T03:37:32+08:00	1577	542	2119	555	2674	5266	50.78%	29.95%	6	6
8	臺東縣大武鄉	2018-11-25T06:27:58+08:00	1577	542	2119	555	2674	5266	50.78%	29.95%	6	6
8	臺東縣大武鄉	2018-11-25T06:17:40+08:00	1577	542	2119	555	2674	5266	50.78%	29.95%	6	6
8	臺東縣大武鄉	2018-11-25T03:54:44+08:00	1577	542	2119	555	2674	5266	50.78%	29.95%	6	6
8	臺東縣大武鄉	2018-11-24T23:03:49+08:00	1270	429	1699	441	2140	4132	51.79%	30.74%	5	6
8	臺東縣大武鄉	2018-11-24T22:14:52+08:00	203	82	285	95	380	763	49.8%	26.61%	2	6
8	臺東縣大武鄉	2018-11-25T01:24:28+08:00	1577	542	2119	555	2674	5266	50.78%	29.95%	6	6
8	臺東縣大武鄉	2018-11-24T23:37:51+08:00	1270	429	1699	441	2140	4132	51.79%	30.74%	5	6
8	臺東縣大武鄉	2018-11-24T23:07:22+08:00	1270	429	1699	441	2140	4132	51.79%	30.74%	5	6
8	臺東縣大武鄉	2018-11-24T22:12:05+08:00	203	82	285	95	380	763	49.8%	26.61%	2	6
8	臺東縣大武鄉	2018-11-24T23:54:30+08:00	1577	542	2119	555	2674	5266	50.78%	29.95%	6	6
8	臺東縣大武鄉	2018-11-24T23:42:04+08:00	1270	429	1699	441	2140	4132	51.79%	30.74%	5	6
8	臺東縣大武鄉	2018-11-25T01:11:10+08:00	1577	542	2119	555	2674	5266	50.78%	29.95%	6	6
8	臺東縣大武鄉	2018-11-25T01:06:03+08:00	1577	542	2119	555	2674	5266	50.78%	29.95%	6	6
8	臺東縣大武鄉	2018-11-25T00:21:47+08:00	1577	542	2119	555	2674	5266	50.78%	29.95%	6	6
8	臺東縣大武鄉	2018-11-25T06:12:39+08:00	1577	542	2119	555	2674	5266	50.78%	29.95%	6	6
8	臺東縣大武鄉	2018-11-25T06:07:26+08:00	1577	542	2119	555	2674	5266	50.78%	29.95%	6	6
8	臺東縣大武鄉	2018-11-24T22:21:49+08:00	203	82	285	95	380	763	49.8%	26.61%	2	6
8	臺東縣大武鄉	2018-11-25T00:03:38+08:00	1577	542	2119	555	2674	5266	50.78%	29.95%	6	6
8	臺東縣大武鄉	2018-11-24T22:43:53+08:00	645	231	876	213	1089	2090	52.11%	30.86%	3	6
8	臺東縣大武鄉	2018-11-24T22:35:47+08:00	645	231	876	213	1089	2090	52.11%	30.86%	3	6
8	臺東縣大武鄉	2018-11-24T23:58:45+08:00	1577	542	2119	555	2674	5266	50.78%	29.95%	6	6
8	臺東縣大武鄉	2018-11-25T01:01:05+08:00	1577	542	2119	555	2674	5266	50.78%	29.95%	6	6
8	臺東縣大武鄉	2018-11-25T00:56:16+08:00	1577	542	2119	555	2674	5266	50.78%	29.95%	6	6
8	臺東縣大武鄉	2018-11-24T22:39:11+08:00	645	231	876	213	1089	2090	52.11%	30.86%	3	6
8	臺東縣大武鄉	2018-11-25T03:31:02+08:00	1577	542	2119	555	2674	5266	50.78%	29.95%	6	6
8	臺東縣	2018-11-24T22:14:51+08:00	30275	9151	39426	4792	44218	91505	48.32%	33.09%	137	213
8	臺東縣	2018-11-24T23:33:52+08:00	51675	15005	66680	7857	74537	148314	50.26%	34.84%	186	213
8	臺東縣	2018-11-24T22:28:42+08:00	33786	10139	43925	5345	49270	101405	48.59%	33.32%	147	213
8	臺東縣	2018-11-24T22:56:38+08:00	42018	12356	54374	6397	60771	123223	49.32%	34.1%	167	213
8	臺東縣	2018-11-24T23:07:21+08:00	46179	13612	59791	7259	67050	134646	49.8%	34.3%	176	213
8	臺東縣	2018-11-24T22:49:26+08:00	40134	11856	51990	6198	58188	118396	49.15%	33.9%	163	213
8	臺東縣	2018-11-24T23:10:58+08:00	46179	13612	59791	7259	67050	134646	49.8%	34.3%	176	213
8	臺東縣	2018-11-25T06:17:39+08:00	65521	18824	84345	9356	93701	185996	50.38%	35.23%	213	213
8	臺東縣	2018-11-24T22:53:17+08:00	40821	12034	52855	6258	59113	119886	49.31%	34.05%	164	213
8	臺東縣	2018-11-24T23:46:06+08:00	55774	16150	71924	8366	80290	159258	50.42%	35.02%	195	213
8	臺東縣	2018-11-25T00:08:07+08:00	60347	17470	77817	8865	86682	172351	50.29%	35.01%	204	213
8	臺東縣	2018-11-24T22:32:20+08:00	34091	10224	44315	5363	49678	102344	48.54%	33.31%	148	213
8	臺東縣	2018-11-25T00:17:10+08:00	60347	17470	77817	8865	86682	172351	50.29%	35.01%	204	213
8	臺東縣	2018-11-25T04:01:32+08:00	65521	18824	84345	9356	93701	185996	50.38%	35.23%	213	213
8	臺東縣	2018-11-25T03:48:34+08:00	65521	18824	84345	9356	93701	185996	50.38%	35.23%	213	213
8	臺東縣	2018-11-24T23:00:19+08:00	42179	12425	54604	6463	61067	123649	49.39%	34.11%	168	213
8	臺東縣	2018-11-25T06:07:25+08:00	65521	18824	84345	9356	93701	185996	50.38%	35.23%	213	213
8	臺東縣	2018-11-25T06:22:47+08:00	65521	18824	84345	9356	93701	185996	50.38%	35.23%	213	213
8	臺東縣	2018-11-25T03:42:51+08:00	65521	18824	84345	9356	93701	185996	50.38%	35.23%	213	213
8	臺東縣	2018-11-24T22:25:27+08:00	33164	9972	43136	5190	48326	99633	48.5%	33.29%	145	213
8	臺東縣	2018-11-24T22:40:21+08:00	37238	11035	48273	5820	54093	110652	48.89%	33.65%	156	213
8	臺東縣	2018-11-24T23:29:49+08:00	49164	14265	63429	7673	71102	141855	50.12%	34.66%	182	213
8	臺東縣	2018-11-24T23:50:17+08:00	56476	16347	72823	8417	81240	160896	50.49%	35.1%	196	213
8	臺東縣	2018-11-24T23:14:43+08:00	46179	13612	59791	7259	67050	134646	49.8%	34.3%	176	213
8	臺東縣	2018-11-25T00:12:47+08:00	60347	17470	77817	8865	86682	172351	50.29%	35.01%	204	213
8	臺東縣	2018-11-24T23:54:29+08:00	57996	16795	74791	8581	83372	165584	50.35%	35.03%	199	213
8	臺東縣	2018-11-25T06:27:57+08:00	65521	18824	84345	9356	93701	185996	50.38%	35.23%	213	213
8	臺東縣	2018-11-25T01:16:25+08:00	63365	18310	81675	9176	90851	180678	50.28%	35.07%	210	213
8	臺東縣	2018-11-24T22:18:22+08:00	31087	9378	40465	4870	45335	93681	48.39%	33.18%	139	213
8	臺東縣	2018-11-25T03:37:32+08:00	65521	18824	84345	9356	93701	185996	50.38%	35.23%	213	213
8	臺東縣	2018-11-25T01:24:27+08:00	63719	18394	82113	9212	91325	181736	50.25%	35.06%	211	213
8	臺東縣	2018-11-25T03:54:44+08:00	65521	18824	84345	9356	93701	185996	50.38%	35.23%	213	213
8	臺東縣	2018-11-24T23:03:49+08:00	45232	13317	58549	7040	65589	131776	49.77%	34.32%	174	213
8	臺東縣	2018-11-24T23:22:25+08:00	48018	13964	61982	7534	69516	138994	50.01%	34.55%	180	213
8	臺東縣	2018-11-24T23:37:51+08:00	52314	15158	67472	7906	75378	149677	50.36%	34.95%	187	213
8	臺東縣	2018-11-24T22:12:05+08:00	29248	8896	38144	4672	42816	88605	48.32%	33.01%	134	213
8	臺東縣	2018-11-25T01:06:02+08:00	63365	18310	81675	9176	90851	180678	50.28%	35.07%	210	213
8	臺東縣	2018-11-24T23:42:04+08:00	53059	15400	68459	8020	76479	151801	50.38%	34.95%	189	213
8	臺東縣	2018-11-25T01:11:10+08:00	63365	18310	81675	9176	90851	180678	50.28%	35.07%	210	213
8	臺東縣	2018-11-25T06:12:39+08:00	65521	18824	84345	9356	93701	185996	50.38%	35.23%	213	213
8	臺東縣	2018-11-25T00:21:46+08:00	61163	17746	78909	8922	87831	174939	50.21%	34.96%	206	213
8	臺東縣	2018-11-24T22:21:49+08:00	31742	9569	41311	4993	46304	95534	48.47%	33.23%	141	213
8	臺東縣	2018-11-25T01:01:04+08:00	63365	18310	81675	9176	90851	180678	50.28%	35.07%	210	213
8	臺東縣	2018-11-24T22:43:53+08:00	38297	11332	49629	5936	55565	113483	48.96%	33.75%	159	213
8	臺東縣	2018-11-24T23:18:29+08:00	47752	13889	61641	7482	69123	138474	49.92%	34.48%	179	213
8	臺東縣	2018-11-24T22:35:47+08:00	35293	10437	45730	5558	51288	105140	48.78%	33.57%	150	213
8	臺東縣	2018-11-24T23:58:45+08:00	59395	17160	76555	8728	85283	169594	50.29%	35.02%	202	213
8	臺東縣	2018-11-25T00:56:16+08:00	63365	18310	81675	9176	90851	180678	50.28%	35.07%	210	213
8	臺東縣	2018-11-24T22:39:11+08:00	36993	10972	47965	5784	53749	110051	48.84%	33.61%	155	213
8	臺東縣	2018-11-24T23:26:09+08:00	48018	13964	61982	7534	69516	138994	50.01%	34.55%	180	213
8	臺東縣	2018-11-25T03:31:02+08:00	65521	18824	84345	9356	93701	185996	50.38%	35.23%	213	213
8	臺東縣	2018-11-25T00:03:37+08:00	60347	17470	77817	8865	86682	172351	50.29%	35.01%	204	213
8	南投縣國姓鄉	2018-11-24T22:39:08+08:00	6621	1861	8482	802	9284	16597	55.94%	39.89%	20	20
8	南投縣國姓鄉	2018-11-25T03:37:28+08:00	6621	1861	8482	802	9284	16597	55.94%	39.89%	20	20
8	南投縣國姓鄉	2018-11-25T01:24:23+08:00	6621	1861	8482	802	9284	16597	55.94%	39.89%	20	20
8	南投縣國姓鄉	2018-11-24T23:07:17+08:00	6621	1861	8482	802	9284	16597	55.94%	39.89%	20	20
8	南投縣國姓鄉	2018-11-24T22:12:01+08:00	6183	1742	7925	745	8670	15502	55.93%	39.89%	19	20
8	南投縣國姓鄉	2018-11-24T22:32:17+08:00	6621	1861	8482	802	9284	16597	55.94%	39.89%	20	20
8	南投縣國姓鄉	2018-11-25T03:30:57+08:00	6621	1861	8482	802	9284	16597	55.94%	39.89%	20	20
8	南投縣國姓鄉	2018-11-25T03:48:28+08:00	6621	1861	8482	802	9284	16597	55.94%	39.89%	20	20
8	南投縣國姓鄉	2018-11-24T23:42:01+08:00	6621	1861	8482	802	9284	16597	55.94%	39.89%	20	20
8	南投縣國姓鄉	2018-11-24T22:21:45+08:00	6621	1861	8482	802	9284	16597	55.94%	39.89%	20	20
8	南投縣國姓鄉	2018-11-25T04:01:28+08:00	6621	1861	8482	802	9284	16597	55.94%	39.89%	20	20
8	南投縣國姓鄉	2018-11-25T00:21:43+08:00	6621	1861	8482	802	9284	16597	55.94%	39.89%	20	20
8	南投縣國姓鄉	2018-11-24T22:40:18+08:00	6621	1861	8482	802	9284	16597	55.94%	39.89%	20	20
8	南投縣國姓鄉	2018-11-24T23:00:16+08:00	6621	1861	8482	802	9284	16597	55.94%	39.89%	20	20
8	南投縣國姓鄉	2018-11-25T06:12:35+08:00	6621	1861	8482	802	9284	16597	55.94%	39.89%	20	20
8	南投縣國姓鄉	2018-11-25T03:54:39+08:00	6621	1861	8482	802	9284	16597	55.94%	39.89%	20	20
8	南投縣國姓鄉	2018-11-25T01:01:00+08:00	6621	1861	8482	802	9284	16597	55.94%	39.89%	20	20
8	南投縣國姓鄉	2018-11-24T23:33:49+08:00	6621	1861	8482	802	9284	16597	55.94%	39.89%	20	20
8	南投縣國姓鄉	2018-11-25T00:03:33+08:00	6621	1861	8482	802	9284	16597	55.94%	39.89%	20	20
8	南投縣國姓鄉	2018-11-24T23:37:47+08:00	6621	1861	8482	802	9284	16597	55.94%	39.89%	20	20
8	南投縣國姓鄉	2018-11-24T22:35:43+08:00	6621	1861	8482	802	9284	16597	55.94%	39.89%	20	20
8	南投縣國姓鄉	2018-11-24T23:54:26+08:00	6621	1861	8482	802	9284	16597	55.94%	39.89%	20	20
8	南投縣國姓鄉	2018-11-24T23:58:41+08:00	6621	1861	8482	802	9284	16597	55.94%	39.89%	20	20
8	南投縣國姓鄉	2018-11-25T00:56:12+08:00	6621	1861	8482	802	9284	16597	55.94%	39.89%	20	20
8	南投縣國姓鄉	2018-11-24T22:56:35+08:00	6621	1861	8482	802	9284	16597	55.94%	39.89%	20	20
8	南投縣國姓鄉	2018-11-25T06:17:35+08:00	6621	1861	8482	802	9284	16597	55.94%	39.89%	20	20
8	南投縣國姓鄉	2018-11-24T22:49:23+08:00	6621	1861	8482	802	9284	16597	55.94%	39.89%	20	20
8	南投縣國姓鄉	2018-11-24T23:14:39+08:00	6621	1861	8482	802	9284	16597	55.94%	39.89%	20	20
8	南投縣國姓鄉	2018-11-24T23:22:22+08:00	6621	1861	8482	802	9284	16597	55.94%	39.89%	20	20
8	南投縣國姓鄉	2018-11-24T22:43:49+08:00	6621	1861	8482	802	9284	16597	55.94%	39.89%	20	20
8	南投縣國姓鄉	2018-11-24T23:03:46+08:00	6621	1861	8482	802	9284	16597	55.94%	39.89%	20	20
8	南投縣國姓鄉	2018-11-24T23:10:55+08:00	6621	1861	8482	802	9284	16597	55.94%	39.89%	20	20
8	南投縣國姓鄉	2018-11-25T00:08:03+08:00	6621	1861	8482	802	9284	16597	55.94%	39.89%	20	20
8	南投縣國姓鄉	2018-11-25T03:42:47+08:00	6621	1861	8482	802	9284	16597	55.94%	39.89%	20	20
8	南投縣國姓鄉	2018-11-24T22:53:13+08:00	6621	1861	8482	802	9284	16597	55.94%	39.89%	20	20
8	南投縣國姓鄉	2018-11-24T23:46:02+08:00	6621	1861	8482	802	9284	16597	55.94%	39.89%	20	20
8	南投縣國姓鄉	2018-11-25T01:11:05+08:00	6621	1861	8482	802	9284	16597	55.94%	39.89%	20	20
8	南投縣國姓鄉	2018-11-25T00:17:07+08:00	6621	1861	8482	802	9284	16597	55.94%	39.89%	20	20
8	南投縣國姓鄉	2018-11-24T23:29:45+08:00	6621	1861	8482	802	9284	16597	55.94%	39.89%	20	20
8	南投縣國姓鄉	2018-11-25T06:22:44+08:00	6621	1861	8482	802	9284	16597	55.94%	39.89%	20	20
8	南投縣國姓鄉	2018-11-25T06:07:21+08:00	6621	1861	8482	802	9284	16597	55.94%	39.89%	20	20
8	南投縣國姓鄉	2018-11-24T22:25:23+08:00	6621	1861	8482	802	9284	16597	55.94%	39.89%	20	20
8	南投縣國姓鄉	2018-11-25T01:05:58+08:00	6621	1861	8482	802	9284	16597	55.94%	39.89%	20	20
8	南投縣國姓鄉	2018-11-25T00:12:44+08:00	6621	1861	8482	802	9284	16597	55.94%	39.89%	20	20
8	南投縣國姓鄉	2018-11-24T23:26:06+08:00	6621	1861	8482	802	9284	16597	55.94%	39.89%	20	20
8	南投縣國姓鄉	2018-11-24T22:14:47+08:00	6183	1742	7925	745	8670	15502	55.93%	39.89%	19	20
8	南投縣國姓鄉	2018-11-24T22:18:18+08:00	6183	1742	7925	745	8670	15502	55.93%	39.89%	19	20
8	南投縣國姓鄉	2018-11-25T06:27:54+08:00	6621	1861	8482	802	9284	16597	55.94%	39.89%	20	20
8	南投縣國姓鄉	2018-11-24T23:50:13+08:00	6621	1861	8482	802	9284	16597	55.94%	39.89%	20	20
8	南投縣國姓鄉	2018-11-25T01:16:20+08:00	6621	1861	8482	802	9284	16597	55.94%	39.89%	20	20
8	南投縣國姓鄉	2018-11-24T22:28:39+08:00	6621	1861	8482	802	9284	16597	55.94%	39.89%	20	20
8	南投縣國姓鄉	2018-11-24T23:18:26+08:00	6621	1861	8482	802	9284	16597	55.94%	39.89%	20	20
8	南投縣	2018-11-25T01:24:23+08:00	178821	46683	225504	19043	244547	427089	57.26%	41.87%	488	488
8	南投縣	2018-11-24T22:39:07+08:00	140433	37121	177554	15422	192976	337090	57.25%	41.66%	407	488
8	南投縣	2018-11-24T23:07:17+08:00	161486	42218	203704	17384	221088	386599	57.19%	41.77%	453	488
8	南投縣	2018-11-24T22:12:01+08:00	120633	31852	152485	13204	165689	289557	57.22%	41.66%	362	488
8	南投縣	2018-11-25T03:37:27+08:00	178821	46683	225504	19043	244547	427089	57.26%	41.87%	488	488
8	南投縣	2018-11-24T23:22:21+08:00	169650	44352	214002	18087	232089	405532	57.23%	41.83%	469	488
8	南投縣	2018-11-24T22:32:17+08:00	136027	35916	171943	14865	186808	326922	57.14%	41.61%	397	488
8	南投縣	2018-11-25T03:30:57+08:00	178821	46683	225504	19043	244547	427089	57.26%	41.87%	488	488
8	南投縣	2018-11-25T03:48:28+08:00	178821	46683	225504	19043	244547	427089	57.26%	41.87%	488	488
8	南投縣	2018-11-25T01:00:59+08:00	178821	46683	225504	19043	244547	427089	57.26%	41.87%	488	488
8	南投縣	2018-11-24T23:42:00+08:00	173899	45501	219400	18486	237886	415142	57.3%	41.89%	477	488
8	南投縣	2018-11-25T04:01:28+08:00	178821	46683	225504	19043	244547	427089	57.26%	41.87%	488	488
8	南投縣	2018-11-24T22:21:44+08:00	130660	34508	165168	14206	179374	314097	57.11%	41.6%	385	488
8	南投縣	2018-11-24T22:40:17+08:00	143050	37760	180810	15700	196510	343015	57.29%	41.7%	413	488
8	南投縣	2018-11-25T00:21:42+08:00	177913	46453	224366	18943	243309	425257	57.21%	41.84%	486	488
8	南投縣	2018-11-25T06:12:35+08:00	178821	46683	225504	19043	244547	427089	57.26%	41.87%	488	488
8	南投縣	2018-11-25T00:03:32+08:00	176155	46007	222162	18668	240830	420255	57.31%	41.92%	482	488
8	南投縣	2018-11-25T03:54:39+08:00	178821	46683	225504	19043	244547	427089	57.26%	41.87%	488	488
8	南投縣	2018-11-24T23:58:40+08:00	175308	45845	221153	18609	239762	418277	57.32%	41.91%	480	488
8	南投縣	2018-11-24T23:26:05+08:00	171163	44811	215974	18213	234187	409109	57.24%	41.84%	472	488
8	南投縣	2018-11-24T23:37:47+08:00	173677	45437	219114	18476	237590	414686	57.29%	41.88%	477	488
8	南投縣	2018-11-24T22:35:43+08:00	138419	36588	175007	15246	190253	332624	57.2%	41.61%	402	488
8	南投縣	2018-11-24T23:54:26+08:00	175308	45845	221153	18609	239762	418277	57.32%	41.91%	480	488
8	南投縣	2018-11-24T23:33:48+08:00	172786	45238	218024	18396	236420	412773	57.28%	41.86%	475	488
8	南投縣	2018-11-25T00:56:12+08:00	178821	46683	225504	19043	244547	427089	57.26%	41.87%	488	488
8	南投縣	2018-11-24T22:56:35+08:00	151476	39785	191261	16511	207772	362906	57.25%	41.74%	432	488
8	南投縣	2018-11-24T22:43:48+08:00	144298	38096	182394	15814	198208	346026	57.28%	41.7%	416	488
8	南投縣	2018-11-24T23:14:39+08:00	166275	43514	209789	17807	227596	397822	57.21%	41.8%	463	488
8	南投縣	2018-11-24T23:10:54+08:00	164175	42963	207138	17625	224763	393149	57.17%	41.76%	459	488
8	南投縣	2018-11-25T06:17:34+08:00	178821	46683	225504	19043	244547	427089	57.26%	41.87%	488	488
8	南投縣	2018-11-24T23:03:46+08:00	158903	41684	200587	17122	217709	380581	57.2%	41.75%	448	488
8	南投縣	2018-11-24T22:49:22+08:00	147762	38891	186653	16098	202751	353954	57.28%	41.75%	424	488
8	南投縣	2018-11-25T00:08:03+08:00	176734	46175	222909	18820	241729	421567	57.34%	41.92%	483	488
8	南投縣	2018-11-24T22:53:13+08:00	149668	39322	188990	16284	205274	358519	57.26%	41.75%	428	488
8	南投縣	2018-11-24T23:46:02+08:00	174161	45588	219749	18518	238267	415756	57.31%	41.89%	478	488
8	南投縣	2018-11-25T03:42:46+08:00	178821	46683	225504	19043	244547	427089	57.26%	41.87%	488	488
8	南投縣	2018-11-25T01:11:05+08:00	178821	46683	225504	19043	244547	427089	57.26%	41.87%	488	488
8	南投縣	2018-11-24T22:25:22+08:00	132141	34880	167021	14354	181375	317661	57.1%	41.6%	388	488
8	南投縣	2018-11-25T06:07:21+08:00	178821	46683	225504	19043	244547	427089	57.26%	41.87%	488	488
8	南投縣	2018-11-25T06:22:43+08:00	178821	46683	225504	19043	244547	427089	57.26%	41.87%	488	488
8	南投縣	2018-11-24T23:29:44+08:00	171619	44915	216534	18249	234783	410112	57.25%	41.85%	473	488
8	南投縣	2018-11-25T00:17:06+08:00	177636	46399	224035	18928	242963	423881	57.32%	41.91%	485	488
8	南投縣	2018-11-24T23:00:15+08:00	155121	40753	195874	16807	212681	371578	57.24%	41.75%	440	488
8	南投縣	2018-11-25T00:12:43+08:00	177168	46272	223440	18864	242304	422557	57.34%	41.93%	484	488
8	南投縣	2018-11-24T22:28:38+08:00	133086	35150	168236	14461	182697	319923	57.11%	41.6%	390	488
8	南投縣	2018-11-24T22:14:47+08:00	123322	32550	155872	13489	169361	295999	57.22%	41.66%	368	488
8	南投縣	2018-11-25T06:27:53+08:00	178821	46683	225504	19043	244547	427089	57.26%	41.87%	488	488
8	南投縣	2018-11-24T22:18:18+08:00	125333	33064	158397	13658	172055	300951	57.17%	41.65%	373	488
8	南投縣	2018-11-24T23:50:13+08:00	174703	45711	220414	18566	238980	416950	57.32%	41.9%	479	488
8	南投縣	2018-11-25T01:16:20+08:00	178821	46683	225504	19043	244547	427089	57.26%	41.87%	488	488
8	南投縣	2018-11-25T01:05:57+08:00	178821	46683	225504	19043	244547	427089	57.26%	41.87%	488	488
8	南投縣	2018-11-24T23:18:26+08:00	168083	43920	212003	17927	229930	401698	57.24%	41.84%	466	488
8	新竹縣橫山鄉	2018-11-24T22:39:06+08:00	3921	1077	4998	452	5450	9346	58.31%	41.95%	14	16
8	新竹縣橫山鄉	2018-11-24T23:03:44+08:00	4816	1321	6137	536	6673	11346	58.81%	42.45%	16	16
8	新竹縣橫山鄉	2018-11-24T23:22:20+08:00	4816	1321	6137	536	6673	11346	58.81%	42.45%	16	16
8	新竹縣橫山鄉	2018-11-24T23:58:39+08:00	4816	1321	6137	536	6673	11346	58.81%	42.45%	16	16
8	新竹縣橫山鄉	2018-11-24T22:49:21+08:00	3921	1077	4998	452	5450	9346	58.31%	41.95%	14	16
8	新竹縣橫山鄉	2018-11-24T23:46:01+08:00	4816	1321	6137	536	6673	11346	58.81%	42.45%	16	16
8	新竹縣橫山鄉	2018-11-25T03:48:26+08:00	4816	1321	6137	536	6673	11346	58.81%	42.45%	16	16
8	新竹縣橫山鄉	2018-11-24T22:53:11+08:00	4816	1321	6137	536	6673	11346	58.81%	42.45%	16	16
8	新竹縣橫山鄉	2018-11-25T03:42:45+08:00	4816	1321	6137	536	6673	11346	58.81%	42.45%	16	16
8	新竹縣橫山鄉	2018-11-25T01:00:58+08:00	4816	1321	6137	536	6673	11346	58.81%	42.45%	16	16
8	新竹縣橫山鄉	2018-11-25T00:08:01+08:00	4816	1321	6137	536	6673	11346	58.81%	42.45%	16	16
8	新竹縣橫山鄉	2018-11-25T04:01:26+08:00	4816	1321	6137	536	6673	11346	58.81%	42.45%	16	16
8	新竹縣橫山鄉	2018-11-24T22:25:21+08:00	3219	875	4094	388	4482	7785	57.57%	41.35%	13	16
8	新竹縣橫山鄉	2018-11-25T06:12:34+08:00	4816	1321	6137	536	6673	11346	58.81%	42.45%	16	16
8	新竹縣橫山鄉	2018-11-24T22:40:16+08:00	3921	1077	4998	452	5450	9346	58.31%	41.95%	14	16
8	新竹縣橫山鄉	2018-11-24T22:21:43+08:00	3219	875	4094	388	4482	7785	57.57%	41.35%	13	16
8	新竹縣橫山鄉	2018-11-25T00:17:05+08:00	4816	1321	6137	536	6673	11346	58.81%	42.45%	16	16
8	新竹縣橫山鄉	2018-11-24T23:18:24+08:00	4816	1321	6137	536	6673	11346	58.81%	42.45%	16	16
8	新竹縣橫山鄉	2018-11-24T23:37:46+08:00	4816	1321	6137	536	6673	11346	58.81%	42.45%	16	16
8	新竹縣橫山鄉	2018-11-24T22:35:42+08:00	3921	1077	4998	452	5450	9346	58.31%	41.95%	14	16
8	新竹縣橫山鄉	2018-11-25T03:54:37+08:00	4816	1321	6137	536	6673	11346	58.81%	42.45%	16	16
8	新竹縣橫山鄉	2018-11-24T23:33:47+08:00	4816	1321	6137	536	6673	11346	58.81%	42.45%	16	16
8	新竹縣橫山鄉	2018-11-24T23:26:04+08:00	4816	1321	6137	536	6673	11346	58.81%	42.45%	16	16
8	新竹縣橫山鄉	2018-11-24T22:14:45+08:00	3219	875	4094	388	4482	7785	57.57%	41.35%	13	16
8	新竹縣橫山鄉	2018-11-24T23:07:15+08:00	4816	1321	6137	536	6673	11346	58.81%	42.45%	16	16
8	新竹縣橫山鄉	2018-11-24T23:14:37+08:00	4816	1321	6137	536	6673	11346	58.81%	42.45%	16	16
8	新竹縣橫山鄉	2018-11-24T23:10:53+08:00	4816	1321	6137	536	6673	11346	58.81%	42.45%	16	16
8	新竹縣橫山鄉	2018-11-25T06:17:33+08:00	4816	1321	6137	536	6673	11346	58.81%	42.45%	16	16
8	新竹縣橫山鄉	2018-11-24T22:43:47+08:00	3921	1077	4998	452	5450	9346	58.31%	41.95%	14	16
8	新竹縣橫山鄉	2018-11-24T22:56:33+08:00	4816	1321	6137	536	6673	11346	58.81%	42.45%	16	16
8	新竹縣橫山鄉	2018-11-25T01:24:21+08:00	4816	1321	6137	536	6673	11346	58.81%	42.45%	16	16
8	新竹縣橫山鄉	2018-11-25T03:37:23+08:00	4816	1321	6137	536	6673	11346	58.81%	42.45%	16	16
8	新竹縣橫山鄉	2018-11-25T03:30:55+08:00	4816	1321	6137	536	6673	11346	58.81%	42.45%	16	16
8	新竹縣橫山鄉	2018-11-24T22:32:15+08:00	3219	875	4094	388	4482	7785	57.57%	41.35%	13	16
8	新竹縣橫山鄉	2018-11-24T22:11:59+08:00	3219	875	4094	388	4482	7785	57.57%	41.35%	13	16
8	新竹縣橫山鄉	2018-11-24T23:00:14+08:00	4816	1321	6137	536	6673	11346	58.81%	42.45%	16	16
8	新竹縣橫山鄉	2018-11-25T06:07:19+08:00	4816	1321	6137	536	6673	11346	58.81%	42.45%	16	16
8	新竹縣橫山鄉	2018-11-25T01:11:03+08:00	4816	1321	6137	536	6673	11346	58.81%	42.45%	16	16
8	新竹縣橫山鄉	2018-11-24T23:29:43+08:00	4816	1321	6137	536	6673	11346	58.81%	42.45%	16	16
8	新竹縣橫山鄉	2018-11-25T00:21:41+08:00	4816	1321	6137	536	6673	11346	58.81%	42.45%	16	16
8	新竹縣橫山鄉	2018-11-25T06:22:42+08:00	4816	1321	6137	536	6673	11346	58.81%	42.45%	16	16
8	新竹縣橫山鄉	2018-11-25T00:56:10+08:00	4816	1321	6137	536	6673	11346	58.81%	42.45%	16	16
8	新竹縣橫山鄉	2018-11-24T22:18:16+08:00	3219	875	4094	388	4482	7785	57.57%	41.35%	13	16
8	新竹縣橫山鄉	2018-11-25T01:05:56+08:00	4816	1321	6137	536	6673	11346	58.81%	42.45%	16	16
8	新竹縣橫山鄉	2018-11-24T23:54:24+08:00	4816	1321	6137	536	6673	11346	58.81%	42.45%	16	16
8	新竹縣橫山鄉	2018-11-24T23:41:59+08:00	4816	1321	6137	536	6673	11346	58.81%	42.45%	16	16
8	新竹縣橫山鄉	2018-11-25T01:16:18+08:00	4816	1321	6137	536	6673	11346	58.81%	42.45%	16	16
8	新竹縣橫山鄉	2018-11-25T06:27:52+08:00	4816	1321	6137	536	6673	11346	58.81%	42.45%	16	16
8	新竹縣橫山鄉	2018-11-25T00:12:42+08:00	4816	1321	6137	536	6673	11346	58.81%	42.45%	16	16
8	新竹縣橫山鄉	2018-11-24T22:28:37+08:00	3219	875	4094	388	4482	7785	57.57%	41.35%	13	16
8	新竹縣橫山鄉	2018-11-25T00:03:30+08:00	4816	1321	6137	536	6673	11346	58.81%	42.45%	16	16
8	新竹縣橫山鄉	2018-11-24T23:50:12+08:00	4816	1321	6137	536	6673	11346	58.81%	42.45%	16	16
8	澎湖縣西嶼鄉	2018-11-24T23:26:10+08:00	1618	461	2079	382	2461	7382	33.34%	21.92%	12	12
8	澎湖縣西嶼鄉	2018-11-24T23:10:59+08:00	1618	461	2079	382	2461	7382	33.34%	21.92%	12	12
8	澎湖縣西嶼鄉	2018-11-24T22:49:27+08:00	1618	461	2079	382	2461	7382	33.34%	21.92%	12	12
8	澎湖縣西嶼鄉	2018-11-24T23:33:53+08:00	1618	461	2079	382	2461	7382	33.34%	21.92%	12	12
8	澎湖縣西嶼鄉	2018-11-24T22:56:39+08:00	1618	461	2079	382	2461	7382	33.34%	21.92%	12	12
8	澎湖縣西嶼鄉	2018-11-24T23:22:26+08:00	1618	461	2079	382	2461	7382	33.34%	21.92%	12	12
8	澎湖縣西嶼鄉	2018-11-24T22:28:43+08:00	1618	461	2079	382	2461	7382	33.34%	21.92%	12	12
8	澎湖縣西嶼鄉	2018-11-24T23:18:30+08:00	1618	461	2079	382	2461	7382	33.34%	21.92%	12	12
8	澎湖縣西嶼鄉	2018-11-25T00:17:11+08:00	1618	461	2079	382	2461	7382	33.34%	21.92%	12	12
8	澎湖縣西嶼鄉	2018-11-24T22:32:21+08:00	1618	461	2079	382	2461	7382	33.34%	21.92%	12	12
8	澎湖縣西嶼鄉	2018-11-24T23:46:06+08:00	1618	461	2079	382	2461	7382	33.34%	21.92%	12	12
8	澎湖縣西嶼鄉	2018-11-24T22:53:18+08:00	1618	461	2079	382	2461	7382	33.34%	21.92%	12	12
8	澎湖縣西嶼鄉	2018-11-25T00:08:08+08:00	1618	461	2079	382	2461	7382	33.34%	21.92%	12	12
8	澎湖縣西嶼鄉	2018-11-25T04:01:32+08:00	1618	461	2079	382	2461	7382	33.34%	21.92%	12	12
8	澎湖縣西嶼鄉	2018-11-25T03:48:34+08:00	1618	461	2079	382	2461	7382	33.34%	21.92%	12	12
8	澎湖縣西嶼鄉	2018-11-24T22:25:28+08:00	1618	461	2079	382	2461	7382	33.34%	21.92%	12	12
8	澎湖縣西嶼鄉	2018-11-25T06:22:47+08:00	1618	461	2079	382	2461	7382	33.34%	21.92%	12	12
8	澎湖縣西嶼鄉	2018-11-24T23:00:20+08:00	1618	461	2079	382	2461	7382	33.34%	21.92%	12	12
8	澎湖縣西嶼鄉	2018-11-24T22:40:21+08:00	1618	461	2079	382	2461	7382	33.34%	21.92%	12	12
8	澎湖縣西嶼鄉	2018-11-24T23:14:44+08:00	1618	461	2079	382	2461	7382	33.34%	21.92%	12	12
8	澎湖縣西嶼鄉	2018-11-25T03:37:33+08:00	1618	461	2079	382	2461	7382	33.34%	21.92%	12	12
8	澎湖縣西嶼鄉	2018-11-24T22:18:23+08:00	1618	461	2079	382	2461	7382	33.34%	21.92%	12	12
8	澎湖縣西嶼鄉	2018-11-24T23:50:18+08:00	1618	461	2079	382	2461	7382	33.34%	21.92%	12	12
8	澎湖縣西嶼鄉	2018-11-24T23:58:46+08:00	1618	461	2079	382	2461	7382	33.34%	21.92%	12	12
8	澎湖縣西嶼鄉	2018-11-25T00:12:48+08:00	1618	461	2079	382	2461	7382	33.34%	21.92%	12	12
8	澎湖縣西嶼鄉	2018-11-24T23:03:50+08:00	1618	461	2079	382	2461	7382	33.34%	21.92%	12	12
8	澎湖縣西嶼鄉	2018-11-24T22:39:12+08:00	1618	461	2079	382	2461	7382	33.34%	21.92%	12	12
8	澎湖縣西嶼鄉	2018-11-25T06:27:58+08:00	1618	461	2079	382	2461	7382	33.34%	21.92%	12	12
8	澎湖縣西嶼鄉	2018-11-25T06:17:40+08:00	1618	461	2079	382	2461	7382	33.34%	21.92%	12	12
8	澎湖縣西嶼鄉	2018-11-24T22:14:52+08:00	1618	461	2079	382	2461	7382	33.34%	21.92%	12	12
8	澎湖縣西嶼鄉	2018-11-25T01:24:28+08:00	1618	461	2079	382	2461	7382	33.34%	21.92%	12	12
8	澎湖縣西嶼鄉	2018-11-25T03:54:45+08:00	1618	461	2079	382	2461	7382	33.34%	21.92%	12	12
8	澎湖縣西嶼鄉	2018-11-24T23:37:51+08:00	1618	461	2079	382	2461	7382	33.34%	21.92%	12	12
8	澎湖縣西嶼鄉	2018-11-24T23:07:22+08:00	1618	461	2079	382	2461	7382	33.34%	21.92%	12	12
8	澎湖縣西嶼鄉	2018-11-24T22:12:05+08:00	1618	461	2079	382	2461	7382	33.34%	21.92%	12	12
8	澎湖縣西嶼鄉	2018-11-24T23:54:30+08:00	1618	461	2079	382	2461	7382	33.34%	21.92%	12	12
8	澎湖縣西嶼鄉	2018-11-25T06:12:40+08:00	1618	461	2079	382	2461	7382	33.34%	21.92%	12	12
8	澎湖縣西嶼鄉	2018-11-24T23:29:50+08:00	1618	461	2079	382	2461	7382	33.34%	21.92%	12	12
8	澎湖縣西嶼鄉	2018-11-24T23:42:05+08:00	1618	461	2079	382	2461	7382	33.34%	21.92%	12	12
8	澎湖縣西嶼鄉	2018-11-25T01:06:03+08:00	1618	461	2079	382	2461	7382	33.34%	21.92%	12	12
8	澎湖縣西嶼鄉	2018-11-25T01:11:11+08:00	1618	461	2079	382	2461	7382	33.34%	21.92%	12	12
8	澎湖縣西嶼鄉	2018-11-25T00:21:47+08:00	1618	461	2079	382	2461	7382	33.34%	21.92%	12	12
8	澎湖縣西嶼鄉	2018-11-25T03:42:52+08:00	1618	461	2079	382	2461	7382	33.34%	21.92%	12	12
8	澎湖縣西嶼鄉	2018-11-25T06:07:26+08:00	1618	461	2079	382	2461	7382	33.34%	21.92%	12	12
8	澎湖縣西嶼鄉	2018-11-24T22:21:49+08:00	1618	461	2079	382	2461	7382	33.34%	21.92%	12	12
8	澎湖縣西嶼鄉	2018-11-24T22:43:53+08:00	1618	461	2079	382	2461	7382	33.34%	21.92%	12	12
8	澎湖縣西嶼鄉	2018-11-25T03:31:03+08:00	1618	461	2079	382	2461	7382	33.34%	21.92%	12	12
8	澎湖縣西嶼鄉	2018-11-24T22:35:47+08:00	1618	461	2079	382	2461	7382	33.34%	21.92%	12	12
8	澎湖縣西嶼鄉	2018-11-25T01:01:05+08:00	1618	461	2079	382	2461	7382	33.34%	21.92%	12	12
8	澎湖縣西嶼鄉	2018-11-25T00:56:16+08:00	1618	461	2079	382	2461	7382	33.34%	21.92%	12	12
8	澎湖縣西嶼鄉	2018-11-25T01:16:26+08:00	1618	461	2079	382	2461	7382	33.34%	21.92%	12	12
8	澎湖縣西嶼鄉	2018-11-25T00:03:39+08:00	1618	461	2079	382	2461	7382	33.34%	21.92%	12	12
8	高雄市楠梓區	2018-11-24T23:03:43+08:00	44722	14096	58818	5255	64073	107596	59.55%	41.56%	72	99
8	高雄市楠梓區	2018-11-24T23:58:37+08:00	61460	18963	80423	7060	87483	147315	59.38%	41.72%	95	99
8	高雄市楠梓區	2018-11-25T06:17:31+08:00	63689	19693	83382	7497	90879	153132	59.35%	41.59%	99	99
8	高雄市楠梓區	2018-11-24T23:22:18+08:00	49585	15547	65132	5859	70991	119682	59.32%	41.43%	79	99
8	高雄市楠梓區	2018-11-24T22:43:45+08:00	39868	12566	52434	4702	57136	95686	59.71%	41.67%	65	99
8	高雄市楠梓區	2018-11-24T23:14:35+08:00	46921	14775	61696	5470	67166	113051	59.41%	41.5%	75	99
8	高雄市楠梓區	2018-11-25T03:37:20+08:00	63689	19693	83382	7497	90879	153132	59.35%	41.59%	99	99
8	高雄市楠梓區	2018-11-25T00:56:09+08:00	63689	19693	83382	7497	90879	153132	59.35%	41.59%	99	99
8	高雄市楠梓區	2018-11-24T22:49:19+08:00	40558	12783	53341	4759	58100	97277	59.73%	41.69%	66	99
8	高雄市楠梓區	2018-11-25T00:03:28+08:00	61996	19134	81130	7168	88298	148754	59.36%	41.68%	96	99
8	高雄市楠梓區	2018-11-25T03:42:43+08:00	63689	19693	83382	7497	90879	153132	59.35%	41.59%	99	99
8	高雄市楠梓區	2018-11-24T22:53:10+08:00	41889	13236	55125	4937	60062	100737	59.62%	41.58%	68	99
8	高雄市楠梓區	2018-11-25T00:08:00+08:00	61996	19134	81130	7168	88298	148754	59.36%	41.68%	96	99
8	高雄市楠梓區	2018-11-25T01:00:56+08:00	63689	19693	83382	7497	90879	153132	59.35%	41.59%	99	99
8	高雄市楠梓區	2018-11-24T22:25:19+08:00	33327	10345	43672	3747	47419	79328	59.78%	42.01%	54	99
8	高雄市楠梓區	2018-11-25T00:17:03+08:00	63305	19561	82866	7403	90269	152218	59.3%	41.59%	98	99
8	高雄市楠梓區	2018-11-25T01:11:01+08:00	63689	19693	83382	7497	90879	153132	59.35%	41.59%	99	99
8	高雄市楠梓區	2018-11-25T06:22:41+08:00	63689	19693	83382	7497	90879	153132	59.35%	41.59%	99	99
8	高雄市楠梓區	2018-11-25T06:12:32+08:00	63689	19693	83382	7497	90879	153132	59.35%	41.59%	99	99
8	高雄市楠梓區	2018-11-24T23:18:23+08:00	48948	15423	64371	5762	70133	118186	59.34%	41.42%	78	99
8	高雄市楠梓區	2018-11-24T23:50:10+08:00	60066	18517	78583	6891	85474	144216	59.27%	41.65%	93	99
8	高雄市楠梓區	2018-11-24T22:18:15+08:00	28595	8954	37549	3249	40798	68271	59.76%	41.88%	47	99
8	高雄市楠梓區	2018-11-24T22:28:35+08:00	34417	10783	45200	3908	49108	82103	59.81%	41.92%	56	99
8	高雄市楠梓區	2018-11-24T23:54:20+08:00	60691	18746	79437	6993	86430	145669	59.33%	41.66%	94	99
8	高雄市楠梓區	2018-11-24T22:14:44+08:00	27221	8510	35731	3079	38810	65007	59.7%	41.87%	45	99
8	高雄市楠梓區	2018-11-25T01:05:54+08:00	63689	19693	83382	7497	90879	153132	59.35%	41.59%	99	99
8	高雄市楠梓區	2018-11-25T06:27:51+08:00	63689	19693	83382	7497	90879	153132	59.35%	41.59%	99	99
8	高雄市楠梓區	2018-11-24T23:26:03+08:00	51171	16008	67179	6016	73195	123370	59.33%	41.48%	81	99
8	高雄市楠梓區	2018-11-25T00:12:41+08:00	63305	19561	82866	7403	90269	152218	59.3%	41.59%	98	99
8	高雄市楠梓區	2018-11-24T22:56:32+08:00	43321	13691	57012	5111	62123	104172	59.64%	41.59%	70	99
8	高雄市楠梓區	2018-11-25T01:24:19+08:00	63689	19693	83382	7497	90879	153132	59.35%	41.59%	99	99
8	高雄市楠梓區	2018-11-24T22:39:04+08:00	37514	11795	49309	4310	53619	89724	59.76%	41.81%	61	99
8	高雄市楠梓區	2018-11-24T23:10:52+08:00	45216	14342	59558	5354	64912	109124	59.48%	41.44%	73	99
8	高雄市楠梓區	2018-11-24T23:07:14+08:00	45216	14342	59558	5354	64912	109124	59.48%	41.44%	73	99
8	高雄市楠梓區	2018-11-25T00:21:39+08:00	63689	19693	83382	7497	90879	153132	59.35%	41.59%	99	99
8	高雄市楠梓區	2018-11-24T22:32:14+08:00	35131	10993	46124	3950	50074	83818	59.74%	41.91%	57	99
8	高雄市楠梓區	2018-11-25T03:30:54+08:00	63689	19693	83382	7497	90879	153132	59.35%	41.59%	99	99
8	高雄市楠梓區	2018-11-25T03:48:24+08:00	63689	19693	83382	7497	90879	153132	59.35%	41.59%	99	99
8	高雄市楠梓區	2018-11-24T23:29:42+08:00	52065	16231	68296	6102	74398	125378	59.34%	41.53%	82	99
8	高雄市楠梓區	2018-11-24T23:00:13+08:00	43321	13691	57012	5111	62123	104172	59.64%	41.59%	70	99
8	高雄市楠梓區	2018-11-24T22:21:41+08:00	31921	9915	41836	3604	45440	75938	59.84%	42.04%	52	99
8	高雄市楠梓區	2018-11-24T22:40:14+08:00	38018	12010	50028	4466	54494	91217	59.74%	41.68%	62	99
8	高雄市楠梓區	2018-11-25T06:07:18+08:00	63689	19693	83382	7497	90879	153132	59.35%	41.59%	99	99
8	高雄市楠梓區	2018-11-24T22:11:58+08:00	25879	8100	33979	2943	36922	61558	59.98%	42.04%	43	99
8	高雄市楠梓區	2018-11-25T04:01:24+08:00	63689	19693	83382	7497	90879	153132	59.35%	41.59%	99	99
8	高雄市楠梓區	2018-11-24T23:41:57+08:00	58853	18093	76946	6743	83689	141389	59.19%	41.62%	91	99
8	高雄市楠梓區	2018-11-24T23:37:45+08:00	55875	17323	73198	6480	79678	134698	59.15%	41.48%	87	99
8	高雄市楠梓區	2018-11-24T22:35:40+08:00	35581	11138	46719	4024	50743	84880	59.78%	41.92%	58	99
8	高雄市楠梓區	2018-11-25T03:54:35+08:00	63689	19693	83382	7497	90879	153132	59.35%	41.59%	99	99
8	高雄市楠梓區	2018-11-24T23:33:45+08:00	54395	16882	71277	6307	77584	131001	59.22%	41.52%	85	99
8	高雄市楠梓區	2018-11-24T23:45:59+08:00	59288	18286	77574	6804	84378	142545	59.19%	41.59%	92	99
8	高雄市楠梓區	2018-11-25T01:16:17+08:00	63689	19693	83382	7497	90879	153132	59.35%	41.59%	99	99
8	高雄市大寮區	2018-11-24T22:49:20+08:00	32680	10348	43028	3460	46488	83440	55.71%	39.17%	71	81
8	高雄市大寮區	2018-11-25T03:37:21+08:00	38152	12176	50328	4102	54430	97309	55.94%	39.21%	81	81
8	高雄市大寮區	2018-11-24T23:03:43+08:00	33660	10703	44363	3613	47976	85818	55.9%	39.22%	73	81
8	高雄市大寮區	2018-11-24T23:58:37+08:00	36315	11629	47944	3906	51850	92882	55.82%	39.1%	78	81
8	高雄市大寮區	2018-11-25T06:17:31+08:00	38152	12176	50328	4102	54430	97309	55.94%	39.21%	81	81
8	高雄市大寮區	2018-11-25T00:03:29+08:00	36315	11629	47944	3906	51850	92882	55.82%	39.1%	78	81
8	高雄市大寮區	2018-11-24T23:14:35+08:00	34666	11060	45726	3717	49443	88471	55.89%	39.18%	75	81
8	高雄市大寮區	2018-11-25T00:56:09+08:00	38152	12176	50328	4102	54430	97309	55.94%	39.21%	81	81
8	高雄市大寮區	2018-11-24T23:22:19+08:00	35200	11228	46428	3751	50179	89861	55.84%	39.17%	76	81
8	高雄市大寮區	2018-11-25T03:42:43+08:00	38152	12176	50328	4102	54430	97309	55.94%	39.21%	81	81
8	高雄市大寮區	2018-11-24T22:53:10+08:00	32680	10348	43028	3460	46488	83440	55.71%	39.17%	71	81
8	高雄市大寮區	2018-11-25T00:08:00+08:00	36315	11629	47944	3906	51850	92882	55.82%	39.1%	78	81
8	高雄市大寮區	2018-11-24T23:46:00+08:00	35824	11421	47245	3824	51069	91481	55.82%	39.16%	77	81
8	高雄市大寮區	2018-11-25T01:00:56+08:00	38152	12176	50328	4102	54430	97309	55.94%	39.21%	81	81
8	高雄市大寮區	2018-11-24T22:25:19+08:00	29856	9369	39225	3149	42374	75997	55.76%	39.29%	66	81
8	高雄市大寮區	2018-11-25T06:12:33+08:00	38152	12176	50328	4102	54430	97309	55.94%	39.21%	81	81
8	高雄市大寮區	2018-11-25T00:17:04+08:00	37478	11979	49457	4059	53516	95680	55.93%	39.17%	80	81
8	高雄市大寮區	2018-11-25T06:22:41+08:00	38152	12176	50328	4102	54430	97309	55.94%	39.21%	81	81
8	高雄市大寮區	2018-11-24T23:18:23+08:00	35200	11228	46428	3751	50179	89861	55.84%	39.17%	76	81
8	高雄市大寮區	2018-11-24T23:50:10+08:00	35824	11421	47245	3824	51069	91481	55.82%	39.16%	77	81
8	高雄市大寮區	2018-11-24T22:18:15+08:00	29424	9229	38653	3118	41771	74891	55.78%	39.29%	65	81
8	高雄市大寮區	2018-11-24T22:14:44+08:00	28979	9072	38051	3029	41080	73712	55.73%	39.31%	64	81
8	高雄市大寮區	2018-11-25T01:05:54+08:00	38152	12176	50328	4102	54430	97309	55.94%	39.21%	81	81
8	高雄市大寮區	2018-11-24T23:33:46+08:00	35824	11421	47245	3824	51069	91481	55.82%	39.16%	77	81
8	高雄市大寮區	2018-11-25T06:27:51+08:00	38152	12176	50328	4102	54430	97309	55.94%	39.21%	81	81
8	高雄市大寮區	2018-11-24T23:26:03+08:00	35200	11228	46428	3751	50179	89861	55.84%	39.17%	76	81
8	高雄市大寮區	2018-11-25T03:54:36+08:00	38152	12176	50328	4102	54430	97309	55.94%	39.21%	81	81
8	高雄市大寮區	2018-11-25T00:12:41+08:00	36959	11803	48762	3967	52729	94400	55.86%	39.15%	79	81
8	高雄市大寮區	2018-11-25T01:24:20+08:00	38152	12176	50328	4102	54430	97309	55.94%	39.21%	81	81
8	高雄市大寮區	2018-11-24T22:56:32+08:00	32680	10348	43028	3460	46488	83440	55.71%	39.17%	71	81
8	高雄市大寮區	2018-11-24T22:43:46+08:00	32680	10348	43028	3460	46488	83440	55.71%	39.17%	71	81
8	高雄市大寮區	2018-11-24T22:39:05+08:00	31709	9984	41693	3383	45076	80777	55.8%	39.25%	69	81
8	高雄市大寮區	2018-11-24T23:10:52+08:00	34666	11060	45726	3717	49443	88471	55.89%	39.18%	75	81
8	高雄市大寮區	2018-11-24T23:07:14+08:00	33660	10703	44363	3613	47976	85818	55.9%	39.22%	73	81
8	高雄市大寮區	2018-11-25T03:48:25+08:00	38152	12176	50328	4102	54430	97309	55.94%	39.21%	81	81
8	高雄市大寮區	2018-11-24T22:32:14+08:00	30489	9586	40075	3209	43284	77632	55.76%	39.27%	67	81
8	高雄市大寮區	2018-11-25T03:30:54+08:00	38152	12176	50328	4102	54430	97309	55.94%	39.21%	81	81
8	高雄市大寮區	2018-11-24T22:40:15+08:00	31709	9984	41693	3383	45076	80777	55.8%	39.25%	69	81
8	高雄市大寮區	2018-11-25T00:21:40+08:00	37478	11979	49457	4059	53516	95680	55.93%	39.17%	80	81
8	高雄市大寮區	2018-11-24T23:29:42+08:00	35200	11228	46428	3751	50179	89861	55.84%	39.17%	76	81
8	高雄市大寮區	2018-11-25T01:11:02+08:00	38152	12176	50328	4102	54430	97309	55.94%	39.21%	81	81
8	高雄市大寮區	2018-11-24T23:00:13+08:00	33208	10537	43745	3545	47290	84698	55.83%	39.21%	72	81
8	高雄市大寮區	2018-11-24T22:11:59+08:00	27921	8741	36662	2936	39598	71042	55.74%	39.3%	62	81
8	高雄市大寮區	2018-11-24T22:21:41+08:00	29856	9369	39225	3149	42374	75997	55.76%	39.29%	66	81
8	高雄市大寮區	2018-11-25T06:07:18+08:00	38152	12176	50328	4102	54430	97309	55.94%	39.21%	81	81
8	高雄市大寮區	2018-11-25T04:01:24+08:00	38152	12176	50328	4102	54430	97309	55.94%	39.21%	81	81
8	高雄市大寮區	2018-11-24T22:28:36+08:00	30489	9586	40075	3209	43284	77632	55.76%	39.27%	67	81
8	高雄市大寮區	2018-11-24T22:35:41+08:00	30489	9586	40075	3209	43284	77632	55.76%	39.27%	67	81
8	高雄市大寮區	2018-11-24T23:37:45+08:00	35824	11421	47245	3824	51069	91481	55.82%	39.16%	77	81
8	高雄市大寮區	2018-11-24T23:41:58+08:00	35824	11421	47245	3824	51069	91481	55.82%	39.16%	77	81
8	高雄市大寮區	2018-11-24T23:54:22+08:00	36315	11629	47944	3906	51850	92882	55.82%	39.1%	78	81
8	高雄市大寮區	2018-11-25T01:16:17+08:00	38152	12176	50328	4102	54430	97309	55.94%	39.21%	81	81
8	苗栗縣獅潭鄉	2018-11-25T03:37:26+08:00	1444	370	1814	204	2018	3968	50.86%	36.39%	7	7
8	苗栗縣獅潭鄉	2018-11-24T23:07:16+08:00	1444	370	1814	204	2018	3968	50.86%	36.39%	7	7
8	苗栗縣獅潭鄉	2018-11-24T22:12:00+08:00	1444	370	1814	204	2018	3968	50.86%	36.39%	7	7
8	苗栗縣獅潭鄉	2018-11-24T22:39:07+08:00	1444	370	1814	204	2018	3968	50.86%	36.39%	7	7
8	苗栗縣獅潭鄉	2018-11-24T23:03:45+08:00	1444	370	1814	204	2018	3968	50.86%	36.39%	7	7
8	苗栗縣獅潭鄉	2018-11-24T23:22:21+08:00	1444	370	1814	204	2018	3968	50.86%	36.39%	7	7
8	苗栗縣獅潭鄉	2018-11-25T01:24:22+08:00	1444	370	1814	204	2018	3968	50.86%	36.39%	7	7
8	苗栗縣獅潭鄉	2018-11-24T23:46:01+08:00	1444	370	1814	204	2018	3968	50.86%	36.39%	7	7
8	苗栗縣獅潭鄉	2018-11-24T23:42:00+08:00	1444	370	1814	204	2018	3968	50.86%	36.39%	7	7
8	苗栗縣獅潭鄉	2018-11-25T03:30:56+08:00	1444	370	1814	204	2018	3968	50.86%	36.39%	7	7
8	苗栗縣獅潭鄉	2018-11-25T03:42:45+08:00	1444	370	1814	204	2018	3968	50.86%	36.39%	7	7
8	苗栗縣獅潭鄉	2018-11-24T22:32:16+08:00	1444	370	1814	204	2018	3968	50.86%	36.39%	7	7
8	苗栗縣獅潭鄉	2018-11-25T03:48:27+08:00	1444	370	1814	204	2018	3968	50.86%	36.39%	7	7
8	苗栗縣獅潭鄉	2018-11-25T01:00:58+08:00	1444	370	1814	204	2018	3968	50.86%	36.39%	7	7
8	苗栗縣獅潭鄉	2018-11-24T22:25:21+08:00	1444	370	1814	204	2018	3968	50.86%	36.39%	7	7
8	苗栗縣獅潭鄉	2018-11-25T04:01:27+08:00	1444	370	1814	204	2018	3968	50.86%	36.39%	7	7
8	苗栗縣獅潭鄉	2018-11-24T22:21:43+08:00	1444	370	1814	204	2018	3968	50.86%	36.39%	7	7
8	苗栗縣獅潭鄉	2018-11-24T22:40:17+08:00	1444	370	1814	204	2018	3968	50.86%	36.39%	7	7
8	苗栗縣獅潭鄉	2018-11-25T00:21:42+08:00	1444	370	1814	204	2018	3968	50.86%	36.39%	7	7
8	苗栗縣獅潭鄉	2018-11-25T06:12:35+08:00	1444	370	1814	204	2018	3968	50.86%	36.39%	7	7
8	苗栗縣獅潭鄉	2018-11-24T22:35:42+08:00	1444	370	1814	204	2018	3968	50.86%	36.39%	7	7
8	苗栗縣獅潭鄉	2018-11-24T23:58:40+08:00	1444	370	1814	204	2018	3968	50.86%	36.39%	7	7
8	苗栗縣獅潭鄉	2018-11-24T23:26:05+08:00	1444	370	1814	204	2018	3968	50.86%	36.39%	7	7
8	苗栗縣獅潭鄉	2018-11-24T23:37:47+08:00	1444	370	1814	204	2018	3968	50.86%	36.39%	7	7
8	苗栗縣獅潭鄉	2018-11-24T23:18:25+08:00	1444	370	1814	204	2018	3968	50.86%	36.39%	7	7
8	苗栗縣獅潭鄉	2018-11-24T23:33:48+08:00	1444	370	1814	204	2018	3968	50.86%	36.39%	7	7
8	苗栗縣獅潭鄉	2018-11-25T03:54:38+08:00	1444	370	1814	204	2018	3968	50.86%	36.39%	7	7
8	苗栗縣獅潭鄉	2018-11-24T22:43:48+08:00	1444	370	1814	204	2018	3968	50.86%	36.39%	7	7
8	苗栗縣獅潭鄉	2018-11-24T23:10:54+08:00	1444	370	1814	204	2018	3968	50.86%	36.39%	7	7
8	苗栗縣獅潭鄉	2018-11-25T06:17:33+08:00	1444	370	1814	204	2018	3968	50.86%	36.39%	7	7
8	苗栗縣獅潭鄉	2018-11-24T22:56:34+08:00	1444	370	1814	204	2018	3968	50.86%	36.39%	7	7
8	苗栗縣獅潭鄉	2018-11-24T23:14:38+08:00	1444	370	1814	204	2018	3968	50.86%	36.39%	7	7
8	苗栗縣獅潭鄉	2018-11-24T22:49:22+08:00	1444	370	1814	204	2018	3968	50.86%	36.39%	7	7
8	苗栗縣獅潭鄉	2018-11-25T00:08:02+08:00	1444	370	1814	204	2018	3968	50.86%	36.39%	7	7
8	苗栗縣獅潭鄉	2018-11-24T22:53:12+08:00	1444	370	1814	204	2018	3968	50.86%	36.39%	7	7
8	苗栗縣獅潭鄉	2018-11-25T06:22:43+08:00	1444	370	1814	204	2018	3968	50.86%	36.39%	7	7
8	苗栗縣獅潭鄉	2018-11-24T23:29:44+08:00	1444	370	1814	204	2018	3968	50.86%	36.39%	7	7
8	苗栗縣獅潭鄉	2018-11-25T00:17:06+08:00	1444	370	1814	204	2018	3968	50.86%	36.39%	7	7
8	苗栗縣獅潭鄉	2018-11-25T01:11:04+08:00	1444	370	1814	204	2018	3968	50.86%	36.39%	7	7
8	苗栗縣獅潭鄉	2018-11-25T06:07:20+08:00	1444	370	1814	204	2018	3968	50.86%	36.39%	7	7
8	苗栗縣獅潭鄉	2018-11-24T23:00:15+08:00	1444	370	1814	204	2018	3968	50.86%	36.39%	7	7
8	苗栗縣獅潭鄉	2018-11-25T00:12:43+08:00	1444	370	1814	204	2018	3968	50.86%	36.39%	7	7
8	苗栗縣獅潭鄉	2018-11-24T22:28:38+08:00	1444	370	1814	204	2018	3968	50.86%	36.39%	7	7
8	苗栗縣獅潭鄉	2018-11-25T01:05:56+08:00	1444	370	1814	204	2018	3968	50.86%	36.39%	7	7
8	苗栗縣獅潭鄉	2018-11-25T06:27:53+08:00	1444	370	1814	204	2018	3968	50.86%	36.39%	7	7
8	苗栗縣獅潭鄉	2018-11-25T00:03:31+08:00	1444	370	1814	204	2018	3968	50.86%	36.39%	7	7
8	苗栗縣獅潭鄉	2018-11-24T23:54:25+08:00	1444	370	1814	204	2018	3968	50.86%	36.39%	7	7
8	苗栗縣獅潭鄉	2018-11-24T22:14:46+08:00	1444	370	1814	204	2018	3968	50.86%	36.39%	7	7
8	苗栗縣獅潭鄉	2018-11-25T00:56:11+08:00	1444	370	1814	204	2018	3968	50.86%	36.39%	7	7
8	苗栗縣獅潭鄉	2018-11-24T22:18:17+08:00	1444	370	1814	204	2018	3968	50.86%	36.39%	7	7
8	苗栗縣獅潭鄉	2018-11-25T01:16:19+08:00	1444	370	1814	204	2018	3968	50.86%	36.39%	7	7
8	苗栗縣獅潭鄉	2018-11-24T23:50:12+08:00	1444	370	1814	204	2018	3968	50.86%	36.39%	7	7
8	苗栗縣卓蘭鎮	2018-11-24T23:07:16+08:00	5633	1630	7263	586	7849	13677	57.39%	41.19%	18	19
8	苗栗縣卓蘭鎮	2018-11-24T22:12:00+08:00	5244	1530	6774	567	7341	12737	57.64%	41.17%	17	19
8	苗栗縣卓蘭鎮	2018-11-24T22:39:06+08:00	5633	1630	7263	586	7849	13677	57.39%	41.19%	18	19
8	苗栗縣卓蘭鎮	2018-11-24T23:22:20+08:00	5633	1630	7263	586	7849	13677	57.39%	41.19%	18	19
8	苗栗縣卓蘭鎮	2018-11-24T23:58:39+08:00	5633	1630	7263	586	7849	13677	57.39%	41.19%	18	19
8	苗栗縣卓蘭鎮	2018-11-24T23:03:45+08:00	5633	1630	7263	586	7849	13677	57.39%	41.19%	18	19
8	苗栗縣卓蘭鎮	2018-11-24T22:49:21+08:00	5633	1630	7263	586	7849	13677	57.39%	41.19%	18	19
8	苗栗縣卓蘭鎮	2018-11-24T23:46:01+08:00	5633	1630	7263	586	7849	13677	57.39%	41.19%	18	19
8	苗栗縣卓蘭鎮	2018-11-25T03:48:26+08:00	6104	1799	7903	650	8553	14772	57.9%	41.32%	19	19
8	苗栗縣卓蘭鎮	2018-11-25T03:30:56+08:00	6104	1799	7903	650	8553	14772	57.9%	41.32%	19	19
8	苗栗縣卓蘭鎮	2018-11-25T03:42:45+08:00	6104	1799	7903	650	8553	14772	57.9%	41.32%	19	19
8	苗栗縣卓蘭鎮	2018-11-24T22:32:16+08:00	5244	1530	6774	567	7341	12737	57.64%	41.17%	17	19
8	苗栗縣卓蘭鎮	2018-11-25T01:00:58+08:00	6104	1799	7903	650	8553	14772	57.9%	41.32%	19	19
8	苗栗縣卓蘭鎮	2018-11-24T22:25:21+08:00	5244	1530	6774	567	7341	12737	57.64%	41.17%	17	19
8	苗栗縣卓蘭鎮	2018-11-25T06:12:34+08:00	6104	1799	7903	650	8553	14772	57.9%	41.32%	19	19
8	苗栗縣卓蘭鎮	2018-11-24T22:40:16+08:00	5633	1630	7263	586	7849	13677	57.39%	41.19%	18	19
8	苗栗縣卓蘭鎮	2018-11-25T04:01:27+08:00	6104	1799	7903	650	8553	14772	57.9%	41.32%	19	19
8	苗栗縣卓蘭鎮	2018-11-24T22:21:43+08:00	5244	1530	6774	567	7341	12737	57.64%	41.17%	17	19
8	苗栗縣卓蘭鎮	2018-11-25T00:17:05+08:00	6104	1799	7903	650	8553	14772	57.9%	41.32%	19	19
8	苗栗縣卓蘭鎮	2018-11-25T00:21:42+08:00	6104	1799	7903	650	8553	14772	57.9%	41.32%	19	19
8	苗栗縣卓蘭鎮	2018-11-24T23:37:46+08:00	5633	1630	7263	586	7849	13677	57.39%	41.19%	18	19
8	苗栗縣卓蘭鎮	2018-11-24T22:35:42+08:00	5244	1530	6774	567	7341	12737	57.64%	41.17%	17	19
8	苗栗縣卓蘭鎮	2018-11-24T23:33:47+08:00	5633	1630	7263	586	7849	13677	57.39%	41.19%	18	19
8	苗栗縣卓蘭鎮	2018-11-24T23:18:25+08:00	5633	1630	7263	586	7849	13677	57.39%	41.19%	18	19
8	苗栗縣卓蘭鎮	2018-11-24T23:26:04+08:00	5633	1630	7263	586	7849	13677	57.39%	41.19%	18	19
8	苗栗縣卓蘭鎮	2018-11-25T03:54:38+08:00	6104	1799	7903	650	8553	14772	57.9%	41.32%	19	19
8	苗栗縣卓蘭鎮	2018-11-25T03:37:25+08:00	6104	1799	7903	650	8553	14772	57.9%	41.32%	19	19
8	苗栗縣卓蘭鎮	2018-11-24T23:10:54+08:00	5633	1630	7263	586	7849	13677	57.39%	41.19%	18	19
8	苗栗縣卓蘭鎮	2018-11-24T23:14:37+08:00	5633	1630	7263	586	7849	13677	57.39%	41.19%	18	19
8	苗栗縣卓蘭鎮	2018-11-25T06:17:33+08:00	6104	1799	7903	650	8553	14772	57.9%	41.32%	19	19
8	苗栗縣卓蘭鎮	2018-11-24T22:43:47+08:00	5633	1630	7263	586	7849	13677	57.39%	41.19%	18	19
8	苗栗縣卓蘭鎮	2018-11-25T01:24:21+08:00	6104	1799	7903	650	8553	14772	57.9%	41.32%	19	19
8	苗栗縣卓蘭鎮	2018-11-24T22:56:34+08:00	5633	1630	7263	586	7849	13677	57.39%	41.19%	18	19
8	苗栗縣卓蘭鎮	2018-11-25T00:08:02+08:00	6104	1799	7903	650	8553	14772	57.9%	41.32%	19	19
8	苗栗縣卓蘭鎮	2018-11-24T22:53:12+08:00	5633	1630	7263	586	7849	13677	57.39%	41.19%	18	19
8	苗栗縣卓蘭鎮	2018-11-25T01:11:04+08:00	6104	1799	7903	650	8553	14772	57.9%	41.32%	19	19
8	苗栗縣卓蘭鎮	2018-11-24T23:29:43+08:00	5633	1630	7263	586	7849	13677	57.39%	41.19%	18	19
8	苗栗縣卓蘭鎮	2018-11-25T06:22:42+08:00	6104	1799	7903	650	8553	14772	57.9%	41.32%	19	19
8	苗栗縣卓蘭鎮	2018-11-25T06:07:20+08:00	6104	1799	7903	650	8553	14772	57.9%	41.32%	19	19
8	苗栗縣卓蘭鎮	2018-11-24T23:00:15+08:00	5633	1630	7263	586	7849	13677	57.39%	41.19%	18	19
8	苗栗縣卓蘭鎮	2018-11-25T01:05:56+08:00	6104	1799	7903	650	8553	14772	57.9%	41.32%	19	19
8	苗栗縣卓蘭鎮	2018-11-24T23:41:59+08:00	5633	1630	7263	586	7849	13677	57.39%	41.19%	18	19
8	苗栗縣卓蘭鎮	2018-11-25T00:03:31+08:00	5633	1630	7263	586	7849	13677	57.39%	41.19%	18	19
8	苗栗縣卓蘭鎮	2018-11-24T23:54:25+08:00	5633	1630	7263	586	7849	13677	57.39%	41.19%	18	19
8	苗栗縣卓蘭鎮	2018-11-24T22:14:46+08:00	5244	1530	6774	567	7341	12737	57.64%	41.17%	17	19
8	苗栗縣卓蘭鎮	2018-11-25T06:27:52+08:00	6104	1799	7903	650	8553	14772	57.9%	41.32%	19	19
8	苗栗縣卓蘭鎮	2018-11-25T00:56:11+08:00	6104	1799	7903	650	8553	14772	57.9%	41.32%	19	19
8	苗栗縣卓蘭鎮	2018-11-24T22:18:17+08:00	5244	1530	6774	567	7341	12737	57.64%	41.17%	17	19
8	苗栗縣卓蘭鎮	2018-11-25T00:12:42+08:00	6104	1799	7903	650	8553	14772	57.9%	41.32%	19	19
8	苗栗縣卓蘭鎮	2018-11-24T22:28:37+08:00	5244	1530	6774	567	7341	12737	57.64%	41.17%	17	19
8	苗栗縣卓蘭鎮	2018-11-25T01:16:19+08:00	6104	1799	7903	650	8553	14772	57.9%	41.32%	19	19
8	苗栗縣卓蘭鎮	2018-11-24T23:50:12+08:00	5633	1630	7263	586	7849	13677	57.39%	41.19%	18	19
8	桃園市龜山區	2018-11-25T03:37:17+08:00	45663	14542	60205	3969	64174	131702	48.73%	34.67%	78	78
8	桃園市龜山區	2018-11-25T01:10:58+08:00	39492	12605	52097	3558	55655	114152	48.76%	34.6%	69	78
8	桃園市龜山區	2018-11-25T00:12:37+08:00	32611	10339	42950	2867	45817	94278	48.6%	34.59%	58	78
8	桃園市龜山區	2018-11-24T22:49:17+08:00	19406	6271	25677	1777	27454	56774	48.36%	34.18%	38	78
8	桃園市龜山區	2018-11-24T23:14:32+08:00	23978	7552	31530	2199	33729	69851	48.29%	34.33%	45	78
8	桃園市龜山區	2018-11-24T22:43:43+08:00	19406	6271	25677	1777	27454	56774	48.36%	34.18%	38	78
8	桃園市龜山區	2018-11-24T22:56:30+08:00	20978	6800	27778	1913	29691	61601	48.2%	34.05%	41	78
8	桃園市龜山區	2018-11-25T06:22:37+08:00	45663	14542	60205	3969	64174	131702	48.73%	34.67%	78	78
8	桃園市龜山區	2018-11-25T03:30:50+08:00	45663	14542	60205	3969	64174	131702	48.73%	34.67%	78	78
8	桃園市龜山區	2018-11-25T03:48:21+08:00	45663	14542	60205	3969	64174	131702	48.73%	34.67%	78	78
8	桃園市龜山區	2018-11-24T22:32:11+08:00	18030	5893	23923	1672	25595	53275	48.04%	33.84%	36	78
8	桃園市龜山區	2018-11-24T23:29:39+08:00	27347	8664	36011	2472	38483	79569	48.36%	34.37%	50	78
8	桃園市龜山區	2018-11-25T04:01:21+08:00	45663	14542	60205	3969	64174	131702	48.73%	34.67%	78	78
8	桃園市龜山區	2018-11-24T22:25:17+08:00	16459	5384	21843	1513	23356	48191	48.47%	34.15%	33	78
8	桃園市龜山區	2018-11-25T06:07:15+08:00	45663	14542	60205	3969	64174	131702	48.73%	34.67%	78	78
8	桃園市龜山區	2018-11-24T22:18:12+08:00	15300	5009	20309	1427	21736	45054	48.24%	33.96%	31	78
8	桃園市龜山區	2018-11-24T23:54:18+08:00	29115	9252	38367	2603	40970	84540	48.46%	34.44%	53	78
8	桃園市龜山區	2018-11-25T00:07:57+08:00	31744	10061	41805	2797	44602	91998	48.48%	34.51%	57	78
8	桃園市龜山區	2018-11-25T01:16:14+08:00	41472	13294	54766	3703	58469	119685	48.85%	34.65%	72	78
8	桃園市龜山區	2018-11-24T23:41:55+08:00	28560	9077	37637	2577	40214	83041	48.43%	34.39%	52	78
8	桃園市龜山區	2018-11-24T22:28:33+08:00	17546	5720	23266	1610	24876	51777	48.04%	33.89%	35	78
8	桃園市龜山區	2018-11-24T23:58:34+08:00	30950	9811	40761	2732	43493	89820	48.42%	34.46%	56	78
8	桃園市龜山區	2018-11-24T23:22:15+08:00	26842	8487	35329	2433	37762	78114	48.34%	34.36%	49	78
8	桃園市龜山區	2018-11-25T01:24:16+08:00	41472	13294	54766	3703	58469	119685	48.85%	34.65%	72	78
8	桃園市龜山區	2018-11-24T22:35:38+08:00	18030	5893	23923	1672	25595	53275	48.04%	33.84%	36	78
8	桃園市龜山區	2018-11-24T23:07:12+08:00	23343	7371	30714	2130	32844	67737	48.49%	34.46%	44	78
8	桃園市龜山區	2018-11-24T22:39:02+08:00	18030	5893	23923	1672	25595	53275	48.04%	33.84%	36	78
8	桃園市龜山區	2018-11-25T00:56:05+08:00	38488	12246	50734	3451	54185	110981	48.82%	34.68%	67	78
8	桃園市龜山區	2018-11-25T06:27:48+08:00	45663	14542	60205	3969	64174	131702	48.73%	34.67%	78	78
8	桃園市龜山區	2018-11-24T23:50:07+08:00	29115	9252	38367	2603	40970	84540	48.46%	34.44%	53	78
8	桃園市龜山區	2018-11-25T00:03:25+08:00	30950	9811	40761	2732	43493	89820	48.42%	34.46%	56	78
8	桃園市龜山區	2018-11-24T23:03:41+08:00	23343	7371	30714	2130	32844	67737	48.49%	34.46%	44	78
8	桃園市龜山區	2018-11-24T23:00:06+08:00	21773	6958	28731	1976	30707	63486	48.37%	34.3%	42	78
8	桃園市龜山區	2018-11-24T22:21:38+08:00	15854	5144	20998	1470	22468	46373	48.45%	34.19%	32	78
8	桃園市龜山區	2018-11-25T00:21:36+08:00	33284	10580	43864	2924	46788	96298	48.59%	34.56%	59	78
8	桃園市龜山區	2018-11-25T01:00:52+08:00	39080	12439	51519	3486	55005	112924	48.71%	34.61%	68	78
8	桃園市龜山區	2018-11-25T06:12:30+08:00	45663	14542	60205	3969	64174	131702	48.73%	34.67%	78	78
8	桃園市龜山區	2018-11-24T22:53:06+08:00	19899	6419	26318	1823	28141	58433	48.16%	34.05%	39	78
8	桃園市龜山區	2018-11-24T22:40:12+08:00	18717	6063	24780	1718	26498	54815	48.34%	34.15%	37	78
8	桃園市龜山區	2018-11-25T03:42:39+08:00	45663	14542	60205	3969	64174	131702	48.73%	34.67%	78	78
8	桃園市龜山區	2018-11-25T00:17:01+08:00	32611	10339	42950	2867	45817	94278	48.6%	34.59%	58	78
8	桃園市龜山區	2018-11-24T22:11:56+08:00	14300	4650	18950	1282	20232	41887	48.3%	34.14%	29	78
8	桃園市龜山區	2018-11-25T03:54:33+08:00	45663	14542	60205	3969	64174	131702	48.73%	34.67%	78	78
8	桃園市龜山區	2018-11-24T23:33:43+08:00	27347	8664	36011	2472	38483	79569	48.36%	34.37%	50	78
8	桃園市龜山區	2018-11-24T23:18:20+08:00	24546	7786	32332	2278	34610	71603	48.34%	34.28%	46	78
8	桃園市龜山區	2018-11-24T23:37:42+08:00	27966	8878	36844	2529	39373	81373	48.39%	34.37%	51	78
8	桃園市龜山區	2018-11-24T22:14:41+08:00	15300	5009	20309	1427	21736	45054	48.24%	33.96%	31	78
8	桃園市龜山區	2018-11-25T01:05:50+08:00	39492	12605	52097	3558	55655	114152	48.76%	34.6%	69	78
8	桃園市龜山區	2018-11-24T23:26:00+08:00	26842	8487	35329	2433	37762	78114	48.34%	34.36%	49	78
8	桃園市龜山區	2018-11-24T23:10:49+08:00	23978	7552	31530	2199	33729	69851	48.29%	34.33%	45	78
8	桃園市龜山區	2018-11-25T06:17:28+08:00	45663	14542	60205	3969	64174	131702	48.73%	34.67%	78	78
8	桃園市龜山區	2018-11-24T23:45:57+08:00	29115	9252	38367	2603	40970	84540	48.46%	34.44%	53	78
8	臺南市永康區	2018-11-25T00:56:08+08:00	69493	22722	92215	7200	99415	195001	50.98%	35.64%	142	142
8	臺南市永康區	2018-11-24T23:14:34+08:00	68502	22333	90835	7132	97967	191857	51.06%	35.7%	140	142
8	臺南市永康區	2018-11-24T23:03:43+08:00	67693	22077	89770	7051	96821	189484	51.1%	35.72%	138	142
8	臺南市永康區	2018-11-24T23:58:37+08:00	68996	22520	91516	7163	98679	193411	51.02%	35.67%	141	142
8	臺南市永康區	2018-11-25T06:17:31+08:00	69493	22722	92215	7200	99415	195001	50.98%	35.64%	142	142
8	臺南市永康區	2018-11-24T23:22:18+08:00	68502	22333	90835	7132	97967	191857	51.06%	35.7%	140	142
8	臺南市永康區	2018-11-24T22:43:45+08:00	64166	21196	85362	6761	92123	180346	51.08%	35.58%	132	142
8	臺南市永康區	2018-11-25T03:37:20+08:00	69493	22722	92215	7200	99415	195001	50.98%	35.64%	142	142
8	臺南市永康區	2018-11-24T22:49:19+08:00	64166	21196	85362	6761	92123	180346	51.08%	35.58%	132	142
8	臺南市永康區	2018-11-25T00:03:28+08:00	68996	22520	91516	7163	98679	193411	51.02%	35.67%	141	142
8	臺南市永康區	2018-11-25T03:42:42+08:00	69493	22722	92215	7200	99415	195001	50.98%	35.64%	142	142
8	臺南市永康區	2018-11-24T22:25:19+08:00	58443	19220	77663	6124	83787	163535	51.23%	35.74%	121	142
8	臺南市永康區	2018-11-25T06:22:40+08:00	69493	22722	92215	7200	99415	195001	50.98%	35.64%	142	142
8	臺南市永康區	2018-11-25T00:17:03+08:00	68996	22520	91516	7163	98679	193411	51.02%	35.67%	141	142
8	臺南市永康區	2018-11-25T01:11:01+08:00	69493	22722	92215	7200	99415	195001	50.98%	35.64%	142	142
8	臺南市永康區	2018-11-24T23:29:41+08:00	68502	22333	90835	7132	97967	191857	51.06%	35.7%	140	142
8	臺南市永康區	2018-11-25T06:12:32+08:00	69493	22722	92215	7200	99415	195001	50.98%	35.64%	142	142
8	臺南市永康區	2018-11-24T23:50:10+08:00	68502	22333	90835	7132	97967	191857	51.06%	35.7%	140	142
8	臺南市永康區	2018-11-25T00:12:40+08:00	68996	22520	91516	7163	98679	193411	51.02%	35.67%	141	142
8	臺南市永康區	2018-11-24T22:28:35+08:00	59315	19579	78894	6250	85144	166223	51.22%	35.68%	123	142
8	臺南市永康區	2018-11-24T22:14:43+08:00	51766	16877	68643	5448	74091	144377	51.32%	35.85%	109	142
8	臺南市永康區	2018-11-24T23:26:02+08:00	68502	22333	90835	7132	97967	191857	51.06%	35.7%	140	142
8	臺南市永康區	2018-11-24T23:54:20+08:00	68502	22333	90835	7132	97967	191857	51.06%	35.7%	140	142
8	臺南市永康區	2018-11-25T06:27:50+08:00	69493	22722	92215	7200	99415	195001	50.98%	35.64%	142	142
8	臺南市永康區	2018-11-25T00:07:59+08:00	68996	22520	91516	7163	98679	193411	51.02%	35.67%	141	142
8	臺南市永康區	2018-11-24T23:18:22+08:00	68502	22333	90835	7132	97967	191857	51.06%	35.7%	140	142
8	臺南市永康區	2018-11-25T01:05:53+08:00	69493	22722	92215	7200	99415	195001	50.98%	35.64%	142	142
8	臺南市永康區	2018-11-24T22:18:14+08:00	53417	17469	70886	5613	76499	148825	51.4%	35.89%	112	142
8	臺南市永康區	2018-11-24T22:56:32+08:00	65383	21540	86923	6829	93752	183845	51%	35.56%	134	142
8	臺南市永康區	2018-11-25T01:24:19+08:00	69493	22722	92215	7200	99415	195001	50.98%	35.64%	142	142
8	臺南市永康區	2018-11-24T22:39:04+08:00	62605	20650	83255	6623	89878	175753	51.14%	35.62%	129	142
8	臺南市永康區	2018-11-24T23:10:52+08:00	68502	22333	90835	7132	97967	191857	51.06%	35.7%	140	142
8	臺南市永康區	2018-11-24T23:07:14+08:00	67942	22159	90101	7072	97173	190156	51.1%	35.73%	139	142
8	臺南市永康區	2018-11-25T00:21:39+08:00	68996	22520	91516	7163	98679	193411	51.02%	35.67%	141	142
8	臺南市永康區	2018-11-24T22:32:13+08:00	60422	19929	80351	6378	86729	169326	51.22%	35.68%	125	142
8	臺南市永康區	2018-11-25T03:30:53+08:00	69493	22722	92215	7200	99415	195001	50.98%	35.64%	142	142
8	臺南市永康區	2018-11-25T03:48:24+08:00	69493	22722	92215	7200	99415	195001	50.98%	35.64%	142	142
8	臺南市永康區	2018-11-25T01:00:55+08:00	69493	22722	92215	7200	99415	195001	50.98%	35.64%	142	142
8	臺南市永康區	2018-11-24T23:00:13+08:00	65900	21707	87607	6872	94479	185206	51.01%	35.58%	135	142
8	臺南市永康區	2018-11-25T06:07:17+08:00	69493	22722	92215	7200	99415	195001	50.98%	35.64%	142	142
8	臺南市永康區	2018-11-24T22:53:09+08:00	64166	21196	85362	6761	92123	180346	51.08%	35.58%	132	142
8	臺南市永康區	2018-11-24T22:40:14+08:00	62605	20650	83255	6623	89878	175753	51.14%	35.62%	129	142
8	臺南市永康區	2018-11-24T22:11:58+08:00	50518	16450	66968	5320	72288	140818	51.33%	35.87%	107	142
8	臺南市永康區	2018-11-25T04:01:23+08:00	69493	22722	92215	7200	99415	195001	50.98%	35.64%	142	142
8	臺南市永康區	2018-11-24T22:21:40+08:00	57298	18847	76145	5993	82138	160253	51.26%	35.75%	119	142
8	臺南市永康區	2018-11-24T23:41:57+08:00	68502	22333	90835	7132	97967	191857	51.06%	35.7%	140	142
8	臺南市永康區	2018-11-25T01:16:16+08:00	69493	22722	92215	7200	99415	195001	50.98%	35.64%	142	142
8	臺南市永康區	2018-11-24T22:35:40+08:00	62185	20493	82678	6575	89253	174275	51.21%	35.68%	128	142
8	臺南市永康區	2018-11-25T03:54:35+08:00	69493	22722	92215	7200	99415	195001	50.98%	35.64%	142	142
8	臺南市永康區	2018-11-24T23:33:45+08:00	68502	22333	90835	7132	97967	191857	51.06%	35.7%	140	142
8	臺南市永康區	2018-11-24T23:37:44+08:00	68502	22333	90835	7132	97967	191857	51.06%	35.7%	140	142
8	臺南市永康區	2018-11-24T23:45:59+08:00	68502	22333	90835	7132	97967	191857	51.06%	35.7%	140	142
8	屏東縣新埤鄉	2018-11-24T23:10:57+08:00	2880	990	3870	548	4418	9033	48.91%	31.88%	12	12
8	屏東縣新埤鄉	2018-11-24T23:07:19+08:00	2880	990	3870	548	4418	9033	48.91%	31.88%	12	12
8	屏東縣新埤鄉	2018-11-24T22:14:50+08:00	2543	869	3412	471	3883	7710	50.36%	32.98%	11	12
8	屏東縣新埤鄉	2018-11-25T06:17:37+08:00	2880	990	3870	548	4418	9033	48.91%	31.88%	12	12
8	屏東縣新埤鄉	2018-11-25T01:24:25+08:00	2880	990	3870	548	4418	9033	48.91%	31.88%	12	12
8	屏東縣新埤鄉	2018-11-24T22:56:37+08:00	2543	869	3412	471	3883	7710	50.36%	32.98%	11	12
8	屏東縣新埤鄉	2018-11-25T03:54:41+08:00	2880	990	3870	548	4418	9033	48.91%	31.88%	12	12
8	屏東縣新埤鄉	2018-11-24T22:32:19+08:00	2543	869	3412	471	3883	7710	50.36%	32.98%	11	12
8	屏東縣新埤鄉	2018-11-24T22:53:16+08:00	2543	869	3412	471	3883	7710	50.36%	32.98%	11	12
8	屏東縣新埤鄉	2018-11-25T01:06:00+08:00	2880	990	3870	548	4418	9033	48.91%	31.88%	12	12
8	屏東縣新埤鄉	2018-11-24T22:25:26+08:00	2543	869	3412	471	3883	7710	50.36%	32.98%	11	12
8	屏東縣新埤鄉	2018-11-24T23:00:17+08:00	2543	869	3412	471	3883	7710	50.36%	32.98%	11	12
8	屏東縣新埤鄉	2018-11-25T01:11:08+08:00	2880	990	3870	548	4418	9033	48.91%	31.88%	12	12
8	屏東縣新埤鄉	2018-11-25T06:07:23+08:00	2880	990	3870	548	4418	9033	48.91%	31.88%	12	12
8	屏東縣新埤鄉	2018-11-24T22:40:19+08:00	2543	869	3412	471	3883	7710	50.36%	32.98%	11	12
8	屏東縣新埤鄉	2018-11-24T23:29:47+08:00	2880	990	3870	548	4418	9033	48.91%	31.88%	12	12
8	屏東縣新埤鄉	2018-11-25T00:21:45+08:00	2880	990	3870	548	4418	9033	48.91%	31.88%	12	12
8	屏東縣新埤鄉	2018-11-25T03:31:00+08:00	2880	990	3870	548	4418	9033	48.91%	31.88%	12	12
8	屏東縣新埤鄉	2018-11-25T01:16:23+08:00	2880	990	3870	548	4418	9033	48.91%	31.88%	12	12
8	屏東縣新埤鄉	2018-11-25T00:03:35+08:00	2880	990	3870	548	4418	9033	48.91%	31.88%	12	12
8	屏東縣新埤鄉	2018-11-25T00:56:14+08:00	2880	990	3870	548	4418	9033	48.91%	31.88%	12	12
8	屏東縣新埤鄉	2018-11-24T22:35:45+08:00	2543	869	3412	471	3883	7710	50.36%	32.98%	11	12
8	屏東縣新埤鄉	2018-11-24T23:14:42+08:00	2880	990	3870	548	4418	9033	48.91%	31.88%	12	12
8	屏東縣新埤鄉	2018-11-24T23:37:49+08:00	2880	990	3870	548	4418	9033	48.91%	31.88%	12	12
8	屏東縣新埤鄉	2018-11-24T22:43:51+08:00	2543	869	3412	471	3883	7710	50.36%	32.98%	11	12
8	屏東縣新埤鄉	2018-11-25T06:27:56+08:00	2880	990	3870	548	4418	9033	48.91%	31.88%	12	12
8	屏東縣新埤鄉	2018-11-24T23:54:28+08:00	2880	990	3870	548	4418	9033	48.91%	31.88%	12	12
8	屏東縣新埤鄉	2018-11-24T23:22:24+08:00	2880	990	3870	548	4418	9033	48.91%	31.88%	12	12
8	屏東縣新埤鄉	2018-11-24T22:28:41+08:00	2543	869	3412	471	3883	7710	50.36%	32.98%	11	12
8	屏東縣新埤鄉	2018-11-24T22:12:03+08:00	2543	869	3412	471	3883	7710	50.36%	32.98%	11	12
8	屏東縣新埤鄉	2018-11-24T23:33:51+08:00	2880	990	3870	548	4418	9033	48.91%	31.88%	12	12
8	屏東縣新埤鄉	2018-11-24T23:03:48+08:00	2543	869	3412	471	3883	7710	50.36%	32.98%	11	12
8	屏東縣新埤鄉	2018-11-24T22:49:25+08:00	2543	869	3412	471	3883	7710	50.36%	32.98%	11	12
8	屏東縣新埤鄉	2018-11-25T04:01:30+08:00	2880	990	3870	548	4418	9033	48.91%	31.88%	12	12
8	屏東縣新埤鄉	2018-11-25T03:42:49+08:00	2880	990	3870	548	4418	9033	48.91%	31.88%	12	12
8	屏東縣新埤鄉	2018-11-24T23:42:02+08:00	2880	990	3870	548	4418	9033	48.91%	31.88%	12	12
8	屏東縣新埤鄉	2018-11-25T00:08:05+08:00	2880	990	3870	548	4418	9033	48.91%	31.88%	12	12
8	屏東縣新埤鄉	2018-11-24T23:46:04+08:00	2880	990	3870	548	4418	9033	48.91%	31.88%	12	12
8	屏東縣新埤鄉	2018-11-25T00:17:09+08:00	2880	990	3870	548	4418	9033	48.91%	31.88%	12	12
8	屏東縣新埤鄉	2018-11-25T06:12:37+08:00	2880	990	3870	548	4418	9033	48.91%	31.88%	12	12
8	屏東縣新埤鄉	2018-11-25T06:22:45+08:00	2880	990	3870	548	4418	9033	48.91%	31.88%	12	12
8	屏東縣新埤鄉	2018-11-24T22:21:47+08:00	2543	869	3412	471	3883	7710	50.36%	32.98%	11	12
8	屏東縣新埤鄉	2018-11-25T03:48:31+08:00	2880	990	3870	548	4418	9033	48.91%	31.88%	12	12
8	屏東縣新埤鄉	2018-11-24T22:39:10+08:00	2543	869	3412	471	3883	7710	50.36%	32.98%	11	12
8	屏東縣新埤鄉	2018-11-24T22:18:20+08:00	2543	869	3412	471	3883	7710	50.36%	32.98%	11	12
8	屏東縣新埤鄉	2018-11-25T03:37:30+08:00	2880	990	3870	548	4418	9033	48.91%	31.88%	12	12
8	屏東縣新埤鄉	2018-11-24T23:58:43+08:00	2880	990	3870	548	4418	9033	48.91%	31.88%	12	12
8	屏東縣新埤鄉	2018-11-24T23:26:07+08:00	2880	990	3870	548	4418	9033	48.91%	31.88%	12	12
8	屏東縣新埤鄉	2018-11-25T00:12:45+08:00	2880	990	3870	548	4418	9033	48.91%	31.88%	12	12
8	屏東縣新埤鄉	2018-11-25T01:01:02+08:00	2880	990	3870	548	4418	9033	48.91%	31.88%	12	12
8	屏東縣新埤鄉	2018-11-24T23:18:28+08:00	2880	990	3870	548	4418	9033	48.91%	31.88%	12	12
8	屏東縣新埤鄉	2018-11-24T23:50:15+08:00	2880	990	3870	548	4418	9033	48.91%	31.88%	12	12
8	臺南市安定區	2018-11-25T03:37:19+08:00	9082	3227	12309	1359	13668	26104	52.36%	34.79%	24	24
8	臺南市安定區	2018-11-25T00:56:08+08:00	9082	3227	12309	1359	13668	26104	52.36%	34.79%	24	24
8	臺南市安定區	2018-11-24T22:49:18+08:00	9082	3227	12309	1359	13668	26104	52.36%	34.79%	24	24
8	臺南市安定區	2018-11-24T23:14:34+08:00	9082	3227	12309	1359	13668	26104	52.36%	34.79%	24	24
8	臺南市安定區	2018-11-24T22:43:45+08:00	9082	3227	12309	1359	13668	26104	52.36%	34.79%	24	24
8	臺南市安定區	2018-11-24T23:03:42+08:00	9082	3227	12309	1359	13668	26104	52.36%	34.79%	24	24
8	臺南市安定區	2018-11-24T23:10:51+08:00	9082	3227	12309	1359	13668	26104	52.36%	34.79%	24	24
8	臺南市安定區	2018-11-25T00:03:28+08:00	9082	3227	12309	1359	13668	26104	52.36%	34.79%	24	24
8	臺南市安定區	2018-11-25T06:17:30+08:00	9082	3227	12309	1359	13668	26104	52.36%	34.79%	24	24
8	臺南市安定區	2018-11-24T23:58:36+08:00	9082	3227	12309	1359	13668	26104	52.36%	34.79%	24	24
8	臺南市安定區	2018-11-24T23:22:17+08:00	9082	3227	12309	1359	13668	26104	52.36%	34.79%	24	24
8	臺南市安定區	2018-11-25T03:42:42+08:00	9082	3227	12309	1359	13668	26104	52.36%	34.79%	24	24
8	臺南市安定區	2018-11-25T06:22:40+08:00	9082	3227	12309	1359	13668	26104	52.36%	34.79%	24	24
8	臺南市安定區	2018-11-24T23:29:41+08:00	9082	3227	12309	1359	13668	26104	52.36%	34.79%	24	24
8	臺南市安定區	2018-11-24T22:25:18+08:00	9082	3227	12309	1359	13668	26104	52.36%	34.79%	24	24
8	臺南市安定區	2018-11-25T01:11:00+08:00	9082	3227	12309	1359	13668	26104	52.36%	34.79%	24	24
8	臺南市安定區	2018-11-25T00:17:02+08:00	9082	3227	12309	1359	13668	26104	52.36%	34.79%	24	24
8	臺南市安定區	2018-11-25T06:12:32+08:00	9082	3227	12309	1359	13668	26104	52.36%	34.79%	24	24
8	臺南市安定區	2018-11-25T00:12:40+08:00	9082	3227	12309	1359	13668	26104	52.36%	34.79%	24	24
8	臺南市安定區	2018-11-24T22:28:35+08:00	9082	3227	12309	1359	13668	26104	52.36%	34.79%	24	24
8	臺南市安定區	2018-11-24T22:14:43+08:00	9082	3227	12309	1359	13668	26104	52.36%	34.79%	24	24
8	臺南市安定區	2018-11-24T23:26:02+08:00	9082	3227	12309	1359	13668	26104	52.36%	34.79%	24	24
8	臺南市安定區	2018-11-24T23:54:20+08:00	9082	3227	12309	1359	13668	26104	52.36%	34.79%	24	24
8	臺南市安定區	2018-11-25T06:27:50+08:00	9082	3227	12309	1359	13668	26104	52.36%	34.79%	24	24
8	臺南市安定區	2018-11-25T00:07:59+08:00	9082	3227	12309	1359	13668	26104	52.36%	34.79%	24	24
8	臺南市安定區	2018-11-24T23:18:22+08:00	9082	3227	12309	1359	13668	26104	52.36%	34.79%	24	24
8	臺南市安定區	2018-11-25T01:05:53+08:00	9082	3227	12309	1359	13668	26104	52.36%	34.79%	24	24
8	臺南市安定區	2018-11-24T22:18:14+08:00	9082	3227	12309	1359	13668	26104	52.36%	34.79%	24	24
8	臺南市安定區	2018-11-25T01:24:18+08:00	9082	3227	12309	1359	13668	26104	52.36%	34.79%	24	24
8	臺南市安定區	2018-11-24T22:56:32+08:00	9082	3227	12309	1359	13668	26104	52.36%	34.79%	24	24
8	臺南市安定區	2018-11-24T23:50:09+08:00	9082	3227	12309	1359	13668	26104	52.36%	34.79%	24	24
8	臺南市安定區	2018-11-24T22:39:03+08:00	9082	3227	12309	1359	13668	26104	52.36%	34.79%	24	24
8	臺南市安定區	2018-11-24T23:07:14+08:00	9082	3227	12309	1359	13668	26104	52.36%	34.79%	24	24
8	臺南市安定區	2018-11-24T22:32:13+08:00	9082	3227	12309	1359	13668	26104	52.36%	34.79%	24	24
8	臺南市安定區	2018-11-25T03:30:53+08:00	9082	3227	12309	1359	13668	26104	52.36%	34.79%	24	24
8	臺南市安定區	2018-11-25T03:48:23+08:00	9082	3227	12309	1359	13668	26104	52.36%	34.79%	24	24
8	臺南市安定區	2018-11-25T01:00:55+08:00	9082	3227	12309	1359	13668	26104	52.36%	34.79%	24	24
8	臺南市安定區	2018-11-24T23:00:09+08:00	9082	3227	12309	1359	13668	26104	52.36%	34.79%	24	24
8	臺南市安定區	2018-11-25T00:21:38+08:00	9082	3227	12309	1359	13668	26104	52.36%	34.79%	24	24
8	臺南市安定區	2018-11-25T06:07:17+08:00	9082	3227	12309	1359	13668	26104	52.36%	34.79%	24	24
8	臺南市安定區	2018-11-24T22:53:09+08:00	9082	3227	12309	1359	13668	26104	52.36%	34.79%	24	24
8	臺南市安定區	2018-11-24T22:40:14+08:00	9082	3227	12309	1359	13668	26104	52.36%	34.79%	24	24
8	臺南市安定區	2018-11-24T22:11:58+08:00	9082	3227	12309	1359	13668	26104	52.36%	34.79%	24	24
8	臺南市安定區	2018-11-25T04:01:23+08:00	9082	3227	12309	1359	13668	26104	52.36%	34.79%	24	24
8	臺南市安定區	2018-11-24T22:21:40+08:00	9082	3227	12309	1359	13668	26104	52.36%	34.79%	24	24
8	臺南市安定區	2018-11-24T23:41:57+08:00	9082	3227	12309	1359	13668	26104	52.36%	34.79%	24	24
8	臺南市安定區	2018-11-25T01:16:16+08:00	9082	3227	12309	1359	13668	26104	52.36%	34.79%	24	24
8	臺南市安定區	2018-11-24T22:35:40+08:00	9082	3227	12309	1359	13668	26104	52.36%	34.79%	24	24
8	臺南市安定區	2018-11-25T03:54:35+08:00	9082	3227	12309	1359	13668	26104	52.36%	34.79%	24	24
8	臺南市安定區	2018-11-24T23:33:45+08:00	9082	3227	12309	1359	13668	26104	52.36%	34.79%	24	24
8	臺南市安定區	2018-11-24T23:37:44+08:00	9082	3227	12309	1359	13668	26104	52.36%	34.79%	24	24
8	臺南市安定區	2018-11-24T23:45:59+08:00	9082	3227	12309	1359	13668	26104	52.36%	34.79%	24	24
8	屏東縣萬丹鄉	2018-11-24T22:56:36+08:00	14359	5135	19494	2446	21940	42075	52.14%	34.13%	38	39
8	屏東縣萬丹鄉	2018-11-25T06:17:36+08:00	14920	5311	20231	2511	22742	43478	52.31%	34.32%	39	39
8	屏東縣萬丹鄉	2018-11-24T23:07:19+08:00	14359	5135	19494	2446	21940	42075	52.14%	34.13%	38	39
8	屏東縣萬丹鄉	2018-11-24T23:10:56+08:00	14359	5135	19494	2446	21940	42075	52.14%	34.13%	38	39
8	屏東縣萬丹鄉	2018-11-24T22:39:09+08:00	14359	5135	19494	2446	21940	42075	52.14%	34.13%	38	39
8	屏東縣萬丹鄉	2018-11-25T01:24:25+08:00	14920	5311	20231	2511	22742	43478	52.31%	34.32%	39	39
8	屏東縣萬丹鄉	2018-11-25T03:54:41+08:00	14920	5311	20231	2511	22742	43478	52.31%	34.32%	39	39
8	屏東縣萬丹鄉	2018-11-25T03:30:59+08:00	14920	5311	20231	2511	22742	43478	52.31%	34.32%	39	39
8	屏東縣萬丹鄉	2018-11-24T22:32:19+08:00	13955	4910	18865	2385	21250	40664	52.26%	34.32%	37	39
8	屏東縣萬丹鄉	2018-11-25T01:06:00+08:00	14920	5311	20231	2511	22742	43478	52.31%	34.32%	39	39
8	屏東縣萬丹鄉	2018-11-24T23:00:17+08:00	14359	5135	19494	2446	21940	42075	52.14%	34.13%	38	39
8	屏東縣萬丹鄉	2018-11-25T00:21:44+08:00	14920	5311	20231	2511	22742	43478	52.31%	34.32%	39	39
8	屏東縣萬丹鄉	2018-11-25T01:11:08+08:00	14920	5311	20231	2511	22742	43478	52.31%	34.32%	39	39
8	屏東縣萬丹鄉	2018-11-25T06:07:23+08:00	14920	5311	20231	2511	22742	43478	52.31%	34.32%	39	39
8	屏東縣萬丹鄉	2018-11-24T22:40:19+08:00	14359	5135	19494	2446	21940	42075	52.14%	34.13%	38	39
8	屏東縣萬丹鄉	2018-11-24T23:29:47+08:00	14920	5311	20231	2511	22742	43478	52.31%	34.32%	39	39
8	屏東縣萬丹鄉	2018-11-25T00:03:35+08:00	14920	5311	20231	2511	22742	43478	52.31%	34.32%	39	39
8	屏東縣萬丹鄉	2018-11-25T00:56:14+08:00	14920	5311	20231	2511	22742	43478	52.31%	34.32%	39	39
8	屏東縣萬丹鄉	2018-11-24T23:54:27+08:00	14920	5311	20231	2511	22742	43478	52.31%	34.32%	39	39
8	屏東縣萬丹鄉	2018-11-24T22:35:45+08:00	14359	5135	19494	2446	21940	42075	52.14%	34.13%	38	39
8	屏東縣萬丹鄉	2018-11-25T01:16:22+08:00	14920	5311	20231	2511	22742	43478	52.31%	34.32%	39	39
8	屏東縣萬丹鄉	2018-11-24T23:37:49+08:00	14920	5311	20231	2511	22742	43478	52.31%	34.32%	39	39
8	屏東縣萬丹鄉	2018-11-24T22:43:51+08:00	14359	5135	19494	2446	21940	42075	52.14%	34.13%	38	39
8	屏東縣萬丹鄉	2018-11-24T23:22:23+08:00	14920	5311	20231	2511	22742	43478	52.31%	34.32%	39	39
8	屏東縣萬丹鄉	2018-11-24T22:49:24+08:00	14359	5135	19494	2446	21940	42075	52.14%	34.13%	38	39
8	屏東縣萬丹鄉	2018-11-24T22:12:03+08:00	13955	4910	18865	2385	21250	40664	52.26%	34.32%	37	39
8	屏東縣萬丹鄉	2018-11-24T23:33:51+08:00	14920	5311	20231	2511	22742	43478	52.31%	34.32%	39	39
8	屏東縣萬丹鄉	2018-11-24T23:03:47+08:00	14359	5135	19494	2446	21940	42075	52.14%	34.13%	38	39
8	屏東縣萬丹鄉	2018-11-24T22:28:40+08:00	13955	4910	18865	2385	21250	40664	52.26%	34.32%	37	39
8	屏東縣萬丹鄉	2018-11-25T04:01:30+08:00	14920	5311	20231	2511	22742	43478	52.31%	34.32%	39	39
8	屏東縣萬丹鄉	2018-11-25T03:42:49+08:00	14920	5311	20231	2511	22742	43478	52.31%	34.32%	39	39
8	屏東縣萬丹鄉	2018-11-24T23:42:02+08:00	14920	5311	20231	2511	22742	43478	52.31%	34.32%	39	39
8	屏東縣萬丹鄉	2018-11-25T00:08:05+08:00	14920	5311	20231	2511	22742	43478	52.31%	34.32%	39	39
8	屏東縣萬丹鄉	2018-11-24T22:53:15+08:00	14359	5135	19494	2446	21940	42075	52.14%	34.13%	38	39
8	屏東縣萬丹鄉	2018-11-24T23:46:04+08:00	14920	5311	20231	2511	22742	43478	52.31%	34.32%	39	39
8	屏東縣萬丹鄉	2018-11-25T06:12:37+08:00	14920	5311	20231	2511	22742	43478	52.31%	34.32%	39	39
8	屏東縣萬丹鄉	2018-11-24T22:21:46+08:00	13955	4910	18865	2385	21250	40664	52.26%	34.32%	37	39
8	屏東縣萬丹鄉	2018-11-24T22:25:25+08:00	13955	4910	18865	2385	21250	40664	52.26%	34.32%	37	39
8	屏東縣萬丹鄉	2018-11-25T00:17:08+08:00	14920	5311	20231	2511	22742	43478	52.31%	34.32%	39	39
8	屏東縣萬丹鄉	2018-11-25T06:22:45+08:00	14920	5311	20231	2511	22742	43478	52.31%	34.32%	39	39
8	屏東縣萬丹鄉	2018-11-25T03:48:31+08:00	14920	5311	20231	2511	22742	43478	52.31%	34.32%	39	39
8	屏東縣萬丹鄉	2018-11-24T22:14:49+08:00	13955	4910	18865	2385	21250	40664	52.26%	34.32%	37	39
8	屏東縣萬丹鄉	2018-11-24T22:18:20+08:00	13955	4910	18865	2385	21250	40664	52.26%	34.32%	37	39
8	屏東縣萬丹鄉	2018-11-25T03:37:30+08:00	14920	5311	20231	2511	22742	43478	52.31%	34.32%	39	39
8	屏東縣萬丹鄉	2018-11-24T23:58:43+08:00	14920	5311	20231	2511	22742	43478	52.31%	34.32%	39	39
8	屏東縣萬丹鄉	2018-11-25T06:27:55+08:00	14920	5311	20231	2511	22742	43478	52.31%	34.32%	39	39
8	屏東縣萬丹鄉	2018-11-24T23:26:07+08:00	14920	5311	20231	2511	22742	43478	52.31%	34.32%	39	39
8	屏東縣萬丹鄉	2018-11-25T00:12:45+08:00	14920	5311	20231	2511	22742	43478	52.31%	34.32%	39	39
8	屏東縣萬丹鄉	2018-11-25T01:01:02+08:00	14920	5311	20231	2511	22742	43478	52.31%	34.32%	39	39
8	屏東縣萬丹鄉	2018-11-24T23:18:28+08:00	14920	5311	20231	2511	22742	43478	52.31%	34.32%	39	39
8	屏東縣萬丹鄉	2018-11-24T23:14:41+08:00	14920	5311	20231	2511	22742	43478	52.31%	34.32%	39	39
8	屏東縣萬丹鄉	2018-11-24T23:50:15+08:00	14920	5311	20231	2511	22742	43478	52.31%	34.32%	39	39
8	臺南市北門區	2018-11-25T03:37:19+08:00	2613	829	3442	343	3785	9925	38.14%	26.33%	18	18
8	臺南市北門區	2018-11-25T00:56:08+08:00	2613	829	3442	343	3785	9925	38.14%	26.33%	18	18
8	臺南市北門區	2018-11-24T22:49:18+08:00	2613	829	3442	343	3785	9925	38.14%	26.33%	18	18
8	臺南市北門區	2018-11-24T23:14:34+08:00	2613	829	3442	343	3785	9925	38.14%	26.33%	18	18
8	臺南市北門區	2018-11-24T22:56:31+08:00	2613	829	3442	343	3785	9925	38.14%	26.33%	18	18
8	臺南市北門區	2018-11-25T00:03:27+08:00	2613	829	3442	343	3785	9925	38.14%	26.33%	18	18
8	臺南市北門區	2018-11-24T22:43:45+08:00	2613	829	3442	343	3785	9925	38.14%	26.33%	18	18
8	臺南市北門區	2018-11-24T23:03:42+08:00	2613	829	3442	343	3785	9925	38.14%	26.33%	18	18
8	臺南市北門區	2018-11-24T23:10:51+08:00	2613	829	3442	343	3785	9925	38.14%	26.33%	18	18
8	臺南市北門區	2018-11-25T06:17:30+08:00	2613	829	3442	343	3785	9925	38.14%	26.33%	18	18
8	臺南市北門區	2018-11-24T23:58:36+08:00	2613	829	3442	343	3785	9925	38.14%	26.33%	18	18
8	臺南市北門區	2018-11-24T23:22:17+08:00	2613	829	3442	343	3785	9925	38.14%	26.33%	18	18
8	臺南市北門區	2018-11-25T03:42:42+08:00	2613	829	3442	343	3785	9925	38.14%	26.33%	18	18
8	臺南市北門區	2018-11-25T06:22:40+08:00	2613	829	3442	343	3785	9925	38.14%	26.33%	18	18
8	臺南市北門區	2018-11-24T23:29:41+08:00	2613	829	3442	343	3785	9925	38.14%	26.33%	18	18
8	臺南市北門區	2018-11-24T22:25:18+08:00	2613	829	3442	343	3785	9925	38.14%	26.33%	18	18
8	臺南市北門區	2018-11-25T01:11:00+08:00	2613	829	3442	343	3785	9925	38.14%	26.33%	18	18
8	臺南市北門區	2018-11-25T00:17:02+08:00	2613	829	3442	343	3785	9925	38.14%	26.33%	18	18
8	臺南市北門區	2018-11-25T06:12:32+08:00	2613	829	3442	343	3785	9925	38.14%	26.33%	18	18
8	臺南市北門區	2018-11-25T00:12:40+08:00	2613	829	3442	343	3785	9925	38.14%	26.33%	18	18
8	臺南市北門區	2018-11-24T22:14:43+08:00	2613	829	3442	343	3785	9925	38.14%	26.33%	18	18
8	臺南市北門區	2018-11-24T23:26:02+08:00	2613	829	3442	343	3785	9925	38.14%	26.33%	18	18
8	臺南市北門區	2018-11-25T06:27:50+08:00	2613	829	3442	343	3785	9925	38.14%	26.33%	18	18
8	臺南市北門區	2018-11-25T00:07:59+08:00	2613	829	3442	343	3785	9925	38.14%	26.33%	18	18
8	臺南市北門區	2018-11-24T23:18:22+08:00	2613	829	3442	343	3785	9925	38.14%	26.33%	18	18
8	臺南市北門區	2018-11-25T01:05:53+08:00	2613	829	3442	343	3785	9925	38.14%	26.33%	18	18
8	臺南市北門區	2018-11-24T23:54:19+08:00	2613	829	3442	343	3785	9925	38.14%	26.33%	18	18
8	臺南市北門區	2018-11-24T22:28:34+08:00	2613	829	3442	343	3785	9925	38.14%	26.33%	18	18
8	臺南市北門區	2018-11-24T22:18:14+08:00	2613	829	3442	343	3785	9925	38.14%	26.33%	18	18
8	臺南市北門區	2018-11-25T01:24:18+08:00	2613	829	3442	343	3785	9925	38.14%	26.33%	18	18
8	臺南市北門區	2018-11-24T23:50:09+08:00	2613	829	3442	343	3785	9925	38.14%	26.33%	18	18
8	臺南市北門區	2018-11-24T22:39:03+08:00	2613	829	3442	343	3785	9925	38.14%	26.33%	18	18
8	臺南市北門區	2018-11-24T23:07:13+08:00	2613	829	3442	343	3785	9925	38.14%	26.33%	18	18
8	臺南市北門區	2018-11-24T22:32:13+08:00	2613	829	3442	343	3785	9925	38.14%	26.33%	18	18
8	臺南市北門區	2018-11-25T03:30:53+08:00	2613	829	3442	343	3785	9925	38.14%	26.33%	18	18
8	臺南市北門區	2018-11-25T03:48:23+08:00	2613	829	3442	343	3785	9925	38.14%	26.33%	18	18
8	臺南市北門區	2018-11-25T01:00:55+08:00	2613	829	3442	343	3785	9925	38.14%	26.33%	18	18
8	臺南市北門區	2018-11-24T23:00:09+08:00	2613	829	3442	343	3785	9925	38.14%	26.33%	18	18
8	臺南市北門區	2018-11-25T00:21:38+08:00	2613	829	3442	343	3785	9925	38.14%	26.33%	18	18
8	臺南市北門區	2018-11-25T06:07:17+08:00	2613	829	3442	343	3785	9925	38.14%	26.33%	18	18
8	臺南市北門區	2018-11-24T22:11:57+08:00	2613	829	3442	343	3785	9925	38.14%	26.33%	18	18
8	臺南市北門區	2018-11-24T22:53:09+08:00	2613	829	3442	343	3785	9925	38.14%	26.33%	18	18
8	臺南市北門區	2018-11-24T22:40:14+08:00	2613	829	3442	343	3785	9925	38.14%	26.33%	18	18
8	臺南市北門區	2018-11-25T04:01:23+08:00	2613	829	3442	343	3785	9925	38.14%	26.33%	18	18
8	臺南市北門區	2018-11-24T22:21:40+08:00	2613	829	3442	343	3785	9925	38.14%	26.33%	18	18
8	臺南市北門區	2018-11-24T23:41:57+08:00	2613	829	3442	343	3785	9925	38.14%	26.33%	18	18
8	臺南市北門區	2018-11-25T03:54:34+08:00	2613	829	3442	343	3785	9925	38.14%	26.33%	18	18
8	臺南市北門區	2018-11-25T01:16:16+08:00	2613	829	3442	343	3785	9925	38.14%	26.33%	18	18
8	臺南市北門區	2018-11-24T23:45:58+08:00	2613	829	3442	343	3785	9925	38.14%	26.33%	18	18
8	臺南市北門區	2018-11-24T22:35:40+08:00	2613	829	3442	343	3785	9925	38.14%	26.33%	18	18
8	臺南市北門區	2018-11-24T23:33:45+08:00	2613	829	3442	343	3785	9925	38.14%	26.33%	18	18
8	臺南市北門區	2018-11-24T23:37:44+08:00	2613	829	3442	343	3785	9925	38.14%	26.33%	18	18
8	屏東縣牡丹鄉	2018-11-24T23:07:20+08:00	1305	314	1619	112	1731	4314	40.13%	30.25%	7	7
8	屏東縣牡丹鄉	2018-11-24T23:10:57+08:00	1305	314	1619	112	1731	4314	40.13%	30.25%	7	7
8	屏東縣牡丹鄉	2018-11-25T06:17:38+08:00	1305	314	1619	112	1731	4314	40.13%	30.25%	7	7
8	屏東縣牡丹鄉	2018-11-24T22:14:50+08:00	698	165	863	45	908	2571	35.32%	27.15%	5	7
8	屏東縣牡丹鄉	2018-11-24T22:56:37+08:00	1305	314	1619	112	1731	4314	40.13%	30.25%	7	7
8	屏東縣牡丹鄉	2018-11-24T22:32:19+08:00	698	165	863	45	908	2571	35.32%	27.15%	5	7
8	屏東縣牡丹鄉	2018-11-25T01:06:01+08:00	1305	314	1619	112	1731	4314	40.13%	30.25%	7	7
8	屏東縣牡丹鄉	2018-11-24T22:53:16+08:00	1305	314	1619	112	1731	4314	40.13%	30.25%	7	7
8	屏東縣牡丹鄉	2018-11-25T00:08:06+08:00	1305	314	1619	112	1731	4314	40.13%	30.25%	7	7
8	屏東縣牡丹鄉	2018-11-24T22:25:26+08:00	698	165	863	45	908	2571	35.32%	27.15%	5	7
8	屏東縣牡丹鄉	2018-11-24T23:29:48+08:00	1305	314	1619	112	1731	4314	40.13%	30.25%	7	7
8	屏東縣牡丹鄉	2018-11-24T22:40:20+08:00	807	204	1011	57	1068	3008	35.51%	26.83%	6	7
8	屏東縣牡丹鄉	2018-11-25T06:22:46+08:00	1305	314	1619	112	1731	4314	40.13%	30.25%	7	7
8	屏東縣牡丹鄉	2018-11-25T06:07:24+08:00	1305	314	1619	112	1731	4314	40.13%	30.25%	7	7
8	屏東縣牡丹鄉	2018-11-24T23:00:18+08:00	1305	314	1619	112	1731	4314	40.13%	30.25%	7	7
8	屏東縣牡丹鄉	2018-11-25T03:48:32+08:00	1305	314	1619	112	1731	4314	40.13%	30.25%	7	7
8	屏東縣牡丹鄉	2018-11-25T03:42:50+08:00	1305	314	1619	112	1731	4314	40.13%	30.25%	7	7
8	屏東縣牡丹鄉	2018-11-25T00:21:45+08:00	1305	314	1619	112	1731	4314	40.13%	30.25%	7	7
8	屏東縣牡丹鄉	2018-11-25T01:11:09+08:00	1305	314	1619	112	1731	4314	40.13%	30.25%	7	7
8	屏東縣牡丹鄉	2018-11-25T01:16:23+08:00	1305	314	1619	112	1731	4314	40.13%	30.25%	7	7
8	屏東縣牡丹鄉	2018-11-25T03:31:01+08:00	1305	314	1619	112	1731	4314	40.13%	30.25%	7	7
8	屏東縣牡丹鄉	2018-11-24T23:14:42+08:00	1305	314	1619	112	1731	4314	40.13%	30.25%	7	7
8	屏東縣牡丹鄉	2018-11-24T23:50:16+08:00	1305	314	1619	112	1731	4314	40.13%	30.25%	7	7
8	屏東縣牡丹鄉	2018-11-25T06:27:56+08:00	1305	314	1619	112	1731	4314	40.13%	30.25%	7	7
8	屏東縣牡丹鄉	2018-11-25T00:56:15+08:00	1305	314	1619	112	1731	4314	40.13%	30.25%	7	7
8	屏東縣牡丹鄉	2018-11-25T00:12:46+08:00	1305	314	1619	112	1731	4314	40.13%	30.25%	7	7
8	屏東縣牡丹鄉	2018-11-24T23:54:28+08:00	1305	314	1619	112	1731	4314	40.13%	30.25%	7	7
8	屏東縣牡丹鄉	2018-11-24T23:37:50+08:00	1305	314	1619	112	1731	4314	40.13%	30.25%	7	7
8	屏東縣牡丹鄉	2018-11-24T23:22:24+08:00	1305	314	1619	112	1731	4314	40.13%	30.25%	7	7
8	屏東縣牡丹鄉	2018-11-24T22:28:41+08:00	698	165	863	45	908	2571	35.32%	27.15%	5	7
8	屏東縣牡丹鄉	2018-11-24T22:12:04+08:00	698	165	863	45	908	2571	35.32%	27.15%	5	7
8	屏東縣牡丹鄉	2018-11-24T23:33:51+08:00	1305	314	1619	112	1731	4314	40.13%	30.25%	7	7
8	屏東縣牡丹鄉	2018-11-25T01:24:26+08:00	1305	314	1619	112	1731	4314	40.13%	30.25%	7	7
8	屏東縣牡丹鄉	2018-11-25T03:54:42+08:00	1305	314	1619	112	1731	4314	40.13%	30.25%	7	7
8	屏東縣牡丹鄉	2018-11-24T23:03:48+08:00	1305	314	1619	112	1731	4314	40.13%	30.25%	7	7
8	屏東縣牡丹鄉	2018-11-24T22:49:25+08:00	1305	314	1619	112	1731	4314	40.13%	30.25%	7	7
8	屏東縣牡丹鄉	2018-11-24T23:42:03+08:00	1305	314	1619	112	1731	4314	40.13%	30.25%	7	7
8	屏東縣牡丹鄉	2018-11-24T23:46:05+08:00	1305	314	1619	112	1731	4314	40.13%	30.25%	7	7
8	屏東縣牡丹鄉	2018-11-25T04:01:31+08:00	1305	314	1619	112	1731	4314	40.13%	30.25%	7	7
8	屏東縣牡丹鄉	2018-11-25T00:17:09+08:00	1305	314	1619	112	1731	4314	40.13%	30.25%	7	7
8	屏東縣牡丹鄉	2018-11-25T06:12:38+08:00	1305	314	1619	112	1731	4314	40.13%	30.25%	7	7
8	屏東縣牡丹鄉	2018-11-24T22:21:47+08:00	698	165	863	45	908	2571	35.32%	27.15%	5	7
8	屏東縣牡丹鄉	2018-11-25T01:01:03+08:00	1305	314	1619	112	1731	4314	40.13%	30.25%	7	7
8	屏東縣牡丹鄉	2018-11-24T22:39:10+08:00	698	165	863	45	908	2571	35.32%	27.15%	5	7
8	屏東縣牡丹鄉	2018-11-24T23:26:08+08:00	1305	314	1619	112	1731	4314	40.13%	30.25%	7	7
8	屏東縣牡丹鄉	2018-11-24T22:35:46+08:00	698	165	863	45	908	2571	35.32%	27.15%	5	7
8	屏東縣牡丹鄉	2018-11-24T23:58:44+08:00	1305	314	1619	112	1731	4314	40.13%	30.25%	7	7
8	屏東縣牡丹鄉	2018-11-24T23:18:29+08:00	1305	314	1619	112	1731	4314	40.13%	30.25%	7	7
8	屏東縣牡丹鄉	2018-11-25T00:03:36+08:00	1305	314	1619	112	1731	4314	40.13%	30.25%	7	7
8	屏東縣牡丹鄉	2018-11-25T03:37:31+08:00	1305	314	1619	112	1731	4314	40.13%	30.25%	7	7
8	屏東縣牡丹鄉	2018-11-24T22:18:21+08:00	698	165	863	45	908	2571	35.32%	27.15%	5	7
8	屏東縣牡丹鄉	2018-11-24T22:43:52+08:00	807	204	1011	57	1068	3008	35.51%	26.83%	6	7
8	臺南市麻豆區	2018-11-25T03:37:19+08:00	12101	4413	16514	1309	17823	37963	46.95%	31.88%	35	35
8	臺南市麻豆區	2018-11-24T22:49:18+08:00	12101	4413	16514	1309	17823	37963	46.95%	31.88%	35	35
8	臺南市麻豆區	2018-11-24T23:14:33+08:00	12101	4413	16514	1309	17823	37963	46.95%	31.88%	35	35
8	臺南市麻豆區	2018-11-24T22:56:31+08:00	12101	4413	16514	1309	17823	37963	46.95%	31.88%	35	35
8	臺南市麻豆區	2018-11-25T00:12:39+08:00	12101	4413	16514	1309	17823	37963	46.95%	31.88%	35	35
8	臺南市麻豆區	2018-11-25T00:03:27+08:00	12101	4413	16514	1309	17823	37963	46.95%	31.88%	35	35
8	臺南市麻豆區	2018-11-25T00:56:07+08:00	12101	4413	16514	1309	17823	37963	46.95%	31.88%	35	35
8	臺南市麻豆區	2018-11-24T23:03:42+08:00	12101	4413	16514	1309	17823	37963	46.95%	31.88%	35	35
8	臺南市麻豆區	2018-11-24T23:10:51+08:00	12101	4413	16514	1309	17823	37963	46.95%	31.88%	35	35
8	臺南市麻豆區	2018-11-24T22:43:44+08:00	12101	4413	16514	1309	17823	37963	46.95%	31.88%	35	35
8	臺南市麻豆區	2018-11-25T06:17:30+08:00	12101	4413	16514	1309	17823	37963	46.95%	31.88%	35	35
8	臺南市麻豆區	2018-11-24T23:58:36+08:00	12101	4413	16514	1309	17823	37963	46.95%	31.88%	35	35
8	臺南市麻豆區	2018-11-24T23:22:17+08:00	12101	4413	16514	1309	17823	37963	46.95%	31.88%	35	35
8	臺南市麻豆區	2018-11-25T06:22:40+08:00	12101	4413	16514	1309	17823	37963	46.95%	31.88%	35	35
8	臺南市麻豆區	2018-11-24T23:29:41+08:00	12101	4413	16514	1309	17823	37963	46.95%	31.88%	35	35
8	臺南市麻豆區	2018-11-24T22:25:18+08:00	11486	4301	15787	1263	17050	36366	46.88%	31.58%	34	35
8	臺南市麻豆區	2018-11-25T01:11:00+08:00	12101	4413	16514	1309	17823	37963	46.95%	31.88%	35	35
8	臺南市麻豆區	2018-11-25T00:17:02+08:00	12101	4413	16514	1309	17823	37963	46.95%	31.88%	35	35
8	臺南市麻豆區	2018-11-25T00:07:58+08:00	12101	4413	16514	1309	17823	37963	46.95%	31.88%	35	35
8	臺南市麻豆區	2018-11-25T01:16:15+08:00	12101	4413	16514	1309	17823	37963	46.95%	31.88%	35	35
8	臺南市麻豆區	2018-11-24T23:26:02+08:00	12101	4413	16514	1309	17823	37963	46.95%	31.88%	35	35
8	臺南市麻豆區	2018-11-25T01:05:52+08:00	12101	4413	16514	1309	17823	37963	46.95%	31.88%	35	35
8	臺南市麻豆區	2018-11-24T22:14:42+08:00	9672	3634	13306	1104	14410	30796	46.79%	31.41%	30	35
8	臺南市麻豆區	2018-11-24T23:54:19+08:00	12101	4413	16514	1309	17823	37963	46.95%	31.88%	35	35
8	臺南市麻豆區	2018-11-24T22:28:34+08:00	11486	4301	15787	1263	17050	36366	46.88%	31.58%	34	35
8	臺南市麻豆區	2018-11-24T22:18:14+08:00	10183	3817	14000	1150	15150	32121	47.17%	31.7%	31	35
8	臺南市麻豆區	2018-11-25T01:24:18+08:00	12101	4413	16514	1309	17823	37963	46.95%	31.88%	35	35
8	臺南市麻豆區	2018-11-24T22:35:39+08:00	12101	4413	16514	1309	17823	37963	46.95%	31.88%	35	35
8	臺南市麻豆區	2018-11-24T23:50:09+08:00	12101	4413	16514	1309	17823	37963	46.95%	31.88%	35	35
8	臺南市麻豆區	2018-11-25T06:27:49+08:00	12101	4413	16514	1309	17823	37963	46.95%	31.88%	35	35
8	臺南市麻豆區	2018-11-24T22:39:03+08:00	12101	4413	16514	1309	17823	37963	46.95%	31.88%	35	35
8	臺南市麻豆區	2018-11-24T23:07:13+08:00	12101	4413	16514	1309	17823	37963	46.95%	31.88%	35	35
8	臺南市麻豆區	2018-11-25T01:00:54+08:00	12101	4413	16514	1309	17823	37963	46.95%	31.88%	35	35
8	臺南市麻豆區	2018-11-25T00:21:37+08:00	12101	4413	16514	1309	17823	37963	46.95%	31.88%	35	35
8	臺南市麻豆區	2018-11-24T22:32:13+08:00	12101	4413	16514	1309	17823	37963	46.95%	31.88%	35	35
8	臺南市麻豆區	2018-11-25T03:48:23+08:00	12101	4413	16514	1309	17823	37963	46.95%	31.88%	35	35
8	臺南市麻豆區	2018-11-24T23:00:09+08:00	12101	4413	16514	1309	17823	37963	46.95%	31.88%	35	35
8	臺南市麻豆區	2018-11-25T03:30:52+08:00	12101	4413	16514	1309	17823	37963	46.95%	31.88%	35	35
8	臺南市麻豆區	2018-11-25T03:42:41+08:00	12101	4413	16514	1309	17823	37963	46.95%	31.88%	35	35
8	臺南市麻豆區	2018-11-24T22:21:39+08:00	11486	4301	15787	1263	17050	36366	46.88%	31.58%	34	35
8	臺南市麻豆區	2018-11-24T22:53:08+08:00	12101	4413	16514	1309	17823	37963	46.95%	31.88%	35	35
8	臺南市麻豆區	2018-11-25T06:07:17+08:00	12101	4413	16514	1309	17823	37963	46.95%	31.88%	35	35
8	臺南市麻豆區	2018-11-24T22:11:57+08:00	9199	3465	12664	1045	13709	29534	46.42%	31.15%	29	35
8	臺南市麻豆區	2018-11-24T22:40:13+08:00	12101	4413	16514	1309	17823	37963	46.95%	31.88%	35	35
8	臺南市麻豆區	2018-11-25T06:12:31+08:00	12101	4413	16514	1309	17823	37963	46.95%	31.88%	35	35
8	臺南市麻豆區	2018-11-25T04:01:23+08:00	12101	4413	16514	1309	17823	37963	46.95%	31.88%	35	35
8	臺南市麻豆區	2018-11-24T23:33:44+08:00	12101	4413	16514	1309	17823	37963	46.95%	31.88%	35	35
8	臺南市麻豆區	2018-11-25T03:54:34+08:00	12101	4413	16514	1309	17823	37963	46.95%	31.88%	35	35
8	臺南市麻豆區	2018-11-24T23:45:58+08:00	12101	4413	16514	1309	17823	37963	46.95%	31.88%	35	35
8	臺南市麻豆區	2018-11-24T23:41:56+08:00	12101	4413	16514	1309	17823	37963	46.95%	31.88%	35	35
8	臺南市麻豆區	2018-11-24T23:37:43+08:00	12101	4413	16514	1309	17823	37963	46.95%	31.88%	35	35
8	臺南市麻豆區	2018-11-24T23:18:21+08:00	12101	4413	16514	1309	17823	37963	46.95%	31.88%	35	35
8	屏東縣車城鄉	2018-11-24T23:10:57+08:00	2023	694	2717	306	3023	7595	39.8%	26.64%	13	13
8	屏東縣車城鄉	2018-11-24T23:07:19+08:00	2023	694	2717	306	3023	7595	39.8%	26.64%	13	13
8	屏東縣車城鄉	2018-11-24T22:14:50+08:00	2023	694	2717	306	3023	7595	39.8%	26.64%	13	13
8	屏東縣車城鄉	2018-11-25T06:17:37+08:00	2023	694	2717	306	3023	7595	39.8%	26.64%	13	13
8	屏東縣車城鄉	2018-11-24T22:56:37+08:00	2023	694	2717	306	3023	7595	39.8%	26.64%	13	13
8	屏東縣車城鄉	2018-11-24T22:32:19+08:00	2023	694	2717	306	3023	7595	39.8%	26.64%	13	13
8	屏東縣車城鄉	2018-11-25T01:06:01+08:00	2023	694	2717	306	3023	7595	39.8%	26.64%	13	13
8	屏東縣車城鄉	2018-11-24T22:53:16+08:00	2023	694	2717	306	3023	7595	39.8%	26.64%	13	13
8	屏東縣車城鄉	2018-11-25T00:08:06+08:00	2023	694	2717	306	3023	7595	39.8%	26.64%	13	13
8	屏東縣車城鄉	2018-11-24T22:25:26+08:00	2023	694	2717	306	3023	7595	39.8%	26.64%	13	13
8	屏東縣車城鄉	2018-11-25T01:11:08+08:00	2023	694	2717	306	3023	7595	39.8%	26.64%	13	13
8	屏東縣車城鄉	2018-11-24T22:40:20+08:00	2023	694	2717	306	3023	7595	39.8%	26.64%	13	13
8	屏東縣車城鄉	2018-11-25T06:07:24+08:00	2023	694	2717	306	3023	7595	39.8%	26.64%	13	13
8	屏東縣車城鄉	2018-11-24T23:00:18+08:00	2023	694	2717	306	3023	7595	39.8%	26.64%	13	13
8	屏東縣車城鄉	2018-11-25T03:48:32+08:00	2023	694	2717	306	3023	7595	39.8%	26.64%	13	13
8	屏東縣車城鄉	2018-11-24T23:29:47+08:00	2023	694	2717	306	3023	7595	39.8%	26.64%	13	13
8	屏東縣車城鄉	2018-11-25T00:21:45+08:00	2023	694	2717	306	3023	7595	39.8%	26.64%	13	13
8	屏東縣車城鄉	2018-11-25T03:31:00+08:00	2023	694	2717	306	3023	7595	39.8%	26.64%	13	13
8	屏東縣車城鄉	2018-11-25T01:16:23+08:00	2023	694	2717	306	3023	7595	39.8%	26.64%	13	13
8	屏東縣車城鄉	2018-11-25T00:56:14+08:00	2023	694	2717	306	3023	7595	39.8%	26.64%	13	13
8	屏東縣車城鄉	2018-11-24T22:35:45+08:00	2023	694	2717	306	3023	7595	39.8%	26.64%	13	13
8	屏東縣車城鄉	2018-11-24T23:14:42+08:00	2023	694	2717	306	3023	7595	39.8%	26.64%	13	13
8	屏東縣車城鄉	2018-11-24T23:50:16+08:00	2023	694	2717	306	3023	7595	39.8%	26.64%	13	13
8	屏東縣車城鄉	2018-11-24T23:37:49+08:00	2023	694	2717	306	3023	7595	39.8%	26.64%	13	13
8	屏東縣車城鄉	2018-11-24T22:43:51+08:00	2023	694	2717	306	3023	7595	39.8%	26.64%	13	13
8	屏東縣車城鄉	2018-11-25T06:27:56+08:00	2023	694	2717	306	3023	7595	39.8%	26.64%	13	13
8	屏東縣車城鄉	2018-11-25T00:12:46+08:00	2023	694	2717	306	3023	7595	39.8%	26.64%	13	13
8	屏東縣車城鄉	2018-11-24T23:54:28+08:00	2023	694	2717	306	3023	7595	39.8%	26.64%	13	13
8	屏東縣車城鄉	2018-11-24T23:22:24+08:00	2023	694	2717	306	3023	7595	39.8%	26.64%	13	13
8	屏東縣車城鄉	2018-11-24T22:28:41+08:00	2023	694	2717	306	3023	7595	39.8%	26.64%	13	13
8	屏東縣車城鄉	2018-11-24T22:12:03+08:00	2023	694	2717	306	3023	7595	39.8%	26.64%	13	13
8	屏東縣車城鄉	2018-11-24T23:33:51+08:00	2023	694	2717	306	3023	7595	39.8%	26.64%	13	13
8	屏東縣車城鄉	2018-11-25T01:24:26+08:00	2023	694	2717	306	3023	7595	39.8%	26.64%	13	13
8	屏東縣車城鄉	2018-11-25T03:54:42+08:00	2023	694	2717	306	3023	7595	39.8%	26.64%	13	13
8	屏東縣車城鄉	2018-11-24T23:03:48+08:00	2023	694	2717	306	3023	7595	39.8%	26.64%	13	13
8	屏東縣車城鄉	2018-11-24T22:49:25+08:00	2023	694	2717	306	3023	7595	39.8%	26.64%	13	13
8	屏東縣車城鄉	2018-11-24T23:42:03+08:00	2023	694	2717	306	3023	7595	39.8%	26.64%	13	13
8	屏東縣車城鄉	2018-11-25T04:01:30+08:00	2023	694	2717	306	3023	7595	39.8%	26.64%	13	13
8	屏東縣車城鄉	2018-11-25T03:42:49+08:00	2023	694	2717	306	3023	7595	39.8%	26.64%	13	13
8	屏東縣車城鄉	2018-11-24T23:46:04+08:00	2023	694	2717	306	3023	7595	39.8%	26.64%	13	13
8	屏東縣車城鄉	2018-11-25T00:17:09+08:00	2023	694	2717	306	3023	7595	39.8%	26.64%	13	13
8	屏東縣車城鄉	2018-11-25T06:12:38+08:00	2023	694	2717	306	3023	7595	39.8%	26.64%	13	13
8	屏東縣車城鄉	2018-11-25T06:22:45+08:00	2023	694	2717	306	3023	7595	39.8%	26.64%	13	13
8	屏東縣車城鄉	2018-11-24T22:21:47+08:00	2023	694	2717	306	3023	7595	39.8%	26.64%	13	13
8	屏東縣車城鄉	2018-11-24T22:39:10+08:00	2023	694	2717	306	3023	7595	39.8%	26.64%	13	13
8	屏東縣車城鄉	2018-11-24T23:26:08+08:00	2023	694	2717	306	3023	7595	39.8%	26.64%	13	13
8	屏東縣車城鄉	2018-11-25T03:37:30+08:00	2023	694	2717	306	3023	7595	39.8%	26.64%	13	13
8	屏東縣車城鄉	2018-11-24T23:58:43+08:00	2023	694	2717	306	3023	7595	39.8%	26.64%	13	13
8	屏東縣車城鄉	2018-11-25T00:03:36+08:00	2023	694	2717	306	3023	7595	39.8%	26.64%	13	13
8	屏東縣車城鄉	2018-11-24T22:18:21+08:00	2023	694	2717	306	3023	7595	39.8%	26.64%	13	13
8	屏東縣車城鄉	2018-11-25T01:01:02+08:00	2023	694	2717	306	3023	7595	39.8%	26.64%	13	13
8	屏東縣車城鄉	2018-11-24T23:18:28+08:00	2023	694	2717	306	3023	7595	39.8%	26.64%	13	13
8	新竹市東區	2018-11-24T23:10:59+08:00	54259	16816	71075	4075	75150	133739	56.19%	40.57%	117	139
8	新竹市東區	2018-11-24T23:22:27+08:00	58312	18178	76490	4342	80832	143642	56.27%	40.6%	124	139
8	新竹市東區	2018-11-24T23:18:31+08:00	57258	17833	75091	4272	79363	141088	56.25%	40.58%	122	139
8	新竹市東區	2018-11-24T22:49:28+08:00	46159	14241	60400	3505	63905	113762	56.17%	40.58%	102	139
8	新竹市東區	2018-11-24T23:33:54+08:00	60404	18764	79168	4509	83677	148583	56.32%	40.65%	128	139
8	新竹市東區	2018-11-24T22:12:06+08:00	33315	10368	43683	2611	46294	82986	55.79%	40.15%	78	139
8	新竹市東區	2018-11-24T23:26:11+08:00	58751	18299	77050	4379	81429	144721	56.27%	40.6%	125	139
8	新竹市東區	2018-11-24T22:28:44+08:00	40867	12667	53534	3121	56655	101002	56.09%	40.46%	92	139
8	新竹市東區	2018-11-24T23:37:52+08:00	61420	18995	80415	4600	85015	151017	56.29%	40.67%	130	139
8	新竹市東區	2018-11-24T22:53:19+08:00	47745	14777	62522	3592	66114	117857	56.1%	40.51%	105	139
8	新竹市東區	2018-11-24T22:21:50+08:00	37917	11653	49570	2900	52470	94118	55.75%	40.29%	86	139
8	新竹市東區	2018-11-25T04:01:33+08:00	66631	20584	87215	4981	92196	163757	56.3%	40.69%	139	139
8	新竹市東區	2018-11-25T00:08:09+08:00	63917	19746	83663	4789	88452	157268	56.24%	40.64%	134	139
8	新竹市東區	2018-11-24T23:46:07+08:00	62682	19364	82046	4693	86739	154235	56.24%	40.64%	132	139
8	新竹市東區	2018-11-25T01:11:12+08:00	66631	20584	87215	4981	92196	163757	56.3%	40.69%	139	139
8	新竹市東區	2018-11-24T23:42:06+08:00	61420	18995	80415	4600	85015	151017	56.29%	40.67%	130	139
8	新竹市東區	2018-11-24T23:00:20+08:00	49891	15430	65321	3734	69055	122958	56.16%	40.58%	109	139
8	新竹市東區	2018-11-24T22:25:29+08:00	38749	11979	50728	2981	53709	96219	55.82%	40.27%	88	139
8	新竹市東區	2018-11-25T06:22:48+08:00	66631	20584	87215	4981	92196	163757	56.3%	40.69%	139	139
8	新竹市東區	2018-11-25T03:48:35+08:00	66631	20584	87215	4981	92196	163757	56.3%	40.69%	139	139
8	新竹市東區	2018-11-25T06:27:59+08:00	66631	20584	87215	4981	92196	163757	56.3%	40.69%	139	139
8	新竹市東區	2018-11-25T06:17:41+08:00	66631	20584	87215	4981	92196	163757	56.3%	40.69%	139	139
8	新竹市東區	2018-11-24T23:03:51+08:00	52322	16210	68532	3965	72497	129182	56.12%	40.5%	114	139
8	新竹市東區	2018-11-24T22:39:13+08:00	44735	13800	58535	3370	61905	110282	56.13%	40.56%	99	139
8	新竹市東區	2018-11-25T03:37:34+08:00	66631	20584	87215	4981	92196	163757	56.3%	40.69%	139	139
8	新竹市東區	2018-11-25T00:12:49+08:00	64479	19924	84403	4818	89221	158622	56.25%	40.65%	135	139
8	新竹市東區	2018-11-24T23:58:47+08:00	62682	19364	82046	4693	86739	154235	56.24%	40.64%	132	139
8	新竹市東區	2018-11-24T22:18:23+08:00	35362	10903	46265	2741	49006	88088	55.63%	40.14%	82	139
8	新竹市東區	2018-11-24T23:50:18+08:00	62682	19364	82046	4693	86739	154235	56.24%	40.64%	132	139
8	新竹市東區	2018-11-24T23:14:45+08:00	54938	17055	71993	4114	76107	135339	56.23%	40.59%	118	139
8	新竹市東區	2018-11-24T22:56:40+08:00	49348	15272	64620	3702	68322	121691	56.14%	40.55%	108	139
8	新竹市東區	2018-11-25T01:01:06+08:00	66631	20584	87215	4981	92196	163757	56.3%	40.69%	139	139
8	新竹市東區	2018-11-25T01:24:29+08:00	66631	20584	87215	4981	92196	163757	56.3%	40.69%	139	139
8	新竹市東區	2018-11-24T23:54:31+08:00	62682	19364	82046	4693	86739	154235	56.24%	40.64%	132	139
8	新竹市東區	2018-11-24T23:07:23+08:00	53541	16619	70160	4039	74199	131992	56.21%	40.56%	116	139
8	新竹市東區	2018-11-25T03:54:45+08:00	66631	20584	87215	4981	92196	163757	56.3%	40.69%	139	139
8	新竹市東區	2018-11-25T00:03:40+08:00	63337	19574	82911	4752	87663	155855	56.25%	40.64%	133	139
8	新竹市東區	2018-11-24T22:14:53+08:00	34295	10622	44917	2677	47594	85474	55.68%	40.12%	80	139
8	新竹市東區	2018-11-24T23:29:50+08:00	59315	18468	77783	4451	82234	146109	56.28%	40.6%	126	139
8	新竹市東區	2018-11-25T00:17:12+08:00	64479	19924	84403	4818	89221	158622	56.25%	40.65%	135	139
8	新竹市東區	2018-11-24T22:32:22+08:00	43096	13356	56452	3285	59737	106362	56.16%	40.52%	96	139
8	新竹市東區	2018-11-25T06:12:41+08:00	66631	20584	87215	4981	92196	163757	56.3%	40.69%	139	139
8	新竹市東區	2018-11-25T01:06:04+08:00	66631	20584	87215	4981	92196	163757	56.3%	40.69%	139	139
8	新竹市東區	2018-11-24T22:40:22+08:00	45140	13924	59064	3429	62493	111283	56.16%	40.56%	100	139
8	新竹市東區	2018-11-25T03:42:53+08:00	66631	20584	87215	4981	92196	163757	56.3%	40.69%	139	139
8	新竹市東區	2018-11-25T00:21:48+08:00	64978	20116	85094	4848	89942	159939	56.24%	40.63%	136	139
8	新竹市東區	2018-11-25T06:07:27+08:00	66631	20584	87215	4981	92196	163757	56.3%	40.69%	139	139
8	新竹市東區	2018-11-25T00:56:17+08:00	66631	20584	87215	4981	92196	163757	56.3%	40.69%	139	139
8	新竹市東區	2018-11-24T22:35:48+08:00	43605	13506	57111	3309	60420	107760	56.07%	40.46%	97	139
8	新竹市東區	2018-11-24T22:43:54+08:00	45140	13924	59064	3429	62493	111283	56.16%	40.56%	100	139
8	新竹市東區	2018-11-25T03:31:04+08:00	66631	20584	87215	4981	92196	163757	56.3%	40.69%	139	139
8	新竹市東區	2018-11-25T01:16:26+08:00	66631	20584	87215	4981	92196	163757	56.3%	40.69%	139	139
8	花蓮縣壽豐鄉	2018-11-24T22:14:51+08:00	3772	1160	4932	586	5518	10422	52.95%	36.19%	15	21
8	花蓮縣壽豐鄉	2018-11-24T23:33:52+08:00	5963	1879	7842	882	8724	15847	55.05%	37.63%	21	21
8	花蓮縣壽豐鄉	2018-11-24T22:28:42+08:00	3772	1160	4932	586	5518	10422	52.95%	36.19%	15	21
8	花蓮縣壽豐鄉	2018-11-24T22:56:38+08:00	4495	1405	5900	687	6587	12252	53.76%	36.69%	17	21
8	花蓮縣壽豐鄉	2018-11-24T23:07:21+08:00	5190	1636	6826	764	7590	13943	54.44%	37.22%	19	21
8	花蓮縣壽豐鄉	2018-11-24T22:49:26+08:00	4495	1405	5900	687	6587	12252	53.76%	36.69%	17	21
8	花蓮縣壽豐鄉	2018-11-24T23:10:58+08:00	5190	1636	6826	764	7590	13943	54.44%	37.22%	19	21
8	花蓮縣壽豐鄉	2018-11-25T06:17:39+08:00	5963	1879	7842	882	8724	15847	55.05%	37.63%	21	21
8	花蓮縣壽豐鄉	2018-11-24T22:53:17+08:00	4495	1405	5900	687	6587	12252	53.76%	36.69%	17	21
8	花蓮縣壽豐鄉	2018-11-25T00:08:07+08:00	5963	1879	7842	882	8724	15847	55.05%	37.63%	21	21
8	花蓮縣壽豐鄉	2018-11-24T22:32:20+08:00	4216	1307	5523	641	6164	11561	53.32%	36.47%	16	21
8	花蓮縣壽豐鄉	2018-11-25T00:17:10+08:00	5963	1879	7842	882	8724	15847	55.05%	37.63%	21	21
8	花蓮縣壽豐鄉	2018-11-25T03:48:33+08:00	5963	1879	7842	882	8724	15847	55.05%	37.63%	21	21
8	花蓮縣壽豐鄉	2018-11-24T23:00:19+08:00	4495	1405	5900	687	6587	12252	53.76%	36.69%	17	21
8	花蓮縣壽豐鄉	2018-11-25T06:07:25+08:00	5963	1879	7842	882	8724	15847	55.05%	37.63%	21	21
8	花蓮縣壽豐鄉	2018-11-25T06:22:47+08:00	5963	1879	7842	882	8724	15847	55.05%	37.63%	21	21
8	花蓮縣壽豐鄉	2018-11-24T23:29:48+08:00	5586	1762	7348	829	8177	14972	54.62%	37.31%	20	21
8	花蓮縣壽豐鄉	2018-11-24T22:40:20+08:00	4216	1307	5523	641	6164	11561	53.32%	36.47%	16	21
8	花蓮縣壽豐鄉	2018-11-24T22:25:27+08:00	3772	1160	4932	586	5518	10422	52.95%	36.19%	15	21
8	花蓮縣壽豐鄉	2018-11-25T03:42:50+08:00	5963	1879	7842	882	8724	15847	55.05%	37.63%	21	21
8	花蓮縣壽豐鄉	2018-11-24T23:50:17+08:00	5963	1879	7842	882	8724	15847	55.05%	37.63%	21	21
8	花蓮縣壽豐鄉	2018-11-24T23:14:43+08:00	5190	1636	6826	764	7590	13943	54.44%	37.22%	19	21
8	花蓮縣壽豐鄉	2018-11-25T01:16:24+08:00	5963	1879	7842	882	8724	15847	55.05%	37.63%	21	21
8	花蓮縣壽豐鄉	2018-11-25T00:12:47+08:00	5963	1879	7842	882	8724	15847	55.05%	37.63%	21	21
8	花蓮縣壽豐鄉	2018-11-24T23:54:29+08:00	5963	1879	7842	882	8724	15847	55.05%	37.63%	21	21
8	花蓮縣壽豐鄉	2018-11-25T06:27:57+08:00	5963	1879	7842	882	8724	15847	55.05%	37.63%	21	21
8	花蓮縣壽豐鄉	2018-11-25T03:31:01+08:00	5963	1879	7842	882	8724	15847	55.05%	37.63%	21	21
8	花蓮縣壽豐鄉	2018-11-24T22:18:22+08:00	3772	1160	4932	586	5518	10422	52.95%	36.19%	15	21
8	花蓮縣壽豐鄉	2018-11-25T03:37:32+08:00	5963	1879	7842	882	8724	15847	55.05%	37.63%	21	21
8	花蓮縣壽豐鄉	2018-11-25T00:56:15+08:00	5963	1879	7842	882	8724	15847	55.05%	37.63%	21	21
8	花蓮縣壽豐鄉	2018-11-24T23:37:50+08:00	5963	1879	7842	882	8724	15847	55.05%	37.63%	21	21
8	花蓮縣壽豐鄉	2018-11-25T01:24:27+08:00	5963	1879	7842	882	8724	15847	55.05%	37.63%	21	21
8	花蓮縣壽豐鄉	2018-11-25T03:54:43+08:00	5963	1879	7842	882	8724	15847	55.05%	37.63%	21	21
8	花蓮縣壽豐鄉	2018-11-24T23:03:49+08:00	4810	1482	6292	726	7018	12947	54.21%	37.15%	18	21
8	花蓮縣壽豐鄉	2018-11-24T22:12:04+08:00	3772	1160	4932	586	5518	10422	52.95%	36.19%	15	21
8	花蓮縣壽豐鄉	2018-11-24T23:22:25+08:00	5586	1762	7348	829	8177	14972	54.62%	37.31%	20	21
8	花蓮縣壽豐鄉	2018-11-25T01:06:02+08:00	5963	1879	7842	882	8724	15847	55.05%	37.63%	21	21
8	花蓮縣壽豐鄉	2018-11-24T23:42:04+08:00	5963	1879	7842	882	8724	15847	55.05%	37.63%	21	21
8	花蓮縣壽豐鄉	2018-11-25T01:11:10+08:00	5963	1879	7842	882	8724	15847	55.05%	37.63%	21	21
8	花蓮縣壽豐鄉	2018-11-24T23:46:05+08:00	5963	1879	7842	882	8724	15847	55.05%	37.63%	21	21
8	花蓮縣壽豐鄉	2018-11-25T04:01:31+08:00	5963	1879	7842	882	8724	15847	55.05%	37.63%	21	21
8	花蓮縣壽豐鄉	2018-11-25T06:12:39+08:00	5963	1879	7842	882	8724	15847	55.05%	37.63%	21	21
8	花蓮縣壽豐鄉	2018-11-24T22:21:48+08:00	3772	1160	4932	586	5518	10422	52.95%	36.19%	15	21
8	花蓮縣壽豐鄉	2018-11-25T00:21:46+08:00	5963	1879	7842	882	8724	15847	55.05%	37.63%	21	21
8	花蓮縣壽豐鄉	2018-11-25T01:01:04+08:00	5963	1879	7842	882	8724	15847	55.05%	37.63%	21	21
8	花蓮縣壽豐鄉	2018-11-24T22:35:46+08:00	4216	1307	5523	641	6164	11561	53.32%	36.47%	16	21
8	花蓮縣壽豐鄉	2018-11-24T23:18:29+08:00	5586	1762	7348	829	8177	14972	54.62%	37.31%	20	21
8	花蓮縣壽豐鄉	2018-11-24T23:58:45+08:00	5963	1879	7842	882	8724	15847	55.05%	37.63%	21	21
8	花蓮縣壽豐鄉	2018-11-24T22:39:11+08:00	4216	1307	5523	641	6164	11561	53.32%	36.47%	16	21
8	花蓮縣壽豐鄉	2018-11-24T23:26:09+08:00	5586	1762	7348	829	8177	14972	54.62%	37.31%	20	21
8	花蓮縣壽豐鄉	2018-11-25T00:03:37+08:00	5963	1879	7842	882	8724	15847	55.05%	37.63%	21	21
8	花蓮縣壽豐鄉	2018-11-24T22:43:52+08:00	4216	1307	5523	641	6164	11561	53.32%	36.47%	16	21
8	臺中市和平區	2018-11-24T22:49:18+08:00	3027	724	3751	311	4062	6811	59.64%	44.44%	14	17
8	臺中市和平區	2018-11-24T23:14:33+08:00	4208	1007	5215	450	5665	9498	59.64%	44.3%	17	17
8	臺中市和平區	2018-11-24T22:56:31+08:00	3027	724	3751	311	4062	6811	59.64%	44.44%	14	17
8	臺中市和平區	2018-11-25T00:12:39+08:00	4208	1007	5215	450	5665	9498	59.64%	44.3%	17	17
8	臺中市和平區	2018-11-25T00:03:27+08:00	4208	1007	5215	450	5665	9498	59.64%	44.3%	17	17
8	臺中市和平區	2018-11-25T00:56:07+08:00	4208	1007	5215	450	5665	9498	59.64%	44.3%	17	17
8	臺中市和平區	2018-11-24T23:03:42+08:00	3294	778	4072	331	4403	7524	58.52%	43.78%	15	17
8	臺中市和平區	2018-11-24T23:10:51+08:00	4208	1007	5215	450	5665	9498	59.64%	44.3%	17	17
8	臺中市和平區	2018-11-25T03:37:18+08:00	4208	1007	5215	450	5665	9498	59.64%	44.3%	17	17
8	臺中市和平區	2018-11-24T22:43:44+08:00	3027	724	3751	311	4062	6811	59.64%	44.44%	14	17
8	臺中市和平區	2018-11-25T06:17:30+08:00	4208	1007	5215	450	5665	9498	59.64%	44.3%	17	17
8	臺中市和平區	2018-11-25T01:10:59+08:00	4208	1007	5215	450	5665	9498	59.64%	44.3%	17	17
8	臺中市和平區	2018-11-24T23:22:17+08:00	4208	1007	5215	450	5665	9498	59.64%	44.3%	17	17
8	臺中市和平區	2018-11-25T06:22:39+08:00	4208	1007	5215	450	5665	9498	59.64%	44.3%	17	17
8	臺中市和平區	2018-11-24T22:25:18+08:00	2309	523	2832	246	3078	5219	58.98%	44.24%	12	17
8	臺中市和平區	2018-11-24T23:29:40+08:00	4208	1007	5215	450	5665	9498	59.64%	44.3%	17	17
8	臺中市和平區	2018-11-25T00:17:02+08:00	4208	1007	5215	450	5665	9498	59.64%	44.3%	17	17
8	臺中市和平區	2018-11-25T00:07:58+08:00	4208	1007	5215	450	5665	9498	59.64%	44.3%	17	17
8	臺中市和平區	2018-11-25T01:16:15+08:00	4208	1007	5215	450	5665	9498	59.64%	44.3%	17	17
8	臺中市和平區	2018-11-25T01:05:52+08:00	4208	1007	5215	450	5665	9498	59.64%	44.3%	17	17
8	臺中市和平區	2018-11-24T22:14:42+08:00	2309	523	2832	246	3078	5219	58.98%	44.24%	12	17
8	臺中市和平區	2018-11-24T23:54:19+08:00	4208	1007	5215	450	5665	9498	59.64%	44.3%	17	17
8	臺中市和平區	2018-11-24T22:28:34+08:00	2744	660	3404	285	3689	6175	59.74%	44.44%	13	17
8	臺中市和平區	2018-11-24T22:18:13+08:00	2309	523	2832	246	3078	5219	58.98%	44.24%	12	17
8	臺中市和平區	2018-11-25T01:24:18+08:00	4208	1007	5215	450	5665	9498	59.64%	44.3%	17	17
8	臺中市和平區	2018-11-24T22:35:39+08:00	3027	724	3751	311	4062	6811	59.64%	44.44%	14	17
8	臺中市和平區	2018-11-24T23:50:09+08:00	4208	1007	5215	450	5665	9498	59.64%	44.3%	17	17
8	臺中市和平區	2018-11-24T23:58:35+08:00	4208	1007	5215	450	5665	9498	59.64%	44.3%	17	17
8	臺中市和平區	2018-11-25T06:27:49+08:00	4208	1007	5215	450	5665	9498	59.64%	44.3%	17	17
8	臺中市和平區	2018-11-24T22:39:03+08:00	3027	724	3751	311	4062	6811	59.64%	44.44%	14	17
8	臺中市和平區	2018-11-24T23:07:13+08:00	3737	903	4640	387	5027	8487	59.23%	44.03%	16	17
8	臺中市和平區	2018-11-25T01:00:54+08:00	4208	1007	5215	450	5665	9498	59.64%	44.3%	17	17
8	臺中市和平區	2018-11-24T23:00:08+08:00	3027	724	3751	311	4062	6811	59.64%	44.44%	14	17
8	臺中市和平區	2018-11-25T03:48:22+08:00	4208	1007	5215	450	5665	9498	59.64%	44.3%	17	17
8	臺中市和平區	2018-11-25T00:21:37+08:00	4208	1007	5215	450	5665	9498	59.64%	44.3%	17	17
8	臺中市和平區	2018-11-25T03:30:52+08:00	4208	1007	5215	450	5665	9498	59.64%	44.3%	17	17
8	臺中市和平區	2018-11-25T03:42:41+08:00	4208	1007	5215	450	5665	9498	59.64%	44.3%	17	17
8	臺中市和平區	2018-11-24T22:21:39+08:00	2309	523	2832	246	3078	5219	58.98%	44.24%	12	17
8	臺中市和平區	2018-11-24T22:32:12+08:00	2744	660	3404	285	3689	6175	59.74%	44.44%	13	17
8	臺中市和平區	2018-11-24T22:53:08+08:00	3027	724	3751	311	4062	6811	59.64%	44.44%	14	17
8	臺中市和平區	2018-11-25T04:01:22+08:00	4208	1007	5215	450	5665	9498	59.64%	44.3%	17	17
8	臺中市和平區	2018-11-24T22:11:57+08:00	2309	523	2832	246	3078	5219	58.98%	44.24%	12	17
8	臺中市和平區	2018-11-24T22:40:13+08:00	3027	724	3751	311	4062	6811	59.64%	44.44%	14	17
8	臺中市和平區	2018-11-25T06:12:31+08:00	4208	1007	5215	450	5665	9498	59.64%	44.3%	17	17
8	臺中市和平區	2018-11-25T06:07:16+08:00	4208	1007	5215	450	5665	9498	59.64%	44.3%	17	17
8	臺中市和平區	2018-11-24T23:33:44+08:00	4208	1007	5215	450	5665	9498	59.64%	44.3%	17	17
8	臺中市和平區	2018-11-24T23:26:01+08:00	4208	1007	5215	450	5665	9498	59.64%	44.3%	17	17
8	臺中市和平區	2018-11-25T03:54:34+08:00	4208	1007	5215	450	5665	9498	59.64%	44.3%	17	17
8	臺中市和平區	2018-11-24T23:45:58+08:00	4208	1007	5215	450	5665	9498	59.64%	44.3%	17	17
8	臺中市和平區	2018-11-24T23:41:56+08:00	4208	1007	5215	450	5665	9498	59.64%	44.3%	17	17
8	臺中市和平區	2018-11-24T23:37:43+08:00	4208	1007	5215	450	5665	9498	59.64%	44.3%	17	17
8	臺中市和平區	2018-11-24T23:18:21+08:00	4208	1007	5215	450	5665	9498	59.64%	44.3%	17	17
8	臺東縣太麻里鄉	2018-11-24T23:26:10+08:00	2997	971	3968	569	4537	9666	46.94%	31.01%	15	15
8	臺東縣太麻里鄉	2018-11-24T22:49:26+08:00	2997	971	3968	569	4537	9666	46.94%	31.01%	15	15
8	臺東縣太麻里鄉	2018-11-24T23:10:58+08:00	2997	971	3968	569	4537	9666	46.94%	31.01%	15	15
8	臺東縣太麻里鄉	2018-11-24T23:33:53+08:00	2997	971	3968	569	4537	9666	46.94%	31.01%	15	15
8	臺東縣太麻里鄉	2018-11-24T22:56:39+08:00	2997	971	3968	569	4537	9666	46.94%	31.01%	15	15
8	臺東縣太麻里鄉	2018-11-24T23:22:26+08:00	2997	971	3968	569	4537	9666	46.94%	31.01%	15	15
8	臺東縣太麻里鄉	2018-11-24T22:28:43+08:00	2997	971	3968	569	4537	9666	46.94%	31.01%	15	15
8	臺東縣太麻里鄉	2018-11-24T23:18:30+08:00	2997	971	3968	569	4537	9666	46.94%	31.01%	15	15
8	臺東縣太麻里鄉	2018-11-25T00:17:11+08:00	2997	971	3968	569	4537	9666	46.94%	31.01%	15	15
8	臺東縣太麻里鄉	2018-11-24T22:32:21+08:00	2997	971	3968	569	4537	9666	46.94%	31.01%	15	15
8	臺東縣太麻里鄉	2018-11-24T23:46:06+08:00	2997	971	3968	569	4537	9666	46.94%	31.01%	15	15
8	臺東縣太麻里鄉	2018-11-25T00:08:07+08:00	2997	971	3968	569	4537	9666	46.94%	31.01%	15	15
8	臺東縣太麻里鄉	2018-11-24T22:53:18+08:00	2997	971	3968	569	4537	9666	46.94%	31.01%	15	15
8	臺東縣太麻里鄉	2018-11-25T04:01:32+08:00	2997	971	3968	569	4537	9666	46.94%	31.01%	15	15
8	臺東縣太麻里鄉	2018-11-25T03:48:34+08:00	2997	971	3968	569	4537	9666	46.94%	31.01%	15	15
8	臺東縣太麻里鄉	2018-11-24T23:00:19+08:00	2997	971	3968	569	4537	9666	46.94%	31.01%	15	15
8	臺東縣太麻里鄉	2018-11-25T06:07:25+08:00	2997	971	3968	569	4537	9666	46.94%	31.01%	15	15
8	臺東縣太麻里鄉	2018-11-24T22:25:28+08:00	2997	971	3968	569	4537	9666	46.94%	31.01%	15	15
8	臺東縣太麻里鄉	2018-11-25T06:22:47+08:00	2997	971	3968	569	4537	9666	46.94%	31.01%	15	15
8	臺東縣太麻里鄉	2018-11-25T03:42:51+08:00	2997	971	3968	569	4537	9666	46.94%	31.01%	15	15
8	臺東縣太麻里鄉	2018-11-24T22:40:21+08:00	2997	971	3968	569	4537	9666	46.94%	31.01%	15	15
8	臺東縣太麻里鄉	2018-11-24T23:29:49+08:00	2997	971	3968	569	4537	9666	46.94%	31.01%	15	15
8	臺東縣太麻里鄉	2018-11-24T23:14:44+08:00	2997	971	3968	569	4537	9666	46.94%	31.01%	15	15
8	臺東縣太麻里鄉	2018-11-24T23:50:17+08:00	2997	971	3968	569	4537	9666	46.94%	31.01%	15	15
8	臺東縣太麻里鄉	2018-11-25T00:12:47+08:00	2997	971	3968	569	4537	9666	46.94%	31.01%	15	15
8	臺東縣太麻里鄉	2018-11-25T01:16:25+08:00	2997	971	3968	569	4537	9666	46.94%	31.01%	15	15
8	臺東縣太麻里鄉	2018-11-24T22:18:22+08:00	2746	895	3641	517	4158	8929	46.57%	30.75%	14	15
8	臺東縣太麻里鄉	2018-11-25T03:37:32+08:00	2997	971	3968	569	4537	9666	46.94%	31.01%	15	15
8	臺東縣太麻里鄉	2018-11-25T06:27:58+08:00	2997	971	3968	569	4537	9666	46.94%	31.01%	15	15
8	臺東縣太麻里鄉	2018-11-25T06:17:40+08:00	2997	971	3968	569	4537	9666	46.94%	31.01%	15	15
8	臺東縣太麻里鄉	2018-11-25T03:54:44+08:00	2997	971	3968	569	4537	9666	46.94%	31.01%	15	15
8	臺東縣太麻里鄉	2018-11-24T23:03:49+08:00	2997	971	3968	569	4537	9666	46.94%	31.01%	15	15
8	臺東縣太麻里鄉	2018-11-24T22:14:52+08:00	2746	895	3641	517	4158	8929	46.57%	30.75%	14	15
8	臺東縣太麻里鄉	2018-11-25T01:24:28+08:00	2997	971	3968	569	4537	9666	46.94%	31.01%	15	15
8	臺東縣太麻里鄉	2018-11-24T23:37:51+08:00	2997	971	3968	569	4537	9666	46.94%	31.01%	15	15
8	臺東縣太麻里鄉	2018-11-24T23:07:22+08:00	2997	971	3968	569	4537	9666	46.94%	31.01%	15	15
8	臺東縣太麻里鄉	2018-11-24T22:12:05+08:00	2746	895	3641	517	4158	8929	46.57%	30.75%	14	15
8	臺東縣太麻里鄉	2018-11-24T23:54:30+08:00	2997	971	3968	569	4537	9666	46.94%	31.01%	15	15
8	臺東縣太麻里鄉	2018-11-24T23:42:04+08:00	2997	971	3968	569	4537	9666	46.94%	31.01%	15	15
8	臺東縣太麻里鄉	2018-11-25T01:11:10+08:00	2997	971	3968	569	4537	9666	46.94%	31.01%	15	15
8	臺東縣太麻里鄉	2018-11-25T01:06:03+08:00	2997	971	3968	569	4537	9666	46.94%	31.01%	15	15
8	臺東縣太麻里鄉	2018-11-25T00:21:47+08:00	2997	971	3968	569	4537	9666	46.94%	31.01%	15	15
8	臺東縣太麻里鄉	2018-11-25T06:12:39+08:00	2997	971	3968	569	4537	9666	46.94%	31.01%	15	15
8	臺東縣太麻里鄉	2018-11-24T22:21:49+08:00	2997	971	3968	569	4537	9666	46.94%	31.01%	15	15
8	臺東縣太麻里鄉	2018-11-25T01:01:04+08:00	2997	971	3968	569	4537	9666	46.94%	31.01%	15	15
8	臺東縣太麻里鄉	2018-11-25T00:03:38+08:00	2997	971	3968	569	4537	9666	46.94%	31.01%	15	15
8	臺東縣太麻里鄉	2018-11-24T22:43:53+08:00	2997	971	3968	569	4537	9666	46.94%	31.01%	15	15
8	臺東縣太麻里鄉	2018-11-24T22:35:47+08:00	2997	971	3968	569	4537	9666	46.94%	31.01%	15	15
8	臺東縣太麻里鄉	2018-11-24T23:58:45+08:00	2997	971	3968	569	4537	9666	46.94%	31.01%	15	15
8	臺東縣太麻里鄉	2018-11-25T00:56:16+08:00	2997	971	3968	569	4537	9666	46.94%	31.01%	15	15
8	臺東縣太麻里鄉	2018-11-24T22:39:11+08:00	2997	971	3968	569	4537	9666	46.94%	31.01%	15	15
8	臺東縣太麻里鄉	2018-11-25T03:31:02+08:00	2997	971	3968	569	4537	9666	46.94%	31.01%	15	15
8	高雄市田寮區	2018-11-24T22:49:20+08:00	1969	745	2714	366	3080	6671	46.17%	29.52%	12	12
8	高雄市田寮區	2018-11-25T03:37:21+08:00	1969	745	2714	366	3080	6671	46.17%	29.52%	12	12
8	高雄市田寮區	2018-11-24T23:03:44+08:00	1969	745	2714	366	3080	6671	46.17%	29.52%	12	12
8	高雄市田寮區	2018-11-25T00:03:29+08:00	1969	745	2714	366	3080	6671	46.17%	29.52%	12	12
8	高雄市田寮區	2018-11-25T00:56:09+08:00	1969	745	2714	366	3080	6671	46.17%	29.52%	12	12
8	高雄市田寮區	2018-11-24T23:58:38+08:00	1969	745	2714	366	3080	6671	46.17%	29.52%	12	12
8	高雄市田寮區	2018-11-24T23:22:19+08:00	1969	745	2714	366	3080	6671	46.17%	29.52%	12	12
8	高雄市田寮區	2018-11-25T03:42:44+08:00	1969	745	2714	366	3080	6671	46.17%	29.52%	12	12
8	高雄市田寮區	2018-11-24T22:53:10+08:00	1969	745	2714	366	3080	6671	46.17%	29.52%	12	12
8	高雄市田寮區	2018-11-25T01:00:57+08:00	1969	745	2714	366	3080	6671	46.17%	29.52%	12	12
8	高雄市田寮區	2018-11-25T00:08:00+08:00	1969	745	2714	366	3080	6671	46.17%	29.52%	12	12
8	高雄市田寮區	2018-11-24T23:46:00+08:00	1969	745	2714	366	3080	6671	46.17%	29.52%	12	12
8	高雄市田寮區	2018-11-24T22:21:42+08:00	1969	745	2714	366	3080	6671	46.17%	29.52%	12	12
8	高雄市田寮區	2018-11-25T06:12:33+08:00	1969	745	2714	366	3080	6671	46.17%	29.52%	12	12
8	高雄市田寮區	2018-11-25T00:17:04+08:00	1969	745	2714	366	3080	6671	46.17%	29.52%	12	12
8	高雄市田寮區	2018-11-25T06:22:41+08:00	1969	745	2714	366	3080	6671	46.17%	29.52%	12	12
8	高雄市田寮區	2018-11-24T22:25:20+08:00	1969	745	2714	366	3080	6671	46.17%	29.52%	12	12
8	高雄市田寮區	2018-11-24T23:18:23+08:00	1969	745	2714	366	3080	6671	46.17%	29.52%	12	12
8	高雄市田寮區	2018-11-24T22:14:44+08:00	1969	745	2714	366	3080	6671	46.17%	29.52%	12	12
8	高雄市田寮區	2018-11-24T23:50:11+08:00	1969	745	2714	366	3080	6671	46.17%	29.52%	12	12
8	高雄市田寮區	2018-11-25T01:05:54+08:00	1969	745	2714	366	3080	6671	46.17%	29.52%	12	12
8	高雄市田寮區	2018-11-24T23:33:46+08:00	1969	745	2714	366	3080	6671	46.17%	29.52%	12	12
8	高雄市田寮區	2018-11-25T06:27:51+08:00	1969	745	2714	366	3080	6671	46.17%	29.52%	12	12
8	高雄市田寮區	2018-11-24T23:26:03+08:00	1969	745	2714	366	3080	6671	46.17%	29.52%	12	12
8	高雄市田寮區	2018-11-25T03:54:36+08:00	1969	745	2714	366	3080	6671	46.17%	29.52%	12	12
8	高雄市田寮區	2018-11-25T00:12:41+08:00	1969	745	2714	366	3080	6671	46.17%	29.52%	12	12
8	高雄市田寮區	2018-11-25T01:24:20+08:00	1969	745	2714	366	3080	6671	46.17%	29.52%	12	12
8	高雄市田寮區	2018-11-24T22:43:46+08:00	1969	745	2714	366	3080	6671	46.17%	29.52%	12	12
8	高雄市田寮區	2018-11-25T06:17:32+08:00	1969	745	2714	366	3080	6671	46.17%	29.52%	12	12
8	高雄市田寮區	2018-11-24T23:07:15+08:00	1969	745	2714	366	3080	6671	46.17%	29.52%	12	12
8	高雄市田寮區	2018-11-24T22:39:05+08:00	1969	745	2714	366	3080	6671	46.17%	29.52%	12	12
8	高雄市田寮區	2018-11-24T22:56:33+08:00	1969	745	2714	366	3080	6671	46.17%	29.52%	12	12
8	高雄市田寮區	2018-11-24T23:14:36+08:00	1969	745	2714	366	3080	6671	46.17%	29.52%	12	12
8	高雄市田寮區	2018-11-24T23:10:52+08:00	1969	745	2714	366	3080	6671	46.17%	29.52%	12	12
8	高雄市田寮區	2018-11-25T03:48:25+08:00	1969	745	2714	366	3080	6671	46.17%	29.52%	12	12
8	高雄市田寮區	2018-11-24T22:32:14+08:00	1969	745	2714	366	3080	6671	46.17%	29.52%	12	12
8	高雄市田寮區	2018-11-25T03:30:54+08:00	1969	745	2714	366	3080	6671	46.17%	29.52%	12	12
8	高雄市田寮區	2018-11-24T22:40:15+08:00	1969	745	2714	366	3080	6671	46.17%	29.52%	12	12
8	高雄市田寮區	2018-11-25T00:21:40+08:00	1969	745	2714	366	3080	6671	46.17%	29.52%	12	12
8	高雄市田寮區	2018-11-24T23:29:42+08:00	1969	745	2714	366	3080	6671	46.17%	29.52%	12	12
8	高雄市田寮區	2018-11-25T01:11:02+08:00	1969	745	2714	366	3080	6671	46.17%	29.52%	12	12
8	高雄市田寮區	2018-11-24T22:11:59+08:00	1969	745	2714	366	3080	6671	46.17%	29.52%	12	12
8	高雄市田寮區	2018-11-24T23:00:14+08:00	1969	745	2714	366	3080	6671	46.17%	29.52%	12	12
8	高雄市田寮區	2018-11-25T06:07:18+08:00	1969	745	2714	366	3080	6671	46.17%	29.52%	12	12
8	高雄市田寮區	2018-11-25T04:01:24+08:00	1969	745	2714	366	3080	6671	46.17%	29.52%	12	12
8	高雄市田寮區	2018-11-24T22:28:36+08:00	1969	745	2714	366	3080	6671	46.17%	29.52%	12	12
8	高雄市田寮區	2018-11-24T22:18:16+08:00	1969	745	2714	366	3080	6671	46.17%	29.52%	12	12
8	高雄市田寮區	2018-11-24T23:54:23+08:00	1969	745	2714	366	3080	6671	46.17%	29.52%	12	12
8	高雄市田寮區	2018-11-24T22:35:41+08:00	1969	745	2714	366	3080	6671	46.17%	29.52%	12	12
8	高雄市田寮區	2018-11-24T23:37:45+08:00	1969	745	2714	366	3080	6671	46.17%	29.52%	12	12
8	高雄市田寮區	2018-11-24T23:41:58+08:00	1969	745	2714	366	3080	6671	46.17%	29.52%	12	12
8	高雄市田寮區	2018-11-25T01:16:17+08:00	1969	745	2714	366	3080	6671	46.17%	29.52%	12	12
8	高雄市六龜區	2018-11-24T22:49:20+08:00	3260	962	4222	666	4888	10498	46.56%	31.05%	11	12
8	高雄市六龜區	2018-11-24T23:03:44+08:00	3260	962	4222	666	4888	10498	46.56%	31.05%	11	12
8	高雄市六龜區	2018-11-24T23:58:38+08:00	3583	1077	4660	737	5397	11501	46.93%	31.15%	12	12
8	高雄市六龜區	2018-11-24T23:22:19+08:00	3260	962	4222	666	4888	10498	46.56%	31.05%	11	12
8	高雄市六龜區	2018-11-25T03:42:44+08:00	3583	1077	4660	737	5397	11501	46.93%	31.15%	12	12
8	高雄市六龜區	2018-11-25T01:00:57+08:00	3583	1077	4660	737	5397	11501	46.93%	31.15%	12	12
8	高雄市六龜區	2018-11-24T22:53:11+08:00	3260	962	4222	666	4888	10498	46.56%	31.05%	11	12
8	高雄市六龜區	2018-11-24T23:46:00+08:00	3583	1077	4660	737	5397	11501	46.93%	31.15%	12	12
8	高雄市六龜區	2018-11-25T00:08:01+08:00	3583	1077	4660	737	5397	11501	46.93%	31.15%	12	12
8	高雄市六龜區	2018-11-24T22:21:42+08:00	3260	962	4222	666	4888	10498	46.56%	31.05%	11	12
8	高雄市六龜區	2018-11-25T06:12:33+08:00	3583	1077	4660	737	5397	11501	46.93%	31.15%	12	12
8	高雄市六龜區	2018-11-25T00:17:04+08:00	3583	1077	4660	737	5397	11501	46.93%	31.15%	12	12
8	高雄市六龜區	2018-11-24T22:25:20+08:00	3260	962	4222	666	4888	10498	46.56%	31.05%	11	12
8	高雄市六龜區	2018-11-24T23:18:24+08:00	3260	962	4222	666	4888	10498	46.56%	31.05%	11	12
8	高雄市六龜區	2018-11-25T01:05:55+08:00	3583	1077	4660	737	5397	11501	46.93%	31.15%	12	12
8	高雄市六龜區	2018-11-24T23:50:11+08:00	3583	1077	4660	737	5397	11501	46.93%	31.15%	12	12
8	高雄市六龜區	2018-11-24T23:26:04+08:00	3260	962	4222	666	4888	10498	46.56%	31.05%	11	12
8	高雄市六龜區	2018-11-24T22:14:45+08:00	2838	845	3683	552	4235	9116	46.46%	31.13%	10	12
8	高雄市六龜區	2018-11-24T23:33:46+08:00	3260	962	4222	666	4888	10498	46.56%	31.05%	11	12
8	高雄市六龜區	2018-11-25T06:27:51+08:00	3583	1077	4660	737	5397	11501	46.93%	31.15%	12	12
8	高雄市六龜區	2018-11-25T03:54:36+08:00	3583	1077	4660	737	5397	11501	46.93%	31.15%	12	12
8	高雄市六龜區	2018-11-25T01:24:20+08:00	3583	1077	4660	737	5397	11501	46.93%	31.15%	12	12
8	高雄市六龜區	2018-11-24T22:43:46+08:00	3260	962	4222	666	4888	10498	46.56%	31.05%	11	12
8	高雄市六龜區	2018-11-25T06:17:32+08:00	3583	1077	4660	737	5397	11501	46.93%	31.15%	12	12
8	高雄市六龜區	2018-11-25T03:37:22+08:00	3583	1077	4660	737	5397	11501	46.93%	31.15%	12	12
8	高雄市六龜區	2018-11-24T23:07:15+08:00	3260	962	4222	666	4888	10498	46.56%	31.05%	11	12
8	高雄市六龜區	2018-11-24T22:39:05+08:00	3260	962	4222	666	4888	10498	46.56%	31.05%	11	12
8	高雄市六龜區	2018-11-24T23:10:53+08:00	3260	962	4222	666	4888	10498	46.56%	31.05%	11	12
8	高雄市六龜區	2018-11-24T22:56:33+08:00	3260	962	4222	666	4888	10498	46.56%	31.05%	11	12
8	高雄市六龜區	2018-11-24T23:14:36+08:00	3260	962	4222	666	4888	10498	46.56%	31.05%	11	12
8	高雄市六龜區	2018-11-25T03:48:25+08:00	3583	1077	4660	737	5397	11501	46.93%	31.15%	12	12
8	高雄市六龜區	2018-11-25T03:30:55+08:00	3583	1077	4660	737	5397	11501	46.93%	31.15%	12	12
8	高雄市六龜區	2018-11-24T22:32:15+08:00	3260	962	4222	666	4888	10498	46.56%	31.05%	11	12
8	高雄市六龜區	2018-11-24T22:40:15+08:00	3260	962	4222	666	4888	10498	46.56%	31.05%	11	12
8	高雄市六龜區	2018-11-25T04:01:25+08:00	3583	1077	4660	737	5397	11501	46.93%	31.15%	12	12
8	高雄市六龜區	2018-11-24T22:11:59+08:00	2838	845	3683	552	4235	9116	46.46%	31.13%	10	12
8	高雄市六龜區	2018-11-24T23:00:14+08:00	3260	962	4222	666	4888	10498	46.56%	31.05%	11	12
8	高雄市六龜區	2018-11-25T06:07:19+08:00	3583	1077	4660	737	5397	11501	46.93%	31.15%	12	12
8	高雄市六龜區	2018-11-25T01:11:03+08:00	3583	1077	4660	737	5397	11501	46.93%	31.15%	12	12
8	高雄市六龜區	2018-11-24T23:29:43+08:00	3260	962	4222	666	4888	10498	46.56%	31.05%	11	12
8	高雄市六龜區	2018-11-25T00:21:41+08:00	3583	1077	4660	737	5397	11501	46.93%	31.15%	12	12
8	高雄市六龜區	2018-11-25T06:22:42+08:00	3583	1077	4660	737	5397	11501	46.93%	31.15%	12	12
8	高雄市六龜區	2018-11-24T22:28:36+08:00	3260	962	4222	666	4888	10498	46.56%	31.05%	11	12
8	高雄市六龜區	2018-11-25T00:56:10+08:00	3583	1077	4660	737	5397	11501	46.93%	31.15%	12	12
8	高雄市六龜區	2018-11-24T22:18:16+08:00	2838	845	3683	552	4235	9116	46.46%	31.13%	10	12
8	高雄市六龜區	2018-11-24T23:54:24+08:00	3583	1077	4660	737	5397	11501	46.93%	31.15%	12	12
8	高雄市六龜區	2018-11-24T22:35:41+08:00	3260	962	4222	666	4888	10498	46.56%	31.05%	11	12
8	高雄市六龜區	2018-11-25T01:16:18+08:00	3583	1077	4660	737	5397	11501	46.93%	31.15%	12	12
8	高雄市六龜區	2018-11-24T23:37:45+08:00	3583	1077	4660	737	5397	11501	46.93%	31.15%	12	12
8	高雄市六龜區	2018-11-24T23:41:58+08:00	3583	1077	4660	737	5397	11501	46.93%	31.15%	12	12
8	高雄市六龜區	2018-11-25T00:12:42+08:00	3583	1077	4660	737	5397	11501	46.93%	31.15%	12	12
8	高雄市六龜區	2018-11-25T00:03:30+08:00	3583	1077	4660	737	5397	11501	46.93%	31.15%	12	12
8	嘉義縣新港鄉	2018-11-24T23:07:18+08:00	9189	3294	12483	1935	14418	27342	52.73%	33.61%	31	31
8	嘉義縣新港鄉	2018-11-24T22:56:36+08:00	8620	3110	11730	1847	13577	25942	52.34%	33.23%	30	31
8	嘉義縣新港鄉	2018-11-25T01:24:24+08:00	9189	3294	12483	1935	14418	27342	52.73%	33.61%	31	31
8	嘉義縣新港鄉	2018-11-25T03:54:40+08:00	9189	3294	12483	1935	14418	27342	52.73%	33.61%	31	31
8	嘉義縣新港鄉	2018-11-25T06:17:36+08:00	9189	3294	12483	1935	14418	27342	52.73%	33.61%	31	31
8	嘉義縣新港鄉	2018-11-24T23:10:56+08:00	9189	3294	12483	1935	14418	27342	52.73%	33.61%	31	31
8	嘉義縣新港鄉	2018-11-25T03:37:29+08:00	9189	3294	12483	1935	14418	27342	52.73%	33.61%	31	31
8	嘉義縣新港鄉	2018-11-24T22:39:09+08:00	8185	2961	11146	1700	12846	24639	52.14%	33.22%	28	31
8	嘉義縣新港鄉	2018-11-25T03:30:59+08:00	9189	3294	12483	1935	14418	27342	52.73%	33.61%	31	31
8	嘉義縣新港鄉	2018-11-24T22:32:18+08:00	8185	2961	11146	1700	12846	24639	52.14%	33.22%	28	31
8	嘉義縣新港鄉	2018-11-25T03:48:29+08:00	9189	3294	12483	1935	14418	27342	52.73%	33.61%	31	31
8	嘉義縣新港鄉	2018-11-24T23:00:17+08:00	8620	3110	11730	1847	13577	25942	52.34%	33.23%	30	31
8	嘉義縣新港鄉	2018-11-25T06:07:22+08:00	9189	3294	12483	1935	14418	27342	52.73%	33.61%	31	31
8	嘉義縣新港鄉	2018-11-25T00:21:44+08:00	9189	3294	12483	1935	14418	27342	52.73%	33.61%	31	31
8	嘉義縣新港鄉	2018-11-24T23:29:46+08:00	9189	3294	12483	1935	14418	27342	52.73%	33.61%	31	31
8	嘉義縣新港鄉	2018-11-24T22:40:18+08:00	8185	2961	11146	1700	12846	24639	52.14%	33.22%	28	31
8	嘉義縣新港鄉	2018-11-25T04:01:29+08:00	9189	3294	12483	1935	14418	27342	52.73%	33.61%	31	31
8	嘉義縣新港鄉	2018-11-25T01:11:07+08:00	9189	3294	12483	1935	14418	27342	52.73%	33.61%	31	31
8	嘉義縣新港鄉	2018-11-24T23:37:48+08:00	9189	3294	12483	1935	14418	27342	52.73%	33.61%	31	31
8	嘉義縣新港鄉	2018-11-24T22:43:50+08:00	8460	3049	11509	1798	13307	25455	52.28%	33.24%	29	31
8	嘉義縣新港鄉	2018-11-25T00:56:13+08:00	9189	3294	12483	1935	14418	27342	52.73%	33.61%	31	31
8	嘉義縣新港鄉	2018-11-24T23:54:27+08:00	9189	3294	12483	1935	14418	27342	52.73%	33.61%	31	31
8	嘉義縣新港鄉	2018-11-25T01:16:22+08:00	9189	3294	12483	1935	14418	27342	52.73%	33.61%	31	31
8	嘉義縣新港鄉	2018-11-25T00:03:34+08:00	9189	3294	12483	1935	14418	27342	52.73%	33.61%	31	31
8	嘉義縣新港鄉	2018-11-24T22:35:44+08:00	8185	2961	11146	1700	12846	24639	52.14%	33.22%	28	31
8	嘉義縣新港鄉	2018-11-25T01:01:01+08:00	9189	3294	12483	1935	14418	27342	52.73%	33.61%	31	31
8	嘉義縣新港鄉	2018-11-24T23:22:23+08:00	9189	3294	12483	1935	14418	27342	52.73%	33.61%	31	31
8	嘉義縣新港鄉	2018-11-24T22:49:24+08:00	8620	3110	11730	1847	13577	25942	52.34%	33.23%	30	31
8	嘉義縣新港鄉	2018-11-24T23:03:47+08:00	8620	3110	11730	1847	13577	25942	52.34%	33.23%	30	31
8	嘉義縣新港鄉	2018-11-24T22:28:40+08:00	8185	2961	11146	1700	12846	24639	52.14%	33.22%	28	31
8	嘉義縣新港鄉	2018-11-24T23:33:50+08:00	9189	3294	12483	1935	14418	27342	52.73%	33.61%	31	31
8	嘉義縣新港鄉	2018-11-24T22:12:02+08:00	8185	2961	11146	1700	12846	24639	52.14%	33.22%	28	31
8	嘉義縣新港鄉	2018-11-25T00:08:04+08:00	9189	3294	12483	1935	14418	27342	52.73%	33.61%	31	31
8	嘉義縣新港鄉	2018-11-24T23:42:02+08:00	9189	3294	12483	1935	14418	27342	52.73%	33.61%	31	31
8	嘉義縣新港鄉	2018-11-25T03:42:48+08:00	9189	3294	12483	1935	14418	27342	52.73%	33.61%	31	31
8	嘉義縣新港鄉	2018-11-24T22:53:15+08:00	8620	3110	11730	1847	13577	25942	52.34%	33.23%	30	31
8	嘉義縣新港鄉	2018-11-24T23:46:03+08:00	9189	3294	12483	1935	14418	27342	52.73%	33.61%	31	31
8	嘉義縣新港鄉	2018-11-25T00:17:07+08:00	9189	3294	12483	1935	14418	27342	52.73%	33.61%	31	31
8	嘉義縣新港鄉	2018-11-24T22:21:46+08:00	8185	2961	11146	1700	12846	24639	52.14%	33.22%	28	31
8	嘉義縣新港鄉	2018-11-24T22:25:25+08:00	8185	2961	11146	1700	12846	24639	52.14%	33.22%	28	31
8	嘉義縣新港鄉	2018-11-25T06:22:44+08:00	9189	3294	12483	1935	14418	27342	52.73%	33.61%	31	31
8	嘉義縣新港鄉	2018-11-25T06:12:36+08:00	9189	3294	12483	1935	14418	27342	52.73%	33.61%	31	31
8	嘉義縣新港鄉	2018-11-24T22:14:49+08:00	8185	2961	11146	1700	12846	24639	52.14%	33.22%	28	31
8	嘉義縣新港鄉	2018-11-24T23:18:27+08:00	9189	3294	12483	1935	14418	27342	52.73%	33.61%	31	31
8	嘉義縣新港鄉	2018-11-24T23:50:14+08:00	9189	3294	12483	1935	14418	27342	52.73%	33.61%	31	31
8	嘉義縣新港鄉	2018-11-24T22:18:19+08:00	8185	2961	11146	1700	12846	24639	52.14%	33.22%	28	31
8	嘉義縣新港鄉	2018-11-24T23:58:42+08:00	9189	3294	12483	1935	14418	27342	52.73%	33.61%	31	31
8	嘉義縣新港鄉	2018-11-25T06:27:55+08:00	9189	3294	12483	1935	14418	27342	52.73%	33.61%	31	31
8	嘉義縣新港鄉	2018-11-24T23:26:07+08:00	9189	3294	12483	1935	14418	27342	52.73%	33.61%	31	31
8	嘉義縣新港鄉	2018-11-25T00:12:45+08:00	9189	3294	12483	1935	14418	27342	52.73%	33.61%	31	31
8	嘉義縣新港鄉	2018-11-25T01:05:59+08:00	9189	3294	12483	1935	14418	27342	52.73%	33.61%	31	31
8	嘉義縣新港鄉	2018-11-24T23:14:41+08:00	9189	3294	12483	1935	14418	27342	52.73%	33.61%	31	31
8	嘉義縣大埔鄉	2018-11-24T23:07:18+08:00	943	281	1224	88	1312	2531	51.84%	37.26%	8	9
8	嘉義縣大埔鄉	2018-11-24T22:56:36+08:00	687	213	900	64	964	1962	49.13%	35.02%	7	9
8	嘉義縣大埔鄉	2018-11-25T06:17:36+08:00	1488	448	1936	177	2113	3999	52.84%	37.21%	9	9
8	嘉義縣大埔鄉	2018-11-24T23:10:56+08:00	943	281	1224	88	1312	2531	51.84%	37.26%	8	9
8	嘉義縣大埔鄉	2018-11-25T03:37:29+08:00	1488	448	1936	177	2113	3999	52.84%	37.21%	9	9
8	嘉義縣大埔鄉	2018-11-24T22:39:09+08:00	687	213	900	64	964	1962	49.13%	35.02%	7	9
8	嘉義縣大埔鄉	2018-11-25T01:24:25+08:00	943	281	1224	88	1312	2531	51.84%	37.26%	8	9
8	嘉義縣大埔鄉	2018-11-25T03:54:41+08:00	1488	448	1936	177	2113	3999	52.84%	37.21%	9	9
8	嘉義縣大埔鄉	2018-11-25T03:30:59+08:00	1488	448	1936	177	2113	3999	52.84%	37.21%	9	9
8	嘉義縣大埔鄉	2018-11-24T22:32:18+08:00	687	213	900	64	964	1962	49.13%	35.02%	7	9
8	嘉義縣大埔鄉	2018-11-24T23:00:17+08:00	687	213	900	64	964	1962	49.13%	35.02%	7	9
8	嘉義縣大埔鄉	2018-11-25T00:21:44+08:00	943	281	1224	88	1312	2531	51.84%	37.26%	8	9
8	嘉義縣大埔鄉	2018-11-24T23:29:46+08:00	943	281	1224	88	1312	2531	51.84%	37.26%	8	9
8	嘉義縣大埔鄉	2018-11-25T06:07:23+08:00	1488	448	1936	177	2113	3999	52.84%	37.21%	9	9
8	嘉義縣大埔鄉	2018-11-25T04:01:29+08:00	1488	448	1936	177	2113	3999	52.84%	37.21%	9	9
8	嘉義縣大埔鄉	2018-11-25T01:11:07+08:00	943	281	1224	88	1312	2531	51.84%	37.26%	8	9
8	嘉義縣大埔鄉	2018-11-24T22:40:19+08:00	687	213	900	64	964	1962	49.13%	35.02%	7	9
8	嘉義縣大埔鄉	2018-11-24T22:43:50+08:00	687	213	900	64	964	1962	49.13%	35.02%	7	9
8	嘉義縣大埔鄉	2018-11-25T00:56:13+08:00	943	281	1224	88	1312	2531	51.84%	37.26%	8	9
8	嘉義縣大埔鄉	2018-11-24T23:54:27+08:00	943	281	1224	88	1312	2531	51.84%	37.26%	8	9
8	嘉義縣大埔鄉	2018-11-24T22:35:45+08:00	687	213	900	64	964	1962	49.13%	35.02%	7	9
8	嘉義縣大埔鄉	2018-11-25T01:16:22+08:00	943	281	1224	88	1312	2531	51.84%	37.26%	8	9
8	嘉義縣大埔鄉	2018-11-25T00:03:34+08:00	943	281	1224	88	1312	2531	51.84%	37.26%	8	9
8	嘉義縣大埔鄉	2018-11-24T23:37:49+08:00	943	281	1224	88	1312	2531	51.84%	37.26%	8	9
8	嘉義縣大埔鄉	2018-11-25T01:01:01+08:00	943	281	1224	88	1312	2531	51.84%	37.26%	8	9
8	嘉義縣大埔鄉	2018-11-24T23:22:23+08:00	943	281	1224	88	1312	2531	51.84%	37.26%	8	9
8	嘉義縣大埔鄉	2018-11-24T22:49:24+08:00	687	213	900	64	964	1962	49.13%	35.02%	7	9
8	嘉義縣大埔鄉	2018-11-24T23:03:47+08:00	943	281	1224	88	1312	2531	51.84%	37.26%	8	9
8	嘉義縣大埔鄉	2018-11-24T22:28:40+08:00	687	213	900	64	964	1962	49.13%	35.02%	7	9
8	嘉義縣大埔鄉	2018-11-24T23:33:50+08:00	943	281	1224	88	1312	2531	51.84%	37.26%	8	9
8	嘉義縣大埔鄉	2018-11-24T22:12:02+08:00	687	213	900	64	964	1962	49.13%	35.02%	7	9
8	嘉義縣大埔鄉	2018-11-24T23:42:02+08:00	943	281	1224	88	1312	2531	51.84%	37.26%	8	9
8	嘉義縣大埔鄉	2018-11-25T00:08:05+08:00	943	281	1224	88	1312	2531	51.84%	37.26%	8	9
8	嘉義縣大埔鄉	2018-11-25T03:42:48+08:00	1488	448	1936	177	2113	3999	52.84%	37.21%	9	9
8	嘉義縣大埔鄉	2018-11-24T22:53:15+08:00	687	213	900	64	964	1962	49.13%	35.02%	7	9
8	嘉義縣大埔鄉	2018-11-24T23:46:04+08:00	943	281	1224	88	1312	2531	51.84%	37.26%	8	9
8	嘉義縣大埔鄉	2018-11-25T06:12:37+08:00	1488	448	1936	177	2113	3999	52.84%	37.21%	9	9
8	嘉義縣大埔鄉	2018-11-24T22:21:46+08:00	687	213	900	64	964	1962	49.13%	35.02%	7	9
8	嘉義縣大埔鄉	2018-11-24T22:25:25+08:00	687	213	900	64	964	1962	49.13%	35.02%	7	9
8	嘉義縣大埔鄉	2018-11-25T00:17:08+08:00	943	281	1224	88	1312	2531	51.84%	37.26%	8	9
8	嘉義縣大埔鄉	2018-11-25T06:22:45+08:00	1488	448	1936	177	2113	3999	52.84%	37.21%	9	9
8	嘉義縣大埔鄉	2018-11-25T03:48:31+08:00	1488	448	1936	177	2113	3999	52.84%	37.21%	9	9
8	嘉義縣大埔鄉	2018-11-24T22:14:49+08:00	687	213	900	64	964	1962	49.13%	35.02%	7	9
8	嘉義縣大埔鄉	2018-11-24T22:18:20+08:00	687	213	900	64	964	1962	49.13%	35.02%	7	9
8	嘉義縣大埔鄉	2018-11-24T23:18:27+08:00	943	281	1224	88	1312	2531	51.84%	37.26%	8	9
8	嘉義縣大埔鄉	2018-11-24T23:58:42+08:00	943	281	1224	88	1312	2531	51.84%	37.26%	8	9
8	嘉義縣大埔鄉	2018-11-25T06:27:55+08:00	1488	448	1936	177	2113	3999	52.84%	37.21%	9	9
8	嘉義縣大埔鄉	2018-11-24T23:26:07+08:00	943	281	1224	88	1312	2531	51.84%	37.26%	8	9
8	嘉義縣大埔鄉	2018-11-25T00:12:45+08:00	943	281	1224	88	1312	2531	51.84%	37.26%	8	9
8	嘉義縣大埔鄉	2018-11-25T01:05:59+08:00	943	281	1224	88	1312	2531	51.84%	37.26%	8	9
8	嘉義縣大埔鄉	2018-11-24T23:14:41+08:00	943	281	1224	88	1312	2531	51.84%	37.26%	8	9
8	嘉義縣大埔鄉	2018-11-24T23:50:15+08:00	943	281	1224	88	1312	2531	51.84%	37.26%	8	9
8	金門縣	2018-11-24T23:26:10+08:00	32636	6569	39205	2797	42002	117450	35.76%	27.79%	75	78
8	金門縣	2018-11-24T23:10:59+08:00	32636	6569	39205	2797	42002	117450	35.76%	27.79%	75	78
8	金門縣	2018-11-24T22:49:27+08:00	30982	6229	37211	2683	39894	111828	35.67%	27.71%	72	78
8	金門縣	2018-11-24T23:33:53+08:00	33718	6754	40472	2890	43362	121185	35.78%	27.82%	77	78
8	金門縣	2018-11-24T22:12:06+08:00	25756	5043	30799	2232	33031	93018	35.51%	27.69%	61	78
8	金門縣	2018-11-24T22:56:39+08:00	31482	6336	37818	2717	40535	113608	35.68%	27.71%	73	78
8	金門縣	2018-11-24T23:22:26+08:00	32636	6569	39205	2797	42002	117450	35.76%	27.79%	75	78
8	金門縣	2018-11-24T22:28:43+08:00	28102	5484	33586	2418	36004	101611	35.43%	27.66%	66	78
8	金門縣	2018-11-24T23:18:30+08:00	32636	6569	39205	2797	42002	117450	35.76%	27.79%	75	78
8	金門縣	2018-11-24T23:37:52+08:00	33718	6754	40472	2890	43362	121185	35.78%	27.82%	77	78
8	金門縣	2018-11-25T00:17:11+08:00	34139	6816	40955	2945	43900	122695	35.78%	27.82%	78	78
8	金門縣	2018-11-24T22:32:21+08:00	28569	5567	34136	2472	36608	103014	35.54%	27.73%	67	78
8	金門縣	2018-11-24T23:46:06+08:00	34139	6816	40955	2945	43900	122695	35.78%	27.82%	78	78
8	金門縣	2018-11-24T22:21:50+08:00	28102	5484	33586	2418	36004	101611	35.43%	27.66%	66	78
8	金門縣	2018-11-24T22:53:18+08:00	30982	6229	37211	2683	39894	111828	35.67%	27.71%	72	78
8	金門縣	2018-11-25T00:08:08+08:00	34139	6816	40955	2945	43900	122695	35.78%	27.82%	78	78
8	金門縣	2018-11-25T04:01:32+08:00	34139	6816	40955	2945	43900	122695	35.78%	27.82%	78	78
8	金門縣	2018-11-25T03:48:34+08:00	34139	6816	40955	2945	43900	122695	35.78%	27.82%	78	78
8	金門縣	2018-11-24T22:25:28+08:00	28102	5484	33586	2418	36004	101611	35.43%	27.66%	66	78
8	金門縣	2018-11-24T23:00:20+08:00	31931	6440	38371	2749	41120	114933	35.78%	27.78%	74	78
8	金門縣	2018-11-25T06:22:48+08:00	34139	6816	40955	2945	43900	122695	35.78%	27.82%	78	78
8	金門縣	2018-11-24T22:40:21+08:00	29496	5747	35243	2559	37802	106708	35.43%	27.64%	69	78
8	金門縣	2018-11-24T23:14:44+08:00	32636	6569	39205	2797	42002	117450	35.76%	27.79%	75	78
8	金門縣	2018-11-25T03:37:33+08:00	34139	6816	40955	2945	43900	122695	35.78%	27.82%	78	78
8	金門縣	2018-11-24T22:18:23+08:00	27320	5319	32639	2342	34981	98697	35.44%	27.68%	64	78
8	金門縣	2018-11-24T23:50:18+08:00	34139	6816	40955	2945	43900	122695	35.78%	27.82%	78	78
8	金門縣	2018-11-24T23:58:46+08:00	34139	6816	40955	2945	43900	122695	35.78%	27.82%	78	78
8	金門縣	2018-11-25T00:12:48+08:00	34139	6816	40955	2945	43900	122695	35.78%	27.82%	78	78
8	金門縣	2018-11-24T23:03:50+08:00	32636	6569	39205	2797	42002	117450	35.76%	27.79%	75	78
8	金門縣	2018-11-24T22:39:12+08:00	28977	5660	34637	2505	37142	104705	35.47%	27.67%	68	78
8	金門縣	2018-11-25T06:27:58+08:00	34139	6816	40955	2945	43900	122695	35.78%	27.82%	78	78
8	金門縣	2018-11-25T06:17:40+08:00	34139	6816	40955	2945	43900	122695	35.78%	27.82%	78	78
8	金門縣	2018-11-24T22:14:52+08:00	27320	5319	32639	2342	34981	98697	35.44%	27.68%	64	78
8	金門縣	2018-11-25T01:24:28+08:00	34139	6816	40955	2945	43900	122695	35.78%	27.82%	78	78
8	金門縣	2018-11-25T03:54:45+08:00	34139	6816	40955	2945	43900	122695	35.78%	27.82%	78	78
8	金門縣	2018-11-24T23:07:22+08:00	32636	6569	39205	2797	42002	117450	35.76%	27.79%	75	78
8	金門縣	2018-11-24T23:54:30+08:00	34139	6816	40955	2945	43900	122695	35.78%	27.82%	78	78
8	金門縣	2018-11-25T06:12:40+08:00	34139	6816	40955	2945	43900	122695	35.78%	27.82%	78	78
8	金門縣	2018-11-24T23:29:50+08:00	32636	6569	39205	2797	42002	117450	35.76%	27.79%	75	78
8	金門縣	2018-11-24T23:42:05+08:00	34139	6816	40955	2945	43900	122695	35.78%	27.82%	78	78
8	金門縣	2018-11-25T01:06:03+08:00	34139	6816	40955	2945	43900	122695	35.78%	27.82%	78	78
8	金門縣	2018-11-25T01:11:11+08:00	34139	6816	40955	2945	43900	122695	35.78%	27.82%	78	78
8	金門縣	2018-11-25T00:21:47+08:00	34139	6816	40955	2945	43900	122695	35.78%	27.82%	78	78
8	金門縣	2018-11-25T03:42:52+08:00	34139	6816	40955	2945	43900	122695	35.78%	27.82%	78	78
8	金門縣	2018-11-25T06:07:26+08:00	34139	6816	40955	2945	43900	122695	35.78%	27.82%	78	78
8	金門縣	2018-11-25T00:56:17+08:00	34139	6816	40955	2945	43900	122695	35.78%	27.82%	78	78
8	金門縣	2018-11-24T22:43:54+08:00	29899	5850	35749	2589	38338	108383	35.37%	27.59%	70	78
8	金門縣	2018-11-25T03:31:03+08:00	34139	6816	40955	2945	43900	122695	35.78%	27.82%	78	78
8	金門縣	2018-11-24T22:35:47+08:00	28977	5660	34637	2505	37142	104705	35.47%	27.67%	68	78
8	金門縣	2018-11-25T01:01:05+08:00	34139	6816	40955	2945	43900	122695	35.78%	27.82%	78	78
8	金門縣	2018-11-25T01:16:26+08:00	34139	6816	40955	2945	43900	122695	35.78%	27.82%	78	78
8	金門縣	2018-11-25T00:03:39+08:00	34139	6816	40955	2945	43900	122695	35.78%	27.82%	78	78
8	臺北市中山區	2018-11-24T23:07:11+08:00	61394	21994	83388	6316	89704	158749	56.51%	38.67%	109	133
8	臺北市中山區	2018-11-25T01:05:49+08:00	75659	27107	102766	7777	110543	195148	56.65%	38.77%	133	133
8	臺北市中山區	2018-11-24T22:49:16+08:00	57320	20619	77939	5921	83860	148355	56.53%	38.64%	102	133
8	臺北市中山區	2018-11-24T22:43:42+08:00	55176	19979	75155	5736	80891	142928	56.6%	38.6%	98	133
8	臺北市中山區	2018-11-25T01:10:56+08:00	75659	27107	102766	7777	110543	195148	56.65%	38.77%	133	133
8	臺北市中山區	2018-11-24T22:39:00+08:00	54483	19791	74274	5660	79934	141341	56.55%	38.55%	97	133
8	臺北市中山區	2018-11-25T03:37:16+08:00	75659	27107	102766	7777	110543	195148	56.65%	38.77%	133	133
8	臺北市中山區	2018-11-25T01:10:57+08:00	75659	27107	102766	7777	110543	195148	56.65%	38.77%	133	133
8	臺北市中山區	2018-11-24T23:50:04+08:00	72107	25845	97952	7375	105327	185947	56.64%	38.78%	127	133
8	臺北市中山區	2018-11-25T01:24:14+08:00	75659	27107	102766	7777	110543	195148	56.65%	38.77%	133	133
8	臺北市中山區	2018-11-25T00:12:36+08:00	74376	26634	101010	7626	108636	192014	56.58%	38.73%	131	133
8	臺北市中山區	2018-11-24T22:32:10+08:00	53800	19550	73350	5605	78955	139687	56.52%	38.51%	96	133
8	臺北市中山區	2018-11-24T23:29:38+08:00	65555	23296	88851	6765	95616	169032	56.57%	38.78%	116	133
8	臺北市中山區	2018-11-25T03:48:19+08:00	75659	27107	102766	7777	110543	195148	56.65%	38.77%	133	133
8	臺北市中山區	2018-11-25T06:22:36+08:00	75659	27107	102766	7777	110543	195148	56.65%	38.77%	133	133
8	臺北市中山區	2018-11-25T06:12:29+08:00	75659	27107	102766	7777	110543	195148	56.65%	38.77%	133	133
8	臺北市中山區	2018-11-25T00:21:35+08:00	74376	26634	101010	7626	108636	192014	56.58%	38.73%	131	133
8	臺北市中山區	2018-11-24T23:00:03+08:00	57776	20745	78521	5970	84491	149353	56.57%	38.68%	103	133
8	臺北市中山區	2018-11-25T03:48:20+08:00	75659	27107	102766	7777	110543	195148	56.65%	38.77%	133	133
8	臺北市中山區	2018-11-24T23:25:59+08:00	64899	23180	88079	6709	94788	167628	56.55%	38.72%	115	133
8	臺北市中山區	2018-11-24T23:29:39+08:00	65555	23296	88851	6765	95616	169032	56.57%	38.78%	116	133
8	臺北市中山區	2018-11-24T23:00:04+08:00	57776	20745	78521	5970	84491	149353	56.57%	38.68%	103	133
8	臺北市中山區	2018-11-25T01:00:51+08:00	75659	27107	102766	7777	110543	195148	56.65%	38.77%	133	133
8	臺北市中山區	2018-11-25T06:07:14+08:00	75659	27107	102766	7777	110543	195148	56.65%	38.77%	133	133
8	臺北市中山區	2018-11-25T06:07:13+08:00	75659	27107	102766	7777	110543	195148	56.65%	38.77%	133	133
8	臺北市中山區	2018-11-24T22:53:05+08:00	57320	20619	77939	5921	83860	148355	56.53%	38.64%	102	133
8	臺北市中山區	2018-11-24T22:40:11+08:00	54483	19791	74274	5660	79934	141341	56.55%	38.55%	97	133
8	臺北市中山區	2018-11-24T22:25:16+08:00	51357	18721	70078	5379	75457	133613	56.47%	38.44%	92	133
8	臺北市中山區	2018-11-24T22:11:55+08:00	46084	16650	62734	4843	67577	120132	56.25%	38.36%	83	133
8	臺北市中山區	2018-11-25T04:01:20+08:00	75659	27107	102766	7777	110543	195148	56.65%	38.77%	133	133
8	臺北市中山區	2018-11-25T01:16:12+08:00	75659	27107	102766	7777	110543	195148	56.65%	38.77%	133	133
8	臺北市中山區	2018-11-24T23:37:41+08:00	67711	24120	91831	6913	98744	174565	56.57%	38.79%	120	133
8	臺北市中山區	2018-11-24T23:41:54+08:00	68994	24659	93653	7030	100683	177791	56.63%	38.81%	122	133
8	臺北市中山區	2018-11-24T22:28:32+08:00	51934	18911	70845	5436	76281	135049	56.48%	38.46%	93	133
8	臺北市中山區	2018-11-25T01:16:13+08:00	75659	27107	102766	7777	110543	195148	56.65%	38.77%	133	133
8	臺北市中山區	2018-11-25T03:54:31+08:00	75659	27107	102766	7777	110543	195148	56.65%	38.77%	133	133
8	臺北市中山區	2018-11-24T23:33:41+08:00	66094	23543	89637	6775	96412	170364	56.59%	38.8%	117	133
8	臺北市中山區	2018-11-24T23:54:17+08:00	72705	26082	98787	7470	106257	187534	56.66%	38.77%	128	133
8	臺北市中山區	2018-11-25T00:03:24+08:00	73900	26480	100380	7589	107969	190699	56.62%	38.75%	130	133
8	臺北市中山區	2018-11-24T22:35:36+08:00	54483	19791	74274	5660	79934	141341	56.55%	38.55%	97	133
8	臺北市中山區	2018-11-25T00:16:59+08:00	74376	26634	101010	7626	108636	192014	56.58%	38.73%	131	133
8	臺北市中山區	2018-11-24T23:58:33+08:00	73387	26243	99630	7512	107142	189119	56.65%	38.8%	129	133
8	臺北市中山區	2018-11-24T22:14:39+08:00	47259	17099	64358	4981	69339	123123	56.32%	38.38%	85	133
8	臺北市中山區	2018-11-24T22:43:41+08:00	55176	19979	75155	5736	80891	142928	56.6%	38.6%	98	133
8	臺北市中山區	2018-11-25T06:27:46+08:00	75659	27107	102766	7777	110543	195148	56.65%	38.77%	133	133
8	臺北市中山區	2018-11-24T23:03:40+08:00	60735	21794	82529	6231	88760	157096	56.5%	38.66%	108	133
8	臺北市中山區	2018-11-24T23:14:30+08:00	62490	22357	84847	6418	91265	161543	56.5%	38.68%	111	133
8	臺北市中山區	2018-11-24T23:22:14+08:00	64443	22985	87428	6651	94079	166261	56.59%	38.76%	114	133
8	臺北市中山區	2018-11-24T23:58:32+08:00	73387	26243	99630	7512	107142	189119	56.65%	38.8%	129	133
8	臺北市中山區	2018-11-25T03:37:15+08:00	75659	27107	102766	7777	110543	195148	56.65%	38.77%	133	133
8	臺北市中山區	2018-11-25T00:56:03+08:00	74947	26876	101823	7689	109512	193464	56.61%	38.74%	132	133
8	臺北市中山區	2018-11-25T00:56:04+08:00	74947	26876	101823	7689	109512	193464	56.61%	38.74%	132	133
8	臺北市中山區	2018-11-24T23:14:31+08:00	62490	22357	84847	6418	91265	161543	56.5%	38.68%	111	133
8	臺北市中山區	2018-11-25T06:27:47+08:00	75659	27107	102766	7777	110543	195148	56.65%	38.77%	133	133
8	臺北市中山區	2018-11-24T22:21:36+08:00	50342	18309	68651	5306	73957	130885	56.51%	38.46%	90	133
8	臺北市中山區	2018-11-25T00:17:00+08:00	74376	26634	101010	7626	108636	192014	56.58%	38.73%	131	133
8	臺北市中山區	2018-11-25T03:42:37+08:00	75659	27107	102766	7777	110543	195148	56.65%	38.77%	133	133
8	臺北市中山區	2018-11-25T03:30:49+08:00	75659	27107	102766	7777	110543	195148	56.65%	38.77%	133	133
8	臺北市中山區	2018-11-25T03:42:36+08:00	75659	27107	102766	7777	110543	195148	56.65%	38.77%	133	133
8	臺北市中山區	2018-11-24T22:25:15+08:00	51357	18721	70078	5379	75457	133613	56.47%	38.44%	92	133
8	臺北市中山區	2018-11-24T22:18:11+08:00	49136	17781	66917	5146	72063	127734	56.42%	38.47%	88	133
8	臺北市中山區	2018-11-24T22:28:31+08:00	51934	18911	70845	5436	76281	135049	56.48%	38.46%	93	133
8	臺北市中山區	2018-11-24T23:10:48+08:00	62490	22357	84847	6418	91265	161543	56.5%	38.68%	111	133
8	臺北市中山區	2018-11-24T22:14:40+08:00	47259	17099	64358	4981	69339	123123	56.32%	38.38%	85	133
8	臺北市中山區	2018-11-25T06:17:27+08:00	75659	27107	102766	7777	110543	195148	56.65%	38.77%	133	133
8	臺北市中山區	2018-11-24T22:56:29+08:00	57776	20745	78521	5970	84491	149353	56.57%	38.68%	103	133
8	臺北市中山區	2018-11-24T23:18:18+08:00	63087	22555	85642	6505	92147	162972	56.54%	38.71%	112	133
8	臺北市中山區	2018-11-24T23:45:56+08:00	72107	25845	97952	7375	105327	185947	56.64%	38.78%	127	133
8	臺北市中山區	2018-11-24T23:03:39+08:00	60735	21794	82529	6231	88760	157096	56.5%	38.66%	108	133
8	臺北市中山區	2018-11-25T00:07:55+08:00	73900	26480	100380	7589	107969	190699	56.62%	38.75%	130	133
8	臺北市中山區	2018-11-24T23:33:42+08:00	66094	23543	89637	6775	96412	170364	56.59%	38.8%	117	133
8	臺北市中山區	2018-11-24T23:10:49+08:00	62490	22357	84847	6418	91265	161543	56.5%	38.68%	111	133
8	臺北市中山區	2018-11-24T22:18:10+08:00	49136	17781	66917	5146	72063	127734	56.42%	38.47%	88	133
8	臺北市中山區	2018-11-24T23:18:19+08:00	63087	22555	85642	6505	92147	162972	56.54%	38.71%	112	133
8	臺中市西屯區	2018-11-25T03:37:17+08:00	78086	21557	99643	6371	106014	183814	57.67%	42.48%	120	120
8	臺中市西屯區	2018-11-24T23:10:50+08:00	65510	18210	83720	5384	89104	154166	57.8%	42.49%	102	120
8	臺中市西屯區	2018-11-25T00:56:06+08:00	78086	21557	99643	6371	106014	183814	57.67%	42.48%	120	120
8	臺中市西屯區	2018-11-24T23:22:16+08:00	68217	19012	87229	5601	92830	160675	57.78%	42.46%	106	120
8	臺中市西屯區	2018-11-25T01:10:58+08:00	78086	21557	99643	6371	106014	183814	57.67%	42.48%	120	120
8	臺中市西屯區	2018-11-24T22:49:17+08:00	58501	16298	74799	4913	79712	137896	57.81%	42.42%	92	120
8	臺中市西屯區	2018-11-24T23:14:32+08:00	66156	18398	84554	5432	89986	155881	57.73%	42.44%	103	120
8	臺中市西屯區	2018-11-24T22:43:43+08:00	56430	15654	72084	4731	76815	133086	57.72%	42.4%	89	120
8	臺中市西屯區	2018-11-25T00:03:26+08:00	77423	21417	98840	6315	105155	182257	57.7%	42.48%	119	120
8	臺中市西屯區	2018-11-24T22:56:30+08:00	60707	16918	77625	5056	82681	142983	57.83%	42.46%	95	120
8	臺中市西屯區	2018-11-25T00:12:38+08:00	78086	21557	99643	6371	106014	183814	57.67%	42.48%	120	120
8	臺中市西屯區	2018-11-25T03:48:21+08:00	78086	21557	99643	6371	106014	183814	57.67%	42.48%	120	120
8	臺中市西屯區	2018-11-25T06:22:38+08:00	78086	21557	99643	6371	106014	183814	57.67%	42.48%	120	120
8	臺中市西屯區	2018-11-25T03:30:51+08:00	78086	21557	99643	6371	106014	183814	57.67%	42.48%	120	120
8	臺中市西屯區	2018-11-24T22:25:17+08:00	49159	13755	62914	4188	67102	116076	57.81%	42.35%	78	120
8	臺中市西屯區	2018-11-25T06:07:15+08:00	78086	21557	99643	6371	106014	183814	57.67%	42.48%	120	120
8	臺中市西屯區	2018-11-24T23:29:40+08:00	70191	19495	89686	5751	95437	165047	57.82%	42.53%	109	120
8	臺中市西屯區	2018-11-24T23:54:18+08:00	76002	21037	97039	6188	103227	178710	57.76%	42.53%	117	120
8	臺中市西屯區	2018-11-25T00:07:57+08:00	78086	21557	99643	6371	106014	183814	57.67%	42.48%	120	120
8	臺中市西屯區	2018-11-25T01:16:14+08:00	78086	21557	99643	6371	106014	183814	57.67%	42.48%	120	120
8	臺中市西屯區	2018-11-24T22:18:13+08:00	44931	12553	57484	3870	61354	106090	57.83%	42.35%	72	120
8	臺中市西屯區	2018-11-24T23:41:55+08:00	73229	20323	93552	5988	99540	172374	57.75%	42.48%	113	120
8	臺中市西屯區	2018-11-24T22:28:33+08:00	51141	14142	65283	4335	69618	120959	57.56%	42.28%	81	120
8	臺中市西屯區	2018-11-24T23:58:34+08:00	76002	21037	97039	6188	103227	178710	57.76%	42.53%	117	120
8	臺中市西屯區	2018-11-24T23:50:08+08:00	75215	20835	96050	6138	102188	176934	57.75%	42.51%	116	120
8	臺中市西屯區	2018-11-25T01:24:16+08:00	78086	21557	99643	6371	106014	183814	57.67%	42.48%	120	120
8	臺中市西屯區	2018-11-24T22:35:38+08:00	53154	14734	67888	4527	72415	125627	57.64%	42.31%	84	120
8	臺中市西屯區	2018-11-24T23:07:12+08:00	64888	18044	82932	5340	88272	152664	57.82%	42.5%	101	120
8	臺中市西屯區	2018-11-24T22:39:02+08:00	54304	15069	69373	4614	73987	128155	57.73%	42.37%	86	120
8	臺中市西屯區	2018-11-25T06:27:48+08:00	78086	21557	99643	6371	106014	183814	57.67%	42.48%	120	120
8	臺中市西屯區	2018-11-24T23:03:41+08:00	64888	18044	82932	5340	88272	152664	57.82%	42.5%	101	120
8	臺中市西屯區	2018-11-25T01:00:53+08:00	78086	21557	99643	6371	106014	183814	57.67%	42.48%	120	120
8	臺中市西屯區	2018-11-25T00:21:37+08:00	78086	21557	99643	6371	106014	183814	57.67%	42.48%	120	120
8	臺中市西屯區	2018-11-24T22:21:38+08:00	46392	12928	59320	4000	63320	109423	57.87%	42.4%	74	120
8	臺中市西屯區	2018-11-25T03:42:40+08:00	78086	21557	99643	6371	106014	183814	57.67%	42.48%	120	120
8	臺中市西屯區	2018-11-24T23:00:07+08:00	63482	17720	81202	5252	86454	149511	57.82%	42.46%	99	120
8	臺中市西屯區	2018-11-24T22:32:12+08:00	52358	14505	66863	4460	71323	123774	57.62%	42.3%	83	120
8	臺中市西屯區	2018-11-25T06:12:30+08:00	78086	21557	99643	6371	106014	183814	57.67%	42.48%	120	120
8	臺中市西屯區	2018-11-25T04:01:22+08:00	78086	21557	99643	6371	106014	183814	57.67%	42.48%	120	120
8	臺中市西屯區	2018-11-25T00:17:01+08:00	78086	21557	99643	6371	106014	183814	57.67%	42.48%	120	120
8	臺中市西屯區	2018-11-24T22:40:13+08:00	55129	15256	70385	4649	75034	130090	57.68%	42.38%	87	120
8	臺中市西屯區	2018-11-24T22:53:07+08:00	59195	16531	75726	4969	80695	139570	57.82%	42.41%	93	120
8	臺中市西屯區	2018-11-24T22:11:56+08:00	42492	11907	54399	3686	58085	100675	57.7%	42.21%	69	120
8	臺中市西屯區	2018-11-25T03:54:33+08:00	78086	21557	99643	6371	106014	183814	57.67%	42.48%	120	120
8	臺中市西屯區	2018-11-25T01:05:51+08:00	78086	21557	99643	6371	106014	183814	57.67%	42.48%	120	120
8	臺中市西屯區	2018-11-24T23:26:01+08:00	68944	19223	88167	5662	93829	162341	57.8%	42.47%	107	120
8	臺中市西屯區	2018-11-24T23:33:43+08:00	71782	19908	91690	5880	97570	168831	57.79%	42.52%	111	120
8	臺中市西屯區	2018-11-24T23:18:20+08:00	66901	18593	85494	5476	90970	157576	57.73%	42.46%	104	120
8	臺中市西屯區	2018-11-25T06:17:29+08:00	78086	21557	99643	6371	106014	183814	57.67%	42.48%	120	120
8	臺中市西屯區	2018-11-24T23:37:42+08:00	73229	20323	93552	5988	99540	172374	57.75%	42.48%	113	120
8	臺中市西屯區	2018-11-24T22:14:41+08:00	43468	12158	55626	3759	59385	102837	57.75%	42.27%	70	120
8	臺中市西屯區	2018-11-24T23:45:57+08:00	74507	20715	95222	6111	101333	175550	57.72%	42.44%	115	120
8	臺中市神岡區	2018-11-24T23:10:50+08:00	21398	6476	27874	2381	30255	51667	58.56%	41.42%	40	42
8	臺中市神岡區	2018-11-25T00:56:06+08:00	22607	6854	29461	2490	31951	54565	58.56%	41.43%	42	42
8	臺中市神岡區	2018-11-24T23:14:33+08:00	21398	6476	27874	2381	30255	51667	58.56%	41.42%	40	42
8	臺中市神岡區	2018-11-24T23:22:16+08:00	22607	6854	29461	2490	31951	54565	58.56%	41.43%	42	42
8	臺中市神岡區	2018-11-25T00:12:39+08:00	22607	6854	29461	2490	31951	54565	58.56%	41.43%	42	42
8	臺中市神岡區	2018-11-24T22:49:17+08:00	20760	6290	27050	2304	29354	50077	58.62%	41.46%	39	42
8	臺中市神岡區	2018-11-25T03:37:18+08:00	22607	6854	29461	2490	31951	54565	58.56%	41.43%	42	42
8	臺中市神岡區	2018-11-24T22:43:44+08:00	20296	6120	26416	2231	28647	48789	58.72%	41.6%	38	42
8	臺中市神岡區	2018-11-25T00:03:26+08:00	22607	6854	29461	2490	31951	54565	58.56%	41.43%	42	42
8	臺中市神岡區	2018-11-25T01:10:59+08:00	22607	6854	29461	2490	31951	54565	58.56%	41.43%	42	42
8	臺中市神岡區	2018-11-24T22:56:30+08:00	20760	6290	27050	2304	29354	50077	58.62%	41.46%	39	42
8	臺中市神岡區	2018-11-25T06:22:39+08:00	22607	6854	29461	2490	31951	54565	58.56%	41.43%	42	42
8	臺中市神岡區	2018-11-25T03:30:51+08:00	22607	6854	29461	2490	31951	54565	58.56%	41.43%	42	42
8	臺中市神岡區	2018-11-24T22:25:17+08:00	18656	5613	24269	2073	26342	44476	59.23%	41.95%	35	42
8	臺中市神岡區	2018-11-24T23:29:40+08:00	22607	6854	29461	2490	31951	54565	58.56%	41.43%	42	42
8	臺中市神岡區	2018-11-25T01:16:15+08:00	22607	6854	29461	2490	31951	54565	58.56%	41.43%	42	42
8	臺中市神岡區	2018-11-24T23:54:18+08:00	22607	6854	29461	2490	31951	54565	58.56%	41.43%	42	42
8	臺中市神岡區	2018-11-25T00:07:57+08:00	22607	6854	29461	2490	31951	54565	58.56%	41.43%	42	42
8	臺中市神岡區	2018-11-24T22:14:42+08:00	16977	5098	22075	1872	23947	40579	59.01%	41.84%	32	42
8	臺中市神岡區	2018-11-24T22:18:13+08:00	16977	5098	22075	1872	23947	40579	59.01%	41.84%	32	42
8	臺中市神岡區	2018-11-24T22:28:33+08:00	19167	5788	24955	2104	27059	45820	59.05%	41.83%	36	42
8	臺中市神岡區	2018-11-24T23:50:08+08:00	22607	6854	29461	2490	31951	54565	58.56%	41.43%	42	42
8	臺中市神岡區	2018-11-24T23:07:12+08:00	21398	6476	27874	2381	30255	51667	58.56%	41.42%	40	42
8	臺中市神岡區	2018-11-24T22:39:02+08:00	19672	5962	25634	2152	27786	47222	58.84%	41.66%	37	42
8	臺中市神岡區	2018-11-25T01:24:17+08:00	22607	6854	29461	2490	31951	54565	58.56%	41.43%	42	42
8	臺中市神岡區	2018-11-24T22:35:39+08:00	19672	5962	25634	2152	27786	47222	58.84%	41.66%	37	42
8	臺中市神岡區	2018-11-24T23:58:35+08:00	22607	6854	29461	2490	31951	54565	58.56%	41.43%	42	42
8	臺中市神岡區	2018-11-25T06:27:49+08:00	22607	6854	29461	2490	31951	54565	58.56%	41.43%	42	42
8	臺中市神岡區	2018-11-24T23:03:41+08:00	20760	6290	27050	2304	29354	50077	58.62%	41.46%	39	42
8	臺中市神岡區	2018-11-25T01:00:53+08:00	22607	6854	29461	2490	31951	54565	58.56%	41.43%	42	42
8	臺中市神岡區	2018-11-24T23:00:08+08:00	20760	6290	27050	2304	29354	50077	58.62%	41.46%	39	42
8	臺中市神岡區	2018-11-25T03:48:22+08:00	22607	6854	29461	2490	31951	54565	58.56%	41.43%	42	42
8	臺中市神岡區	2018-11-25T00:21:37+08:00	22607	6854	29461	2490	31951	54565	58.56%	41.43%	42	42
8	臺中市神岡區	2018-11-25T03:42:40+08:00	22607	6854	29461	2490	31951	54565	58.56%	41.43%	42	42
8	臺中市神岡區	2018-11-24T22:21:39+08:00	17561	5285	22846	1954	24800	41889	59.2%	41.92%	33	42
8	臺中市神岡區	2018-11-24T22:32:12+08:00	19672	5962	25634	2152	27786	47222	58.84%	41.66%	37	42
8	臺中市神岡區	2018-11-25T04:01:22+08:00	22607	6854	29461	2490	31951	54565	58.56%	41.43%	42	42
8	臺中市神岡區	2018-11-24T22:11:57+08:00	16977	5098	22075	1872	23947	40579	59.01%	41.84%	32	42
8	臺中市神岡區	2018-11-25T00:17:01+08:00	22607	6854	29461	2490	31951	54565	58.56%	41.43%	42	42
8	臺中市神岡區	2018-11-24T22:40:13+08:00	19672	5962	25634	2152	27786	47222	58.84%	41.66%	37	42
8	臺中市神岡區	2018-11-24T22:53:07+08:00	20760	6290	27050	2304	29354	50077	58.62%	41.46%	39	42
8	臺中市神岡區	2018-11-25T06:12:31+08:00	22607	6854	29461	2490	31951	54565	58.56%	41.43%	42	42
8	臺中市神岡區	2018-11-25T06:07:16+08:00	22607	6854	29461	2490	31951	54565	58.56%	41.43%	42	42
8	臺中市神岡區	2018-11-24T23:33:44+08:00	22607	6854	29461	2490	31951	54565	58.56%	41.43%	42	42
8	臺中市神岡區	2018-11-25T03:54:33+08:00	22607	6854	29461	2490	31951	54565	58.56%	41.43%	42	42
8	臺中市神岡區	2018-11-25T01:05:51+08:00	22607	6854	29461	2490	31951	54565	58.56%	41.43%	42	42
8	臺中市神岡區	2018-11-24T23:26:01+08:00	22607	6854	29461	2490	31951	54565	58.56%	41.43%	42	42
8	臺中市神岡區	2018-11-25T06:17:29+08:00	22607	6854	29461	2490	31951	54565	58.56%	41.43%	42	42
8	臺中市神岡區	2018-11-24T23:41:56+08:00	22607	6854	29461	2490	31951	54565	58.56%	41.43%	42	42
8	臺中市神岡區	2018-11-24T23:37:43+08:00	22607	6854	29461	2490	31951	54565	58.56%	41.43%	42	42
8	臺中市神岡區	2018-11-24T23:18:21+08:00	22072	6684	28756	2439	31195	53150	58.69%	41.53%	41	42
8	臺中市神岡區	2018-11-24T23:45:57+08:00	22607	6854	29461	2490	31951	54565	58.56%	41.43%	42	42
8	臺南市歸仁區	2018-11-25T00:56:08+08:00	20119	7113	27232	2388	29620	57387	51.61%	35.06%	46	46
8	臺南市歸仁區	2018-11-24T23:14:34+08:00	20119	7113	27232	2388	29620	57387	51.61%	35.06%	46	46
8	臺南市歸仁區	2018-11-24T23:03:43+08:00	20119	7113	27232	2388	29620	57387	51.61%	35.06%	46	46
8	臺南市歸仁區	2018-11-25T06:17:31+08:00	20119	7113	27232	2388	29620	57387	51.61%	35.06%	46	46
8	臺南市歸仁區	2018-11-24T23:22:18+08:00	20119	7113	27232	2388	29620	57387	51.61%	35.06%	46	46
8	臺南市歸仁區	2018-11-24T22:43:45+08:00	20119	7113	27232	2388	29620	57387	51.61%	35.06%	46	46
8	臺南市歸仁區	2018-11-24T23:10:51+08:00	20119	7113	27232	2388	29620	57387	51.61%	35.06%	46	46
8	臺南市歸仁區	2018-11-25T03:37:20+08:00	20119	7113	27232	2388	29620	57387	51.61%	35.06%	46	46
8	臺南市歸仁區	2018-11-24T22:49:19+08:00	20119	7113	27232	2388	29620	57387	51.61%	35.06%	46	46
8	臺南市歸仁區	2018-11-25T00:03:28+08:00	20119	7113	27232	2388	29620	57387	51.61%	35.06%	46	46
8	臺南市歸仁區	2018-11-24T23:58:36+08:00	20119	7113	27232	2388	29620	57387	51.61%	35.06%	46	46
8	臺南市歸仁區	2018-11-25T03:42:42+08:00	20119	7113	27232	2388	29620	57387	51.61%	35.06%	46	46
8	臺南市歸仁區	2018-11-24T22:25:19+08:00	19206	6791	25997	2313	28310	54646	51.81%	35.15%	44	46
8	臺南市歸仁區	2018-11-25T06:22:40+08:00	20119	7113	27232	2388	29620	57387	51.61%	35.06%	46	46
8	臺南市歸仁區	2018-11-25T00:17:03+08:00	20119	7113	27232	2388	29620	57387	51.61%	35.06%	46	46
8	臺南市歸仁區	2018-11-25T01:11:01+08:00	20119	7113	27232	2388	29620	57387	51.61%	35.06%	46	46
8	臺南市歸仁區	2018-11-24T23:29:41+08:00	20119	7113	27232	2388	29620	57387	51.61%	35.06%	46	46
8	臺南市歸仁區	2018-11-25T06:12:32+08:00	20119	7113	27232	2388	29620	57387	51.61%	35.06%	46	46
8	臺南市歸仁區	2018-11-24T23:50:10+08:00	20119	7113	27232	2388	29620	57387	51.61%	35.06%	46	46
8	臺南市歸仁區	2018-11-25T00:12:40+08:00	20119	7113	27232	2388	29620	57387	51.61%	35.06%	46	46
8	臺南市歸仁區	2018-11-24T22:28:35+08:00	19206	6791	25997	2313	28310	54646	51.81%	35.15%	44	46
8	臺南市歸仁區	2018-11-24T22:14:43+08:00	18221	6439	24660	2184	26844	52004	51.62%	35.04%	42	46
8	臺南市歸仁區	2018-11-24T23:26:02+08:00	20119	7113	27232	2388	29620	57387	51.61%	35.06%	46	46
8	臺南市歸仁區	2018-11-24T23:54:20+08:00	20119	7113	27232	2388	29620	57387	51.61%	35.06%	46	46
8	臺南市歸仁區	2018-11-25T06:27:50+08:00	20119	7113	27232	2388	29620	57387	51.61%	35.06%	46	46
8	臺南市歸仁區	2018-11-25T00:07:59+08:00	20119	7113	27232	2388	29620	57387	51.61%	35.06%	46	46
8	臺南市歸仁區	2018-11-24T23:18:22+08:00	20119	7113	27232	2388	29620	57387	51.61%	35.06%	46	46
8	臺南市歸仁區	2018-11-25T01:05:53+08:00	20119	7113	27232	2388	29620	57387	51.61%	35.06%	46	46
8	臺南市歸仁區	2018-11-24T22:18:14+08:00	18606	6595	25201	2257	27458	53132	51.68%	35.02%	43	46
8	臺南市歸仁區	2018-11-24T22:56:32+08:00	20119	7113	27232	2388	29620	57387	51.61%	35.06%	46	46
8	臺南市歸仁區	2018-11-25T01:24:19+08:00	20119	7113	27232	2388	29620	57387	51.61%	35.06%	46	46
8	臺南市歸仁區	2018-11-24T22:39:04+08:00	20119	7113	27232	2388	29620	57387	51.61%	35.06%	46	46
8	臺南市歸仁區	2018-11-24T23:07:14+08:00	20119	7113	27232	2388	29620	57387	51.61%	35.06%	46	46
8	臺南市歸仁區	2018-11-25T00:21:39+08:00	20119	7113	27232	2388	29620	57387	51.61%	35.06%	46	46
8	臺南市歸仁區	2018-11-24T22:32:13+08:00	19206	6791	25997	2313	28310	54646	51.81%	35.15%	44	46
8	臺南市歸仁區	2018-11-25T03:30:53+08:00	20119	7113	27232	2388	29620	57387	51.61%	35.06%	46	46
8	臺南市歸仁區	2018-11-25T03:48:24+08:00	20119	7113	27232	2388	29620	57387	51.61%	35.06%	46	46
8	臺南市歸仁區	2018-11-25T01:00:55+08:00	20119	7113	27232	2388	29620	57387	51.61%	35.06%	46	46
8	臺南市歸仁區	2018-11-24T23:00:13+08:00	20119	7113	27232	2388	29620	57387	51.61%	35.06%	46	46
8	臺南市歸仁區	2018-11-25T06:07:17+08:00	20119	7113	27232	2388	29620	57387	51.61%	35.06%	46	46
8	臺南市歸仁區	2018-11-24T22:53:09+08:00	20119	7113	27232	2388	29620	57387	51.61%	35.06%	46	46
8	臺南市歸仁區	2018-11-24T22:40:14+08:00	20119	7113	27232	2388	29620	57387	51.61%	35.06%	46	46
8	臺南市歸仁區	2018-11-24T22:11:58+08:00	18221	6439	24660	2184	26844	52004	51.62%	35.04%	42	46
8	臺南市歸仁區	2018-11-25T04:01:23+08:00	20119	7113	27232	2388	29620	57387	51.61%	35.06%	46	46
8	臺南市歸仁區	2018-11-24T22:21:40+08:00	19206	6791	25997	2313	28310	54646	51.81%	35.15%	44	46
8	臺南市歸仁區	2018-11-24T23:41:57+08:00	20119	7113	27232	2388	29620	57387	51.61%	35.06%	46	46
8	臺南市歸仁區	2018-11-25T01:16:16+08:00	20119	7113	27232	2388	29620	57387	51.61%	35.06%	46	46
8	臺南市歸仁區	2018-11-24T22:35:40+08:00	19206	6791	25997	2313	28310	54646	51.81%	35.15%	44	46
8	臺南市歸仁區	2018-11-25T03:54:35+08:00	20119	7113	27232	2388	29620	57387	51.61%	35.06%	46	46
8	臺南市歸仁區	2018-11-24T23:33:45+08:00	20119	7113	27232	2388	29620	57387	51.61%	35.06%	46	46
8	臺南市歸仁區	2018-11-24T23:37:44+08:00	20119	7113	27232	2388	29620	57387	51.61%	35.06%	46	46
8	臺南市歸仁區	2018-11-24T23:45:59+08:00	20119	7113	27232	2388	29620	57387	51.61%	35.06%	46	46
8	南投縣魚池鄉	2018-11-25T03:37:28+08:00	5418	1488	6906	657	7563	13958	54.18%	38.82%	25	25
8	南投縣魚池鄉	2018-11-25T01:24:23+08:00	5418	1488	6906	657	7563	13958	54.18%	38.82%	25	25
8	南投縣魚池鄉	2018-11-24T22:39:07+08:00	5036	1379	6415	616	7031	13036	53.94%	38.63%	24	25
8	南投縣魚池鄉	2018-11-24T23:07:17+08:00	5418	1488	6906	657	7563	13958	54.18%	38.82%	25	25
8	南投縣魚池鄉	2018-11-24T22:12:01+08:00	4231	1167	5398	524	5922	11070	53.5%	38.22%	22	25
8	南投縣魚池鄉	2018-11-24T22:32:17+08:00	5036	1379	6415	616	7031	13036	53.94%	38.63%	24	25
8	南投縣魚池鄉	2018-11-25T03:30:57+08:00	5418	1488	6906	657	7563	13958	54.18%	38.82%	25	25
8	南投縣魚池鄉	2018-11-25T03:48:28+08:00	5418	1488	6906	657	7563	13958	54.18%	38.82%	25	25
8	南投縣魚池鄉	2018-11-24T23:42:01+08:00	5418	1488	6906	657	7563	13958	54.18%	38.82%	25	25
8	南投縣魚池鄉	2018-11-25T04:01:28+08:00	5418	1488	6906	657	7563	13958	54.18%	38.82%	25	25
8	南投縣魚池鄉	2018-11-25T00:21:43+08:00	5418	1488	6906	657	7563	13958	54.18%	38.82%	25	25
8	南投縣魚池鄉	2018-11-24T22:21:44+08:00	4571	1255	5826	562	6388	11938	53.51%	38.29%	23	25
8	南投縣魚池鄉	2018-11-24T23:00:16+08:00	5418	1488	6906	657	7563	13958	54.18%	38.82%	25	25
8	南投縣魚池鄉	2018-11-24T22:40:17+08:00	5036	1379	6415	616	7031	13036	53.94%	38.63%	24	25
8	南投縣魚池鄉	2018-11-25T06:12:35+08:00	5418	1488	6906	657	7563	13958	54.18%	38.82%	25	25
8	南投縣魚池鄉	2018-11-25T03:54:39+08:00	5418	1488	6906	657	7563	13958	54.18%	38.82%	25	25
8	南投縣魚池鄉	2018-11-25T01:01:00+08:00	5418	1488	6906	657	7563	13958	54.18%	38.82%	25	25
8	南投縣魚池鄉	2018-11-24T23:33:49+08:00	5418	1488	6906	657	7563	13958	54.18%	38.82%	25	25
8	南投縣魚池鄉	2018-11-25T00:03:33+08:00	5418	1488	6906	657	7563	13958	54.18%	38.82%	25	25
8	南投縣魚池鄉	2018-11-24T23:37:47+08:00	5418	1488	6906	657	7563	13958	54.18%	38.82%	25	25
8	南投縣魚池鄉	2018-11-24T22:35:43+08:00	5036	1379	6415	616	7031	13036	53.94%	38.63%	24	25
8	南投縣魚池鄉	2018-11-24T23:54:26+08:00	5418	1488	6906	657	7563	13958	54.18%	38.82%	25	25
8	南投縣魚池鄉	2018-11-24T23:58:41+08:00	5418	1488	6906	657	7563	13958	54.18%	38.82%	25	25
8	南投縣魚池鄉	2018-11-25T00:56:12+08:00	5418	1488	6906	657	7563	13958	54.18%	38.82%	25	25
8	南投縣魚池鄉	2018-11-24T22:56:35+08:00	5418	1488	6906	657	7563	13958	54.18%	38.82%	25	25
8	南投縣魚池鄉	2018-11-24T22:49:23+08:00	5418	1488	6906	657	7563	13958	54.18%	38.82%	25	25
8	南投縣魚池鄉	2018-11-24T23:14:39+08:00	5418	1488	6906	657	7563	13958	54.18%	38.82%	25	25
8	南投縣魚池鄉	2018-11-24T23:22:22+08:00	5418	1488	6906	657	7563	13958	54.18%	38.82%	25	25
8	南投縣魚池鄉	2018-11-25T06:17:34+08:00	5418	1488	6906	657	7563	13958	54.18%	38.82%	25	25
8	南投縣魚池鄉	2018-11-24T22:43:49+08:00	5036	1379	6415	616	7031	13036	53.94%	38.63%	24	25
8	南投縣魚池鄉	2018-11-24T23:03:46+08:00	5418	1488	6906	657	7563	13958	54.18%	38.82%	25	25
8	南投縣魚池鄉	2018-11-24T23:10:55+08:00	5418	1488	6906	657	7563	13958	54.18%	38.82%	25	25
8	南投縣魚池鄉	2018-11-25T00:08:03+08:00	5418	1488	6906	657	7563	13958	54.18%	38.82%	25	25
8	南投縣魚池鄉	2018-11-25T03:42:47+08:00	5418	1488	6906	657	7563	13958	54.18%	38.82%	25	25
8	南投縣魚池鄉	2018-11-24T22:53:13+08:00	5418	1488	6906	657	7563	13958	54.18%	38.82%	25	25
8	南投縣魚池鄉	2018-11-24T23:46:02+08:00	5418	1488	6906	657	7563	13958	54.18%	38.82%	25	25
8	南投縣魚池鄉	2018-11-25T01:11:05+08:00	5418	1488	6906	657	7563	13958	54.18%	38.82%	25	25
8	南投縣魚池鄉	2018-11-24T23:29:45+08:00	5418	1488	6906	657	7563	13958	54.18%	38.82%	25	25
8	南投縣魚池鄉	2018-11-25T06:07:21+08:00	5418	1488	6906	657	7563	13958	54.18%	38.82%	25	25
8	南投縣魚池鄉	2018-11-25T06:22:43+08:00	5418	1488	6906	657	7563	13958	54.18%	38.82%	25	25
8	南投縣魚池鄉	2018-11-25T00:17:06+08:00	5418	1488	6906	657	7563	13958	54.18%	38.82%	25	25
8	南投縣魚池鄉	2018-11-24T22:25:23+08:00	5036	1379	6415	616	7031	13036	53.94%	38.63%	24	25
8	南投縣魚池鄉	2018-11-25T01:05:58+08:00	5418	1488	6906	657	7563	13958	54.18%	38.82%	25	25
8	南投縣魚池鄉	2018-11-25T00:12:44+08:00	5418	1488	6906	657	7563	13958	54.18%	38.82%	25	25
8	南投縣魚池鄉	2018-11-24T23:26:06+08:00	5418	1488	6906	657	7563	13958	54.18%	38.82%	25	25
8	南投縣魚池鄉	2018-11-24T22:14:47+08:00	4571	1255	5826	562	6388	11938	53.51%	38.29%	23	25
8	南投縣魚池鄉	2018-11-24T22:18:18+08:00	4571	1255	5826	562	6388	11938	53.51%	38.29%	23	25
8	南投縣魚池鄉	2018-11-25T06:27:54+08:00	5418	1488	6906	657	7563	13958	54.18%	38.82%	25	25
8	南投縣魚池鄉	2018-11-24T23:50:13+08:00	5418	1488	6906	657	7563	13958	54.18%	38.82%	25	25
8	南投縣魚池鄉	2018-11-25T01:16:20+08:00	5418	1488	6906	657	7563	13958	54.18%	38.82%	25	25
8	南投縣魚池鄉	2018-11-24T22:28:39+08:00	5036	1379	6415	616	7031	13036	53.94%	38.63%	24	25
8	南投縣魚池鄉	2018-11-24T23:18:26+08:00	5418	1488	6906	657	7563	13958	54.18%	38.82%	25	25
8	雲林縣臺西鄉	2018-11-24T22:39:08+08:00	6272	1982	8254	1231	9485	21125	44.9%	29.69%	22	22
8	雲林縣臺西鄉	2018-11-25T03:37:28+08:00	6272	1982	8254	1231	9485	21125	44.9%	29.69%	22	22
8	雲林縣臺西鄉	2018-11-24T23:07:18+08:00	6272	1982	8254	1231	9485	21125	44.9%	29.69%	22	22
8	雲林縣臺西鄉	2018-11-24T22:56:36+08:00	6272	1982	8254	1231	9485	21125	44.9%	29.69%	22	22
8	雲林縣臺西鄉	2018-11-25T01:24:24+08:00	6272	1982	8254	1231	9485	21125	44.9%	29.69%	22	22
8	雲林縣臺西鄉	2018-11-25T03:54:40+08:00	6272	1982	8254	1231	9485	21125	44.9%	29.69%	22	22
8	雲林縣臺西鄉	2018-11-24T22:32:18+08:00	6272	1982	8254	1231	9485	21125	44.9%	29.69%	22	22
8	雲林縣臺西鄉	2018-11-25T03:30:58+08:00	6272	1982	8254	1231	9485	21125	44.9%	29.69%	22	22
8	雲林縣臺西鄉	2018-11-24T23:42:01+08:00	6272	1982	8254	1231	9485	21125	44.9%	29.69%	22	22
8	雲林縣臺西鄉	2018-11-25T03:48:29+08:00	6272	1982	8254	1231	9485	21125	44.9%	29.69%	22	22
8	雲林縣臺西鄉	2018-11-24T22:21:45+08:00	6272	1982	8254	1231	9485	21125	44.9%	29.69%	22	22
8	雲林縣臺西鄉	2018-11-25T06:07:22+08:00	6272	1982	8254	1231	9485	21125	44.9%	29.69%	22	22
8	雲林縣臺西鄉	2018-11-25T00:21:43+08:00	6272	1982	8254	1231	9485	21125	44.9%	29.69%	22	22
8	雲林縣臺西鄉	2018-11-24T23:29:46+08:00	6272	1982	8254	1231	9485	21125	44.9%	29.69%	22	22
8	雲林縣臺西鄉	2018-11-25T01:11:06+08:00	6272	1982	8254	1231	9485	21125	44.9%	29.69%	22	22
8	雲林縣臺西鄉	2018-11-24T22:40:18+08:00	6272	1982	8254	1231	9485	21125	44.9%	29.69%	22	22
8	雲林縣臺西鄉	2018-11-25T04:01:29+08:00	6272	1982	8254	1231	9485	21125	44.9%	29.69%	22	22
8	雲林縣臺西鄉	2018-11-24T23:00:16+08:00	6272	1982	8254	1231	9485	21125	44.9%	29.69%	22	22
8	雲林縣臺西鄉	2018-11-24T23:37:48+08:00	6272	1982	8254	1231	9485	21125	44.9%	29.69%	22	22
8	雲林縣臺西鄉	2018-11-25T00:56:13+08:00	6272	1982	8254	1231	9485	21125	44.9%	29.69%	22	22
8	雲林縣臺西鄉	2018-11-24T23:33:49+08:00	6272	1982	8254	1231	9485	21125	44.9%	29.69%	22	22
8	雲林縣臺西鄉	2018-11-25T00:03:34+08:00	6272	1982	8254	1231	9485	21125	44.9%	29.69%	22	22
8	雲林縣臺西鄉	2018-11-24T22:35:44+08:00	6272	1982	8254	1231	9485	21125	44.9%	29.69%	22	22
8	雲林縣臺西鄉	2018-11-24T23:54:26+08:00	6272	1982	8254	1231	9485	21125	44.9%	29.69%	22	22
8	雲林縣臺西鄉	2018-11-25T01:01:01+08:00	6272	1982	8254	1231	9485	21125	44.9%	29.69%	22	22
8	雲林縣臺西鄉	2018-11-25T06:17:35+08:00	6272	1982	8254	1231	9485	21125	44.9%	29.69%	22	22
8	雲林縣臺西鄉	2018-11-24T22:49:23+08:00	6272	1982	8254	1231	9485	21125	44.9%	29.69%	22	22
8	雲林縣臺西鄉	2018-11-24T23:22:22+08:00	6272	1982	8254	1231	9485	21125	44.9%	29.69%	22	22
8	雲林縣臺西鄉	2018-11-24T22:43:49+08:00	6272	1982	8254	1231	9485	21125	44.9%	29.69%	22	22
8	雲林縣臺西鄉	2018-11-24T23:03:46+08:00	6272	1982	8254	1231	9485	21125	44.9%	29.69%	22	22
8	雲林縣臺西鄉	2018-11-24T23:10:55+08:00	6272	1982	8254	1231	9485	21125	44.9%	29.69%	22	22
8	雲林縣臺西鄉	2018-11-24T22:12:02+08:00	6272	1982	8254	1231	9485	21125	44.9%	29.69%	22	22
8	雲林縣臺西鄉	2018-11-25T00:08:04+08:00	6272	1982	8254	1231	9485	21125	44.9%	29.69%	22	22
8	雲林縣臺西鄉	2018-11-25T03:42:47+08:00	6272	1982	8254	1231	9485	21125	44.9%	29.69%	22	22
8	雲林縣臺西鄉	2018-11-24T22:53:14+08:00	6272	1982	8254	1231	9485	21125	44.9%	29.69%	22	22
8	雲林縣臺西鄉	2018-11-24T23:46:03+08:00	6272	1982	8254	1231	9485	21125	44.9%	29.69%	22	22
8	雲林縣臺西鄉	2018-11-25T00:17:07+08:00	6272	1982	8254	1231	9485	21125	44.9%	29.69%	22	22
8	雲林縣臺西鄉	2018-11-24T22:25:25+08:00	6272	1982	8254	1231	9485	21125	44.9%	29.69%	22	22
8	雲林縣臺西鄉	2018-11-25T06:22:44+08:00	6272	1982	8254	1231	9485	21125	44.9%	29.69%	22	22
8	雲林縣臺西鄉	2018-11-25T06:12:36+08:00	6272	1982	8254	1231	9485	21125	44.9%	29.69%	22	22
8	雲林縣臺西鄉	2018-11-25T01:05:58+08:00	6272	1982	8254	1231	9485	21125	44.9%	29.69%	22	22
8	雲林縣臺西鄉	2018-11-25T00:12:44+08:00	6272	1982	8254	1231	9485	21125	44.9%	29.69%	22	22
8	雲林縣臺西鄉	2018-11-24T23:26:06+08:00	6272	1982	8254	1231	9485	21125	44.9%	29.69%	22	22
8	雲林縣臺西鄉	2018-11-25T06:27:54+08:00	6272	1982	8254	1231	9485	21125	44.9%	29.69%	22	22
8	雲林縣臺西鄉	2018-11-24T23:18:27+08:00	6272	1982	8254	1231	9485	21125	44.9%	29.69%	22	22
8	雲林縣臺西鄉	2018-11-24T23:50:14+08:00	6272	1982	8254	1231	9485	21125	44.9%	29.69%	22	22
8	雲林縣臺西鄉	2018-11-24T23:14:40+08:00	6272	1982	8254	1231	9485	21125	44.9%	29.69%	22	22
8	雲林縣臺西鄉	2018-11-24T22:18:19+08:00	6272	1982	8254	1231	9485	21125	44.9%	29.69%	22	22
8	雲林縣臺西鄉	2018-11-24T23:58:42+08:00	6272	1982	8254	1231	9485	21125	44.9%	29.69%	22	22
8	雲林縣臺西鄉	2018-11-24T22:28:39+08:00	6272	1982	8254	1231	9485	21125	44.9%	29.69%	22	22
8	雲林縣臺西鄉	2018-11-24T22:14:48+08:00	6272	1982	8254	1231	9485	21125	44.9%	29.69%	22	22
8	雲林縣臺西鄉	2018-11-25T01:16:21+08:00	6272	1982	8254	1231	9485	21125	44.9%	29.69%	22	22
8	雲林縣北港鎮	2018-11-24T22:39:08+08:00	9033	3030	12063	1666	13729	25581	53.67%	35.31%	34	41
8	雲林縣北港鎮	2018-11-25T03:37:28+08:00	12097	4026	16123	2146	18269	33958	53.8%	35.62%	41	41
8	雲林縣北港鎮	2018-11-25T01:24:23+08:00	12097	4026	16123	2146	18269	33958	53.8%	35.62%	41	41
8	雲林縣北港鎮	2018-11-24T23:07:17+08:00	10633	3555	14188	1938	16126	30032	53.7%	35.41%	38	41
8	雲林縣北港鎮	2018-11-24T22:12:01+08:00	6550	2123	8673	1179	9852	18420	53.49%	35.56%	26	41
8	雲林縣北港鎮	2018-11-24T22:32:17+08:00	8087	2675	10762	1466	12228	22654	53.98%	35.7%	31	41
8	雲林縣北港鎮	2018-11-25T03:48:28+08:00	12097	4026	16123	2146	18269	33958	53.8%	35.62%	41	41
8	雲林縣北港鎮	2018-11-25T03:30:58+08:00	12097	4026	16123	2146	18269	33958	53.8%	35.62%	41	41
8	雲林縣北港鎮	2018-11-24T23:42:01+08:00	12097	4026	16123	2146	18269	33958	53.8%	35.62%	41	41
8	雲林縣北港鎮	2018-11-24T22:21:45+08:00	7456	2428	9884	1367	11251	20850	53.96%	35.76%	29	41
8	雲林縣北港鎮	2018-11-25T06:07:22+08:00	12097	4026	16123	2146	18269	33958	53.8%	35.62%	41	41
8	雲林縣北港鎮	2018-11-25T04:01:28+08:00	12097	4026	16123	2146	18269	33958	53.8%	35.62%	41	41
8	雲林縣北港鎮	2018-11-25T00:21:43+08:00	12097	4026	16123	2146	18269	33958	53.8%	35.62%	41	41
8	雲林縣北港鎮	2018-11-25T01:11:06+08:00	12097	4026	16123	2146	18269	33958	53.8%	35.62%	41	41
8	雲林縣北港鎮	2018-11-24T22:40:18+08:00	9807	3268	13075	1837	14912	27849	53.55%	35.21%	36	41
8	雲林縣北港鎮	2018-11-24T23:00:16+08:00	10633	3555	14188	1938	16126	30032	53.7%	35.41%	38	41
8	雲林縣北港鎮	2018-11-24T23:37:48+08:00	12097	4026	16123	2146	18269	33958	53.8%	35.62%	41	41
8	雲林縣北港鎮	2018-11-25T03:54:39+08:00	12097	4026	16123	2146	18269	33958	53.8%	35.62%	41	41
8	雲林縣北港鎮	2018-11-25T01:01:00+08:00	12097	4026	16123	2146	18269	33958	53.8%	35.62%	41	41
8	雲林縣北港鎮	2018-11-24T23:33:49+08:00	12097	4026	16123	2146	18269	33958	53.8%	35.62%	41	41
8	雲林縣北港鎮	2018-11-25T00:03:33+08:00	12097	4026	16123	2146	18269	33958	53.8%	35.62%	41	41
8	雲林縣北港鎮	2018-11-24T22:35:44+08:00	8659	2868	11527	1616	13143	24451	53.75%	35.41%	33	41
8	雲林縣北港鎮	2018-11-24T23:54:26+08:00	12097	4026	16123	2146	18269	33958	53.8%	35.62%	41	41
8	雲林縣北港鎮	2018-11-24T23:58:41+08:00	12097	4026	16123	2146	18269	33958	53.8%	35.62%	41	41
8	雲林縣北港鎮	2018-11-25T00:56:12+08:00	12097	4026	16123	2146	18269	33958	53.8%	35.62%	41	41
8	雲林縣北港鎮	2018-11-24T22:56:35+08:00	10633	3555	14188	1938	16126	30032	53.7%	35.41%	38	41
8	雲林縣北港鎮	2018-11-25T06:17:35+08:00	12097	4026	16123	2146	18269	33958	53.8%	35.62%	41	41
8	雲林縣北港鎮	2018-11-24T22:49:23+08:00	10633	3555	14188	1938	16126	30032	53.7%	35.41%	38	41
8	雲林縣北港鎮	2018-11-24T23:22:22+08:00	11031	3674	14705	1989	16694	31181	53.54%	35.38%	39	41
8	雲林縣北港鎮	2018-11-24T22:43:49+08:00	10249	3420	13669	1909	15578	29000	53.72%	35.34%	37	41
8	雲林縣北港鎮	2018-11-24T23:03:46+08:00	10633	3555	14188	1938	16126	30032	53.7%	35.41%	38	41
8	雲林縣北港鎮	2018-11-24T23:10:55+08:00	10633	3555	14188	1938	16126	30032	53.7%	35.41%	38	41
8	雲林縣北港鎮	2018-11-25T00:08:04+08:00	12097	4026	16123	2146	18269	33958	53.8%	35.62%	41	41
8	雲林縣北港鎮	2018-11-25T03:42:47+08:00	12097	4026	16123	2146	18269	33958	53.8%	35.62%	41	41
8	雲林縣北港鎮	2018-11-24T22:53:14+08:00	10633	3555	14188	1938	16126	30032	53.7%	35.41%	38	41
8	雲林縣北港鎮	2018-11-24T23:46:02+08:00	12097	4026	16123	2146	18269	33958	53.8%	35.62%	41	41
8	雲林縣北港鎮	2018-11-25T00:17:07+08:00	12097	4026	16123	2146	18269	33958	53.8%	35.62%	41	41
8	雲林縣北港鎮	2018-11-24T23:29:45+08:00	12097	4026	16123	2146	18269	33958	53.8%	35.62%	41	41
8	雲林縣北港鎮	2018-11-25T06:22:44+08:00	12097	4026	16123	2146	18269	33958	53.8%	35.62%	41	41
8	雲林縣北港鎮	2018-11-25T06:12:36+08:00	12097	4026	16123	2146	18269	33958	53.8%	35.62%	41	41
8	雲林縣北港鎮	2018-11-24T22:25:24+08:00	7456	2428	9884	1367	11251	20850	53.96%	35.76%	29	41
8	雲林縣北港鎮	2018-11-25T01:05:58+08:00	12097	4026	16123	2146	18269	33958	53.8%	35.62%	41	41
8	雲林縣北港鎮	2018-11-25T00:12:44+08:00	12097	4026	16123	2146	18269	33958	53.8%	35.62%	41	41
8	雲林縣北港鎮	2018-11-24T23:26:06+08:00	11031	3674	14705	1989	16694	31181	53.54%	35.38%	39	41
8	雲林縣北港鎮	2018-11-25T06:27:54+08:00	12097	4026	16123	2146	18269	33958	53.8%	35.62%	41	41
8	雲林縣北港鎮	2018-11-24T23:50:14+08:00	12097	4026	16123	2146	18269	33958	53.8%	35.62%	41	41
8	雲林縣北港鎮	2018-11-24T23:14:40+08:00	10633	3555	14188	1938	16126	30032	53.7%	35.41%	38	41
8	雲林縣北港鎮	2018-11-24T22:18:19+08:00	7199	2333	9532	1292	10824	20126	53.78%	35.77%	28	41
8	雲林縣北港鎮	2018-11-24T22:28:39+08:00	7456	2428	9884	1367	11251	20850	53.96%	35.76%	29	41
8	雲林縣北港鎮	2018-11-24T22:14:48+08:00	6925	2242	9167	1224	10391	19438	53.46%	35.63%	27	41
8	雲林縣北港鎮	2018-11-25T01:16:21+08:00	12097	4026	16123	2146	18269	33958	53.8%	35.62%	41	41
8	雲林縣北港鎮	2018-11-24T23:18:26+08:00	10633	3555	14188	1938	16126	30032	53.7%	35.41%	38	41
8	新竹縣峨眉鄉	2018-11-24T22:12:00+08:00	1241	357	1598	163	1761	2979	59.11%	41.66%	6	8
8	新竹縣峨眉鄉	2018-11-24T22:39:06+08:00	1527	445	1972	219	2191	3662	59.83%	41.7%	7	8
8	新竹縣峨眉鄉	2018-11-24T23:03:44+08:00	1527	445	1972	219	2191	3662	59.83%	41.7%	7	8
8	新竹縣峨眉鄉	2018-11-24T23:22:20+08:00	1527	445	1972	219	2191	3662	59.83%	41.7%	7	8
8	新竹縣峨眉鄉	2018-11-24T23:58:39+08:00	1527	445	1972	219	2191	3662	59.83%	41.7%	7	8
8	新竹縣峨眉鄉	2018-11-24T22:49:21+08:00	1527	445	1972	219	2191	3662	59.83%	41.7%	7	8
8	新竹縣峨眉鄉	2018-11-24T23:46:01+08:00	1527	445	1972	219	2191	3662	59.83%	41.7%	7	8
8	新竹縣峨眉鄉	2018-11-25T03:48:26+08:00	2134	612	2746	302	3048	5068	60.14%	42.11%	8	8
8	新竹縣峨眉鄉	2018-11-25T03:42:45+08:00	2134	612	2746	302	3048	5068	60.14%	42.11%	8	8
8	新竹縣峨眉鄉	2018-11-25T01:00:58+08:00	2134	612	2746	302	3048	5068	60.14%	42.11%	8	8
8	新竹縣峨眉鄉	2018-11-25T00:08:01+08:00	1527	445	1972	219	2191	3662	59.83%	41.7%	7	8
8	新竹縣峨眉鄉	2018-11-25T04:01:26+08:00	2134	612	2746	302	3048	5068	60.14%	42.11%	8	8
8	新竹縣峨眉鄉	2018-11-24T22:25:21+08:00	1527	445	1972	219	2191	3662	59.83%	41.7%	7	8
8	新竹縣峨眉鄉	2018-11-25T06:12:34+08:00	2134	612	2746	302	3048	5068	60.14%	42.11%	8	8
8	新竹縣峨眉鄉	2018-11-24T22:40:16+08:00	1527	445	1972	219	2191	3662	59.83%	41.7%	7	8
8	新竹縣峨眉鄉	2018-11-24T22:21:43+08:00	1527	445	1972	219	2191	3662	59.83%	41.7%	7	8
8	新竹縣峨眉鄉	2018-11-25T00:17:05+08:00	1527	445	1972	219	2191	3662	59.83%	41.7%	7	8
8	新竹縣峨眉鄉	2018-11-24T23:18:24+08:00	1527	445	1972	219	2191	3662	59.83%	41.7%	7	8
8	新竹縣峨眉鄉	2018-11-24T23:37:46+08:00	1527	445	1972	219	2191	3662	59.83%	41.7%	7	8
8	新竹縣峨眉鄉	2018-11-24T22:35:42+08:00	1527	445	1972	219	2191	3662	59.83%	41.7%	7	8
8	新竹縣峨眉鄉	2018-11-25T03:54:37+08:00	2134	612	2746	302	3048	5068	60.14%	42.11%	8	8
8	新竹縣峨眉鄉	2018-11-24T23:33:47+08:00	1527	445	1972	219	2191	3662	59.83%	41.7%	7	8
8	新竹縣峨眉鄉	2018-11-24T23:26:04+08:00	1527	445	1972	219	2191	3662	59.83%	41.7%	7	8
8	新竹縣峨眉鄉	2018-11-24T23:07:15+08:00	1527	445	1972	219	2191	3662	59.83%	41.7%	7	8
8	新竹縣峨眉鄉	2018-11-24T23:14:37+08:00	1527	445	1972	219	2191	3662	59.83%	41.7%	7	8
8	新竹縣峨眉鄉	2018-11-24T23:10:53+08:00	1527	445	1972	219	2191	3662	59.83%	41.7%	7	8
8	新竹縣峨眉鄉	2018-11-25T06:17:33+08:00	2134	612	2746	302	3048	5068	60.14%	42.11%	8	8
8	新竹縣峨眉鄉	2018-11-24T22:43:47+08:00	1527	445	1972	219	2191	3662	59.83%	41.7%	7	8
8	新竹縣峨眉鄉	2018-11-25T01:24:21+08:00	2134	612	2746	302	3048	5068	60.14%	42.11%	8	8
8	新竹縣峨眉鄉	2018-11-24T22:56:34+08:00	1527	445	1972	219	2191	3662	59.83%	41.7%	7	8
8	新竹縣峨眉鄉	2018-11-25T03:37:23+08:00	2134	612	2746	302	3048	5068	60.14%	42.11%	8	8
8	新竹縣峨眉鄉	2018-11-25T03:30:55+08:00	2134	612	2746	302	3048	5068	60.14%	42.11%	8	8
8	新竹縣峨眉鄉	2018-11-24T22:53:12+08:00	1527	445	1972	219	2191	3662	59.83%	41.7%	7	8
8	新竹縣峨眉鄉	2018-11-24T22:32:15+08:00	1527	445	1972	219	2191	3662	59.83%	41.7%	7	8
8	新竹縣峨眉鄉	2018-11-24T23:00:14+08:00	1527	445	1972	219	2191	3662	59.83%	41.7%	7	8
8	新竹縣峨眉鄉	2018-11-25T01:11:03+08:00	2134	612	2746	302	3048	5068	60.14%	42.11%	8	8
8	新竹縣峨眉鄉	2018-11-24T23:29:43+08:00	1527	445	1972	219	2191	3662	59.83%	41.7%	7	8
8	新竹縣峨眉鄉	2018-11-25T00:21:41+08:00	1527	445	1972	219	2191	3662	59.83%	41.7%	7	8
8	新竹縣峨眉鄉	2018-11-25T06:22:42+08:00	2134	612	2746	302	3048	5068	60.14%	42.11%	8	8
8	新竹縣峨眉鄉	2018-11-25T06:07:20+08:00	2134	612	2746	302	3048	5068	60.14%	42.11%	8	8
8	新竹縣峨眉鄉	2018-11-25T01:05:56+08:00	2134	612	2746	302	3048	5068	60.14%	42.11%	8	8
8	新竹縣峨眉鄉	2018-11-24T23:54:24+08:00	1527	445	1972	219	2191	3662	59.83%	41.7%	7	8
8	新竹縣峨眉鄉	2018-11-24T23:41:59+08:00	1527	445	1972	219	2191	3662	59.83%	41.7%	7	8
8	新竹縣峨眉鄉	2018-11-25T01:16:18+08:00	2134	612	2746	302	3048	5068	60.14%	42.11%	8	8
8	新竹縣峨眉鄉	2018-11-25T00:03:31+08:00	1527	445	1972	219	2191	3662	59.83%	41.7%	7	8
8	新竹縣峨眉鄉	2018-11-24T22:14:46+08:00	1241	357	1598	163	1761	2979	59.11%	41.66%	6	8
8	新竹縣峨眉鄉	2018-11-25T06:27:52+08:00	2134	612	2746	302	3048	5068	60.14%	42.11%	8	8
8	新竹縣峨眉鄉	2018-11-25T00:56:11+08:00	2134	612	2746	302	3048	5068	60.14%	42.11%	8	8
8	新竹縣峨眉鄉	2018-11-24T22:18:17+08:00	1241	357	1598	163	1761	2979	59.11%	41.66%	6	8
8	新竹縣峨眉鄉	2018-11-25T00:12:42+08:00	1527	445	1972	219	2191	3662	59.83%	41.7%	7	8
8	新竹縣峨眉鄉	2018-11-24T22:28:37+08:00	1527	445	1972	219	2191	3662	59.83%	41.7%	7	8
8	新竹縣峨眉鄉	2018-11-24T23:50:12+08:00	1527	445	1972	219	2191	3662	59.83%	41.7%	7	8
8	新竹縣竹北市	2018-11-24T23:03:44+08:00	21325	5994	27319	1539	28858	50606	57.02%	42.14%	39	103
8	新竹縣竹北市	2018-11-24T23:22:20+08:00	26167	7376	33543	1913	35456	61961	57.22%	42.23%	48	103
8	新竹縣竹北市	2018-11-24T22:49:21+08:00	14520	4056	18576	1106	19682	34711	56.7%	41.83%	27	103
8	新竹縣竹北市	2018-11-24T23:58:38+08:00	35505	10057	45562	2579	48141	84034	57.29%	42.25%	65	103
8	新竹縣竹北市	2018-11-25T03:42:44+08:00	58887	16366	75253	4168	79421	137129	57.92%	42.94%	103	103
8	新竹縣竹北市	2018-11-24T23:46:01+08:00	31619	8962	40581	2304	42885	74998	57.18%	42.16%	58	103
8	新竹縣竹北市	2018-11-25T01:00:57+08:00	56251	15688	71939	4018	75957	131132	57.92%	42.9%	99	103
8	新竹縣竹北市	2018-11-25T03:48:26+08:00	58887	16366	75253	4168	79421	137129	57.92%	42.94%	103	103
8	新竹縣竹北市	2018-11-24T22:53:11+08:00	15422	4292	19714	1217	20931	36970	56.62%	41.71%	29	103
8	新竹縣竹北市	2018-11-25T00:08:01+08:00	39062	11075	50137	2819	52956	92272	57.39%	42.33%	71	103
8	新竹縣竹北市	2018-11-24T22:21:42+08:00	8353	2401	10754	706	11460	20379	56.23%	40.99%	16	103
8	新竹縣竹北市	2018-11-25T04:01:26+08:00	58887	16366	75253	4168	79421	137129	57.92%	42.94%	103	103
8	新竹縣竹北市	2018-11-25T06:12:34+08:00	58887	16366	75253	4168	79421	137129	57.92%	42.94%	103	103
8	新竹縣竹北市	2018-11-24T22:40:16+08:00	12139	3373	15512	954	16466	29244	56.31%	41.51%	23	103
8	新竹縣竹北市	2018-11-24T22:25:20+08:00	8877	2545	11422	734	12156	21725	55.95%	40.86%	17	103
8	新竹縣竹北市	2018-11-25T00:17:05+08:00	41294	11746	53040	3021	56061	97820	57.31%	42.21%	75	103
8	新竹縣竹北市	2018-11-24T23:18:24+08:00	25520	7204	32724	1840	34564	60495	57.14%	42.19%	47	103
8	新竹縣竹北市	2018-11-24T23:37:46+08:00	30950	8746	39696	2252	41948	73247	57.27%	42.25%	57	103
8	新竹縣竹北市	2018-11-24T22:35:42+08:00	11591	3220	14811	922	15733	28048	56.09%	41.33%	22	103
8	新竹縣竹北市	2018-11-25T03:54:37+08:00	58887	16366	75253	4168	79421	137129	57.92%	42.94%	103	103
8	新竹縣竹北市	2018-11-24T23:33:47+08:00	29722	8409	38131	2162	40293	70438	57.2%	42.2%	55	103
8	新竹縣竹北市	2018-11-25T01:05:55+08:00	56795	15858	72653	4058	76711	132344	57.96%	42.91%	100	103
8	新竹縣竹北市	2018-11-24T23:50:11+08:00	32701	9279	41980	2376	44356	77348	57.35%	42.28%	60	103
8	新竹縣竹北市	2018-11-24T23:26:04+08:00	27243	7675	34918	1963	36881	64400	57.27%	42.3%	50	103
8	新竹縣竹北市	2018-11-24T22:14:45+08:00	4258	1244	5502	426	5928	10409	56.95%	40.91%	9	103
8	新竹縣竹北市	2018-11-25T06:17:32+08:00	58887	16366	75253	4168	79421	137129	57.92%	42.94%	103	103
8	新竹縣竹北市	2018-11-25T03:37:22+08:00	58887	16366	75253	4168	79421	137129	57.92%	42.94%	103	103
8	新竹縣竹北市	2018-11-24T23:07:15+08:00	22431	6302	28733	1633	30366	53124	57.16%	42.22%	41	103
8	新竹縣竹北市	2018-11-24T22:39:05+08:00	11591	3220	14811	922	15733	28048	56.09%	41.33%	22	103
8	新竹縣竹北市	2018-11-24T23:10:53+08:00	23085	6469	29554	1690	31244	54646	57.18%	42.24%	42	103
8	新竹縣竹北市	2018-11-24T22:43:47+08:00	12617	3527	16144	1003	17147	30449	56.31%	41.44%	24	103
8	新竹縣竹北市	2018-11-24T22:56:33+08:00	16629	4658	21287	1250	22537	39812	56.61%	41.77%	31	103
8	新竹縣竹北市	2018-11-25T01:24:21+08:00	58123	16185	74308	4113	78421	135495	57.88%	42.9%	102	103
8	新竹縣竹北市	2018-11-24T23:14:36+08:00	23903	6722	30625	1752	32377	56789	57.01%	42.09%	44	103
8	新竹縣竹北市	2018-11-25T03:30:55+08:00	58887	16366	75253	4168	79421	137129	57.92%	42.94%	103	103
8	新竹縣竹北市	2018-11-24T22:32:15+08:00	11591	3220	14811	922	15733	28048	56.09%	41.33%	22	103
8	新竹縣竹北市	2018-11-24T22:11:59+08:00	4258	1244	5502	426	5928	10409	56.95%	40.91%	9	103
8	新竹縣竹北市	2018-11-24T23:00:14+08:00	17283	4858	22141	1282	23423	41307	56.7%	41.84%	32	103
8	新竹縣竹北市	2018-11-25T06:07:19+08:00	58887	16366	75253	4168	79421	137129	57.92%	42.94%	103	103
8	新竹縣竹北市	2018-11-25T01:11:03+08:00	57399	16012	73411	4082	77493	133850	57.9%	42.88%	101	103
8	新竹縣竹北市	2018-11-24T23:29:43+08:00	28803	8152	36955	2073	39028	68332	57.12%	42.15%	53	103
8	新竹縣竹北市	2018-11-25T00:21:41+08:00	42683	12130	54813	3131	57944	100867	57.45%	42.32%	77	103
8	新竹縣竹北市	2018-11-25T06:22:42+08:00	58887	16366	75253	4168	79421	137129	57.92%	42.94%	103	103
8	新竹縣竹北市	2018-11-25T00:56:10+08:00	56251	15688	71939	4018	75957	131132	57.92%	42.9%	99	103
8	新竹縣竹北市	2018-11-24T22:18:16+08:00	5370	1557	6927	494	7421	13143	56.46%	40.86%	11	103
8	新竹縣竹北市	2018-11-24T23:54:24+08:00	33317	9430	42747	2402	45149	78656	57.4%	42.36%	61	103
8	新竹縣竹北市	2018-11-25T01:16:18+08:00	58123	16185	74308	4113	78421	135495	57.88%	42.9%	102	103
8	新竹縣竹北市	2018-11-24T23:41:58+08:00	31619	8962	40581	2304	42885	74998	57.18%	42.16%	58	103
8	新竹縣竹北市	2018-11-25T06:27:52+08:00	58887	16366	75253	4168	79421	137129	57.92%	42.94%	103	103
8	新竹縣竹北市	2018-11-25T00:12:42+08:00	40138	11366	51504	2948	54452	94863	57.4%	42.31%	73	103
8	新竹縣竹北市	2018-11-24T22:28:37+08:00	9880	2800	12680	816	13496	23986	56.27%	41.19%	19	103
8	新竹縣竹北市	2018-11-25T00:03:30+08:00	37400	10609	48009	2709	50718	88439	57.35%	42.29%	68	103
8	基隆市七堵區	2018-11-24T23:10:59+08:00	13839	4407	18246	1406	19652	37466	52.45%	36.94%	33	39
8	基隆市七堵區	2018-11-24T23:22:27+08:00	13839	4407	18246	1406	19652	37466	52.45%	36.94%	33	39
8	基隆市七堵區	2018-11-24T23:18:31+08:00	13839	4407	18246	1406	19652	37466	52.45%	36.94%	33	39
8	基隆市七堵區	2018-11-24T22:49:28+08:00	11070	3571	14641	1212	15853	30243	52.42%	36.6%	28	39
8	基隆市七堵區	2018-11-24T23:33:54+08:00	14347	4538	18885	1447	20332	38784	52.42%	36.99%	34	39
8	基隆市七堵區	2018-11-24T22:12:06+08:00	8035	2659	10694	879	11573	22182	52.17%	36.22%	22	39
8	基隆市七堵區	2018-11-24T23:26:11+08:00	14347	4538	18885	1447	20332	38784	52.42%	36.99%	34	39
8	基隆市七堵區	2018-11-24T22:56:39+08:00	12148	3885	16033	1284	17317	32960	52.54%	36.86%	30	39
8	基隆市七堵區	2018-11-24T22:28:44+08:00	8846	2884	11730	967	12697	24273	52.31%	36.44%	24	39
8	基隆市七堵區	2018-11-24T23:37:52+08:00	14745	4690	19435	1490	20925	39977	52.34%	36.88%	35	39
8	基隆市七堵區	2018-11-24T22:53:19+08:00	11497	3713	15210	1259	16469	31254	52.69%	36.79%	29	39
8	基隆市七堵區	2018-11-24T22:21:50+08:00	8457	2754	11211	927	12138	23181	52.36%	36.48%	23	39
8	基隆市七堵區	2018-11-25T04:01:33+08:00	17242	5289	22531	1698	24229	46256	52.38%	37.28%	39	39
8	基隆市七堵區	2018-11-24T23:46:07+08:00	14745	4690	19435	1490	20925	39977	52.34%	36.88%	35	39
8	基隆市七堵區	2018-11-25T01:11:12+08:00	17242	5289	22531	1698	24229	46256	52.38%	37.28%	39	39
8	基隆市七堵區	2018-11-25T00:08:08+08:00	14745	4690	19435	1490	20925	39977	52.34%	36.88%	35	39
8	基隆市七堵區	2018-11-24T23:00:20+08:00	12653	4050	16703	1310	18013	34446	52.29%	36.73%	31	39
8	基隆市七堵區	2018-11-24T22:25:29+08:00	8846	2884	11730	967	12697	24273	52.31%	36.44%	24	39
8	基隆市七堵區	2018-11-25T06:22:48+08:00	17242	5289	22531	1698	24229	46256	52.38%	37.28%	39	39
8	基隆市七堵區	2018-11-25T03:48:35+08:00	17242	5289	22531	1698	24229	46256	52.38%	37.28%	39	39
8	基隆市七堵區	2018-11-25T06:27:59+08:00	17242	5289	22531	1698	24229	46256	52.38%	37.28%	39	39
8	基隆市七堵區	2018-11-25T06:17:41+08:00	17242	5289	22531	1698	24229	46256	52.38%	37.28%	39	39
8	基隆市七堵區	2018-11-24T22:39:13+08:00	9482	3070	12552	1020	13572	25995	52.21%	36.48%	25	39
8	基隆市七堵區	2018-11-25T03:37:34+08:00	17242	5289	22531	1698	24229	46256	52.38%	37.28%	39	39
8	基隆市七堵區	2018-11-25T00:12:49+08:00	14745	4690	19435	1490	20925	39977	52.34%	36.88%	35	39
8	基隆市七堵區	2018-11-24T22:18:23+08:00	8035	2659	10694	879	11573	22182	52.17%	36.22%	22	39
8	基隆市七堵區	2018-11-24T23:50:18+08:00	14745	4690	19435	1490	20925	39977	52.34%	36.88%	35	39
8	基隆市七堵區	2018-11-24T23:14:45+08:00	13839	4407	18246	1406	19652	37466	52.45%	36.94%	33	39
8	基隆市七堵區	2018-11-24T23:58:46+08:00	14745	4690	19435	1490	20925	39977	52.34%	36.88%	35	39
8	基隆市七堵區	2018-11-24T23:03:50+08:00	12653	4050	16703	1310	18013	34446	52.29%	36.73%	31	39
8	基隆市七堵區	2018-11-25T01:01:06+08:00	17242	5289	22531	1698	24229	46256	52.38%	37.28%	39	39
8	基隆市七堵區	2018-11-25T01:24:29+08:00	17242	5289	22531	1698	24229	46256	52.38%	37.28%	39	39
8	基隆市七堵區	2018-11-24T23:54:31+08:00	14745	4690	19435	1490	20925	39977	52.34%	36.88%	35	39
8	基隆市七堵區	2018-11-25T03:54:45+08:00	17242	5289	22531	1698	24229	46256	52.38%	37.28%	39	39
8	基隆市七堵區	2018-11-24T23:07:22+08:00	13126	4218	17344	1340	18684	35731	52.29%	36.74%	32	39
8	基隆市七堵區	2018-11-25T00:03:40+08:00	14745	4690	19435	1490	20925	39977	52.34%	36.88%	35	39
8	基隆市七堵區	2018-11-24T22:14:53+08:00	8035	2659	10694	879	11573	22182	52.17%	36.22%	22	39
8	基隆市七堵區	2018-11-25T06:12:40+08:00	17242	5289	22531	1698	24229	46256	52.38%	37.28%	39	39
8	基隆市七堵區	2018-11-24T23:29:50+08:00	14347	4538	18885	1447	20332	38784	52.42%	36.99%	34	39
8	基隆市七堵區	2018-11-25T00:17:12+08:00	14745	4690	19435	1490	20925	39977	52.34%	36.88%	35	39
8	基隆市七堵區	2018-11-24T22:32:22+08:00	8846	2884	11730	967	12697	24273	52.31%	36.44%	24	39
8	基隆市七堵區	2018-11-24T23:42:05+08:00	14745	4690	19435	1490	20925	39977	52.34%	36.88%	35	39
8	基隆市七堵區	2018-11-25T01:06:04+08:00	17242	5289	22531	1698	24229	46256	52.38%	37.28%	39	39
8	基隆市七堵區	2018-11-25T03:42:52+08:00	17242	5289	22531	1698	24229	46256	52.38%	37.28%	39	39
8	基隆市七堵區	2018-11-24T22:40:22+08:00	9877	3196	13073	1071	14144	26957	52.47%	36.64%	26	39
8	基隆市七堵區	2018-11-25T00:21:48+08:00	15850	4884	20734	1598	22332	42552	52.48%	37.25%	37	39
8	基隆市七堵區	2018-11-25T06:07:27+08:00	17242	5289	22531	1698	24229	46256	52.38%	37.28%	39	39
8	基隆市七堵區	2018-11-25T00:56:17+08:00	17242	5289	22531	1698	24229	46256	52.38%	37.28%	39	39
8	基隆市七堵區	2018-11-24T22:35:48+08:00	9482	3070	12552	1020	13572	25995	52.21%	36.48%	25	39
8	基隆市七堵區	2018-11-24T22:43:54+08:00	10537	3402	13939	1151	15090	28731	52.52%	36.67%	27	39
8	基隆市七堵區	2018-11-25T03:31:03+08:00	17242	5289	22531	1698	24229	46256	52.38%	37.28%	39	39
8	基隆市七堵區	2018-11-25T01:16:26+08:00	17242	5289	22531	1698	24229	46256	52.38%	37.28%	39	39
8	臺中市大里區	2018-11-24T22:49:18+08:00	44130	13163	57293	4325	61618	109748	56.14%	40.21%	71	106
8	臺中市大里區	2018-11-24T23:14:33+08:00	53948	15955	69903	5162	75065	134563	55.78%	40.09%	85	106
8	臺中市大里區	2018-11-24T22:56:31+08:00	45567	13580	59147	4503	63650	113481	56.09%	40.15%	73	106
8	臺中市大里區	2018-11-25T00:12:39+08:00	67551	19778	87329	6481	93810	168348	55.72%	40.13%	104	106
8	臺中市大里區	2018-11-25T00:03:27+08:00	66903	19538	86441	6405	92846	166693	55.7%	40.14%	103	106
8	臺中市大里區	2018-11-25T00:56:07+08:00	68915	20147	89062	6611	95673	171769	55.7%	40.12%	106	106
8	臺中市大里區	2018-11-24T23:03:42+08:00	49930	14752	64682	4829	69511	124080	56.02%	40.24%	79	106
8	臺中市大里區	2018-11-24T23:10:51+08:00	52597	15576	68173	5055	73228	131211	55.81%	40.09%	83	106
8	臺中市大里區	2018-11-25T03:37:18+08:00	68915	20147	89062	6611	95673	171769	55.7%	40.12%	106	106
8	臺中市大里區	2018-11-24T22:43:44+08:00	40576	12160	52736	3970	56706	101024	56.13%	40.16%	66	106
8	臺中市大里區	2018-11-25T06:17:30+08:00	68915	20147	89062	6611	95673	171769	55.7%	40.12%	106	106
8	臺中市大里區	2018-11-25T01:10:59+08:00	68915	20147	89062	6611	95673	171769	55.7%	40.12%	106	106
8	臺中市大里區	2018-11-24T23:22:17+08:00	58642	17226	75868	5622	81490	146172	55.75%	40.12%	92	106
8	臺中市大里區	2018-11-25T06:22:39+08:00	68915	20147	89062	6611	95673	171769	55.7%	40.12%	106	106
8	臺中市大里區	2018-11-24T22:25:18+08:00	36544	11134	47678	3630	51308	91051	56.35%	40.14%	60	106
8	臺中市大里區	2018-11-24T23:29:40+08:00	60674	17831	78505	5845	84350	151666	55.62%	40.01%	95	106
8	臺中市大里區	2018-11-25T00:17:02+08:00	68309	19980	88289	6568	94857	170261	55.71%	40.12%	105	106
8	臺中市大里區	2018-11-25T00:07:58+08:00	66903	19538	86441	6405	92846	166693	55.7%	40.14%	103	106
8	臺中市大里區	2018-11-25T01:16:15+08:00	68915	20147	89062	6611	95673	171769	55.7%	40.12%	106	106
8	臺中市大里區	2018-11-25T01:05:52+08:00	68915	20147	89062	6611	95673	171769	55.7%	40.12%	106	106
8	臺中市大里區	2018-11-24T22:14:42+08:00	29591	9153	38744	2990	41734	73963	56.43%	40.01%	50	106
8	臺中市大里區	2018-11-24T23:54:19+08:00	66250	19304	85554	6322	91876	164896	55.72%	40.18%	102	106
8	臺中市大里區	2018-11-24T22:28:34+08:00	37175	11283	48458	3666	52124	92621	56.28%	40.14%	61	106
8	臺中市大里區	2018-11-24T22:18:13+08:00	31819	9836	41655	3192	44847	79858	56.16%	39.84%	53	106
8	臺中市大里區	2018-11-25T01:24:18+08:00	68915	20147	89062	6611	95673	171769	55.7%	40.12%	106	106
8	臺中市大里區	2018-11-24T22:35:39+08:00	38698	11703	50401	3809	54210	96366	56.25%	40.16%	63	106
8	臺中市大里區	2018-11-24T23:50:09+08:00	66250	19304	85554	6322	91876	164896	55.72%	40.18%	102	106
8	臺中市大里區	2018-11-24T23:58:35+08:00	66903	19538	86441	6405	92846	166693	55.7%	40.14%	103	106
8	臺中市大里區	2018-11-25T06:27:49+08:00	68915	20147	89062	6611	95673	171769	55.7%	40.12%	106	106
8	臺中市大里區	2018-11-24T22:39:03+08:00	39293	11861	51154	3863	55017	97796	56.26%	40.18%	64	106
8	臺中市大里區	2018-11-24T23:07:13+08:00	51298	15159	66457	4933	71390	127788	55.87%	40.14%	81	106
8	臺中市大里區	2018-11-25T01:00:54+08:00	68915	20147	89062	6611	95673	171769	55.7%	40.12%	106	106
8	臺中市大里區	2018-11-24T23:00:08+08:00	46255	13785	60040	4545	64585	115143	56.09%	40.17%	74	106
8	臺中市大里區	2018-11-25T03:48:22+08:00	68915	20147	89062	6611	95673	171769	55.7%	40.12%	106	106
8	臺中市大里區	2018-11-25T00:21:37+08:00	68915	20147	89062	6611	95673	171769	55.7%	40.12%	106	106
8	臺中市大里區	2018-11-25T03:30:52+08:00	68915	20147	89062	6611	95673	171769	55.7%	40.12%	106	106
8	臺中市大里區	2018-11-25T03:42:41+08:00	68915	20147	89062	6611	95673	171769	55.7%	40.12%	106	106
8	臺中市大里區	2018-11-24T22:21:39+08:00	34593	10630	45223	3476	48699	86429	56.35%	40.02%	57	106
8	臺中市大里區	2018-11-24T22:32:12+08:00	38022	11500	49522	3731	53253	94559	56.32%	40.21%	62	106
8	臺中市大里區	2018-11-24T22:53:08+08:00	44731	13361	58092	4409	62501	111484	56.06%	40.12%	72	106
8	臺中市大里區	2018-11-25T04:01:22+08:00	68915	20147	89062	6611	95673	171769	55.7%	40.12%	106	106
8	臺中市大里區	2018-11-24T22:11:57+08:00	28011	8741	36752	2872	39624	70511	56.2%	39.73%	48	106
8	臺中市大里區	2018-11-24T22:40:13+08:00	39293	11861	51154	3863	55017	97796	56.26%	40.18%	64	106
8	臺中市大里區	2018-11-25T06:12:31+08:00	68915	20147	89062	6611	95673	171769	55.7%	40.12%	106	106
8	臺中市大里區	2018-11-25T06:07:16+08:00	68915	20147	89062	6611	95673	171769	55.7%	40.12%	106	106
8	臺中市大里區	2018-11-24T23:33:44+08:00	63167	18492	81659	6068	87727	157447	55.72%	40.12%	98	106
8	臺中市大里區	2018-11-24T23:26:01+08:00	59286	17411	76697	5673	82370	148047	55.64%	40.05%	93	106
8	臺中市大里區	2018-11-25T03:54:34+08:00	68915	20147	89062	6611	95673	171769	55.7%	40.12%	106	106
8	臺中市大里區	2018-11-24T23:45:58+08:00	66250	19304	85554	6322	91876	164896	55.72%	40.18%	102	106
8	臺中市大里區	2018-11-24T23:41:56+08:00	66250	19304	85554	6322	91876	164896	55.72%	40.18%	102	106
8	臺中市大里區	2018-11-24T23:37:43+08:00	64801	18922	83723	6219	89942	161186	55.8%	40.2%	100	106
8	臺中市大里區	2018-11-24T23:18:21+08:00	55265	16327	71592	5301	76893	137765	55.81%	40.12%	87	106
8	花蓮縣光復鄉	2018-11-24T22:14:51+08:00	1360	367	1727	209	1936	4218	45.9%	32.24%	9	17
8	花蓮縣光復鄉	2018-11-24T23:33:52+08:00	3066	867	3933	537	4470	8676	51.52%	35.34%	14	17
8	花蓮縣光復鄉	2018-11-24T22:28:42+08:00	1571	400	1971	233	2204	4689	47%	33.5%	10	17
8	花蓮縣光復鄉	2018-11-24T22:56:38+08:00	2417	671	3088	422	3510	6995	50.18%	34.55%	12	17
8	花蓮縣光復鄉	2018-11-24T23:07:21+08:00	2649	748	3397	470	3867	7635	50.65%	34.7%	13	17
8	花蓮縣光復鄉	2018-11-24T22:49:26+08:00	2062	544	2606	317	2923	5984	48.85%	34.46%	11	17
8	花蓮縣光復鄉	2018-11-24T23:10:58+08:00	2649	748	3397	470	3867	7635	50.65%	34.7%	13	17
8	花蓮縣光復鄉	2018-11-25T06:17:39+08:00	3925	1155	5080	738	5818	11417	50.96%	34.38%	17	17
8	花蓮縣光復鄉	2018-11-24T22:53:17+08:00	2417	671	3088	422	3510	6995	50.18%	34.55%	12	17
8	花蓮縣光復鄉	2018-11-24T23:46:06+08:00	3406	972	4378	663	5041	9634	52.33%	35.35%	15	17
8	花蓮縣光復鄉	2018-11-25T00:08:07+08:00	3697	1063	4760	712	5472	10485	52.19%	35.26%	16	17
8	花蓮縣光復鄉	2018-11-24T22:32:20+08:00	1571	400	1971	233	2204	4689	47%	33.5%	10	17
8	花蓮縣光復鄉	2018-11-25T00:17:10+08:00	3925	1155	5080	738	5818	11417	50.96%	34.38%	17	17
8	花蓮縣光復鄉	2018-11-25T03:48:33+08:00	3925	1155	5080	738	5818	11417	50.96%	34.38%	17	17
8	花蓮縣光復鄉	2018-11-24T23:00:19+08:00	2417	671	3088	422	3510	6995	50.18%	34.55%	12	17
8	花蓮縣光復鄉	2018-11-25T06:07:25+08:00	3925	1155	5080	738	5818	11417	50.96%	34.38%	17	17
8	花蓮縣光復鄉	2018-11-25T06:22:47+08:00	3925	1155	5080	738	5818	11417	50.96%	34.38%	17	17
8	花蓮縣光復鄉	2018-11-25T03:42:51+08:00	3925	1155	5080	738	5818	11417	50.96%	34.38%	17	17
8	花蓮縣光復鄉	2018-11-24T22:25:27+08:00	1571	400	1971	233	2204	4689	47%	33.5%	10	17
8	花蓮縣光復鄉	2018-11-24T22:40:21+08:00	1571	400	1971	233	2204	4689	47%	33.5%	10	17
8	花蓮縣光復鄉	2018-11-24T23:29:49+08:00	3066	867	3933	537	4470	8676	51.52%	35.34%	14	17
8	花蓮縣光復鄉	2018-11-24T23:50:17+08:00	3406	972	4378	663	5041	9634	52.33%	35.35%	15	17
8	花蓮縣光復鄉	2018-11-24T23:14:43+08:00	2649	748	3397	470	3867	7635	50.65%	34.7%	13	17
8	花蓮縣光復鄉	2018-11-25T01:16:24+08:00	3925	1155	5080	738	5818	11417	50.96%	34.38%	17	17
8	花蓮縣光復鄉	2018-11-25T00:12:47+08:00	3925	1155	5080	738	5818	11417	50.96%	34.38%	17	17
8	花蓮縣光復鄉	2018-11-24T23:54:29+08:00	3406	972	4378	663	5041	9634	52.33%	35.35%	15	17
8	花蓮縣光復鄉	2018-11-25T06:27:57+08:00	3925	1155	5080	738	5818	11417	50.96%	34.38%	17	17
8	花蓮縣光復鄉	2018-11-25T03:31:01+08:00	3925	1155	5080	738	5818	11417	50.96%	34.38%	17	17
8	花蓮縣光復鄉	2018-11-24T22:18:22+08:00	1360	367	1727	209	1936	4218	45.9%	32.24%	9	17
8	花蓮縣光復鄉	2018-11-25T03:37:32+08:00	3925	1155	5080	738	5818	11417	50.96%	34.38%	17	17
8	花蓮縣光復鄉	2018-11-25T00:56:15+08:00	3925	1155	5080	738	5818	11417	50.96%	34.38%	17	17
8	花蓮縣光復鄉	2018-11-24T23:37:50+08:00	3066	867	3933	537	4470	8676	51.52%	35.34%	14	17
8	花蓮縣光復鄉	2018-11-25T01:24:27+08:00	3925	1155	5080	738	5818	11417	50.96%	34.38%	17	17
8	花蓮縣光復鄉	2018-11-25T03:54:43+08:00	3925	1155	5080	738	5818	11417	50.96%	34.38%	17	17
8	花蓮縣光復鄉	2018-11-24T23:03:49+08:00	2649	748	3397	470	3867	7635	50.65%	34.7%	13	17
8	花蓮縣光復鄉	2018-11-24T22:12:04+08:00	1360	367	1727	209	1936	4218	45.9%	32.24%	9	17
8	花蓮縣光復鄉	2018-11-24T23:22:25+08:00	3066	867	3933	537	4470	8676	51.52%	35.34%	14	17
8	花蓮縣光復鄉	2018-11-25T01:06:02+08:00	3925	1155	5080	738	5818	11417	50.96%	34.38%	17	17
8	花蓮縣光復鄉	2018-11-24T23:42:04+08:00	3406	972	4378	663	5041	9634	52.33%	35.35%	15	17
8	花蓮縣光復鄉	2018-11-25T01:11:10+08:00	3925	1155	5080	738	5818	11417	50.96%	34.38%	17	17
8	花蓮縣光復鄉	2018-11-25T04:01:31+08:00	3925	1155	5080	738	5818	11417	50.96%	34.38%	17	17
8	花蓮縣光復鄉	2018-11-25T06:12:39+08:00	3925	1155	5080	738	5818	11417	50.96%	34.38%	17	17
8	花蓮縣光復鄉	2018-11-24T22:21:48+08:00	1571	400	1971	233	2204	4689	47%	33.5%	10	17
8	花蓮縣光復鄉	2018-11-25T00:21:46+08:00	3925	1155	5080	738	5818	11417	50.96%	34.38%	17	17
8	花蓮縣光復鄉	2018-11-25T01:01:04+08:00	3925	1155	5080	738	5818	11417	50.96%	34.38%	17	17
8	花蓮縣光復鄉	2018-11-24T22:35:46+08:00	1571	400	1971	233	2204	4689	47%	33.5%	10	17
8	花蓮縣光復鄉	2018-11-24T23:18:29+08:00	3066	867	3933	537	4470	8676	51.52%	35.34%	14	17
8	花蓮縣光復鄉	2018-11-24T23:58:45+08:00	3406	972	4378	663	5041	9634	52.33%	35.35%	15	17
8	花蓮縣光復鄉	2018-11-24T22:39:11+08:00	1571	400	1971	233	2204	4689	47%	33.5%	10	17
8	花蓮縣光復鄉	2018-11-24T23:26:09+08:00	3066	867	3933	537	4470	8676	51.52%	35.34%	14	17
8	花蓮縣光復鄉	2018-11-25T00:03:37+08:00	3406	972	4378	663	5041	9634	52.33%	35.35%	15	17
8	花蓮縣光復鄉	2018-11-24T22:43:52+08:00	1571	400	1971	233	2204	4689	47%	33.5%	10	17
8	臺東縣長濱鄉	2018-11-24T23:26:10+08:00	1403	433	1836	414	2250	5759	39.07%	24.36%	10	11
8	臺東縣長濱鄉	2018-11-24T23:07:21+08:00	1403	433	1836	414	2250	5759	39.07%	24.36%	10	11
8	臺東縣長濱鄉	2018-11-24T22:49:26+08:00	1403	433	1836	414	2250	5759	39.07%	24.36%	10	11
8	臺東縣長濱鄉	2018-11-24T23:10:58+08:00	1403	433	1836	414	2250	5759	39.07%	24.36%	10	11
8	臺東縣長濱鄉	2018-11-24T23:33:53+08:00	1403	433	1836	414	2250	5759	39.07%	24.36%	10	11
8	臺東縣長濱鄉	2018-11-24T22:56:39+08:00	1403	433	1836	414	2250	5759	39.07%	24.36%	10	11
8	臺東縣長濱鄉	2018-11-24T23:22:26+08:00	1403	433	1836	414	2250	5759	39.07%	24.36%	10	11
8	臺東縣長濱鄉	2018-11-24T22:28:43+08:00	1261	386	1647	353	2000	5154	38.8%	24.47%	9	11
8	臺東縣長濱鄉	2018-11-24T23:18:30+08:00	1403	433	1836	414	2250	5759	39.07%	24.36%	10	11
8	臺東縣長濱鄉	2018-11-25T00:17:11+08:00	1590	511	2101	484	2585	6484	39.87%	24.52%	11	11
8	臺東縣長濱鄉	2018-11-24T22:32:21+08:00	1261	386	1647	353	2000	5154	38.8%	24.47%	9	11
8	臺東縣長濱鄉	2018-11-24T23:46:06+08:00	1590	511	2101	484	2585	6484	39.87%	24.52%	11	11
8	臺東縣長濱鄉	2018-11-25T00:08:07+08:00	1590	511	2101	484	2585	6484	39.87%	24.52%	11	11
8	臺東縣長濱鄉	2018-11-24T22:53:18+08:00	1403	433	1836	414	2250	5759	39.07%	24.36%	10	11
8	臺東縣長濱鄉	2018-11-25T04:01:32+08:00	1590	511	2101	484	2585	6484	39.87%	24.52%	11	11
8	臺東縣長濱鄉	2018-11-25T03:48:34+08:00	1590	511	2101	484	2585	6484	39.87%	24.52%	11	11
8	臺東縣長濱鄉	2018-11-24T23:00:19+08:00	1403	433	1836	414	2250	5759	39.07%	24.36%	10	11
8	臺東縣長濱鄉	2018-11-25T06:07:25+08:00	1590	511	2101	484	2585	6484	39.87%	24.52%	11	11
8	臺東縣長濱鄉	2018-11-24T22:25:28+08:00	982	289	1271	230	1501	4241	35.39%	23.15%	8	11
8	臺東縣長濱鄉	2018-11-25T06:22:47+08:00	1590	511	2101	484	2585	6484	39.87%	24.52%	11	11
8	臺東縣長濱鄉	2018-11-25T03:42:51+08:00	1590	511	2101	484	2585	6484	39.87%	24.52%	11	11
8	臺東縣長濱鄉	2018-11-24T22:40:21+08:00	1403	433	1836	414	2250	5759	39.07%	24.36%	10	11
8	臺東縣長濱鄉	2018-11-24T23:29:49+08:00	1403	433	1836	414	2250	5759	39.07%	24.36%	10	11
8	臺東縣長濱鄉	2018-11-24T23:14:44+08:00	1403	433	1836	414	2250	5759	39.07%	24.36%	10	11
8	臺東縣長濱鄉	2018-11-24T23:50:17+08:00	1590	511	2101	484	2585	6484	39.87%	24.52%	11	11
8	臺東縣長濱鄉	2018-11-25T00:12:47+08:00	1590	511	2101	484	2585	6484	39.87%	24.52%	11	11
8	臺東縣長濱鄉	2018-11-25T01:16:25+08:00	1590	511	2101	484	2585	6484	39.87%	24.52%	11	11
8	臺東縣長濱鄉	2018-11-24T22:18:22+08:00	982	289	1271	230	1501	4241	35.39%	23.15%	8	11
8	臺東縣長濱鄉	2018-11-25T03:37:32+08:00	1590	511	2101	484	2585	6484	39.87%	24.52%	11	11
8	臺東縣長濱鄉	2018-11-25T06:27:58+08:00	1590	511	2101	484	2585	6484	39.87%	24.52%	11	11
8	臺東縣長濱鄉	2018-11-25T06:17:40+08:00	1590	511	2101	484	2585	6484	39.87%	24.52%	11	11
8	臺東縣長濱鄉	2018-11-25T03:54:44+08:00	1590	511	2101	484	2585	6484	39.87%	24.52%	11	11
8	臺東縣長濱鄉	2018-11-24T23:03:49+08:00	1403	433	1836	414	2250	5759	39.07%	24.36%	10	11
8	臺東縣長濱鄉	2018-11-24T22:14:52+08:00	982	289	1271	230	1501	4241	35.39%	23.15%	8	11
8	臺東縣長濱鄉	2018-11-25T01:24:28+08:00	1590	511	2101	484	2585	6484	39.87%	24.52%	11	11
8	臺東縣長濱鄉	2018-11-24T23:37:51+08:00	1403	433	1836	414	2250	5759	39.07%	24.36%	10	11
8	臺東縣長濱鄉	2018-11-24T22:12:05+08:00	982	289	1271	230	1501	4241	35.39%	23.15%	8	11
8	臺東縣長濱鄉	2018-11-24T23:54:30+08:00	1590	511	2101	484	2585	6484	39.87%	24.52%	11	11
8	臺東縣長濱鄉	2018-11-24T23:42:04+08:00	1590	511	2101	484	2585	6484	39.87%	24.52%	11	11
8	臺東縣長濱鄉	2018-11-25T01:11:10+08:00	1590	511	2101	484	2585	6484	39.87%	24.52%	11	11
8	臺東縣長濱鄉	2018-11-25T01:06:03+08:00	1590	511	2101	484	2585	6484	39.87%	24.52%	11	11
8	臺東縣長濱鄉	2018-11-25T00:21:47+08:00	1590	511	2101	484	2585	6484	39.87%	24.52%	11	11
8	臺東縣長濱鄉	2018-11-25T06:12:39+08:00	1590	511	2101	484	2585	6484	39.87%	24.52%	11	11
8	臺東縣長濱鄉	2018-11-24T22:21:49+08:00	982	289	1271	230	1501	4241	35.39%	23.15%	8	11
8	臺東縣長濱鄉	2018-11-25T01:01:04+08:00	1590	511	2101	484	2585	6484	39.87%	24.52%	11	11
8	臺東縣長濱鄉	2018-11-25T00:03:38+08:00	1590	511	2101	484	2585	6484	39.87%	24.52%	11	11
8	臺東縣長濱鄉	2018-11-24T22:43:53+08:00	1403	433	1836	414	2250	5759	39.07%	24.36%	10	11
8	臺東縣長濱鄉	2018-11-24T22:35:47+08:00	1261	386	1647	353	2000	5154	38.8%	24.47%	9	11
8	臺東縣長濱鄉	2018-11-24T23:58:45+08:00	1590	511	2101	484	2585	6484	39.87%	24.52%	11	11
8	臺東縣長濱鄉	2018-11-25T00:56:16+08:00	1590	511	2101	484	2585	6484	39.87%	24.52%	11	11
8	臺東縣長濱鄉	2018-11-24T22:39:11+08:00	1403	433	1836	414	2250	5759	39.07%	24.36%	10	11
8	臺東縣長濱鄉	2018-11-25T03:31:02+08:00	1590	511	2101	484	2585	6484	39.87%	24.52%	11	11
8	屏東縣琉球鄉	2018-11-24T23:10:57+08:00	2962	827	3789	602	4391	10706	41.01%	27.67%	9	9
8	屏東縣琉球鄉	2018-11-24T23:07:19+08:00	2962	827	3789	602	4391	10706	41.01%	27.67%	9	9
8	屏東縣琉球鄉	2018-11-24T22:14:50+08:00	2962	827	3789	602	4391	10706	41.01%	27.67%	9	9
8	屏東縣琉球鄉	2018-11-25T06:17:37+08:00	2962	827	3789	602	4391	10706	41.01%	27.67%	9	9
8	屏東縣琉球鄉	2018-11-24T22:56:37+08:00	2962	827	3789	602	4391	10706	41.01%	27.67%	9	9
8	屏東縣琉球鄉	2018-11-24T22:32:19+08:00	2962	827	3789	602	4391	10706	41.01%	27.67%	9	9
8	屏東縣琉球鄉	2018-11-25T01:06:01+08:00	2962	827	3789	602	4391	10706	41.01%	27.67%	9	9
8	屏東縣琉球鄉	2018-11-24T22:53:16+08:00	2962	827	3789	602	4391	10706	41.01%	27.67%	9	9
8	屏東縣琉球鄉	2018-11-25T00:08:06+08:00	2962	827	3789	602	4391	10706	41.01%	27.67%	9	9
8	屏東縣琉球鄉	2018-11-24T22:25:26+08:00	2962	827	3789	602	4391	10706	41.01%	27.67%	9	9
8	屏東縣琉球鄉	2018-11-25T01:11:08+08:00	2962	827	3789	602	4391	10706	41.01%	27.67%	9	9
8	屏東縣琉球鄉	2018-11-24T22:40:20+08:00	2962	827	3789	602	4391	10706	41.01%	27.67%	9	9
8	屏東縣琉球鄉	2018-11-25T06:07:24+08:00	2962	827	3789	602	4391	10706	41.01%	27.67%	9	9
8	屏東縣琉球鄉	2018-11-24T23:00:18+08:00	2962	827	3789	602	4391	10706	41.01%	27.67%	9	9
8	屏東縣琉球鄉	2018-11-25T03:48:32+08:00	2962	827	3789	602	4391	10706	41.01%	27.67%	9	9
8	屏東縣琉球鄉	2018-11-24T23:29:47+08:00	2962	827	3789	602	4391	10706	41.01%	27.67%	9	9
8	屏東縣琉球鄉	2018-11-25T00:21:45+08:00	2962	827	3789	602	4391	10706	41.01%	27.67%	9	9
8	屏東縣琉球鄉	2018-11-25T03:31:00+08:00	2962	827	3789	602	4391	10706	41.01%	27.67%	9	9
8	屏東縣琉球鄉	2018-11-25T01:16:23+08:00	2962	827	3789	602	4391	10706	41.01%	27.67%	9	9
8	屏東縣琉球鄉	2018-11-25T00:56:14+08:00	2962	827	3789	602	4391	10706	41.01%	27.67%	9	9
8	屏東縣琉球鄉	2018-11-24T22:35:45+08:00	2962	827	3789	602	4391	10706	41.01%	27.67%	9	9
8	屏東縣琉球鄉	2018-11-24T23:14:42+08:00	2962	827	3789	602	4391	10706	41.01%	27.67%	9	9
8	屏東縣琉球鄉	2018-11-24T23:50:16+08:00	2962	827	3789	602	4391	10706	41.01%	27.67%	9	9
8	屏東縣琉球鄉	2018-11-24T23:37:49+08:00	2962	827	3789	602	4391	10706	41.01%	27.67%	9	9
8	屏東縣琉球鄉	2018-11-24T22:43:51+08:00	2962	827	3789	602	4391	10706	41.01%	27.67%	9	9
8	屏東縣琉球鄉	2018-11-25T06:27:56+08:00	2962	827	3789	602	4391	10706	41.01%	27.67%	9	9
8	屏東縣琉球鄉	2018-11-25T00:12:46+08:00	2962	827	3789	602	4391	10706	41.01%	27.67%	9	9
8	屏東縣琉球鄉	2018-11-24T23:54:28+08:00	2962	827	3789	602	4391	10706	41.01%	27.67%	9	9
8	屏東縣琉球鄉	2018-11-24T23:22:24+08:00	2962	827	3789	602	4391	10706	41.01%	27.67%	9	9
8	屏東縣琉球鄉	2018-11-24T22:28:41+08:00	2962	827	3789	602	4391	10706	41.01%	27.67%	9	9
8	屏東縣琉球鄉	2018-11-24T22:12:03+08:00	2962	827	3789	602	4391	10706	41.01%	27.67%	9	9
8	屏東縣琉球鄉	2018-11-24T23:33:51+08:00	2962	827	3789	602	4391	10706	41.01%	27.67%	9	9
8	屏東縣琉球鄉	2018-11-25T01:24:26+08:00	2962	827	3789	602	4391	10706	41.01%	27.67%	9	9
8	屏東縣琉球鄉	2018-11-25T03:54:42+08:00	2962	827	3789	602	4391	10706	41.01%	27.67%	9	9
8	屏東縣琉球鄉	2018-11-24T23:03:48+08:00	2962	827	3789	602	4391	10706	41.01%	27.67%	9	9
8	屏東縣琉球鄉	2018-11-24T22:49:25+08:00	2962	827	3789	602	4391	10706	41.01%	27.67%	9	9
8	屏東縣琉球鄉	2018-11-24T23:42:03+08:00	2962	827	3789	602	4391	10706	41.01%	27.67%	9	9
8	屏東縣琉球鄉	2018-11-25T04:01:30+08:00	2962	827	3789	602	4391	10706	41.01%	27.67%	9	9
8	屏東縣琉球鄉	2018-11-25T03:42:49+08:00	2962	827	3789	602	4391	10706	41.01%	27.67%	9	9
8	屏東縣琉球鄉	2018-11-24T23:46:04+08:00	2962	827	3789	602	4391	10706	41.01%	27.67%	9	9
8	屏東縣琉球鄉	2018-11-25T00:17:09+08:00	2962	827	3789	602	4391	10706	41.01%	27.67%	9	9
8	屏東縣琉球鄉	2018-11-25T06:12:37+08:00	2962	827	3789	602	4391	10706	41.01%	27.67%	9	9
8	屏東縣琉球鄉	2018-11-25T06:22:45+08:00	2962	827	3789	602	4391	10706	41.01%	27.67%	9	9
8	屏東縣琉球鄉	2018-11-24T22:21:47+08:00	2962	827	3789	602	4391	10706	41.01%	27.67%	9	9
8	屏東縣琉球鄉	2018-11-24T22:39:10+08:00	2962	827	3789	602	4391	10706	41.01%	27.67%	9	9
8	屏東縣琉球鄉	2018-11-24T23:26:08+08:00	2962	827	3789	602	4391	10706	41.01%	27.67%	9	9
8	屏東縣琉球鄉	2018-11-24T22:18:20+08:00	2962	827	3789	602	4391	10706	41.01%	27.67%	9	9
8	屏東縣琉球鄉	2018-11-25T03:37:30+08:00	2962	827	3789	602	4391	10706	41.01%	27.67%	9	9
8	屏東縣琉球鄉	2018-11-24T23:58:43+08:00	2962	827	3789	602	4391	10706	41.01%	27.67%	9	9
8	屏東縣琉球鄉	2018-11-25T00:03:36+08:00	2962	827	3789	602	4391	10706	41.01%	27.67%	9	9
8	屏東縣琉球鄉	2018-11-25T01:01:02+08:00	2962	827	3789	602	4391	10706	41.01%	27.67%	9	9
8	屏東縣琉球鄉	2018-11-24T23:18:28+08:00	2962	827	3789	602	4391	10706	41.01%	27.67%	9	9
8	臺南市東山區	2018-11-25T03:37:19+08:00	4312	1513	5825	904	6729	18471	36.43%	23.34%	23	23
8	臺南市東山區	2018-11-24T22:49:18+08:00	4312	1513	5825	874	6699	18471	36.27%	23.34%	23	23
8	臺南市東山區	2018-11-24T23:14:33+08:00	4312	1513	5825	874	6699	18471	36.27%	23.34%	23	23
8	臺南市東山區	2018-11-24T22:56:31+08:00	4312	1513	5825	874	6699	18471	36.27%	23.34%	23	23
8	臺南市東山區	2018-11-25T00:12:39+08:00	4312	1513	5825	874	6699	18471	36.27%	23.34%	23	23
8	臺南市東山區	2018-11-25T00:03:27+08:00	4312	1513	5825	874	6699	18471	36.27%	23.34%	23	23
8	臺南市東山區	2018-11-25T00:56:07+08:00	4312	1513	5825	874	6699	18471	36.27%	23.34%	23	23
8	臺南市東山區	2018-11-24T23:03:42+08:00	4312	1513	5825	874	6699	18471	36.27%	23.34%	23	23
8	臺南市東山區	2018-11-24T23:10:51+08:00	4312	1513	5825	874	6699	18471	36.27%	23.34%	23	23
8	臺南市東山區	2018-11-24T22:43:44+08:00	4312	1513	5825	874	6699	18471	36.27%	23.34%	23	23
8	臺南市東山區	2018-11-25T06:17:30+08:00	4312	1513	5825	904	6729	18471	36.43%	23.34%	23	23
8	臺南市東山區	2018-11-24T23:58:36+08:00	4312	1513	5825	874	6699	18471	36.27%	23.34%	23	23
8	臺南市東山區	2018-11-24T23:22:17+08:00	4312	1513	5825	874	6699	18471	36.27%	23.34%	23	23
8	臺南市東山區	2018-11-25T06:22:40+08:00	4312	1513	5825	904	6729	18471	36.43%	23.34%	23	23
8	臺南市東山區	2018-11-24T23:29:41+08:00	4312	1513	5825	874	6699	18471	36.27%	23.34%	23	23
8	臺南市東山區	2018-11-24T22:25:18+08:00	4312	1513	5825	874	6699	18471	36.27%	23.34%	23	23
8	臺南市東山區	2018-11-25T01:11:00+08:00	4312	1513	5825	874	6699	18471	36.27%	23.34%	23	23
8	臺南市東山區	2018-11-25T00:17:02+08:00	4312	1513	5825	874	6699	18471	36.27%	23.34%	23	23
8	臺南市東山區	2018-11-25T00:07:58+08:00	4312	1513	5825	874	6699	18471	36.27%	23.34%	23	23
8	臺南市東山區	2018-11-25T01:16:15+08:00	4312	1513	5825	874	6699	18471	36.27%	23.34%	23	23
8	臺南市東山區	2018-11-24T23:26:02+08:00	4312	1513	5825	874	6699	18471	36.27%	23.34%	23	23
8	臺南市東山區	2018-11-25T01:05:52+08:00	4312	1513	5825	874	6699	18471	36.27%	23.34%	23	23
8	臺南市東山區	2018-11-24T22:14:42+08:00	4312	1513	5825	874	6699	18471	36.27%	23.34%	23	23
8	臺南市東山區	2018-11-24T23:54:19+08:00	4312	1513	5825	874	6699	18471	36.27%	23.34%	23	23
8	臺南市東山區	2018-11-24T22:28:34+08:00	4312	1513	5825	874	6699	18471	36.27%	23.34%	23	23
8	臺南市東山區	2018-11-24T22:18:14+08:00	4108	1450	5558	822	6380	17831	35.78%	23.04%	22	23
8	臺南市東山區	2018-11-25T01:24:18+08:00	4114	1439	5553	870	6423	17370	36.98%	23.68%	22	23
8	臺南市東山區	2018-11-24T22:35:39+08:00	4312	1513	5825	874	6699	18471	36.27%	23.34%	23	23
8	臺南市東山區	2018-11-24T23:50:09+08:00	4312	1513	5825	874	6699	18471	36.27%	23.34%	23	23
8	臺南市東山區	2018-11-25T06:27:49+08:00	4312	1513	5825	904	6729	18471	36.43%	23.34%	23	23
8	臺南市東山區	2018-11-24T22:39:03+08:00	4312	1513	5825	874	6699	18471	36.27%	23.34%	23	23
8	臺南市東山區	2018-11-24T23:07:13+08:00	4312	1513	5825	874	6699	18471	36.27%	23.34%	23	23
8	臺南市東山區	2018-11-25T01:00:54+08:00	4312	1513	5825	874	6699	18471	36.27%	23.34%	23	23
8	臺南市東山區	2018-11-25T00:21:37+08:00	4312	1513	5825	874	6699	18471	36.27%	23.34%	23	23
8	臺南市東山區	2018-11-24T22:32:13+08:00	4312	1513	5825	874	6699	18471	36.27%	23.34%	23	23
8	臺南市東山區	2018-11-25T03:48:23+08:00	4312	1513	5825	904	6729	18471	36.43%	23.34%	23	23
8	臺南市東山區	2018-11-24T23:00:09+08:00	4312	1513	5825	874	6699	18471	36.27%	23.34%	23	23
8	臺南市東山區	2018-11-25T03:30:52+08:00	4312	1513	5825	904	6729	18471	36.43%	23.34%	23	23
8	臺南市東山區	2018-11-25T03:42:41+08:00	4312	1513	5825	904	6729	18471	36.43%	23.34%	23	23
8	臺南市東山區	2018-11-24T22:21:39+08:00	4108	1450	5558	822	6380	17831	35.78%	23.04%	22	23
8	臺南市東山區	2018-11-24T22:53:08+08:00	4312	1513	5825	874	6699	18471	36.27%	23.34%	23	23
8	臺南市東山區	2018-11-24T22:11:57+08:00	4312	1513	5825	874	6699	18471	36.27%	23.34%	23	23
8	臺南市東山區	2018-11-24T22:40:13+08:00	4312	1513	5825	874	6699	18471	36.27%	23.34%	23	23
8	臺南市東山區	2018-11-25T06:12:31+08:00	4312	1513	5825	904	6729	18471	36.43%	23.34%	23	23
8	臺南市東山區	2018-11-25T06:07:16+08:00	4312	1513	5825	904	6729	18471	36.43%	23.34%	23	23
8	臺南市東山區	2018-11-25T04:01:23+08:00	4312	1513	5825	904	6729	18471	36.43%	23.34%	23	23
8	臺南市東山區	2018-11-24T23:33:44+08:00	4312	1513	5825	874	6699	18471	36.27%	23.34%	23	23
8	臺南市東山區	2018-11-25T03:54:34+08:00	4312	1513	5825	904	6729	18471	36.43%	23.34%	23	23
8	臺南市東山區	2018-11-24T23:45:58+08:00	4312	1513	5825	874	6699	18471	36.27%	23.34%	23	23
8	臺南市東山區	2018-11-24T23:41:56+08:00	4312	1513	5825	874	6699	18471	36.27%	23.34%	23	23
8	臺南市東山區	2018-11-24T23:37:43+08:00	4312	1513	5825	874	6699	18471	36.27%	23.34%	23	23
8	臺南市東山區	2018-11-24T23:18:21+08:00	4312	1513	5825	874	6699	18471	36.27%	23.34%	23	23
8	屏東縣獅子鄉	2018-11-24T23:07:20+08:00	1382	314	1696	127	1823	4230	43.1%	32.67%	8	8
8	屏東縣獅子鄉	2018-11-24T23:10:57+08:00	1382	314	1696	127	1823	4230	43.1%	32.67%	8	8
8	屏東縣獅子鄉	2018-11-25T06:17:38+08:00	1382	314	1696	127	1823	4230	43.1%	32.67%	8	8
8	屏東縣獅子鄉	2018-11-24T22:14:50+08:00	894	207	1101	96	1197	2571	46.56%	34.77%	5	8
8	屏東縣獅子鄉	2018-11-24T22:56:37+08:00	1166	273	1439	113	1552	3519	44.1%	33.13%	7	8
8	屏東縣獅子鄉	2018-11-24T22:32:19+08:00	894	207	1101	96	1197	2571	46.56%	34.77%	5	8
8	屏東縣獅子鄉	2018-11-25T01:06:01+08:00	1382	314	1696	127	1823	4230	43.1%	32.67%	8	8
8	屏東縣獅子鄉	2018-11-24T22:53:16+08:00	1166	273	1439	113	1552	3519	44.1%	33.13%	7	8
8	屏東縣獅子鄉	2018-11-25T00:08:06+08:00	1382	314	1696	127	1823	4230	43.1%	32.67%	8	8
8	屏東縣獅子鄉	2018-11-24T22:25:26+08:00	894	207	1101	96	1197	2571	46.56%	34.77%	5	8
8	屏東縣獅子鄉	2018-11-24T23:29:48+08:00	1382	314	1696	127	1823	4230	43.1%	32.67%	8	8
8	屏東縣獅子鄉	2018-11-24T22:40:20+08:00	1076	249	1325	106	1431	3173	45.1%	33.91%	6	8
8	屏東縣獅子鄉	2018-11-25T06:22:46+08:00	1382	314	1696	127	1823	4230	43.1%	32.67%	8	8
8	屏東縣獅子鄉	2018-11-25T06:07:24+08:00	1382	314	1696	127	1823	4230	43.1%	32.67%	8	8
8	屏東縣獅子鄉	2018-11-24T23:00:18+08:00	1166	273	1439	113	1552	3519	44.1%	33.13%	7	8
8	屏東縣獅子鄉	2018-11-25T03:48:32+08:00	1382	314	1696	127	1823	4230	43.1%	32.67%	8	8
8	屏東縣獅子鄉	2018-11-25T03:42:50+08:00	1382	314	1696	127	1823	4230	43.1%	32.67%	8	8
8	屏東縣獅子鄉	2018-11-25T00:21:45+08:00	1382	314	1696	127	1823	4230	43.1%	32.67%	8	8
8	屏東縣獅子鄉	2018-11-25T01:11:09+08:00	1382	314	1696	127	1823	4230	43.1%	32.67%	8	8
8	屏東縣獅子鄉	2018-11-25T01:16:23+08:00	1382	314	1696	127	1823	4230	43.1%	32.67%	8	8
8	屏東縣獅子鄉	2018-11-25T03:31:01+08:00	1382	314	1696	127	1823	4230	43.1%	32.67%	8	8
8	屏東縣獅子鄉	2018-11-24T23:14:42+08:00	1382	314	1696	127	1823	4230	43.1%	32.67%	8	8
8	屏東縣獅子鄉	2018-11-24T23:50:16+08:00	1382	314	1696	127	1823	4230	43.1%	32.67%	8	8
8	屏東縣獅子鄉	2018-11-25T06:27:56+08:00	1382	314	1696	127	1823	4230	43.1%	32.67%	8	8
8	屏東縣獅子鄉	2018-11-25T00:56:15+08:00	1382	314	1696	127	1823	4230	43.1%	32.67%	8	8
8	屏東縣獅子鄉	2018-11-25T00:12:46+08:00	1382	314	1696	127	1823	4230	43.1%	32.67%	8	8
8	屏東縣獅子鄉	2018-11-24T23:54:28+08:00	1382	314	1696	127	1823	4230	43.1%	32.67%	8	8
8	屏東縣獅子鄉	2018-11-24T23:37:50+08:00	1382	314	1696	127	1823	4230	43.1%	32.67%	8	8
8	屏東縣獅子鄉	2018-11-24T23:22:24+08:00	1382	314	1696	127	1823	4230	43.1%	32.67%	8	8
8	屏東縣獅子鄉	2018-11-24T22:28:41+08:00	894	207	1101	96	1197	2571	46.56%	34.77%	5	8
8	屏東縣獅子鄉	2018-11-24T22:12:04+08:00	894	207	1101	96	1197	2571	46.56%	34.77%	5	8
8	屏東縣獅子鄉	2018-11-24T23:33:51+08:00	1382	314	1696	127	1823	4230	43.1%	32.67%	8	8
8	屏東縣獅子鄉	2018-11-25T01:24:26+08:00	1382	314	1696	127	1823	4230	43.1%	32.67%	8	8
8	屏東縣獅子鄉	2018-11-25T03:54:42+08:00	1382	314	1696	127	1823	4230	43.1%	32.67%	8	8
8	屏東縣獅子鄉	2018-11-24T23:03:48+08:00	1382	314	1696	127	1823	4230	43.1%	32.67%	8	8
8	屏東縣獅子鄉	2018-11-24T22:49:25+08:00	1166	273	1439	113	1552	3519	44.1%	33.13%	7	8
8	屏東縣獅子鄉	2018-11-24T23:42:03+08:00	1382	314	1696	127	1823	4230	43.1%	32.67%	8	8
8	屏東縣獅子鄉	2018-11-24T23:46:05+08:00	1382	314	1696	127	1823	4230	43.1%	32.67%	8	8
8	屏東縣獅子鄉	2018-11-25T04:01:31+08:00	1382	314	1696	127	1823	4230	43.1%	32.67%	8	8
8	屏東縣獅子鄉	2018-11-25T00:17:09+08:00	1382	314	1696	127	1823	4230	43.1%	32.67%	8	8
8	屏東縣獅子鄉	2018-11-25T06:12:38+08:00	1382	314	1696	127	1823	4230	43.1%	32.67%	8	8
8	屏東縣獅子鄉	2018-11-24T22:21:47+08:00	894	207	1101	96	1197	2571	46.56%	34.77%	5	8
8	屏東縣獅子鄉	2018-11-25T01:01:03+08:00	1382	314	1696	127	1823	4230	43.1%	32.67%	8	8
8	屏東縣獅子鄉	2018-11-24T22:39:10+08:00	1076	249	1325	106	1431	3173	45.1%	33.91%	6	8
8	屏東縣獅子鄉	2018-11-24T23:26:08+08:00	1382	314	1696	127	1823	4230	43.1%	32.67%	8	8
8	屏東縣獅子鄉	2018-11-24T22:35:46+08:00	1076	249	1325	106	1431	3173	45.1%	33.91%	6	8
8	屏東縣獅子鄉	2018-11-24T23:58:44+08:00	1382	314	1696	127	1823	4230	43.1%	32.67%	8	8
8	屏東縣獅子鄉	2018-11-25T00:03:36+08:00	1382	314	1696	127	1823	4230	43.1%	32.67%	8	8
8	屏東縣獅子鄉	2018-11-25T03:37:31+08:00	1382	314	1696	127	1823	4230	43.1%	32.67%	8	8
8	屏東縣獅子鄉	2018-11-24T22:18:21+08:00	894	207	1101	96	1197	2571	46.56%	34.77%	5	8
8	屏東縣獅子鄉	2018-11-24T23:18:28+08:00	1382	314	1696	127	1823	4230	43.1%	32.67%	8	8
8	屏東縣獅子鄉	2018-11-24T22:43:52+08:00	1076	249	1325	106	1431	3173	45.1%	33.91%	6	8
8	臺南市將軍區	2018-11-25T03:37:19+08:00	4896	1613	6509	743	7252	17754	40.85%	27.58%	24	24
8	臺南市將軍區	2018-11-25T00:56:08+08:00	4896	1613	6509	743	7252	17754	40.85%	27.58%	24	24
8	臺南市將軍區	2018-11-24T22:49:18+08:00	4896	1613	6509	743	7252	17754	40.85%	27.58%	24	24
8	臺南市將軍區	2018-11-24T23:14:34+08:00	4896	1613	6509	743	7252	17754	40.85%	27.58%	24	24
8	臺南市將軍區	2018-11-24T22:56:31+08:00	4896	1613	6509	743	7252	17754	40.85%	27.58%	24	24
8	臺南市將軍區	2018-11-25T00:03:27+08:00	4896	1613	6509	743	7252	17754	40.85%	27.58%	24	24
8	臺南市將軍區	2018-11-24T22:43:45+08:00	4896	1613	6509	743	7252	17754	40.85%	27.58%	24	24
8	臺南市將軍區	2018-11-24T23:03:42+08:00	4896	1613	6509	743	7252	17754	40.85%	27.58%	24	24
8	臺南市將軍區	2018-11-24T23:10:51+08:00	4896	1613	6509	743	7252	17754	40.85%	27.58%	24	24
8	臺南市將軍區	2018-11-25T06:17:30+08:00	4896	1613	6509	743	7252	17754	40.85%	27.58%	24	24
8	臺南市將軍區	2018-11-24T23:58:36+08:00	4896	1613	6509	743	7252	17754	40.85%	27.58%	24	24
8	臺南市將軍區	2018-11-24T23:22:17+08:00	4896	1613	6509	743	7252	17754	40.85%	27.58%	24	24
8	臺南市將軍區	2018-11-25T03:42:42+08:00	4896	1613	6509	743	7252	17754	40.85%	27.58%	24	24
8	臺南市將軍區	2018-11-25T06:22:40+08:00	4896	1613	6509	743	7252	17754	40.85%	27.58%	24	24
8	臺南市將軍區	2018-11-24T23:29:41+08:00	4896	1613	6509	743	7252	17754	40.85%	27.58%	24	24
8	臺南市將軍區	2018-11-24T22:25:18+08:00	4896	1613	6509	743	7252	17754	40.85%	27.58%	24	24
8	臺南市將軍區	2018-11-25T01:11:00+08:00	4896	1613	6509	743	7252	17754	40.85%	27.58%	24	24
8	臺南市將軍區	2018-11-25T00:17:02+08:00	4896	1613	6509	743	7252	17754	40.85%	27.58%	24	24
8	臺南市將軍區	2018-11-25T06:12:32+08:00	4896	1613	6509	743	7252	17754	40.85%	27.58%	24	24
8	臺南市將軍區	2018-11-25T00:12:40+08:00	4896	1613	6509	743	7252	17754	40.85%	27.58%	24	24
8	臺南市將軍區	2018-11-24T22:14:43+08:00	4896	1613	6509	743	7252	17754	40.85%	27.58%	24	24
8	臺南市將軍區	2018-11-24T23:26:02+08:00	4896	1613	6509	743	7252	17754	40.85%	27.58%	24	24
8	臺南市將軍區	2018-11-25T06:27:50+08:00	4896	1613	6509	743	7252	17754	40.85%	27.58%	24	24
8	臺南市將軍區	2018-11-25T00:07:59+08:00	4896	1613	6509	743	7252	17754	40.85%	27.58%	24	24
8	臺南市將軍區	2018-11-24T23:18:22+08:00	4896	1613	6509	743	7252	17754	40.85%	27.58%	24	24
8	臺南市將軍區	2018-11-25T01:05:53+08:00	4896	1613	6509	743	7252	17754	40.85%	27.58%	24	24
8	臺南市將軍區	2018-11-24T23:54:19+08:00	4896	1613	6509	743	7252	17754	40.85%	27.58%	24	24
8	臺南市將軍區	2018-11-24T22:28:34+08:00	4896	1613	6509	743	7252	17754	40.85%	27.58%	24	24
8	臺南市將軍區	2018-11-24T22:18:14+08:00	4896	1613	6509	743	7252	17754	40.85%	27.58%	24	24
8	臺南市將軍區	2018-11-25T01:24:18+08:00	4896	1613	6509	743	7252	17754	40.85%	27.58%	24	24
8	臺南市將軍區	2018-11-24T23:50:09+08:00	4896	1613	6509	743	7252	17754	40.85%	27.58%	24	24
8	臺南市將軍區	2018-11-24T22:39:03+08:00	4896	1613	6509	743	7252	17754	40.85%	27.58%	24	24
8	臺南市將軍區	2018-11-24T23:07:13+08:00	4896	1613	6509	743	7252	17754	40.85%	27.58%	24	24
8	臺南市將軍區	2018-11-24T22:32:13+08:00	4896	1613	6509	743	7252	17754	40.85%	27.58%	24	24
8	臺南市將軍區	2018-11-25T03:48:23+08:00	4896	1613	6509	743	7252	17754	40.85%	27.58%	24	24
8	臺南市將軍區	2018-11-25T01:00:55+08:00	4896	1613	6509	743	7252	17754	40.85%	27.58%	24	24
8	臺南市將軍區	2018-11-24T23:00:09+08:00	4896	1613	6509	743	7252	17754	40.85%	27.58%	24	24
8	臺南市將軍區	2018-11-25T00:21:38+08:00	4896	1613	6509	743	7252	17754	40.85%	27.58%	24	24
8	臺南市將軍區	2018-11-25T03:30:52+08:00	4896	1613	6509	743	7252	17754	40.85%	27.58%	24	24
8	臺南市將軍區	2018-11-25T06:07:17+08:00	4896	1613	6509	743	7252	17754	40.85%	27.58%	24	24
8	臺南市將軍區	2018-11-24T22:11:57+08:00	4896	1613	6509	743	7252	17754	40.85%	27.58%	24	24
8	臺南市將軍區	2018-11-24T22:53:09+08:00	4896	1613	6509	743	7252	17754	40.85%	27.58%	24	24
8	臺南市將軍區	2018-11-24T22:40:14+08:00	4896	1613	6509	743	7252	17754	40.85%	27.58%	24	24
8	臺南市將軍區	2018-11-25T04:01:23+08:00	4896	1613	6509	743	7252	17754	40.85%	27.58%	24	24
8	臺南市將軍區	2018-11-24T22:21:40+08:00	4896	1613	6509	743	7252	17754	40.85%	27.58%	24	24
8	臺南市將軍區	2018-11-24T23:41:57+08:00	4896	1613	6509	743	7252	17754	40.85%	27.58%	24	24
8	臺南市將軍區	2018-11-25T03:54:34+08:00	4896	1613	6509	743	7252	17754	40.85%	27.58%	24	24
8	臺南市將軍區	2018-11-25T01:16:16+08:00	4896	1613	6509	743	7252	17754	40.85%	27.58%	24	24
8	臺南市將軍區	2018-11-24T23:45:58+08:00	4896	1613	6509	743	7252	17754	40.85%	27.58%	24	24
8	臺南市將軍區	2018-11-24T22:35:40+08:00	4896	1613	6509	743	7252	17754	40.85%	27.58%	24	24
8	臺南市將軍區	2018-11-24T23:33:45+08:00	4896	1613	6509	743	7252	17754	40.85%	27.58%	24	24
8	臺南市將軍區	2018-11-24T23:37:44+08:00	4896	1613	6509	743	7252	17754	40.85%	27.58%	24	24
8	嘉義市西區	2018-11-24T23:22:27+08:00	40837	13810	54647	4670	59317	111626	53.14%	36.58%	89	96
8	嘉義市西區	2018-11-24T23:18:31+08:00	40436	13671	54107	4607	58714	110517	53.13%	36.59%	88	96
8	嘉義市西區	2018-11-24T22:49:28+08:00	35349	12092	47441	4069	51510	97323	52.93%	36.32%	78	96
8	嘉義市西區	2018-11-24T23:33:54+08:00	41356	14001	55357	4758	60115	113019	53.19%	36.59%	90	96
8	嘉義市西區	2018-11-24T22:12:06+08:00	25462	8883	34345	3018	37363	70215	53.21%	36.26%	59	96
8	嘉義市西區	2018-11-24T23:26:11+08:00	40837	13810	54647	4670	59317	111626	53.14%	36.58%	89	96
8	嘉義市西區	2018-11-24T22:28:44+08:00	32044	10990	43034	3728	46762	88591	52.78%	36.17%	72	96
8	嘉義市西區	2018-11-24T23:37:52+08:00	41356	14001	55357	4758	60115	113019	53.19%	36.59%	90	96
8	嘉義市西區	2018-11-25T03:54:46+08:00	44312	15010	59322	5095	64417	120906	53.28%	36.65%	96	96
8	嘉義市西區	2018-11-24T22:53:19+08:00	36272	12407	48679	4208	52887	99951	52.91%	36.29%	80	96
8	嘉義市西區	2018-11-24T22:21:50+08:00	29881	10350	40231	3444	43675	82888	52.69%	36.05%	68	96
8	嘉義市西區	2018-11-25T04:01:33+08:00	44312	15010	59322	5095	64417	120906	53.28%	36.65%	96	96
8	嘉義市西區	2018-11-25T00:08:09+08:00	44312	15010	59322	5095	64417	120906	53.28%	36.65%	96	96
8	嘉義市西區	2018-11-24T23:46:07+08:00	41920	14173	56093	4818	60911	114377	53.25%	36.65%	91	96
8	嘉義市西區	2018-11-25T01:11:12+08:00	44312	15010	59322	5095	64417	120906	53.28%	36.65%	96	96
8	嘉義市西區	2018-11-24T23:42:06+08:00	41356	14001	55357	4758	60115	113019	53.19%	36.59%	90	96
8	嘉義市西區	2018-11-24T23:11:00+08:00	38887	13211	52098	4501	56599	106308	53.24%	36.58%	85	96
8	嘉義市西區	2018-11-24T23:00:20+08:00	38091	12994	51085	4419	55504	104644	53.04%	36.4%	84	96
8	嘉義市西區	2018-11-24T22:25:29+08:00	31425	10807	42232	3659	45891	86962	52.77%	36.14%	71	96
8	嘉義市西區	2018-11-25T06:22:48+08:00	44312	15010	59322	5095	64417	120906	53.28%	36.65%	96	96
8	嘉義市西區	2018-11-24T23:50:19+08:00	41920	14173	56093	4818	60911	114377	53.25%	36.65%	91	96
8	嘉義市西區	2018-11-25T06:27:59+08:00	44312	15010	59322	5095	64417	120906	53.28%	36.65%	96	96
8	嘉義市西區	2018-11-25T06:17:41+08:00	44312	15010	59322	5095	64417	120906	53.28%	36.65%	96	96
8	嘉義市西區	2018-11-24T23:03:51+08:00	39211	13338	52549	4526	57075	107443	53.12%	36.49%	86	96
8	嘉義市西區	2018-11-24T22:39:13+08:00	33470	11510	44980	3899	48879	92564	52.81%	36.16%	75	96
8	嘉義市西區	2018-11-24T22:18:24+08:00	28950	10042	38992	3340	42332	80388	52.66%	36.01%	66	96
8	嘉義市西區	2018-11-25T03:37:34+08:00	44312	15010	59322	5095	64417	120906	53.28%	36.65%	96	96
8	嘉義市西區	2018-11-25T00:12:49+08:00	44312	15010	59322	5095	64417	120906	53.28%	36.65%	96	96
8	嘉義市西區	2018-11-24T23:58:47+08:00	42552	14377	56929	4905	61834	116004	53.3%	36.68%	92	96
8	嘉義市西區	2018-11-24T23:14:45+08:00	39211	13338	52549	4526	57075	107443	53.12%	36.49%	86	96
8	嘉義市西區	2018-11-24T22:56:40+08:00	36675	12531	49206	4235	53441	101018	52.9%	36.31%	81	96
8	嘉義市西區	2018-11-25T01:01:06+08:00	44312	15010	59322	5095	64417	120906	53.28%	36.65%	96	96
8	嘉義市西區	2018-11-25T01:24:29+08:00	44312	15010	59322	5095	64417	120906	53.28%	36.65%	96	96
8	嘉義市西區	2018-11-24T23:54:31+08:00	42552	14377	56929	4905	61834	116004	53.3%	36.68%	92	96
8	嘉義市西區	2018-11-24T23:07:23+08:00	38887	13211	52098	4501	56599	106308	53.24%	36.58%	85	96
8	嘉義市西區	2018-11-25T00:03:40+08:00	43907	14868	58775	5089	63864	119723	53.34%	36.67%	95	96
8	嘉義市西區	2018-11-24T22:14:53+08:00	27046	9413	36459	3113	39572	75021	52.75%	36.05%	62	96
8	嘉義市西區	2018-11-25T00:17:12+08:00	44312	15010	59322	5095	64417	120906	53.28%	36.65%	96	96
8	嘉義市西區	2018-11-24T22:32:22+08:00	32396	11154	43550	3768	47318	89720	52.74%	36.11%	73	96
8	嘉義市西區	2018-11-25T06:12:41+08:00	44312	15010	59322	5095	64417	120906	53.28%	36.65%	96	96
8	嘉義市西區	2018-11-25T01:06:04+08:00	44312	15010	59322	5095	64417	120906	53.28%	36.65%	96	96
8	嘉義市西區	2018-11-24T23:29:51+08:00	40837	13810	54647	4670	59317	111626	53.14%	36.58%	89	96
8	嘉義市西區	2018-11-24T22:40:22+08:00	34043	11691	45734	3978	49712	93924	52.93%	36.25%	76	96
8	嘉義市西區	2018-11-25T03:42:53+08:00	44312	15010	59322	5095	64417	120906	53.28%	36.65%	96	96
8	嘉義市西區	2018-11-25T00:21:48+08:00	44312	15010	59322	5095	64417	120906	53.28%	36.65%	96	96
8	嘉義市西區	2018-11-25T06:07:27+08:00	44312	15010	59322	5095	64417	120906	53.28%	36.65%	96	96
8	嘉義市西區	2018-11-25T03:48:36+08:00	44312	15010	59322	5095	64417	120906	53.28%	36.65%	96	96
8	嘉義市西區	2018-11-25T00:56:17+08:00	44312	15010	59322	5095	64417	120906	53.28%	36.65%	96	96
8	嘉義市西區	2018-11-24T22:35:48+08:00	32979	11361	44340	3856	48196	91269	52.81%	36.13%	74	96
8	嘉義市西區	2018-11-25T03:31:04+08:00	44312	15010	59322	5095	64417	120906	53.28%	36.65%	96	96
8	嘉義市西區	2018-11-25T01:16:27+08:00	44312	15010	59322	5095	64417	120906	53.28%	36.65%	96	96
8	嘉義市西區	2018-11-24T22:43:55+08:00	34740	11908	46648	4008	50656	95778	52.89%	36.27%	77	96
8	新竹市	2018-11-24T23:10:59+08:00	103210	31632	134842	8428	143270	257006	55.75%	40.16%	227	299
8	新竹市	2018-11-24T23:22:27+08:00	114743	35028	149771	9324	159095	284778	55.87%	40.29%	248	299
8	新竹市	2018-11-24T23:18:31+08:00	111890	34247	146137	9091	155228	278271	55.78%	40.21%	243	299
8	新竹市	2018-11-24T22:49:28+08:00	86176	26462	112638	7084	119722	214216	55.89%	40.23%	194	299
8	新竹市	2018-11-24T23:33:54+08:00	120821	36897	157718	9859	167577	300247	55.81%	40.24%	260	299
8	新竹市	2018-11-24T22:12:06+08:00	63772	19454	83226	5264	88490	159547	55.46%	39.97%	148	299
8	新竹市	2018-11-24T23:26:11+08:00	116247	35494	151741	9446	161187	288575	55.86%	40.28%	251	299
8	新竹市	2018-11-24T22:28:44+08:00	74541	22798	97339	6064	103403	185864	55.63%	40.11%	170	299
8	新竹市	2018-11-24T23:37:52+08:00	123938	37738	161676	10097	171773	307727	55.82%	40.28%	266	299
8	新竹市	2018-11-24T22:53:19+08:00	89238	27433	116671	7292	123963	222653	55.68%	40.08%	200	299
8	新竹市	2018-11-24T22:21:50+08:00	70780	21557	92337	5777	98114	176828	55.49%	40.03%	162	299
8	新竹市	2018-11-25T04:01:33+08:00	141640	43061	184701	11576	196277	351775	55.8%	40.26%	299	299
8	新竹市	2018-11-25T00:08:09+08:00	137151	41724	178875	11234	190109	341234	55.71%	40.19%	291	299
8	新竹市	2018-11-24T23:46:07+08:00	128651	39199	167850	10507	178357	319782	55.77%	40.23%	275	299
8	新竹市	2018-11-25T01:11:12+08:00	141640	43061	184701	11576	196277	351775	55.8%	40.26%	299	299
8	新竹市	2018-11-24T23:42:06+08:00	125605	38230	163835	10202	174037	311956	55.79%	40.26%	269	299
8	新竹市	2018-11-24T23:00:20+08:00	93584	28683	122267	7571	129838	232759	55.78%	40.21%	208	299
8	新竹市	2018-11-24T22:25:29+08:00	72153	22035	94188	5908	100096	180323	55.51%	40.01%	165	299
8	新竹市	2018-11-25T06:22:48+08:00	141640	43061	184701	11576	196277	351775	55.8%	40.26%	299	299
8	新竹市	2018-11-25T03:48:35+08:00	141640	43061	184701	11576	196277	351775	55.8%	40.26%	299	299
8	新竹市	2018-11-25T06:27:59+08:00	141640	43061	184701	11576	196277	351775	55.8%	40.26%	299	299
8	新竹市	2018-11-25T06:17:41+08:00	141640	43061	184701	11576	196277	351775	55.8%	40.26%	299	299
8	新竹市	2018-11-24T23:03:51+08:00	97861	29991	127852	7987	135839	243562	55.77%	40.18%	217	299
8	新竹市	2018-11-24T22:39:13+08:00	82060	25127	107187	6657	113844	204302	55.72%	40.17%	185	299
8	新竹市	2018-11-25T03:37:34+08:00	141640	43061	184701	11576	196277	351775	55.8%	40.26%	299	299
8	新竹市	2018-11-25T00:12:49+08:00	139488	42401	181889	11413	193302	346640	55.76%	40.24%	295	299
8	新竹市	2018-11-24T23:58:47+08:00	133797	40790	174587	10934	185521	333046	55.7%	40.17%	285	299
8	新竹市	2018-11-24T22:18:23+08:00	67254	20454	87708	5494	93202	168271	55.39%	39.97%	155	299
8	新竹市	2018-11-24T23:50:18+08:00	130359	39721	170080	10647	180727	324272	55.73%	40.2%	278	299
8	新竹市	2018-11-24T23:14:45+08:00	105733	32448	138181	8622	146803	263742	55.66%	40.09%	232	299
8	新竹市	2018-11-24T22:56:40+08:00	91351	28082	119433	7438	126871	227675	55.72%	40.12%	204	299
8	新竹市	2018-11-25T01:01:06+08:00	141640	43061	184701	11576	196277	351775	55.8%	40.26%	299	299
8	新竹市	2018-11-25T01:24:29+08:00	141640	43061	184701	11576	196277	351775	55.8%	40.26%	299	299
8	新竹市	2018-11-24T23:54:31+08:00	132232	40304	172536	10766	183302	328922	55.73%	40.2%	282	299
8	新竹市	2018-11-24T23:07:23+08:00	101288	31053	132341	8291	140632	252092	55.79%	40.18%	223	299
8	新竹市	2018-11-25T03:54:45+08:00	141640	43061	184701	11576	196277	351775	55.8%	40.26%	299	299
8	新竹市	2018-11-25T00:03:40+08:00	136571	41552	178123	11197	189320	339821	55.71%	40.19%	290	299
8	新竹市	2018-11-24T22:14:53+08:00	65277	19891	85168	5363	90531	163371	55.41%	39.96%	151	299
8	新竹市	2018-11-24T23:29:50+08:00	118233	36078	154311	9628	163939	293428	55.87%	40.29%	255	299
8	新竹市	2018-11-25T00:17:12+08:00	139488	42401	181889	11413	193302	346640	55.76%	40.24%	295	299
8	新竹市	2018-11-24T22:32:22+08:00	78254	24011	102265	6414	108679	195025	55.73%	40.13%	177	299
8	新竹市	2018-11-25T06:12:41+08:00	141640	43061	184701	11576	196277	351775	55.8%	40.26%	299	299
8	新竹市	2018-11-25T01:06:04+08:00	141640	43061	184701	11576	196277	351775	55.8%	40.26%	299	299
8	新竹市	2018-11-24T22:40:22+08:00	82952	25391	108343	6775	115118	206326	55.79%	40.2%	187	299
8	新竹市	2018-11-25T03:42:53+08:00	141640	43061	184701	11576	196277	351775	55.8%	40.26%	299	299
8	新竹市	2018-11-25T00:21:48+08:00	139987	42593	182580	11443	194023	347957	55.76%	40.23%	296	299
8	新竹市	2018-11-25T06:07:27+08:00	141640	43061	184701	11576	196277	351775	55.8%	40.26%	299	299
8	新竹市	2018-11-25T00:56:17+08:00	141640	43061	184701	11576	196277	351775	55.8%	40.26%	299	299
8	新竹市	2018-11-24T22:35:48+08:00	79238	24278	103516	6463	109979	197399	55.71%	40.14%	179	299
8	新竹市	2018-11-24T22:43:54+08:00	84377	25896	110273	6923	117196	209874	55.84%	40.2%	190	299
8	新竹市	2018-11-25T03:31:04+08:00	141640	43061	184701	11576	196277	351775	55.8%	40.26%	299	299
8	新竹市	2018-11-25T01:16:26+08:00	141640	43061	184701	11576	196277	351775	55.8%	40.26%	299	299
8	金門縣金城鎮	2018-11-24T23:26:10+08:00	9721	1925	11646	766	12412	35914	34.56%	27.07%	20	21
8	金門縣金城鎮	2018-11-24T23:10:59+08:00	9721	1925	11646	766	12412	35914	34.56%	27.07%	20	21
8	金門縣金城鎮	2018-11-24T22:49:27+08:00	9016	1796	10812	718	11530	33397	34.52%	27%	19	21
8	金門縣金城鎮	2018-11-24T23:33:53+08:00	10346	2034	12380	812	13192	37815	34.89%	27.36%	21	21
8	金門縣金城鎮	2018-11-24T22:12:06+08:00	8043	1591	9634	651	10285	29287	35.12%	27.46%	17	21
8	金門縣金城鎮	2018-11-24T22:56:39+08:00	9016	1796	10812	718	11530	33397	34.52%	27%	19	21
8	金門縣金城鎮	2018-11-24T23:22:26+08:00	9721	1925	11646	766	12412	35914	34.56%	27.07%	20	21
8	金門縣金城鎮	2018-11-24T22:28:43+08:00	8613	1693	10306	688	10994	31722	34.66%	27.15%	18	21
8	金門縣金城鎮	2018-11-24T23:18:30+08:00	9721	1925	11646	766	12412	35914	34.56%	27.07%	20	21
8	金門縣金城鎮	2018-11-24T23:37:52+08:00	10346	2034	12380	812	13192	37815	34.89%	27.36%	21	21
8	金門縣金城鎮	2018-11-25T00:17:11+08:00	10346	2034	12380	812	13192	37815	34.89%	27.36%	21	21
8	金門縣金城鎮	2018-11-24T22:32:21+08:00	8613	1693	10306	688	10994	31722	34.66%	27.15%	18	21
8	金門縣金城鎮	2018-11-24T23:46:06+08:00	10346	2034	12380	812	13192	37815	34.89%	27.36%	21	21
8	金門縣金城鎮	2018-11-24T22:21:50+08:00	8613	1693	10306	688	10994	31722	34.66%	27.15%	18	21
8	金門縣金城鎮	2018-11-24T22:53:18+08:00	9016	1796	10812	718	11530	33397	34.52%	27%	19	21
8	金門縣金城鎮	2018-11-25T00:08:08+08:00	10346	2034	12380	812	13192	37815	34.89%	27.36%	21	21
8	金門縣金城鎮	2018-11-25T04:01:32+08:00	10346	2034	12380	812	13192	37815	34.89%	27.36%	21	21
8	金門縣金城鎮	2018-11-24T22:25:28+08:00	8613	1693	10306	688	10994	31722	34.66%	27.15%	18	21
8	金門縣金城鎮	2018-11-24T23:00:20+08:00	9016	1796	10812	718	11530	33397	34.52%	27%	19	21
8	金門縣金城鎮	2018-11-25T06:22:48+08:00	10346	2034	12380	812	13192	37815	34.89%	27.36%	21	21
8	金門縣金城鎮	2018-11-25T03:48:35+08:00	10346	2034	12380	812	13192	37815	34.89%	27.36%	21	21
8	金門縣金城鎮	2018-11-24T22:40:21+08:00	8613	1693	10306	688	10994	31722	34.66%	27.15%	18	21
8	金門縣金城鎮	2018-11-24T23:14:44+08:00	9721	1925	11646	766	12412	35914	34.56%	27.07%	20	21
8	金門縣金城鎮	2018-11-25T03:37:33+08:00	10346	2034	12380	812	13192	37815	34.89%	27.36%	21	21
8	金門縣金城鎮	2018-11-24T22:18:23+08:00	8613	1693	10306	688	10994	31722	34.66%	27.15%	18	21
8	金門縣金城鎮	2018-11-24T23:50:18+08:00	10346	2034	12380	812	13192	37815	34.89%	27.36%	21	21
8	金門縣金城鎮	2018-11-24T23:58:46+08:00	10346	2034	12380	812	13192	37815	34.89%	27.36%	21	21
8	金門縣金城鎮	2018-11-25T00:12:48+08:00	10346	2034	12380	812	13192	37815	34.89%	27.36%	21	21
8	金門縣金城鎮	2018-11-24T23:03:50+08:00	9721	1925	11646	766	12412	35914	34.56%	27.07%	20	21
8	金門縣金城鎮	2018-11-24T22:39:12+08:00	8613	1693	10306	688	10994	31722	34.66%	27.15%	18	21
8	金門縣金城鎮	2018-11-25T06:27:58+08:00	10346	2034	12380	812	13192	37815	34.89%	27.36%	21	21
8	金門縣金城鎮	2018-11-25T06:17:40+08:00	10346	2034	12380	812	13192	37815	34.89%	27.36%	21	21
8	金門縣金城鎮	2018-11-24T22:14:52+08:00	8613	1693	10306	688	10994	31722	34.66%	27.15%	18	21
8	金門縣金城鎮	2018-11-25T01:24:28+08:00	10346	2034	12380	812	13192	37815	34.89%	27.36%	21	21
8	金門縣金城鎮	2018-11-25T03:54:45+08:00	10346	2034	12380	812	13192	37815	34.89%	27.36%	21	21
8	金門縣金城鎮	2018-11-24T23:07:22+08:00	9721	1925	11646	766	12412	35914	34.56%	27.07%	20	21
8	金門縣金城鎮	2018-11-24T23:54:30+08:00	10346	2034	12380	812	13192	37815	34.89%	27.36%	21	21
8	金門縣金城鎮	2018-11-25T06:12:40+08:00	10346	2034	12380	812	13192	37815	34.89%	27.36%	21	21
8	金門縣金城鎮	2018-11-24T23:29:50+08:00	9721	1925	11646	766	12412	35914	34.56%	27.07%	20	21
8	金門縣金城鎮	2018-11-24T23:42:05+08:00	10346	2034	12380	812	13192	37815	34.89%	27.36%	21	21
8	金門縣金城鎮	2018-11-25T01:06:03+08:00	10346	2034	12380	812	13192	37815	34.89%	27.36%	21	21
8	金門縣金城鎮	2018-11-25T01:11:11+08:00	10346	2034	12380	812	13192	37815	34.89%	27.36%	21	21
8	金門縣金城鎮	2018-11-25T00:21:47+08:00	10346	2034	12380	812	13192	37815	34.89%	27.36%	21	21
8	金門縣金城鎮	2018-11-25T03:42:52+08:00	10346	2034	12380	812	13192	37815	34.89%	27.36%	21	21
8	金門縣金城鎮	2018-11-25T06:07:26+08:00	10346	2034	12380	812	13192	37815	34.89%	27.36%	21	21
8	金門縣金城鎮	2018-11-25T00:56:17+08:00	10346	2034	12380	812	13192	37815	34.89%	27.36%	21	21
8	金門縣金城鎮	2018-11-24T22:43:54+08:00	9016	1796	10812	718	11530	33397	34.52%	27%	19	21
8	金門縣金城鎮	2018-11-25T03:31:03+08:00	10346	2034	12380	812	13192	37815	34.89%	27.36%	21	21
8	金門縣金城鎮	2018-11-24T22:35:47+08:00	8613	1693	10306	688	10994	31722	34.66%	27.15%	18	21
8	金門縣金城鎮	2018-11-25T01:01:05+08:00	10346	2034	12380	812	13192	37815	34.89%	27.36%	21	21
8	金門縣金城鎮	2018-11-25T01:16:26+08:00	10346	2034	12380	812	13192	37815	34.89%	27.36%	21	21
8	金門縣金城鎮	2018-11-25T00:03:39+08:00	10346	2034	12380	812	13192	37815	34.89%	27.36%	21	21
8	嘉義縣番路鄉	2018-11-24T23:07:18+08:00	3888	1102	4990	569	5559	10156	54.74%	38.28%	15	15
8	嘉義縣番路鄉	2018-11-24T22:56:36+08:00	3888	1102	4990	569	5559	10156	54.74%	38.28%	15	15
8	嘉義縣番路鄉	2018-11-25T06:17:36+08:00	3888	1102	4990	569	5559	10156	54.74%	38.28%	15	15
8	嘉義縣番路鄉	2018-11-24T23:10:56+08:00	3888	1102	4990	569	5559	10156	54.74%	38.28%	15	15
8	嘉義縣番路鄉	2018-11-25T03:37:29+08:00	3888	1102	4990	569	5559	10156	54.74%	38.28%	15	15
8	嘉義縣番路鄉	2018-11-24T22:39:09+08:00	3178	904	4082	476	4558	8365	54.49%	37.99%	14	15
8	嘉義縣番路鄉	2018-11-25T01:24:25+08:00	3888	1102	4990	569	5559	10156	54.74%	38.28%	15	15
8	嘉義縣番路鄉	2018-11-25T03:54:41+08:00	3888	1102	4990	569	5559	10156	54.74%	38.28%	15	15
8	嘉義縣番路鄉	2018-11-25T03:30:59+08:00	3888	1102	4990	569	5559	10156	54.74%	38.28%	15	15
8	嘉義縣番路鄉	2018-11-24T22:32:18+08:00	3178	904	4082	476	4558	8365	54.49%	37.99%	14	15
8	嘉義縣番路鄉	2018-11-24T23:00:17+08:00	3888	1102	4990	569	5559	10156	54.74%	38.28%	15	15
8	嘉義縣番路鄉	2018-11-25T00:21:44+08:00	3888	1102	4990	569	5559	10156	54.74%	38.28%	15	15
8	嘉義縣番路鄉	2018-11-24T23:29:46+08:00	3888	1102	4990	569	5559	10156	54.74%	38.28%	15	15
8	嘉義縣番路鄉	2018-11-25T06:07:23+08:00	3888	1102	4990	569	5559	10156	54.74%	38.28%	15	15
8	嘉義縣番路鄉	2018-11-25T04:01:29+08:00	3888	1102	4990	569	5559	10156	54.74%	38.28%	15	15
8	嘉義縣番路鄉	2018-11-25T01:11:07+08:00	3888	1102	4990	569	5559	10156	54.74%	38.28%	15	15
8	嘉義縣番路鄉	2018-11-24T22:40:19+08:00	3178	904	4082	476	4558	8365	54.49%	37.99%	14	15
8	嘉義縣番路鄉	2018-11-24T22:43:50+08:00	3178	904	4082	476	4558	8365	54.49%	37.99%	14	15
8	嘉義縣番路鄉	2018-11-25T00:56:13+08:00	3888	1102	4990	569	5559	10156	54.74%	38.28%	15	15
8	嘉義縣番路鄉	2018-11-24T23:54:27+08:00	3888	1102	4990	569	5559	10156	54.74%	38.28%	15	15
8	嘉義縣番路鄉	2018-11-24T22:35:45+08:00	3178	904	4082	476	4558	8365	54.49%	37.99%	14	15
8	嘉義縣番路鄉	2018-11-25T01:16:22+08:00	3888	1102	4990	569	5559	10156	54.74%	38.28%	15	15
8	嘉義縣番路鄉	2018-11-25T00:03:34+08:00	3888	1102	4990	569	5559	10156	54.74%	38.28%	15	15
8	嘉義縣番路鄉	2018-11-24T23:37:49+08:00	3888	1102	4990	569	5559	10156	54.74%	38.28%	15	15
8	嘉義縣番路鄉	2018-11-25T01:01:01+08:00	3888	1102	4990	569	5559	10156	54.74%	38.28%	15	15
8	嘉義縣番路鄉	2018-11-24T23:22:23+08:00	3888	1102	4990	569	5559	10156	54.74%	38.28%	15	15
8	嘉義縣番路鄉	2018-11-24T22:49:24+08:00	3178	904	4082	476	4558	8365	54.49%	37.99%	14	15
8	嘉義縣番路鄉	2018-11-24T23:03:47+08:00	3888	1102	4990	569	5559	10156	54.74%	38.28%	15	15
8	嘉義縣番路鄉	2018-11-24T22:28:40+08:00	3178	904	4082	476	4558	8365	54.49%	37.99%	14	15
8	嘉義縣番路鄉	2018-11-24T23:33:50+08:00	3888	1102	4990	569	5559	10156	54.74%	38.28%	15	15
8	嘉義縣番路鄉	2018-11-24T22:12:02+08:00	3178	904	4082	476	4558	8365	54.49%	37.99%	14	15
8	嘉義縣番路鄉	2018-11-24T23:42:02+08:00	3888	1102	4990	569	5559	10156	54.74%	38.28%	15	15
8	嘉義縣番路鄉	2018-11-25T00:08:05+08:00	3888	1102	4990	569	5559	10156	54.74%	38.28%	15	15
8	嘉義縣番路鄉	2018-11-25T03:42:48+08:00	3888	1102	4990	569	5559	10156	54.74%	38.28%	15	15
8	嘉義縣番路鄉	2018-11-24T22:53:15+08:00	3178	904	4082	476	4558	8365	54.49%	37.99%	14	15
8	嘉義縣番路鄉	2018-11-24T23:46:04+08:00	3888	1102	4990	569	5559	10156	54.74%	38.28%	15	15
8	嘉義縣番路鄉	2018-11-25T06:12:37+08:00	3888	1102	4990	569	5559	10156	54.74%	38.28%	15	15
8	嘉義縣番路鄉	2018-11-25T03:48:30+08:00	3888	1102	4990	569	5559	10156	54.74%	38.28%	15	15
8	嘉義縣番路鄉	2018-11-24T22:21:46+08:00	3178	904	4082	476	4558	8365	54.49%	37.99%	14	15
8	嘉義縣番路鄉	2018-11-24T22:25:25+08:00	3178	904	4082	476	4558	8365	54.49%	37.99%	14	15
8	嘉義縣番路鄉	2018-11-25T00:17:08+08:00	3888	1102	4990	569	5559	10156	54.74%	38.28%	15	15
8	嘉義縣番路鄉	2018-11-25T06:22:45+08:00	3888	1102	4990	569	5559	10156	54.74%	38.28%	15	15
8	嘉義縣番路鄉	2018-11-24T22:14:49+08:00	3178	904	4082	476	4558	8365	54.49%	37.99%	14	15
8	嘉義縣番路鄉	2018-11-24T22:18:20+08:00	3178	904	4082	476	4558	8365	54.49%	37.99%	14	15
8	嘉義縣番路鄉	2018-11-24T23:18:27+08:00	3888	1102	4990	569	5559	10156	54.74%	38.28%	15	15
8	嘉義縣番路鄉	2018-11-24T23:58:42+08:00	3888	1102	4990	569	5559	10156	54.74%	38.28%	15	15
8	嘉義縣番路鄉	2018-11-25T06:27:55+08:00	3888	1102	4990	569	5559	10156	54.74%	38.28%	15	15
8	嘉義縣番路鄉	2018-11-24T23:26:07+08:00	3888	1102	4990	569	5559	10156	54.74%	38.28%	15	15
8	嘉義縣番路鄉	2018-11-25T00:12:45+08:00	3888	1102	4990	569	5559	10156	54.74%	38.28%	15	15
8	嘉義縣番路鄉	2018-11-25T01:05:59+08:00	3888	1102	4990	569	5559	10156	54.74%	38.28%	15	15
8	嘉義縣番路鄉	2018-11-24T23:14:41+08:00	3888	1102	4990	569	5559	10156	54.74%	38.28%	15	15
8	嘉義縣番路鄉	2018-11-24T23:50:15+08:00	3888	1102	4990	569	5559	10156	54.74%	38.28%	15	15
8	嘉義縣溪口鄉	2018-11-24T23:07:18+08:00	2893	993	3886	636	4522	8974	50.39%	32.24%	13	17
8	嘉義縣溪口鄉	2018-11-24T22:56:36+08:00	2539	850	3389	556	3945	7935	49.72%	32%	12	17
8	嘉義縣溪口鄉	2018-11-25T01:24:24+08:00	4125	1455	5580	875	6455	13105	49.26%	31.48%	17	17
8	嘉義縣溪口鄉	2018-11-25T03:54:40+08:00	4125	1455	5580	875	6455	13105	49.26%	31.48%	17	17
8	嘉義縣溪口鄉	2018-11-25T06:17:36+08:00	4125	1455	5580	875	6455	13105	49.26%	31.48%	17	17
8	嘉義縣溪口鄉	2018-11-24T23:10:56+08:00	2893	993	3886	636	4522	8974	50.39%	32.24%	13	17
8	嘉義縣溪口鄉	2018-11-25T03:37:29+08:00	4125	1455	5580	875	6455	13105	49.26%	31.48%	17	17
8	嘉義縣溪口鄉	2018-11-24T22:39:09+08:00	2263	763	3026	490	3516	7149	49.18%	31.65%	11	17
8	嘉義縣溪口鄉	2018-11-25T03:30:59+08:00	4125	1455	5580	875	6455	13105	49.26%	31.48%	17	17
8	嘉義縣溪口鄉	2018-11-24T22:32:18+08:00	2263	763	3026	490	3516	7149	49.18%	31.65%	11	17
8	嘉義縣溪口鄉	2018-11-25T03:48:29+08:00	4125	1455	5580	875	6455	13105	49.26%	31.48%	17	17
8	嘉義縣溪口鄉	2018-11-24T23:00:17+08:00	2539	850	3389	556	3945	7935	49.72%	32%	12	17
8	嘉義縣溪口鄉	2018-11-25T06:07:22+08:00	4125	1455	5580	875	6455	13105	49.26%	31.48%	17	17
8	嘉義縣溪口鄉	2018-11-25T00:21:44+08:00	3148	1088	4236	683	4919	9977	49.3%	31.55%	14	17
8	嘉義縣溪口鄉	2018-11-24T23:29:46+08:00	2893	993	3886	636	4522	8974	50.39%	32.24%	13	17
8	嘉義縣溪口鄉	2018-11-24T22:40:18+08:00	2263	763	3026	490	3516	7149	49.18%	31.65%	11	17
8	嘉義縣溪口鄉	2018-11-25T04:01:29+08:00	4125	1455	5580	875	6455	13105	49.26%	31.48%	17	17
8	嘉義縣溪口鄉	2018-11-25T01:11:07+08:00	4125	1455	5580	875	6455	13105	49.26%	31.48%	17	17
8	嘉義縣溪口鄉	2018-11-24T23:37:48+08:00	3148	1088	4236	683	4919	9977	49.3%	31.55%	14	17
8	嘉義縣溪口鄉	2018-11-24T22:43:50+08:00	2539	850	3389	556	3945	7935	49.72%	32%	12	17
8	嘉義縣溪口鄉	2018-11-25T00:56:13+08:00	4125	1455	5580	875	6455	13105	49.26%	31.48%	17	17
8	嘉義縣溪口鄉	2018-11-24T23:54:27+08:00	3148	1088	4236	683	4919	9977	49.3%	31.55%	14	17
8	嘉義縣溪口鄉	2018-11-25T01:16:22+08:00	4125	1455	5580	875	6455	13105	49.26%	31.48%	17	17
8	嘉義縣溪口鄉	2018-11-25T00:03:34+08:00	3148	1088	4236	683	4919	9977	49.3%	31.55%	14	17
8	嘉義縣溪口鄉	2018-11-24T22:35:44+08:00	2263	763	3026	490	3516	7149	49.18%	31.65%	11	17
8	嘉義縣溪口鄉	2018-11-25T01:01:01+08:00	4125	1455	5580	875	6455	13105	49.26%	31.48%	17	17
8	嘉義縣溪口鄉	2018-11-24T23:22:23+08:00	2893	993	3886	636	4522	8974	50.39%	32.24%	13	17
8	嘉義縣溪口鄉	2018-11-24T22:49:24+08:00	2539	850	3389	556	3945	7935	49.72%	32%	12	17
8	嘉義縣溪口鄉	2018-11-24T23:03:47+08:00	2893	993	3886	636	4522	8974	50.39%	32.24%	13	17
8	嘉義縣溪口鄉	2018-11-24T22:28:40+08:00	2263	763	3026	490	3516	7149	49.18%	31.65%	11	17
8	嘉義縣溪口鄉	2018-11-24T23:33:50+08:00	3148	1088	4236	683	4919	9977	49.3%	31.55%	14	17
8	嘉義縣溪口鄉	2018-11-24T22:12:02+08:00	1795	594	2389	409	2798	5532	50.58%	32.45%	9	17
8	嘉義縣溪口鄉	2018-11-25T00:08:04+08:00	3148	1088	4236	683	4919	9977	49.3%	31.55%	14	17
8	嘉義縣溪口鄉	2018-11-24T23:42:02+08:00	3148	1088	4236	683	4919	9977	49.3%	31.55%	14	17
8	嘉義縣溪口鄉	2018-11-25T03:42:48+08:00	4125	1455	5580	875	6455	13105	49.26%	31.48%	17	17
8	嘉義縣溪口鄉	2018-11-24T22:53:15+08:00	2539	850	3389	556	3945	7935	49.72%	32%	12	17
8	嘉義縣溪口鄉	2018-11-24T23:46:03+08:00	3148	1088	4236	683	4919	9977	49.3%	31.55%	14	17
8	嘉義縣溪口鄉	2018-11-25T00:17:07+08:00	3148	1088	4236	683	4919	9977	49.3%	31.55%	14	17
8	嘉義縣溪口鄉	2018-11-24T22:21:46+08:00	2062	694	2756	432	3188	6441	49.5%	32.01%	10	17
8	嘉義縣溪口鄉	2018-11-24T22:25:25+08:00	2263	763	3026	490	3516	7149	49.18%	31.65%	11	17
8	嘉義縣溪口鄉	2018-11-25T06:22:44+08:00	4125	1455	5580	875	6455	13105	49.26%	31.48%	17	17
8	嘉義縣溪口鄉	2018-11-25T06:12:36+08:00	4125	1455	5580	875	6455	13105	49.26%	31.48%	17	17
8	嘉義縣溪口鄉	2018-11-24T23:26:06+08:00	2893	993	3886	636	4522	8974	50.39%	32.24%	13	17
8	嘉義縣溪口鄉	2018-11-24T23:18:27+08:00	2893	993	3886	636	4522	8974	50.39%	32.24%	13	17
8	嘉義縣溪口鄉	2018-11-24T23:50:14+08:00	3148	1088	4236	683	4919	9977	49.3%	31.55%	14	17
8	嘉義縣溪口鄉	2018-11-24T23:14:40+08:00	2893	993	3886	636	4522	8974	50.39%	32.24%	13	17
8	嘉義縣溪口鄉	2018-11-24T22:18:19+08:00	2062	694	2756	432	3188	6441	49.5%	32.01%	10	17
8	嘉義縣溪口鄉	2018-11-24T23:58:42+08:00	3148	1088	4236	683	4919	9977	49.3%	31.55%	14	17
8	嘉義縣溪口鄉	2018-11-25T06:27:55+08:00	4125	1455	5580	875	6455	13105	49.26%	31.48%	17	17
8	嘉義縣溪口鄉	2018-11-25T00:12:45+08:00	3148	1088	4236	683	4919	9977	49.3%	31.55%	14	17
8	嘉義縣溪口鄉	2018-11-24T22:14:48+08:00	2062	694	2756	432	3188	6441	49.5%	32.01%	10	17
8	嘉義縣溪口鄉	2018-11-25T01:05:59+08:00	4125	1455	5580	875	6455	13105	49.26%	31.48%	17	17
8	高雄市甲仙區	2018-11-24T22:49:20+08:00	1283	348	1631	172	1803	3836	47%	33.45%	6	7
8	高雄市甲仙區	2018-11-24T23:03:44+08:00	1786	515	2301	296	2597	5417	47.94%	32.97%	7	7
8	高雄市甲仙區	2018-11-24T23:58:38+08:00	1786	515	2301	296	2597	5417	47.94%	32.97%	7	7
8	高雄市甲仙區	2018-11-24T23:22:19+08:00	1786	515	2301	296	2597	5417	47.94%	32.97%	7	7
8	高雄市甲仙區	2018-11-25T03:42:44+08:00	1786	515	2301	296	2597	5417	47.94%	32.97%	7	7
8	高雄市甲仙區	2018-11-25T01:00:57+08:00	1786	515	2301	296	2597	5417	47.94%	32.97%	7	7
8	高雄市甲仙區	2018-11-24T22:53:11+08:00	1786	515	2301	296	2597	5417	47.94%	32.97%	7	7
8	高雄市甲仙區	2018-11-24T23:46:00+08:00	1786	515	2301	296	2597	5417	47.94%	32.97%	7	7
8	高雄市甲仙區	2018-11-25T00:08:01+08:00	1786	515	2301	296	2597	5417	47.94%	32.97%	7	7
8	高雄市甲仙區	2018-11-24T22:21:42+08:00	1283	348	1631	172	1803	3836	47%	33.45%	6	7
8	高雄市甲仙區	2018-11-25T06:12:33+08:00	1786	515	2301	296	2597	5417	47.94%	32.97%	7	7
8	高雄市甲仙區	2018-11-25T00:17:04+08:00	1786	515	2301	296	2597	5417	47.94%	32.97%	7	7
8	高雄市甲仙區	2018-11-24T22:25:20+08:00	1283	348	1631	172	1803	3836	47%	33.45%	6	7
8	高雄市甲仙區	2018-11-24T23:18:24+08:00	1786	515	2301	296	2597	5417	47.94%	32.97%	7	7
8	高雄市甲仙區	2018-11-25T03:54:37+08:00	1786	515	2301	296	2597	5417	47.94%	32.97%	7	7
8	高雄市甲仙區	2018-11-25T01:05:55+08:00	1786	515	2301	296	2597	5417	47.94%	32.97%	7	7
8	高雄市甲仙區	2018-11-24T23:50:11+08:00	1786	515	2301	296	2597	5417	47.94%	32.97%	7	7
8	高雄市甲仙區	2018-11-24T23:26:04+08:00	1786	515	2301	296	2597	5417	47.94%	32.97%	7	7
8	高雄市甲仙區	2018-11-24T22:14:45+08:00	1283	348	1631	172	1803	3836	47%	33.45%	6	7
8	高雄市甲仙區	2018-11-24T23:33:46+08:00	1786	515	2301	296	2597	5417	47.94%	32.97%	7	7
8	高雄市甲仙區	2018-11-25T01:24:20+08:00	1786	515	2301	296	2597	5417	47.94%	32.97%	7	7
8	高雄市甲仙區	2018-11-24T22:43:46+08:00	1283	348	1631	172	1803	3836	47%	33.45%	6	7
8	高雄市甲仙區	2018-11-25T06:17:32+08:00	1786	515	2301	296	2597	5417	47.94%	32.97%	7	7
8	高雄市甲仙區	2018-11-25T03:37:22+08:00	1786	515	2301	296	2597	5417	47.94%	32.97%	7	7
8	高雄市甲仙區	2018-11-24T23:07:15+08:00	1786	515	2301	296	2597	5417	47.94%	32.97%	7	7
8	高雄市甲仙區	2018-11-24T22:39:05+08:00	1283	348	1631	172	1803	3836	47%	33.45%	6	7
8	高雄市甲仙區	2018-11-24T23:10:53+08:00	1786	515	2301	296	2597	5417	47.94%	32.97%	7	7
8	高雄市甲仙區	2018-11-24T22:56:33+08:00	1786	515	2301	296	2597	5417	47.94%	32.97%	7	7
8	高雄市甲仙區	2018-11-24T23:14:36+08:00	1786	515	2301	296	2597	5417	47.94%	32.97%	7	7
8	高雄市甲仙區	2018-11-25T03:48:25+08:00	1786	515	2301	296	2597	5417	47.94%	32.97%	7	7
8	高雄市甲仙區	2018-11-25T03:30:55+08:00	1786	515	2301	296	2597	5417	47.94%	32.97%	7	7
8	高雄市甲仙區	2018-11-24T22:32:15+08:00	1283	348	1631	172	1803	3836	47%	33.45%	6	7
8	高雄市甲仙區	2018-11-24T22:40:15+08:00	1283	348	1631	172	1803	3836	47%	33.45%	6	7
8	高雄市甲仙區	2018-11-25T04:01:25+08:00	1786	515	2301	296	2597	5417	47.94%	32.97%	7	7
8	高雄市甲仙區	2018-11-24T22:11:59+08:00	1283	348	1631	172	1803	3836	47%	33.45%	6	7
8	高雄市甲仙區	2018-11-24T23:00:14+08:00	1786	515	2301	296	2597	5417	47.94%	32.97%	7	7
8	高雄市甲仙區	2018-11-25T06:07:19+08:00	1786	515	2301	296	2597	5417	47.94%	32.97%	7	7
8	高雄市甲仙區	2018-11-25T01:11:03+08:00	1786	515	2301	296	2597	5417	47.94%	32.97%	7	7
8	高雄市甲仙區	2018-11-24T23:29:43+08:00	1786	515	2301	296	2597	5417	47.94%	32.97%	7	7
8	高雄市甲仙區	2018-11-25T00:21:41+08:00	1786	515	2301	296	2597	5417	47.94%	32.97%	7	7
8	高雄市甲仙區	2018-11-25T06:22:42+08:00	1786	515	2301	296	2597	5417	47.94%	32.97%	7	7
8	高雄市甲仙區	2018-11-24T22:28:36+08:00	1283	348	1631	172	1803	3836	47%	33.45%	6	7
8	高雄市甲仙區	2018-11-25T00:56:10+08:00	1786	515	2301	296	2597	5417	47.94%	32.97%	7	7
8	高雄市甲仙區	2018-11-24T22:18:16+08:00	1283	348	1631	172	1803	3836	47%	33.45%	6	7
8	高雄市甲仙區	2018-11-24T23:54:24+08:00	1786	515	2301	296	2597	5417	47.94%	32.97%	7	7
8	高雄市甲仙區	2018-11-24T22:35:41+08:00	1283	348	1631	172	1803	3836	47%	33.45%	6	7
8	高雄市甲仙區	2018-11-25T01:16:18+08:00	1786	515	2301	296	2597	5417	47.94%	32.97%	7	7
8	高雄市甲仙區	2018-11-24T23:37:45+08:00	1786	515	2301	296	2597	5417	47.94%	32.97%	7	7
8	高雄市甲仙區	2018-11-24T23:41:58+08:00	1786	515	2301	296	2597	5417	47.94%	32.97%	7	7
8	高雄市甲仙區	2018-11-25T06:27:52+08:00	1786	515	2301	296	2597	5417	47.94%	32.97%	7	7
8	高雄市甲仙區	2018-11-25T00:12:42+08:00	1786	515	2301	296	2597	5417	47.94%	32.97%	7	7
8	高雄市甲仙區	2018-11-25T00:03:30+08:00	1786	515	2301	296	2597	5417	47.94%	32.97%	7	7
8	高雄市阿蓮區	2018-11-24T22:49:20+08:00	8896	3061	11957	944	12901	24534	52.58%	36.26%	21	21
8	高雄市阿蓮區	2018-11-25T03:37:21+08:00	8896	3061	11957	944	12901	24534	52.58%	36.26%	21	21
8	高雄市阿蓮區	2018-11-24T23:03:44+08:00	8896	3061	11957	944	12901	24534	52.58%	36.26%	21	21
8	高雄市阿蓮區	2018-11-25T00:03:29+08:00	8896	3061	11957	944	12901	24534	52.58%	36.26%	21	21
8	高雄市阿蓮區	2018-11-25T00:56:09+08:00	8896	3061	11957	944	12901	24534	52.58%	36.26%	21	21
8	高雄市阿蓮區	2018-11-24T23:58:38+08:00	8896	3061	11957	944	12901	24534	52.58%	36.26%	21	21
8	高雄市阿蓮區	2018-11-24T23:22:19+08:00	8896	3061	11957	944	12901	24534	52.58%	36.26%	21	21
8	高雄市阿蓮區	2018-11-25T03:42:44+08:00	8896	3061	11957	944	12901	24534	52.58%	36.26%	21	21
8	高雄市阿蓮區	2018-11-24T22:53:10+08:00	8896	3061	11957	944	12901	24534	52.58%	36.26%	21	21
8	高雄市阿蓮區	2018-11-25T01:00:57+08:00	8896	3061	11957	944	12901	24534	52.58%	36.26%	21	21
8	高雄市阿蓮區	2018-11-25T00:08:00+08:00	8896	3061	11957	944	12901	24534	52.58%	36.26%	21	21
8	高雄市阿蓮區	2018-11-24T23:46:00+08:00	8896	3061	11957	944	12901	24534	52.58%	36.26%	21	21
8	高雄市阿蓮區	2018-11-24T22:21:42+08:00	8896	3061	11957	944	12901	24534	52.58%	36.26%	21	21
8	高雄市阿蓮區	2018-11-25T06:12:33+08:00	8896	3061	11957	944	12901	24534	52.58%	36.26%	21	21
8	高雄市阿蓮區	2018-11-25T00:17:04+08:00	8896	3061	11957	944	12901	24534	52.58%	36.26%	21	21
8	高雄市阿蓮區	2018-11-25T06:22:41+08:00	8896	3061	11957	944	12901	24534	52.58%	36.26%	21	21
8	高雄市阿蓮區	2018-11-24T22:25:20+08:00	8896	3061	11957	944	12901	24534	52.58%	36.26%	21	21
8	高雄市阿蓮區	2018-11-24T23:18:23+08:00	8896	3061	11957	944	12901	24534	52.58%	36.26%	21	21
8	高雄市阿蓮區	2018-11-24T23:50:11+08:00	8896	3061	11957	944	12901	24534	52.58%	36.26%	21	21
8	高雄市阿蓮區	2018-11-25T01:05:54+08:00	8896	3061	11957	944	12901	24534	52.58%	36.26%	21	21
8	高雄市阿蓮區	2018-11-24T22:14:45+08:00	8896	3061	11957	944	12901	24534	52.58%	36.26%	21	21
8	高雄市阿蓮區	2018-11-24T23:33:46+08:00	8896	3061	11957	944	12901	24534	52.58%	36.26%	21	21
8	高雄市阿蓮區	2018-11-25T06:27:51+08:00	8896	3061	11957	944	12901	24534	52.58%	36.26%	21	21
8	高雄市阿蓮區	2018-11-24T23:26:03+08:00	8896	3061	11957	944	12901	24534	52.58%	36.26%	21	21
8	高雄市阿蓮區	2018-11-25T03:54:36+08:00	8896	3061	11957	944	12901	24534	52.58%	36.26%	21	21
8	高雄市阿蓮區	2018-11-25T00:12:41+08:00	8896	3061	11957	944	12901	24534	52.58%	36.26%	21	21
8	高雄市阿蓮區	2018-11-25T01:24:20+08:00	8896	3061	11957	944	12901	24534	52.58%	36.26%	21	21
8	高雄市阿蓮區	2018-11-24T22:43:46+08:00	8896	3061	11957	944	12901	24534	52.58%	36.26%	21	21
8	高雄市阿蓮區	2018-11-25T06:17:32+08:00	8896	3061	11957	944	12901	24534	52.58%	36.26%	21	21
8	高雄市阿蓮區	2018-11-24T23:07:15+08:00	8896	3061	11957	944	12901	24534	52.58%	36.26%	21	21
8	高雄市阿蓮區	2018-11-24T22:39:05+08:00	8896	3061	11957	944	12901	24534	52.58%	36.26%	21	21
8	高雄市阿蓮區	2018-11-24T22:56:33+08:00	8896	3061	11957	944	12901	24534	52.58%	36.26%	21	21
8	高雄市阿蓮區	2018-11-24T23:14:36+08:00	8896	3061	11957	944	12901	24534	52.58%	36.26%	21	21
8	高雄市阿蓮區	2018-11-24T23:10:52+08:00	8896	3061	11957	944	12901	24534	52.58%	36.26%	21	21
8	高雄市阿蓮區	2018-11-25T03:48:25+08:00	8896	3061	11957	944	12901	24534	52.58%	36.26%	21	21
8	高雄市阿蓮區	2018-11-24T22:32:14+08:00	8896	3061	11957	944	12901	24534	52.58%	36.26%	21	21
8	高雄市阿蓮區	2018-11-25T03:30:54+08:00	8896	3061	11957	944	12901	24534	52.58%	36.26%	21	21
8	高雄市阿蓮區	2018-11-24T22:40:15+08:00	8896	3061	11957	944	12901	24534	52.58%	36.26%	21	21
8	高雄市阿蓮區	2018-11-25T00:21:40+08:00	8896	3061	11957	944	12901	24534	52.58%	36.26%	21	21
8	高雄市阿蓮區	2018-11-24T23:29:42+08:00	8896	3061	11957	944	12901	24534	52.58%	36.26%	21	21
8	高雄市阿蓮區	2018-11-25T01:11:02+08:00	8896	3061	11957	944	12901	24534	52.58%	36.26%	21	21
8	高雄市阿蓮區	2018-11-24T22:11:59+08:00	8309	2864	11173	897	12070	22819	52.89%	36.41%	20	21
8	高雄市阿蓮區	2018-11-24T23:00:14+08:00	8896	3061	11957	944	12901	24534	52.58%	36.26%	21	21
8	高雄市阿蓮區	2018-11-25T06:07:19+08:00	8896	3061	11957	944	12901	24534	52.58%	36.26%	21	21
8	高雄市阿蓮區	2018-11-25T04:01:24+08:00	8896	3061	11957	944	12901	24534	52.58%	36.26%	21	21
8	高雄市阿蓮區	2018-11-24T22:28:36+08:00	8896	3061	11957	944	12901	24534	52.58%	36.26%	21	21
8	高雄市阿蓮區	2018-11-24T22:18:16+08:00	8896	3061	11957	944	12901	24534	52.58%	36.26%	21	21
8	高雄市阿蓮區	2018-11-24T23:54:23+08:00	8896	3061	11957	944	12901	24534	52.58%	36.26%	21	21
8	高雄市阿蓮區	2018-11-24T22:35:41+08:00	8896	3061	11957	944	12901	24534	52.58%	36.26%	21	21
8	高雄市阿蓮區	2018-11-24T23:37:45+08:00	8896	3061	11957	944	12901	24534	52.58%	36.26%	21	21
8	高雄市阿蓮區	2018-11-24T23:41:58+08:00	8896	3061	11957	944	12901	24534	52.58%	36.26%	21	21
8	高雄市阿蓮區	2018-11-25T01:16:17+08:00	8896	3061	11957	944	12901	24534	52.58%	36.26%	21	21
8	臺南市關廟區	2018-11-25T00:56:08+08:00	10370	3637	14007	1315	15322	29913	51.22%	34.67%	32	32
8	臺南市關廟區	2018-11-24T23:14:34+08:00	10370	3637	14007	1315	15322	29913	51.22%	34.67%	32	32
8	臺南市關廟區	2018-11-24T23:03:43+08:00	10370	3637	14007	1315	15322	29913	51.22%	34.67%	32	32
8	臺南市關廟區	2018-11-25T06:17:31+08:00	10370	3637	14007	1315	15322	29913	51.22%	34.67%	32	32
8	臺南市關廟區	2018-11-24T23:22:18+08:00	10370	3637	14007	1315	15322	29913	51.22%	34.67%	32	32
8	臺南市關廟區	2018-11-24T22:43:45+08:00	10370	3637	14007	1315	15322	29913	51.22%	34.67%	32	32
8	臺南市關廟區	2018-11-25T03:37:20+08:00	10370	3637	14007	1315	15322	29913	51.22%	34.67%	32	32
8	臺南市關廟區	2018-11-24T22:49:19+08:00	10370	3637	14007	1315	15322	29913	51.22%	34.67%	32	32
8	臺南市關廟區	2018-11-25T00:03:28+08:00	10370	3637	14007	1315	15322	29913	51.22%	34.67%	32	32
8	臺南市關廟區	2018-11-24T23:58:36+08:00	10370	3637	14007	1315	15322	29913	51.22%	34.67%	32	32
8	臺南市關廟區	2018-11-25T03:42:42+08:00	10370	3637	14007	1315	15322	29913	51.22%	34.67%	32	32
8	臺南市關廟區	2018-11-24T22:25:19+08:00	10370	3637	14007	1315	15322	29913	51.22%	34.67%	32	32
8	臺南市關廟區	2018-11-25T06:22:40+08:00	10370	3637	14007	1315	15322	29913	51.22%	34.67%	32	32
8	臺南市關廟區	2018-11-25T00:17:03+08:00	10370	3637	14007	1315	15322	29913	51.22%	34.67%	32	32
8	臺南市關廟區	2018-11-25T01:11:01+08:00	10370	3637	14007	1315	15322	29913	51.22%	34.67%	32	32
8	臺南市關廟區	2018-11-24T23:29:41+08:00	10370	3637	14007	1315	15322	29913	51.22%	34.67%	32	32
8	臺南市關廟區	2018-11-25T06:12:32+08:00	10370	3637	14007	1315	15322	29913	51.22%	34.67%	32	32
8	臺南市關廟區	2018-11-24T23:50:10+08:00	10370	3637	14007	1315	15322	29913	51.22%	34.67%	32	32
8	臺南市關廟區	2018-11-25T00:12:40+08:00	10370	3637	14007	1315	15322	29913	51.22%	34.67%	32	32
8	臺南市關廟區	2018-11-24T22:28:35+08:00	10370	3637	14007	1315	15322	29913	51.22%	34.67%	32	32
8	臺南市關廟區	2018-11-24T22:14:43+08:00	10370	3637	14007	1315	15322	29913	51.22%	34.67%	32	32
8	臺南市關廟區	2018-11-24T23:26:02+08:00	10370	3637	14007	1315	15322	29913	51.22%	34.67%	32	32
8	臺南市關廟區	2018-11-24T23:54:20+08:00	10370	3637	14007	1315	15322	29913	51.22%	34.67%	32	32
8	臺南市關廟區	2018-11-25T06:27:50+08:00	10370	3637	14007	1315	15322	29913	51.22%	34.67%	32	32
8	臺南市關廟區	2018-11-25T00:07:59+08:00	10370	3637	14007	1315	15322	29913	51.22%	34.67%	32	32
8	臺南市關廟區	2018-11-24T23:18:22+08:00	10370	3637	14007	1315	15322	29913	51.22%	34.67%	32	32
8	臺南市關廟區	2018-11-25T01:05:53+08:00	10370	3637	14007	1315	15322	29913	51.22%	34.67%	32	32
8	臺南市關廟區	2018-11-24T22:18:14+08:00	10370	3637	14007	1315	15322	29913	51.22%	34.67%	32	32
8	臺南市關廟區	2018-11-24T22:56:32+08:00	10370	3637	14007	1315	15322	29913	51.22%	34.67%	32	32
8	臺南市關廟區	2018-11-25T01:24:19+08:00	10370	3637	14007	1315	15322	29913	51.22%	34.67%	32	32
8	臺南市關廟區	2018-11-24T22:39:04+08:00	10370	3637	14007	1315	15322	29913	51.22%	34.67%	32	32
8	臺南市關廟區	2018-11-24T23:10:52+08:00	10370	3637	14007	1315	15322	29913	51.22%	34.67%	32	32
8	臺南市關廟區	2018-11-24T23:07:14+08:00	10370	3637	14007	1315	15322	29913	51.22%	34.67%	32	32
8	臺南市關廟區	2018-11-25T00:21:39+08:00	10370	3637	14007	1315	15322	29913	51.22%	34.67%	32	32
8	臺南市關廟區	2018-11-24T22:32:13+08:00	10370	3637	14007	1315	15322	29913	51.22%	34.67%	32	32
8	臺南市關廟區	2018-11-25T03:30:53+08:00	10370	3637	14007	1315	15322	29913	51.22%	34.67%	32	32
8	臺南市關廟區	2018-11-25T03:48:24+08:00	10370	3637	14007	1315	15322	29913	51.22%	34.67%	32	32
8	臺南市關廟區	2018-11-25T01:00:55+08:00	10370	3637	14007	1315	15322	29913	51.22%	34.67%	32	32
8	臺南市關廟區	2018-11-24T23:00:13+08:00	10370	3637	14007	1315	15322	29913	51.22%	34.67%	32	32
8	臺南市關廟區	2018-11-25T06:07:17+08:00	10370	3637	14007	1315	15322	29913	51.22%	34.67%	32	32
8	臺南市關廟區	2018-11-24T22:53:09+08:00	10370	3637	14007	1315	15322	29913	51.22%	34.67%	32	32
8	臺南市關廟區	2018-11-24T22:40:14+08:00	10370	3637	14007	1315	15322	29913	51.22%	34.67%	32	32
8	臺南市關廟區	2018-11-24T22:11:58+08:00	10370	3637	14007	1315	15322	29913	51.22%	34.67%	32	32
8	臺南市關廟區	2018-11-25T04:01:23+08:00	10370	3637	14007	1315	15322	29913	51.22%	34.67%	32	32
8	臺南市關廟區	2018-11-24T22:21:40+08:00	10370	3637	14007	1315	15322	29913	51.22%	34.67%	32	32
8	臺南市關廟區	2018-11-24T23:41:57+08:00	10370	3637	14007	1315	15322	29913	51.22%	34.67%	32	32
8	臺南市關廟區	2018-11-25T01:16:16+08:00	10370	3637	14007	1315	15322	29913	51.22%	34.67%	32	32
8	臺南市關廟區	2018-11-24T22:35:40+08:00	10370	3637	14007	1315	15322	29913	51.22%	34.67%	32	32
8	臺南市關廟區	2018-11-25T03:54:35+08:00	10370	3637	14007	1315	15322	29913	51.22%	34.67%	32	32
8	臺南市關廟區	2018-11-24T23:33:45+08:00	10370	3637	14007	1315	15322	29913	51.22%	34.67%	32	32
8	臺南市關廟區	2018-11-24T23:37:44+08:00	10370	3637	14007	1315	15322	29913	51.22%	34.67%	32	32
8	臺南市關廟區	2018-11-24T23:45:59+08:00	10370	3637	14007	1315	15322	29913	51.22%	34.67%	32	32
8	臺北市中正區	2018-11-24T23:07:11+08:00	36808	12543	49351	3360	52711	91749	57.45%	40.12%	70	96
8	臺北市中正區	2018-11-25T01:05:49+08:00	51892	17351	69243	4648	73891	128292	57.6%	40.45%	96	96
8	臺北市中正區	2018-11-24T22:49:16+08:00	32129	10895	43024	2971	45995	80298	57.28%	40.01%	62	96
8	臺北市中正區	2018-11-24T22:43:42+08:00	31496	10675	42171	2919	45090	78747	57.26%	40%	61	96
8	臺北市中正區	2018-11-25T01:10:56+08:00	51892	17351	69243	4648	73891	128292	57.6%	40.45%	96	96
8	臺北市中正區	2018-11-24T22:39:00+08:00	29753	10060	39813	2752	42565	74325	57.27%	40.03%	58	96
8	臺北市中正區	2018-11-25T03:37:16+08:00	51892	17351	69243	4648	73891	128292	57.6%	40.45%	96	96
8	臺北市中正區	2018-11-25T01:10:57+08:00	51892	17351	69243	4648	73891	128292	57.6%	40.45%	96	96
8	臺北市中正區	2018-11-24T23:50:04+08:00	41983	14155	56138	3796	59934	104024	57.62%	40.36%	79	96
8	臺北市中正區	2018-11-25T01:24:14+08:00	51892	17351	69243	4648	73891	128292	57.6%	40.45%	96	96
8	臺北市中正區	2018-11-25T00:12:36+08:00	46409	15684	62093	4217	66310	115357	57.48%	40.23%	87	96
8	臺北市中正區	2018-11-24T22:32:10+08:00	28498	9651	38149	2628	40777	71384	57.12%	39.92%	56	96
8	臺北市中正區	2018-11-24T23:29:38+08:00	40268	13597	53865	3618	57483	99863	57.56%	40.32%	76	96
8	臺北市中正區	2018-11-25T03:48:19+08:00	51892	17351	69243	4648	73891	128292	57.6%	40.45%	96	96
8	臺北市中正區	2018-11-25T06:22:36+08:00	51892	17351	69243	4648	73891	128292	57.6%	40.45%	96	96
8	臺北市中正區	2018-11-25T06:12:29+08:00	51892	17351	69243	4648	73891	128292	57.6%	40.45%	96	96
8	臺北市中正區	2018-11-25T00:21:35+08:00	48197	16295	64492	4407	68899	119771	57.53%	40.24%	90	96
8	臺北市中正區	2018-11-24T23:00:03+08:00	32588	11069	43657	3018	46675	81481	57.28%	39.99%	63	96
8	臺北市中正區	2018-11-25T03:48:20+08:00	51892	17351	69243	4648	73891	128292	57.6%	40.45%	96	96
8	臺北市中正區	2018-11-24T23:25:59+08:00	40268	13597	53865	3618	57483	99863	57.56%	40.32%	76	96
8	臺北市中正區	2018-11-24T23:29:39+08:00	40268	13597	53865	3618	57483	99863	57.56%	40.32%	76	96
8	臺北市中正區	2018-11-24T23:00:04+08:00	32588	11069	43657	3018	46675	81481	57.28%	39.99%	63	96
8	臺北市中正區	2018-11-25T01:00:51+08:00	51892	17351	69243	4648	73891	128292	57.6%	40.45%	96	96
8	臺北市中正區	2018-11-25T06:07:14+08:00	51892	17351	69243	4648	73891	128292	57.6%	40.45%	96	96
8	臺北市中正區	2018-11-24T22:53:05+08:00	32129	10895	43024	2971	45995	80298	57.28%	40.01%	62	96
8	臺北市中正區	2018-11-24T22:40:11+08:00	31496	10675	42171	2919	45090	78747	57.26%	40%	61	96
8	臺北市中正區	2018-11-24T22:25:16+08:00	28018	9475	37493	2583	40076	70215	57.08%	39.9%	55	96
8	臺北市中正區	2018-11-24T22:11:55+08:00	23112	7793	30905	2094	32999	58267	56.63%	39.67%	46	96
8	臺北市中正區	2018-11-25T04:01:20+08:00	51892	17351	69243	4648	73891	128292	57.6%	40.45%	96	96
8	臺北市中正區	2018-11-25T01:16:12+08:00	51892	17351	69243	4648	73891	128292	57.6%	40.45%	96	96
8	臺北市中正區	2018-11-25T00:07:56+08:00	46409	15684	62093	4217	66310	115357	57.48%	40.23%	87	96
8	臺北市中正區	2018-11-24T23:37:41+08:00	41406	13958	55364	3744	59108	102666	57.57%	40.33%	78	96
8	臺北市中正區	2018-11-24T23:41:54+08:00	41406	13958	55364	3744	59108	102666	57.57%	40.33%	78	96
8	臺北市中正區	2018-11-24T22:28:32+08:00	28498	9651	38149	2628	40777	71384	57.12%	39.92%	56	96
8	臺北市中正區	2018-11-25T01:16:13+08:00	51892	17351	69243	4648	73891	128292	57.6%	40.45%	96	96
8	臺北市中正區	2018-11-25T03:54:31+08:00	51892	17351	69243	4648	73891	128292	57.6%	40.45%	96	96
8	臺北市中正區	2018-11-24T23:33:41+08:00	41406	13958	55364	3744	59108	102666	57.57%	40.33%	78	96
8	臺北市中正區	2018-11-24T23:54:17+08:00	42463	14322	56785	3835	60620	105225	57.61%	40.35%	80	96
8	臺北市中正區	2018-11-25T00:03:24+08:00	45883	15486	61369	4168	65537	114047	57.46%	40.23%	86	96
8	臺北市中正區	2018-11-24T22:35:36+08:00	29753	10060	39813	2752	42565	74325	57.27%	40.03%	58	96
8	臺北市中正區	2018-11-25T00:16:59+08:00	46409	15684	62093	4217	66310	115357	57.48%	40.23%	87	96
8	臺北市中正區	2018-11-24T23:58:33+08:00	45883	15486	61369	4168	65537	114047	57.46%	40.23%	86	96
8	臺北市中正區	2018-11-24T22:14:39+08:00	24718	8391	33109	2249	35358	62229	56.82%	39.72%	49	96
8	臺北市中正區	2018-11-24T22:43:41+08:00	31496	10675	42171	2919	45090	78747	57.26%	40%	61	96
8	臺北市中正區	2018-11-25T06:27:46+08:00	51892	17351	69243	4648	73891	128292	57.6%	40.45%	96	96
8	臺北市中正區	2018-11-24T23:03:40+08:00	35509	12128	47637	3271	50908	88644	57.43%	40.06%	68	96
8	臺北市中正區	2018-11-24T23:14:30+08:00	38962	13251	52213	3521	55734	96989	57.46%	40.17%	74	96
8	臺北市中正區	2018-11-24T23:22:14+08:00	40268	13597	53865	3618	57483	99863	57.56%	40.32%	76	96
8	臺北市中正區	2018-11-24T23:58:32+08:00	45883	15486	61369	4168	65537	114047	57.46%	40.23%	86	96
8	臺北市中正區	2018-11-25T03:37:15+08:00	51892	17351	69243	4648	73891	128292	57.6%	40.45%	96	96
8	臺北市中正區	2018-11-25T00:56:03+08:00	51892	17351	69243	4648	73891	128292	57.6%	40.45%	96	96
8	臺北市中正區	2018-11-25T00:56:04+08:00	51892	17351	69243	4648	73891	128292	57.6%	40.45%	96	96
8	臺北市中正區	2018-11-24T23:14:31+08:00	38962	13251	52213	3521	55734	96989	57.46%	40.17%	74	96
8	臺北市中正區	2018-11-25T06:27:47+08:00	51892	17351	69243	4648	73891	128292	57.6%	40.45%	96	96
8	臺北市中正區	2018-11-24T22:21:36+08:00	27441	9288	36729	2520	39249	68804	57.04%	39.88%	54	96
8	臺北市中正區	2018-11-25T00:17:00+08:00	46409	15684	62093	4217	66310	115357	57.48%	40.23%	87	96
8	臺北市中正區	2018-11-25T03:42:37+08:00	51892	17351	69243	4648	73891	128292	57.6%	40.45%	96	96
8	臺北市中正區	2018-11-25T03:30:49+08:00	51892	17351	69243	4648	73891	128292	57.6%	40.45%	96	96
8	臺北市中正區	2018-11-25T03:42:36+08:00	51892	17351	69243	4648	73891	128292	57.6%	40.45%	96	96
8	臺北市中正區	2018-11-24T22:25:15+08:00	28018	9475	37493	2583	40076	70215	57.08%	39.9%	55	96
8	臺北市中正區	2018-11-24T22:18:11+08:00	25557	8712	34269	2319	36588	64325	56.88%	39.73%	51	96
8	臺北市中正區	2018-11-24T22:28:31+08:00	28498	9651	38149	2628	40777	71384	57.12%	39.92%	56	96
8	臺北市中正區	2018-11-24T23:10:48+08:00	38432	13075	51507	3481	54988	95643	57.49%	40.18%	73	96
8	臺北市中正區	2018-11-24T22:14:40+08:00	24718	8391	33109	2249	35358	62229	56.82%	39.72%	49	96
8	臺北市中正區	2018-11-25T06:17:27+08:00	51892	17351	69243	4648	73891	128292	57.6%	40.45%	96	96
8	臺北市中正區	2018-11-24T22:56:29+08:00	32588	11069	43657	3018	46675	81481	57.28%	39.99%	63	96
8	臺北市中正區	2018-11-24T23:18:18+08:00	39627	13407	53034	3558	56592	98419	57.5%	40.26%	75	96
8	臺北市中正區	2018-11-24T23:45:56+08:00	41983	14155	56138	3796	59934	104024	57.62%	40.36%	79	96
8	臺北市中正區	2018-11-24T23:03:39+08:00	35509	12128	47637	3271	50908	88644	57.43%	40.06%	68	96
8	臺北市中正區	2018-11-25T00:07:55+08:00	46409	15684	62093	4217	66310	115357	57.48%	40.23%	87	96
8	臺北市中正區	2018-11-24T23:33:42+08:00	41406	13958	55364	3744	59108	102666	57.57%	40.33%	78	96
8	臺北市中正區	2018-11-24T23:10:49+08:00	38432	13075	51507	3481	54988	95643	57.49%	40.18%	73	96
8	臺北市中正區	2018-11-25T03:54:32+08:00	51892	17351	69243	4648	73891	128292	57.6%	40.45%	96	96
8	臺北市中正區	2018-11-24T23:18:19+08:00	39627	13407	53034	3558	56592	98419	57.5%	40.26%	75	96
8	臺中市潭子區	2018-11-24T23:10:50+08:00	31549	8869	40418	2876	43294	75755	57.15%	41.65%	47	55
8	臺中市潭子區	2018-11-25T00:56:06+08:00	37158	10407	47565	3331	50896	89487	56.88%	41.52%	55	55
8	臺中市潭子區	2018-11-24T23:14:33+08:00	32311	9102	41413	2962	44375	77758	57.07%	41.55%	48	55
8	臺中市潭子區	2018-11-24T23:22:16+08:00	33206	9347	42553	3063	45616	79805	57.16%	41.61%	49	55
8	臺中市潭子區	2018-11-24T22:56:31+08:00	28767	8118	36885	2634	39519	69114	57.18%	41.62%	43	55
8	臺中市潭子區	2018-11-25T00:12:39+08:00	37158	10407	47565	3331	50896	89487	56.88%	41.52%	55	55
8	臺中市潭子區	2018-11-24T22:49:17+08:00	28107	7928	36035	2564	38599	67370	57.29%	41.72%	42	55
8	臺中市潭子區	2018-11-25T03:37:18+08:00	37158	10407	47565	3331	50896	89487	56.88%	41.52%	55	55
8	臺中市潭子區	2018-11-24T22:43:44+08:00	25771	7320	33091	2330	35421	61813	57.3%	41.69%	39	55
8	臺中市潭子區	2018-11-25T00:03:26+08:00	36523	10253	46776	3283	50059	87902	56.95%	41.55%	54	55
8	臺中市潭子區	2018-11-25T01:10:59+08:00	37158	10407	47565	3331	50896	89487	56.88%	41.52%	55	55
8	臺中市潭子區	2018-11-25T06:22:39+08:00	37158	10407	47565	3331	50896	89487	56.88%	41.52%	55	55
8	臺中市潭子區	2018-11-25T03:30:51+08:00	37158	10407	47565	3331	50896	89487	56.88%	41.52%	55	55
8	臺中市潭子區	2018-11-24T22:25:17+08:00	21486	6189	27675	2009	29684	51864	57.23%	41.43%	33	55
8	臺中市潭子區	2018-11-24T23:29:40+08:00	33206	9347	42553	3063	45616	79805	57.16%	41.61%	49	55
8	臺中市潭子區	2018-11-25T01:16:15+08:00	37158	10407	47565	3331	50896	89487	56.88%	41.52%	55	55
8	臺中市潭子區	2018-11-24T23:54:18+08:00	35095	9893	44988	3181	48169	84399	57.07%	41.58%	52	55
8	臺中市潭子區	2018-11-25T00:07:57+08:00	36523	10253	46776	3283	50059	87902	56.95%	41.55%	54	55
8	臺中市潭子區	2018-11-24T22:14:42+08:00	19434	5621	25055	1801	26856	46838	57.34%	41.49%	30	55
8	臺中市潭子區	2018-11-24T22:18:13+08:00	19434	5621	25055	1801	26856	46838	57.34%	41.49%	30	55
8	臺中市潭子區	2018-11-24T22:28:33+08:00	23002	6563	29565	2111	31676	55301	57.28%	41.59%	35	55
8	臺中市潭子區	2018-11-24T23:50:08+08:00	35095	9893	44988	3181	48169	84399	57.07%	41.58%	52	55
8	臺中市潭子區	2018-11-24T23:07:12+08:00	31549	8869	40418	2876	43294	75755	57.15%	41.65%	47	55
8	臺中市潭子區	2018-11-24T22:39:02+08:00	25771	7320	33091	2330	35421	61813	57.3%	41.69%	39	55
8	臺中市潭子區	2018-11-25T01:24:17+08:00	37158	10407	47565	3331	50896	89487	56.88%	41.52%	55	55
8	臺中市潭子區	2018-11-24T22:35:39+08:00	25032	7083	32115	2273	34388	60018	57.3%	41.71%	38	55
8	臺中市潭子區	2018-11-24T23:58:35+08:00	35948	10103	46051	3241	49292	86495	56.99%	41.56%	53	55
8	臺中市潭子區	2018-11-25T06:27:49+08:00	37158	10407	47565	3331	50896	89487	56.88%	41.52%	55	55
8	臺中市潭子區	2018-11-24T23:03:41+08:00	31549	8869	40418	2876	43294	75755	57.15%	41.65%	47	55
8	臺中市潭子區	2018-11-25T01:00:53+08:00	37158	10407	47565	3331	50896	89487	56.88%	41.52%	55	55
8	臺中市潭子區	2018-11-24T23:00:08+08:00	30113	8468	38581	2772	41353	72239	57.24%	41.69%	45	55
8	臺中市潭子區	2018-11-25T03:48:22+08:00	37158	10407	47565	3331	50896	89487	56.88%	41.52%	55	55
8	臺中市潭子區	2018-11-25T00:21:37+08:00	37158	10407	47565	3331	50896	89487	56.88%	41.52%	55	55
8	臺中市潭子區	2018-11-25T03:42:40+08:00	37158	10407	47565	3331	50896	89487	56.88%	41.52%	55	55
8	臺中市潭子區	2018-11-24T22:21:39+08:00	20881	6014	26895	1958	28853	50329	57.33%	41.49%	32	55
8	臺中市潭子區	2018-11-24T22:32:12+08:00	23722	6749	30471	2187	32658	57051	57.24%	41.58%	36	55
8	臺中市潭子區	2018-11-25T04:01:22+08:00	37158	10407	47565	3331	50896	89487	56.88%	41.52%	55	55
8	臺中市潭子區	2018-11-24T22:11:57+08:00	18841	5463	24304	1748	26052	45313	57.49%	41.58%	29	55
8	臺中市潭子區	2018-11-25T00:17:01+08:00	37158	10407	47565	3331	50896	89487	56.88%	41.52%	55	55
8	臺中市潭子區	2018-11-24T22:40:13+08:00	25771	7320	33091	2330	35421	61813	57.3%	41.69%	39	55
8	臺中市潭子區	2018-11-24T22:53:07+08:00	28107	7928	36035	2564	38599	67370	57.29%	41.72%	42	55
8	臺中市潭子區	2018-11-25T06:12:31+08:00	37158	10407	47565	3331	50896	89487	56.88%	41.52%	55	55
8	臺中市潭子區	2018-11-25T06:07:16+08:00	37158	10407	47565	3331	50896	89487	56.88%	41.52%	55	55
8	臺中市潭子區	2018-11-24T23:33:44+08:00	33206	9347	42553	3063	45616	79805	57.16%	41.61%	49	55
8	臺中市潭子區	2018-11-25T03:54:33+08:00	37158	10407	47565	3331	50896	89487	56.88%	41.52%	55	55
8	臺中市潭子區	2018-11-25T01:05:51+08:00	37158	10407	47565	3331	50896	89487	56.88%	41.52%	55	55
8	臺中市潭子區	2018-11-24T23:26:01+08:00	33206	9347	42553	3063	45616	79805	57.16%	41.61%	49	55
8	臺中市潭子區	2018-11-25T06:17:29+08:00	37158	10407	47565	3331	50896	89487	56.88%	41.52%	55	55
8	臺中市潭子區	2018-11-24T23:41:56+08:00	34461	9692	44153	3129	47282	82725	57.16%	41.66%	51	55
8	臺中市潭子區	2018-11-24T23:37:43+08:00	33930	9546	43476	3101	46577	81582	57.09%	41.59%	50	55
8	臺中市潭子區	2018-11-24T23:18:21+08:00	33206	9347	42553	3063	45616	79805	57.16%	41.61%	49	55
8	臺中市潭子區	2018-11-24T23:45:57+08:00	35095	9893	44988	3181	48169	84399	57.07%	41.58%	52	55
8	臺中市南屯區	2018-11-25T03:37:17+08:00	59274	16840	76114	5177	81291	135448	60.02%	43.76%	101	101
8	臺中市南屯區	2018-11-24T23:10:50+08:00	54260	15491	69751	4794	74545	124038	60.1%	43.74%	93	101
8	臺中市南屯區	2018-11-25T00:56:06+08:00	58681	16672	75353	5123	80476	133932	60.09%	43.81%	100	101
8	臺中市南屯區	2018-11-24T23:22:16+08:00	54260	15491	69751	4794	74545	124038	60.1%	43.74%	93	101
8	臺中市南屯區	2018-11-25T01:10:58+08:00	59274	16840	76114	5177	81291	135448	60.02%	43.76%	101	101
8	臺中市南屯區	2018-11-24T22:49:17+08:00	52339	14920	67259	4571	71830	119538	60.09%	43.78%	90	101
8	臺中市南屯區	2018-11-24T23:14:32+08:00	54260	15491	69751	4794	74545	124038	60.1%	43.74%	93	101
8	臺中市南屯區	2018-11-24T22:43:43+08:00	49965	14272	64237	4361	68598	114219	60.06%	43.74%	86	101
8	臺中市南屯區	2018-11-25T00:03:26+08:00	56741	16124	72865	4973	77838	129536	60.09%	43.8%	97	101
8	臺中市南屯區	2018-11-24T22:56:30+08:00	53610	15303	68913	4696	73609	122509	60.08%	43.76%	92	101
8	臺中市南屯區	2018-11-25T00:12:38+08:00	57417	16340	73757	5009	78766	131012	60.12%	43.83%	98	101
8	臺中市南屯區	2018-11-25T03:48:21+08:00	59274	16840	76114	5177	81291	135448	60.02%	43.76%	101	101
8	臺中市南屯區	2018-11-25T06:22:38+08:00	59274	16840	76114	5177	81291	135448	60.02%	43.76%	101	101
8	臺中市南屯區	2018-11-25T03:30:51+08:00	59274	16840	76114	5177	81291	135448	60.02%	43.76%	101	101
8	臺中市南屯區	2018-11-24T22:25:17+08:00	43371	12332	55703	3739	59442	98855	60.13%	43.87%	75	101
8	臺中市南屯區	2018-11-25T06:07:15+08:00	59274	16840	76114	5177	81291	135448	60.02%	43.76%	101	101
8	臺中市南屯區	2018-11-24T23:29:40+08:00	54260	15491	69751	4794	74545	124038	60.1%	43.74%	93	101
8	臺中市南屯區	2018-11-24T23:54:18+08:00	56741	16124	72865	4973	77838	129536	60.09%	43.8%	97	101
8	臺中市南屯區	2018-11-25T00:07:57+08:00	56760	16146	72906	4955	77861	129604	60.08%	43.79%	97	101
8	臺中市南屯區	2018-11-25T01:16:14+08:00	59274	16840	76114	5177	81291	135448	60.02%	43.76%	101	101
8	臺中市南屯區	2018-11-24T22:18:13+08:00	40558	11538	52096	3507	55603	92601	60.05%	43.8%	71	101
8	臺中市南屯區	2018-11-24T23:41:55+08:00	56741	16124	72865	4973	77838	129536	60.09%	43.8%	97	101
8	臺中市南屯區	2018-11-24T22:28:33+08:00	43977	12527	56504	3798	60302	100435	60.04%	43.79%	76	101
8	臺中市南屯區	2018-11-24T23:58:34+08:00	56741	16124	72865	4973	77838	129536	60.09%	43.8%	97	101
8	臺中市南屯區	2018-11-24T23:50:08+08:00	56741	16124	72865	4973	77838	129536	60.09%	43.8%	97	101
8	臺中市南屯區	2018-11-25T01:24:16+08:00	59274	16840	76114	5177	81291	135448	60.02%	43.76%	101	101
8	臺中市南屯區	2018-11-24T22:35:38+08:00	46413	13233	59646	4031	63677	105999	60.07%	43.79%	80	101
8	臺中市南屯區	2018-11-24T23:07:12+08:00	54260	15491	69751	4794	74545	124038	60.1%	43.74%	93	101
8	臺中市南屯區	2018-11-24T22:39:02+08:00	47625	13595	61220	4127	65347	108779	60.07%	43.78%	82	101
8	臺中市南屯區	2018-11-25T06:27:48+08:00	59274	16840	76114	5177	81291	135448	60.02%	43.76%	101	101
8	臺中市南屯區	2018-11-24T23:03:41+08:00	54260	15491	69751	4794	74545	124038	60.1%	43.74%	93	101
8	臺中市南屯區	2018-11-25T01:00:53+08:00	59274	16840	76114	5177	81291	135448	60.02%	43.76%	101	101
8	臺中市南屯區	2018-11-25T00:21:37+08:00	58100	16512	74612	5076	79688	132526	60.13%	43.84%	99	101
8	臺中市南屯區	2018-11-24T22:21:38+08:00	41956	11897	53853	3599	57452	95654	60.06%	43.86%	73	101
8	臺中市南屯區	2018-11-25T03:42:40+08:00	59274	16840	76114	5177	81291	135448	60.02%	43.76%	101	101
8	臺中市南屯區	2018-11-24T23:00:07+08:00	54260	15491	69751	4794	74545	124038	60.1%	43.74%	93	101
8	臺中市南屯區	2018-11-24T22:32:12+08:00	44566	12683	57249	3841	61090	101707	60.06%	43.82%	77	101
8	臺中市南屯區	2018-11-25T06:12:30+08:00	59274	16840	76114	5177	81291	135448	60.02%	43.76%	101	101
8	臺中市南屯區	2018-11-25T04:01:22+08:00	59274	16840	76114	5177	81291	135448	60.02%	43.76%	101	101
8	臺中市南屯區	2018-11-25T00:17:01+08:00	58100	16512	74612	5076	79688	132526	60.13%	43.84%	99	101
8	臺中市南屯區	2018-11-24T22:40:13+08:00	48817	13959	62776	4263	67039	111508	60.12%	43.78%	84	101
8	臺中市南屯區	2018-11-24T22:53:07+08:00	53038	15139	68177	4615	72792	121085	60.12%	43.8%	91	101
8	臺中市南屯區	2018-11-24T22:11:56+08:00	37966	10787	48753	3317	52070	87071	59.8%	43.6%	67	101
8	臺中市南屯區	2018-11-25T03:54:33+08:00	59274	16840	76114	5177	81291	135448	60.02%	43.76%	101	101
8	臺中市南屯區	2018-11-25T01:05:51+08:00	59274	16840	76114	5177	81291	135448	60.02%	43.76%	101	101
8	臺中市南屯區	2018-11-24T23:26:01+08:00	54260	15491	69751	4794	74545	124038	60.1%	43.74%	93	101
8	臺中市南屯區	2018-11-24T23:33:43+08:00	55560	15826	71386	4884	76270	127026	60.04%	43.74%	95	101
8	臺中市南屯區	2018-11-24T23:18:20+08:00	54260	15491	69751	4794	74545	124038	60.1%	43.74%	93	101
8	臺中市南屯區	2018-11-25T06:17:29+08:00	59274	16840	76114	5177	81291	135448	60.02%	43.76%	101	101
8	臺中市南屯區	2018-11-24T23:37:42+08:00	56153	15948	72101	4931	77032	128242	60.07%	43.79%	96	101
8	臺中市南屯區	2018-11-24T22:14:41+08:00	39742	11349	51091	3459	54550	90971	59.96%	43.69%	70	101
8	臺中市南屯區	2018-11-24T23:45:57+08:00	56741	16124	72865	4973	77838	129536	60.09%	43.8%	97	101
8	新竹縣	2018-11-24T23:03:44+08:00	114506	31645	146151	10153	156304	280854	55.65%	40.77%	280	404
8	新竹縣	2018-11-24T23:22:20+08:00	128181	35414	163595	11204	174799	313395	55.78%	40.9%	306	404
8	新竹縣	2018-11-24T22:49:21+08:00	99565	27426	126991	8949	135940	244846	55.52%	40.66%	249	404
8	新竹縣	2018-11-24T23:58:38+08:00	147634	40736	188370	12672	201042	361093	55.68%	40.89%	343	404
8	新竹縣	2018-11-25T03:42:44+08:00	183636	50494	234130	15306	249436	445051	56.05%	41.26%	404	404
8	新竹縣	2018-11-25T01:00:57+08:00	180341	49664	230005	15105	245110	437506	56.02%	41.22%	399	404
8	新竹縣	2018-11-25T03:48:26+08:00	183636	50494	234130	15306	249436	445051	56.05%	41.26%	404	404
8	新竹縣	2018-11-24T22:53:11+08:00	102697	28278	130975	9246	140221	252216	55.6%	40.72%	256	404
8	新竹縣	2018-11-24T23:46:00+08:00	141311	38940	180251	12205	192456	345813	55.65%	40.86%	331	404
8	新竹縣	2018-11-25T00:08:01+08:00	154480	42663	197143	13162	210305	377482	55.71%	40.92%	355	404
8	新竹縣	2018-11-24T22:21:42+08:00	73008	20055	93063	6750	99813	179896	55.48%	40.58%	193	404
8	新竹縣	2018-11-25T06:12:34+08:00	183636	50494	234130	15306	249436	445051	56.05%	41.26%	404	404
8	新竹縣	2018-11-24T22:40:16+08:00	90274	24869	115143	8220	123363	221876	55.6%	40.69%	229	404
8	新竹縣	2018-11-24T22:25:20+08:00	74026	20354	94380	6823	101203	182457	55.47%	40.57%	195	404
8	新竹縣	2018-11-25T00:17:05+08:00	158796	43858	202654	13566	216220	388259	55.69%	40.9%	363	404
8	新竹縣	2018-11-24T23:18:24+08:00	123704	34209	157913	10859	168772	302784	55.74%	40.86%	298	404
8	新竹縣	2018-11-24T23:37:46+08:00	139071	38296	177367	11989	189356	340219	55.66%	40.88%	327	404
8	新竹縣	2018-11-24T22:35:42+08:00	84698	23183	107881	7729	115610	207997	55.58%	40.72%	216	404
8	新竹縣	2018-11-25T03:54:37+08:00	183636	50494	234130	15306	249436	445051	56.05%	41.26%	404	404
8	新竹縣	2018-11-24T23:33:47+08:00	135232	37283	172515	11694	184209	330720	55.7%	40.89%	321	404
8	新竹縣	2018-11-25T01:05:55+08:00	180885	49834	230719	15145	245864	438718	56.04%	41.23%	400	404
8	新竹縣	2018-11-24T23:50:11+08:00	143910	39700	183610	12380	195990	352038	55.67%	40.88%	336	404
8	新竹縣	2018-11-24T23:26:04+08:00	130029	35945	165974	11370	177344	317759	55.81%	40.92%	310	404
8	新竹縣	2018-11-24T22:14:45+08:00	61044	16770	77814	5722	83536	150012	55.69%	40.69%	167	404
8	新竹縣	2018-11-25T06:17:32+08:00	183636	50494	234130	15306	249436	445051	56.05%	41.26%	404	404
8	新竹縣	2018-11-25T03:37:22+08:00	183636	50494	234130	15306	249436	445051	56.05%	41.26%	404	404
8	新竹縣	2018-11-24T23:07:15+08:00	117076	32336	149412	10356	159768	286899	55.69%	40.81%	285	404
8	新竹縣	2018-11-24T22:39:05+08:00	87276	23967	111243	7994	119237	214428	55.61%	40.7%	223	404
8	新竹縣	2018-11-24T23:10:53+08:00	118755	32801	151556	10504	162060	290991	55.69%	40.81%	288	404
8	新竹縣	2018-11-24T22:43:47+08:00	93484	25755	119239	8499	127738	230273	55.47%	40.6%	237	404
8	新竹縣	2018-11-24T22:56:33+08:00	105108	28981	134089	9397	143486	258090	55.6%	40.73%	261	404
8	新竹縣	2018-11-25T01:24:21+08:00	182213	50161	232374	15200	247574	441869	56.03%	41.24%	402	404
8	新竹縣	2018-11-24T23:14:36+08:00	120999	33434	154433	10666	165099	296606	55.66%	40.79%	293	404
8	新竹縣	2018-11-25T03:30:55+08:00	183636	50494	234130	15306	249436	445051	56.05%	41.26%	404	404
8	新竹縣	2018-11-24T22:32:15+08:00	81464	22288	103752	7446	111198	200312	55.51%	40.67%	210	404
8	新竹縣	2018-11-25T04:01:25+08:00	183636	50494	234130	15306	249436	445051	56.05%	41.26%	404	404
8	新竹縣	2018-11-24T22:11:59+08:00	59261	16328	75589	5620	81209	145962	55.64%	40.6%	163	404
8	新竹縣	2018-11-24T23:00:14+08:00	107574	29682	137256	9633	146889	264250	55.59%	40.71%	266	404
8	新竹縣	2018-11-25T06:07:19+08:00	183636	50494	234130	15306	249436	445051	56.05%	41.26%	404	404
8	新竹縣	2018-11-25T01:11:03+08:00	181489	49988	231477	15169	246646	440224	56.03%	41.23%	401	404
8	新竹縣	2018-11-24T23:29:43+08:00	133004	36710	169714	11547	181261	325313	55.72%	40.88%	316	404
8	新竹縣	2018-11-25T00:21:41+08:00	160638	44351	204989	13715	218704	392364	55.74%	40.94%	366	404
8	新竹縣	2018-11-25T06:22:42+08:00	183636	50494	234130	15306	249436	445051	56.05%	41.26%	404	404
8	新竹縣	2018-11-25T00:56:10+08:00	179757	49465	229222	15054	244276	436036	56.02%	41.23%	398	404
8	新竹縣	2018-11-24T22:18:16+08:00	65278	17949	83227	6066	89293	161214	55.39%	40.49%	177	404
8	新竹縣	2018-11-24T23:54:24+08:00	144526	39851	184377	12406	196783	353346	55.69%	40.9%	337	404
8	新竹縣	2018-11-25T01:16:18+08:00	182213	50161	232374	15200	247574	441869	56.03%	41.24%	402	404
8	新竹縣	2018-11-24T23:41:58+08:00	140626	38770	179396	12131	191527	344160	55.65%	40.86%	330	404
8	新竹縣	2018-11-25T06:27:52+08:00	183636	50494	234130	15306	249436	445051	56.05%	41.26%	404	404
8	新竹縣	2018-11-25T00:12:42+08:00	156893	43306	200199	13435	213634	383573	55.7%	40.9%	360	404
8	新竹縣	2018-11-24T22:28:37+08:00	76632	21022	97654	7079	104733	188485	55.57%	40.66%	200	404
8	新竹縣	2018-11-25T00:03:30+08:00	151124	41743	192867	12906	205773	369514	55.69%	40.9%	349	404
8	新竹縣寶山鄉	2018-11-24T22:12:00+08:00	2277	636	2913	210	3123	5326	58.64%	42.75%	6	12
8	新竹縣寶山鄉	2018-11-24T22:39:06+08:00	3206	875	4081	315	4396	7377	59.59%	43.46%	8	12
8	新竹縣寶山鄉	2018-11-24T23:03:44+08:00	3206	875	4081	315	4396	7377	59.59%	43.46%	8	12
8	新竹縣寶山鄉	2018-11-24T23:22:20+08:00	4139	1111	5250	385	5635	9603	58.68%	43.1%	10	12
8	新竹縣寶山鄉	2018-11-24T23:58:39+08:00	4139	1111	5250	385	5635	9603	58.68%	43.1%	10	12
8	新竹縣寶山鄉	2018-11-24T22:49:21+08:00	3206	875	4081	315	4396	7377	59.59%	43.46%	8	12
8	新竹縣寶山鄉	2018-11-24T23:46:01+08:00	4139	1111	5250	385	5635	9603	58.68%	43.1%	10	12
8	新竹縣寶山鄉	2018-11-25T03:48:26+08:00	5520	1553	7073	491	7564	12973	58.31%	42.55%	12	12
8	新竹縣寶山鄉	2018-11-24T22:53:11+08:00	3206	875	4081	315	4396	7377	59.59%	43.46%	8	12
8	新竹縣寶山鄉	2018-11-25T03:42:45+08:00	5520	1553	7073	491	7564	12973	58.31%	42.55%	12	12
8	新竹縣寶山鄉	2018-11-25T01:00:58+08:00	5520	1553	7073	491	7564	12973	58.31%	42.55%	12	12
8	新竹縣寶山鄉	2018-11-25T00:08:01+08:00	4936	1354	6290	440	6730	11503	58.51%	42.91%	11	12
8	新竹縣寶山鄉	2018-11-25T04:01:26+08:00	5520	1553	7073	491	7564	12973	58.31%	42.55%	12	12
8	新竹縣寶山鄉	2018-11-24T22:25:21+08:00	3206	875	4081	315	4396	7377	59.59%	43.46%	8	12
8	新竹縣寶山鄉	2018-11-25T06:12:34+08:00	5520	1553	7073	491	7564	12973	58.31%	42.55%	12	12
8	新竹縣寶山鄉	2018-11-24T22:40:16+08:00	3206	875	4081	315	4396	7377	59.59%	43.46%	8	12
8	新竹縣寶山鄉	2018-11-24T22:21:43+08:00	3206	875	4081	315	4396	7377	59.59%	43.46%	8	12
8	新竹縣寶山鄉	2018-11-25T00:17:05+08:00	4936	1354	6290	440	6730	11503	58.51%	42.91%	11	12
8	新竹縣寶山鄉	2018-11-24T23:18:24+08:00	4139	1111	5250	385	5635	9603	58.68%	43.1%	10	12
8	新竹縣寶山鄉	2018-11-24T23:37:46+08:00	4139	1111	5250	385	5635	9603	58.68%	43.1%	10	12
8	新竹縣寶山鄉	2018-11-24T22:35:42+08:00	3206	875	4081	315	4396	7377	59.59%	43.46%	8	12
8	新竹縣寶山鄉	2018-11-25T03:54:37+08:00	5520	1553	7073	491	7564	12973	58.31%	42.55%	12	12
8	新竹縣寶山鄉	2018-11-24T23:33:47+08:00	4139	1111	5250	385	5635	9603	58.68%	43.1%	10	12
8	新竹縣寶山鄉	2018-11-24T23:26:04+08:00	4139	1111	5250	385	5635	9603	58.68%	43.1%	10	12
8	新竹縣寶山鄉	2018-11-24T22:14:45+08:00	2672	716	3388	252	3640	6172	58.98%	43.29%	7	12
8	新竹縣寶山鄉	2018-11-24T23:07:15+08:00	3206	875	4081	315	4396	7377	59.59%	43.46%	8	12
8	新竹縣寶山鄉	2018-11-24T23:14:37+08:00	3631	963	4594	339	4933	8433	58.5%	43.06%	9	12
8	新竹縣寶山鄉	2018-11-24T23:10:53+08:00	3206	875	4081	315	4396	7377	59.59%	43.46%	8	12
8	新竹縣寶山鄉	2018-11-25T06:17:33+08:00	5520	1553	7073	491	7564	12973	58.31%	42.55%	12	12
8	新竹縣寶山鄉	2018-11-24T22:43:47+08:00	3206	875	4081	315	4396	7377	59.59%	43.46%	8	12
8	新竹縣寶山鄉	2018-11-25T01:24:21+08:00	5520	1553	7073	491	7564	12973	58.31%	42.55%	12	12
8	新竹縣寶山鄉	2018-11-24T22:56:34+08:00	3206	875	4081	315	4396	7377	59.59%	43.46%	8	12
8	新竹縣寶山鄉	2018-11-25T03:37:23+08:00	5520	1553	7073	491	7564	12973	58.31%	42.55%	12	12
8	新竹縣寶山鄉	2018-11-25T03:30:55+08:00	5520	1553	7073	491	7564	12973	58.31%	42.55%	12	12
8	新竹縣寶山鄉	2018-11-24T22:32:15+08:00	3206	875	4081	315	4396	7377	59.59%	43.46%	8	12
8	新竹縣寶山鄉	2018-11-24T23:00:14+08:00	3206	875	4081	315	4396	7377	59.59%	43.46%	8	12
8	新竹縣寶山鄉	2018-11-25T01:11:03+08:00	5520	1553	7073	491	7564	12973	58.31%	42.55%	12	12
8	新竹縣寶山鄉	2018-11-24T23:29:43+08:00	4139	1111	5250	385	5635	9603	58.68%	43.1%	10	12
8	新竹縣寶山鄉	2018-11-25T00:21:41+08:00	4936	1354	6290	440	6730	11503	58.51%	42.91%	11	12
8	新竹縣寶山鄉	2018-11-25T06:22:42+08:00	5520	1553	7073	491	7564	12973	58.31%	42.55%	12	12
8	新竹縣寶山鄉	2018-11-25T06:07:20+08:00	5520	1553	7073	491	7564	12973	58.31%	42.55%	12	12
8	新竹縣寶山鄉	2018-11-24T22:18:16+08:00	2672	716	3388	252	3640	6172	58.98%	43.29%	7	12
8	新竹縣寶山鄉	2018-11-25T01:05:56+08:00	5520	1553	7073	491	7564	12973	58.31%	42.55%	12	12
8	新竹縣寶山鄉	2018-11-24T23:54:24+08:00	4139	1111	5250	385	5635	9603	58.68%	43.1%	10	12
8	新竹縣寶山鄉	2018-11-24T23:41:59+08:00	4139	1111	5250	385	5635	9603	58.68%	43.1%	10	12
8	新竹縣寶山鄉	2018-11-25T01:16:18+08:00	5520	1553	7073	491	7564	12973	58.31%	42.55%	12	12
8	新竹縣寶山鄉	2018-11-25T00:03:31+08:00	4936	1354	6290	440	6730	11503	58.51%	42.91%	11	12
8	新竹縣寶山鄉	2018-11-25T06:27:52+08:00	5520	1553	7073	491	7564	12973	58.31%	42.55%	12	12
8	新竹縣寶山鄉	2018-11-25T00:56:11+08:00	4936	1354	6290	440	6730	11503	58.51%	42.91%	11	12
8	新竹縣寶山鄉	2018-11-25T00:12:42+08:00	4936	1354	6290	440	6730	11503	58.51%	42.91%	11	12
8	新竹縣寶山鄉	2018-11-24T22:28:37+08:00	3206	875	4081	315	4396	7377	59.59%	43.46%	8	12
8	新竹縣寶山鄉	2018-11-24T23:50:12+08:00	4139	1111	5250	385	5635	9603	58.68%	43.1%	10	12
8	基隆市暖暖區	2018-11-24T23:10:59+08:00	11592	3199	14791	819	15610	30224	51.65%	38.35%	26	28
8	基隆市暖暖區	2018-11-24T23:22:27+08:00	12197	3381	15578	847	16425	31794	51.66%	38.36%	27	28
8	基隆市暖暖區	2018-11-24T23:18:31+08:00	12197	3381	15578	847	16425	31794	51.66%	38.36%	27	28
8	基隆市暖暖區	2018-11-24T22:49:28+08:00	11102	3061	14163	775	14938	28899	51.69%	38.42%	25	28
8	基隆市暖暖區	2018-11-24T23:33:54+08:00	12703	3527	16230	893	17123	33225	51.54%	38.23%	28	28
8	基隆市暖暖區	2018-11-24T22:12:06+08:00	8304	2206	10510	604	11114	21635	51.37%	38.38%	20	28
8	基隆市暖暖區	2018-11-24T23:26:11+08:00	12703	3527	16230	893	17123	33225	51.54%	38.23%	28	28
8	基隆市暖暖區	2018-11-24T22:56:39+08:00	11102	3061	14163	775	14938	28899	51.69%	38.42%	25	28
8	基隆市暖暖區	2018-11-24T22:28:44+08:00	8833	2454	11287	628	11915	23245	51.26%	38%	21	28
8	基隆市暖暖區	2018-11-24T23:37:52+08:00	12703	3527	16230	893	17123	33225	51.54%	38.23%	28	28
8	基隆市暖暖區	2018-11-24T22:53:19+08:00	11102	3061	14163	775	14938	28899	51.69%	38.42%	25	28
8	基隆市暖暖區	2018-11-24T22:21:50+08:00	8304	2206	10510	604	11114	21635	51.37%	38.38%	20	28
8	基隆市暖暖區	2018-11-25T04:01:33+08:00	12703	3527	16230	893	17123	33225	51.54%	38.23%	28	28
8	基隆市暖暖區	2018-11-24T23:46:07+08:00	12703	3527	16230	893	17123	33225	51.54%	38.23%	28	28
8	基隆市暖暖區	2018-11-25T01:11:12+08:00	12703	3527	16230	893	17123	33225	51.54%	38.23%	28	28
8	基隆市暖暖區	2018-11-25T00:08:08+08:00	12703	3527	16230	893	17123	33225	51.54%	38.23%	28	28
8	基隆市暖暖區	2018-11-24T23:00:20+08:00	11102	3061	14163	775	14938	28899	51.69%	38.42%	25	28
8	基隆市暖暖區	2018-11-24T22:25:29+08:00	8833	2454	11287	628	11915	23245	51.26%	38%	21	28
8	基隆市暖暖區	2018-11-25T06:22:48+08:00	12703	3527	16230	893	17123	33225	51.54%	38.23%	28	28
8	基隆市暖暖區	2018-11-25T03:48:35+08:00	12703	3527	16230	893	17123	33225	51.54%	38.23%	28	28
8	基隆市暖暖區	2018-11-25T06:27:59+08:00	12703	3527	16230	893	17123	33225	51.54%	38.23%	28	28
8	基隆市暖暖區	2018-11-25T06:17:41+08:00	12703	3527	16230	893	17123	33225	51.54%	38.23%	28	28
8	基隆市暖暖區	2018-11-24T22:39:13+08:00	10041	2762	12803	709	13512	26226	51.52%	38.29%	23	28
8	基隆市暖暖區	2018-11-25T03:37:34+08:00	12703	3527	16230	893	17123	33225	51.54%	38.23%	28	28
8	基隆市暖暖區	2018-11-25T00:12:49+08:00	12703	3527	16230	893	17123	33225	51.54%	38.23%	28	28
8	基隆市暖暖區	2018-11-24T22:18:23+08:00	8304	2206	10510	604	11114	21635	51.37%	38.38%	20	28
8	基隆市暖暖區	2018-11-24T23:50:18+08:00	12703	3527	16230	893	17123	33225	51.54%	38.23%	28	28
8	基隆市暖暖區	2018-11-24T23:14:45+08:00	11592	3199	14791	819	15610	30224	51.65%	38.35%	26	28
8	基隆市暖暖區	2018-11-24T23:58:46+08:00	12703	3527	16230	893	17123	33225	51.54%	38.23%	28	28
8	基隆市暖暖區	2018-11-24T23:03:50+08:00	11102	3061	14163	775	14938	28899	51.69%	38.42%	25	28
8	基隆市暖暖區	2018-11-25T01:01:06+08:00	12703	3527	16230	893	17123	33225	51.54%	38.23%	28	28
8	基隆市暖暖區	2018-11-25T01:24:29+08:00	12703	3527	16230	893	17123	33225	51.54%	38.23%	28	28
8	基隆市暖暖區	2018-11-24T23:54:31+08:00	12703	3527	16230	893	17123	33225	51.54%	38.23%	28	28
8	基隆市暖暖區	2018-11-25T03:54:45+08:00	12703	3527	16230	893	17123	33225	51.54%	38.23%	28	28
8	基隆市暖暖區	2018-11-24T23:07:22+08:00	11592	3199	14791	819	15610	30224	51.65%	38.35%	26	28
8	基隆市暖暖區	2018-11-25T00:03:40+08:00	12703	3527	16230	893	17123	33225	51.54%	38.23%	28	28
8	基隆市暖暖區	2018-11-24T22:14:53+08:00	8304	2206	10510	604	11114	21635	51.37%	38.38%	20	28
8	基隆市暖暖區	2018-11-25T06:12:40+08:00	12703	3527	16230	893	17123	33225	51.54%	38.23%	28	28
8	基隆市暖暖區	2018-11-24T23:29:50+08:00	12703	3527	16230	893	17123	33225	51.54%	38.23%	28	28
8	基隆市暖暖區	2018-11-25T00:17:12+08:00	12703	3527	16230	893	17123	33225	51.54%	38.23%	28	28
8	基隆市暖暖區	2018-11-24T22:32:22+08:00	9348	2576	11924	648	12572	24623	51.06%	37.96%	22	28
8	基隆市暖暖區	2018-11-24T23:42:05+08:00	12703	3527	16230	893	17123	33225	51.54%	38.23%	28	28
8	基隆市暖暖區	2018-11-25T01:06:04+08:00	12703	3527	16230	893	17123	33225	51.54%	38.23%	28	28
8	基隆市暖暖區	2018-11-25T03:42:52+08:00	12703	3527	16230	893	17123	33225	51.54%	38.23%	28	28
8	基隆市暖暖區	2018-11-24T22:40:22+08:00	10479	2887	13366	732	14098	27399	51.45%	38.25%	24	28
8	基隆市暖暖區	2018-11-25T00:21:48+08:00	12703	3527	16230	893	17123	33225	51.54%	38.23%	28	28
8	基隆市暖暖區	2018-11-25T06:07:27+08:00	12703	3527	16230	893	17123	33225	51.54%	38.23%	28	28
8	基隆市暖暖區	2018-11-25T00:56:17+08:00	12703	3527	16230	893	17123	33225	51.54%	38.23%	28	28
8	基隆市暖暖區	2018-11-24T22:35:48+08:00	9348	2576	11924	648	12572	24623	51.06%	37.96%	22	28
8	基隆市暖暖區	2018-11-24T22:43:54+08:00	11102	3061	14163	775	14938	28899	51.69%	38.42%	25	28
8	基隆市暖暖區	2018-11-25T03:31:03+08:00	12703	3527	16230	893	17123	33225	51.54%	38.23%	28	28
8	基隆市暖暖區	2018-11-25T01:16:26+08:00	12703	3527	16230	893	17123	33225	51.54%	38.23%	28	28
8	南投縣中寮鄉	2018-11-25T03:37:28+08:00	5299	1549	6848	746	7594	13181	57.61%	40.2%	24	24
8	南投縣中寮鄉	2018-11-25T01:24:23+08:00	5299	1549	6848	746	7594	13181	57.61%	40.2%	24	24
8	南投縣中寮鄉	2018-11-24T22:39:07+08:00	5299	1549	6848	746	7594	13181	57.61%	40.2%	24	24
8	南投縣中寮鄉	2018-11-24T23:07:17+08:00	5299	1549	6848	746	7594	13181	57.61%	40.2%	24	24
8	南投縣中寮鄉	2018-11-24T22:12:01+08:00	5299	1549	6848	746	7594	13181	57.61%	40.2%	24	24
8	南投縣中寮鄉	2018-11-24T22:32:17+08:00	5299	1549	6848	746	7594	13181	57.61%	40.2%	24	24
8	南投縣中寮鄉	2018-11-25T03:30:57+08:00	5299	1549	6848	746	7594	13181	57.61%	40.2%	24	24
8	南投縣中寮鄉	2018-11-25T03:48:28+08:00	5299	1549	6848	746	7594	13181	57.61%	40.2%	24	24
8	南投縣中寮鄉	2018-11-24T23:42:01+08:00	5037	1462	6499	714	7213	12567	57.4%	40.08%	23	24
8	南投縣中寮鄉	2018-11-25T04:01:28+08:00	5299	1549	6848	746	7594	13181	57.61%	40.2%	24	24
8	南投縣中寮鄉	2018-11-25T00:21:43+08:00	5299	1549	6848	746	7594	13181	57.61%	40.2%	24	24
8	南投縣中寮鄉	2018-11-24T22:21:44+08:00	5299	1549	6848	746	7594	13181	57.61%	40.2%	24	24
8	南投縣中寮鄉	2018-11-24T23:00:16+08:00	5299	1549	6848	746	7594	13181	57.61%	40.2%	24	24
8	南投縣中寮鄉	2018-11-24T22:40:17+08:00	5299	1549	6848	746	7594	13181	57.61%	40.2%	24	24
8	南投縣中寮鄉	2018-11-25T06:12:35+08:00	5299	1549	6848	746	7594	13181	57.61%	40.2%	24	24
8	南投縣中寮鄉	2018-11-25T03:54:39+08:00	5299	1549	6848	746	7594	13181	57.61%	40.2%	24	24
8	南投縣中寮鄉	2018-11-25T01:01:00+08:00	5299	1549	6848	746	7594	13181	57.61%	40.2%	24	24
8	南投縣中寮鄉	2018-11-24T23:33:49+08:00	5299	1549	6848	746	7594	13181	57.61%	40.2%	24	24
8	南投縣中寮鄉	2018-11-25T00:03:33+08:00	5299	1549	6848	746	7594	13181	57.61%	40.2%	24	24
8	南投縣中寮鄉	2018-11-24T23:37:47+08:00	5299	1549	6848	746	7594	13181	57.61%	40.2%	24	24
8	南投縣中寮鄉	2018-11-24T22:35:43+08:00	5299	1549	6848	746	7594	13181	57.61%	40.2%	24	24
8	南投縣中寮鄉	2018-11-24T23:54:26+08:00	5299	1549	6848	746	7594	13181	57.61%	40.2%	24	24
8	南投縣中寮鄉	2018-11-24T23:58:41+08:00	5299	1549	6848	746	7594	13181	57.61%	40.2%	24	24
8	南投縣中寮鄉	2018-11-25T00:56:12+08:00	5299	1549	6848	746	7594	13181	57.61%	40.2%	24	24
8	南投縣中寮鄉	2018-11-24T22:56:35+08:00	5299	1549	6848	746	7594	13181	57.61%	40.2%	24	24
8	南投縣中寮鄉	2018-11-24T22:49:23+08:00	5299	1549	6848	746	7594	13181	57.61%	40.2%	24	24
8	南投縣中寮鄉	2018-11-24T23:14:39+08:00	5299	1549	6848	746	7594	13181	57.61%	40.2%	24	24
8	南投縣中寮鄉	2018-11-24T23:22:22+08:00	5299	1549	6848	746	7594	13181	57.61%	40.2%	24	24
8	南投縣中寮鄉	2018-11-25T06:17:34+08:00	5299	1549	6848	746	7594	13181	57.61%	40.2%	24	24
8	南投縣中寮鄉	2018-11-24T22:43:49+08:00	5299	1549	6848	746	7594	13181	57.61%	40.2%	24	24
8	南投縣中寮鄉	2018-11-24T23:03:46+08:00	5299	1549	6848	746	7594	13181	57.61%	40.2%	24	24
8	南投縣中寮鄉	2018-11-24T23:10:55+08:00	5299	1549	6848	746	7594	13181	57.61%	40.2%	24	24
8	南投縣中寮鄉	2018-11-25T00:08:03+08:00	4865	1452	6317	702	7019	12191	57.58%	39.91%	23	24
8	南投縣中寮鄉	2018-11-25T03:42:47+08:00	5299	1549	6848	746	7594	13181	57.61%	40.2%	24	24
8	南投縣中寮鄉	2018-11-24T22:53:13+08:00	5299	1549	6848	746	7594	13181	57.61%	40.2%	24	24
8	南投縣中寮鄉	2018-11-24T23:46:02+08:00	5299	1549	6848	746	7594	13181	57.61%	40.2%	24	24
8	南投縣中寮鄉	2018-11-25T01:11:05+08:00	5299	1549	6848	746	7594	13181	57.61%	40.2%	24	24
8	南投縣中寮鄉	2018-11-24T23:29:45+08:00	5299	1549	6848	746	7594	13181	57.61%	40.2%	24	24
8	南投縣中寮鄉	2018-11-25T06:07:21+08:00	5299	1549	6848	746	7594	13181	57.61%	40.2%	24	24
8	南投縣中寮鄉	2018-11-25T06:22:43+08:00	5299	1549	6848	746	7594	13181	57.61%	40.2%	24	24
8	南投縣中寮鄉	2018-11-25T00:17:06+08:00	5299	1549	6848	746	7594	13181	57.61%	40.2%	24	24
8	南投縣中寮鄉	2018-11-24T22:25:23+08:00	5299	1549	6848	746	7594	13181	57.61%	40.2%	24	24
8	南投縣中寮鄉	2018-11-25T00:12:44+08:00	5299	1549	6848	746	7594	13181	57.61%	40.2%	24	24
8	南投縣中寮鄉	2018-11-24T23:26:06+08:00	5299	1549	6848	746	7594	13181	57.61%	40.2%	24	24
8	南投縣中寮鄉	2018-11-24T22:14:47+08:00	5299	1549	6848	746	7594	13181	57.61%	40.2%	24	24
8	南投縣中寮鄉	2018-11-24T22:18:18+08:00	5299	1549	6848	746	7594	13181	57.61%	40.2%	24	24
8	南投縣中寮鄉	2018-11-25T06:27:54+08:00	5299	1549	6848	746	7594	13181	57.61%	40.2%	24	24
8	南投縣中寮鄉	2018-11-24T23:50:13+08:00	5299	1549	6848	746	7594	13181	57.61%	40.2%	24	24
8	南投縣中寮鄉	2018-11-25T01:16:20+08:00	5299	1549	6848	746	7594	13181	57.61%	40.2%	24	24
8	南投縣中寮鄉	2018-11-25T01:05:57+08:00	5299	1549	6848	746	7594	13181	57.61%	40.2%	24	24
8	南投縣中寮鄉	2018-11-24T22:28:39+08:00	5299	1549	6848	746	7594	13181	57.61%	40.2%	24	24
8	南投縣中寮鄉	2018-11-24T23:18:26+08:00	5299	1549	6848	746	7594	13181	57.61%	40.2%	24	24
8	雲林縣古坑鄉	2018-11-24T22:39:08+08:00	6633	2098	8731	971	9702	19020	51.01%	34.87%	20	27
8	雲林縣古坑鄉	2018-11-25T03:37:28+08:00	9830	3001	12831	1389	14220	27477	51.75%	35.78%	27	27
8	雲林縣古坑鄉	2018-11-25T01:24:23+08:00	9830	3001	12831	1389	14220	27477	51.75%	35.78%	27	27
8	雲林縣古坑鄉	2018-11-24T23:07:17+08:00	8706	2719	11425	1249	12674	24536	51.65%	35.48%	25	27
8	雲林縣古坑鄉	2018-11-24T22:12:01+08:00	6226	1964	8190	895	9085	17894	50.77%	34.79%	19	27
8	雲林縣古坑鄉	2018-11-24T22:32:17+08:00	6226	1964	8190	895	9085	17894	50.77%	34.79%	19	27
8	雲林縣古坑鄉	2018-11-25T03:48:28+08:00	9830	3001	12831	1389	14220	27477	51.75%	35.78%	27	27
8	雲林縣古坑鄉	2018-11-25T03:30:58+08:00	9830	3001	12831	1389	14220	27477	51.75%	35.78%	27	27
8	雲林縣古坑鄉	2018-11-24T23:42:01+08:00	8706	2719	11425	1249	12674	24536	51.65%	35.48%	25	27
8	雲林縣古坑鄉	2018-11-24T22:21:45+08:00	6226	1964	8190	895	9085	17894	50.77%	34.79%	19	27
8	雲林縣古坑鄉	2018-11-25T06:07:22+08:00	9830	3001	12831	1389	14220	27477	51.75%	35.78%	27	27
8	雲林縣古坑鄉	2018-11-25T04:01:28+08:00	9830	3001	12831	1389	14220	27477	51.75%	35.78%	27	27
8	雲林縣古坑鄉	2018-11-25T00:21:43+08:00	9830	3001	12831	1389	14220	27477	51.75%	35.78%	27	27
8	雲林縣古坑鄉	2018-11-25T01:11:06+08:00	9830	3001	12831	1389	14220	27477	51.75%	35.78%	27	27
8	雲林縣古坑鄉	2018-11-24T22:40:18+08:00	7112	2254	9366	1028	10394	20322	51.15%	35%	21	27
8	雲林縣古坑鄉	2018-11-24T23:00:16+08:00	8706	2719	11425	1249	12674	24536	51.65%	35.48%	25	27
8	雲林縣古坑鄉	2018-11-24T23:37:48+08:00	8706	2719	11425	1249	12674	24536	51.65%	35.48%	25	27
8	雲林縣古坑鄉	2018-11-25T03:54:39+08:00	9830	3001	12831	1389	14220	27477	51.75%	35.78%	27	27
8	雲林縣古坑鄉	2018-11-25T01:01:00+08:00	9830	3001	12831	1389	14220	27477	51.75%	35.78%	27	27
8	雲林縣古坑鄉	2018-11-24T23:33:49+08:00	8706	2719	11425	1249	12674	24536	51.65%	35.48%	25	27
8	雲林縣古坑鄉	2018-11-25T00:03:33+08:00	9830	3001	12831	1389	14220	27477	51.75%	35.78%	27	27
8	雲林縣古坑鄉	2018-11-24T22:35:44+08:00	6633	2098	8731	971	9702	19020	51.01%	34.87%	20	27
8	雲林縣古坑鄉	2018-11-24T23:54:26+08:00	9830	3001	12831	1389	14220	27477	51.75%	35.78%	27	27
8	雲林縣古坑鄉	2018-11-24T23:58:41+08:00	9830	3001	12831	1389	14220	27477	51.75%	35.78%	27	27
8	雲林縣古坑鄉	2018-11-25T00:56:12+08:00	9830	3001	12831	1389	14220	27477	51.75%	35.78%	27	27
8	雲林縣古坑鄉	2018-11-24T22:56:35+08:00	8347	2618	10965	1187	12152	23542	51.62%	35.46%	24	27
8	雲林縣古坑鄉	2018-11-25T06:17:35+08:00	9830	3001	12831	1389	14220	27477	51.75%	35.78%	27	27
8	雲林縣古坑鄉	2018-11-24T22:49:23+08:00	7453	2357	9810	1073	10883	21320	51.05%	34.96%	22	27
8	雲林縣古坑鄉	2018-11-24T23:22:22+08:00	8706	2719	11425	1249	12674	24536	51.65%	35.48%	25	27
8	雲林縣古坑鄉	2018-11-24T22:43:49+08:00	7112	2254	9366	1028	10394	20322	51.15%	35%	21	27
8	雲林縣古坑鄉	2018-11-24T23:03:46+08:00	8706	2719	11425	1249	12674	24536	51.65%	35.48%	25	27
8	雲林縣古坑鄉	2018-11-24T23:10:55+08:00	8706	2719	11425	1249	12674	24536	51.65%	35.48%	25	27
8	雲林縣古坑鄉	2018-11-25T00:08:04+08:00	9830	3001	12831	1389	14220	27477	51.75%	35.78%	27	27
8	雲林縣古坑鄉	2018-11-25T03:42:47+08:00	9830	3001	12831	1389	14220	27477	51.75%	35.78%	27	27
8	雲林縣古坑鄉	2018-11-24T22:53:14+08:00	7908	2498	10406	1129	11535	22398	51.5%	35.31%	23	27
8	雲林縣古坑鄉	2018-11-24T23:46:03+08:00	9358	2878	12236	1305	13541	26308	51.47%	35.57%	26	27
8	雲林縣古坑鄉	2018-11-25T00:17:07+08:00	9830	3001	12831	1389	14220	27477	51.75%	35.78%	27	27
8	雲林縣古坑鄉	2018-11-24T23:29:45+08:00	8706	2719	11425	1249	12674	24536	51.65%	35.48%	25	27
8	雲林縣古坑鄉	2018-11-25T06:22:44+08:00	9830	3001	12831	1389	14220	27477	51.75%	35.78%	27	27
8	雲林縣古坑鄉	2018-11-25T06:12:36+08:00	9830	3001	12831	1389	14220	27477	51.75%	35.78%	27	27
8	雲林縣古坑鄉	2018-11-24T22:25:24+08:00	6226	1964	8190	895	9085	17894	50.77%	34.79%	19	27
8	雲林縣古坑鄉	2018-11-25T01:05:58+08:00	9830	3001	12831	1389	14220	27477	51.75%	35.78%	27	27
8	雲林縣古坑鄉	2018-11-25T00:12:44+08:00	9830	3001	12831	1389	14220	27477	51.75%	35.78%	27	27
8	雲林縣古坑鄉	2018-11-24T23:26:06+08:00	8706	2719	11425	1249	12674	24536	51.65%	35.48%	25	27
8	雲林縣古坑鄉	2018-11-25T06:27:54+08:00	9830	3001	12831	1389	14220	27477	51.75%	35.78%	27	27
8	雲林縣古坑鄉	2018-11-24T23:50:14+08:00	9358	2878	12236	1305	13541	26308	51.47%	35.57%	26	27
8	雲林縣古坑鄉	2018-11-24T23:14:40+08:00	8706	2719	11425	1249	12674	24536	51.65%	35.48%	25	27
8	雲林縣古坑鄉	2018-11-24T22:18:19+08:00	6226	1964	8190	895	9085	17894	50.77%	34.79%	19	27
8	雲林縣古坑鄉	2018-11-24T22:28:39+08:00	6226	1964	8190	895	9085	17894	50.77%	34.79%	19	27
8	雲林縣古坑鄉	2018-11-24T22:14:48+08:00	6226	1964	8190	895	9085	17894	50.77%	34.79%	19	27
8	雲林縣古坑鄉	2018-11-25T01:16:21+08:00	9830	3001	12831	1389	14220	27477	51.75%	35.78%	27	27
8	雲林縣古坑鄉	2018-11-24T23:18:26+08:00	8706	2719	11425	1249	12674	24536	51.65%	35.48%	25	27
8	雲林縣元長鄉	2018-11-24T22:39:08+08:00	6174	2194	8368	1185	9553	22830	41.84%	27.04%	25	25
8	雲林縣元長鄉	2018-11-25T03:37:28+08:00	6174	2194	8368	1185	9553	22830	41.84%	27.04%	25	25
8	雲林縣元長鄉	2018-11-24T23:07:18+08:00	6174	2194	8368	1185	9553	22830	41.84%	27.04%	25	25
8	雲林縣元長鄉	2018-11-24T22:56:36+08:00	6174	2194	8368	1185	9553	22830	41.84%	27.04%	25	25
8	雲林縣元長鄉	2018-11-25T01:24:24+08:00	6174	2194	8368	1185	9553	22830	41.84%	27.04%	25	25
8	雲林縣元長鄉	2018-11-25T03:54:40+08:00	6174	2194	8368	1185	9553	22830	41.84%	27.04%	25	25
8	雲林縣元長鄉	2018-11-24T22:32:18+08:00	6174	2194	8368	1185	9553	22830	41.84%	27.04%	25	25
8	雲林縣元長鄉	2018-11-25T03:30:58+08:00	6174	2194	8368	1185	9553	22830	41.84%	27.04%	25	25
8	雲林縣元長鄉	2018-11-24T23:42:01+08:00	6174	2194	8368	1185	9553	22830	41.84%	27.04%	25	25
8	雲林縣元長鄉	2018-11-25T03:48:29+08:00	6174	2194	8368	1185	9553	22830	41.84%	27.04%	25	25
8	雲林縣元長鄉	2018-11-24T22:21:45+08:00	6174	2194	8368	1185	9553	22830	41.84%	27.04%	25	25
8	雲林縣元長鄉	2018-11-25T06:07:22+08:00	6174	2194	8368	1185	9553	22830	41.84%	27.04%	25	25
8	雲林縣元長鄉	2018-11-25T00:21:43+08:00	6174	2194	8368	1185	9553	22830	41.84%	27.04%	25	25
8	雲林縣元長鄉	2018-11-24T23:29:46+08:00	6174	2194	8368	1185	9553	22830	41.84%	27.04%	25	25
8	雲林縣元長鄉	2018-11-25T01:11:06+08:00	6174	2194	8368	1185	9553	22830	41.84%	27.04%	25	25
8	雲林縣元長鄉	2018-11-24T22:40:18+08:00	6174	2194	8368	1185	9553	22830	41.84%	27.04%	25	25
8	雲林縣元長鄉	2018-11-25T04:01:29+08:00	6174	2194	8368	1185	9553	22830	41.84%	27.04%	25	25
8	雲林縣元長鄉	2018-11-24T23:00:16+08:00	6174	2194	8368	1185	9553	22830	41.84%	27.04%	25	25
8	雲林縣元長鄉	2018-11-24T23:37:48+08:00	6174	2194	8368	1185	9553	22830	41.84%	27.04%	25	25
8	雲林縣元長鄉	2018-11-24T22:43:50+08:00	6174	2194	8368	1185	9553	22830	41.84%	27.04%	25	25
8	雲林縣元長鄉	2018-11-25T00:56:13+08:00	6174	2194	8368	1185	9553	22830	41.84%	27.04%	25	25
8	雲林縣元長鄉	2018-11-24T23:54:27+08:00	6174	2194	8368	1185	9553	22830	41.84%	27.04%	25	25
8	雲林縣元長鄉	2018-11-25T00:03:34+08:00	6174	2194	8368	1185	9553	22830	41.84%	27.04%	25	25
8	雲林縣元長鄉	2018-11-24T22:35:44+08:00	6174	2194	8368	1185	9553	22830	41.84%	27.04%	25	25
8	雲林縣元長鄉	2018-11-25T01:01:01+08:00	6174	2194	8368	1185	9553	22830	41.84%	27.04%	25	25
8	雲林縣元長鄉	2018-11-24T23:22:23+08:00	6174	2194	8368	1185	9553	22830	41.84%	27.04%	25	25
8	雲林縣元長鄉	2018-11-25T06:17:35+08:00	6174	2194	8368	1185	9553	22830	41.84%	27.04%	25	25
8	雲林縣元長鄉	2018-11-24T22:49:23+08:00	6174	2194	8368	1185	9553	22830	41.84%	27.04%	25	25
8	雲林縣元長鄉	2018-11-24T23:03:46+08:00	6174	2194	8368	1185	9553	22830	41.84%	27.04%	25	25
8	雲林縣元長鄉	2018-11-24T23:10:55+08:00	6174	2194	8368	1185	9553	22830	41.84%	27.04%	25	25
8	雲林縣元長鄉	2018-11-24T23:33:50+08:00	6174	2194	8368	1185	9553	22830	41.84%	27.04%	25	25
8	雲林縣元長鄉	2018-11-24T22:12:02+08:00	5406	1932	7338	1085	8423	20153	41.8%	26.82%	23	25
8	雲林縣元長鄉	2018-11-25T00:08:04+08:00	6174	2194	8368	1185	9553	22830	41.84%	27.04%	25	25
8	雲林縣元長鄉	2018-11-25T03:42:47+08:00	6174	2194	8368	1185	9553	22830	41.84%	27.04%	25	25
8	雲林縣元長鄉	2018-11-24T22:53:14+08:00	6174	2194	8368	1185	9553	22830	41.84%	27.04%	25	25
8	雲林縣元長鄉	2018-11-24T23:46:03+08:00	6174	2194	8368	1185	9553	22830	41.84%	27.04%	25	25
8	雲林縣元長鄉	2018-11-25T00:17:07+08:00	6174	2194	8368	1185	9553	22830	41.84%	27.04%	25	25
8	雲林縣元長鄉	2018-11-24T22:25:25+08:00	6174	2194	8368	1185	9553	22830	41.84%	27.04%	25	25
8	雲林縣元長鄉	2018-11-25T06:22:44+08:00	6174	2194	8368	1185	9553	22830	41.84%	27.04%	25	25
8	雲林縣元長鄉	2018-11-25T06:12:36+08:00	6174	2194	8368	1185	9553	22830	41.84%	27.04%	25	25
8	雲林縣元長鄉	2018-11-25T01:05:58+08:00	6174	2194	8368	1185	9553	22830	41.84%	27.04%	25	25
8	雲林縣元長鄉	2018-11-25T00:12:44+08:00	6174	2194	8368	1185	9553	22830	41.84%	27.04%	25	25
8	雲林縣元長鄉	2018-11-24T23:26:06+08:00	6174	2194	8368	1185	9553	22830	41.84%	27.04%	25	25
8	雲林縣元長鄉	2018-11-25T06:27:54+08:00	6174	2194	8368	1185	9553	22830	41.84%	27.04%	25	25
8	雲林縣元長鄉	2018-11-24T23:18:27+08:00	6174	2194	8368	1185	9553	22830	41.84%	27.04%	25	25
8	雲林縣元長鄉	2018-11-24T23:50:14+08:00	6174	2194	8368	1185	9553	22830	41.84%	27.04%	25	25
8	雲林縣元長鄉	2018-11-24T23:14:40+08:00	6174	2194	8368	1185	9553	22830	41.84%	27.04%	25	25
8	雲林縣元長鄉	2018-11-24T22:18:19+08:00	6174	2194	8368	1185	9553	22830	41.84%	27.04%	25	25
8	雲林縣元長鄉	2018-11-24T23:58:42+08:00	6174	2194	8368	1185	9553	22830	41.84%	27.04%	25	25
8	雲林縣元長鄉	2018-11-24T22:28:39+08:00	6174	2194	8368	1185	9553	22830	41.84%	27.04%	25	25
8	雲林縣元長鄉	2018-11-24T22:14:48+08:00	5736	2060	7796	1135	8931	21303	41.92%	26.93%	24	25
8	雲林縣元長鄉	2018-11-25T01:16:21+08:00	6174	2194	8368	1185	9553	22830	41.84%	27.04%	25	25
8	宜蘭縣蘇澳鎮	2018-11-24T23:33:52+08:00	13182	4065	17247	2029	19276	34512	55.85%	38.2%	43	43
8	宜蘭縣蘇澳鎮	2018-11-24T23:10:57+08:00	13182	4065	17247	2029	19276	34512	55.85%	38.2%	43	43
8	宜蘭縣蘇澳鎮	2018-11-25T06:17:38+08:00	13182	4065	17247	2029	19276	34512	55.85%	38.2%	43	43
8	宜蘭縣蘇澳鎮	2018-11-24T22:28:42+08:00	12198	3770	15968	1891	17859	32058	55.71%	38.05%	41	43
8	宜蘭縣蘇澳鎮	2018-11-24T23:07:21+08:00	13182	4065	17247	2029	19276	34512	55.85%	38.2%	43	43
8	宜蘭縣蘇澳鎮	2018-11-24T22:14:50+08:00	11785	3640	15425	1849	17274	30930	55.85%	38.1%	40	43
8	宜蘭縣蘇澳鎮	2018-11-24T22:56:37+08:00	12723	3918	16641	1965	18606	33318	55.84%	38.19%	42	43
8	宜蘭縣蘇澳鎮	2018-11-25T01:06:01+08:00	13182	4065	17247	2029	19276	34512	55.85%	38.2%	43	43
8	宜蘭縣蘇澳鎮	2018-11-24T22:32:20+08:00	12198	3770	15968	1891	17859	32058	55.71%	38.05%	41	43
8	宜蘭縣蘇澳鎮	2018-11-24T22:53:16+08:00	12198	3770	15968	1891	17859	32058	55.71%	38.05%	41	43
8	宜蘭縣蘇澳鎮	2018-11-25T00:17:10+08:00	13182	4065	17247	2029	19276	34512	55.85%	38.2%	43	43
8	宜蘭縣蘇澳鎮	2018-11-25T00:08:06+08:00	13182	4065	17247	2029	19276	34512	55.85%	38.2%	43	43
8	宜蘭縣蘇澳鎮	2018-11-25T03:48:33+08:00	13182	4065	17247	2029	19276	34512	55.85%	38.2%	43	43
8	宜蘭縣蘇澳鎮	2018-11-24T23:29:48+08:00	13182	4065	17247	2029	19276	34512	55.85%	38.2%	43	43
8	宜蘭縣蘇澳鎮	2018-11-24T22:40:20+08:00	12198	3770	15968	1891	17859	32058	55.71%	38.05%	41	43
8	宜蘭縣蘇澳鎮	2018-11-25T06:22:46+08:00	13182	4065	17247	2029	19276	34512	55.85%	38.2%	43	43
8	宜蘭縣蘇澳鎮	2018-11-25T06:07:24+08:00	13182	4065	17247	2029	19276	34512	55.85%	38.2%	43	43
8	宜蘭縣蘇澳鎮	2018-11-24T23:00:18+08:00	13182	4065	17247	2029	19276	34512	55.85%	38.2%	43	43
8	宜蘭縣蘇澳鎮	2018-11-24T22:25:27+08:00	12198	3770	15968	1891	17859	32058	55.71%	38.05%	41	43
8	宜蘭縣蘇澳鎮	2018-11-25T03:42:50+08:00	13182	4065	17247	2029	19276	34512	55.85%	38.2%	43	43
8	宜蘭縣蘇澳鎮	2018-11-25T01:11:09+08:00	13182	4065	17247	2029	19276	34512	55.85%	38.2%	43	43
8	宜蘭縣蘇澳鎮	2018-11-25T01:16:24+08:00	13182	4065	17247	2029	19276	34512	55.85%	38.2%	43	43
8	宜蘭縣蘇澳鎮	2018-11-25T03:31:01+08:00	13182	4065	17247	2029	19276	34512	55.85%	38.2%	43	43
8	宜蘭縣蘇澳鎮	2018-11-24T23:14:42+08:00	13182	4065	17247	2029	19276	34512	55.85%	38.2%	43	43
8	宜蘭縣蘇澳鎮	2018-11-24T23:50:16+08:00	13182	4065	17247	2029	19276	34512	55.85%	38.2%	43	43
8	宜蘭縣蘇澳鎮	2018-11-25T06:27:56+08:00	13182	4065	17247	2029	19276	34512	55.85%	38.2%	43	43
8	宜蘭縣蘇澳鎮	2018-11-25T00:56:15+08:00	13182	4065	17247	2029	19276	34512	55.85%	38.2%	43	43
8	宜蘭縣蘇澳鎮	2018-11-25T00:12:46+08:00	13182	4065	17247	2029	19276	34512	55.85%	38.2%	43	43
8	宜蘭縣蘇澳鎮	2018-11-24T23:54:28+08:00	13182	4065	17247	2029	19276	34512	55.85%	38.2%	43	43
8	宜蘭縣蘇澳鎮	2018-11-24T23:37:50+08:00	13182	4065	17247	2029	19276	34512	55.85%	38.2%	43	43
8	宜蘭縣蘇澳鎮	2018-11-24T22:12:04+08:00	11785	3640	15425	1849	17274	30930	55.85%	38.1%	40	43
8	宜蘭縣蘇澳鎮	2018-11-24T23:22:25+08:00	13182	4065	17247	2029	19276	34512	55.85%	38.2%	43	43
8	宜蘭縣蘇澳鎮	2018-11-25T01:24:26+08:00	13182	4065	17247	2029	19276	34512	55.85%	38.2%	43	43
8	宜蘭縣蘇澳鎮	2018-11-25T03:54:42+08:00	13182	4065	17247	2029	19276	34512	55.85%	38.2%	43	43
8	宜蘭縣蘇澳鎮	2018-11-24T23:03:48+08:00	13182	4065	17247	2029	19276	34512	55.85%	38.2%	43	43
8	宜蘭縣蘇澳鎮	2018-11-24T22:49:25+08:00	12198	3770	15968	1891	17859	32058	55.71%	38.05%	41	43
8	宜蘭縣蘇澳鎮	2018-11-24T23:42:03+08:00	13182	4065	17247	2029	19276	34512	55.85%	38.2%	43	43
8	宜蘭縣蘇澳鎮	2018-11-24T23:46:05+08:00	13182	4065	17247	2029	19276	34512	55.85%	38.2%	43	43
8	宜蘭縣蘇澳鎮	2018-11-25T04:01:31+08:00	13182	4065	17247	2029	19276	34512	55.85%	38.2%	43	43
8	宜蘭縣蘇澳鎮	2018-11-24T22:21:48+08:00	12198	3770	15968	1891	17859	32058	55.71%	38.05%	41	43
8	宜蘭縣蘇澳鎮	2018-11-25T06:12:38+08:00	13182	4065	17247	2029	19276	34512	55.85%	38.2%	43	43
8	宜蘭縣蘇澳鎮	2018-11-25T00:21:46+08:00	13182	4065	17247	2029	19276	34512	55.85%	38.2%	43	43
8	宜蘭縣蘇澳鎮	2018-11-25T01:01:03+08:00	13182	4065	17247	2029	19276	34512	55.85%	38.2%	43	43
8	宜蘭縣蘇澳鎮	2018-11-24T22:39:10+08:00	12198	3770	15968	1891	17859	32058	55.71%	38.05%	41	43
8	宜蘭縣蘇澳鎮	2018-11-24T23:26:08+08:00	13182	4065	17247	2029	19276	34512	55.85%	38.2%	43	43
8	宜蘭縣蘇澳鎮	2018-11-24T22:35:46+08:00	12198	3770	15968	1891	17859	32058	55.71%	38.05%	41	43
8	宜蘭縣蘇澳鎮	2018-11-24T23:58:44+08:00	13182	4065	17247	2029	19276	34512	55.85%	38.2%	43	43
8	宜蘭縣蘇澳鎮	2018-11-24T23:18:29+08:00	13182	4065	17247	2029	19276	34512	55.85%	38.2%	43	43
8	宜蘭縣蘇澳鎮	2018-11-25T00:03:36+08:00	13182	4065	17247	2029	19276	34512	55.85%	38.2%	43	43
8	宜蘭縣蘇澳鎮	2018-11-25T03:37:31+08:00	13182	4065	17247	2029	19276	34512	55.85%	38.2%	43	43
8	宜蘭縣蘇澳鎮	2018-11-24T22:18:21+08:00	11785	3640	15425	1849	17274	30930	55.85%	38.1%	40	43
8	宜蘭縣蘇澳鎮	2018-11-24T22:43:52+08:00	12198	3770	15968	1891	17859	32058	55.71%	38.05%	41	43
8	連江縣南竿鄉	2018-11-24T23:26:10+08:00	0	0	0	0	0	0	0%	0%	0	4
8	連江縣南竿鄉	2018-11-24T23:10:59+08:00	0	0	0	0	0	0	0%	0%	0	4
8	連江縣南竿鄉	2018-11-24T22:49:27+08:00	0	0	0	0	0	0	0%	0%	0	4
8	連江縣南竿鄉	2018-11-24T23:22:27+08:00	0	0	0	0	0	0	0%	0%	0	4
8	連江縣南竿鄉	2018-11-24T23:18:31+08:00	0	0	0	0	0	0	0%	0%	0	4
8	連江縣南竿鄉	2018-11-24T23:33:54+08:00	0	0	0	0	0	0	0%	0%	0	4
8	連江縣南竿鄉	2018-11-24T22:12:06+08:00	0	0	0	0	0	0	0%	0%	0	4
8	連江縣南竿鄉	2018-11-24T22:56:39+08:00	0	0	0	0	0	0	0%	0%	0	4
8	連江縣南竿鄉	2018-11-24T22:28:44+08:00	0	0	0	0	0	0	0%	0%	0	4
8	連江縣南竿鄉	2018-11-24T23:37:52+08:00	0	0	0	0	0	0	0%	0%	0	4
8	連江縣南竿鄉	2018-11-24T22:53:19+08:00	0	0	0	0	0	0	0%	0%	0	4
8	連江縣南竿鄉	2018-11-25T00:17:11+08:00	0	0	0	0	0	0	0%	0%	0	4
8	連江縣南竿鄉	2018-11-24T22:32:21+08:00	0	0	0	0	0	0	0%	0%	0	4
8	連江縣南竿鄉	2018-11-24T22:21:50+08:00	0	0	0	0	0	0	0%	0%	0	4
8	連江縣南竿鄉	2018-11-25T04:01:33+08:00	2708	425	3133	139	3272	6461	50.64%	41.91%	4	4
8	連江縣南竿鄉	2018-11-24T23:46:07+08:00	0	0	0	0	0	0	0%	0%	0	4
8	連江縣南竿鄉	2018-11-25T00:08:08+08:00	0	0	0	0	0	0	0%	0%	0	4
8	連江縣南竿鄉	2018-11-24T23:00:20+08:00	0	0	0	0	0	0	0%	0%	0	4
8	連江縣南竿鄉	2018-11-24T22:25:29+08:00	0	0	0	0	0	0	0%	0%	0	4
8	連江縣南竿鄉	2018-11-25T06:22:48+08:00	2708	425	3133	139	3272	6461	50.64%	41.91%	4	4
8	連江縣南竿鄉	2018-11-25T03:48:35+08:00	2708	425	3133	139	3272	6461	50.64%	41.91%	4	4
8	連江縣南竿鄉	2018-11-24T22:39:13+08:00	0	0	0	0	0	0	0%	0%	0	4
8	連江縣南竿鄉	2018-11-25T00:12:49+08:00	0	0	0	0	0	0	0%	0%	0	4
8	連江縣南竿鄉	2018-11-25T03:37:33+08:00	2708	425	3133	139	3272	6461	50.64%	41.91%	4	4
8	連江縣南竿鄉	2018-11-24T22:18:23+08:00	0	0	0	0	0	0	0%	0%	0	4
8	連江縣南竿鄉	2018-11-24T23:50:18+08:00	0	0	0	0	0	0	0%	0%	0	4
8	連江縣南竿鄉	2018-11-24T23:14:45+08:00	0	0	0	0	0	0	0%	0%	0	4
8	連江縣南竿鄉	2018-11-24T23:58:46+08:00	0	0	0	0	0	0	0%	0%	0	4
8	連江縣南竿鄉	2018-11-24T23:03:50+08:00	0	0	0	0	0	0	0%	0%	0	4
8	連江縣南竿鄉	2018-11-25T06:27:58+08:00	2708	425	3133	139	3272	6461	50.64%	41.91%	4	4
8	連江縣南竿鄉	2018-11-25T06:17:40+08:00	2708	425	3133	139	3272	6461	50.64%	41.91%	4	4
8	連江縣南竿鄉	2018-11-24T23:54:31+08:00	0	0	0	0	0	0	0%	0%	0	4
8	連江縣南竿鄉	2018-11-24T22:14:52+08:00	0	0	0	0	0	0	0%	0%	0	4
8	連江縣南竿鄉	2018-11-25T01:24:28+08:00	2708	425	3133	139	3272	6461	50.64%	41.91%	4	4
8	連江縣南竿鄉	2018-11-25T03:54:45+08:00	2708	425	3133	139	3272	6461	50.64%	41.91%	4	4
8	連江縣南竿鄉	2018-11-24T23:07:22+08:00	0	0	0	0	0	0	0%	0%	0	4
8	連江縣南竿鄉	2018-11-25T06:12:40+08:00	2708	425	3133	139	3272	6461	50.64%	41.91%	4	4
8	連江縣南竿鄉	2018-11-24T23:29:50+08:00	0	0	0	0	0	0	0%	0%	0	4
8	連江縣南竿鄉	2018-11-24T23:42:05+08:00	0	0	0	0	0	0	0%	0%	0	4
8	連江縣南竿鄉	2018-11-25T01:06:04+08:00	2018	347	2365	113	2478	4918	50.39%	41.03%	3	4
8	連江縣南竿鄉	2018-11-25T01:11:11+08:00	2708	425	3133	139	3272	6461	50.64%	41.91%	4	4
8	連江縣南竿鄉	2018-11-25T00:21:47+08:00	0	0	0	0	0	0	0%	0%	0	4
8	連江縣南竿鄉	2018-11-25T03:42:52+08:00	2708	425	3133	139	3272	6461	50.64%	41.91%	4	4
8	連江縣南竿鄉	2018-11-25T06:07:26+08:00	2708	425	3133	139	3272	6461	50.64%	41.91%	4	4
8	連江縣南竿鄉	2018-11-24T22:40:22+08:00	0	0	0	0	0	0	0%	0%	0	4
8	連江縣南竿鄉	2018-11-25T00:56:17+08:00	830	139	969	44	1013	1967	51.5%	42.2%	1	4
8	連江縣南竿鄉	2018-11-24T22:35:48+08:00	0	0	0	0	0	0	0%	0%	0	4
8	連江縣南竿鄉	2018-11-24T22:43:54+08:00	0	0	0	0	0	0	0%	0%	0	4
8	連江縣南竿鄉	2018-11-25T03:31:03+08:00	2708	425	3133	139	3272	6461	50.64%	41.91%	4	4
8	連江縣南竿鄉	2018-11-25T01:01:05+08:00	2018	347	2365	113	2478	4918	50.39%	41.03%	3	4
8	連江縣南竿鄉	2018-11-25T01:16:26+08:00	2708	425	3133	139	3272	6461	50.64%	41.91%	4	4
8	連江縣南竿鄉	2018-11-25T00:03:39+08:00	0	0	0	0	0	0	0%	0%	0	4
8	臺中市外埔區	2018-11-24T23:10:50+08:00	11290	3099	14389	1294	15683	27059	57.96%	41.72%	20	20
8	臺中市外埔區	2018-11-25T00:56:06+08:00	11290	3099	14389	1294	15683	27059	57.96%	41.72%	20	20
8	臺中市外埔區	2018-11-24T23:14:33+08:00	11290	3099	14389	1294	15683	27059	57.96%	41.72%	20	20
8	臺中市外埔區	2018-11-24T23:22:16+08:00	11290	3099	14389	1294	15683	27059	57.96%	41.72%	20	20
8	臺中市外埔區	2018-11-24T22:56:31+08:00	11290	3099	14389	1294	15683	27059	57.96%	41.72%	20	20
8	臺中市外埔區	2018-11-25T00:12:39+08:00	11290	3099	14389	1294	15683	27059	57.96%	41.72%	20	20
8	臺中市外埔區	2018-11-24T22:49:17+08:00	11290	3099	14389	1294	15683	27059	57.96%	41.72%	20	20
8	臺中市外埔區	2018-11-25T03:37:18+08:00	11290	3099	14389	1294	15683	27059	57.96%	41.72%	20	20
8	臺中市外埔區	2018-11-24T22:43:44+08:00	11290	3099	14389	1294	15683	27059	57.96%	41.72%	20	20
8	臺中市外埔區	2018-11-25T00:03:26+08:00	11290	3099	14389	1294	15683	27059	57.96%	41.72%	20	20
8	臺中市外埔區	2018-11-25T01:10:59+08:00	11290	3099	14389	1294	15683	27059	57.96%	41.72%	20	20
8	臺中市外埔區	2018-11-25T06:22:39+08:00	11290	3099	14389	1294	15683	27059	57.96%	41.72%	20	20
8	臺中市外埔區	2018-11-25T03:30:51+08:00	11290	3099	14389	1294	15683	27059	57.96%	41.72%	20	20
8	臺中市外埔區	2018-11-24T22:25:17+08:00	10551	2877	13428	1185	14613	25157	58.09%	41.94%	19	20
8	臺中市外埔區	2018-11-24T23:29:40+08:00	11290	3099	14389	1294	15683	27059	57.96%	41.72%	20	20
8	臺中市外埔區	2018-11-25T00:17:02+08:00	11290	3099	14389	1294	15683	27059	57.96%	41.72%	20	20
8	臺中市外埔區	2018-11-25T00:07:58+08:00	11290	3099	14389	1294	15683	27059	57.96%	41.72%	20	20
8	臺中市外埔區	2018-11-25T01:16:15+08:00	11290	3099	14389	1294	15683	27059	57.96%	41.72%	20	20
8	臺中市外埔區	2018-11-25T01:05:52+08:00	11290	3099	14389	1294	15683	27059	57.96%	41.72%	20	20
8	臺中市外埔區	2018-11-24T22:14:42+08:00	10551	2877	13428	1185	14613	25157	58.09%	41.94%	19	20
8	臺中市外埔區	2018-11-24T23:54:19+08:00	11290	3099	14389	1294	15683	27059	57.96%	41.72%	20	20
8	臺中市外埔區	2018-11-24T22:28:34+08:00	11290	3099	14389	1294	15683	27059	57.96%	41.72%	20	20
8	臺中市外埔區	2018-11-24T22:18:13+08:00	10551	2877	13428	1185	14613	25157	58.09%	41.94%	19	20
8	臺中市外埔區	2018-11-24T23:50:08+08:00	11290	3099	14389	1294	15683	27059	57.96%	41.72%	20	20
8	臺中市外埔區	2018-11-24T22:39:02+08:00	11290	3099	14389	1294	15683	27059	57.96%	41.72%	20	20
8	臺中市外埔區	2018-11-25T01:24:17+08:00	11290	3099	14389	1294	15683	27059	57.96%	41.72%	20	20
8	臺中市外埔區	2018-11-24T22:35:39+08:00	11290	3099	14389	1294	15683	27059	57.96%	41.72%	20	20
8	臺中市外埔區	2018-11-24T23:58:35+08:00	11290	3099	14389	1294	15683	27059	57.96%	41.72%	20	20
8	臺中市外埔區	2018-11-25T06:27:49+08:00	11290	3099	14389	1294	15683	27059	57.96%	41.72%	20	20
8	臺中市外埔區	2018-11-24T23:03:41+08:00	11290	3099	14389	1294	15683	27059	57.96%	41.72%	20	20
8	臺中市外埔區	2018-11-24T23:07:13+08:00	11290	3099	14389	1294	15683	27059	57.96%	41.72%	20	20
8	臺中市外埔區	2018-11-25T01:00:53+08:00	11290	3099	14389	1294	15683	27059	57.96%	41.72%	20	20
8	臺中市外埔區	2018-11-24T23:00:08+08:00	11290	3099	14389	1294	15683	27059	57.96%	41.72%	20	20
8	臺中市外埔區	2018-11-25T03:48:22+08:00	11290	3099	14389	1294	15683	27059	57.96%	41.72%	20	20
8	臺中市外埔區	2018-11-25T00:21:37+08:00	11290	3099	14389	1294	15683	27059	57.96%	41.72%	20	20
8	臺中市外埔區	2018-11-25T03:42:41+08:00	11290	3099	14389	1294	15683	27059	57.96%	41.72%	20	20
8	臺中市外埔區	2018-11-24T22:21:39+08:00	10551	2877	13428	1185	14613	25157	58.09%	41.94%	19	20
8	臺中市外埔區	2018-11-24T22:32:12+08:00	11290	3099	14389	1294	15683	27059	57.96%	41.72%	20	20
8	臺中市外埔區	2018-11-24T22:53:08+08:00	11290	3099	14389	1294	15683	27059	57.96%	41.72%	20	20
8	臺中市外埔區	2018-11-25T04:01:22+08:00	11290	3099	14389	1294	15683	27059	57.96%	41.72%	20	20
8	臺中市外埔區	2018-11-24T22:11:57+08:00	10551	2877	13428	1185	14613	25157	58.09%	41.94%	19	20
8	臺中市外埔區	2018-11-24T22:40:13+08:00	11290	3099	14389	1294	15683	27059	57.96%	41.72%	20	20
8	臺中市外埔區	2018-11-25T06:12:31+08:00	11290	3099	14389	1294	15683	27059	57.96%	41.72%	20	20
8	臺中市外埔區	2018-11-25T06:07:16+08:00	11290	3099	14389	1294	15683	27059	57.96%	41.72%	20	20
8	臺中市外埔區	2018-11-24T23:33:44+08:00	11290	3099	14389	1294	15683	27059	57.96%	41.72%	20	20
8	臺中市外埔區	2018-11-24T23:26:01+08:00	11290	3099	14389	1294	15683	27059	57.96%	41.72%	20	20
8	臺中市外埔區	2018-11-25T03:54:34+08:00	11290	3099	14389	1294	15683	27059	57.96%	41.72%	20	20
8	臺中市外埔區	2018-11-25T06:17:29+08:00	11290	3099	14389	1294	15683	27059	57.96%	41.72%	20	20
8	臺中市外埔區	2018-11-24T23:41:56+08:00	11290	3099	14389	1294	15683	27059	57.96%	41.72%	20	20
8	臺中市外埔區	2018-11-24T23:37:43+08:00	11290	3099	14389	1294	15683	27059	57.96%	41.72%	20	20
8	臺中市外埔區	2018-11-24T23:18:21+08:00	11290	3099	14389	1294	15683	27059	57.96%	41.72%	20	20
8	臺中市外埔區	2018-11-24T23:45:57+08:00	11290	3099	14389	1294	15683	27059	57.96%	41.72%	20	20
8	彰化縣鹿港鎮	2018-11-24T22:12:00+08:00	14678	4548	19226	2024	21250	36368	58.43%	40.36%	35	65
8	彰化縣鹿港鎮	2018-11-24T22:39:07+08:00	16756	5142	21898	2351	24249	41464	58.48%	40.41%	40	65
8	彰化縣鹿港鎮	2018-11-24T23:03:45+08:00	18078	5501	23579	2498	26077	44582	58.49%	40.55%	43	65
8	彰化縣鹿港鎮	2018-11-24T23:07:17+08:00	18078	5501	23579	2498	26077	44582	58.49%	40.55%	43	65
8	彰化縣鹿港鎮	2018-11-25T03:37:27+08:00	28359	8531	36890	3742	40632	70505	57.63%	40.22%	65	65
8	彰化縣鹿港鎮	2018-11-24T23:22:21+08:00	21547	6615	28162	2967	31129	52998	58.74%	40.66%	50	65
8	彰化縣鹿港鎮	2018-11-25T01:24:22+08:00	28359	8531	36890	3742	40632	70505	57.63%	40.22%	65	65
8	彰化縣鹿港鎮	2018-11-25T03:30:57+08:00	28359	8531	36890	3742	40632	70505	57.63%	40.22%	65	65
8	彰化縣鹿港鎮	2018-11-25T01:00:59+08:00	27767	8386	36153	3698	39851	69061	57.7%	40.21%	64	65
8	彰化縣鹿港鎮	2018-11-24T23:42:00+08:00	23633	7197	30830	3217	34047	58539	58.16%	40.37%	55	65
8	彰化縣鹿港鎮	2018-11-24T22:32:16+08:00	16001	4929	20930	2226	23156	39600	58.47%	40.41%	38	65
8	彰化縣鹿港鎮	2018-11-25T03:48:27+08:00	28359	8531	36890	3742	40632	70505	57.63%	40.22%	65	65
8	彰化縣鹿港鎮	2018-11-25T04:01:27+08:00	28359	8531	36890	3742	40632	70505	57.63%	40.22%	65	65
8	彰化縣鹿港鎮	2018-11-24T22:21:44+08:00	16001	4929	20930	2226	23156	39600	58.47%	40.41%	38	65
8	彰化縣鹿港鎮	2018-11-24T22:40:17+08:00	16756	5142	21898	2351	24249	41464	58.48%	40.41%	40	65
8	彰化縣鹿港鎮	2018-11-25T00:21:42+08:00	26490	7965	34455	3501	37956	65713	57.76%	40.31%	61	65
8	彰化縣鹿港鎮	2018-11-25T06:12:35+08:00	28359	8531	36890	3742	40632	70505	57.63%	40.22%	65	65
8	彰化縣鹿港鎮	2018-11-25T00:03:32+08:00	25464	7695	33159	3412	36571	63144	57.92%	40.33%	59	65
8	彰化縣鹿港鎮	2018-11-24T23:58:40+08:00	25464	7695	33159	3412	36571	63144	57.92%	40.33%	59	65
8	彰化縣鹿港鎮	2018-11-24T23:26:05+08:00	21911	6729	28640	2994	31634	53905	58.68%	40.65%	51	65
8	彰化縣鹿港鎮	2018-11-24T23:37:47+08:00	23633	7197	30830	3217	34047	58539	58.16%	40.37%	55	65
8	彰化縣鹿港鎮	2018-11-24T23:18:25+08:00	20158	6190	26348	2777	29125	49539	58.79%	40.69%	47	65
8	彰化縣鹿港鎮	2018-11-24T22:35:43+08:00	16404	5023	21427	2265	23692	40584	58.38%	40.42%	39	65
8	彰化縣鹿港鎮	2018-11-24T23:33:48+08:00	22901	6967	29868	3134	33002	56614	58.29%	40.45%	53	65
8	彰化縣鹿港鎮	2018-11-25T03:54:38+08:00	28359	8531	36890	3742	40632	70505	57.63%	40.22%	65	65
8	彰化縣鹿港鎮	2018-11-25T00:56:12+08:00	27767	8386	36153	3698	39851	69061	57.7%	40.21%	64	65
8	彰化縣鹿港鎮	2018-11-24T22:43:48+08:00	16756	5142	21898	2351	24249	41464	58.48%	40.41%	40	65
8	彰化縣鹿港鎮	2018-11-24T23:14:39+08:00	19136	5880	25016	2654	27670	47234	58.58%	40.51%	45	65
8	彰化縣鹿港鎮	2018-11-24T23:10:54+08:00	18569	5673	24242	2571	26813	45809	58.53%	40.54%	44	65
8	彰化縣鹿港鎮	2018-11-25T06:17:34+08:00	28359	8531	36890	3742	40632	70505	57.63%	40.22%	65	65
8	彰化縣鹿港鎮	2018-11-24T22:56:34+08:00	17630	5388	23018	2441	25459	43579	58.42%	40.46%	42	65
8	彰化縣鹿港鎮	2018-11-24T22:49:22+08:00	16756	5142	21898	2351	24249	41464	58.48%	40.41%	40	65
8	彰化縣鹿港鎮	2018-11-24T22:53:13+08:00	17159	5275	22434	2381	24815	42561	58.3%	40.32%	41	65
8	彰化縣鹿港鎮	2018-11-24T23:46:02+08:00	23633	7197	30830	3217	34047	58539	58.16%	40.37%	55	65
8	彰化縣鹿港鎮	2018-11-25T00:08:02+08:00	25464	7695	33159	3412	36571	63144	57.92%	40.33%	59	65
8	彰化縣鹿港鎮	2018-11-25T03:42:46+08:00	28359	8531	36890	3742	40632	70505	57.63%	40.22%	65	65
8	彰化縣鹿港鎮	2018-11-25T01:11:05+08:00	28359	8531	36890	3742	40632	70505	57.63%	40.22%	65	65
8	彰化縣鹿港鎮	2018-11-24T22:25:22+08:00	16001	4929	20930	2226	23156	39600	58.47%	40.41%	38	65
8	彰化縣鹿港鎮	2018-11-25T06:07:21+08:00	28359	8531	36890	3742	40632	70505	57.63%	40.22%	65	65
8	彰化縣鹿港鎮	2018-11-25T06:22:43+08:00	28359	8531	36890	3742	40632	70505	57.63%	40.22%	65	65
8	彰化縣鹿港鎮	2018-11-24T23:29:44+08:00	21911	6729	28640	2994	31634	53905	58.68%	40.65%	51	65
8	彰化縣鹿港鎮	2018-11-25T00:17:06+08:00	26490	7965	34455	3501	37956	65713	57.76%	40.31%	61	65
8	彰化縣鹿港鎮	2018-11-24T23:00:15+08:00	17630	5388	23018	2441	25459	43579	58.42%	40.46%	42	65
8	彰化縣鹿港鎮	2018-11-25T00:12:43+08:00	25963	7837	33800	3474	37274	64417	57.86%	40.3%	60	65
8	彰化縣鹿港鎮	2018-11-24T22:28:38+08:00	16001	4929	20930	2226	23156	39600	58.47%	40.41%	38	65
8	彰化縣鹿港鎮	2018-11-24T22:14:47+08:00	15068	4669	19737	2112	21849	37342	58.51%	40.35%	36	65
8	彰化縣鹿港鎮	2018-11-25T06:27:53+08:00	28359	8531	36890	3742	40632	70505	57.63%	40.22%	65	65
8	彰化縣鹿港鎮	2018-11-24T22:18:18+08:00	15523	4795	20318	2172	22490	38439	58.51%	40.38%	37	65
8	彰化縣鹿港鎮	2018-11-24T23:50:13+08:00	24111	7327	31438	3271	34709	59734	58.11%	40.36%	56	65
8	彰化縣鹿港鎮	2018-11-25T01:16:20+08:00	28359	8531	36890	3742	40632	70505	57.63%	40.22%	65	65
8	彰化縣鹿港鎮	2018-11-24T23:54:25+08:00	24516	7429	31945	3317	35262	60754	58.04%	40.35%	57	65
8	彰化縣鹿港鎮	2018-11-25T01:05:57+08:00	27767	8386	36153	3698	39851	69061	57.7%	40.21%	64	65
8	臺東縣臺東市	2018-11-24T22:14:51+08:00	8372	2315	10687	892	11579	21601	53.6%	38.76%	23	69
8	臺東縣臺東市	2018-11-24T22:28:42+08:00	10599	2931	13530	1173	14703	27544	53.38%	38.48%	28	69
8	臺東縣臺東市	2018-11-24T22:56:38+08:00	16094	4215	20309	1655	21964	40769	53.87%	39.48%	38	69
8	臺東縣臺東市	2018-11-24T23:07:21+08:00	18743	4991	23734	2063	25797	47731	54.05%	39.27%	43	69
8	臺東縣臺東市	2018-11-24T22:49:26+08:00	14781	3921	18702	1564	20266	37766	53.66%	39.14%	36	69
8	臺東縣臺東市	2018-11-24T23:10:58+08:00	18743	4991	23734	2063	25797	47731	54.05%	39.27%	43	69
8	臺東縣臺東市	2018-11-24T23:33:53+08:00	23069	6188	29257	2453	31710	58646	54.07%	39.34%	50	69
8	臺東縣臺東市	2018-11-25T06:17:39+08:00	34531	9173	43704	3501	47205	87803	53.76%	39.33%	69	69
8	臺東縣臺東市	2018-11-24T22:53:17+08:00	15468	4099	19567	1624	21191	39256	53.98%	39.4%	37	69
8	臺東縣臺東市	2018-11-24T23:46:06+08:00	25884	6922	32806	2687	35493	65544	54.15%	39.49%	55	69
8	臺東縣臺東市	2018-11-25T00:08:07+08:00	30056	8067	38123	3121	41244	76637	53.82%	39.22%	62	69
8	臺東縣臺東市	2018-11-24T22:32:20+08:00	10904	3016	13920	1191	15111	28483	53.05%	38.28%	29	69
8	臺東縣臺東市	2018-11-25T00:17:10+08:00	30056	8067	38123	3121	41244	76637	53.82%	39.22%	62	69
8	臺東縣臺東市	2018-11-25T04:01:32+08:00	34531	9173	43704	3501	47205	87803	53.76%	39.33%	69	69
8	臺東縣臺東市	2018-11-25T03:48:34+08:00	34531	9173	43704	3501	47205	87803	53.76%	39.33%	69	69
8	臺東縣臺東市	2018-11-24T23:00:19+08:00	16094	4215	20309	1655	21964	40769	53.87%	39.48%	38	69
8	臺東縣臺東市	2018-11-25T06:07:25+08:00	34531	9173	43704	3501	47205	87803	53.76%	39.33%	69	69
8	臺東縣臺東市	2018-11-24T22:25:28+08:00	10256	2861	13117	1141	14258	26685	53.43%	38.43%	27	69
8	臺東縣臺東市	2018-11-25T06:22:47+08:00	34531	9173	43704	3501	47205	87803	53.76%	39.33%	69	69
8	臺東縣臺東市	2018-11-25T03:42:51+08:00	34531	9173	43704	3501	47205	87803	53.76%	39.33%	69	69
8	臺東縣臺東市	2018-11-24T22:40:21+08:00	12731	3379	16110	1373	17483	32575	53.67%	39.08%	32	69
8	臺東縣臺東市	2018-11-24T23:29:49+08:00	20558	5448	26006	2269	28275	52187	54.18%	39.39%	46	69
8	臺東縣臺東市	2018-11-24T23:50:17+08:00	26586	7119	33705	2738	36443	67182	54.25%	39.57%	56	69
8	臺東縣臺東市	2018-11-24T23:14:43+08:00	18743	4991	23734	2063	25797	47731	54.05%	39.27%	43	69
8	臺東縣臺東市	2018-11-25T00:12:47+08:00	30056	8067	38123	3121	41244	76637	53.82%	39.22%	62	69
8	臺東縣臺東市	2018-11-24T23:54:29+08:00	26586	7119	33705	2738	36443	67182	54.25%	39.57%	56	69
8	臺東縣臺東市	2018-11-25T06:27:57+08:00	34531	9173	43704	3501	47205	87803	53.76%	39.33%	69	69
8	臺東縣臺東市	2018-11-25T01:16:25+08:00	32375	8659	41034	3321	44355	82485	53.77%	39.25%	66	69
8	臺東縣臺東市	2018-11-24T22:18:22+08:00	9016	2488	11504	929	12433	23280	53.41%	38.73%	24	69
8	臺東縣臺東市	2018-11-25T03:37:32+08:00	34531	9173	43704	3501	47205	87803	53.76%	39.33%	69	69
8	臺東縣臺東市	2018-11-25T01:24:27+08:00	32729	8743	41472	3357	44829	83543	53.66%	39.18%	67	69
8	臺東縣臺東市	2018-11-25T03:54:44+08:00	34531	9173	43704	3501	47205	87803	53.76%	39.33%	69	69
8	臺東縣臺東市	2018-11-24T23:03:49+08:00	18261	4811	23072	1954	25026	46226	54.14%	39.5%	42	69
8	臺東縣臺東市	2018-11-24T23:22:25+08:00	19412	5147	24559	2130	26689	49326	54.11%	39.35%	44	69
8	臺東縣臺東市	2018-11-24T23:37:51+08:00	23708	6341	30049	2502	32551	60009	54.24%	39.51%	51	69
8	臺東縣臺東市	2018-11-24T22:12:05+08:00	7424	2099	9523	806	10329	19031	54.27%	39.01%	21	69
8	臺東縣臺東市	2018-11-25T01:06:02+08:00	32375	8659	41034	3321	44355	82485	53.77%	39.25%	66	69
8	臺東縣臺東市	2018-11-24T23:42:04+08:00	24266	6505	30771	2546	33317	61408	54.26%	39.52%	52	69
8	臺東縣臺東市	2018-11-25T01:11:10+08:00	32375	8659	41034	3321	44355	82485	53.77%	39.25%	66	69
8	臺東縣臺東市	2018-11-25T06:12:39+08:00	34531	9173	43704	3501	47205	87803	53.76%	39.33%	69	69
8	臺東縣臺東市	2018-11-25T00:21:46+08:00	30519	8219	38738	3131	41869	77987	53.69%	39.13%	63	69
8	臺東縣臺東市	2018-11-24T22:21:49+08:00	9420	2603	12023	1000	13023	24396	53.38%	38.61%	25	69
8	臺東縣臺東市	2018-11-25T01:01:04+08:00	32375	8659	41034	3321	44355	82485	53.77%	39.25%	66	69
8	臺東縣臺東市	2018-11-24T22:43:53+08:00	13479	3567	17046	1429	18475	34435	53.65%	39.14%	34	69
8	臺東縣臺東市	2018-11-24T23:18:29+08:00	19412	5147	24559	2130	26689	49326	54.11%	39.35%	44	69
8	臺東縣臺東市	2018-11-24T22:35:47+08:00	11664	3080	14744	1268	16012	29952	53.46%	38.94%	30	69
8	臺東縣臺東市	2018-11-24T23:58:45+08:00	29104	7757	36861	2984	39845	73880	53.93%	39.39%	60	69
8	臺東縣臺東市	2018-11-25T00:56:16+08:00	32375	8659	41034	3321	44355	82485	53.77%	39.25%	66	69
8	臺東縣臺東市	2018-11-24T22:39:11+08:00	12731	3379	16110	1373	17483	32575	53.67%	39.08%	32	69
8	臺東縣臺東市	2018-11-24T23:26:09+08:00	19412	5147	24559	2130	26689	49326	54.11%	39.35%	44	69
8	臺東縣臺東市	2018-11-25T03:31:02+08:00	34531	9173	43704	3501	47205	87803	53.76%	39.33%	69	69
8	臺東縣臺東市	2018-11-25T00:03:37+08:00	30056	8067	38123	3121	41244	76637	53.82%	39.22%	62	69
8	臺東縣綠島鄉	2018-11-24T23:26:10+08:00	801	211	1012	63	1075	2497	43.05%	32.08%	3	4
8	臺東縣綠島鄉	2018-11-24T22:49:27+08:00	801	211	1012	63	1075	2497	43.05%	32.08%	3	4
8	臺東縣綠島鄉	2018-11-24T23:10:58+08:00	801	211	1012	63	1075	2497	43.05%	32.08%	3	4
8	臺東縣綠島鄉	2018-11-24T23:33:53+08:00	801	211	1012	63	1075	2497	43.05%	32.08%	3	4
8	臺東縣綠島鄉	2018-11-24T22:56:39+08:00	801	211	1012	63	1075	2497	43.05%	32.08%	3	4
8	臺東縣綠島鄉	2018-11-24T23:22:26+08:00	801	211	1012	63	1075	2497	43.05%	32.08%	3	4
8	臺東縣綠島鄉	2018-11-24T22:28:43+08:00	801	211	1012	63	1075	2497	43.05%	32.08%	3	4
8	臺東縣綠島鄉	2018-11-24T23:18:30+08:00	801	211	1012	63	1075	2497	43.05%	32.08%	3	4
8	臺東縣綠島鄉	2018-11-25T00:17:11+08:00	1147	300	1447	101	1548	3579	43.25%	32.05%	4	4
8	臺東縣綠島鄉	2018-11-24T22:32:21+08:00	801	211	1012	63	1075	2497	43.05%	32.08%	3	4
8	臺東縣綠島鄉	2018-11-24T23:46:06+08:00	1147	300	1447	101	1548	3579	43.25%	32.05%	4	4
8	臺東縣綠島鄉	2018-11-25T00:08:07+08:00	1147	300	1447	101	1548	3579	43.25%	32.05%	4	4
8	臺東縣綠島鄉	2018-11-24T22:53:18+08:00	801	211	1012	63	1075	2497	43.05%	32.08%	3	4
8	臺東縣綠島鄉	2018-11-25T04:01:32+08:00	1147	300	1447	101	1548	3579	43.25%	32.05%	4	4
8	臺東縣綠島鄉	2018-11-25T03:48:34+08:00	1147	300	1447	101	1548	3579	43.25%	32.05%	4	4
8	臺東縣綠島鄉	2018-11-24T23:00:19+08:00	801	211	1012	63	1075	2497	43.05%	32.08%	3	4
8	臺東縣綠島鄉	2018-11-24T22:25:28+08:00	801	211	1012	63	1075	2497	43.05%	32.08%	3	4
8	臺東縣綠島鄉	2018-11-25T06:22:47+08:00	1147	300	1447	101	1548	3579	43.25%	32.05%	4	4
8	臺東縣綠島鄉	2018-11-25T03:42:51+08:00	1147	300	1447	101	1548	3579	43.25%	32.05%	4	4
8	臺東縣綠島鄉	2018-11-24T22:40:21+08:00	801	211	1012	63	1075	2497	43.05%	32.08%	3	4
8	臺東縣綠島鄉	2018-11-24T23:29:49+08:00	801	211	1012	63	1075	2497	43.05%	32.08%	3	4
8	臺東縣綠島鄉	2018-11-24T23:14:44+08:00	801	211	1012	63	1075	2497	43.05%	32.08%	3	4
8	臺東縣綠島鄉	2018-11-24T23:50:17+08:00	1147	300	1447	101	1548	3579	43.25%	32.05%	4	4
8	臺東縣綠島鄉	2018-11-25T00:12:47+08:00	1147	300	1447	101	1548	3579	43.25%	32.05%	4	4
8	臺東縣綠島鄉	2018-11-25T01:16:25+08:00	1147	300	1447	101	1548	3579	43.25%	32.05%	4	4
8	臺東縣綠島鄉	2018-11-24T22:18:22+08:00	339	105	444	33	477	1023	46.63%	33.14%	2	4
8	臺東縣綠島鄉	2018-11-25T03:37:32+08:00	1147	300	1447	101	1548	3579	43.25%	32.05%	4	4
8	臺東縣綠島鄉	2018-11-25T06:27:58+08:00	1147	300	1447	101	1548	3579	43.25%	32.05%	4	4
8	臺東縣綠島鄉	2018-11-25T06:17:40+08:00	1147	300	1447	101	1548	3579	43.25%	32.05%	4	4
8	臺東縣綠島鄉	2018-11-25T03:54:44+08:00	1147	300	1447	101	1548	3579	43.25%	32.05%	4	4
8	臺東縣綠島鄉	2018-11-24T23:03:49+08:00	801	211	1012	63	1075	2497	43.05%	32.08%	3	4
8	臺東縣綠島鄉	2018-11-24T22:14:52+08:00	339	105	444	33	477	1023	46.63%	33.14%	2	4
8	臺東縣綠島鄉	2018-11-25T01:24:28+08:00	1147	300	1447	101	1548	3579	43.25%	32.05%	4	4
8	臺東縣綠島鄉	2018-11-24T23:37:51+08:00	801	211	1012	63	1075	2497	43.05%	32.08%	3	4
8	臺東縣綠島鄉	2018-11-24T23:07:22+08:00	801	211	1012	63	1075	2497	43.05%	32.08%	3	4
8	臺東縣綠島鄉	2018-11-24T22:12:05+08:00	339	105	444	33	477	1023	46.63%	33.14%	2	4
8	臺東縣綠島鄉	2018-11-24T23:54:30+08:00	1147	300	1447	101	1548	3579	43.25%	32.05%	4	4
8	臺東縣綠島鄉	2018-11-25T06:12:40+08:00	1147	300	1447	101	1548	3579	43.25%	32.05%	4	4
8	臺東縣綠島鄉	2018-11-24T23:42:04+08:00	801	211	1012	63	1075	2497	43.05%	32.08%	3	4
8	臺東縣綠島鄉	2018-11-25T01:11:10+08:00	1147	300	1447	101	1548	3579	43.25%	32.05%	4	4
8	臺東縣綠島鄉	2018-11-25T01:06:03+08:00	1147	300	1447	101	1548	3579	43.25%	32.05%	4	4
8	臺東縣綠島鄉	2018-11-25T00:21:47+08:00	1147	300	1447	101	1548	3579	43.25%	32.05%	4	4
8	臺東縣綠島鄉	2018-11-25T06:07:26+08:00	1147	300	1447	101	1548	3579	43.25%	32.05%	4	4
8	臺東縣綠島鄉	2018-11-24T22:21:49+08:00	339	105	444	33	477	1023	46.63%	33.14%	2	4
8	臺東縣綠島鄉	2018-11-25T00:03:38+08:00	1147	300	1447	101	1548	3579	43.25%	32.05%	4	4
8	臺東縣綠島鄉	2018-11-24T22:43:53+08:00	801	211	1012	63	1075	2497	43.05%	32.08%	3	4
8	臺東縣綠島鄉	2018-11-24T22:35:47+08:00	801	211	1012	63	1075	2497	43.05%	32.08%	3	4
8	臺東縣綠島鄉	2018-11-24T23:58:45+08:00	1147	300	1447	101	1548	3579	43.25%	32.05%	4	4
8	臺東縣綠島鄉	2018-11-25T01:01:05+08:00	1147	300	1447	101	1548	3579	43.25%	32.05%	4	4
8	臺東縣綠島鄉	2018-11-25T00:56:16+08:00	1147	300	1447	101	1548	3579	43.25%	32.05%	4	4
8	臺東縣綠島鄉	2018-11-24T22:39:11+08:00	801	211	1012	63	1075	2497	43.05%	32.08%	3	4
8	臺東縣綠島鄉	2018-11-25T03:31:02+08:00	1147	300	1447	101	1548	3579	43.25%	32.05%	4	4
8	新竹縣北埔鄉	2018-11-24T22:39:06+08:00	2291	687	2978	211	3189	5764	55.33%	39.75%	8	10
8	新竹縣北埔鄉	2018-11-24T23:03:44+08:00	2291	687	2978	211	3189	5764	55.33%	39.75%	8	10
8	新竹縣北埔鄉	2018-11-24T23:22:20+08:00	2291	687	2978	211	3189	5764	55.33%	39.75%	8	10
8	新竹縣北埔鄉	2018-11-24T23:58:39+08:00	3310	931	4241	297	4538	8180	55.48%	40.46%	10	10
8	新竹縣北埔鄉	2018-11-24T22:49:21+08:00	2291	687	2978	211	3189	5764	55.33%	39.75%	8	10
8	新竹縣北埔鄉	2018-11-24T23:46:01+08:00	3310	931	4241	297	4538	8180	55.48%	40.46%	10	10
8	新竹縣北埔鄉	2018-11-25T03:48:26+08:00	3310	931	4241	297	4538	8180	55.48%	40.46%	10	10
8	新竹縣北埔鄉	2018-11-24T22:53:11+08:00	2291	687	2978	211	3189	5764	55.33%	39.75%	8	10
8	新竹縣北埔鄉	2018-11-25T03:42:45+08:00	3310	931	4241	297	4538	8180	55.48%	40.46%	10	10
8	新竹縣北埔鄉	2018-11-25T01:00:58+08:00	3310	931	4241	297	4538	8180	55.48%	40.46%	10	10
8	新竹縣北埔鄉	2018-11-25T00:08:01+08:00	3310	931	4241	297	4538	8180	55.48%	40.46%	10	10
8	新竹縣北埔鄉	2018-11-25T04:01:26+08:00	3310	931	4241	297	4538	8180	55.48%	40.46%	10	10
8	新竹縣北埔鄉	2018-11-24T22:25:21+08:00	2291	687	2978	211	3189	5764	55.33%	39.75%	8	10
8	新竹縣北埔鄉	2018-11-25T06:12:34+08:00	3310	931	4241	297	4538	8180	55.48%	40.46%	10	10
8	新竹縣北埔鄉	2018-11-24T22:40:16+08:00	2291	687	2978	211	3189	5764	55.33%	39.75%	8	10
8	新竹縣北埔鄉	2018-11-24T22:21:43+08:00	2291	687	2978	211	3189	5764	55.33%	39.75%	8	10
8	新竹縣北埔鄉	2018-11-25T00:17:05+08:00	3310	931	4241	297	4538	8180	55.48%	40.46%	10	10
8	新竹縣北埔鄉	2018-11-24T23:18:24+08:00	2291	687	2978	211	3189	5764	55.33%	39.75%	8	10
8	新竹縣北埔鄉	2018-11-24T23:37:46+08:00	2625	761	3386	223	3609	6527	55.29%	40.22%	9	10
8	新竹縣北埔鄉	2018-11-24T22:35:42+08:00	2291	687	2978	211	3189	5764	55.33%	39.75%	8	10
8	新竹縣北埔鄉	2018-11-25T03:54:37+08:00	3310	931	4241	297	4538	8180	55.48%	40.46%	10	10
8	新竹縣北埔鄉	2018-11-24T23:33:47+08:00	2625	761	3386	223	3609	6527	55.29%	40.22%	9	10
8	新竹縣北埔鄉	2018-11-24T23:26:04+08:00	2291	687	2978	211	3189	5764	55.33%	39.75%	8	10
8	新竹縣北埔鄉	2018-11-24T22:14:45+08:00	2291	687	2978	211	3189	5764	55.33%	39.75%	8	10
8	新竹縣北埔鄉	2018-11-24T23:07:15+08:00	2291	687	2978	211	3189	5764	55.33%	39.75%	8	10
8	新竹縣北埔鄉	2018-11-24T23:14:37+08:00	2291	687	2978	211	3189	5764	55.33%	39.75%	8	10
8	新竹縣北埔鄉	2018-11-24T23:10:53+08:00	2291	687	2978	211	3189	5764	55.33%	39.75%	8	10
8	新竹縣北埔鄉	2018-11-25T06:17:33+08:00	3310	931	4241	297	4538	8180	55.48%	40.46%	10	10
8	新竹縣北埔鄉	2018-11-24T22:43:47+08:00	2291	687	2978	211	3189	5764	55.33%	39.75%	8	10
8	新竹縣北埔鄉	2018-11-24T22:56:33+08:00	2291	687	2978	211	3189	5764	55.33%	39.75%	8	10
8	新竹縣北埔鄉	2018-11-25T01:24:21+08:00	3310	931	4241	297	4538	8180	55.48%	40.46%	10	10
8	新竹縣北埔鄉	2018-11-25T03:37:23+08:00	3310	931	4241	297	4538	8180	55.48%	40.46%	10	10
8	新竹縣北埔鄉	2018-11-25T03:30:55+08:00	3310	931	4241	297	4538	8180	55.48%	40.46%	10	10
8	新竹縣北埔鄉	2018-11-24T22:32:15+08:00	2291	687	2978	211	3189	5764	55.33%	39.75%	8	10
8	新竹縣北埔鄉	2018-11-24T22:11:59+08:00	2291	687	2978	211	3189	5764	55.33%	39.75%	8	10
8	新竹縣北埔鄉	2018-11-24T23:00:14+08:00	2291	687	2978	211	3189	5764	55.33%	39.75%	8	10
8	新竹縣北埔鄉	2018-11-25T06:07:19+08:00	3310	931	4241	297	4538	8180	55.48%	40.46%	10	10
8	新竹縣北埔鄉	2018-11-25T01:11:03+08:00	3310	931	4241	297	4538	8180	55.48%	40.46%	10	10
8	新竹縣北埔鄉	2018-11-24T23:29:43+08:00	2291	687	2978	211	3189	5764	55.33%	39.75%	8	10
8	新竹縣北埔鄉	2018-11-25T00:21:41+08:00	3310	931	4241	297	4538	8180	55.48%	40.46%	10	10
8	新竹縣北埔鄉	2018-11-25T06:22:42+08:00	3310	931	4241	297	4538	8180	55.48%	40.46%	10	10
8	新竹縣北埔鄉	2018-11-25T00:56:10+08:00	3310	931	4241	297	4538	8180	55.48%	40.46%	10	10
8	新竹縣北埔鄉	2018-11-24T22:18:16+08:00	2291	687	2978	211	3189	5764	55.33%	39.75%	8	10
8	新竹縣北埔鄉	2018-11-25T01:05:56+08:00	3310	931	4241	297	4538	8180	55.48%	40.46%	10	10
8	新竹縣北埔鄉	2018-11-24T23:54:24+08:00	3310	931	4241	297	4538	8180	55.48%	40.46%	10	10
8	新竹縣北埔鄉	2018-11-24T23:41:59+08:00	2625	761	3386	223	3609	6527	55.29%	40.22%	9	10
8	新竹縣北埔鄉	2018-11-25T01:16:18+08:00	3310	931	4241	297	4538	8180	55.48%	40.46%	10	10
8	新竹縣北埔鄉	2018-11-25T06:27:52+08:00	3310	931	4241	297	4538	8180	55.48%	40.46%	10	10
8	新竹縣北埔鄉	2018-11-25T00:12:42+08:00	3310	931	4241	297	4538	8180	55.48%	40.46%	10	10
8	新竹縣北埔鄉	2018-11-24T22:28:37+08:00	2291	687	2978	211	3189	5764	55.33%	39.75%	8	10
8	新竹縣北埔鄉	2018-11-25T00:03:30+08:00	3310	931	4241	297	4538	8180	55.48%	40.46%	10	10
8	新竹縣北埔鄉	2018-11-24T23:50:12+08:00	3310	931	4241	297	4538	8180	55.48%	40.46%	10	10
8	澎湖縣望安鄉	2018-11-24T23:26:10+08:00	1065	299	1364	224	1588	4152	38.25%	25.65%	9	10
8	澎湖縣望安鄉	2018-11-24T23:10:59+08:00	1065	299	1364	224	1588	4152	38.25%	25.65%	9	10
8	澎湖縣望安鄉	2018-11-24T22:49:27+08:00	1065	299	1364	224	1588	4152	38.25%	25.65%	9	10
8	澎湖縣望安鄉	2018-11-24T23:33:53+08:00	1192	333	1525	232	1757	4628	37.96%	25.76%	10	10
8	澎湖縣望安鄉	2018-11-24T22:56:39+08:00	1065	299	1364	224	1588	4152	38.25%	25.65%	9	10
8	澎湖縣望安鄉	2018-11-24T23:22:26+08:00	1065	299	1364	224	1588	4152	38.25%	25.65%	9	10
8	澎湖縣望安鄉	2018-11-24T22:28:43+08:00	1065	299	1364	224	1588	4152	38.25%	25.65%	9	10
8	澎湖縣望安鄉	2018-11-24T23:18:30+08:00	1065	299	1364	224	1588	4152	38.25%	25.65%	9	10
8	澎湖縣望安鄉	2018-11-25T00:17:11+08:00	1192	333	1525	232	1757	4628	37.96%	25.76%	10	10
8	澎湖縣望安鄉	2018-11-24T22:32:21+08:00	1065	299	1364	224	1588	4152	38.25%	25.65%	9	10
8	澎湖縣望安鄉	2018-11-24T23:46:06+08:00	1192	333	1525	232	1757	4628	37.96%	25.76%	10	10
8	澎湖縣望安鄉	2018-11-24T22:53:18+08:00	1065	299	1364	224	1588	4152	38.25%	25.65%	9	10
8	澎湖縣望安鄉	2018-11-25T00:08:08+08:00	1192	333	1525	232	1757	4628	37.96%	25.76%	10	10
8	澎湖縣望安鄉	2018-11-25T04:01:32+08:00	1192	333	1525	232	1757	4628	37.96%	25.76%	10	10
8	澎湖縣望安鄉	2018-11-25T03:48:34+08:00	1192	333	1525	232	1757	4628	37.96%	25.76%	10	10
8	澎湖縣望安鄉	2018-11-24T22:25:28+08:00	939	257	1196	192	1388	3588	38.68%	26.17%	7	10
8	澎湖縣望安鄉	2018-11-25T06:22:47+08:00	1192	333	1525	232	1757	4628	37.96%	25.76%	10	10
8	澎湖縣望安鄉	2018-11-24T23:00:20+08:00	1065	299	1364	224	1588	4152	38.25%	25.65%	9	10
8	澎湖縣望安鄉	2018-11-24T22:40:21+08:00	1065	299	1364	224	1588	4152	38.25%	25.65%	9	10
8	澎湖縣望安鄉	2018-11-24T23:14:44+08:00	1065	299	1364	224	1588	4152	38.25%	25.65%	9	10
8	澎湖縣望安鄉	2018-11-25T03:37:33+08:00	1192	333	1525	232	1757	4628	37.96%	25.76%	10	10
8	澎湖縣望安鄉	2018-11-24T22:18:23+08:00	788	215	1003	148	1151	3117	36.93%	25.28%	6	10
8	澎湖縣望安鄉	2018-11-24T23:50:18+08:00	1192	333	1525	232	1757	4628	37.96%	25.76%	10	10
8	澎湖縣望安鄉	2018-11-24T23:58:46+08:00	1192	333	1525	232	1757	4628	37.96%	25.76%	10	10
8	澎湖縣望安鄉	2018-11-25T00:12:48+08:00	1192	333	1525	232	1757	4628	37.96%	25.76%	10	10
8	澎湖縣望安鄉	2018-11-24T23:03:50+08:00	1065	299	1364	224	1588	4152	38.25%	25.65%	9	10
8	澎湖縣望安鄉	2018-11-24T22:39:12+08:00	1065	299	1364	224	1588	4152	38.25%	25.65%	9	10
8	澎湖縣望安鄉	2018-11-25T06:27:58+08:00	1192	333	1525	232	1757	4628	37.96%	25.76%	10	10
8	澎湖縣望安鄉	2018-11-25T06:17:40+08:00	1192	333	1525	232	1757	4628	37.96%	25.76%	10	10
8	澎湖縣望安鄉	2018-11-24T22:14:52+08:00	788	215	1003	148	1151	3117	36.93%	25.28%	6	10
8	澎湖縣望安鄉	2018-11-25T01:24:28+08:00	1192	333	1525	232	1757	4628	37.96%	25.76%	10	10
8	澎湖縣望安鄉	2018-11-25T03:54:45+08:00	1192	333	1525	232	1757	4628	37.96%	25.76%	10	10
8	澎湖縣望安鄉	2018-11-24T23:37:51+08:00	1192	333	1525	232	1757	4628	37.96%	25.76%	10	10
8	澎湖縣望安鄉	2018-11-24T23:07:22+08:00	1065	299	1364	224	1588	4152	38.25%	25.65%	9	10
8	澎湖縣望安鄉	2018-11-24T22:12:05+08:00	788	215	1003	148	1151	3117	36.93%	25.28%	6	10
8	澎湖縣望安鄉	2018-11-24T23:54:30+08:00	1192	333	1525	232	1757	4628	37.96%	25.76%	10	10
8	澎湖縣望安鄉	2018-11-25T06:12:40+08:00	1192	333	1525	232	1757	4628	37.96%	25.76%	10	10
8	澎湖縣望安鄉	2018-11-24T23:29:50+08:00	1065	299	1364	224	1588	4152	38.25%	25.65%	9	10
8	澎湖縣望安鄉	2018-11-24T23:42:05+08:00	1192	333	1525	232	1757	4628	37.96%	25.76%	10	10
8	澎湖縣望安鄉	2018-11-25T01:06:03+08:00	1192	333	1525	232	1757	4628	37.96%	25.76%	10	10
8	澎湖縣望安鄉	2018-11-25T01:11:11+08:00	1192	333	1525	232	1757	4628	37.96%	25.76%	10	10
8	澎湖縣望安鄉	2018-11-25T00:21:47+08:00	1192	333	1525	232	1757	4628	37.96%	25.76%	10	10
8	澎湖縣望安鄉	2018-11-25T03:42:52+08:00	1192	333	1525	232	1757	4628	37.96%	25.76%	10	10
8	澎湖縣望安鄉	2018-11-25T06:07:26+08:00	1192	333	1525	232	1757	4628	37.96%	25.76%	10	10
8	澎湖縣望安鄉	2018-11-24T22:21:49+08:00	788	215	1003	148	1151	3117	36.93%	25.28%	6	10
8	澎湖縣望安鄉	2018-11-24T22:43:54+08:00	1065	299	1364	224	1588	4152	38.25%	25.65%	9	10
8	澎湖縣望安鄉	2018-11-25T03:31:03+08:00	1192	333	1525	232	1757	4628	37.96%	25.76%	10	10
8	澎湖縣望安鄉	2018-11-24T22:35:47+08:00	1065	299	1364	224	1588	4152	38.25%	25.65%	9	10
8	澎湖縣望安鄉	2018-11-25T01:01:05+08:00	1192	333	1525	232	1757	4628	37.96%	25.76%	10	10
8	澎湖縣望安鄉	2018-11-25T00:56:16+08:00	1192	333	1525	232	1757	4628	37.96%	25.76%	10	10
8	澎湖縣望安鄉	2018-11-25T01:16:26+08:00	1192	333	1525	232	1757	4628	37.96%	25.76%	10	10
8	澎湖縣望安鄉	2018-11-25T00:03:39+08:00	1192	333	1525	232	1757	4628	37.96%	25.76%	10	10
8	苗栗縣後龍鎮	2018-11-24T23:07:16+08:00	11176	3779	14955	1580	16535	29912	55.28%	37.36%	34	35
8	苗栗縣後龍鎮	2018-11-24T22:12:00+08:00	8383	2904	11287	1181	12468	22920	54.4%	36.58%	27	35
8	苗栗縣後龍鎮	2018-11-24T22:39:06+08:00	9573	3273	12846	1336	14182	25902	54.75%	36.96%	30	35
8	苗栗縣後龍鎮	2018-11-24T23:22:20+08:00	11546	3888	15434	1628	17062	30948	55.13%	37.31%	35	35
8	苗栗縣後龍鎮	2018-11-24T23:58:39+08:00	11546	3888	15434	1628	17062	30948	55.13%	37.31%	35	35
8	苗栗縣後龍鎮	2018-11-24T23:03:45+08:00	10720	3622	14342	1530	15872	28799	55.11%	37.22%	33	35
8	苗栗縣後龍鎮	2018-11-24T22:49:21+08:00	9944	3404	13348	1392	14740	26785	55.03%	37.13%	31	35
8	苗栗縣後龍鎮	2018-11-24T23:46:01+08:00	11546	3888	15434	1628	17062	30948	55.13%	37.31%	35	35
8	苗栗縣後龍鎮	2018-11-25T03:48:26+08:00	11546	3888	15434	1628	17062	30948	55.13%	37.31%	35	35
8	苗栗縣後龍鎮	2018-11-25T03:30:56+08:00	11546	3888	15434	1628	17062	30948	55.13%	37.31%	35	35
8	苗栗縣後龍鎮	2018-11-25T03:42:45+08:00	11546	3888	15434	1628	17062	30948	55.13%	37.31%	35	35
8	苗栗縣後龍鎮	2018-11-24T22:32:16+08:00	9573	3273	12846	1336	14182	25902	54.75%	36.96%	30	35
8	苗栗縣後龍鎮	2018-11-25T01:00:58+08:00	11546	3888	15434	1628	17062	30948	55.13%	37.31%	35	35
8	苗栗縣後龍鎮	2018-11-24T22:25:21+08:00	8722	3012	11734	1223	12957	23885	54.25%	36.52%	28	35
8	苗栗縣後龍鎮	2018-11-25T06:12:34+08:00	11546	3888	15434	1628	17062	30948	55.13%	37.31%	35	35
8	苗栗縣後龍鎮	2018-11-24T22:40:16+08:00	9944	3404	13348	1392	14740	26785	55.03%	37.13%	31	35
8	苗栗縣後龍鎮	2018-11-25T04:01:27+08:00	11546	3888	15434	1628	17062	30948	55.13%	37.31%	35	35
8	苗栗縣後龍鎮	2018-11-24T22:21:43+08:00	8722	3012	11734	1223	12957	23885	54.25%	36.52%	28	35
8	苗栗縣後龍鎮	2018-11-25T00:17:05+08:00	11546	3888	15434	1628	17062	30948	55.13%	37.31%	35	35
8	苗栗縣後龍鎮	2018-11-25T00:21:42+08:00	11546	3888	15434	1628	17062	30948	55.13%	37.31%	35	35
8	苗栗縣後龍鎮	2018-11-24T23:18:24+08:00	11546	3888	15434	1628	17062	30948	55.13%	37.31%	35	35
8	苗栗縣後龍鎮	2018-11-24T23:37:46+08:00	11546	3888	15434	1628	17062	30948	55.13%	37.31%	35	35
8	苗栗縣後龍鎮	2018-11-24T22:35:42+08:00	9573	3273	12846	1336	14182	25902	54.75%	36.96%	30	35
8	苗栗縣後龍鎮	2018-11-24T23:33:47+08:00	11546	3888	15434	1628	17062	30948	55.13%	37.31%	35	35
8	苗栗縣後龍鎮	2018-11-24T23:26:04+08:00	11546	3888	15434	1628	17062	30948	55.13%	37.31%	35	35
8	苗栗縣後龍鎮	2018-11-25T03:54:38+08:00	11546	3888	15434	1628	17062	30948	55.13%	37.31%	35	35
8	苗栗縣後龍鎮	2018-11-25T03:37:25+08:00	11546	3888	15434	1628	17062	30948	55.13%	37.31%	35	35
8	苗栗縣後龍鎮	2018-11-24T23:10:54+08:00	11176	3779	14955	1580	16535	29912	55.28%	37.36%	34	35
8	苗栗縣後龍鎮	2018-11-24T23:14:37+08:00	11546	3888	15434	1628	17062	30948	55.13%	37.31%	35	35
8	苗栗縣後龍鎮	2018-11-25T06:17:33+08:00	11546	3888	15434	1628	17062	30948	55.13%	37.31%	35	35
8	苗栗縣後龍鎮	2018-11-24T22:43:47+08:00	9944	3404	13348	1392	14740	26785	55.03%	37.13%	31	35
8	苗栗縣後龍鎮	2018-11-25T01:24:21+08:00	11546	3888	15434	1628	17062	30948	55.13%	37.31%	35	35
8	苗栗縣後龍鎮	2018-11-24T22:56:34+08:00	10720	3622	14342	1530	15872	28799	55.11%	37.22%	33	35
8	苗栗縣後龍鎮	2018-11-25T00:08:02+08:00	11546	3888	15434	1628	17062	30948	55.13%	37.31%	35	35
8	苗栗縣後龍鎮	2018-11-24T22:53:12+08:00	10340	3505	13845	1428	15273	27762	55.01%	37.25%	32	35
8	苗栗縣後龍鎮	2018-11-25T01:11:04+08:00	11546	3888	15434	1628	17062	30948	55.13%	37.31%	35	35
8	苗栗縣後龍鎮	2018-11-24T23:29:43+08:00	11546	3888	15434	1628	17062	30948	55.13%	37.31%	35	35
8	苗栗縣後龍鎮	2018-11-25T06:22:42+08:00	11546	3888	15434	1628	17062	30948	55.13%	37.31%	35	35
8	苗栗縣後龍鎮	2018-11-25T06:07:20+08:00	11546	3888	15434	1628	17062	30948	55.13%	37.31%	35	35
8	苗栗縣後龍鎮	2018-11-24T23:00:15+08:00	10720	3622	14342	1530	15872	28799	55.11%	37.22%	33	35
8	苗栗縣後龍鎮	2018-11-25T01:05:56+08:00	11546	3888	15434	1628	17062	30948	55.13%	37.31%	35	35
8	苗栗縣後龍鎮	2018-11-24T23:41:59+08:00	11546	3888	15434	1628	17062	30948	55.13%	37.31%	35	35
8	苗栗縣後龍鎮	2018-11-25T00:03:31+08:00	11546	3888	15434	1628	17062	30948	55.13%	37.31%	35	35
8	苗栗縣後龍鎮	2018-11-24T23:54:25+08:00	11546	3888	15434	1628	17062	30948	55.13%	37.31%	35	35
8	苗栗縣後龍鎮	2018-11-24T22:14:46+08:00	8383	2904	11287	1181	12468	22920	54.4%	36.58%	27	35
8	苗栗縣後龍鎮	2018-11-25T06:27:52+08:00	11546	3888	15434	1628	17062	30948	55.13%	37.31%	35	35
8	苗栗縣後龍鎮	2018-11-25T00:56:11+08:00	11546	3888	15434	1628	17062	30948	55.13%	37.31%	35	35
8	苗栗縣後龍鎮	2018-11-24T22:18:17+08:00	8383	2904	11287	1181	12468	22920	54.4%	36.58%	27	35
8	苗栗縣後龍鎮	2018-11-25T00:12:42+08:00	11546	3888	15434	1628	17062	30948	55.13%	37.31%	35	35
8	苗栗縣後龍鎮	2018-11-24T22:28:37+08:00	8953	3110	12063	1268	13331	24686	54%	36.27%	29	35
8	苗栗縣後龍鎮	2018-11-25T01:16:19+08:00	11546	3888	15434	1628	17062	30948	55.13%	37.31%	35	35
8	苗栗縣後龍鎮	2018-11-24T23:50:12+08:00	11546	3888	15434	1628	17062	30948	55.13%	37.31%	35	35
8	苗栗縣三灣鄉	2018-11-25T03:37:26+08:00	2335	716	3051	322	3373	5852	57.64%	39.9%	9	9
8	苗栗縣三灣鄉	2018-11-24T23:07:16+08:00	2335	716	3051	322	3373	5852	57.64%	39.9%	9	9
8	苗栗縣三灣鄉	2018-11-24T22:12:00+08:00	2335	716	3051	322	3373	5852	57.64%	39.9%	9	9
8	苗栗縣三灣鄉	2018-11-24T22:39:06+08:00	2335	716	3051	322	3373	5852	57.64%	39.9%	9	9
8	苗栗縣三灣鄉	2018-11-24T23:03:45+08:00	2335	716	3051	322	3373	5852	57.64%	39.9%	9	9
8	苗栗縣三灣鄉	2018-11-24T23:22:21+08:00	2335	716	3051	322	3373	5852	57.64%	39.9%	9	9
8	苗栗縣三灣鄉	2018-11-25T01:24:22+08:00	2335	716	3051	322	3373	5852	57.64%	39.9%	9	9
8	苗栗縣三灣鄉	2018-11-24T23:46:01+08:00	2335	716	3051	322	3373	5852	57.64%	39.9%	9	9
8	苗栗縣三灣鄉	2018-11-24T23:42:00+08:00	2335	716	3051	322	3373	5852	57.64%	39.9%	9	9
8	苗栗縣三灣鄉	2018-11-25T03:30:56+08:00	2335	716	3051	322	3373	5852	57.64%	39.9%	9	9
8	苗栗縣三灣鄉	2018-11-25T03:42:45+08:00	2335	716	3051	322	3373	5852	57.64%	39.9%	9	9
8	苗栗縣三灣鄉	2018-11-24T22:32:16+08:00	2335	716	3051	322	3373	5852	57.64%	39.9%	9	9
8	苗栗縣三灣鄉	2018-11-25T03:48:27+08:00	2335	716	3051	322	3373	5852	57.64%	39.9%	9	9
8	苗栗縣三灣鄉	2018-11-25T01:00:58+08:00	2335	716	3051	322	3373	5852	57.64%	39.9%	9	9
8	苗栗縣三灣鄉	2018-11-24T22:25:21+08:00	2335	716	3051	322	3373	5852	57.64%	39.9%	9	9
8	苗栗縣三灣鄉	2018-11-25T04:01:27+08:00	2335	716	3051	322	3373	5852	57.64%	39.9%	9	9
8	苗栗縣三灣鄉	2018-11-24T22:21:43+08:00	2335	716	3051	322	3373	5852	57.64%	39.9%	9	9
8	苗栗縣三灣鄉	2018-11-24T22:40:17+08:00	2335	716	3051	322	3373	5852	57.64%	39.9%	9	9
8	苗栗縣三灣鄉	2018-11-25T00:21:42+08:00	2335	716	3051	322	3373	5852	57.64%	39.9%	9	9
8	苗栗縣三灣鄉	2018-11-25T06:12:35+08:00	2335	716	3051	322	3373	5852	57.64%	39.9%	9	9
8	苗栗縣三灣鄉	2018-11-24T23:37:46+08:00	2335	716	3051	322	3373	5852	57.64%	39.9%	9	9
8	苗栗縣三灣鄉	2018-11-24T22:35:42+08:00	2335	716	3051	322	3373	5852	57.64%	39.9%	9	9
8	苗栗縣三灣鄉	2018-11-24T23:58:40+08:00	2335	716	3051	322	3373	5852	57.64%	39.9%	9	9
8	苗栗縣三灣鄉	2018-11-24T23:26:05+08:00	2335	716	3051	322	3373	5852	57.64%	39.9%	9	9
8	苗栗縣三灣鄉	2018-11-24T23:18:25+08:00	2335	716	3051	322	3373	5852	57.64%	39.9%	9	9
8	苗栗縣三灣鄉	2018-11-24T23:33:48+08:00	2335	716	3051	322	3373	5852	57.64%	39.9%	9	9
8	苗栗縣三灣鄉	2018-11-25T03:54:38+08:00	2335	716	3051	322	3373	5852	57.64%	39.9%	9	9
8	苗栗縣三灣鄉	2018-11-24T22:43:48+08:00	2335	716	3051	322	3373	5852	57.64%	39.9%	9	9
8	苗栗縣三灣鄉	2018-11-24T23:10:54+08:00	2335	716	3051	322	3373	5852	57.64%	39.9%	9	9
8	苗栗縣三灣鄉	2018-11-25T06:17:33+08:00	2335	716	3051	322	3373	5852	57.64%	39.9%	9	9
8	苗栗縣三灣鄉	2018-11-24T22:56:34+08:00	2335	716	3051	322	3373	5852	57.64%	39.9%	9	9
8	苗栗縣三灣鄉	2018-11-24T23:14:38+08:00	2335	716	3051	322	3373	5852	57.64%	39.9%	9	9
8	苗栗縣三灣鄉	2018-11-24T22:49:22+08:00	2335	716	3051	322	3373	5852	57.64%	39.9%	9	9
8	苗栗縣三灣鄉	2018-11-25T00:08:02+08:00	2335	716	3051	322	3373	5852	57.64%	39.9%	9	9
8	苗栗縣三灣鄉	2018-11-24T22:53:12+08:00	2335	716	3051	322	3373	5852	57.64%	39.9%	9	9
8	苗栗縣三灣鄉	2018-11-25T06:22:43+08:00	2335	716	3051	322	3373	5852	57.64%	39.9%	9	9
8	苗栗縣三灣鄉	2018-11-24T23:29:44+08:00	2335	716	3051	322	3373	5852	57.64%	39.9%	9	9
8	苗栗縣三灣鄉	2018-11-25T00:17:06+08:00	2335	716	3051	322	3373	5852	57.64%	39.9%	9	9
8	苗栗縣三灣鄉	2018-11-25T01:11:04+08:00	2335	716	3051	322	3373	5852	57.64%	39.9%	9	9
8	苗栗縣三灣鄉	2018-11-25T06:07:20+08:00	2335	716	3051	322	3373	5852	57.64%	39.9%	9	9
8	苗栗縣三灣鄉	2018-11-24T23:00:15+08:00	2335	716	3051	322	3373	5852	57.64%	39.9%	9	9
8	苗栗縣三灣鄉	2018-11-25T00:12:43+08:00	2335	716	3051	322	3373	5852	57.64%	39.9%	9	9
8	苗栗縣三灣鄉	2018-11-24T22:28:38+08:00	2335	716	3051	322	3373	5852	57.64%	39.9%	9	9
8	苗栗縣三灣鄉	2018-11-25T01:05:56+08:00	2335	716	3051	322	3373	5852	57.64%	39.9%	9	9
8	苗栗縣三灣鄉	2018-11-25T06:27:53+08:00	2335	716	3051	322	3373	5852	57.64%	39.9%	9	9
8	苗栗縣三灣鄉	2018-11-25T00:03:31+08:00	2335	716	3051	322	3373	5852	57.64%	39.9%	9	9
8	苗栗縣三灣鄉	2018-11-24T23:54:25+08:00	2335	716	3051	322	3373	5852	57.64%	39.9%	9	9
8	苗栗縣三灣鄉	2018-11-24T22:14:46+08:00	2335	716	3051	322	3373	5852	57.64%	39.9%	9	9
8	苗栗縣三灣鄉	2018-11-25T00:56:11+08:00	2335	716	3051	322	3373	5852	57.64%	39.9%	9	9
8	苗栗縣三灣鄉	2018-11-24T22:18:17+08:00	2335	716	3051	322	3373	5852	57.64%	39.9%	9	9
8	苗栗縣三灣鄉	2018-11-25T01:16:19+08:00	2335	716	3051	322	3373	5852	57.64%	39.9%	9	9
8	苗栗縣三灣鄉	2018-11-24T23:50:12+08:00	2335	716	3051	322	3373	5852	57.64%	39.9%	9	9
8	高雄市大樹區	2018-11-24T22:49:20+08:00	12829	4207	17036	1580	18616	34311	54.26%	37.39%	31	32
8	高雄市大樹區	2018-11-25T03:37:21+08:00	13775	4495	18270	1662	19932	36772	54.2%	37.46%	32	32
8	高雄市大樹區	2018-11-24T23:03:43+08:00	12829	4207	17036	1580	18616	34311	54.26%	37.39%	31	32
8	高雄市大樹區	2018-11-24T23:58:37+08:00	13775	4495	18270	1662	19932	36772	54.2%	37.46%	32	32
8	高雄市大樹區	2018-11-25T06:17:31+08:00	13775	4495	18270	1662	19932	36772	54.2%	37.46%	32	32
8	高雄市大樹區	2018-11-25T00:03:29+08:00	13775	4495	18270	1662	19932	36772	54.2%	37.46%	32	32
8	高雄市大樹區	2018-11-24T23:14:35+08:00	12829	4207	17036	1580	18616	34311	54.26%	37.39%	31	32
8	高雄市大樹區	2018-11-25T00:56:09+08:00	13775	4495	18270	1662	19932	36772	54.2%	37.46%	32	32
8	高雄市大樹區	2018-11-24T23:22:19+08:00	12829	4207	17036	1580	18616	34311	54.26%	37.39%	31	32
8	高雄市大樹區	2018-11-25T03:42:43+08:00	13775	4495	18270	1662	19932	36772	54.2%	37.46%	32	32
8	高雄市大樹區	2018-11-24T22:53:10+08:00	12829	4207	17036	1580	18616	34311	54.26%	37.39%	31	32
8	高雄市大樹區	2018-11-25T00:08:00+08:00	13775	4495	18270	1662	19932	36772	54.2%	37.46%	32	32
8	高雄市大樹區	2018-11-24T23:46:00+08:00	13775	4495	18270	1662	19932	36772	54.2%	37.46%	32	32
8	高雄市大樹區	2018-11-25T01:00:56+08:00	13775	4495	18270	1662	19932	36772	54.2%	37.46%	32	32
8	高雄市大樹區	2018-11-24T22:25:19+08:00	12829	4207	17036	1580	18616	34311	54.26%	37.39%	31	32
8	高雄市大樹區	2018-11-25T06:12:33+08:00	13775	4495	18270	1662	19932	36772	54.2%	37.46%	32	32
8	高雄市大樹區	2018-11-25T00:17:04+08:00	13775	4495	18270	1662	19932	36772	54.2%	37.46%	32	32
8	高雄市大樹區	2018-11-25T06:22:41+08:00	13775	4495	18270	1662	19932	36772	54.2%	37.46%	32	32
8	高雄市大樹區	2018-11-24T23:18:23+08:00	12829	4207	17036	1580	18616	34311	54.26%	37.39%	31	32
8	高雄市大樹區	2018-11-24T22:18:15+08:00	12566	4131	16697	1560	18257	33591	54.35%	37.41%	30	32
8	高雄市大樹區	2018-11-24T22:14:44+08:00	12566	4131	16697	1560	18257	33591	54.35%	37.41%	30	32
8	高雄市大樹區	2018-11-24T23:50:11+08:00	13775	4495	18270	1662	19932	36772	54.2%	37.46%	32	32
8	高雄市大樹區	2018-11-25T01:05:54+08:00	13775	4495	18270	1662	19932	36772	54.2%	37.46%	32	32
8	高雄市大樹區	2018-11-24T23:33:46+08:00	13775	4495	18270	1662	19932	36772	54.2%	37.46%	32	32
8	高雄市大樹區	2018-11-25T06:27:51+08:00	13775	4495	18270	1662	19932	36772	54.2%	37.46%	32	32
8	高雄市大樹區	2018-11-24T23:26:03+08:00	13775	4495	18270	1662	19932	36772	54.2%	37.46%	32	32
8	高雄市大樹區	2018-11-25T03:54:36+08:00	13775	4495	18270	1662	19932	36772	54.2%	37.46%	32	32
8	高雄市大樹區	2018-11-25T00:12:41+08:00	13775	4495	18270	1662	19932	36772	54.2%	37.46%	32	32
8	高雄市大樹區	2018-11-25T01:24:20+08:00	13775	4495	18270	1662	19932	36772	54.2%	37.46%	32	32
8	高雄市大樹區	2018-11-24T22:56:32+08:00	12829	4207	17036	1580	18616	34311	54.26%	37.39%	31	32
8	高雄市大樹區	2018-11-24T22:43:46+08:00	12829	4207	17036	1580	18616	34311	54.26%	37.39%	31	32
8	高雄市大樹區	2018-11-24T22:39:05+08:00	12829	4207	17036	1580	18616	34311	54.26%	37.39%	31	32
8	高雄市大樹區	2018-11-24T23:10:52+08:00	12829	4207	17036	1580	18616	34311	54.26%	37.39%	31	32
8	高雄市大樹區	2018-11-24T23:07:14+08:00	12829	4207	17036	1580	18616	34311	54.26%	37.39%	31	32
8	高雄市大樹區	2018-11-25T03:48:25+08:00	13775	4495	18270	1662	19932	36772	54.2%	37.46%	32	32
8	高雄市大樹區	2018-11-24T22:32:14+08:00	12829	4207	17036	1580	18616	34311	54.26%	37.39%	31	32
8	高雄市大樹區	2018-11-25T03:30:54+08:00	13775	4495	18270	1662	19932	36772	54.2%	37.46%	32	32
8	高雄市大樹區	2018-11-24T22:40:15+08:00	12829	4207	17036	1580	18616	34311	54.26%	37.39%	31	32
8	高雄市大樹區	2018-11-25T00:21:40+08:00	13775	4495	18270	1662	19932	36772	54.2%	37.46%	32	32
8	高雄市大樹區	2018-11-24T23:29:42+08:00	13775	4495	18270	1662	19932	36772	54.2%	37.46%	32	32
8	高雄市大樹區	2018-11-25T01:11:02+08:00	13775	4495	18270	1662	19932	36772	54.2%	37.46%	32	32
8	高雄市大樹區	2018-11-24T23:00:13+08:00	12829	4207	17036	1580	18616	34311	54.26%	37.39%	31	32
8	高雄市大樹區	2018-11-24T22:11:59+08:00	12566	4131	16697	1560	18257	33591	54.35%	37.41%	30	32
8	高雄市大樹區	2018-11-24T22:21:41+08:00	12566	4131	16697	1560	18257	33591	54.35%	37.41%	30	32
8	高雄市大樹區	2018-11-25T06:07:18+08:00	13775	4495	18270	1662	19932	36772	54.2%	37.46%	32	32
8	高雄市大樹區	2018-11-25T04:01:24+08:00	13775	4495	18270	1662	19932	36772	54.2%	37.46%	32	32
8	高雄市大樹區	2018-11-24T22:28:36+08:00	12829	4207	17036	1580	18616	34311	54.26%	37.39%	31	32
8	高雄市大樹區	2018-11-24T22:35:41+08:00	12829	4207	17036	1580	18616	34311	54.26%	37.39%	31	32
8	高雄市大樹區	2018-11-24T23:37:45+08:00	13775	4495	18270	1662	19932	36772	54.2%	37.46%	32	32
8	高雄市大樹區	2018-11-24T23:41:58+08:00	13775	4495	18270	1662	19932	36772	54.2%	37.46%	32	32
8	高雄市大樹區	2018-11-24T23:54:22+08:00	13775	4495	18270	1662	19932	36772	54.2%	37.46%	32	32
8	高雄市大樹區	2018-11-25T01:16:17+08:00	13775	4495	18270	1662	19932	36772	54.2%	37.46%	32	32
8	高雄市三民區	2018-11-24T23:03:43+08:00	70749	24839	95588	7431	103019	177528	58.03%	39.85%	125	189
8	高雄市三民區	2018-11-24T23:58:37+08:00	96569	33577	130146	9871	140017	241447	57.99%	40%	163	189
8	高雄市三民區	2018-11-25T06:17:31+08:00	116063	39799	155862	11491	167353	289519	57.8%	40.09%	189	189
8	高雄市三民區	2018-11-24T23:22:18+08:00	77397	27120	104517	8135	112652	193478	58.22%	40%	135	189
8	高雄市三民區	2018-11-24T22:43:45+08:00	60654	21323	81977	6478	88455	153534	57.61%	39.51%	110	189
8	高雄市三民區	2018-11-25T00:03:29+08:00	97120	33804	130924	9912	140836	242874	57.99%	39.99%	164	189
8	高雄市三民區	2018-11-24T23:14:35+08:00	73404	25823	99227	7782	107009	183879	58.2%	39.92%	129	189
8	高雄市三民區	2018-11-25T03:37:20+08:00	116063	39799	155862	11491	167353	289519	57.8%	40.09%	189	189
8	高雄市三民區	2018-11-25T00:56:09+08:00	113782	39142	152924	11276	164200	283980	57.82%	40.07%	186	189
8	高雄市三民區	2018-11-24T22:49:19+08:00	65541	22998	88539	6977	95516	165020	57.88%	39.72%	117	189
8	高雄市三民區	2018-11-25T03:42:43+08:00	116063	39799	155862	11491	167353	289519	57.8%	40.09%	189	189
8	高雄市三民區	2018-11-24T22:53:10+08:00	65541	22998	88539	6977	95516	165020	57.88%	39.72%	117	189
8	高雄市三民區	2018-11-25T00:08:00+08:00	97876	34035	131911	9970	141881	244536	58.02%	40.03%	165	189
8	高雄市三民區	2018-11-25T01:00:56+08:00	113782	39142	152924	11276	164200	283980	57.82%	40.07%	186	189
8	高雄市三民區	2018-11-24T22:25:19+08:00	51324	18135	69459	5496	74955	130362	57.5%	39.37%	95	189
8	高雄市三民區	2018-11-25T06:12:33+08:00	116063	39799	155862	11491	167353	289519	57.8%	40.09%	189	189
8	高雄市三民區	2018-11-25T00:17:03+08:00	102409	35370	137779	10266	148045	255612	57.92%	40.06%	171	189
8	高雄市三民區	2018-11-25T01:11:01+08:00	114515	39391	153906	11338	165244	285904	57.8%	40.05%	187	189
8	高雄市三民區	2018-11-25T06:22:41+08:00	116063	39799	155862	11491	167353	289519	57.8%	40.09%	189	189
8	高雄市三民區	2018-11-24T23:18:23+08:00	73404	25823	99227	7782	107009	183879	58.2%	39.92%	129	189
8	高雄市三民區	2018-11-24T23:50:10+08:00	93949	32582	126531	9626	136157	234741	58%	40.02%	159	189
8	高雄市三民區	2018-11-24T22:18:15+08:00	45858	16283	62141	5006	67147	117245	57.27%	39.11%	87	189
8	高雄市三民區	2018-11-24T22:28:35+08:00	51998	18367	70365	5570	75935	131986	57.53%	39.4%	96	189
8	高雄市三民區	2018-11-24T22:14:44+08:00	43262	15412	58674	4762	63436	109448	57.96%	39.53%	83	189
8	高雄市三民區	2018-11-25T01:05:54+08:00	114515	39391	153906	11338	165244	285904	57.8%	40.05%	187	189
8	高雄市三民區	2018-11-24T23:54:21+08:00	94747	32861	127608	9704	137312	236755	58%	40.02%	160	189
8	高雄市三民區	2018-11-24T23:33:46+08:00	85229	29730	114959	8841	123800	213325	58.03%	39.95%	147	189
8	高雄市三民區	2018-11-25T06:27:51+08:00	116063	39799	155862	11491	167353	289519	57.8%	40.09%	189	189
8	高雄市三民區	2018-11-24T23:26:03+08:00	78550	27551	106101	8255	114356	196516	58.19%	39.97%	137	189
8	高雄市三民區	2018-11-25T00:12:41+08:00	101793	35190	136983	10229	147212	254106	57.93%	40.06%	170	189
8	高雄市三民區	2018-11-24T22:56:32+08:00	66775	23448	90223	7066	97289	168051	57.89%	39.73%	119	189
8	高雄市三民區	2018-11-25T01:24:19+08:00	114515	39391	153906	11338	165244	285904	57.8%	40.05%	187	189
8	高雄市三民區	2018-11-24T22:39:04+08:00	56793	20013	76806	6081	82887	144104	57.52%	39.41%	104	189
8	高雄市三民區	2018-11-24T23:10:52+08:00	72852	25569	98421	7675	106096	182406	58.16%	39.94%	128	189
8	高雄市三民區	2018-11-24T23:07:14+08:00	72142	25285	97427	7586	105013	180722	58.11%	39.92%	127	189
8	高雄市三民區	2018-11-25T00:21:39+08:00	103067	35626	138693	10311	149004	257501	57.87%	40.03%	172	189
8	高雄市三民區	2018-11-24T22:32:14+08:00	52698	18569	71267	5632	76899	133559	57.58%	39.46%	97	189
8	高雄市三民區	2018-11-25T03:30:54+08:00	116063	39799	155862	11491	167353	289519	57.8%	40.09%	189	189
8	高雄市三民區	2018-11-25T03:48:24+08:00	116063	39799	155862	11491	167353	289519	57.8%	40.09%	189	189
8	高雄市三民區	2018-11-24T22:40:15+08:00	58582	20645	79227	6236	85463	148356	57.61%	39.49%	107	189
8	高雄市三民區	2018-11-24T23:29:42+08:00	81012	28347	109359	8559	117918	202868	58.13%	39.93%	141	189
8	高雄市三民區	2018-11-24T23:00:13+08:00	68612	24122	92734	7266	100000	172516	57.97%	39.77%	122	189
8	高雄市三民區	2018-11-24T22:21:41+08:00	49483	17451	66934	5267	72201	125664	57.46%	39.38%	92	189
8	高雄市三民區	2018-11-25T06:07:18+08:00	116063	39799	155862	11491	167353	289519	57.8%	40.09%	189	189
8	高雄市三民區	2018-11-24T22:11:58+08:00	39320	14087	53407	4309	57716	99650	57.92%	39.46%	77	189
8	高雄市三民區	2018-11-25T04:01:24+08:00	116063	39799	155862	11491	167353	289519	57.8%	40.09%	189	189
8	高雄市三民區	2018-11-24T23:41:57+08:00	88701	30887	119588	9149	128737	222025	57.98%	39.95%	152	189
8	高雄市三民區	2018-11-24T23:37:45+08:00	86678	30153	116831	8977	125808	216654	58.07%	40.01%	149	189
8	高雄市三民區	2018-11-24T22:35:40+08:00	53759	18920	72679	5758	78437	136396	57.51%	39.41%	99	189
8	高雄市三民區	2018-11-25T03:54:35+08:00	116063	39799	155862	11491	167353	289519	57.8%	40.09%	189	189
8	高雄市三民區	2018-11-24T23:45:59+08:00	92509	32092	124601	9454	134055	231299	57.96%	40%	157	189
8	高雄市三民區	2018-11-25T01:16:17+08:00	114515	39391	153906	11338	165244	285904	57.8%	40.05%	187	189
8	南投縣南投市	2018-11-25T01:24:23+08:00	37773	9552	47325	3247	50572	84328	59.97%	44.79%	84	84
8	南投縣南投市	2018-11-24T22:39:07+08:00	25431	6555	31986	2247	34233	56738	60.34%	44.82%	61	84
8	南投縣南投市	2018-11-24T23:07:17+08:00	30486	7578	38064	2631	40695	68002	59.84%	44.83%	70	84
8	南投縣南投市	2018-11-24T22:12:01+08:00	19903	5050	24953	1719	26672	44132	60.44%	45.1%	49	84
8	南投縣南投市	2018-11-25T03:37:27+08:00	37773	9552	47325	3247	50572	84328	59.97%	44.79%	84	84
8	南投縣南投市	2018-11-24T22:32:17+08:00	24454	6274	30728	2172	32900	54614	60.24%	44.78%	59	84
8	南投縣南投市	2018-11-25T03:30:57+08:00	37773	9552	47325	3247	50572	84328	59.97%	44.79%	84	84
8	南投縣南投市	2018-11-25T03:48:28+08:00	37773	9552	47325	3247	50572	84328	59.97%	44.79%	84	84
8	南投縣南投市	2018-11-25T01:00:59+08:00	37773	9552	47325	3247	50572	84328	59.97%	44.79%	84	84
8	南投縣南投市	2018-11-24T23:42:00+08:00	37251	9451	46702	3203	49905	83250	59.95%	44.75%	83	84
8	南投縣南投市	2018-11-25T04:01:28+08:00	37773	9552	47325	3247	50572	84328	59.97%	44.79%	84	84
8	南投縣南投市	2018-11-24T22:21:44+08:00	23295	5938	29233	1991	31224	51701	60.39%	45.06%	56	84
8	南投縣南投市	2018-11-24T23:00:16+08:00	29195	7383	36578	2562	39140	65066	60.15%	44.87%	68	84
8	南投縣南投市	2018-11-24T22:40:17+08:00	26434	6807	33241	2326	35567	58835	60.45%	44.93%	63	84
8	南投縣南投市	2018-11-25T00:21:42+08:00	37773	9552	47325	3247	50572	84328	59.97%	44.79%	84	84
8	南投縣南投市	2018-11-25T06:12:35+08:00	37773	9552	47325	3247	50572	84328	59.97%	44.79%	84	84
8	南投縣南投市	2018-11-25T00:03:32+08:00	37773	9552	47325	3247	50572	84328	59.97%	44.79%	84	84
8	南投縣南投市	2018-11-25T03:54:39+08:00	37773	9552	47325	3247	50572	84328	59.97%	44.79%	84	84
8	南投縣南投市	2018-11-24T23:26:05+08:00	35252	8877	44129	3011	47140	78766	59.85%	44.76%	79	84
8	南投縣南投市	2018-11-24T23:37:47+08:00	36767	9300	46067	3161	49228	82180	59.9%	44.74%	82	84
8	南投縣南投市	2018-11-24T22:35:43+08:00	24898	6410	31308	2216	33524	55616	60.28%	44.77%	60	84
8	南投縣南投市	2018-11-24T23:54:26+08:00	37251	9451	46702	3203	49905	83250	59.95%	44.75%	83	84
8	南投縣南投市	2018-11-24T23:58:41+08:00	37251	9451	46702	3203	49905	83250	59.95%	44.75%	83	84
8	南投縣南投市	2018-11-24T23:33:48+08:00	36334	9167	45501	3121	48622	81156	59.91%	44.77%	81	84
8	南投縣南投市	2018-11-25T00:56:12+08:00	37773	9552	47325	3247	50572	84328	59.97%	44.79%	84	84
8	南投縣南投市	2018-11-24T22:56:35+08:00	28618	7234	35852	2534	38386	63836	60.13%	44.83%	67	84
8	南投縣南投市	2018-11-24T22:43:48+08:00	26833	6899	33732	2369	36101	59808	60.36%	44.87%	64	84
8	南投縣南投市	2018-11-24T23:14:39+08:00	32029	8007	40036	2763	42799	71467	59.89%	44.82%	73	84
8	南投縣南投市	2018-11-24T23:22:22+08:00	33739	8418	42157	2885	45042	75189	59.91%	44.87%	76	84
8	南投縣南投市	2018-11-25T06:17:34+08:00	37773	9552	47325	3247	50572	84328	59.97%	44.79%	84	84
8	南投縣南投市	2018-11-24T23:03:46+08:00	29804	7541	37345	2600	39945	66518	60.05%	44.81%	69	84
8	南投縣南投市	2018-11-24T23:10:55+08:00	31432	7838	39270	2698	41968	70191	59.79%	44.78%	72	84
8	南投縣南投市	2018-11-24T22:49:22+08:00	27429	7080	34509	2405	36914	61242	60.28%	44.79%	65	84
8	南投縣南投市	2018-11-25T00:08:03+08:00	37773	9552	47325	3247	50572	84328	59.97%	44.79%	84	84
8	南投縣南投市	2018-11-24T22:53:13+08:00	28054	7105	35159	2483	37642	62463	60.26%	44.91%	66	84
8	南投縣南投市	2018-11-24T23:46:02+08:00	37251	9451	46702	3203	49905	83250	59.95%	44.75%	83	84
8	南投縣南投市	2018-11-25T03:42:46+08:00	37773	9552	47325	3247	50572	84328	59.97%	44.79%	84	84
8	南投縣南投市	2018-11-25T01:11:05+08:00	37773	9552	47325	3247	50572	84328	59.97%	44.79%	84	84
8	南投縣南投市	2018-11-24T22:25:22+08:00	23295	5938	29233	1991	31224	51701	60.39%	45.06%	56	84
8	南投縣南投市	2018-11-25T06:07:21+08:00	37773	9552	47325	3247	50572	84328	59.97%	44.79%	84	84
8	南投縣南投市	2018-11-25T06:22:43+08:00	37773	9552	47325	3247	50572	84328	59.97%	44.79%	84	84
8	南投縣南投市	2018-11-24T23:29:44+08:00	35708	8981	44689	3047	47736	79769	59.84%	44.76%	80	84
8	南投縣南投市	2018-11-25T00:17:06+08:00	37773	9552	47325	3247	50572	84328	59.97%	44.79%	84	84
8	南投縣南投市	2018-11-25T00:12:43+08:00	37773	9552	47325	3247	50572	84328	59.97%	44.79%	84	84
8	南投縣南投市	2018-11-24T22:28:38+08:00	23784	6063	29847	2041	31888	52822	60.37%	45.03%	57	84
8	南投縣南投市	2018-11-24T22:14:47+08:00	20815	5298	26113	1810	27923	46180	60.47%	45.07%	51	84
8	南投縣南投市	2018-11-25T06:27:53+08:00	37773	9552	47325	3247	50572	84328	59.97%	44.79%	84	84
8	南投縣南投市	2018-11-24T22:18:18+08:00	21910	5588	27498	1878	29376	48530	60.53%	45.15%	53	84
8	南投縣南投市	2018-11-24T23:50:13+08:00	37251	9451	46702	3203	49905	83250	59.95%	44.75%	83	84
8	南投縣南投市	2018-11-25T01:16:20+08:00	37773	9552	47325	3247	50572	84328	59.97%	44.79%	84	84
8	南投縣南投市	2018-11-25T01:05:57+08:00	37773	9552	47325	3247	50572	84328	59.97%	44.79%	84	84
8	南投縣南投市	2018-11-24T23:18:26+08:00	33172	8255	41427	2838	44265	73901	59.9%	44.89%	75	84
8	南投縣水里鄉	2018-11-24T22:39:08+08:00	5726	1639	7365	642	8007	14583	54.91%	39.26%	21	22
8	南投縣水里鄉	2018-11-25T03:37:28+08:00	6115	1728	7843	674	8517	15458	55.1%	39.56%	22	22
8	南投縣水里鄉	2018-11-25T01:24:23+08:00	6115	1728	7843	674	8517	15458	55.1%	39.56%	22	22
8	南投縣水里鄉	2018-11-24T23:07:17+08:00	6115	1728	7843	674	8517	15458	55.1%	39.56%	22	22
8	南投縣水里鄉	2018-11-24T22:12:01+08:00	5291	1517	6808	613	7421	13579	54.65%	38.96%	20	22
8	南投縣水里鄉	2018-11-24T22:32:17+08:00	5726	1639	7365	642	8007	14583	54.91%	39.26%	21	22
8	南投縣水里鄉	2018-11-25T03:48:28+08:00	6115	1728	7843	674	8517	15458	55.1%	39.56%	22	22
8	南投縣水里鄉	2018-11-25T03:30:58+08:00	6115	1728	7843	674	8517	15458	55.1%	39.56%	22	22
8	南投縣水里鄉	2018-11-24T23:42:01+08:00	6115	1728	7843	674	8517	15458	55.1%	39.56%	22	22
8	南投縣水里鄉	2018-11-24T22:21:45+08:00	5726	1639	7365	642	8007	14583	54.91%	39.26%	21	22
8	南投縣水里鄉	2018-11-25T04:01:28+08:00	6115	1728	7843	674	8517	15458	55.1%	39.56%	22	22
8	南投縣水里鄉	2018-11-25T00:21:43+08:00	6115	1728	7843	674	8517	15458	55.1%	39.56%	22	22
8	南投縣水里鄉	2018-11-24T22:40:18+08:00	5726	1639	7365	642	8007	14583	54.91%	39.26%	21	22
8	南投縣水里鄉	2018-11-24T23:00:16+08:00	6115	1728	7843	674	8517	15458	55.1%	39.56%	22	22
8	南投縣水里鄉	2018-11-25T06:12:35+08:00	6115	1728	7843	674	8517	15458	55.1%	39.56%	22	22
8	南投縣水里鄉	2018-11-25T03:54:39+08:00	6115	1728	7843	674	8517	15458	55.1%	39.56%	22	22
8	南投縣水里鄉	2018-11-25T01:01:00+08:00	6115	1728	7843	674	8517	15458	55.1%	39.56%	22	22
8	南投縣水里鄉	2018-11-24T23:33:49+08:00	6115	1728	7843	674	8517	15458	55.1%	39.56%	22	22
8	南投縣水里鄉	2018-11-25T00:03:33+08:00	6115	1728	7843	674	8517	15458	55.1%	39.56%	22	22
8	南投縣水里鄉	2018-11-24T23:37:47+08:00	6115	1728	7843	674	8517	15458	55.1%	39.56%	22	22
8	南投縣水里鄉	2018-11-24T22:35:43+08:00	5726	1639	7365	642	8007	14583	54.91%	39.26%	21	22
8	南投縣水里鄉	2018-11-24T23:54:26+08:00	6115	1728	7843	674	8517	15458	55.1%	39.56%	22	22
8	南投縣水里鄉	2018-11-24T23:58:41+08:00	6115	1728	7843	674	8517	15458	55.1%	39.56%	22	22
8	南投縣水里鄉	2018-11-25T00:56:12+08:00	6115	1728	7843	674	8517	15458	55.1%	39.56%	22	22
8	南投縣水里鄉	2018-11-24T22:56:35+08:00	6115	1728	7843	674	8517	15458	55.1%	39.56%	22	22
8	南投縣水里鄉	2018-11-25T06:17:35+08:00	6115	1728	7843	674	8517	15458	55.1%	39.56%	22	22
8	南投縣水里鄉	2018-11-24T22:49:23+08:00	6115	1728	7843	674	8517	15458	55.1%	39.56%	22	22
8	南投縣水里鄉	2018-11-24T23:14:39+08:00	6115	1728	7843	674	8517	15458	55.1%	39.56%	22	22
8	南投縣水里鄉	2018-11-24T23:22:22+08:00	6115	1728	7843	674	8517	15458	55.1%	39.56%	22	22
8	南投縣水里鄉	2018-11-24T22:43:49+08:00	5726	1639	7365	642	8007	14583	54.91%	39.26%	21	22
8	南投縣水里鄉	2018-11-24T23:03:46+08:00	6115	1728	7843	674	8517	15458	55.1%	39.56%	22	22
8	南投縣水里鄉	2018-11-24T23:10:55+08:00	6115	1728	7843	674	8517	15458	55.1%	39.56%	22	22
8	南投縣水里鄉	2018-11-25T00:08:03+08:00	6115	1728	7843	674	8517	15458	55.1%	39.56%	22	22
8	南投縣水里鄉	2018-11-25T03:42:47+08:00	6115	1728	7843	674	8517	15458	55.1%	39.56%	22	22
8	南投縣水里鄉	2018-11-24T22:53:14+08:00	6115	1728	7843	674	8517	15458	55.1%	39.56%	22	22
8	南投縣水里鄉	2018-11-24T23:46:02+08:00	6115	1728	7843	674	8517	15458	55.1%	39.56%	22	22
8	南投縣水里鄉	2018-11-25T01:11:05+08:00	6115	1728	7843	674	8517	15458	55.1%	39.56%	22	22
8	南投縣水里鄉	2018-11-25T00:17:07+08:00	6115	1728	7843	674	8517	15458	55.1%	39.56%	22	22
8	南投縣水里鄉	2018-11-24T23:29:45+08:00	6115	1728	7843	674	8517	15458	55.1%	39.56%	22	22
8	南投縣水里鄉	2018-11-25T06:22:44+08:00	6115	1728	7843	674	8517	15458	55.1%	39.56%	22	22
8	南投縣水里鄉	2018-11-25T06:07:21+08:00	6115	1728	7843	674	8517	15458	55.1%	39.56%	22	22
8	南投縣水里鄉	2018-11-24T22:25:23+08:00	5726	1639	7365	642	8007	14583	54.91%	39.26%	21	22
8	南投縣水里鄉	2018-11-25T01:05:58+08:00	6115	1728	7843	674	8517	15458	55.1%	39.56%	22	22
8	南投縣水里鄉	2018-11-25T00:12:44+08:00	6115	1728	7843	674	8517	15458	55.1%	39.56%	22	22
8	南投縣水里鄉	2018-11-24T23:26:06+08:00	6115	1728	7843	674	8517	15458	55.1%	39.56%	22	22
8	南投縣水里鄉	2018-11-24T22:14:47+08:00	5726	1639	7365	642	8007	14583	54.91%	39.26%	21	22
8	南投縣水里鄉	2018-11-24T22:18:18+08:00	5726	1639	7365	642	8007	14583	54.91%	39.26%	21	22
8	南投縣水里鄉	2018-11-25T06:27:54+08:00	6115	1728	7843	674	8517	15458	55.1%	39.56%	22	22
8	南投縣水里鄉	2018-11-24T23:50:13+08:00	6115	1728	7843	674	8517	15458	55.1%	39.56%	22	22
8	南投縣水里鄉	2018-11-25T01:16:20+08:00	6115	1728	7843	674	8517	15458	55.1%	39.56%	22	22
8	南投縣水里鄉	2018-11-24T22:28:39+08:00	5726	1639	7365	642	8007	14583	54.91%	39.26%	21	22
8	南投縣水里鄉	2018-11-24T23:18:26+08:00	6115	1728	7843	674	8517	15458	55.1%	39.56%	22	22
8	屏東縣恆春鎮	2018-11-24T22:56:36+08:00	4467	1383	5850	611	6461	14023	46.07%	31.85%	15	25
8	屏東縣恆春鎮	2018-11-25T06:17:36+08:00	8345	2490	10835	982	11817	25661	46.05%	32.52%	25	25
8	屏東縣恆春鎮	2018-11-24T23:07:19+08:00	5110	1541	6651	671	7322	16011	45.73%	31.92%	17	25
8	屏東縣恆春鎮	2018-11-24T23:10:56+08:00	5110	1541	6651	671	7322	16011	45.73%	31.92%	17	25
8	屏東縣恆春鎮	2018-11-24T22:39:09+08:00	3768	1168	4936	516	5452	11899	45.82%	31.67%	13	25
8	屏東縣恆春鎮	2018-11-25T01:24:25+08:00	8345	2490	10835	982	11817	25661	46.05%	32.52%	25	25
8	屏東縣恆春鎮	2018-11-25T03:54:41+08:00	8345	2490	10835	982	11817	25661	46.05%	32.52%	25	25
8	屏東縣恆春鎮	2018-11-25T03:30:59+08:00	8345	2490	10835	982	11817	25661	46.05%	32.52%	25	25
8	屏東縣恆春鎮	2018-11-24T22:32:19+08:00	2932	923	3855	443	4298	9277	46.33%	31.61%	11	25
8	屏東縣恆春鎮	2018-11-25T01:06:00+08:00	8345	2490	10835	982	11817	25661	46.05%	32.52%	25	25
8	屏東縣恆春鎮	2018-11-24T23:00:17+08:00	4652	1424	6076	621	6697	14731	45.46%	31.58%	16	25
8	屏東縣恆春鎮	2018-11-25T00:21:44+08:00	7923	2361	10284	930	11214	24408	45.94%	32.46%	24	25
8	屏東縣恆春鎮	2018-11-25T01:11:08+08:00	8345	2490	10835	982	11817	25661	46.05%	32.52%	25	25
8	屏東縣恆春鎮	2018-11-25T06:07:23+08:00	8345	2490	10835	982	11817	25661	46.05%	32.52%	25	25
8	屏東縣恆春鎮	2018-11-24T22:40:19+08:00	4135	1271	5406	566	5972	13003	45.93%	31.8%	14	25
8	屏東縣恆春鎮	2018-11-24T23:29:47+08:00	5110	1541	6651	671	7322	16011	45.73%	31.92%	17	25
8	屏東縣恆春鎮	2018-11-25T00:03:35+08:00	7480	2247	9727	867	10594	22923	46.22%	32.63%	23	25
8	屏東縣恆春鎮	2018-11-25T00:56:14+08:00	8345	2490	10835	982	11817	25661	46.05%	32.52%	25	25
8	屏東縣恆春鎮	2018-11-24T23:54:27+08:00	6978	2093	9071	823	9894	21418	46.19%	32.58%	22	25
8	屏東縣恆春鎮	2018-11-24T22:35:45+08:00	3256	1024	4280	468	4748	10356	45.85%	31.44%	12	25
8	屏東縣恆春鎮	2018-11-25T01:16:22+08:00	8345	2490	10835	982	11817	25661	46.05%	32.52%	25	25
8	屏東縣恆春鎮	2018-11-24T23:37:49+08:00	5834	1785	7619	741	8360	18068	46.27%	32.29%	19	25
8	屏東縣恆春鎮	2018-11-24T22:43:51+08:00	4135	1271	5406	566	5972	13003	45.93%	31.8%	14	25
8	屏東縣恆春鎮	2018-11-24T23:22:23+08:00	5110	1541	6651	671	7322	16011	45.73%	31.92%	17	25
8	屏東縣恆春鎮	2018-11-24T22:49:24+08:00	4467	1383	5850	611	6461	14023	46.07%	31.85%	15	25
8	屏東縣恆春鎮	2018-11-24T22:12:03+08:00	1384	453	1837	222	2059	4311	47.76%	32.1%	6	25
8	屏東縣恆春鎮	2018-11-24T23:03:47+08:00	5110	1541	6651	671	7322	16011	45.73%	31.92%	17	25
8	屏東縣恆春鎮	2018-11-24T22:28:40+08:00	2553	834	3387	398	3785	8151	46.44%	31.32%	10	25
8	屏東縣恆春鎮	2018-11-24T23:33:50+08:00	5834	1785	7619	741	8360	18068	46.27%	32.29%	19	25
8	屏東縣恆春鎮	2018-11-25T04:01:30+08:00	8345	2490	10835	982	11817	25661	46.05%	32.52%	25	25
8	屏東縣恆春鎮	2018-11-25T03:42:49+08:00	8345	2490	10835	982	11817	25661	46.05%	32.52%	25	25
8	屏東縣恆春鎮	2018-11-24T23:42:02+08:00	6173	1889	8062	779	8841	18964	46.62%	32.55%	20	25
8	屏東縣恆春鎮	2018-11-25T00:08:05+08:00	7480	2247	9727	867	10594	22923	46.22%	32.63%	23	25
8	屏東縣恆春鎮	2018-11-24T22:53:15+08:00	4467	1383	5850	611	6461	14023	46.07%	31.85%	15	25
8	屏東縣恆春鎮	2018-11-24T23:46:04+08:00	6978	2093	9071	823	9894	21418	46.19%	32.58%	22	25
8	屏東縣恆春鎮	2018-11-25T06:12:37+08:00	8345	2490	10835	982	11817	25661	46.05%	32.52%	25	25
8	屏東縣恆春鎮	2018-11-24T22:21:46+08:00	2355	780	3135	373	3508	7376	47.56%	31.93%	9	25
8	屏東縣恆春鎮	2018-11-24T22:25:25+08:00	2553	834	3387	398	3785	8151	46.44%	31.32%	10	25
8	屏東縣恆春鎮	2018-11-25T00:17:08+08:00	7923	2361	10284	930	11214	24408	45.94%	32.46%	24	25
8	屏東縣恆春鎮	2018-11-25T06:22:45+08:00	8345	2490	10835	982	11817	25661	46.05%	32.52%	25	25
8	屏東縣恆春鎮	2018-11-25T03:48:31+08:00	8345	2490	10835	982	11817	25661	46.05%	32.52%	25	25
8	屏東縣恆春鎮	2018-11-24T22:14:49+08:00	1695	579	2274	282	2556	5421	47.15%	31.27%	7	25
8	屏東縣恆春鎮	2018-11-24T22:18:20+08:00	1695	579	2274	282	2556	5421	47.15%	31.27%	7	25
8	屏東縣恆春鎮	2018-11-25T03:37:30+08:00	8345	2490	10835	982	11817	25661	46.05%	32.52%	25	25
8	屏東縣恆春鎮	2018-11-24T23:58:43+08:00	6978	2093	9071	823	9894	21418	46.19%	32.58%	22	25
8	屏東縣恆春鎮	2018-11-25T06:27:55+08:00	8345	2490	10835	982	11817	25661	46.05%	32.52%	25	25
8	屏東縣恆春鎮	2018-11-24T23:26:07+08:00	5110	1541	6651	671	7322	16011	45.73%	31.92%	17	25
8	屏東縣恆春鎮	2018-11-25T00:12:45+08:00	7923	2361	10284	930	11214	24408	45.94%	32.46%	24	25
8	屏東縣恆春鎮	2018-11-25T01:01:02+08:00	8345	2490	10835	982	11817	25661	46.05%	32.52%	25	25
8	屏東縣恆春鎮	2018-11-24T23:18:28+08:00	5110	1541	6651	671	7322	16011	45.73%	31.92%	17	25
8	屏東縣恆春鎮	2018-11-24T23:14:41+08:00	5110	1541	6651	671	7322	16011	45.73%	31.92%	17	25
8	屏東縣恆春鎮	2018-11-24T23:50:15+08:00	6978	2093	9071	823	9894	21418	46.19%	32.58%	22	25
8	臺南市新市區	2018-11-25T03:37:19+08:00	10793	3857	14650	1357	16007	30386	52.68%	35.52%	27	27
8	臺南市新市區	2018-11-25T00:56:08+08:00	10793	3857	14650	1357	16007	30386	52.68%	35.52%	27	27
8	臺南市新市區	2018-11-24T22:49:18+08:00	10793	3857	14650	1357	16007	30386	52.68%	35.52%	27	27
8	臺南市新市區	2018-11-24T23:14:34+08:00	10793	3857	14650	1357	16007	30386	52.68%	35.52%	27	27
8	臺南市新市區	2018-11-24T22:43:45+08:00	10793	3857	14650	1357	16007	30386	52.68%	35.52%	27	27
8	臺南市新市區	2018-11-24T23:03:42+08:00	10793	3857	14650	1357	16007	30386	52.68%	35.52%	27	27
8	臺南市新市區	2018-11-24T23:10:51+08:00	10793	3857	14650	1357	16007	30386	52.68%	35.52%	27	27
8	臺南市新市區	2018-11-25T00:03:28+08:00	10793	3857	14650	1357	16007	30386	52.68%	35.52%	27	27
8	臺南市新市區	2018-11-25T06:17:30+08:00	10793	3857	14650	1357	16007	30386	52.68%	35.52%	27	27
8	臺南市新市區	2018-11-24T23:58:36+08:00	10793	3857	14650	1357	16007	30386	52.68%	35.52%	27	27
8	臺南市新市區	2018-11-24T23:22:17+08:00	10793	3857	14650	1357	16007	30386	52.68%	35.52%	27	27
8	臺南市新市區	2018-11-25T03:42:42+08:00	10793	3857	14650	1357	16007	30386	52.68%	35.52%	27	27
8	臺南市新市區	2018-11-25T06:22:40+08:00	10793	3857	14650	1357	16007	30386	52.68%	35.52%	27	27
8	臺南市新市區	2018-11-24T23:29:41+08:00	10793	3857	14650	1357	16007	30386	52.68%	35.52%	27	27
8	臺南市新市區	2018-11-24T22:25:18+08:00	10793	3857	14650	1357	16007	30386	52.68%	35.52%	27	27
8	臺南市新市區	2018-11-25T01:11:00+08:00	10793	3857	14650	1357	16007	30386	52.68%	35.52%	27	27
8	臺南市新市區	2018-11-25T00:17:02+08:00	10793	3857	14650	1357	16007	30386	52.68%	35.52%	27	27
8	臺南市新市區	2018-11-25T06:12:32+08:00	10793	3857	14650	1357	16007	30386	52.68%	35.52%	27	27
8	臺南市新市區	2018-11-25T00:12:40+08:00	10793	3857	14650	1357	16007	30386	52.68%	35.52%	27	27
8	臺南市新市區	2018-11-24T22:28:35+08:00	10793	3857	14650	1357	16007	30386	52.68%	35.52%	27	27
8	臺南市新市區	2018-11-24T22:14:43+08:00	10465	3711	14176	1319	15495	29475	52.57%	35.5%	26	27
8	臺南市新市區	2018-11-24T23:26:02+08:00	10793	3857	14650	1357	16007	30386	52.68%	35.52%	27	27
8	臺南市新市區	2018-11-24T23:54:20+08:00	10793	3857	14650	1357	16007	30386	52.68%	35.52%	27	27
8	臺南市新市區	2018-11-25T06:27:50+08:00	10793	3857	14650	1357	16007	30386	52.68%	35.52%	27	27
8	臺南市新市區	2018-11-25T00:07:59+08:00	10793	3857	14650	1357	16007	30386	52.68%	35.52%	27	27
8	臺南市新市區	2018-11-24T23:18:22+08:00	10793	3857	14650	1357	16007	30386	52.68%	35.52%	27	27
8	臺南市新市區	2018-11-25T01:05:53+08:00	10793	3857	14650	1357	16007	30386	52.68%	35.52%	27	27
8	臺南市新市區	2018-11-24T22:18:14+08:00	10793	3857	14650	1357	16007	30386	52.68%	35.52%	27	27
8	臺南市新市區	2018-11-25T01:24:18+08:00	10793	3857	14650	1357	16007	30386	52.68%	35.52%	27	27
8	臺南市新市區	2018-11-24T22:56:32+08:00	10793	3857	14650	1357	16007	30386	52.68%	35.52%	27	27
8	臺南市新市區	2018-11-24T23:50:09+08:00	10793	3857	14650	1357	16007	30386	52.68%	35.52%	27	27
8	臺南市新市區	2018-11-24T22:39:03+08:00	10793	3857	14650	1357	16007	30386	52.68%	35.52%	27	27
8	臺南市新市區	2018-11-24T23:07:13+08:00	10793	3857	14650	1357	16007	30386	52.68%	35.52%	27	27
8	臺南市新市區	2018-11-24T22:32:13+08:00	10793	3857	14650	1357	16007	30386	52.68%	35.52%	27	27
8	臺南市新市區	2018-11-25T03:30:53+08:00	10793	3857	14650	1357	16007	30386	52.68%	35.52%	27	27
8	臺南市新市區	2018-11-25T03:48:23+08:00	10793	3857	14650	1357	16007	30386	52.68%	35.52%	27	27
8	臺南市新市區	2018-11-25T01:00:55+08:00	10793	3857	14650	1357	16007	30386	52.68%	35.52%	27	27
8	臺南市新市區	2018-11-24T23:00:09+08:00	10793	3857	14650	1357	16007	30386	52.68%	35.52%	27	27
8	臺南市新市區	2018-11-25T00:21:38+08:00	10793	3857	14650	1357	16007	30386	52.68%	35.52%	27	27
8	臺南市新市區	2018-11-25T06:07:17+08:00	10793	3857	14650	1357	16007	30386	52.68%	35.52%	27	27
8	臺南市新市區	2018-11-24T22:53:09+08:00	10793	3857	14650	1357	16007	30386	52.68%	35.52%	27	27
8	臺南市新市區	2018-11-24T22:40:14+08:00	10793	3857	14650	1357	16007	30386	52.68%	35.52%	27	27
8	臺南市新市區	2018-11-24T22:11:58+08:00	10465	3711	14176	1319	15495	29475	52.57%	35.5%	26	27
8	臺南市新市區	2018-11-25T04:01:23+08:00	10793	3857	14650	1357	16007	30386	52.68%	35.52%	27	27
8	臺南市新市區	2018-11-24T22:21:40+08:00	10793	3857	14650	1357	16007	30386	52.68%	35.52%	27	27
8	臺南市新市區	2018-11-24T23:41:57+08:00	10793	3857	14650	1357	16007	30386	52.68%	35.52%	27	27
8	臺南市新市區	2018-11-25T01:16:16+08:00	10793	3857	14650	1357	16007	30386	52.68%	35.52%	27	27
8	臺南市新市區	2018-11-24T22:35:40+08:00	10793	3857	14650	1357	16007	30386	52.68%	35.52%	27	27
8	臺南市新市區	2018-11-25T03:54:35+08:00	10793	3857	14650	1357	16007	30386	52.68%	35.52%	27	27
8	臺南市新市區	2018-11-24T23:33:45+08:00	10793	3857	14650	1357	16007	30386	52.68%	35.52%	27	27
8	臺南市新市區	2018-11-24T23:37:44+08:00	10793	3857	14650	1357	16007	30386	52.68%	35.52%	27	27
8	臺南市新市區	2018-11-24T23:45:59+08:00	10793	3857	14650	1357	16007	30386	52.68%	35.52%	27	27
8	屏東縣竹田鄉	2018-11-24T23:10:57+08:00	5350	1904	7254	890	8144	14126	57.65%	37.87%	15	16
8	屏東縣竹田鄉	2018-11-24T23:07:19+08:00	5350	1904	7254	890	8144	14126	57.65%	37.87%	15	16
8	屏東縣竹田鄉	2018-11-24T22:14:50+08:00	2248	795	3043	397	3440	5645	60.94%	39.82%	7	16
8	屏東縣竹田鄉	2018-11-25T06:17:37+08:00	5777	2046	7823	962	8785	15353	57.22%	37.63%	16	16
8	屏東縣竹田鄉	2018-11-25T01:24:25+08:00	5777	2046	7823	962	8785	15353	57.22%	37.63%	16	16
8	屏東縣竹田鄉	2018-11-24T22:56:37+08:00	5350	1904	7254	890	8144	14126	57.65%	37.87%	15	16
8	屏東縣竹田鄉	2018-11-25T03:54:41+08:00	5777	2046	7823	962	8785	15353	57.22%	37.63%	16	16
8	屏東縣竹田鄉	2018-11-24T22:32:19+08:00	3462	1241	4703	580	5283	8943	59.07%	38.71%	11	16
8	屏東縣竹田鄉	2018-11-24T22:53:16+08:00	5350	1904	7254	890	8144	14126	57.65%	37.87%	15	16
8	屏東縣竹田鄉	2018-11-25T01:06:00+08:00	5777	2046	7823	962	8785	15353	57.22%	37.63%	16	16
8	屏東縣竹田鄉	2018-11-24T22:25:26+08:00	3462	1241	4703	580	5283	8943	59.07%	38.71%	11	16
8	屏東縣竹田鄉	2018-11-24T23:00:17+08:00	5350	1904	7254	890	8144	14126	57.65%	37.87%	15	16
8	屏東縣竹田鄉	2018-11-25T01:11:08+08:00	5777	2046	7823	962	8785	15353	57.22%	37.63%	16	16
8	屏東縣竹田鄉	2018-11-25T06:07:23+08:00	5777	2046	7823	962	8785	15353	57.22%	37.63%	16	16
8	屏東縣竹田鄉	2018-11-24T22:40:19+08:00	4430	1603	6033	748	6781	11675	58.08%	37.94%	13	16
8	屏東縣竹田鄉	2018-11-24T23:29:47+08:00	5350	1904	7254	890	8144	14126	57.65%	37.87%	15	16
8	屏東縣竹田鄉	2018-11-25T00:21:45+08:00	5777	2046	7823	962	8785	15353	57.22%	37.63%	16	16
8	屏東縣竹田鄉	2018-11-25T03:31:00+08:00	5777	2046	7823	962	8785	15353	57.22%	37.63%	16	16
8	屏東縣竹田鄉	2018-11-25T01:16:23+08:00	5777	2046	7823	962	8785	15353	57.22%	37.63%	16	16
8	屏東縣竹田鄉	2018-11-25T00:03:35+08:00	5350	1904	7254	890	8144	14126	57.65%	37.87%	15	16
8	屏東縣竹田鄉	2018-11-25T00:56:14+08:00	5777	2046	7823	962	8785	15353	57.22%	37.63%	16	16
8	屏東縣竹田鄉	2018-11-24T22:35:45+08:00	3883	1411	5294	652	5946	10172	58.45%	38.17%	12	16
8	屏東縣竹田鄉	2018-11-24T23:14:42+08:00	5350	1904	7254	890	8144	14126	57.65%	37.87%	15	16
8	屏東縣竹田鄉	2018-11-24T23:37:49+08:00	5350	1904	7254	890	8144	14126	57.65%	37.87%	15	16
8	屏東縣竹田鄉	2018-11-24T22:43:51+08:00	4847	1737	6584	821	7405	12867	57.55%	37.67%	14	16
8	屏東縣竹田鄉	2018-11-25T06:27:56+08:00	5777	2046	7823	962	8785	15353	57.22%	37.63%	16	16
8	屏東縣竹田鄉	2018-11-24T23:54:28+08:00	5350	1904	7254	890	8144	14126	57.65%	37.87%	15	16
8	屏東縣竹田鄉	2018-11-24T23:22:24+08:00	5350	1904	7254	890	8144	14126	57.65%	37.87%	15	16
8	屏東縣竹田鄉	2018-11-24T22:28:41+08:00	3462	1241	4703	580	5283	8943	59.07%	38.71%	11	16
8	屏東縣竹田鄉	2018-11-24T22:12:03+08:00	1766	650	2416	337	2753	4520	60.91%	39.07%	5	16
8	屏東縣竹田鄉	2018-11-24T23:33:51+08:00	5350	1904	7254	890	8144	14126	57.65%	37.87%	15	16
8	屏東縣竹田鄉	2018-11-24T23:03:48+08:00	5350	1904	7254	890	8144	14126	57.65%	37.87%	15	16
8	屏東縣竹田鄉	2018-11-24T22:49:25+08:00	5350	1904	7254	890	8144	14126	57.65%	37.87%	15	16
8	屏東縣竹田鄉	2018-11-25T04:01:30+08:00	5777	2046	7823	962	8785	15353	57.22%	37.63%	16	16
8	屏東縣竹田鄉	2018-11-25T03:42:49+08:00	5777	2046	7823	962	8785	15353	57.22%	37.63%	16	16
8	屏東縣竹田鄉	2018-11-24T23:42:02+08:00	5350	1904	7254	890	8144	14126	57.65%	37.87%	15	16
8	屏東縣竹田鄉	2018-11-25T00:08:05+08:00	5350	1904	7254	890	8144	14126	57.65%	37.87%	15	16
8	屏東縣竹田鄉	2018-11-24T23:46:04+08:00	5350	1904	7254	890	8144	14126	57.65%	37.87%	15	16
8	屏東縣竹田鄉	2018-11-25T00:17:09+08:00	5777	2046	7823	962	8785	15353	57.22%	37.63%	16	16
8	屏東縣竹田鄉	2018-11-25T06:12:37+08:00	5777	2046	7823	962	8785	15353	57.22%	37.63%	16	16
8	屏東縣竹田鄉	2018-11-25T06:22:45+08:00	5777	2046	7823	962	8785	15353	57.22%	37.63%	16	16
8	屏東縣竹田鄉	2018-11-24T22:21:47+08:00	3462	1241	4703	580	5283	8943	59.07%	38.71%	11	16
8	屏東縣竹田鄉	2018-11-25T03:48:31+08:00	5777	2046	7823	962	8785	15353	57.22%	37.63%	16	16
8	屏東縣竹田鄉	2018-11-24T22:39:10+08:00	3883	1411	5294	652	5946	10172	58.45%	38.17%	12	16
8	屏東縣竹田鄉	2018-11-24T22:18:20+08:00	2442	884	3326	436	3762	6149	61.18%	39.71%	8	16
8	屏東縣竹田鄉	2018-11-25T03:37:30+08:00	5777	2046	7823	962	8785	15353	57.22%	37.63%	16	16
8	屏東縣竹田鄉	2018-11-24T23:58:43+08:00	5350	1904	7254	890	8144	14126	57.65%	37.87%	15	16
8	屏東縣竹田鄉	2018-11-24T23:26:07+08:00	5350	1904	7254	890	8144	14126	57.65%	37.87%	15	16
8	屏東縣竹田鄉	2018-11-25T00:12:45+08:00	5777	2046	7823	962	8785	15353	57.22%	37.63%	16	16
8	屏東縣竹田鄉	2018-11-25T01:01:02+08:00	5777	2046	7823	962	8785	15353	57.22%	37.63%	16	16
8	屏東縣竹田鄉	2018-11-24T23:18:28+08:00	5350	1904	7254	890	8144	14126	57.65%	37.87%	15	16
8	屏東縣竹田鄉	2018-11-24T23:50:15+08:00	5350	1904	7254	890	8144	14126	57.65%	37.87%	15	16
8	臺南市龍崎區	2018-11-25T00:56:08+08:00	1137	377	1514	184	1698	3713	45.73%	30.62%	8	8
8	臺南市龍崎區	2018-11-24T23:14:34+08:00	1137	377	1514	184	1698	3713	45.73%	30.62%	8	8
8	臺南市龍崎區	2018-11-24T23:03:43+08:00	1137	377	1514	184	1698	3713	45.73%	30.62%	8	8
8	臺南市龍崎區	2018-11-25T06:17:31+08:00	1137	377	1514	184	1698	3713	45.73%	30.62%	8	8
8	臺南市龍崎區	2018-11-24T23:22:18+08:00	1137	377	1514	184	1698	3713	45.73%	30.62%	8	8
8	臺南市龍崎區	2018-11-24T22:43:45+08:00	1137	377	1514	184	1698	3713	45.73%	30.62%	8	8
8	臺南市龍崎區	2018-11-25T03:37:20+08:00	1137	377	1514	184	1698	3713	45.73%	30.62%	8	8
8	臺南市龍崎區	2018-11-24T22:49:19+08:00	1137	377	1514	184	1698	3713	45.73%	30.62%	8	8
8	臺南市龍崎區	2018-11-25T00:03:28+08:00	1137	377	1514	184	1698	3713	45.73%	30.62%	8	8
8	臺南市龍崎區	2018-11-24T23:58:36+08:00	1137	377	1514	184	1698	3713	45.73%	30.62%	8	8
8	臺南市龍崎區	2018-11-25T03:42:42+08:00	1137	377	1514	184	1698	3713	45.73%	30.62%	8	8
8	臺南市龍崎區	2018-11-24T22:25:19+08:00	1137	377	1514	184	1698	3713	45.73%	30.62%	8	8
8	臺南市龍崎區	2018-11-25T06:22:40+08:00	1137	377	1514	184	1698	3713	45.73%	30.62%	8	8
8	臺南市龍崎區	2018-11-25T00:17:03+08:00	1137	377	1514	184	1698	3713	45.73%	30.62%	8	8
8	臺南市龍崎區	2018-11-25T01:11:01+08:00	1137	377	1514	184	1698	3713	45.73%	30.62%	8	8
8	臺南市龍崎區	2018-11-24T23:29:41+08:00	1137	377	1514	184	1698	3713	45.73%	30.62%	8	8
8	臺南市龍崎區	2018-11-25T06:12:32+08:00	1137	377	1514	184	1698	3713	45.73%	30.62%	8	8
8	臺南市龍崎區	2018-11-24T23:50:10+08:00	1137	377	1514	184	1698	3713	45.73%	30.62%	8	8
8	臺南市龍崎區	2018-11-25T00:12:40+08:00	1137	377	1514	184	1698	3713	45.73%	30.62%	8	8
8	臺南市龍崎區	2018-11-24T22:28:35+08:00	1137	377	1514	184	1698	3713	45.73%	30.62%	8	8
8	臺南市龍崎區	2018-11-24T22:14:43+08:00	1137	377	1514	184	1698	3713	45.73%	30.62%	8	8
8	臺南市龍崎區	2018-11-24T23:26:02+08:00	1137	377	1514	184	1698	3713	45.73%	30.62%	8	8
8	臺南市龍崎區	2018-11-24T23:54:20+08:00	1137	377	1514	184	1698	3713	45.73%	30.62%	8	8
8	臺南市龍崎區	2018-11-25T06:27:50+08:00	1137	377	1514	184	1698	3713	45.73%	30.62%	8	8
8	臺南市龍崎區	2018-11-25T00:07:59+08:00	1137	377	1514	184	1698	3713	45.73%	30.62%	8	8
8	臺南市龍崎區	2018-11-24T23:18:22+08:00	1137	377	1514	184	1698	3713	45.73%	30.62%	8	8
8	臺南市龍崎區	2018-11-25T01:05:53+08:00	1137	377	1514	184	1698	3713	45.73%	30.62%	8	8
8	臺南市龍崎區	2018-11-24T22:18:14+08:00	1137	377	1514	184	1698	3713	45.73%	30.62%	8	8
8	臺南市龍崎區	2018-11-24T22:56:32+08:00	1137	377	1514	184	1698	3713	45.73%	30.62%	8	8
8	臺南市龍崎區	2018-11-25T01:24:19+08:00	1137	377	1514	184	1698	3713	45.73%	30.62%	8	8
8	臺南市龍崎區	2018-11-24T22:39:04+08:00	1137	377	1514	184	1698	3713	45.73%	30.62%	8	8
8	臺南市龍崎區	2018-11-24T23:10:52+08:00	1137	377	1514	184	1698	3713	45.73%	30.62%	8	8
8	臺南市龍崎區	2018-11-24T23:07:14+08:00	1137	377	1514	184	1698	3713	45.73%	30.62%	8	8
8	臺南市龍崎區	2018-11-25T00:21:39+08:00	1137	377	1514	184	1698	3713	45.73%	30.62%	8	8
8	臺南市龍崎區	2018-11-24T22:32:13+08:00	1137	377	1514	184	1698	3713	45.73%	30.62%	8	8
8	臺南市龍崎區	2018-11-25T03:30:53+08:00	1137	377	1514	184	1698	3713	45.73%	30.62%	8	8
8	臺南市龍崎區	2018-11-25T03:48:24+08:00	1137	377	1514	184	1698	3713	45.73%	30.62%	8	8
8	臺南市龍崎區	2018-11-25T01:00:55+08:00	1137	377	1514	184	1698	3713	45.73%	30.62%	8	8
8	臺南市龍崎區	2018-11-24T23:00:13+08:00	1137	377	1514	184	1698	3713	45.73%	30.62%	8	8
8	臺南市龍崎區	2018-11-25T06:07:17+08:00	1137	377	1514	184	1698	3713	45.73%	30.62%	8	8
8	臺南市龍崎區	2018-11-24T22:53:09+08:00	1137	377	1514	184	1698	3713	45.73%	30.62%	8	8
8	臺南市龍崎區	2018-11-24T22:40:14+08:00	1137	377	1514	184	1698	3713	45.73%	30.62%	8	8
8	臺南市龍崎區	2018-11-24T22:11:58+08:00	1137	377	1514	184	1698	3713	45.73%	30.62%	8	8
8	臺南市龍崎區	2018-11-25T04:01:23+08:00	1137	377	1514	184	1698	3713	45.73%	30.62%	8	8
8	臺南市龍崎區	2018-11-24T22:21:40+08:00	1137	377	1514	184	1698	3713	45.73%	30.62%	8	8
8	臺南市龍崎區	2018-11-24T23:41:57+08:00	1137	377	1514	184	1698	3713	45.73%	30.62%	8	8
8	臺南市龍崎區	2018-11-25T01:16:16+08:00	1137	377	1514	184	1698	3713	45.73%	30.62%	8	8
8	臺南市龍崎區	2018-11-24T22:35:40+08:00	1137	377	1514	184	1698	3713	45.73%	30.62%	8	8
8	臺南市龍崎區	2018-11-25T03:54:35+08:00	1137	377	1514	184	1698	3713	45.73%	30.62%	8	8
8	臺南市龍崎區	2018-11-24T23:33:45+08:00	1137	377	1514	184	1698	3713	45.73%	30.62%	8	8
8	臺南市龍崎區	2018-11-24T23:37:44+08:00	1137	377	1514	184	1698	3713	45.73%	30.62%	8	8
8	臺南市龍崎區	2018-11-24T23:45:59+08:00	1137	377	1514	184	1698	3713	45.73%	30.62%	8	8
8	桃園市大園區	2018-11-25T03:37:17+08:00	25568	8256	33824	2421	36245	73900	49.05%	34.6%	50	50
8	桃園市大園區	2018-11-24T22:39:01+08:00	14359	4680	19039	1469	20508	41342	49.61%	34.73%	29	50
8	桃園市大園區	2018-11-25T01:10:58+08:00	25568	8256	33824	2421	36245	73900	49.05%	34.6%	50	50
8	桃園市大園區	2018-11-25T00:12:37+08:00	22913	7403	30316	2214	32530	65963	49.32%	34.74%	45	50
8	桃園市大園區	2018-11-24T22:49:17+08:00	15372	4997	20369	1566	21935	44058	49.79%	34.89%	31	50
8	桃園市大園區	2018-11-24T23:14:32+08:00	16829	5490	22319	1695	24014	48468	49.55%	34.72%	34	50
8	桃園市大園區	2018-11-24T22:43:43+08:00	14793	4826	19619	1500	21119	42603	49.57%	34.72%	30	50
8	桃園市大園區	2018-11-24T22:56:30+08:00	15372	4997	20369	1566	21935	44058	49.79%	34.89%	31	50
8	桃園市大園區	2018-11-25T06:22:37+08:00	25568	8256	33824	2421	36245	73900	49.05%	34.6%	50	50
8	桃園市大園區	2018-11-25T03:30:50+08:00	25568	8256	33824	2421	36245	73900	49.05%	34.6%	50	50
8	桃園市大園區	2018-11-25T03:48:21+08:00	25568	8256	33824	2421	36245	73900	49.05%	34.6%	50	50
8	桃園市大園區	2018-11-24T22:32:11+08:00	13304	4312	17616	1377	18993	38113	49.83%	34.91%	27	50
8	桃園市大園區	2018-11-24T23:29:39+08:00	18331	6022	24353	1880	26233	52935	49.56%	34.63%	37	50
8	桃園市大園區	2018-11-25T04:01:21+08:00	25568	8256	33824	2421	36245	73900	49.05%	34.6%	50	50
8	桃園市大園區	2018-11-24T22:25:16+08:00	12722	4129	16851	1309	18160	36463	49.8%	34.89%	26	50
8	桃園市大園區	2018-11-25T06:07:15+08:00	25568	8256	33824	2421	36245	73900	49.05%	34.6%	50	50
8	桃園市大園區	2018-11-24T22:18:12+08:00	11643	3799	15442	1209	16651	33704	49.4%	34.54%	24	50
8	桃園市大園區	2018-11-24T23:54:18+08:00	20514	6703	27217	2044	29261	59566	49.12%	34.44%	41	50
8	桃園市大園區	2018-11-25T00:07:57+08:00	21721	7049	28770	2124	30894	62917	49.1%	34.52%	43	50
8	桃園市大園區	2018-11-25T01:16:14+08:00	25568	8256	33824	2421	36245	73900	49.05%	34.6%	50	50
8	桃園市大園區	2018-11-24T23:41:55+08:00	18928	6203	25131	1920	27051	54779	49.38%	34.55%	38	50
8	桃園市大園區	2018-11-24T22:28:33+08:00	12722	4129	16851	1309	18160	36463	49.8%	34.89%	26	50
8	桃園市大園區	2018-11-24T23:58:34+08:00	21113	6858	27971	2106	30077	61267	49.09%	34.46%	42	50
8	桃園市大園區	2018-11-24T23:22:15+08:00	17862	5842	23704	1819	25523	51516	49.54%	34.67%	36	50
8	桃園市大園區	2018-11-25T01:24:16+08:00	25568	8256	33824	2421	36245	73900	49.05%	34.6%	50	50
8	桃園市大園區	2018-11-24T22:35:38+08:00	13304	4312	17616	1377	18993	38113	49.83%	34.91%	27	50
8	桃園市大園區	2018-11-24T23:07:12+08:00	16298	5313	21611	1639	23250	46781	49.7%	34.84%	33	50
8	桃園市大園區	2018-11-25T00:56:05+08:00	25568	8256	33824	2421	36245	73900	49.05%	34.6%	50	50
8	桃園市大園區	2018-11-25T06:27:48+08:00	25568	8256	33824	2421	36245	73900	49.05%	34.6%	50	50
8	桃園市大園區	2018-11-24T23:50:07+08:00	20514	6703	27217	2044	29261	59566	49.12%	34.44%	41	50
8	桃園市大園區	2018-11-25T00:03:25+08:00	21721	7049	28770	2124	30894	62917	49.1%	34.52%	43	50
8	桃園市大園區	2018-11-24T23:03:41+08:00	15812	5160	20972	1609	22581	45384	49.76%	34.84%	32	50
8	桃園市大園區	2018-11-24T23:00:06+08:00	15372	4997	20369	1566	21935	44058	49.79%	34.89%	31	50
8	桃園市大園區	2018-11-24T22:21:38+08:00	12722	4129	16851	1309	18160	36463	49.8%	34.89%	26	50
8	桃園市大園區	2018-11-25T00:21:36+08:00	24474	7912	32386	2341	34727	70946	48.95%	34.5%	48	50
8	桃園市大園區	2018-11-25T01:00:52+08:00	25568	8256	33824	2421	36245	73900	49.05%	34.6%	50	50
8	桃園市大園區	2018-11-25T06:12:30+08:00	25568	8256	33824	2421	36245	73900	49.05%	34.6%	50	50
8	桃園市大園區	2018-11-24T22:53:06+08:00	15372	4997	20369	1566	21935	44058	49.79%	34.89%	31	50
8	桃園市大園區	2018-11-24T22:40:12+08:00	14359	4680	19039	1469	20508	41342	49.61%	34.73%	29	50
8	桃園市大園區	2018-11-25T03:42:39+08:00	25568	8256	33824	2421	36245	73900	49.05%	34.6%	50	50
8	桃園市大園區	2018-11-25T00:17:01+08:00	23510	7593	31103	2264	33367	67517	49.42%	34.82%	46	50
8	桃園市大園區	2018-11-24T22:11:56+08:00	10180	3289	13469	1027	14496	29796	48.65%	34.17%	21	50
8	桃園市大園區	2018-11-24T23:33:43+08:00	18331	6022	24353	1880	26233	52935	49.56%	34.63%	37	50
8	桃園市大園區	2018-11-24T23:18:20+08:00	17862	5842	23704	1819	25523	51516	49.54%	34.67%	36	50
8	桃園市大園區	2018-11-24T23:37:42+08:00	18928	6203	25131	1920	27051	54779	49.38%	34.55%	38	50
8	桃園市大園區	2018-11-24T22:14:41+08:00	11133	3591	14724	1141	15865	32290	49.13%	34.48%	23	50
8	桃園市大園區	2018-11-25T01:05:50+08:00	25568	8256	33824	2421	36245	73900	49.05%	34.6%	50	50
8	桃園市大園區	2018-11-24T23:26:00+08:00	18331	6022	24353	1880	26233	52935	49.56%	34.63%	37	50
8	桃園市大園區	2018-11-24T23:10:49+08:00	16829	5490	22319	1695	24014	48468	49.55%	34.72%	34	50
8	桃園市大園區	2018-11-25T03:54:32+08:00	25568	8256	33824	2421	36245	73900	49.05%	34.6%	50	50
8	桃園市大園區	2018-11-25T06:17:28+08:00	25568	8256	33824	2421	36245	73900	49.05%	34.6%	50	50
8	桃園市大園區	2018-11-24T23:45:57+08:00	19958	6530	26488	2017	28505	57929	49.21%	34.45%	40	50
8	苗栗縣三義鄉	2018-11-25T03:37:26+08:00	6123	1538	7661	471	8132	13889	58.55%	44.09%	16	16
8	苗栗縣三義鄉	2018-11-24T23:07:16+08:00	6123	1538	7661	471	8132	13889	58.55%	44.09%	16	16
8	苗栗縣三義鄉	2018-11-24T22:12:00+08:00	4678	1218	5896	382	6278	10622	59.1%	44.04%	13	16
8	苗栗縣三義鄉	2018-11-24T22:39:06+08:00	5579	1420	6999	449	7448	12691	58.69%	43.96%	15	16
8	苗栗縣三義鄉	2018-11-24T23:03:45+08:00	6123	1538	7661	471	8132	13889	58.55%	44.09%	16	16
8	苗栗縣三義鄉	2018-11-24T22:49:21+08:00	6123	1538	7661	471	8132	13889	58.55%	44.09%	16	16
8	苗栗縣三義鄉	2018-11-24T23:22:21+08:00	6123	1538	7661	471	8132	13889	58.55%	44.09%	16	16
8	苗栗縣三義鄉	2018-11-25T01:24:22+08:00	6123	1538	7661	471	8132	13889	58.55%	44.09%	16	16
8	苗栗縣三義鄉	2018-11-24T23:46:01+08:00	6123	1538	7661	471	8132	13889	58.55%	44.09%	16	16
8	苗栗縣三義鄉	2018-11-24T23:42:00+08:00	6123	1538	7661	471	8132	13889	58.55%	44.09%	16	16
8	苗栗縣三義鄉	2018-11-25T03:30:56+08:00	6123	1538	7661	471	8132	13889	58.55%	44.09%	16	16
8	苗栗縣三義鄉	2018-11-25T03:42:45+08:00	6123	1538	7661	471	8132	13889	58.55%	44.09%	16	16
8	苗栗縣三義鄉	2018-11-24T22:32:16+08:00	5579	1420	6999	449	7448	12691	58.69%	43.96%	15	16
8	苗栗縣三義鄉	2018-11-25T03:48:27+08:00	6123	1538	7661	471	8132	13889	58.55%	44.09%	16	16
8	苗栗縣三義鄉	2018-11-25T01:00:58+08:00	6123	1538	7661	471	8132	13889	58.55%	44.09%	16	16
8	苗栗縣三義鄉	2018-11-24T22:25:21+08:00	5579	1420	6999	449	7448	12691	58.69%	43.96%	15	16
8	苗栗縣三義鄉	2018-11-25T06:12:34+08:00	6123	1538	7661	471	8132	13889	58.55%	44.09%	16	16
8	苗栗縣三義鄉	2018-11-25T04:01:27+08:00	6123	1538	7661	471	8132	13889	58.55%	44.09%	16	16
8	苗栗縣三義鄉	2018-11-24T22:21:43+08:00	5052	1317	6369	431	6800	11475	59.26%	44.03%	14	16
8	苗栗縣三義鄉	2018-11-25T00:17:05+08:00	6123	1538	7661	471	8132	13889	58.55%	44.09%	16	16
8	苗栗縣三義鄉	2018-11-24T22:40:17+08:00	6123	1538	7661	471	8132	13889	58.55%	44.09%	16	16
8	苗栗縣三義鄉	2018-11-25T00:21:42+08:00	6123	1538	7661	471	8132	13889	58.55%	44.09%	16	16
8	苗栗縣三義鄉	2018-11-24T23:37:46+08:00	6123	1538	7661	471	8132	13889	58.55%	44.09%	16	16
8	苗栗縣三義鄉	2018-11-24T22:35:42+08:00	5579	1420	6999	449	7448	12691	58.69%	43.96%	15	16
8	苗栗縣三義鄉	2018-11-24T23:58:40+08:00	6123	1538	7661	471	8132	13889	58.55%	44.09%	16	16
8	苗栗縣三義鄉	2018-11-24T23:26:05+08:00	6123	1538	7661	471	8132	13889	58.55%	44.09%	16	16
8	苗栗縣三義鄉	2018-11-24T23:18:25+08:00	6123	1538	7661	471	8132	13889	58.55%	44.09%	16	16
8	苗栗縣三義鄉	2018-11-24T23:33:48+08:00	6123	1538	7661	471	8132	13889	58.55%	44.09%	16	16
8	苗栗縣三義鄉	2018-11-25T03:54:38+08:00	6123	1538	7661	471	8132	13889	58.55%	44.09%	16	16
8	苗栗縣三義鄉	2018-11-24T23:10:54+08:00	6123	1538	7661	471	8132	13889	58.55%	44.09%	16	16
8	苗栗縣三義鄉	2018-11-24T23:14:37+08:00	6123	1538	7661	471	8132	13889	58.55%	44.09%	16	16
8	苗栗縣三義鄉	2018-11-25T06:17:33+08:00	6123	1538	7661	471	8132	13889	58.55%	44.09%	16	16
8	苗栗縣三義鄉	2018-11-24T22:43:47+08:00	6123	1538	7661	471	8132	13889	58.55%	44.09%	16	16
8	苗栗縣三義鄉	2018-11-24T22:56:34+08:00	6123	1538	7661	471	8132	13889	58.55%	44.09%	16	16
8	苗栗縣三義鄉	2018-11-25T00:08:02+08:00	6123	1538	7661	471	8132	13889	58.55%	44.09%	16	16
8	苗栗縣三義鄉	2018-11-24T22:53:12+08:00	6123	1538	7661	471	8132	13889	58.55%	44.09%	16	16
8	苗栗縣三義鄉	2018-11-25T06:22:43+08:00	6123	1538	7661	471	8132	13889	58.55%	44.09%	16	16
8	苗栗縣三義鄉	2018-11-24T23:29:44+08:00	6123	1538	7661	471	8132	13889	58.55%	44.09%	16	16
8	苗栗縣三義鄉	2018-11-25T01:11:04+08:00	6123	1538	7661	471	8132	13889	58.55%	44.09%	16	16
8	苗栗縣三義鄉	2018-11-25T06:07:20+08:00	6123	1538	7661	471	8132	13889	58.55%	44.09%	16	16
8	苗栗縣三義鄉	2018-11-24T23:00:15+08:00	6123	1538	7661	471	8132	13889	58.55%	44.09%	16	16
8	苗栗縣三義鄉	2018-11-25T00:12:43+08:00	6123	1538	7661	471	8132	13889	58.55%	44.09%	16	16
8	苗栗縣三義鄉	2018-11-24T22:28:38+08:00	5579	1420	6999	449	7448	12691	58.69%	43.96%	15	16
8	苗栗縣三義鄉	2018-11-25T01:05:56+08:00	6123	1538	7661	471	8132	13889	58.55%	44.09%	16	16
8	苗栗縣三義鄉	2018-11-25T06:27:53+08:00	6123	1538	7661	471	8132	13889	58.55%	44.09%	16	16
8	苗栗縣三義鄉	2018-11-25T00:03:31+08:00	6123	1538	7661	471	8132	13889	58.55%	44.09%	16	16
8	苗栗縣三義鄉	2018-11-24T23:54:25+08:00	6123	1538	7661	471	8132	13889	58.55%	44.09%	16	16
8	苗栗縣三義鄉	2018-11-24T22:14:46+08:00	4678	1218	5896	382	6278	10622	59.1%	44.04%	13	16
8	苗栗縣三義鄉	2018-11-25T00:56:11+08:00	6123	1538	7661	471	8132	13889	58.55%	44.09%	16	16
8	苗栗縣三義鄉	2018-11-24T22:18:17+08:00	4678	1218	5896	382	6278	10622	59.1%	44.04%	13	16
8	苗栗縣三義鄉	2018-11-25T01:16:19+08:00	6123	1538	7661	471	8132	13889	58.55%	44.09%	16	16
8	苗栗縣三義鄉	2018-11-24T23:50:12+08:00	6123	1538	7661	471	8132	13889	58.55%	44.09%	16	16
8	苗栗縣通霄鎮	2018-11-24T23:07:16+08:00	9512	3585	13097	1380	14477	27281	53.07%	34.87%	32	34
8	苗栗縣通霄鎮	2018-11-24T22:12:00+08:00	8483	3213	11696	1236	12932	24253	53.32%	34.98%	29	34
8	苗栗縣通霄鎮	2018-11-24T22:39:06+08:00	8483	3213	11696	1236	12932	24253	53.32%	34.98%	29	34
8	苗栗縣通霄鎮	2018-11-24T23:22:20+08:00	10444	3914	14358	1525	15883	29709	53.46%	35.15%	34	34
8	苗栗縣通霄鎮	2018-11-24T23:58:39+08:00	10444	3914	14358	1525	15883	29709	53.46%	35.15%	34	34
8	苗栗縣通霄鎮	2018-11-24T23:03:45+08:00	9512	3585	13097	1380	14477	27281	53.07%	34.87%	32	34
8	苗栗縣通霄鎮	2018-11-24T22:49:21+08:00	9146	3449	12595	1307	13902	26143	53.18%	34.98%	31	34
8	苗栗縣通霄鎮	2018-11-24T23:46:01+08:00	10444	3914	14358	1525	15883	29709	53.46%	35.15%	34	34
8	苗栗縣通霄鎮	2018-11-25T03:48:26+08:00	10444	3914	14358	1525	15883	29709	53.46%	35.15%	34	34
8	苗栗縣通霄鎮	2018-11-25T03:30:56+08:00	10444	3914	14358	1525	15883	29709	53.46%	35.15%	34	34
8	苗栗縣通霄鎮	2018-11-25T03:42:45+08:00	10444	3914	14358	1525	15883	29709	53.46%	35.15%	34	34
8	苗栗縣通霄鎮	2018-11-24T22:32:16+08:00	8483	3213	11696	1236	12932	24253	53.32%	34.98%	29	34
8	苗栗縣通霄鎮	2018-11-25T01:00:58+08:00	10444	3914	14358	1525	15883	29709	53.46%	35.15%	34	34
8	苗栗縣通霄鎮	2018-11-25T04:01:26+08:00	10444	3914	14358	1525	15883	29709	53.46%	35.15%	34	34
8	苗栗縣通霄鎮	2018-11-24T22:25:21+08:00	8483	3213	11696	1236	12932	24253	53.32%	34.98%	29	34
8	苗栗縣通霄鎮	2018-11-25T06:12:34+08:00	10444	3914	14358	1525	15883	29709	53.46%	35.15%	34	34
8	苗栗縣通霄鎮	2018-11-24T22:40:16+08:00	8483	3213	11696	1236	12932	24253	53.32%	34.98%	29	34
8	苗栗縣通霄鎮	2018-11-24T22:21:43+08:00	8483	3213	11696	1236	12932	24253	53.32%	34.98%	29	34
8	苗栗縣通霄鎮	2018-11-25T00:17:05+08:00	10444	3914	14358	1525	15883	29709	53.46%	35.15%	34	34
8	苗栗縣通霄鎮	2018-11-24T23:18:24+08:00	10444	3914	14358	1525	15883	29709	53.46%	35.15%	34	34
8	苗栗縣通霄鎮	2018-11-24T23:37:46+08:00	10444	3914	14358	1525	15883	29709	53.46%	35.15%	34	34
8	苗栗縣通霄鎮	2018-11-24T22:35:42+08:00	8483	3213	11696	1236	12932	24253	53.32%	34.98%	29	34
8	苗栗縣通霄鎮	2018-11-25T03:54:37+08:00	10444	3914	14358	1525	15883	29709	53.46%	35.15%	34	34
8	苗栗縣通霄鎮	2018-11-24T23:33:47+08:00	10444	3914	14358	1525	15883	29709	53.46%	35.15%	34	34
8	苗栗縣通霄鎮	2018-11-24T23:26:04+08:00	10444	3914	14358	1525	15883	29709	53.46%	35.15%	34	34
8	苗栗縣通霄鎮	2018-11-24T23:10:54+08:00	9512	3585	13097	1380	14477	27281	53.07%	34.87%	32	34
8	苗栗縣通霄鎮	2018-11-24T23:14:37+08:00	9939	3738	13677	1451	15128	28423	53.22%	34.97%	33	34
8	苗栗縣通霄鎮	2018-11-25T06:17:33+08:00	10444	3914	14358	1525	15883	29709	53.46%	35.15%	34	34
8	苗栗縣通霄鎮	2018-11-24T22:43:47+08:00	8779	3322	12101	1258	13359	25022	53.39%	35.09%	30	34
8	苗栗縣通霄鎮	2018-11-25T01:24:21+08:00	10444	3914	14358	1525	15883	29709	53.46%	35.15%	34	34
8	苗栗縣通霄鎮	2018-11-24T22:56:34+08:00	9512	3585	13097	1380	14477	27281	53.07%	34.87%	32	34
8	苗栗縣通霄鎮	2018-11-25T03:37:24+08:00	10444	3914	14358	1525	15883	29709	53.46%	35.15%	34	34
8	苗栗縣通霄鎮	2018-11-25T00:08:02+08:00	10444	3914	14358	1525	15883	29709	53.46%	35.15%	34	34
8	苗栗縣通霄鎮	2018-11-24T22:53:12+08:00	9512	3585	13097	1380	14477	27281	53.07%	34.87%	32	34
8	苗栗縣通霄鎮	2018-11-25T01:11:03+08:00	10444	3914	14358	1525	15883	29709	53.46%	35.15%	34	34
8	苗栗縣通霄鎮	2018-11-24T23:29:43+08:00	10444	3914	14358	1525	15883	29709	53.46%	35.15%	34	34
8	苗栗縣通霄鎮	2018-11-25T00:21:41+08:00	10444	3914	14358	1525	15883	29709	53.46%	35.15%	34	34
8	苗栗縣通霄鎮	2018-11-25T06:22:42+08:00	10444	3914	14358	1525	15883	29709	53.46%	35.15%	34	34
8	苗栗縣通霄鎮	2018-11-25T06:07:20+08:00	10444	3914	14358	1525	15883	29709	53.46%	35.15%	34	34
8	苗栗縣通霄鎮	2018-11-24T23:00:15+08:00	9512	3585	13097	1380	14477	27281	53.07%	34.87%	32	34
8	苗栗縣通霄鎮	2018-11-25T01:05:56+08:00	10444	3914	14358	1525	15883	29709	53.46%	35.15%	34	34
8	苗栗縣通霄鎮	2018-11-24T23:54:24+08:00	10444	3914	14358	1525	15883	29709	53.46%	35.15%	34	34
8	苗栗縣通霄鎮	2018-11-24T23:41:59+08:00	10444	3914	14358	1525	15883	29709	53.46%	35.15%	34	34
8	苗栗縣通霄鎮	2018-11-25T00:03:31+08:00	10444	3914	14358	1525	15883	29709	53.46%	35.15%	34	34
8	苗栗縣通霄鎮	2018-11-24T22:14:46+08:00	8483	3213	11696	1236	12932	24253	53.32%	34.98%	29	34
8	苗栗縣通霄鎮	2018-11-25T06:27:52+08:00	10444	3914	14358	1525	15883	29709	53.46%	35.15%	34	34
8	苗栗縣通霄鎮	2018-11-25T00:56:11+08:00	10444	3914	14358	1525	15883	29709	53.46%	35.15%	34	34
8	苗栗縣通霄鎮	2018-11-24T22:18:17+08:00	8483	3213	11696	1236	12932	24253	53.32%	34.98%	29	34
8	苗栗縣通霄鎮	2018-11-25T00:12:42+08:00	10444	3914	14358	1525	15883	29709	53.46%	35.15%	34	34
8	苗栗縣通霄鎮	2018-11-24T22:28:37+08:00	8483	3213	11696	1236	12932	24253	53.32%	34.98%	29	34
8	苗栗縣通霄鎮	2018-11-25T01:16:19+08:00	10444	3914	14358	1525	15883	29709	53.46%	35.15%	34	34
8	苗栗縣通霄鎮	2018-11-24T23:50:12+08:00	10444	3914	14358	1525	15883	29709	53.46%	35.15%	34	34
8	高雄市	2018-11-25T00:56:08+08:00	916412	299209	1215621	98462	1314083	2284386	57.52%	40.12%	784	1
8	高雄市	2018-11-24T23:03:43+08:00	688142	227143	915285	77437	992722	1732723	57.29%	39.71%	441	1
8	高雄市	2018-11-24T23:58:37+08:00	837430	274339	1111769	91284	1203053	2093370	57.47%	40%	670	1
8	高雄市	2018-11-25T06:17:31+08:00	944727	307838	1252565	100943	1353508	2353342	57.51%	40.14%	823	1
8	高雄市	2018-11-24T23:22:18+08:00	739802	243361	983163	82199	1065362	1858739	57.32%	39.8%	523	1
8	高雄市	2018-11-24T22:43:45+08:00	615962	204367	820329	70468	890797	1558652	57.15%	39.52%	325	1
8	高雄市	2018-11-24T23:14:35+08:00	708316	233679	941995	79421	1021416	1781502	57.33%	39.76%	475	1
8	高雄市	2018-11-25T03:37:20+08:00	943903	307655	1251558	100845	1352403	2351297	57.52%	40.14%	822	1
8	高雄市	2018-11-24T22:49:19+08:00	639250	211670	850920	72648	923568	1615267	57.18%	39.58%	363	1
8	高雄市	2018-11-25T00:03:28+08:00	845545	276915	1122460	92036	1214496	2113128	57.47%	40.01%	683	1
8	高雄市	2018-11-25T03:42:43+08:00	943903	307655	1251558	100845	1352403	2351297	57.52%	40.14%	822	1
8	高雄市	2018-11-25T01:00:56+08:00	918440	299809	1218249	98624	1316873	2289722	57.51%	40.11%	787	1
8	高雄市	2018-11-24T22:25:19+08:00	550702	183304	734006	63936	797942	1397507	57.1%	39.41%	213	1
8	高雄市	2018-11-25T00:17:03+08:00	868691	284006	1152697	94174	1246871	2168596	57.5%	40.06%	717	1
8	高雄市	2018-11-25T01:11:01+08:00	923524	301197	1224721	99008	1323729	2301497	57.52%	40.13%	793	1
8	高雄市	2018-11-25T06:22:41+08:00	944727	307838	1252565	100943	1353508	2353342	57.51%	40.14%	823	1
8	高雄市	2018-11-25T06:12:32+08:00	944727	307838	1252565	100943	1353508	2353342	57.51%	40.14%	823	1
8	高雄市	2018-11-24T23:50:10+08:00	817579	268178	1085757	89589	1175346	2046399	57.43%	39.95%	641	1
8	高雄市	2018-11-24T22:18:15+08:00	506522	169195	675717	59442	735159	1289218	57.02%	39.29%	137	1
8	高雄市	2018-11-25T00:12:40+08:00	864310	282583	1146893	93777	1240670	2158266	57.48%	40.05%	711	1
8	高雄市	2018-11-24T22:28:35+08:00	560007	186534	746541	64895	811436	1420927	57.11%	39.41%	230	1
8	高雄市	2018-11-24T23:54:20+08:00	826165	270947	1097112	90293	1187405	2066849	57.45%	39.97%	653	1
8	高雄市	2018-11-24T22:14:44+08:00	493553	165015	658568	58131	716699	1256056	57.06%	39.29%	116	1
8	高雄市	2018-11-25T06:27:50+08:00	944727	307838	1252565	100943	1353508	2353342	57.51%	40.14%	823	1
8	高雄市	2018-11-25T00:07:59+08:00	850817	278593	1129410	92442	1221852	2125935	57.47%	40.02%	691	1
8	高雄市	2018-11-24T23:18:22+08:00	719751	237302	957053	80641	1037694	1810225	57.32%	39.76%	493	1
8	高雄市	2018-11-24T23:26:03+08:00	747261	245891	993152	82973	1076125	1877212	57.33%	39.81%	534	1
8	高雄市	2018-11-25T01:05:53+08:00	920888	300575	1221463	98757	1320220	2295425	57.52%	40.12%	790	1
8	高雄市	2018-11-24T22:56:32+08:00	656180	216787	872967	74381	947348	1655849	57.21%	39.63%	390	1
8	高雄市	2018-11-25T01:24:19+08:00	928132	302641	1230773	99429	1330202	2312583	57.52%	40.13%	799	1
8	高雄市	2018-11-24T22:39:04+08:00	596964	198424	795388	68594	863982	1512997	57.1%	39.46%	293	1
8	高雄市	2018-11-24T23:10:52+08:00	699963	231088	931051	78723	1009774	1761834	57.31%	39.73%	462	1
8	高雄市	2018-11-24T23:07:14+08:00	694749	229237	923986	78153	1002139	1748430	57.32%	39.74%	452	1
8	高雄市	2018-11-25T00:21:39+08:00	872933	285554	1158487	94766	1253253	2179665	57.5%	40.05%	724	1
8	高雄市	2018-11-24T22:32:14+08:00	569699	189201	758900	65718	824618	1443964	57.11%	39.45%	246	1
8	高雄市	2018-11-25T03:30:53+08:00	943903	307655	1251558	100845	1352403	2351297	57.52%	40.14%	822	1
8	高雄市	2018-11-25T03:48:24+08:00	944727	307838	1252565	100943	1353508	2353342	57.51%	40.14%	823	1
8	高雄市	2018-11-24T23:29:42+08:00	753755	247921	1001676	83631	1085307	1893266	57.32%	39.81%	544	1
8	高雄市	2018-11-24T23:00:13+08:00	664575	219659	884234	75131	959365	1675772	57.25%	39.66%	403	1
8	高雄市	2018-11-24T22:21:41+08:00	538011	179367	717378	62660	780038	1366874	57.07%	39.36%	191	1
8	高雄市	2018-11-24T22:53:09+08:00	647856	214194	862050	73616	935666	1635995	57.19%	39.6%	377	1
8	高雄市	2018-11-24T22:40:14+08:00	606183	201436	807619	69519	877138	1535290	57.13%	39.48%	309	1
8	高雄市	2018-11-25T06:07:18+08:00	944727	307838	1252565	100943	1353508	2353342	57.51%	40.14%	823	1
8	高雄市	2018-11-24T22:11:58+08:00	480718	160924	641642	56763	698405	1224348	57.04%	39.26%	094	1
8	高雄市	2018-11-25T04:01:24+08:00	944727	307838	1252565	100943	1353508	2353342	57.51%	40.14%	823	1
8	高雄市	2018-11-24T23:41:57+08:00	797129	261504	1058633	87485	1146118	1996727	57.4%	39.92%	609	1
8	高雄市	2018-11-24T22:35:40+08:00	580726	192821	773547	66820	840367	1472265	57.08%	39.44%	266	1
8	高雄市	2018-11-25T03:54:35+08:00	944727	307838	1252565	100943	1353508	2353342	57.51%	40.14%	823	1
8	高雄市	2018-11-24T23:33:45+08:00	773837	254181	1028018	85261	1113279	1941069	57.35%	39.87%	574	1
8	高雄市	2018-11-24T23:37:44+08:00	782361	256695	1039056	86051	1125107	1961557	57.36%	39.88%	588	1
8	高雄市	2018-11-24T23:45:59+08:00	811594	266255	1077849	88848	1166697	2031385	57.43%	39.95%	631	1
8	高雄市	2018-11-25T01:16:17+08:00	925997	301982	1227979	99211	1327190	2307433	57.52%	40.13%	796	1
8	高雄市旗津區	2018-11-24T22:49:20+08:00	7343	2648	9991	1224	11215	22815	49.16%	32.18%	17	18
8	高雄市旗津區	2018-11-25T03:37:21+08:00	7980	2930	10910	1363	12273	24860	49.37%	32.1%	18	18
8	高雄市旗津區	2018-11-24T23:03:43+08:00	7343	2648	9991	1224	11215	22815	49.16%	32.18%	17	18
8	高雄市旗津區	2018-11-24T23:58:37+08:00	7980	2930	10910	1363	12273	24860	49.37%	32.1%	18	18
8	高雄市旗津區	2018-11-25T06:17:31+08:00	7980	2930	10910	1363	12273	24860	49.37%	32.1%	18	18
8	高雄市旗津區	2018-11-24T23:22:18+08:00	7343	2648	9991	1224	11215	22815	49.16%	32.18%	17	18
8	高雄市旗津區	2018-11-25T00:03:29+08:00	7980	2930	10910	1363	12273	24860	49.37%	32.1%	18	18
8	高雄市旗津區	2018-11-24T23:14:35+08:00	7343	2648	9991	1224	11215	22815	49.16%	32.18%	17	18
8	高雄市旗津區	2018-11-25T00:56:09+08:00	7980	2930	10910	1363	12273	24860	49.37%	32.1%	18	18
8	高雄市旗津區	2018-11-25T03:42:43+08:00	7980	2930	10910	1363	12273	24860	49.37%	32.1%	18	18
8	高雄市旗津區	2018-11-24T22:53:10+08:00	7343	2648	9991	1224	11215	22815	49.16%	32.18%	17	18
8	高雄市旗津區	2018-11-25T00:08:00+08:00	7980	2930	10910	1363	12273	24860	49.37%	32.1%	18	18
8	高雄市旗津區	2018-11-25T01:00:56+08:00	7980	2930	10910	1363	12273	24860	49.37%	32.1%	18	18
8	高雄市旗津區	2018-11-24T22:25:19+08:00	7343	2648	9991	1224	11215	22815	49.16%	32.18%	17	18
8	高雄市旗津區	2018-11-25T06:12:33+08:00	7980	2930	10910	1363	12273	24860	49.37%	32.1%	18	18
8	高雄市旗津區	2018-11-25T00:17:03+08:00	7980	2930	10910	1363	12273	24860	49.37%	32.1%	18	18
8	高雄市旗津區	2018-11-25T06:22:41+08:00	7980	2930	10910	1363	12273	24860	49.37%	32.1%	18	18
8	高雄市旗津區	2018-11-24T23:18:23+08:00	7343	2648	9991	1224	11215	22815	49.16%	32.18%	17	18
8	高雄市旗津區	2018-11-24T23:50:10+08:00	7980	2930	10910	1363	12273	24860	49.37%	32.1%	18	18
8	高雄市旗津區	2018-11-24T22:18:15+08:00	7343	2648	9991	1224	11215	22815	49.16%	32.18%	17	18
8	高雄市旗津區	2018-11-24T22:14:44+08:00	7343	2648	9991	1224	11215	22815	49.16%	32.18%	17	18
8	高雄市旗津區	2018-11-25T01:05:54+08:00	7980	2930	10910	1363	12273	24860	49.37%	32.1%	18	18
8	高雄市旗津區	2018-11-24T23:54:21+08:00	7980	2930	10910	1363	12273	24860	49.37%	32.1%	18	18
8	高雄市旗津區	2018-11-24T23:33:46+08:00	7343	2648	9991	1224	11215	22815	49.16%	32.18%	17	18
8	高雄市旗津區	2018-11-25T06:27:51+08:00	7980	2930	10910	1363	12273	24860	49.37%	32.1%	18	18
8	高雄市旗津區	2018-11-24T23:26:03+08:00	7343	2648	9991	1224	11215	22815	49.16%	32.18%	17	18
8	高雄市旗津區	2018-11-25T03:54:36+08:00	7980	2930	10910	1363	12273	24860	49.37%	32.1%	18	18
8	高雄市旗津區	2018-11-25T00:12:41+08:00	7980	2930	10910	1363	12273	24860	49.37%	32.1%	18	18
8	高雄市旗津區	2018-11-24T22:56:32+08:00	7343	2648	9991	1224	11215	22815	49.16%	32.18%	17	18
8	高雄市旗津區	2018-11-24T22:43:46+08:00	7343	2648	9991	1224	11215	22815	49.16%	32.18%	17	18
8	高雄市旗津區	2018-11-25T01:24:19+08:00	7980	2930	10910	1363	12273	24860	49.37%	32.1%	18	18
8	高雄市旗津區	2018-11-24T22:39:04+08:00	7343	2648	9991	1224	11215	22815	49.16%	32.18%	17	18
8	高雄市旗津區	2018-11-24T23:10:52+08:00	7343	2648	9991	1224	11215	22815	49.16%	32.18%	17	18
8	高雄市旗津區	2018-11-24T23:07:14+08:00	7343	2648	9991	1224	11215	22815	49.16%	32.18%	17	18
8	高雄市旗津區	2018-11-24T22:32:14+08:00	7343	2648	9991	1224	11215	22815	49.16%	32.18%	17	18
8	高雄市旗津區	2018-11-25T03:30:54+08:00	7980	2930	10910	1363	12273	24860	49.37%	32.1%	18	18
8	高雄市旗津區	2018-11-25T03:48:24+08:00	7980	2930	10910	1363	12273	24860	49.37%	32.1%	18	18
8	高雄市旗津區	2018-11-24T22:40:15+08:00	7343	2648	9991	1224	11215	22815	49.16%	32.18%	17	18
8	高雄市旗津區	2018-11-25T00:21:40+08:00	7980	2930	10910	1363	12273	24860	49.37%	32.1%	18	18
8	高雄市旗津區	2018-11-24T23:29:42+08:00	7343	2648	9991	1224	11215	22815	49.16%	32.18%	17	18
8	高雄市旗津區	2018-11-25T01:11:02+08:00	7980	2930	10910	1363	12273	24860	49.37%	32.1%	18	18
8	高雄市旗津區	2018-11-24T23:00:13+08:00	7343	2648	9991	1224	11215	22815	49.16%	32.18%	17	18
8	高雄市旗津區	2018-11-24T22:21:41+08:00	7343	2648	9991	1224	11215	22815	49.16%	32.18%	17	18
8	高雄市旗津區	2018-11-25T06:07:18+08:00	7980	2930	10910	1363	12273	24860	49.37%	32.1%	18	18
8	高雄市旗津區	2018-11-24T22:11:58+08:00	7343	2648	9991	1224	11215	22815	49.16%	32.18%	17	18
8	高雄市旗津區	2018-11-25T04:01:24+08:00	7980	2930	10910	1363	12273	24860	49.37%	32.1%	18	18
8	高雄市旗津區	2018-11-24T22:28:36+08:00	7343	2648	9991	1224	11215	22815	49.16%	32.18%	17	18
8	高雄市旗津區	2018-11-24T23:41:57+08:00	7980	2930	10910	1363	12273	24860	49.37%	32.1%	18	18
8	高雄市旗津區	2018-11-24T22:35:41+08:00	7343	2648	9991	1224	11215	22815	49.16%	32.18%	17	18
8	高雄市旗津區	2018-11-24T23:37:45+08:00	7343	2648	9991	1224	11215	22815	49.16%	32.18%	17	18
8	高雄市旗津區	2018-11-24T23:45:59+08:00	7980	2930	10910	1363	12273	24860	49.37%	32.1%	18	18
8	高雄市旗津區	2018-11-25T01:16:17+08:00	7980	2930	10910	1363	12273	24860	49.37%	32.1%	18	18
8	澎湖縣	2018-11-24T23:26:10+08:00	22759	6441	29200	3110	32310	74618	43.3%	30.5%	104	116
8	澎湖縣	2018-11-24T22:49:27+08:00	19299	5280	24579	2580	27159	63601	42.7%	30.34%	95	116
8	澎湖縣	2018-11-24T23:10:58+08:00	20040	5508	25548	2721	28269	65840	42.94%	30.44%	97	116
8	澎湖縣	2018-11-24T23:33:53+08:00	24278	6830	31108	3252	34360	79372	43.29%	30.59%	108	116
8	澎湖縣	2018-11-24T22:56:39+08:00	19299	5280	24579	2580	27159	63601	42.7%	30.34%	95	116
8	澎湖縣	2018-11-24T23:22:26+08:00	22496	6240	28736	3083	31819	73617	43.22%	30.56%	103	116
8	澎湖縣	2018-11-24T22:28:43+08:00	17105	4741	21846	2354	24200	56785	42.62%	30.12%	89	116
8	澎湖縣	2018-11-24T23:18:30+08:00	22235	6127	28362	2970	31332	72188	43.4%	30.8%	102	116
8	澎湖縣	2018-11-25T00:17:11+08:00	27738	7783	35521	3552	39073	89057	43.87%	31.15%	115	116
8	澎湖縣	2018-11-24T22:32:21+08:00	17444	4825	22269	2371	24640	57958	42.51%	30.1%	90	116
8	澎湖縣	2018-11-24T23:46:06+08:00	24278	6830	31108	3252	34360	79372	43.29%	30.59%	108	116
8	澎湖縣	2018-11-24T22:53:18+08:00	19299	5280	24579	2580	27159	63601	42.7%	30.34%	95	116
8	澎湖縣	2018-11-25T00:08:08+08:00	26131	7307	33438	3409	36847	84247	43.74%	31.02%	112	116
8	澎湖縣	2018-11-25T04:01:32+08:00	28232	7910	36142	3599	39741	90405	43.96%	31.23%	116	116
8	澎湖縣	2018-11-25T03:48:34+08:00	28232	7910	36142	3599	39741	90405	43.96%	31.23%	116	116
8	澎湖縣	2018-11-24T23:00:19+08:00	19299	5280	24579	2580	27159	63601	42.7%	30.34%	95	116
8	澎湖縣	2018-11-24T22:25:28+08:00	16583	4564	21147	2267	23414	55006	42.57%	30.15%	86	116
8	澎湖縣	2018-11-25T06:22:47+08:00	28232	7910	36142	3599	39741	90405	43.96%	31.23%	116	116
8	澎湖縣	2018-11-24T22:40:21+08:00	19299	5280	24579	2580	27159	63601	42.7%	30.34%	95	116
8	澎湖縣	2018-11-24T23:29:49+08:00	23621	6656	30277	3175	33452	77396	43.22%	30.52%	106	116
8	澎湖縣	2018-11-24T23:14:44+08:00	20630	5670	26300	2763	29063	67478	43.07%	30.57%	98	116
8	澎湖縣	2018-11-24T23:50:17+08:00	24278	6830	31108	3252	34360	79372	43.29%	30.59%	108	116
8	澎湖縣	2018-11-25T00:12:47+08:00	27273	7673	34946	3496	38442	87773	43.8%	31.07%	114	116
8	澎湖縣	2018-11-25T03:37:33+08:00	28232	7910	36142	3599	39741	90405	43.96%	31.23%	116	116
8	澎湖縣	2018-11-25T01:16:25+08:00	28232	7910	36142	3599	39741	90405	43.96%	31.23%	116	116
8	澎湖縣	2018-11-24T23:58:46+08:00	24836	6972	31808	3299	35107	80812	43.44%	30.73%	109	116
8	澎湖縣	2018-11-24T22:18:22+08:00	15127	4144	19271	2053	21324	50744	42.02%	29.81%	82	116
8	澎湖縣	2018-11-24T23:03:50+08:00	20040	5508	25548	2721	28269	65840	42.94%	30.44%	97	116
8	澎湖縣	2018-11-24T22:39:12+08:00	18702	5128	23830	2525	26355	62047	42.48%	30.14%	94	116
8	澎湖縣	2018-11-25T06:27:58+08:00	28232	7910	36142	3599	39741	90405	43.96%	31.23%	116	116
8	澎湖縣	2018-11-25T06:17:40+08:00	28232	7910	36142	3599	39741	90405	43.96%	31.23%	116	116
8	澎湖縣	2018-11-25T03:54:44+08:00	28232	7910	36142	3599	39741	90405	43.96%	31.23%	116	116
8	澎湖縣	2018-11-24T22:14:52+08:00	14447	4014	18461	2008	20469	49263	41.55%	29.33%	81	116
8	澎湖縣	2018-11-25T01:24:28+08:00	28232	7910	36142	3599	39741	90405	43.96%	31.23%	116	116
8	澎湖縣	2018-11-24T23:37:51+08:00	24278	6830	31108	3252	34360	79372	43.29%	30.59%	108	116
8	澎湖縣	2018-11-24T23:07:22+08:00	20040	5508	25548	2721	28269	65840	42.94%	30.44%	97	116
8	澎湖縣	2018-11-24T22:12:05+08:00	14014	3933	17947	1965	19912	48143	41.36%	29.11%	80	116
8	澎湖縣	2018-11-24T23:54:30+08:00	24278	6830	31108	3252	34360	79372	43.29%	30.59%	108	116
8	澎湖縣	2018-11-25T06:12:40+08:00	28232	7910	36142	3599	39741	90405	43.96%	31.23%	116	116
8	澎湖縣	2018-11-24T23:42:04+08:00	24278	6830	31108	3252	34360	79372	43.29%	30.59%	108	116
8	澎湖縣	2018-11-25T01:06:03+08:00	28232	7910	36142	3599	39741	90405	43.96%	31.23%	116	116
8	澎湖縣	2018-11-25T01:11:11+08:00	28232	7910	36142	3599	39741	90405	43.96%	31.23%	116	116
8	澎湖縣	2018-11-25T00:21:47+08:00	27738	7783	35521	3552	39073	89057	43.87%	31.15%	115	116
8	澎湖縣	2018-11-25T03:42:52+08:00	28232	7910	36142	3599	39741	90405	43.96%	31.23%	116	116
8	澎湖縣	2018-11-25T06:07:26+08:00	28232	7910	36142	3599	39741	90405	43.96%	31.23%	116	116
8	澎湖縣	2018-11-24T22:21:49+08:00	15992	4372	20364	2156	22520	53148	42.37%	30.09%	84	116
8	澎湖縣	2018-11-24T22:43:53+08:00	19299	5280	24579	2580	27159	63601	42.7%	30.34%	95	116
8	澎湖縣	2018-11-24T22:35:47+08:00	18045	4958	23003	2438	25441	59682	42.63%	30.24%	92	116
8	澎湖縣	2018-11-25T01:01:05+08:00	28232	7910	36142	3599	39741	90405	43.96%	31.23%	116	116
8	澎湖縣	2018-11-25T00:56:16+08:00	28232	7910	36142	3599	39741	90405	43.96%	31.23%	116	116
8	澎湖縣	2018-11-25T03:31:02+08:00	28232	7910	36142	3599	39741	90405	43.96%	31.23%	116	116
8	澎湖縣	2018-11-25T00:03:39+08:00	26131	7307	33438	3409	36847	84247	43.74%	31.02%	112	116
8	南投縣竹山鎮	2018-11-25T01:24:23+08:00	18263	5289	23552	2222	25774	47034	54.8%	38.83%	53	53
8	南投縣竹山鎮	2018-11-24T22:39:07+08:00	15572	4542	20114	1870	21984	40415	54.4%	38.53%	47	53
8	南投縣竹山鎮	2018-11-24T23:07:17+08:00	17431	5062	22493	2103	24596	45005	54.65%	38.73%	51	53
8	南投縣竹山鎮	2018-11-24T22:12:01+08:00	13846	4089	17935	1639	19574	35763	54.73%	38.72%	43	53
8	南投縣竹山鎮	2018-11-25T03:37:27+08:00	18263	5289	23552	2222	25774	47034	54.8%	38.83%	53	53
8	南投縣竹山鎮	2018-11-24T22:32:17+08:00	15572	4542	20114	1870	21984	40415	54.4%	38.53%	47	53
8	南投縣竹山鎮	2018-11-25T03:30:57+08:00	18263	5289	23552	2222	25774	47034	54.8%	38.83%	53	53
8	南投縣竹山鎮	2018-11-25T03:48:28+08:00	18263	5289	23552	2222	25774	47034	54.8%	38.83%	53	53
8	南投縣竹山鎮	2018-11-24T23:42:01+08:00	18263	5289	23552	2222	25774	47034	54.8%	38.83%	53	53
8	南投縣竹山鎮	2018-11-25T04:01:28+08:00	18263	5289	23552	2222	25774	47034	54.8%	38.83%	53	53
8	南投縣竹山鎮	2018-11-25T00:21:43+08:00	18263	5289	23552	2222	25774	47034	54.8%	38.83%	53	53
8	南投縣竹山鎮	2018-11-24T22:21:44+08:00	15152	4425	19577	1794	21371	39193	54.53%	38.66%	46	53
8	南投縣竹山鎮	2018-11-24T23:00:16+08:00	15852	4628	20480	1924	22404	41236	54.33%	38.44%	48	53
8	南投縣竹山鎮	2018-11-24T22:40:17+08:00	15852	4628	20480	1924	22404	41236	54.33%	38.44%	48	53
8	南投縣竹山鎮	2018-11-25T06:12:35+08:00	18263	5289	23552	2222	25774	47034	54.8%	38.83%	53	53
8	南投縣竹山鎮	2018-11-25T00:03:32+08:00	18263	5289	23552	2222	25774	47034	54.8%	38.83%	53	53
8	南投縣竹山鎮	2018-11-25T03:54:39+08:00	18263	5289	23552	2222	25774	47034	54.8%	38.83%	53	53
8	南投縣竹山鎮	2018-11-25T01:01:00+08:00	18263	5289	23552	2222	25774	47034	54.8%	38.83%	53	53
8	南投縣竹山鎮	2018-11-24T23:33:49+08:00	18263	5289	23552	2222	25774	47034	54.8%	38.83%	53	53
8	南投縣竹山鎮	2018-11-24T23:26:05+08:00	18263	5289	23552	2222	25774	47034	54.8%	38.83%	53	53
8	南投縣竹山鎮	2018-11-24T23:37:47+08:00	18263	5289	23552	2222	25774	47034	54.8%	38.83%	53	53
8	南投縣竹山鎮	2018-11-24T22:35:43+08:00	15572	4542	20114	1870	21984	40415	54.4%	38.53%	47	53
8	南投縣竹山鎮	2018-11-24T23:54:26+08:00	18263	5289	23552	2222	25774	47034	54.8%	38.83%	53	53
8	南投縣竹山鎮	2018-11-24T23:58:41+08:00	18263	5289	23552	2222	25774	47034	54.8%	38.83%	53	53
8	南投縣竹山鎮	2018-11-25T00:56:12+08:00	18263	5289	23552	2222	25774	47034	54.8%	38.83%	53	53
8	南投縣竹山鎮	2018-11-24T22:56:35+08:00	15852	4628	20480	1924	22404	41236	54.33%	38.44%	48	53
8	南投縣竹山鎮	2018-11-24T23:14:39+08:00	17749	5151	22900	2170	25070	45864	54.66%	38.7%	52	53
8	南投縣竹山鎮	2018-11-24T23:22:22+08:00	18263	5289	23552	2222	25774	47034	54.8%	38.83%	53	53
8	南投縣竹山鎮	2018-11-25T06:17:34+08:00	18263	5289	23552	2222	25774	47034	54.8%	38.83%	53	53
8	南投縣竹山鎮	2018-11-24T22:43:49+08:00	15852	4628	20480	1924	22404	41236	54.33%	38.44%	48	53
8	南投縣竹山鎮	2018-11-24T23:03:46+08:00	16408	4795	21203	1972	23175	42522	54.5%	38.59%	49	53
8	南投縣竹山鎮	2018-11-24T23:10:55+08:00	17749	5151	22900	2170	25070	45864	54.66%	38.7%	52	53
8	南投縣竹山鎮	2018-11-24T22:49:22+08:00	15852	4628	20480	1924	22404	41236	54.33%	38.44%	48	53
8	南投縣竹山鎮	2018-11-25T00:08:03+08:00	18263	5289	23552	2222	25774	47034	54.8%	38.83%	53	53
8	南投縣竹山鎮	2018-11-24T22:53:13+08:00	15852	4628	20480	1924	22404	41236	54.33%	38.44%	48	53
8	南投縣竹山鎮	2018-11-24T23:46:02+08:00	18263	5289	23552	2222	25774	47034	54.8%	38.83%	53	53
8	南投縣竹山鎮	2018-11-25T03:42:46+08:00	18263	5289	23552	2222	25774	47034	54.8%	38.83%	53	53
8	南投縣竹山鎮	2018-11-25T01:11:05+08:00	18263	5289	23552	2222	25774	47034	54.8%	38.83%	53	53
8	南投縣竹山鎮	2018-11-24T23:29:45+08:00	18263	5289	23552	2222	25774	47034	54.8%	38.83%	53	53
8	南投縣竹山鎮	2018-11-25T06:07:21+08:00	18263	5289	23552	2222	25774	47034	54.8%	38.83%	53	53
8	南投縣竹山鎮	2018-11-25T06:22:43+08:00	18263	5289	23552	2222	25774	47034	54.8%	38.83%	53	53
8	南投縣竹山鎮	2018-11-25T00:17:06+08:00	18263	5289	23552	2222	25774	47034	54.8%	38.83%	53	53
8	南投縣竹山鎮	2018-11-24T22:25:23+08:00	15152	4425	19577	1794	21371	39193	54.53%	38.66%	46	53
8	南投縣竹山鎮	2018-11-25T00:12:43+08:00	18263	5289	23552	2222	25774	47034	54.8%	38.83%	53	53
8	南投縣竹山鎮	2018-11-24T22:14:47+08:00	14848	4329	19177	1766	20943	38285	54.7%	38.78%	45	53
8	南投縣竹山鎮	2018-11-24T22:18:18+08:00	14848	4329	19177	1766	20943	38285	54.7%	38.78%	45	53
8	南投縣竹山鎮	2018-11-25T06:27:54+08:00	18263	5289	23552	2222	25774	47034	54.8%	38.83%	53	53
8	南投縣竹山鎮	2018-11-24T23:50:13+08:00	18263	5289	23552	2222	25774	47034	54.8%	38.83%	53	53
8	南投縣竹山鎮	2018-11-25T01:16:20+08:00	18263	5289	23552	2222	25774	47034	54.8%	38.83%	53	53
8	南投縣竹山鎮	2018-11-25T01:05:57+08:00	18263	5289	23552	2222	25774	47034	54.8%	38.83%	53	53
8	南投縣竹山鎮	2018-11-24T22:28:39+08:00	15152	4425	19577	1794	21371	39193	54.53%	38.66%	46	53
8	南投縣竹山鎮	2018-11-24T23:18:26+08:00	17749	5151	22900	2170	25070	45864	54.66%	38.7%	52	53
8	屏東縣高樹鄉	2018-11-24T23:07:19+08:00	5714	2242	7956	1153	9109	19322	47.14%	29.57%	20	22
8	屏東縣高樹鄉	2018-11-24T23:10:56+08:00	5714	2242	7956	1153	9109	19322	47.14%	29.57%	20	22
8	屏東縣高樹鄉	2018-11-24T22:39:09+08:00	5714	2242	7956	1153	9109	19322	47.14%	29.57%	20	22
8	屏東縣高樹鄉	2018-11-25T06:17:37+08:00	6482	2513	8995	1308	10303	21697	47.49%	29.88%	22	22
8	屏東縣高樹鄉	2018-11-25T01:24:25+08:00	6482	2513	8995	1308	10303	21697	47.49%	29.88%	22	22
8	屏東縣高樹鄉	2018-11-24T22:56:37+08:00	5714	2242	7956	1153	9109	19322	47.14%	29.57%	20	22
8	屏東縣高樹鄉	2018-11-25T03:54:41+08:00	6482	2513	8995	1308	10303	21697	47.49%	29.88%	22	22
8	屏東縣高樹鄉	2018-11-24T22:32:19+08:00	5714	2242	7956	1153	9109	19322	47.14%	29.57%	20	22
8	屏東縣高樹鄉	2018-11-24T22:53:16+08:00	5714	2242	7956	1153	9109	19322	47.14%	29.57%	20	22
8	屏東縣高樹鄉	2018-11-25T01:06:00+08:00	6482	2513	8995	1308	10303	21697	47.49%	29.88%	22	22
8	屏東縣高樹鄉	2018-11-24T22:25:26+08:00	5714	2242	7956	1153	9109	19322	47.14%	29.57%	20	22
8	屏東縣高樹鄉	2018-11-24T23:00:17+08:00	5714	2242	7956	1153	9109	19322	47.14%	29.57%	20	22
8	屏東縣高樹鄉	2018-11-25T01:11:08+08:00	6482	2513	8995	1308	10303	21697	47.49%	29.88%	22	22
8	屏東縣高樹鄉	2018-11-25T06:07:23+08:00	6482	2513	8995	1308	10303	21697	47.49%	29.88%	22	22
8	屏東縣高樹鄉	2018-11-24T22:40:19+08:00	5714	2242	7956	1153	9109	19322	47.14%	29.57%	20	22
8	屏東縣高樹鄉	2018-11-24T23:29:47+08:00	6108	2381	8489	1225	9714	20438	47.53%	29.89%	21	22
8	屏東縣高樹鄉	2018-11-25T00:21:45+08:00	6482	2513	8995	1308	10303	21697	47.49%	29.88%	22	22
8	屏東縣高樹鄉	2018-11-25T03:31:00+08:00	6482	2513	8995	1308	10303	21697	47.49%	29.88%	22	22
8	屏東縣高樹鄉	2018-11-25T01:16:23+08:00	6482	2513	8995	1308	10303	21697	47.49%	29.88%	22	22
8	屏東縣高樹鄉	2018-11-25T00:03:35+08:00	6482	2513	8995	1308	10303	21697	47.49%	29.88%	22	22
8	屏東縣高樹鄉	2018-11-25T00:56:14+08:00	6482	2513	8995	1308	10303	21697	47.49%	29.88%	22	22
8	屏東縣高樹鄉	2018-11-24T23:54:27+08:00	6482	2513	8995	1308	10303	21697	47.49%	29.88%	22	22
8	屏東縣高樹鄉	2018-11-24T22:35:45+08:00	5714	2242	7956	1153	9109	19322	47.14%	29.57%	20	22
8	屏東縣高樹鄉	2018-11-24T23:37:49+08:00	6482	2513	8995	1308	10303	21697	47.49%	29.88%	22	22
8	屏東縣高樹鄉	2018-11-24T22:43:51+08:00	5714	2242	7956	1153	9109	19322	47.14%	29.57%	20	22
8	屏東縣高樹鄉	2018-11-25T06:27:56+08:00	6482	2513	8995	1308	10303	21697	47.49%	29.88%	22	22
8	屏東縣高樹鄉	2018-11-24T23:22:24+08:00	6108	2381	8489	1225	9714	20438	47.53%	29.89%	21	22
8	屏東縣高樹鄉	2018-11-24T22:28:41+08:00	5714	2242	7956	1153	9109	19322	47.14%	29.57%	20	22
8	屏東縣高樹鄉	2018-11-24T22:49:24+08:00	5714	2242	7956	1153	9109	19322	47.14%	29.57%	20	22
8	屏東縣高樹鄉	2018-11-24T22:12:03+08:00	5411	2129	7540	1098	8638	18400	46.95%	29.41%	19	22
8	屏東縣高樹鄉	2018-11-24T23:33:51+08:00	6482	2513	8995	1308	10303	21697	47.49%	29.88%	22	22
8	屏東縣高樹鄉	2018-11-24T23:03:48+08:00	5714	2242	7956	1153	9109	19322	47.14%	29.57%	20	22
8	屏東縣高樹鄉	2018-11-25T04:01:30+08:00	6482	2513	8995	1308	10303	21697	47.49%	29.88%	22	22
8	屏東縣高樹鄉	2018-11-25T03:42:49+08:00	6482	2513	8995	1308	10303	21697	47.49%	29.88%	22	22
8	屏東縣高樹鄉	2018-11-24T23:42:02+08:00	6482	2513	8995	1308	10303	21697	47.49%	29.88%	22	22
8	屏東縣高樹鄉	2018-11-25T00:08:05+08:00	6482	2513	8995	1308	10303	21697	47.49%	29.88%	22	22
8	屏東縣高樹鄉	2018-11-24T23:46:04+08:00	6482	2513	8995	1308	10303	21697	47.49%	29.88%	22	22
8	屏東縣高樹鄉	2018-11-25T00:17:09+08:00	6482	2513	8995	1308	10303	21697	47.49%	29.88%	22	22
8	屏東縣高樹鄉	2018-11-25T06:12:37+08:00	6482	2513	8995	1308	10303	21697	47.49%	29.88%	22	22
8	屏東縣高樹鄉	2018-11-25T06:22:45+08:00	6482	2513	8995	1308	10303	21697	47.49%	29.88%	22	22
8	屏東縣高樹鄉	2018-11-24T22:21:47+08:00	5714	2242	7956	1153	9109	19322	47.14%	29.57%	20	22
8	屏東縣高樹鄉	2018-11-25T03:48:31+08:00	6482	2513	8995	1308	10303	21697	47.49%	29.88%	22	22
8	屏東縣高樹鄉	2018-11-24T22:14:49+08:00	5411	2129	7540	1098	8638	18400	46.95%	29.41%	19	22
8	屏東縣高樹鄉	2018-11-24T22:18:20+08:00	5714	2242	7956	1153	9109	19322	47.14%	29.57%	20	22
8	屏東縣高樹鄉	2018-11-25T03:37:30+08:00	6482	2513	8995	1308	10303	21697	47.49%	29.88%	22	22
8	屏東縣高樹鄉	2018-11-24T23:58:43+08:00	6482	2513	8995	1308	10303	21697	47.49%	29.88%	22	22
8	屏東縣高樹鄉	2018-11-24T23:26:07+08:00	6108	2381	8489	1225	9714	20438	47.53%	29.89%	21	22
8	屏東縣高樹鄉	2018-11-25T00:12:45+08:00	6482	2513	8995	1308	10303	21697	47.49%	29.88%	22	22
8	屏東縣高樹鄉	2018-11-25T01:01:02+08:00	6482	2513	8995	1308	10303	21697	47.49%	29.88%	22	22
8	屏東縣高樹鄉	2018-11-24T23:18:28+08:00	6108	2381	8489	1225	9714	20438	47.53%	29.89%	21	22
8	屏東縣高樹鄉	2018-11-24T23:14:41+08:00	6108	2381	8489	1225	9714	20438	47.53%	29.89%	21	22
8	屏東縣高樹鄉	2018-11-24T23:50:15+08:00	6482	2513	8995	1308	10303	21697	47.49%	29.88%	22	22
8	臺南市安南區	2018-11-25T00:56:08+08:00	54864	19800	74664	7489	82153	159654	51.46%	34.36%	90	90
8	臺南市安南區	2018-11-24T23:03:43+08:00	34614	12727	47341	4774	52115	101881	51.15%	33.97%	61	90
8	臺南市安南區	2018-11-24T23:58:37+08:00	50110	18072	68182	6777	74959	145866	51.39%	34.35%	83	90
8	臺南市安南區	2018-11-25T06:17:31+08:00	54864	19800	74664	7489	82153	159654	51.46%	34.36%	90	90
8	臺南市安南區	2018-11-24T23:22:18+08:00	38893	14168	53061	5302	58363	114073	51.16%	34.09%	67	90
8	臺南市安南區	2018-11-24T22:43:45+08:00	30193	10663	40856	4129	44985	87594	51.36%	34.47%	54	90
8	臺南市安南區	2018-11-24T23:14:35+08:00	36730	13439	50169	5030	55199	108108	51.06%	33.98%	64	90
8	臺南市安南區	2018-11-25T03:37:20+08:00	54864	19800	74664	7489	82153	159654	51.46%	34.36%	90	90
8	臺南市安南區	2018-11-24T22:49:19+08:00	31923	11763	43686	4419	48105	93972	51.19%	33.97%	57	90
8	臺南市安南區	2018-11-25T00:03:28+08:00	52128	18799	70927	7112	78039	151590	51.48%	34.39%	86	90
8	臺南市安南區	2018-11-25T03:42:42+08:00	54864	19800	74664	7489	82153	159654	51.46%	34.36%	90	90
8	臺南市安南區	2018-11-24T22:25:19+08:00	25294	8982	34276	3453	37729	73081	51.63%	34.61%	46	90
8	臺南市安南區	2018-11-25T00:17:03+08:00	52128	18799	70927	7112	78039	151590	51.48%	34.39%	86	90
8	臺南市安南區	2018-11-25T01:11:01+08:00	54864	19800	74664	7489	82153	159654	51.46%	34.36%	90	90
8	臺南市安南區	2018-11-25T06:22:41+08:00	54864	19800	74664	7489	82153	159654	51.46%	34.36%	90	90
8	臺南市安南區	2018-11-25T06:12:32+08:00	54864	19800	74664	7489	82153	159654	51.46%	34.36%	90	90
8	臺南市安南區	2018-11-24T23:50:10+08:00	48016	17366	65382	6572	71954	139793	51.47%	34.35%	80	90
8	臺南市安南區	2018-11-24T22:18:15+08:00	23526	8335	31861	3211	35072	67429	52.01%	34.89%	43	90
8	臺南市安南區	2018-11-25T00:12:40+08:00	52128	18799	70927	7112	78039	151590	51.48%	34.39%	86	90
8	臺南市安南區	2018-11-24T22:28:35+08:00	26624	9402	36026	3660	39686	77009	51.53%	34.57%	48	90
8	臺南市安南區	2018-11-24T23:26:02+08:00	40226	14623	54849	5513	60362	117522	51.36%	34.23%	69	90
8	臺南市安南區	2018-11-24T23:54:20+08:00	48696	17613	66309	6651	72960	141566	51.54%	34.4%	81	90
8	臺南市安南區	2018-11-24T22:14:44+08:00	23057	8153	31210	3146	34356	65982	52.07%	34.94%	42	90
8	臺南市安南區	2018-11-25T06:27:50+08:00	54864	19800	74664	7489	82153	159654	51.46%	34.36%	90	90
8	臺南市安南區	2018-11-25T00:07:59+08:00	52128	18799	70927	7112	78039	151590	51.48%	34.39%	86	90
8	臺南市安南區	2018-11-24T23:18:22+08:00	37531	13706	51237	5130	56367	110507	51.01%	33.96%	65	90
8	臺南市安南區	2018-11-25T01:05:53+08:00	54864	19800	74664	7489	82153	159654	51.46%	34.36%	90	90
8	臺南市安南區	2018-11-24T22:56:32+08:00	33930	12478	46408	4694	51102	100081	51.06%	33.9%	60	90
8	臺南市安南區	2018-11-25T01:24:19+08:00	54864	19800	74664	7489	82153	159654	51.46%	34.36%	90	90
8	臺南市安南區	2018-11-24T22:39:04+08:00	28104	9921	38025	3857	41882	81372	51.47%	34.54%	51	90
8	臺南市安南區	2018-11-24T23:10:52+08:00	36047	13205	49252	4941	54193	105817	51.21%	34.07%	63	90
8	臺南市安南區	2018-11-24T23:07:14+08:00	35536	13009	48545	4866	53411	104324	51.2%	34.06%	62	90
8	臺南市安南區	2018-11-25T00:21:39+08:00	52128	18799	70927	7112	78039	151590	51.48%	34.39%	86	90
8	臺南市安南區	2018-11-24T22:32:13+08:00	26624	9402	36026	3660	39686	77009	51.53%	34.57%	48	90
8	臺南市安南區	2018-11-25T03:30:53+08:00	54864	19800	74664	7489	82153	159654	51.46%	34.36%	90	90
8	臺南市安南區	2018-11-25T03:48:24+08:00	54864	19800	74664	7489	82153	159654	51.46%	34.36%	90	90
8	臺南市安南區	2018-11-25T01:00:55+08:00	54864	19800	74664	7489	82153	159654	51.46%	34.36%	90	90
8	臺南市安南區	2018-11-24T23:29:42+08:00	40925	14911	55836	5671	61507	119764	51.36%	34.17%	70	90
8	臺南市安南區	2018-11-24T23:00:13+08:00	34614	12727	47341	4774	52115	101881	51.15%	33.97%	61	90
8	臺南市安南區	2018-11-24T22:21:41+08:00	25294	8982	34276	3453	37729	73081	51.63%	34.61%	46	90
8	臺南市安南區	2018-11-24T22:53:09+08:00	33190	12206	45396	4592	49988	97938	51.04%	33.89%	59	90
8	臺南市安南區	2018-11-24T22:40:14+08:00	29584	10433	40017	4038	44055	85685	51.42%	34.53%	53	90
8	臺南市安南區	2018-11-25T06:07:18+08:00	54864	19800	74664	7489	82153	159654	51.46%	34.36%	90	90
8	臺南市安南區	2018-11-24T22:11:58+08:00	21938	7754	29692	2948	32640	62935	51.86%	34.86%	40	90
8	臺南市安南區	2018-11-25T04:01:24+08:00	54864	19800	74664	7489	82153	159654	51.46%	34.36%	90	90
8	臺南市安南區	2018-11-24T23:41:57+08:00	45208	16431	61639	6321	67960	132066	51.46%	34.23%	76	90
8	臺南市安南區	2018-11-25T01:16:16+08:00	54864	19800	74664	7489	82153	159654	51.46%	34.36%	90	90
8	臺南市安南區	2018-11-24T22:35:40+08:00	27636	9776	37412	3828	41240	79992	51.56%	34.55%	50	90
8	臺南市安南區	2018-11-25T03:54:35+08:00	54864	19800	74664	7489	82153	159654	51.46%	34.36%	90	90
8	臺南市安南區	2018-11-24T23:33:45+08:00	43935	15995	59930	6124	66054	128707	51.32%	34.14%	74	90
8	臺南市安南區	2018-11-24T23:37:44+08:00	45208	16431	61639	6321	67960	132066	51.46%	34.23%	76	90
8	臺南市安南區	2018-11-24T23:45:59+08:00	46904	16974	63878	6420	70298	136628	51.45%	34.33%	78	90
8	屏東縣屏東市	2018-11-24T23:07:18+08:00	50717	15740	66457	5383	71840	137446	52.27%	36.9%	126	149
8	屏東縣屏東市	2018-11-24T22:56:36+08:00	48217	14964	63181	5104	68285	130654	52.26%	36.9%	121	149
8	屏東縣屏東市	2018-11-25T06:17:36+08:00	63176	19070	82246	6383	88629	170148	52.09%	37.13%	149	149
8	屏東縣屏東市	2018-11-24T23:10:56+08:00	51119	15874	66993	5428	72421	138764	52.19%	36.84%	127	149
8	屏東縣屏東市	2018-11-24T22:39:09+08:00	41530	13157	54687	4569	59256	113340	52.28%	36.64%	108	149
8	屏東縣屏東市	2018-11-25T01:24:25+08:00	63176	19070	82246	6383	88629	170148	52.09%	37.13%	149	149
8	屏東縣屏東市	2018-11-25T03:54:41+08:00	63176	19070	82246	6383	88629	170148	52.09%	37.13%	149	149
8	屏東縣屏東市	2018-11-25T03:30:59+08:00	63176	19070	82246	6383	88629	170148	52.09%	37.13%	149	149
8	屏東縣屏東市	2018-11-24T22:32:18+08:00	37569	12052	49621	4166	53787	103354	52.04%	36.35%	100	149
8	屏東縣屏東市	2018-11-25T01:06:00+08:00	63176	19070	82246	6383	88629	170148	52.09%	37.13%	149	149
8	屏東縣屏東市	2018-11-24T23:00:17+08:00	48217	14964	63181	5104	68285	130654	52.26%	36.9%	121	149
8	屏東縣屏東市	2018-11-25T00:21:44+08:00	61088	18586	79674	6224	85898	164972	52.07%	37.03%	146	149
8	屏東縣屏東市	2018-11-25T06:07:23+08:00	63176	19070	82246	6383	88629	170148	52.09%	37.13%	149	149
8	屏東縣屏東市	2018-11-25T04:01:29+08:00	63176	19070	82246	6383	88629	170148	52.09%	37.13%	149	149
8	屏東縣屏東市	2018-11-25T01:11:07+08:00	63176	19070	82246	6383	88629	170148	52.09%	37.13%	149	149
8	屏東縣屏東市	2018-11-24T22:40:19+08:00	43439	13674	57113	4723	61836	118425	52.22%	36.68%	112	149
8	屏東縣屏東市	2018-11-24T23:29:47+08:00	56813	17391	74204	5796	80000	154071	51.92%	36.87%	138	149
8	屏東縣屏東市	2018-11-24T22:43:50+08:00	44614	13990	58604	4777	63381	121431	52.2%	36.74%	114	149
8	屏東縣屏東市	2018-11-25T00:03:35+08:00	60070	18283	78353	6123	84476	162354	52.03%	37%	144	149
8	屏東縣屏東市	2018-11-25T00:56:13+08:00	63176	19070	82246	6383	88629	170148	52.09%	37.13%	149	149
8	屏東縣屏東市	2018-11-24T23:54:27+08:00	59451	18151	77602	6089	83691	160762	52.06%	36.98%	143	149
8	屏東縣屏東市	2018-11-24T22:35:45+08:00	38871	12400	51271	4292	55563	106663	52.09%	36.44%	103	149
8	屏東縣屏東市	2018-11-25T01:16:22+08:00	63176	19070	82246	6383	88629	170148	52.09%	37.13%	149	149
8	屏東縣屏東市	2018-11-24T23:37:49+08:00	57900	17671	75571	5948	81519	156871	51.97%	36.91%	140	149
8	屏東縣屏東市	2018-11-24T23:22:23+08:00	54589	16723	71312	5664	76976	147673	52.13%	36.97%	134	149
8	屏東縣屏東市	2018-11-24T22:49:24+08:00	46173	14378	60551	4914	65465	125191	52.29%	36.88%	117	149
8	屏東縣屏東市	2018-11-24T22:12:03+08:00	27279	8940	36219	3133	39352	75672	52%	36.05%	78	149
8	屏東縣屏東市	2018-11-24T23:03:47+08:00	49638	15400	65038	5288	70326	134677	52.22%	36.86%	124	149
8	屏東縣屏東市	2018-11-24T22:28:40+08:00	35308	11366	46674	3906	50580	97456	51.9%	36.23%	95	149
8	屏東縣屏東市	2018-11-24T23:33:50+08:00	57900	17671	75571	5948	81519	156871	51.97%	36.91%	140	149
8	屏東縣屏東市	2018-11-24T23:42:02+08:00	57900	17671	75571	5948	81519	156871	51.97%	36.91%	140	149
8	屏東縣屏東市	2018-11-25T00:08:05+08:00	60842	18463	79305	6171	85476	164304	52.02%	37.03%	145	149
8	屏東縣屏東市	2018-11-25T03:42:48+08:00	63176	19070	82246	6383	88629	170148	52.09%	37.13%	149	149
8	屏東縣屏東市	2018-11-24T22:53:15+08:00	47133	14694	61827	5007	66834	127771	52.31%	36.89%	119	149
8	屏東縣屏東市	2018-11-24T23:46:04+08:00	58907	18017	76924	6042	82966	159392	52.05%	36.96%	142	149
8	屏東縣屏東市	2018-11-25T06:12:37+08:00	63176	19070	82246	6383	88629	170148	52.09%	37.13%	149	149
8	屏東縣屏東市	2018-11-24T22:21:46+08:00	33869	10898	44767	3848	48615	93497	52%	36.22%	92	149
8	屏東縣屏東市	2018-11-24T22:25:25+08:00	34296	11011	45307	3872	49179	94712	51.92%	36.21%	93	149
8	屏東縣屏東市	2018-11-25T00:17:08+08:00	60842	18463	79305	6171	85476	164304	52.02%	37.03%	145	149
8	屏東縣屏東市	2018-11-25T06:22:45+08:00	63176	19070	82246	6383	88629	170148	52.09%	37.13%	149	149
8	屏東縣屏東市	2018-11-25T03:48:31+08:00	63176	19070	82246	6383	88629	170148	52.09%	37.13%	149	149
8	屏東縣屏東市	2018-11-24T22:14:49+08:00	29048	9482	38530	3364	41894	80711	51.91%	35.99%	82	149
8	屏東縣屏東市	2018-11-24T22:18:20+08:00	31015	10020	41035	3530	44565	85786	51.95%	36.15%	86	149
8	屏東縣屏東市	2018-11-25T03:37:30+08:00	63176	19070	82246	6383	88629	170148	52.09%	37.13%	149	149
8	屏東縣屏東市	2018-11-24T23:18:27+08:00	53451	16541	69992	5603	75595	145022	52.13%	36.86%	132	149
8	屏東縣屏東市	2018-11-24T23:58:42+08:00	59451	18151	77602	6089	83691	160762	52.06%	36.98%	143	149
8	屏東縣屏東市	2018-11-25T06:27:55+08:00	63176	19070	82246	6383	88629	170148	52.09%	37.13%	149	149
8	屏東縣屏東市	2018-11-24T23:26:07+08:00	55651	17022	72673	5732	78405	150845	51.98%	36.89%	136	149
8	屏東縣屏東市	2018-11-25T00:12:45+08:00	60842	18463	79305	6171	85476	164304	52.02%	37.03%	145	149
8	屏東縣屏東市	2018-11-25T01:01:02+08:00	63176	19070	82246	6383	88629	170148	52.09%	37.13%	149	149
8	屏東縣屏東市	2018-11-24T23:14:41+08:00	51579	16015	67594	5449	73043	140004	52.17%	36.84%	128	149
8	屏東縣屏東市	2018-11-24T23:50:15+08:00	58907	18017	76924	6042	82966	159392	52.05%	36.96%	142	149
8	臺南市南化區	2018-11-25T00:56:08+08:00	2452	783	3235	377	3612	7786	46.39%	31.49%	10	10
8	臺南市南化區	2018-11-24T22:49:18+08:00	2452	783	3235	377	3612	7786	46.39%	31.49%	10	10
8	臺南市南化區	2018-11-24T23:14:34+08:00	2452	783	3235	377	3612	7786	46.39%	31.49%	10	10
8	臺南市南化區	2018-11-24T23:22:18+08:00	2452	783	3235	377	3612	7786	46.39%	31.49%	10	10
8	臺南市南化區	2018-11-24T22:43:45+08:00	2452	783	3235	377	3612	7786	46.39%	31.49%	10	10
8	臺南市南化區	2018-11-24T23:03:42+08:00	2452	783	3235	377	3612	7786	46.39%	31.49%	10	10
8	臺南市南化區	2018-11-24T23:10:51+08:00	2452	783	3235	377	3612	7786	46.39%	31.49%	10	10
8	臺南市南化區	2018-11-25T03:37:20+08:00	2452	783	3235	377	3612	7786	46.39%	31.49%	10	10
8	臺南市南化區	2018-11-25T00:03:28+08:00	2452	783	3235	377	3612	7786	46.39%	31.49%	10	10
8	臺南市南化區	2018-11-25T06:17:30+08:00	2452	783	3235	377	3612	7786	46.39%	31.49%	10	10
8	臺南市南化區	2018-11-24T23:58:36+08:00	2452	783	3235	377	3612	7786	46.39%	31.49%	10	10
8	臺南市南化區	2018-11-25T03:42:42+08:00	2452	783	3235	377	3612	7786	46.39%	31.49%	10	10
8	臺南市南化區	2018-11-24T22:25:19+08:00	2452	783	3235	377	3612	7786	46.39%	31.49%	10	10
8	臺南市南化區	2018-11-25T06:22:40+08:00	2452	783	3235	377	3612	7786	46.39%	31.49%	10	10
8	臺南市南化區	2018-11-25T00:17:03+08:00	2452	783	3235	377	3612	7786	46.39%	31.49%	10	10
8	臺南市南化區	2018-11-25T01:11:01+08:00	2452	783	3235	377	3612	7786	46.39%	31.49%	10	10
8	臺南市南化區	2018-11-24T23:29:41+08:00	2452	783	3235	377	3612	7786	46.39%	31.49%	10	10
8	臺南市南化區	2018-11-25T06:12:32+08:00	2452	783	3235	377	3612	7786	46.39%	31.49%	10	10
8	臺南市南化區	2018-11-24T23:50:10+08:00	2452	783	3235	377	3612	7786	46.39%	31.49%	10	10
8	臺南市南化區	2018-11-25T00:12:40+08:00	2452	783	3235	377	3612	7786	46.39%	31.49%	10	10
8	臺南市南化區	2018-11-24T22:28:35+08:00	2452	783	3235	377	3612	7786	46.39%	31.49%	10	10
8	臺南市南化區	2018-11-24T22:14:43+08:00	2452	783	3235	377	3612	7786	46.39%	31.49%	10	10
8	臺南市南化區	2018-11-24T23:26:02+08:00	2452	783	3235	377	3612	7786	46.39%	31.49%	10	10
8	臺南市南化區	2018-11-24T23:54:20+08:00	2452	783	3235	377	3612	7786	46.39%	31.49%	10	10
8	臺南市南化區	2018-11-25T06:27:50+08:00	2452	783	3235	377	3612	7786	46.39%	31.49%	10	10
8	臺南市南化區	2018-11-25T00:07:59+08:00	2452	783	3235	377	3612	7786	46.39%	31.49%	10	10
8	臺南市南化區	2018-11-24T23:18:22+08:00	2452	783	3235	377	3612	7786	46.39%	31.49%	10	10
8	臺南市南化區	2018-11-25T01:05:53+08:00	2452	783	3235	377	3612	7786	46.39%	31.49%	10	10
8	臺南市南化區	2018-11-24T22:18:14+08:00	2452	783	3235	377	3612	7786	46.39%	31.49%	10	10
8	臺南市南化區	2018-11-24T22:56:32+08:00	2452	783	3235	377	3612	7786	46.39%	31.49%	10	10
8	臺南市南化區	2018-11-25T01:24:19+08:00	2452	783	3235	377	3612	7786	46.39%	31.49%	10	10
8	臺南市南化區	2018-11-24T22:39:04+08:00	2452	783	3235	377	3612	7786	46.39%	31.49%	10	10
8	臺南市南化區	2018-11-24T23:07:14+08:00	2452	783	3235	377	3612	7786	46.39%	31.49%	10	10
8	臺南市南化區	2018-11-24T22:32:13+08:00	2452	783	3235	377	3612	7786	46.39%	31.49%	10	10
8	臺南市南化區	2018-11-25T03:30:53+08:00	2452	783	3235	377	3612	7786	46.39%	31.49%	10	10
8	臺南市南化區	2018-11-25T03:48:23+08:00	2452	783	3235	377	3612	7786	46.39%	31.49%	10	10
8	臺南市南化區	2018-11-25T01:00:55+08:00	2452	783	3235	377	3612	7786	46.39%	31.49%	10	10
8	臺南市南化區	2018-11-25T00:21:38+08:00	2452	783	3235	377	3612	7786	46.39%	31.49%	10	10
8	臺南市南化區	2018-11-25T06:07:17+08:00	2452	783	3235	377	3612	7786	46.39%	31.49%	10	10
8	臺南市南化區	2018-11-24T22:53:09+08:00	2452	783	3235	377	3612	7786	46.39%	31.49%	10	10
8	臺南市南化區	2018-11-24T22:40:14+08:00	2452	783	3235	377	3612	7786	46.39%	31.49%	10	10
8	臺南市南化區	2018-11-24T22:11:58+08:00	2452	783	3235	377	3612	7786	46.39%	31.49%	10	10
8	臺南市南化區	2018-11-25T04:01:23+08:00	2452	783	3235	377	3612	7786	46.39%	31.49%	10	10
8	臺南市南化區	2018-11-24T22:21:40+08:00	2452	783	3235	377	3612	7786	46.39%	31.49%	10	10
8	臺南市南化區	2018-11-24T23:00:12+08:00	2452	783	3235	377	3612	7786	46.39%	31.49%	10	10
8	臺南市南化區	2018-11-24T23:41:57+08:00	2452	783	3235	377	3612	7786	46.39%	31.49%	10	10
8	臺南市南化區	2018-11-25T01:16:16+08:00	2452	783	3235	377	3612	7786	46.39%	31.49%	10	10
8	臺南市南化區	2018-11-24T22:35:40+08:00	2452	783	3235	377	3612	7786	46.39%	31.49%	10	10
8	臺南市南化區	2018-11-25T03:54:35+08:00	2452	783	3235	377	3612	7786	46.39%	31.49%	10	10
8	臺南市南化區	2018-11-24T23:33:45+08:00	2452	783	3235	377	3612	7786	46.39%	31.49%	10	10
8	臺南市南化區	2018-11-24T23:37:44+08:00	2452	783	3235	377	3612	7786	46.39%	31.49%	10	10
8	臺南市南化區	2018-11-24T23:45:59+08:00	2452	783	3235	377	3612	7786	46.39%	31.49%	10	10
8	全國	2018-11-25T01:05:49+08:00	7406767	2287432	9694199	806340	10500539	19268304	54.5%	38.44%	576	15
8	全國	2018-11-25T01:10:56+08:00	7427787	2293108	9720895	808206	10529101	19320073	54.5%	38.45%	609	15
8	全國	2018-11-24T22:39:00+08:00	4968762	1551845	6520607	569065	7089672	13072322	54.23%	38.01%	321	15
8	全國	2018-11-24T23:07:10+08:00	5831978	1810568	7642546	654458	8297004	15260068	54.37%	38.22%	885	15
8	全國	2018-11-24T23:50:04+08:00	6707757	2076851	8784608	740956	9525564	17495029	54.45%	38.34%	414	15
8	全國	2018-11-25T01:24:14+08:00	7466872	2304937	9771809	811564	10583373	19418949	54.5%	38.45%	670	15
8	全國	2018-11-25T00:12:36+08:00	6986515	2161486	9148001	767547	9915548	18209207	54.45%	38.37%	882	15
8	全國	2018-11-24T22:32:10+08:00	4766088	1489744	6255832	547752	6803584	12548089	54.22%	37.98%	940	15
8	全國	2018-11-25T01:00:50+08:00	7394178	2283599	9677777	805301	10483078	19236707	54.5%	38.44%	556	15
8	全國	2018-11-24T23:29:38+08:00	6312731	1956938	8269669	702514	8972183	16492350	54.4%	38.28%	734	15
8	全國	2018-11-25T03:48:19+08:00	7599267	2346316	9945583	823945	10769528	19757067	54.51%	38.46%	887	15
8	全國	2018-11-25T06:22:36+08:00	7599267	2346316	9945583	823945	10769528	19757067	54.51%	38.46%	887	15
8	全國	2018-11-25T06:12:29+08:00	7599267	2346316	9945583	823945	10769528	19757067	54.51%	38.46%	887	15
8	全國	2018-11-25T00:21:35+08:00	7100542	2195523	9296065	778373	10074438	18500038	54.46%	38.38%	072	15
8	全國	2018-11-24T23:00:03+08:00	5586902	1736323	7323225	630116	7953341	14638602	54.33%	38.17%	445	15
8	全國	2018-11-24T23:25:59+08:00	6253273	1939149	8192422	696646	8889068	16339839	54.4%	38.27%	633	15
8	全國	2018-11-25T06:07:13+08:00	7599267	2346316	9945583	823945	10769528	19757067	54.51%	38.46%	887	15
8	全國	2018-11-24T22:40:11+08:00	4968762	1551845	6520607	569065	7089672	13072322	54.23%	38.01%	321	15
8	全國	2018-11-24T22:11:55+08:00	4031945	1264989	5296934	471082	5768016	10659820	54.11%	37.82%	561	15
8	全國	2018-11-25T04:01:20+08:00	7599267	2346316	9945583	823945	10769528	19757067	54.51%	38.46%	887	15
8	全國	2018-11-24T22:53:04+08:00	5414980	1684844	7099824	613331	7713155	14205809	54.3%	38.12%	142	15
8	全國	2018-11-25T01:16:12+08:00	7448648	2299294	9747942	809895	10557837	19372749	54.5%	38.45%	640	15
8	全國	2018-11-24T23:45:55+08:00	6609129	2046700	8655829	731339	9387168	17243920	54.44%	38.33%	241	15
8	全國	2018-11-24T23:37:41+08:00	6501985	2013645	8515630	720693	9236323	16972887	54.42%	38.31%	058	15
8	全國	2018-11-24T23:54:16+08:00	6748448	2089093	8837541	744693	9582234	17596972	54.45%	38.35%	481	15
8	全國	2018-11-24T23:41:53+08:00	6560529	2031881	8592410	726657	9319067	17119573	54.44%	38.32%	155	15
8	全國	2018-11-25T03:54:31+08:00	7599267	2346316	9945583	823945	10769528	19757067	54.51%	38.46%	887	15
8	全國	2018-11-24T23:33:41+08:00	6373782	1975514	8349296	708365	9057661	16646893	54.41%	38.29%	837	15
8	全國	2018-11-24T22:35:36+08:00	4870238	1521318	6391556	558876	6950432	12815992	54.23%	38%	134	15
8	全國	2018-11-25T00:16:59+08:00	7065344	2184899	9250243	774870	10025113	18408849	54.46%	38.38%	013	15
8	全國	2018-11-25T00:03:23+08:00	6885416	2131434	9016850	757786	9774636	17953837	54.44%	38.35%	715	15
8	全國	2018-11-24T22:14:39+08:00	4141140	1298406	5439546	482344	5921890	10944016	54.11%	37.84%	766	15
8	全國	2018-11-24T22:43:41+08:00	5144572	1603697	6748269	586373	7334642	13518440	54.26%	38.06%	651	15
8	全國	2018-11-25T06:27:46+08:00	7599267	2346316	9945583	823945	10769528	19757067	54.51%	38.46%	887	15
8	全國	2018-11-24T22:49:15+08:00	5331303	1659776	6991079	604868	7595947	13991234	54.29%	38.1%	989	15
8	全國	2018-11-24T23:14:30+08:00	5965229	1851281	7816510	667585	8484095	15600566	54.38%	38.24%	127	15
8	全國	2018-11-24T23:22:14+08:00	6189860	1918873	8108733	690207	8798940	16173251	54.4%	38.27%	522	15
8	全國	2018-11-24T23:58:32+08:00	6845667	2118287	8963954	754115	9718069	17848468	54.45%	38.35%	644	15
8	全國	2018-11-25T03:37:15+08:00	7598443	2346133	9944576	823847	10768423	19755022	54.51%	38.46%	886	15
8	全國	2018-11-25T00:56:03+08:00	7368663	2275779	9644442	802971	10447413	19170291	54.5%	38.44%	515	15
8	全國	2018-11-24T22:21:36+08:00	4364339	1367574	5731913	506049	6237962	11519747	54.15%	37.89%	189	15
8	全國	2018-11-25T03:30:49+08:00	7598030	2345977	9944007	823816	10767823	19753878	54.51%	38.46%	885	15
8	全國	2018-11-25T03:42:36+08:00	7598443	2346133	9944576	823847	10768423	19755022	54.51%	38.46%	886	15
8	全國	2018-11-24T22:25:15+08:00	4581326	1433359	6014685	528238	6542923	12075423	54.18%	37.94%	590	15
8	全國	2018-11-24T22:28:31+08:00	4680086	1463706	6143792	538656	6682448	12328706	54.2%	37.96%	776	15
8	全國	2018-11-24T23:10:48+08:00	5894812	1829910	7724722	660966	8385688	15422249	54.37%	38.22%	002	15
8	全國	2018-11-25T06:17:27+08:00	7599267	2346316	9945583	823945	10769528	19757067	54.51%	38.46%	887	15
8	全國	2018-11-24T22:56:29+08:00	5497463	1709684	7207147	621500	7828647	14415164	54.31%	38.14%	288	15
8	全國	2018-11-24T23:18:18+08:00	6045525	1875453	7920978	675772	8596750	15803288	54.4%	38.25%	273	15
8	全國	2018-11-24T23:03:39+08:00	5675048	1762916	7437964	638666	8076630	14862285	54.34%	38.18%	603	15
8	全國	2018-11-25T00:07:55+08:00	6950180	2150754	9100934	764004	9864938	18118770	54.45%	38.36%	822	15
8	全國	2018-11-24T22:18:10+08:00	4253900	1333225	5587125	494033	6081158	11235773	54.12%	37.86%	979	15
8	臺北市南港區	2018-11-24T23:07:11+08:00	41696	13143	54839	3544	58383	101907	57.29%	40.92%	72	72
8	臺北市南港區	2018-11-25T01:05:49+08:00	41696	13143	54839	3544	58383	101907	57.29%	40.92%	72	72
8	臺北市南港區	2018-11-24T22:49:16+08:00	41156	12974	54130	3497	57627	100518	57.33%	40.94%	71	72
8	臺北市南港區	2018-11-24T22:39:01+08:00	41156	12974	54130	3497	57627	100518	57.33%	40.94%	71	72
8	臺北市南港區	2018-11-24T22:43:42+08:00	41156	12974	54130	3497	57627	100518	57.33%	40.94%	71	72
8	臺北市南港區	2018-11-25T01:24:15+08:00	41696	13143	54839	3544	58383	101907	57.29%	40.92%	72	72
8	臺北市南港區	2018-11-24T23:50:05+08:00	41696	13143	54839	3544	58383	101907	57.29%	40.92%	72	72
8	臺北市南港區	2018-11-24T22:39:00+08:00	41156	12974	54130	3497	57627	100518	57.33%	40.94%	71	72
8	臺北市南港區	2018-11-25T03:37:16+08:00	41696	13143	54839	3544	58383	101907	57.29%	40.92%	72	72
8	臺北市南港區	2018-11-25T01:10:57+08:00	41696	13143	54839	3544	58383	101907	57.29%	40.92%	72	72
8	臺北市南港區	2018-11-24T23:50:04+08:00	41696	13143	54839	3544	58383	101907	57.29%	40.92%	72	72
8	臺北市南港區	2018-11-25T01:24:14+08:00	41696	13143	54839	3544	58383	101907	57.29%	40.92%	72	72
8	臺北市南港區	2018-11-25T00:12:36+08:00	41696	13143	54839	3544	58383	101907	57.29%	40.92%	72	72
8	臺北市南港區	2018-11-25T06:22:37+08:00	41696	13143	54839	3544	58383	101907	57.29%	40.92%	72	72
8	臺北市南港區	2018-11-24T22:32:10+08:00	41156	12974	54130	3497	57627	100518	57.33%	40.94%	71	72
8	臺北市南港區	2018-11-24T23:29:38+08:00	41696	13143	54839	3544	58383	101907	57.29%	40.92%	72	72
8	臺北市南港區	2018-11-25T06:22:36+08:00	41696	13143	54839	3544	58383	101907	57.29%	40.92%	72	72
8	臺北市南港區	2018-11-25T06:12:29+08:00	41696	13143	54839	3544	58383	101907	57.29%	40.92%	72	72
8	臺北市南港區	2018-11-25T00:21:35+08:00	41696	13143	54839	3544	58383	101907	57.29%	40.92%	72	72
8	臺北市南港區	2018-11-24T23:00:03+08:00	41696	13143	54839	3544	58383	101907	57.29%	40.92%	72	72
8	臺北市南港區	2018-11-25T03:48:20+08:00	41696	13143	54839	3544	58383	101907	57.29%	40.92%	72	72
8	臺北市南港區	2018-11-24T23:25:59+08:00	41696	13143	54839	3544	58383	101907	57.29%	40.92%	72	72
8	臺北市南港區	2018-11-24T23:29:39+08:00	41696	13143	54839	3544	58383	101907	57.29%	40.92%	72	72
8	臺北市南港區	2018-11-24T23:00:04+08:00	41696	13143	54839	3544	58383	101907	57.29%	40.92%	72	72
8	臺北市南港區	2018-11-25T01:00:51+08:00	41696	13143	54839	3544	58383	101907	57.29%	40.92%	72	72
8	臺北市南港區	2018-11-25T06:07:14+08:00	41696	13143	54839	3544	58383	101907	57.29%	40.92%	72	72
8	臺北市南港區	2018-11-24T22:53:05+08:00	41696	13143	54839	3544	58383	101907	57.29%	40.92%	72	72
8	臺北市南港區	2018-11-24T22:40:11+08:00	41156	12974	54130	3497	57627	100518	57.33%	40.94%	71	72
8	臺北市南港區	2018-11-24T22:25:16+08:00	41156	12974	54130	3497	57627	100518	57.33%	40.94%	71	72
8	臺北市南港區	2018-11-24T22:11:55+08:00	41156	12974	54130	3497	57627	100518	57.33%	40.94%	71	72
8	臺北市南港區	2018-11-25T04:01:20+08:00	41696	13143	54839	3544	58383	101907	57.29%	40.92%	72	72
8	臺北市南港區	2018-11-25T01:16:12+08:00	41696	13143	54839	3544	58383	101907	57.29%	40.92%	72	72
8	臺北市南港區	2018-11-25T00:07:56+08:00	41696	13143	54839	3544	58383	101907	57.29%	40.92%	72	72
8	臺北市南港區	2018-11-24T23:37:41+08:00	41696	13143	54839	3544	58383	101907	57.29%	40.92%	72	72
8	臺北市南港區	2018-11-24T23:41:54+08:00	41696	13143	54839	3544	58383	101907	57.29%	40.92%	72	72
8	臺北市南港區	2018-11-24T22:28:32+08:00	41156	12974	54130	3497	57627	100518	57.33%	40.94%	71	72
8	臺北市南港區	2018-11-25T01:16:13+08:00	41696	13143	54839	3544	58383	101907	57.29%	40.92%	72	72
8	臺北市南港區	2018-11-25T03:54:31+08:00	41696	13143	54839	3544	58383	101907	57.29%	40.92%	72	72
8	臺北市南港區	2018-11-24T23:54:17+08:00	41696	13143	54839	3544	58383	101907	57.29%	40.92%	72	72
8	臺北市南港區	2018-11-25T00:03:24+08:00	41696	13143	54839	3544	58383	101907	57.29%	40.92%	72	72
8	臺北市南港區	2018-11-24T22:35:36+08:00	41156	12974	54130	3497	57627	100518	57.33%	40.94%	71	72
8	臺北市南港區	2018-11-25T00:16:59+08:00	41696	13143	54839	3544	58383	101907	57.29%	40.92%	72	72
8	臺北市南港區	2018-11-24T23:22:15+08:00	41696	13143	54839	3544	58383	101907	57.29%	40.92%	72	72
8	臺北市南港區	2018-11-24T23:58:33+08:00	41696	13143	54839	3544	58383	101907	57.29%	40.92%	72	72
8	臺北市南港區	2018-11-24T22:14:39+08:00	41156	12974	54130	3497	57627	100518	57.33%	40.94%	71	72
8	臺北市南港區	2018-11-24T23:03:40+08:00	41696	13143	54839	3544	58383	101907	57.29%	40.92%	72	72
8	臺北市南港區	2018-11-24T23:14:30+08:00	41696	13143	54839	3544	58383	101907	57.29%	40.92%	72	72
8	臺北市南港區	2018-11-24T23:22:14+08:00	41696	13143	54839	3544	58383	101907	57.29%	40.92%	72	72
8	臺北市南港區	2018-11-24T23:58:32+08:00	41696	13143	54839	3544	58383	101907	57.29%	40.92%	72	72
8	臺北市南港區	2018-11-24T22:35:37+08:00	41156	12974	54130	3497	57627	100518	57.33%	40.94%	71	72
8	臺北市南港區	2018-11-25T03:37:15+08:00	41696	13143	54839	3544	58383	101907	57.29%	40.92%	72	72
8	臺北市南港區	2018-11-25T00:56:04+08:00	41696	13143	54839	3544	58383	101907	57.29%	40.92%	72	72
8	臺北市南港區	2018-11-24T23:14:31+08:00	41696	13143	54839	3544	58383	101907	57.29%	40.92%	72	72
8	臺北市南港區	2018-11-25T06:27:47+08:00	41696	13143	54839	3544	58383	101907	57.29%	40.92%	72	72
8	臺北市南港區	2018-11-24T22:21:36+08:00	41156	12974	54130	3497	57627	100518	57.33%	40.94%	71	72
8	臺北市南港區	2018-11-24T22:21:37+08:00	41156	12974	54130	3497	57627	100518	57.33%	40.94%	71	72
8	臺北市南港區	2018-11-25T00:17:00+08:00	41696	13143	54839	3544	58383	101907	57.29%	40.92%	72	72
8	臺北市南港區	2018-11-25T03:42:37+08:00	41696	13143	54839	3544	58383	101907	57.29%	40.92%	72	72
8	臺北市南港區	2018-11-25T03:30:49+08:00	41696	13143	54839	3544	58383	101907	57.29%	40.92%	72	72
8	臺北市南港區	2018-11-25T03:42:36+08:00	41696	13143	54839	3544	58383	101907	57.29%	40.92%	72	72
8	臺北市南港區	2018-11-24T22:25:15+08:00	41156	12974	54130	3497	57627	100518	57.33%	40.94%	71	72
8	臺北市南港區	2018-11-24T22:18:11+08:00	41156	12974	54130	3497	57627	100518	57.33%	40.94%	71	72
8	臺北市南港區	2018-11-24T22:28:31+08:00	41156	12974	54130	3497	57627	100518	57.33%	40.94%	71	72
8	臺北市南港區	2018-11-24T23:10:48+08:00	41696	13143	54839	3544	58383	101907	57.29%	40.92%	72	72
8	臺北市南港區	2018-11-24T22:14:40+08:00	41156	12974	54130	3497	57627	100518	57.33%	40.94%	71	72
8	臺北市南港區	2018-11-25T06:17:27+08:00	41696	13143	54839	3544	58383	101907	57.29%	40.92%	72	72
8	臺北市南港區	2018-11-24T22:56:29+08:00	41696	13143	54839	3544	58383	101907	57.29%	40.92%	72	72
8	臺北市南港區	2018-11-24T23:45:56+08:00	41696	13143	54839	3544	58383	101907	57.29%	40.92%	72	72
8	臺北市南港區	2018-11-25T00:07:55+08:00	41696	13143	54839	3544	58383	101907	57.29%	40.92%	72	72
8	臺北市南港區	2018-11-24T23:33:42+08:00	41696	13143	54839	3544	58383	101907	57.29%	40.92%	72	72
8	臺北市南港區	2018-11-24T23:10:49+08:00	41696	13143	54839	3544	58383	101907	57.29%	40.92%	72	72
8	臺北市南港區	2018-11-25T03:54:32+08:00	41696	13143	54839	3544	58383	101907	57.29%	40.92%	72	72
8	臺北市南港區	2018-11-24T23:18:19+08:00	41696	13143	54839	3544	58383	101907	57.29%	40.92%	72	72
8	桃園市大溪區	2018-11-25T03:37:17+08:00	28638	8815	37453	3444	40897	78285	52.24%	36.58%	59	59
8	桃園市大溪區	2018-11-24T22:49:16+08:00	23021	7334	30355	2892	33247	64064	51.9%	35.93%	49	59
8	桃園市大溪區	2018-11-24T22:39:01+08:00	21620	6991	28611	2700	31311	60374	51.86%	35.81%	46	59
8	桃園市大溪區	2018-11-25T01:10:58+08:00	28638	8815	37453	3444	40897	78285	52.24%	36.58%	59	59
8	桃園市大溪區	2018-11-25T00:12:37+08:00	28638	8815	37453	3444	40897	78285	52.24%	36.58%	59	59
8	桃園市大溪區	2018-11-25T01:24:15+08:00	28638	8815	37453	3444	40897	78285	52.24%	36.58%	59	59
8	桃園市大溪區	2018-11-24T23:14:32+08:00	26419	8163	34582	3172	37754	72525	52.06%	36.43%	55	59
8	桃園市大溪區	2018-11-24T22:43:43+08:00	21974	7119	29093	2739	31832	61430	51.82%	35.77%	47	59
8	桃園市大溪區	2018-11-24T22:56:30+08:00	24142	7658	31800	3016	34816	66836	52.09%	36.12%	51	59
8	桃園市大溪區	2018-11-25T06:22:37+08:00	28638	8815	37453	3444	40897	78285	52.24%	36.58%	59	59
8	桃園市大溪區	2018-11-25T03:30:50+08:00	28638	8815	37453	3444	40897	78285	52.24%	36.58%	59	59
8	桃園市大溪區	2018-11-24T23:00:05+08:00	25213	7878	33091	3105	36196	69564	52.03%	36.24%	53	59
8	桃園市大溪區	2018-11-25T03:48:21+08:00	28638	8815	37453	3444	40897	78285	52.24%	36.58%	59	59
8	桃園市大溪區	2018-11-24T22:32:11+08:00	21620	6991	28611	2700	31311	60374	51.86%	35.81%	46	59
8	桃園市大溪區	2018-11-24T23:29:39+08:00	27448	8532	35980	3321	39301	75496	52.06%	36.36%	57	59
8	桃園市大溪區	2018-11-25T04:01:21+08:00	28638	8815	37453	3444	40897	78285	52.24%	36.58%	59	59
8	桃園市大溪區	2018-11-24T22:25:16+08:00	20176	6492	26668	2565	29233	56242	51.98%	35.87%	43	59
8	桃園市大溪區	2018-11-25T06:07:15+08:00	28638	8815	37453	3444	40897	78285	52.24%	36.58%	59	59
8	桃園市大溪區	2018-11-25T00:07:56+08:00	28638	8815	37453	3444	40897	78285	52.24%	36.58%	59	59
8	桃園市大溪區	2018-11-24T22:28:32+08:00	21261	6852	28113	2655	30768	59368	51.83%	35.81%	45	59
8	桃園市大溪區	2018-11-24T22:18:12+08:00	16994	5728	22722	2168	24890	47868	52%	35.5%	37	59
8	桃園市大溪區	2018-11-25T01:16:14+08:00	28638	8815	37453	3444	40897	78285	52.24%	36.58%	59	59
8	桃園市大溪區	2018-11-24T23:54:17+08:00	28638	8815	37453	3444	40897	78285	52.24%	36.58%	59	59
8	桃園市大溪區	2018-11-24T23:41:55+08:00	27448	8532	35980	3321	39301	75496	52.06%	36.36%	57	59
8	桃園市大溪區	2018-11-24T23:58:34+08:00	28638	8815	37453	3444	40897	78285	52.24%	36.58%	59	59
8	桃園市大溪區	2018-11-24T23:22:15+08:00	27448	8532	35980	3321	39301	75496	52.06%	36.36%	57	59
8	桃園市大溪區	2018-11-24T22:35:38+08:00	21620	6991	28611	2700	31311	60374	51.86%	35.81%	46	59
8	桃園市大溪區	2018-11-24T23:07:12+08:00	26419	8163	34582	3172	37754	72525	52.06%	36.43%	55	59
8	桃園市大溪區	2018-11-24T23:03:40+08:00	26419	8163	34582	3172	37754	72525	52.06%	36.43%	55	59
8	桃園市大溪區	2018-11-25T00:56:05+08:00	28638	8815	37453	3444	40897	78285	52.24%	36.58%	59	59
8	桃園市大溪區	2018-11-25T06:27:48+08:00	28638	8815	37453	3444	40897	78285	52.24%	36.58%	59	59
8	桃園市大溪區	2018-11-24T23:50:07+08:00	28638	8815	37453	3444	40897	78285	52.24%	36.58%	59	59
8	桃園市大溪區	2018-11-25T00:03:25+08:00	28638	8815	37453	3444	40897	78285	52.24%	36.58%	59	59
8	桃園市大溪區	2018-11-25T00:21:36+08:00	28638	8815	37453	3444	40897	78285	52.24%	36.58%	59	59
8	桃園市大溪區	2018-11-25T01:00:52+08:00	28638	8815	37453	3444	40897	78285	52.24%	36.58%	59	59
8	桃園市大溪區	2018-11-24T22:21:37+08:00	18916	6293	25209	2444	27653	53345	51.84%	35.46%	41	59
8	桃園市大溪區	2018-11-25T06:12:30+08:00	28638	8815	37453	3444	40897	78285	52.24%	36.58%	59	59
8	桃園市大溪區	2018-11-24T22:53:06+08:00	23565	7494	31059	2962	34021	65433	51.99%	36.01%	50	59
8	桃園市大溪區	2018-11-24T22:40:12+08:00	21620	6991	28611	2700	31311	60374	51.86%	35.81%	46	59
8	桃園市大溪區	2018-11-25T00:17:00+08:00	28638	8815	37453	3444	40897	78285	52.24%	36.58%	59	59
8	桃園市大溪區	2018-11-25T03:42:39+08:00	28638	8815	37453	3444	40897	78285	52.24%	36.58%	59	59
8	桃園市大溪區	2018-11-24T22:11:56+08:00	16075	5447	21522	2044	23566	45485	51.81%	35.34%	35	59
8	桃園市大溪區	2018-11-24T23:33:43+08:00	27448	8532	35980	3321	39301	75496	52.06%	36.36%	57	59
8	桃園市大溪區	2018-11-24T23:18:20+08:00	26954	8381	35335	3246	38581	74002	52.14%	36.42%	56	59
8	桃園市大溪區	2018-11-24T23:37:42+08:00	27448	8532	35980	3321	39301	75496	52.06%	36.36%	57	59
8	桃園市大溪區	2018-11-24T22:14:41+08:00	16440	5560	22000	2104	24104	46461	51.88%	35.38%	36	59
8	桃園市大溪區	2018-11-25T01:05:50+08:00	28638	8815	37453	3444	40897	78285	52.24%	36.58%	59	59
8	桃園市大溪區	2018-11-24T23:26:00+08:00	27448	8532	35980	3321	39301	75496	52.06%	36.36%	57	59
8	桃園市大溪區	2018-11-24T23:10:49+08:00	26419	8163	34582	3172	37754	72525	52.06%	36.43%	55	59
8	桃園市大溪區	2018-11-25T03:54:32+08:00	28638	8815	37453	3444	40897	78285	52.24%	36.58%	59	59
8	桃園市大溪區	2018-11-25T06:17:28+08:00	28638	8815	37453	3444	40897	78285	52.24%	36.58%	59	59
8	桃園市大溪區	2018-11-24T23:45:57+08:00	28638	8815	37453	3444	40897	78285	52.24%	36.58%	59	59
8	桃園市復興區	2018-11-25T03:37:17+08:00	3560	968	4528	402	4930	9766	50.48%	36.45%	10	10
8	桃園市復興區	2018-11-24T23:10:50+08:00	2198	572	2770	245	3015	5868	51.38%	37.46%	7	10
8	桃園市復興區	2018-11-24T23:22:16+08:00	2198	572	2770	245	3015	5868	51.38%	37.46%	7	10
8	桃園市復興區	2018-11-25T01:10:58+08:00	3129	848	3977	361	4338	8542	50.78%	36.63%	9	10
8	桃園市復興區	2018-11-25T00:12:37+08:00	3129	848	3977	361	4338	8542	50.78%	36.63%	9	10
8	桃園市復興區	2018-11-24T22:49:17+08:00	1484	383	1867	165	2032	4101	49.55%	36.19%	5	10
8	桃園市復興區	2018-11-24T23:14:32+08:00	2198	572	2770	245	3015	5868	51.38%	37.46%	7	10
8	桃園市復興區	2018-11-24T22:43:43+08:00	1484	383	1867	165	2032	4101	49.55%	36.19%	5	10
8	桃園市復興區	2018-11-24T22:56:30+08:00	1753	453	2206	183	2389	4852	49.24%	36.13%	6	10
8	桃園市復興區	2018-11-25T06:22:37+08:00	3560	968	4528	402	4930	9766	50.48%	36.45%	10	10
8	桃園市復興區	2018-11-25T03:48:21+08:00	3560	968	4528	402	4930	9766	50.48%	36.45%	10	10
8	桃園市復興區	2018-11-25T03:30:51+08:00	3560	968	4528	402	4930	9766	50.48%	36.45%	10	10
8	桃園市復興區	2018-11-24T22:32:11+08:00	1220	320	1540	140	1680	3341	50.28%	36.52%	4	10
8	桃園市復興區	2018-11-25T04:01:21+08:00	3560	968	4528	402	4930	9766	50.48%	36.45%	10	10
8	桃園市復興區	2018-11-24T22:25:17+08:00	1220	320	1540	140	1680	3341	50.28%	36.52%	4	10
8	桃園市復興區	2018-11-25T06:07:15+08:00	3560	968	4528	402	4930	9766	50.48%	36.45%	10	10
8	桃園市復興區	2018-11-24T23:29:40+08:00	2950	805	3755	351	4106	7859	52.25%	37.54%	8	10
8	桃園市復興區	2018-11-24T22:18:12+08:00	965	257	1222	117	1339	2625	51.01%	36.76%	3	10
8	桃園市復興區	2018-11-24T23:54:18+08:00	2950	805	3755	351	4106	7859	52.25%	37.54%	8	10
8	桃園市復興區	2018-11-25T00:07:57+08:00	3129	848	3977	361	4338	8542	50.78%	36.63%	9	10
8	桃園市復興區	2018-11-25T01:16:14+08:00	3129	848	3977	361	4338	8542	50.78%	36.63%	9	10
8	桃園市復興區	2018-11-24T23:41:55+08:00	2950	805	3755	351	4106	7859	52.25%	37.54%	8	10
8	桃園市復興區	2018-11-24T22:28:33+08:00	1220	320	1540	140	1680	3341	50.28%	36.52%	4	10
8	桃園市復興區	2018-11-24T23:58:34+08:00	2950	805	3755	351	4106	7859	52.25%	37.54%	8	10
8	桃園市復興區	2018-11-24T23:50:08+08:00	2950	805	3755	351	4106	7859	52.25%	37.54%	8	10
8	桃園市復興區	2018-11-25T01:24:16+08:00	3129	848	3977	361	4338	8542	50.78%	36.63%	9	10
8	桃園市復興區	2018-11-24T22:35:38+08:00	1220	320	1540	140	1680	3341	50.28%	36.52%	4	10
8	桃園市復興區	2018-11-24T23:07:12+08:00	2198	572	2770	245	3015	5868	51.38%	37.46%	7	10
8	桃園市復興區	2018-11-24T22:39:02+08:00	1484	383	1867	165	2032	4101	49.55%	36.19%	5	10
8	桃園市復興區	2018-11-25T00:56:05+08:00	3129	848	3977	361	4338	8542	50.78%	36.63%	9	10
8	桃園市復興區	2018-11-25T06:27:48+08:00	3560	968	4528	402	4930	9766	50.48%	36.45%	10	10
8	桃園市復興區	2018-11-25T00:03:25+08:00	3129	848	3977	361	4338	8542	50.78%	36.63%	9	10
8	桃園市復興區	2018-11-24T23:03:41+08:00	2198	572	2770	245	3015	5868	51.38%	37.46%	7	10
8	桃園市復興區	2018-11-24T23:00:06+08:00	1753	453	2206	183	2389	4852	49.24%	36.13%	6	10
8	桃園市復興區	2018-11-24T22:21:38+08:00	1220	320	1540	140	1680	3341	50.28%	36.52%	4	10
8	桃園市復興區	2018-11-25T03:42:40+08:00	3560	968	4528	402	4930	9766	50.48%	36.45%	10	10
8	桃園市復興區	2018-11-25T00:21:36+08:00	3129	848	3977	361	4338	8542	50.78%	36.63%	9	10
8	桃園市復興區	2018-11-25T01:00:52+08:00	3129	848	3977	361	4338	8542	50.78%	36.63%	9	10
8	桃園市復興區	2018-11-25T06:12:30+08:00	3560	968	4528	402	4930	9766	50.48%	36.45%	10	10
8	桃園市復興區	2018-11-24T22:40:12+08:00	1484	383	1867	165	2032	4101	49.55%	36.19%	5	10
8	桃園市復興區	2018-11-25T00:17:01+08:00	3129	848	3977	361	4338	8542	50.78%	36.63%	9	10
8	桃園市復興區	2018-11-24T22:53:07+08:00	1484	383	1867	165	2032	4101	49.55%	36.19%	5	10
8	桃園市復興區	2018-11-24T22:11:56+08:00	965	257	1222	117	1339	2625	51.01%	36.76%	3	10
8	桃園市復興區	2018-11-25T03:54:33+08:00	3560	968	4528	402	4930	9766	50.48%	36.45%	10	10
8	桃園市復興區	2018-11-25T01:05:51+08:00	3129	848	3977	361	4338	8542	50.78%	36.63%	9	10
8	桃園市復興區	2018-11-24T23:33:43+08:00	2950	805	3755	351	4106	7859	52.25%	37.54%	8	10
8	桃園市復興區	2018-11-24T23:18:20+08:00	2198	572	2770	245	3015	5868	51.38%	37.46%	7	10
8	桃園市復興區	2018-11-25T06:17:29+08:00	3560	968	4528	402	4930	9766	50.48%	36.45%	10	10
8	桃園市復興區	2018-11-24T23:37:42+08:00	2950	805	3755	351	4106	7859	52.25%	37.54%	8	10
8	桃園市復興區	2018-11-24T22:14:41+08:00	965	257	1222	117	1339	2625	51.01%	36.76%	3	10
8	桃園市復興區	2018-11-24T23:26:00+08:00	2198	572	2770	245	3015	5868	51.38%	37.46%	7	10
8	桃園市復興區	2018-11-24T23:45:57+08:00	2950	805	3755	351	4106	7859	52.25%	37.54%	8	10
8	宜蘭縣壯圍鄉	2018-11-24T23:33:52+08:00	8149	2591	10740	1453	12193	21447	56.85%	38%	23	23
8	宜蘭縣壯圍鄉	2018-11-24T23:10:57+08:00	8149	2591	10740	1453	12193	21447	56.85%	38%	23	23
8	宜蘭縣壯圍鄉	2018-11-25T06:17:38+08:00	8149	2591	10740	1453	12193	21447	56.85%	38%	23	23
8	宜蘭縣壯圍鄉	2018-11-24T22:28:42+08:00	7579	2414	9993	1337	11330	20012	56.62%	37.87%	22	23
8	宜蘭縣壯圍鄉	2018-11-24T23:07:21+08:00	8149	2591	10740	1453	12193	21447	56.85%	38%	23	23
8	宜蘭縣壯圍鄉	2018-11-24T22:14:50+08:00	7276	2273	9549	1244	10793	19101	56.5%	38.09%	21	23
8	宜蘭縣壯圍鄉	2018-11-24T22:56:37+08:00	7579	2414	9993	1337	11330	20012	56.62%	37.87%	22	23
8	宜蘭縣壯圍鄉	2018-11-24T22:53:17+08:00	7579	2414	9993	1337	11330	20012	56.62%	37.87%	22	23
8	宜蘭縣壯圍鄉	2018-11-25T01:06:01+08:00	8149	2591	10740	1453	12193	21447	56.85%	38%	23	23
8	宜蘭縣壯圍鄉	2018-11-24T22:32:20+08:00	7579	2414	9993	1337	11330	20012	56.62%	37.87%	22	23
8	宜蘭縣壯圍鄉	2018-11-25T00:17:10+08:00	8149	2591	10740	1453	12193	21447	56.85%	38%	23	23
8	宜蘭縣壯圍鄉	2018-11-25T00:08:06+08:00	8149	2591	10740	1453	12193	21447	56.85%	38%	23	23
8	宜蘭縣壯圍鄉	2018-11-25T03:48:33+08:00	8149	2591	10740	1453	12193	21447	56.85%	38%	23	23
8	宜蘭縣壯圍鄉	2018-11-24T23:29:48+08:00	8149	2591	10740	1453	12193	21447	56.85%	38%	23	23
8	宜蘭縣壯圍鄉	2018-11-24T22:40:20+08:00	7579	2414	9993	1337	11330	20012	56.62%	37.87%	22	23
8	宜蘭縣壯圍鄉	2018-11-25T06:22:46+08:00	8149	2591	10740	1453	12193	21447	56.85%	38%	23	23
8	宜蘭縣壯圍鄉	2018-11-25T06:07:24+08:00	8149	2591	10740	1453	12193	21447	56.85%	38%	23	23
8	宜蘭縣壯圍鄉	2018-11-24T23:00:18+08:00	7579	2414	9993	1337	11330	20012	56.62%	37.87%	22	23
8	宜蘭縣壯圍鄉	2018-11-24T22:25:27+08:00	7579	2414	9993	1337	11330	20012	56.62%	37.87%	22	23
8	宜蘭縣壯圍鄉	2018-11-25T03:42:50+08:00	8149	2591	10740	1453	12193	21447	56.85%	38%	23	23
8	宜蘭縣壯圍鄉	2018-11-25T01:11:09+08:00	8149	2591	10740	1453	12193	21447	56.85%	38%	23	23
8	宜蘭縣壯圍鄉	2018-11-25T01:16:24+08:00	8149	2591	10740	1453	12193	21447	56.85%	38%	23	23
8	宜蘭縣壯圍鄉	2018-11-24T23:54:29+08:00	8149	2591	10740	1453	12193	21447	56.85%	38%	23	23
8	宜蘭縣壯圍鄉	2018-11-25T06:27:57+08:00	8149	2591	10740	1453	12193	21447	56.85%	38%	23	23
8	宜蘭縣壯圍鄉	2018-11-25T03:31:01+08:00	8149	2591	10740	1453	12193	21447	56.85%	38%	23	23
8	宜蘭縣壯圍鄉	2018-11-24T23:14:42+08:00	8149	2591	10740	1453	12193	21447	56.85%	38%	23	23
8	宜蘭縣壯圍鄉	2018-11-24T23:50:16+08:00	8149	2591	10740	1453	12193	21447	56.85%	38%	23	23
8	宜蘭縣壯圍鄉	2018-11-25T00:56:15+08:00	8149	2591	10740	1453	12193	21447	56.85%	38%	23	23
8	宜蘭縣壯圍鄉	2018-11-25T00:12:46+08:00	8149	2591	10740	1453	12193	21447	56.85%	38%	23	23
8	宜蘭縣壯圍鄉	2018-11-24T23:37:50+08:00	8149	2591	10740	1453	12193	21447	56.85%	38%	23	23
8	宜蘭縣壯圍鄉	2018-11-25T03:54:43+08:00	8149	2591	10740	1453	12193	21447	56.85%	38%	23	23
8	宜蘭縣壯圍鄉	2018-11-24T22:12:04+08:00	7276	2273	9549	1244	10793	19101	56.5%	38.09%	21	23
8	宜蘭縣壯圍鄉	2018-11-24T23:22:25+08:00	8149	2591	10740	1453	12193	21447	56.85%	38%	23	23
8	宜蘭縣壯圍鄉	2018-11-25T01:24:26+08:00	8149	2591	10740	1453	12193	21447	56.85%	38%	23	23
8	宜蘭縣壯圍鄉	2018-11-24T23:03:48+08:00	8149	2591	10740	1453	12193	21447	56.85%	38%	23	23
8	宜蘭縣壯圍鄉	2018-11-24T22:49:25+08:00	7579	2414	9993	1337	11330	20012	56.62%	37.87%	22	23
8	宜蘭縣壯圍鄉	2018-11-24T23:42:03+08:00	8149	2591	10740	1453	12193	21447	56.85%	38%	23	23
8	宜蘭縣壯圍鄉	2018-11-24T23:46:05+08:00	8149	2591	10740	1453	12193	21447	56.85%	38%	23	23
8	宜蘭縣壯圍鄉	2018-11-25T04:01:31+08:00	8149	2591	10740	1453	12193	21447	56.85%	38%	23	23
8	宜蘭縣壯圍鄉	2018-11-24T22:21:48+08:00	7579	2414	9993	1337	11330	20012	56.62%	37.87%	22	23
8	宜蘭縣壯圍鄉	2018-11-25T06:12:38+08:00	8149	2591	10740	1453	12193	21447	56.85%	38%	23	23
8	宜蘭縣壯圍鄉	2018-11-25T00:21:46+08:00	8149	2591	10740	1453	12193	21447	56.85%	38%	23	23
8	宜蘭縣壯圍鄉	2018-11-25T01:01:03+08:00	8149	2591	10740	1453	12193	21447	56.85%	38%	23	23
8	宜蘭縣壯圍鄉	2018-11-24T22:39:10+08:00	7579	2414	9993	1337	11330	20012	56.62%	37.87%	22	23
8	宜蘭縣壯圍鄉	2018-11-24T22:35:46+08:00	7579	2414	9993	1337	11330	20012	56.62%	37.87%	22	23
8	宜蘭縣壯圍鄉	2018-11-24T23:58:44+08:00	8149	2591	10740	1453	12193	21447	56.85%	38%	23	23
8	宜蘭縣壯圍鄉	2018-11-24T23:18:29+08:00	8149	2591	10740	1453	12193	21447	56.85%	38%	23	23
8	宜蘭縣壯圍鄉	2018-11-25T03:37:31+08:00	8149	2591	10740	1453	12193	21447	56.85%	38%	23	23
8	宜蘭縣壯圍鄉	2018-11-24T22:18:21+08:00	7276	2273	9549	1244	10793	19101	56.5%	38.09%	21	23
8	宜蘭縣壯圍鄉	2018-11-24T23:26:09+08:00	8149	2591	10740	1453	12193	21447	56.85%	38%	23	23
8	宜蘭縣壯圍鄉	2018-11-25T00:03:37+08:00	8149	2591	10740	1453	12193	21447	56.85%	38%	23	23
8	宜蘭縣壯圍鄉	2018-11-24T22:43:52+08:00	7579	2414	9993	1337	11330	20012	56.62%	37.87%	22	23
8	新北市板橋區	2018-11-24T23:07:11+08:00	159609	53218	212827	19468	232295	415206	55.95%	38.44%	309	338
8	新北市板橋區	2018-11-25T01:05:49+08:00	176926	59047	235973	21774	257747	463411	55.62%	38.18%	338	338
8	新北市板橋區	2018-11-24T22:49:16+08:00	154378	51604	205982	18866	224848	401891	55.95%	38.41%	300	338
8	新北市板橋區	2018-11-24T22:43:42+08:00	151943	50831	202774	18605	221379	395522	55.97%	38.42%	296	338
8	新北市板橋區	2018-11-24T22:39:00+08:00	148022	49550	197572	18155	215727	385158	56.01%	38.43%	289	338
8	新北市板橋區	2018-11-25T01:10:57+08:00	176926	59047	235973	21774	257747	463411	55.62%	38.18%	338	338
8	新北市板橋區	2018-11-24T23:50:04+08:00	171156	57212	228368	21124	249492	447251	55.78%	38.27%	329	338
8	新北市板橋區	2018-11-25T01:24:14+08:00	176926	59047	235973	21774	257747	463411	55.62%	38.18%	338	338
8	新北市板橋區	2018-11-25T00:12:36+08:00	175641	58569	234210	21628	255838	459984	55.62%	38.18%	336	338
8	新北市板橋區	2018-11-24T22:32:10+08:00	144240	48379	192619	17764	210383	375042	56.1%	38.46%	283	338
8	新北市板橋區	2018-11-24T23:29:38+08:00	166152	55428	221580	20248	241828	433360	55.8%	38.34%	320	338
8	新北市板橋區	2018-11-25T06:22:36+08:00	176926	59047	235973	21774	257747	463411	55.62%	38.18%	338	338
8	新北市板橋區	2018-11-25T06:12:29+08:00	176926	59047	235973	21774	257747	463411	55.62%	38.18%	338	338
8	新北市板橋區	2018-11-25T00:21:35+08:00	175641	58569	234210	21628	255838	459984	55.62%	38.18%	336	338
8	新北市板橋區	2018-11-25T03:48:20+08:00	176926	59047	235973	21774	257747	463411	55.62%	38.18%	338	338
8	新北市板橋區	2018-11-24T23:25:59+08:00	165441	55213	220654	20205	240859	431406	55.83%	38.35%	319	338
8	新北市板橋區	2018-11-24T23:00:04+08:00	157460	52568	210028	19262	229290	409623	55.98%	38.44%	305	338
8	新北市板橋區	2018-11-25T01:00:51+08:00	176926	59047	235973	21774	257747	463411	55.62%	38.18%	338	338
8	新北市板橋區	2018-11-25T06:07:14+08:00	176926	59047	235973	21774	257747	463411	55.62%	38.18%	338	338
8	新北市板橋區	2018-11-24T22:53:05+08:00	155496	51970	207466	18992	226458	404740	55.95%	38.42%	302	338
8	新北市板橋區	2018-11-24T22:40:11+08:00	150139	50223	200362	18474	218836	390747	56%	38.42%	293	338
8	新北市板橋區	2018-11-24T22:11:55+08:00	124187	41490	165677	15104	180781	321000	56.32%	38.69%	248	338
8	新北市板橋區	2018-11-25T04:01:20+08:00	176926	59047	235973	21774	257747	463411	55.62%	38.18%	338	338
8	新北市板橋區	2018-11-25T01:16:12+08:00	176926	59047	235973	21774	257747	463411	55.62%	38.18%	338	338
8	新北市板橋區	2018-11-24T23:37:41+08:00	169457	56611	226068	20787	246855	442199	55.82%	38.32%	326	338
8	新北市板橋區	2018-11-24T23:41:54+08:00	170144	56862	227006	20895	247901	444092	55.82%	38.31%	327	338
8	新北市板橋區	2018-11-24T22:28:32+08:00	141586	47391	188977	17442	206419	367959	56.1%	38.48%	279	338
8	新北市板橋區	2018-11-25T03:54:31+08:00	176926	59047	235973	21774	257747	463411	55.62%	38.18%	338	338
8	新北市板橋區	2018-11-24T23:54:17+08:00	171156	57212	228368	21124	249492	447251	55.78%	38.27%	329	338
8	新北市板橋區	2018-11-25T00:03:24+08:00	174930	58373	233303	21543	254846	458223	55.62%	38.18%	335	338
8	新北市板橋區	2018-11-24T22:35:36+08:00	146716	49125	195841	17974	213815	381710	56.02%	38.44%	287	338
8	新北市板橋區	2018-11-24T23:03:40+08:00	157835	52670	210505	19296	229801	410553	55.97%	38.44%	306	338
8	新北市板橋區	2018-11-24T23:22:14+08:00	164945	55009	219954	20117	240071	429875	55.85%	38.37%	318	338
8	新北市板橋區	2018-11-24T23:58:32+08:00	174930	58373	233303	21543	254846	458223	55.62%	38.18%	335	338
8	新北市板橋區	2018-11-25T03:37:15+08:00	176926	59047	235973	21774	257747	463411	55.62%	38.18%	338	338
8	新北市板橋區	2018-11-25T00:56:04+08:00	176926	59047	235973	21774	257747	463411	55.62%	38.18%	338	338
8	新北市板橋區	2018-11-24T23:14:31+08:00	161432	53809	215241	19674	234915	419971	55.94%	38.44%	312	338
8	新北市板橋區	2018-11-25T06:27:47+08:00	176926	59047	235973	21774	257747	463411	55.62%	38.18%	338	338
8	新北市板橋區	2018-11-24T22:21:36+08:00	135538	45436	180974	16571	197545	351871	56.14%	38.52%	268	338
8	新北市板橋區	2018-11-25T00:17:00+08:00	175641	58569	234210	21628	255838	459984	55.62%	38.18%	336	338
8	新北市板橋區	2018-11-25T03:42:37+08:00	176926	59047	235973	21774	257747	463411	55.62%	38.18%	338	338
8	新北市板橋區	2018-11-25T03:30:49+08:00	176926	59047	235973	21774	257747	463411	55.62%	38.18%	338	338
8	新北市板橋區	2018-11-24T22:25:15+08:00	138879	46509	185388	17038	202426	360836	56.1%	38.49%	274	338
8	新北市板橋區	2018-11-24T22:18:11+08:00	130641	43628	174269	15992	190261	338360	56.23%	38.61%	259	338
8	新北市板橋區	2018-11-24T22:14:40+08:00	127579	42605	170184	15519	185703	330204	56.24%	38.64%	254	338
8	新北市板橋區	2018-11-25T06:17:27+08:00	176926	59047	235973	21774	257747	463411	55.62%	38.18%	338	338
8	新北市板橋區	2018-11-24T22:56:29+08:00	156069	52149	208218	19101	227319	406215	55.96%	38.42%	303	338
8	新北市板橋區	2018-11-24T23:45:56+08:00	170525	57021	227546	21024	248570	445451	55.8%	38.28%	328	338
8	新北市板橋區	2018-11-25T00:07:55+08:00	175641	58569	234210	21628	255838	459984	55.62%	38.18%	336	338
8	新北市板橋區	2018-11-24T23:33:42+08:00	167211	55788	222999	20388	243387	436127	55.81%	38.34%	322	338
8	新北市板橋區	2018-11-24T23:10:49+08:00	160787	53615	214402	19611	234013	418516	55.91%	38.42%	311	338
8	新北市板橋區	2018-11-24T23:18:19+08:00	162176	54051	216227	19713	235940	421906	55.92%	38.44%	313	338
8	連江縣東引鄉	2018-11-24T23:10:59+08:00	484	78	562	16	578	1138	50.79%	42.53%	1	1
8	連江縣東引鄉	2018-11-24T22:49:27+08:00	484	78	562	16	578	1138	50.79%	42.53%	1	1
8	連江縣東引鄉	2018-11-24T23:22:27+08:00	484	78	562	16	578	1138	50.79%	42.53%	1	1
8	連江縣東引鄉	2018-11-24T23:18:31+08:00	484	78	562	16	578	1138	50.79%	42.53%	1	1
8	連江縣東引鄉	2018-11-24T23:33:54+08:00	484	78	562	16	578	1138	50.79%	42.53%	1	1
8	連江縣東引鄉	2018-11-24T22:12:06+08:00	0	0	0	0	0	0	0%	0%	0	1
8	連江縣東引鄉	2018-11-24T23:26:11+08:00	484	78	562	16	578	1138	50.79%	42.53%	1	1
8	連江縣東引鄉	2018-11-24T22:56:39+08:00	484	78	562	16	578	1138	50.79%	42.53%	1	1
8	連江縣東引鄉	2018-11-24T22:28:44+08:00	0	0	0	0	0	0	0%	0%	0	1
8	連江縣東引鄉	2018-11-24T23:37:52+08:00	484	78	562	16	578	1138	50.79%	42.53%	1	1
8	連江縣東引鄉	2018-11-24T22:53:19+08:00	484	78	562	16	578	1138	50.79%	42.53%	1	1
8	連江縣東引鄉	2018-11-24T22:32:21+08:00	0	0	0	0	0	0	0%	0%	0	1
8	連江縣東引鄉	2018-11-24T22:21:50+08:00	0	0	0	0	0	0	0%	0%	0	1
8	連江縣東引鄉	2018-11-25T04:01:33+08:00	484	78	562	16	578	1138	50.79%	42.53%	1	1
8	連江縣東引鄉	2018-11-24T23:46:07+08:00	484	78	562	16	578	1138	50.79%	42.53%	1	1
8	連江縣東引鄉	2018-11-25T01:11:12+08:00	484	78	562	16	578	1138	50.79%	42.53%	1	1
8	連江縣東引鄉	2018-11-25T00:08:08+08:00	484	78	562	16	578	1138	50.79%	42.53%	1	1
8	連江縣東引鄉	2018-11-24T23:00:20+08:00	484	78	562	16	578	1138	50.79%	42.53%	1	1
8	連江縣東引鄉	2018-11-24T22:25:29+08:00	0	0	0	0	0	0	0%	0%	0	1
8	連江縣東引鄉	2018-11-25T06:22:48+08:00	484	78	562	16	578	1138	50.79%	42.53%	1	1
8	連江縣東引鄉	2018-11-25T03:48:35+08:00	484	78	562	16	578	1138	50.79%	42.53%	1	1
8	連江縣東引鄉	2018-11-25T06:17:41+08:00	484	78	562	16	578	1138	50.79%	42.53%	1	1
8	連江縣東引鄉	2018-11-24T22:39:13+08:00	0	0	0	0	0	0	0%	0%	0	1
8	連江縣東引鄉	2018-11-25T00:12:49+08:00	484	78	562	16	578	1138	50.79%	42.53%	1	1
8	連江縣東引鄉	2018-11-25T03:37:33+08:00	484	78	562	16	578	1138	50.79%	42.53%	1	1
8	連江縣東引鄉	2018-11-24T22:18:23+08:00	0	0	0	0	0	0	0%	0%	0	1
8	連江縣東引鄉	2018-11-24T23:50:18+08:00	484	78	562	16	578	1138	50.79%	42.53%	1	1
8	連江縣東引鄉	2018-11-24T23:14:45+08:00	484	78	562	16	578	1138	50.79%	42.53%	1	1
8	連江縣東引鄉	2018-11-24T23:58:46+08:00	484	78	562	16	578	1138	50.79%	42.53%	1	1
8	連江縣東引鄉	2018-11-24T23:03:50+08:00	484	78	562	16	578	1138	50.79%	42.53%	1	1
8	連江縣東引鄉	2018-11-25T01:01:06+08:00	484	78	562	16	578	1138	50.79%	42.53%	1	1
8	連江縣東引鄉	2018-11-25T06:27:58+08:00	484	78	562	16	578	1138	50.79%	42.53%	1	1
8	連江縣東引鄉	2018-11-25T01:24:29+08:00	484	78	562	16	578	1138	50.79%	42.53%	1	1
8	連江縣東引鄉	2018-11-24T23:54:31+08:00	484	78	562	16	578	1138	50.79%	42.53%	1	1
8	連江縣東引鄉	2018-11-25T03:54:45+08:00	484	78	562	16	578	1138	50.79%	42.53%	1	1
8	連江縣東引鄉	2018-11-24T23:07:22+08:00	484	78	562	16	578	1138	50.79%	42.53%	1	1
8	連江縣東引鄉	2018-11-24T22:14:53+08:00	0	0	0	0	0	0	0%	0%	0	1
8	連江縣東引鄉	2018-11-25T06:12:40+08:00	484	78	562	16	578	1138	50.79%	42.53%	1	1
8	連江縣東引鄉	2018-11-24T23:29:50+08:00	484	78	562	16	578	1138	50.79%	42.53%	1	1
8	連江縣東引鄉	2018-11-25T00:17:12+08:00	484	78	562	16	578	1138	50.79%	42.53%	1	1
8	連江縣東引鄉	2018-11-24T23:42:05+08:00	484	78	562	16	578	1138	50.79%	42.53%	1	1
8	連江縣東引鄉	2018-11-25T01:06:04+08:00	484	78	562	16	578	1138	50.79%	42.53%	1	1
8	連江縣東引鄉	2018-11-25T00:21:47+08:00	484	78	562	16	578	1138	50.79%	42.53%	1	1
8	連江縣東引鄉	2018-11-25T03:42:52+08:00	484	78	562	16	578	1138	50.79%	42.53%	1	1
8	連江縣東引鄉	2018-11-25T06:07:26+08:00	484	78	562	16	578	1138	50.79%	42.53%	1	1
8	連江縣東引鄉	2018-11-24T22:40:22+08:00	0	0	0	0	0	0	0%	0%	0	1
8	連江縣東引鄉	2018-11-25T00:56:17+08:00	484	78	562	16	578	1138	50.79%	42.53%	1	1
8	連江縣東引鄉	2018-11-24T22:35:48+08:00	0	0	0	0	0	0	0%	0%	0	1
8	連江縣東引鄉	2018-11-24T22:43:54+08:00	484	78	562	16	578	1138	50.79%	42.53%	1	1
8	連江縣東引鄉	2018-11-25T03:31:03+08:00	484	78	562	16	578	1138	50.79%	42.53%	1	1
8	連江縣東引鄉	2018-11-25T01:16:26+08:00	484	78	562	16	578	1138	50.79%	42.53%	1	1
8	連江縣東引鄉	2018-11-25T00:03:39+08:00	484	78	562	16	578	1138	50.79%	42.53%	1	1
8	臺東縣金峰鄉	2018-11-24T23:26:10+08:00	714	216	930	148	1078	1787	60.32%	39.96%	4	5
8	臺東縣金峰鄉	2018-11-24T22:49:27+08:00	448	141	589	96	685	1267	54.06%	35.36%	3	5
8	臺東縣金峰鄉	2018-11-24T23:10:58+08:00	448	141	589	96	685	1267	54.06%	35.36%	3	5
8	臺東縣金峰鄉	2018-11-24T23:33:53+08:00	714	216	930	148	1078	1787	60.32%	39.96%	4	5
8	臺東縣金峰鄉	2018-11-24T22:56:39+08:00	448	141	589	96	685	1267	54.06%	35.36%	3	5
8	臺東縣金峰鄉	2018-11-24T23:22:26+08:00	714	216	930	148	1078	1787	60.32%	39.96%	4	5
8	臺東縣金峰鄉	2018-11-24T22:28:43+08:00	203	78	281	60	341	666	51.2%	30.48%	2	5
8	臺東縣金峰鄉	2018-11-24T23:18:30+08:00	448	141	589	96	685	1267	54.06%	35.36%	3	5
8	臺東縣金峰鄉	2018-11-25T00:17:11+08:00	714	216	930	148	1078	1787	60.32%	39.96%	4	5
8	臺東縣金峰鄉	2018-11-24T22:32:21+08:00	203	78	281	60	341	666	51.2%	30.48%	2	5
8	臺東縣金峰鄉	2018-11-24T23:46:06+08:00	714	216	930	148	1078	1787	60.32%	39.96%	4	5
8	臺東縣金峰鄉	2018-11-25T00:08:07+08:00	714	216	930	148	1078	1787	60.32%	39.96%	4	5
8	臺東縣金峰鄉	2018-11-24T22:53:18+08:00	448	141	589	96	685	1267	54.06%	35.36%	3	5
8	臺東縣金峰鄉	2018-11-25T04:01:32+08:00	1060	340	1400	212	1612	3028	53.24%	35.01%	5	5
8	臺東縣金峰鄉	2018-11-25T03:48:34+08:00	1060	340	1400	212	1612	3028	53.24%	35.01%	5	5
8	臺東縣金峰鄉	2018-11-24T23:00:19+08:00	448	141	589	96	685	1267	54.06%	35.36%	3	5
8	臺東縣金峰鄉	2018-11-24T22:25:28+08:00	203	78	281	60	341	666	51.2%	30.48%	2	5
8	臺東縣金峰鄉	2018-11-25T06:22:47+08:00	1060	340	1400	212	1612	3028	53.24%	35.01%	5	5
8	臺東縣金峰鄉	2018-11-25T03:42:51+08:00	1060	340	1400	212	1612	3028	53.24%	35.01%	5	5
8	臺東縣金峰鄉	2018-11-24T22:40:21+08:00	448	141	589	96	685	1267	54.06%	35.36%	3	5
8	臺東縣金峰鄉	2018-11-24T23:29:49+08:00	714	216	930	148	1078	1787	60.32%	39.96%	4	5
8	臺東縣金峰鄉	2018-11-24T23:14:44+08:00	448	141	589	96	685	1267	54.06%	35.36%	3	5
8	臺東縣金峰鄉	2018-11-24T23:50:17+08:00	714	216	930	148	1078	1787	60.32%	39.96%	4	5
8	臺東縣金峰鄉	2018-11-25T00:12:47+08:00	714	216	930	148	1078	1787	60.32%	39.96%	4	5
8	臺東縣金峰鄉	2018-11-25T03:37:33+08:00	1060	340	1400	212	1612	3028	53.24%	35.01%	5	5
8	臺東縣金峰鄉	2018-11-25T01:16:25+08:00	1060	340	1400	212	1612	3028	53.24%	35.01%	5	5
8	臺東縣金峰鄉	2018-11-24T22:18:22+08:00	79	39	118	34	152	330	46.06%	23.94%	1	5
8	臺東縣金峰鄉	2018-11-24T23:03:50+08:00	448	141	589	96	685	1267	54.06%	35.36%	3	5
8	臺東縣金峰鄉	2018-11-24T22:39:12+08:00	203	78	281	60	341	666	51.2%	30.48%	2	5
8	臺東縣金峰鄉	2018-11-25T06:27:58+08:00	1060	340	1400	212	1612	3028	53.24%	35.01%	5	5
8	臺東縣金峰鄉	2018-11-25T06:17:40+08:00	1060	340	1400	212	1612	3028	53.24%	35.01%	5	5
8	臺東縣金峰鄉	2018-11-25T03:54:44+08:00	1060	340	1400	212	1612	3028	53.24%	35.01%	5	5
8	臺東縣金峰鄉	2018-11-24T22:14:52+08:00	79	39	118	34	152	330	46.06%	23.94%	1	5
8	臺東縣金峰鄉	2018-11-25T01:24:28+08:00	1060	340	1400	212	1612	3028	53.24%	35.01%	5	5
8	臺東縣金峰鄉	2018-11-24T23:37:51+08:00	714	216	930	148	1078	1787	60.32%	39.96%	4	5
8	臺東縣金峰鄉	2018-11-24T23:07:22+08:00	448	141	589	96	685	1267	54.06%	35.36%	3	5
8	臺東縣金峰鄉	2018-11-24T22:12:05+08:00	0	0	0	0	0	0	0%	0%	0	5
8	臺東縣金峰鄉	2018-11-24T23:54:30+08:00	714	216	930	148	1078	1787	60.32%	39.96%	4	5
8	臺東縣金峰鄉	2018-11-25T06:12:40+08:00	1060	340	1400	212	1612	3028	53.24%	35.01%	5	5
8	臺東縣金峰鄉	2018-11-24T23:42:04+08:00	714	216	930	148	1078	1787	60.32%	39.96%	4	5
8	臺東縣金峰鄉	2018-11-25T01:06:03+08:00	1060	340	1400	212	1612	3028	53.24%	35.01%	5	5
8	臺東縣金峰鄉	2018-11-25T01:11:11+08:00	1060	340	1400	212	1612	3028	53.24%	35.01%	5	5
8	臺東縣金峰鄉	2018-11-25T00:21:47+08:00	714	216	930	148	1078	1787	60.32%	39.96%	4	5
8	臺東縣金峰鄉	2018-11-25T06:07:26+08:00	1060	340	1400	212	1612	3028	53.24%	35.01%	5	5
8	臺東縣金峰鄉	2018-11-24T22:21:49+08:00	79	39	118	34	152	330	46.06%	23.94%	1	5
8	臺東縣金峰鄉	2018-11-25T00:03:38+08:00	714	216	930	148	1078	1787	60.32%	39.96%	4	5
8	臺東縣金峰鄉	2018-11-24T22:43:53+08:00	448	141	589	96	685	1267	54.06%	35.36%	3	5
8	臺東縣金峰鄉	2018-11-24T22:35:47+08:00	203	78	281	60	341	666	51.2%	30.48%	2	5
8	臺東縣金峰鄉	2018-11-24T23:58:45+08:00	714	216	930	148	1078	1787	60.32%	39.96%	4	5
8	臺東縣金峰鄉	2018-11-25T01:01:05+08:00	1060	340	1400	212	1612	3028	53.24%	35.01%	5	5
8	臺東縣金峰鄉	2018-11-25T00:56:16+08:00	1060	340	1400	212	1612	3028	53.24%	35.01%	5	5
8	臺東縣金峰鄉	2018-11-25T03:31:02+08:00	1060	340	1400	212	1612	3028	53.24%	35.01%	5	5
8	臺東縣卑南鄉	2018-11-24T22:14:51+08:00	4521	1376	5897	726	6623	12903	51.33%	35.04%	20	22
8	臺東縣卑南鄉	2018-11-24T22:56:38+08:00	4811	1500	6311	782	7093	13871	51.14%	34.68%	21	22
8	臺東縣卑南鄉	2018-11-24T23:07:21+08:00	4811	1500	6311	782	7093	13871	51.14%	34.68%	21	22
8	臺東縣卑南鄉	2018-11-24T22:49:26+08:00	4521	1376	5897	726	6623	12903	51.33%	35.04%	20	22
8	臺東縣卑南鄉	2018-11-24T23:10:58+08:00	4811	1500	6311	782	7093	13871	51.14%	34.68%	21	22
8	臺東縣卑南鄉	2018-11-24T23:33:53+08:00	4811	1500	6311	782	7093	13871	51.14%	34.68%	21	22
8	臺東縣卑南鄉	2018-11-24T23:22:26+08:00	4811	1500	6311	782	7093	13871	51.14%	34.68%	21	22
8	臺東縣卑南鄉	2018-11-24T22:28:43+08:00	4521	1376	5897	726	6623	12903	51.33%	35.04%	20	22
8	臺東縣卑南鄉	2018-11-24T23:18:30+08:00	4811	1500	6311	782	7093	13871	51.14%	34.68%	21	22
8	臺東縣卑南鄉	2018-11-25T06:17:39+08:00	5255	1631	6886	835	7721	14976	51.56%	35.09%	22	22
8	臺東縣卑南鄉	2018-11-25T00:17:11+08:00	5255	1631	6886	835	7721	14976	51.56%	35.09%	22	22
8	臺東縣卑南鄉	2018-11-24T23:46:06+08:00	5255	1631	6886	835	7721	14976	51.56%	35.09%	22	22
8	臺東縣卑南鄉	2018-11-25T00:08:07+08:00	5255	1631	6886	835	7721	14976	51.56%	35.09%	22	22
8	臺東縣卑南鄉	2018-11-24T22:32:20+08:00	4521	1376	5897	726	6623	12903	51.33%	35.04%	20	22
8	臺東縣卑南鄉	2018-11-24T22:53:18+08:00	4521	1376	5897	726	6623	12903	51.33%	35.04%	20	22
8	臺東縣卑南鄉	2018-11-25T04:01:32+08:00	5255	1631	6886	835	7721	14976	51.56%	35.09%	22	22
8	臺東縣卑南鄉	2018-11-25T03:48:34+08:00	5255	1631	6886	835	7721	14976	51.56%	35.09%	22	22
8	臺東縣卑南鄉	2018-11-24T23:00:19+08:00	4811	1500	6311	782	7093	13871	51.14%	34.68%	21	22
8	臺東縣卑南鄉	2018-11-25T06:07:25+08:00	5255	1631	6886	835	7721	14976	51.56%	35.09%	22	22
8	臺東縣卑南鄉	2018-11-24T22:25:28+08:00	4521	1376	5897	726	6623	12903	51.33%	35.04%	20	22
8	臺東縣卑南鄉	2018-11-25T06:22:47+08:00	5255	1631	6886	835	7721	14976	51.56%	35.09%	22	22
8	臺東縣卑南鄉	2018-11-25T03:42:51+08:00	5255	1631	6886	835	7721	14976	51.56%	35.09%	22	22
8	臺東縣卑南鄉	2018-11-24T22:40:21+08:00	4521	1376	5897	726	6623	12903	51.33%	35.04%	20	22
8	臺東縣卑南鄉	2018-11-24T23:29:49+08:00	4811	1500	6311	782	7093	13871	51.14%	34.68%	21	22
8	臺東縣卑南鄉	2018-11-24T23:50:17+08:00	5255	1631	6886	835	7721	14976	51.56%	35.09%	22	22
8	臺東縣卑南鄉	2018-11-24T23:14:43+08:00	4811	1500	6311	782	7093	13871	51.14%	34.68%	21	22
8	臺東縣卑南鄉	2018-11-25T00:12:47+08:00	5255	1631	6886	835	7721	14976	51.56%	35.09%	22	22
8	臺東縣卑南鄉	2018-11-25T06:27:57+08:00	5255	1631	6886	835	7721	14976	51.56%	35.09%	22	22
8	臺東縣卑南鄉	2018-11-25T01:16:25+08:00	5255	1631	6886	835	7721	14976	51.56%	35.09%	22	22
8	臺東縣卑南鄉	2018-11-24T22:18:22+08:00	4521	1376	5897	726	6623	12903	51.33%	35.04%	20	22
8	臺東縣卑南鄉	2018-11-25T03:37:32+08:00	5255	1631	6886	835	7721	14976	51.56%	35.09%	22	22
8	臺東縣卑南鄉	2018-11-25T01:24:27+08:00	5255	1631	6886	835	7721	14976	51.56%	35.09%	22	22
8	臺東縣卑南鄉	2018-11-25T03:54:44+08:00	5255	1631	6886	835	7721	14976	51.56%	35.09%	22	22
8	臺東縣卑南鄉	2018-11-24T23:03:49+08:00	4811	1500	6311	782	7093	13871	51.14%	34.68%	21	22
8	臺東縣卑南鄉	2018-11-24T23:37:51+08:00	4811	1500	6311	782	7093	13871	51.14%	34.68%	21	22
8	臺東縣卑南鄉	2018-11-24T22:12:05+08:00	4521	1376	5897	726	6623	12903	51.33%	35.04%	20	22
8	臺東縣卑南鄉	2018-11-24T23:54:30+08:00	5255	1631	6886	835	7721	14976	51.56%	35.09%	22	22
8	臺東縣卑南鄉	2018-11-25T01:06:02+08:00	5255	1631	6886	835	7721	14976	51.56%	35.09%	22	22
8	臺東縣卑南鄉	2018-11-24T23:42:04+08:00	4811	1500	6311	782	7093	13871	51.14%	34.68%	21	22
8	臺東縣卑南鄉	2018-11-25T01:11:10+08:00	5255	1631	6886	835	7721	14976	51.56%	35.09%	22	22
8	臺東縣卑南鄉	2018-11-25T06:12:39+08:00	5255	1631	6886	835	7721	14976	51.56%	35.09%	22	22
8	臺東縣卑南鄉	2018-11-25T00:21:46+08:00	5255	1631	6886	835	7721	14976	51.56%	35.09%	22	22
8	臺東縣卑南鄉	2018-11-24T22:21:49+08:00	4521	1376	5897	726	6623	12903	51.33%	35.04%	20	22
8	臺東縣卑南鄉	2018-11-25T01:01:04+08:00	5255	1631	6886	835	7721	14976	51.56%	35.09%	22	22
8	臺東縣卑南鄉	2018-11-25T00:03:38+08:00	5255	1631	6886	835	7721	14976	51.56%	35.09%	22	22
8	臺東縣卑南鄉	2018-11-24T22:43:53+08:00	4521	1376	5897	726	6623	12903	51.33%	35.04%	20	22
8	臺東縣卑南鄉	2018-11-24T22:35:47+08:00	4521	1376	5897	726	6623	12903	51.33%	35.04%	20	22
8	臺東縣卑南鄉	2018-11-24T23:58:45+08:00	5255	1631	6886	835	7721	14976	51.56%	35.09%	22	22
8	臺東縣卑南鄉	2018-11-25T00:56:16+08:00	5255	1631	6886	835	7721	14976	51.56%	35.09%	22	22
8	臺東縣卑南鄉	2018-11-24T22:39:11+08:00	4521	1376	5897	726	6623	12903	51.33%	35.04%	20	22
8	臺東縣卑南鄉	2018-11-24T23:26:09+08:00	4811	1500	6311	782	7093	13871	51.14%	34.68%	21	22
8	臺東縣卑南鄉	2018-11-25T03:31:02+08:00	5255	1631	6886	835	7721	14976	51.56%	35.09%	22	22
8	臺中市大肚區	2018-11-24T22:49:18+08:00	13255	3674	16929	1415	18344	31770	57.74%	41.72%	23	33
8	臺中市大肚區	2018-11-25T00:56:06+08:00	19777	5502	25279	2139	27418	47457	57.77%	41.67%	33	33
8	臺中市大肚區	2018-11-24T23:14:33+08:00	17043	4812	21855	1862	23717	41080	57.73%	41.49%	29	33
8	臺中市大肚區	2018-11-24T23:22:16+08:00	18529	5175	23704	2034	25738	44572	57.74%	41.57%	31	33
8	臺中市大肚區	2018-11-24T22:56:31+08:00	13785	3827	17612	1478	19090	33162	57.57%	41.57%	24	33
8	臺中市大肚區	2018-11-25T00:12:39+08:00	19222	5337	24559	2082	26641	46201	57.66%	41.61%	32	33
8	臺中市大肚區	2018-11-24T23:03:42+08:00	15877	4476	20353	1710	22063	38301	57.6%	41.45%	27	33
8	臺中市大肚區	2018-11-24T23:10:51+08:00	17043	4812	21855	1862	23717	41080	57.73%	41.49%	29	33
8	臺中市大肚區	2018-11-25T03:37:18+08:00	19777	5502	25279	2139	27418	47457	57.77%	41.67%	33	33
8	臺中市大肚區	2018-11-24T22:43:44+08:00	12681	3497	16178	1353	17531	30434	57.6%	41.67%	22	33
8	臺中市大肚區	2018-11-25T00:03:26+08:00	19222	5337	24559	2082	26641	46201	57.66%	41.61%	32	33
8	臺中市大肚區	2018-11-25T01:10:59+08:00	19777	5502	25279	2139	27418	47457	57.77%	41.67%	33	33
8	臺中市大肚區	2018-11-25T06:22:39+08:00	19777	5502	25279	2139	27418	47457	57.77%	41.67%	33	33
8	臺中市大肚區	2018-11-24T22:25:18+08:00	10275	2786	13061	1069	14130	24749	57.09%	41.52%	18	33
8	臺中市大肚區	2018-11-24T23:29:40+08:00	18529	5175	23704	2034	25738	44572	57.74%	41.57%	31	33
8	臺中市大肚區	2018-11-25T00:17:02+08:00	19222	5337	24559	2082	26641	46201	57.66%	41.61%	32	33
8	臺中市大肚區	2018-11-25T00:07:58+08:00	19222	5337	24559	2082	26641	46201	57.66%	41.61%	32	33
8	臺中市大肚區	2018-11-25T01:16:15+08:00	19777	5502	25279	2139	27418	47457	57.77%	41.67%	33	33
8	臺中市大肚區	2018-11-25T01:05:52+08:00	19777	5502	25279	2139	27418	47457	57.77%	41.67%	33	33
8	臺中市大肚區	2018-11-24T22:14:42+08:00	9655	2565	12220	966	13186	22996	57.34%	41.99%	17	33
8	臺中市大肚區	2018-11-24T23:54:19+08:00	18529	5175	23704	2034	25738	44572	57.74%	41.57%	31	33
8	臺中市大肚區	2018-11-24T22:28:34+08:00	10275	2786	13061	1069	14130	24749	57.09%	41.52%	18	33
8	臺中市大肚區	2018-11-24T22:18:13+08:00	9655	2565	12220	966	13186	22996	57.34%	41.99%	17	33
8	臺中市大肚區	2018-11-25T01:24:17+08:00	19777	5502	25279	2139	27418	47457	57.77%	41.67%	33	33
8	臺中市大肚區	2018-11-24T22:35:39+08:00	10678	2910	13588	1125	14713	25611	57.45%	41.69%	19	33
8	臺中市大肚區	2018-11-24T23:50:09+08:00	18529	5175	23704	2034	25738	44572	57.74%	41.57%	31	33
8	臺中市大肚區	2018-11-24T23:58:35+08:00	19222	5337	24559	2082	26641	46201	57.66%	41.61%	32	33
8	臺中市大肚區	2018-11-25T06:27:49+08:00	19777	5502	25279	2139	27418	47457	57.77%	41.67%	33	33
8	臺中市大肚區	2018-11-24T22:39:03+08:00	12011	3312	15323	1287	16610	28914	57.45%	41.54%	21	33
8	臺中市大肚區	2018-11-24T23:07:13+08:00	16408	4625	21033	1766	22799	39595	57.58%	41.44%	28	33
8	臺中市大肚區	2018-11-25T01:00:53+08:00	19777	5502	25279	2139	27418	47457	57.77%	41.67%	33	33
8	臺中市大肚區	2018-11-24T23:00:08+08:00	15169	4277	19446	1600	21046	36571	57.55%	41.48%	26	33
8	臺中市大肚區	2018-11-25T03:48:22+08:00	19777	5502	25279	2139	27418	47457	57.77%	41.67%	33	33
8	臺中市大肚區	2018-11-25T00:21:37+08:00	19222	5337	24559	2082	26641	46201	57.66%	41.61%	32	33
8	臺中市大肚區	2018-11-25T03:30:52+08:00	19777	5502	25279	2139	27418	47457	57.77%	41.67%	33	33
8	臺中市大肚區	2018-11-25T03:42:41+08:00	19777	5502	25279	2139	27418	47457	57.77%	41.67%	33	33
8	臺中市大肚區	2018-11-24T22:21:39+08:00	10275	2786	13061	1069	14130	24749	57.09%	41.52%	18	33
8	臺中市大肚區	2018-11-24T22:32:12+08:00	10275	2786	13061	1069	14130	24749	57.09%	41.52%	18	33
8	臺中市大肚區	2018-11-24T22:53:08+08:00	13785	3827	17612	1478	19090	33162	57.57%	41.57%	24	33
8	臺中市大肚區	2018-11-25T04:01:22+08:00	19777	5502	25279	2139	27418	47457	57.77%	41.67%	33	33
8	臺中市大肚區	2018-11-24T22:11:57+08:00	9655	2565	12220	966	13186	22996	57.34%	41.99%	17	33
8	臺中市大肚區	2018-11-24T22:40:13+08:00	12011	3312	15323	1287	16610	28914	57.45%	41.54%	21	33
8	臺中市大肚區	2018-11-25T06:12:31+08:00	19777	5502	25279	2139	27418	47457	57.77%	41.67%	33	33
8	臺中市大肚區	2018-11-25T06:07:16+08:00	19777	5502	25279	2139	27418	47457	57.77%	41.67%	33	33
8	臺中市大肚區	2018-11-24T23:33:44+08:00	18529	5175	23704	2034	25738	44572	57.74%	41.57%	31	33
8	臺中市大肚區	2018-11-24T23:26:01+08:00	18529	5175	23704	2034	25738	44572	57.74%	41.57%	31	33
8	臺中市大肚區	2018-11-25T03:54:34+08:00	19777	5502	25279	2139	27418	47457	57.77%	41.67%	33	33
8	臺中市大肚區	2018-11-24T23:45:58+08:00	18529	5175	23704	2034	25738	44572	57.74%	41.57%	31	33
8	臺中市大肚區	2018-11-25T06:17:29+08:00	19777	5502	25279	2139	27418	47457	57.77%	41.67%	33	33
8	臺中市大肚區	2018-11-24T23:41:56+08:00	18529	5175	23704	2034	25738	44572	57.74%	41.57%	31	33
8	臺中市大肚區	2018-11-24T23:37:43+08:00	18529	5175	23704	2034	25738	44572	57.74%	41.57%	31	33
8	臺中市大肚區	2018-11-24T23:18:21+08:00	17043	4812	21855	1862	23717	41080	57.73%	41.49%	29	33
8	屏東縣九如鄉	2018-11-25T06:17:36+08:00	6601	2369	8970	1357	10327	19132	53.98%	34.5%	14	14
8	屏東縣九如鄉	2018-11-24T23:07:19+08:00	4940	1820	6760	990	7750	14485	53.5%	34.1%	11	14
8	屏東縣九如鄉	2018-11-24T23:10:56+08:00	5485	1963	7448	1112	8560	15967	53.61%	34.35%	12	14
8	屏東縣九如鄉	2018-11-24T22:39:09+08:00	3877	1450	5327	808	6135	11207	54.74%	34.59%	9	14
8	屏東縣九如鄉	2018-11-25T01:24:25+08:00	6601	2369	8970	1357	10327	19132	53.98%	34.5%	14	14
8	屏東縣九如鄉	2018-11-24T22:56:37+08:00	4382	1647	6029	933	6962	12807	54.36%	34.22%	10	14
8	屏東縣九如鄉	2018-11-25T03:54:41+08:00	6601	2369	8970	1357	10327	19132	53.98%	34.5%	14	14
8	屏東縣九如鄉	2018-11-24T22:32:19+08:00	3877	1450	5327	808	6135	11207	54.74%	34.59%	9	14
8	屏東縣九如鄉	2018-11-25T01:06:00+08:00	6601	2369	8970	1357	10327	19132	53.98%	34.5%	14	14
8	屏東縣九如鄉	2018-11-24T22:25:26+08:00	3877	1450	5327	808	6135	11207	54.74%	34.59%	9	14
8	屏東縣九如鄉	2018-11-24T23:00:17+08:00	4382	1647	6029	933	6962	12807	54.36%	34.22%	10	14
8	屏東縣九如鄉	2018-11-25T01:11:08+08:00	6601	2369	8970	1357	10327	19132	53.98%	34.5%	14	14
8	屏東縣九如鄉	2018-11-25T06:07:23+08:00	6601	2369	8970	1357	10327	19132	53.98%	34.5%	14	14
8	屏東縣九如鄉	2018-11-24T22:40:19+08:00	3877	1450	5327	808	6135	11207	54.74%	34.59%	9	14
8	屏東縣九如鄉	2018-11-24T23:29:47+08:00	5919	2119	8038	1201	9239	17133	53.93%	34.55%	13	14
8	屏東縣九如鄉	2018-11-25T00:21:45+08:00	6601	2369	8970	1357	10327	19132	53.98%	34.5%	14	14
8	屏東縣九如鄉	2018-11-25T03:31:00+08:00	6601	2369	8970	1357	10327	19132	53.98%	34.5%	14	14
8	屏東縣九如鄉	2018-11-25T00:03:35+08:00	6601	2369	8970	1357	10327	19132	53.98%	34.5%	14	14
8	屏東縣九如鄉	2018-11-25T00:56:14+08:00	6601	2369	8970	1357	10327	19132	53.98%	34.5%	14	14
8	屏東縣九如鄉	2018-11-24T23:54:27+08:00	6601	2369	8970	1357	10327	19132	53.98%	34.5%	14	14
8	屏東縣九如鄉	2018-11-24T22:35:45+08:00	3877	1450	5327	808	6135	11207	54.74%	34.59%	9	14
8	屏東縣九如鄉	2018-11-25T01:16:22+08:00	6601	2369	8970	1357	10327	19132	53.98%	34.5%	14	14
8	屏東縣九如鄉	2018-11-24T23:37:49+08:00	6601	2369	8970	1357	10327	19132	53.98%	34.5%	14	14
8	屏東縣九如鄉	2018-11-24T22:43:51+08:00	3877	1450	5327	808	6135	11207	54.74%	34.59%	9	14
8	屏東縣九如鄉	2018-11-25T06:27:56+08:00	6601	2369	8970	1357	10327	19132	53.98%	34.5%	14	14
8	屏東縣九如鄉	2018-11-24T23:22:24+08:00	5919	2119	8038	1201	9239	17133	53.93%	34.55%	13	14
8	屏東縣九如鄉	2018-11-24T22:28:41+08:00	3877	1450	5327	808	6135	11207	54.74%	34.59%	9	14
8	屏東縣九如鄉	2018-11-24T22:49:24+08:00	4382	1647	6029	933	6962	12807	54.36%	34.22%	10	14
8	屏東縣九如鄉	2018-11-24T22:12:03+08:00	3877	1450	5327	808	6135	11207	54.74%	34.59%	9	14
8	屏東縣九如鄉	2018-11-24T23:33:51+08:00	5919	2119	8038	1201	9239	17133	53.93%	34.55%	13	14
8	屏東縣九如鄉	2018-11-24T23:03:47+08:00	4940	1820	6760	990	7750	14485	53.5%	34.1%	11	14
8	屏東縣九如鄉	2018-11-25T04:01:30+08:00	6601	2369	8970	1357	10327	19132	53.98%	34.5%	14	14
8	屏東縣九如鄉	2018-11-25T03:42:49+08:00	6601	2369	8970	1357	10327	19132	53.98%	34.5%	14	14
8	屏東縣九如鄉	2018-11-24T23:42:02+08:00	6601	2369	8970	1357	10327	19132	53.98%	34.5%	14	14
8	屏東縣九如鄉	2018-11-25T00:08:05+08:00	6601	2369	8970	1357	10327	19132	53.98%	34.5%	14	14
8	屏東縣九如鄉	2018-11-24T22:53:15+08:00	4382	1647	6029	933	6962	12807	54.36%	34.22%	10	14
8	屏東縣九如鄉	2018-11-24T23:46:04+08:00	6601	2369	8970	1357	10327	19132	53.98%	34.5%	14	14
8	屏東縣九如鄉	2018-11-25T00:17:09+08:00	6601	2369	8970	1357	10327	19132	53.98%	34.5%	14	14
8	屏東縣九如鄉	2018-11-25T06:12:37+08:00	6601	2369	8970	1357	10327	19132	53.98%	34.5%	14	14
8	屏東縣九如鄉	2018-11-24T22:21:46+08:00	3877	1450	5327	808	6135	11207	54.74%	34.59%	9	14
8	屏東縣九如鄉	2018-11-25T06:22:45+08:00	6601	2369	8970	1357	10327	19132	53.98%	34.5%	14	14
8	屏東縣九如鄉	2018-11-25T03:48:31+08:00	6601	2369	8970	1357	10327	19132	53.98%	34.5%	14	14
8	屏東縣九如鄉	2018-11-24T22:14:49+08:00	3877	1450	5327	808	6135	11207	54.74%	34.59%	9	14
8	屏東縣九如鄉	2018-11-24T22:18:20+08:00	3877	1450	5327	808	6135	11207	54.74%	34.59%	9	14
8	屏東縣九如鄉	2018-11-25T03:37:30+08:00	6601	2369	8970	1357	10327	19132	53.98%	34.5%	14	14
8	屏東縣九如鄉	2018-11-24T23:58:43+08:00	6601	2369	8970	1357	10327	19132	53.98%	34.5%	14	14
8	屏東縣九如鄉	2018-11-24T23:26:07+08:00	5919	2119	8038	1201	9239	17133	53.93%	34.55%	13	14
8	屏東縣九如鄉	2018-11-25T00:12:45+08:00	6601	2369	8970	1357	10327	19132	53.98%	34.5%	14	14
8	屏東縣九如鄉	2018-11-25T01:01:02+08:00	6601	2369	8970	1357	10327	19132	53.98%	34.5%	14	14
8	屏東縣九如鄉	2018-11-24T23:18:28+08:00	5919	2119	8038	1201	9239	17133	53.93%	34.55%	13	14
8	屏東縣九如鄉	2018-11-24T23:14:41+08:00	5485	1963	7448	1112	8560	15967	53.61%	34.35%	12	14
8	屏東縣九如鄉	2018-11-24T23:50:15+08:00	6601	2369	8970	1357	10327	19132	53.98%	34.5%	14	14
8	屏東縣崁頂鄉	2018-11-24T23:10:57+08:00	3314	1165	4479	533	5012	9827	51%	33.72%	10	12
8	屏東縣崁頂鄉	2018-11-24T23:07:19+08:00	3314	1165	4479	533	5012	9827	51%	33.72%	10	12
8	屏東縣崁頂鄉	2018-11-24T22:14:50+08:00	2958	1051	4009	476	4485	8823	50.83%	33.53%	9	12
8	屏東縣崁頂鄉	2018-11-25T06:17:37+08:00	4227	1400	5627	649	6276	12270	51.15%	34.45%	12	12
8	屏東縣崁頂鄉	2018-11-25T01:24:25+08:00	4227	1400	5627	649	6276	12270	51.15%	34.45%	12	12
8	屏東縣崁頂鄉	2018-11-24T22:56:37+08:00	3314	1165	4479	533	5012	9827	51%	33.72%	10	12
8	屏東縣崁頂鄉	2018-11-24T22:32:19+08:00	2958	1051	4009	476	4485	8823	50.83%	33.53%	9	12
8	屏東縣崁頂鄉	2018-11-24T22:53:16+08:00	3314	1165	4479	533	5012	9827	51%	33.72%	10	12
8	屏東縣崁頂鄉	2018-11-25T01:06:00+08:00	4227	1400	5627	649	6276	12270	51.15%	34.45%	12	12
8	屏東縣崁頂鄉	2018-11-24T22:25:26+08:00	2958	1051	4009	476	4485	8823	50.83%	33.53%	9	12
8	屏東縣崁頂鄉	2018-11-25T01:11:08+08:00	4227	1400	5627	649	6276	12270	51.15%	34.45%	12	12
8	屏東縣崁頂鄉	2018-11-25T06:07:24+08:00	4227	1400	5627	649	6276	12270	51.15%	34.45%	12	12
8	屏東縣崁頂鄉	2018-11-24T23:00:18+08:00	3314	1165	4479	533	5012	9827	51%	33.72%	10	12
8	屏東縣崁頂鄉	2018-11-25T03:48:32+08:00	4227	1400	5627	649	6276	12270	51.15%	34.45%	12	12
8	屏東縣崁頂鄉	2018-11-24T22:40:19+08:00	2958	1051	4009	476	4485	8823	50.83%	33.53%	9	12
8	屏東縣崁頂鄉	2018-11-24T23:29:47+08:00	4227	1400	5627	649	6276	12270	51.15%	34.45%	12	12
8	屏東縣崁頂鄉	2018-11-25T00:21:45+08:00	4227	1400	5627	649	6276	12270	51.15%	34.45%	12	12
8	屏東縣崁頂鄉	2018-11-25T03:31:00+08:00	4227	1400	5627	649	6276	12270	51.15%	34.45%	12	12
8	屏東縣崁頂鄉	2018-11-25T01:16:23+08:00	4227	1400	5627	649	6276	12270	51.15%	34.45%	12	12
8	屏東縣崁頂鄉	2018-11-25T00:03:35+08:00	4227	1400	5627	649	6276	12270	51.15%	34.45%	12	12
8	屏東縣崁頂鄉	2018-11-25T00:56:14+08:00	4227	1400	5627	649	6276	12270	51.15%	34.45%	12	12
8	屏東縣崁頂鄉	2018-11-24T22:35:45+08:00	2958	1051	4009	476	4485	8823	50.83%	33.53%	9	12
8	屏東縣崁頂鄉	2018-11-24T23:14:42+08:00	3314	1165	4479	533	5012	9827	51%	33.72%	10	12
8	屏東縣崁頂鄉	2018-11-24T23:50:16+08:00	4227	1400	5627	649	6276	12270	51.15%	34.45%	12	12
8	屏東縣崁頂鄉	2018-11-24T23:37:49+08:00	4227	1400	5627	649	6276	12270	51.15%	34.45%	12	12
8	屏東縣崁頂鄉	2018-11-24T22:43:51+08:00	3314	1165	4479	533	5012	9827	51%	33.72%	10	12
8	屏東縣崁頂鄉	2018-11-25T06:27:56+08:00	4227	1400	5627	649	6276	12270	51.15%	34.45%	12	12
8	屏東縣崁頂鄉	2018-11-25T00:12:46+08:00	4227	1400	5627	649	6276	12270	51.15%	34.45%	12	12
8	屏東縣崁頂鄉	2018-11-24T23:54:28+08:00	4227	1400	5627	649	6276	12270	51.15%	34.45%	12	12
8	屏東縣崁頂鄉	2018-11-24T23:22:24+08:00	3732	1266	4998	580	5578	11017	50.63%	33.87%	11	12
8	屏東縣崁頂鄉	2018-11-24T22:28:41+08:00	2958	1051	4009	476	4485	8823	50.83%	33.53%	9	12
8	屏東縣崁頂鄉	2018-11-24T22:12:03+08:00	2958	1051	4009	476	4485	8823	50.83%	33.53%	9	12
8	屏東縣崁頂鄉	2018-11-24T23:33:51+08:00	4227	1400	5627	649	6276	12270	51.15%	34.45%	12	12
8	屏東縣崁頂鄉	2018-11-25T03:54:42+08:00	4227	1400	5627	649	6276	12270	51.15%	34.45%	12	12
8	屏東縣崁頂鄉	2018-11-24T23:03:48+08:00	3314	1165	4479	533	5012	9827	51%	33.72%	10	12
8	屏東縣崁頂鄉	2018-11-24T22:49:25+08:00	3314	1165	4479	533	5012	9827	51%	33.72%	10	12
8	屏東縣崁頂鄉	2018-11-25T04:01:30+08:00	4227	1400	5627	649	6276	12270	51.15%	34.45%	12	12
8	屏東縣崁頂鄉	2018-11-25T03:42:49+08:00	4227	1400	5627	649	6276	12270	51.15%	34.45%	12	12
8	屏東縣崁頂鄉	2018-11-24T23:42:02+08:00	4227	1400	5627	649	6276	12270	51.15%	34.45%	12	12
8	屏東縣崁頂鄉	2018-11-25T00:08:05+08:00	4227	1400	5627	649	6276	12270	51.15%	34.45%	12	12
8	屏東縣崁頂鄉	2018-11-24T23:46:04+08:00	4227	1400	5627	649	6276	12270	51.15%	34.45%	12	12
8	屏東縣崁頂鄉	2018-11-25T00:17:09+08:00	4227	1400	5627	649	6276	12270	51.15%	34.45%	12	12
8	屏東縣崁頂鄉	2018-11-25T06:12:37+08:00	4227	1400	5627	649	6276	12270	51.15%	34.45%	12	12
8	屏東縣崁頂鄉	2018-11-25T06:22:45+08:00	4227	1400	5627	649	6276	12270	51.15%	34.45%	12	12
8	屏東縣崁頂鄉	2018-11-24T22:21:47+08:00	2958	1051	4009	476	4485	8823	50.83%	33.53%	9	12
8	屏東縣崁頂鄉	2018-11-24T22:39:10+08:00	2958	1051	4009	476	4485	8823	50.83%	33.53%	9	12
8	屏東縣崁頂鄉	2018-11-24T22:18:20+08:00	2958	1051	4009	476	4485	8823	50.83%	33.53%	9	12
8	屏東縣崁頂鄉	2018-11-25T03:37:30+08:00	4227	1400	5627	649	6276	12270	51.15%	34.45%	12	12
8	屏東縣崁頂鄉	2018-11-24T23:58:43+08:00	4227	1400	5627	649	6276	12270	51.15%	34.45%	12	12
8	屏東縣崁頂鄉	2018-11-24T23:26:07+08:00	4227	1400	5627	649	6276	12270	51.15%	34.45%	12	12
8	屏東縣崁頂鄉	2018-11-25T01:01:02+08:00	4227	1400	5627	649	6276	12270	51.15%	34.45%	12	12
8	屏東縣崁頂鄉	2018-11-24T23:18:28+08:00	3732	1266	4998	580	5578	11017	50.63%	33.87%	11	12
8	臺中市東區	2018-11-25T03:37:17+08:00	26338	8256	34594	2732	37326	64291	58.06%	40.97%	49	49
8	臺中市東區	2018-11-24T23:10:50+08:00	24513	7744	32257	2591	34848	59642	58.43%	41.1%	46	49
8	臺中市東區	2018-11-25T00:56:06+08:00	26338	8256	34594	2732	37326	64291	58.06%	40.97%	49	49
8	臺中市東區	2018-11-24T23:22:16+08:00	24956	7914	32870	2657	35527	60748	58.48%	41.08%	47	49
8	臺中市東區	2018-11-25T01:10:58+08:00	26338	8256	34594	2732	37326	64291	58.06%	40.97%	49	49
8	臺中市東區	2018-11-25T00:12:37+08:00	25630	8056	33686	2722	36408	62441	58.31%	41.05%	48	49
8	臺中市東區	2018-11-24T22:49:17+08:00	24123	7628	31751	2520	34271	58689	58.39%	41.1%	45	49
8	臺中市東區	2018-11-24T23:14:32+08:00	24513	7744	32257	2591	34848	59642	58.43%	41.1%	46	49
8	臺中市東區	2018-11-24T22:43:43+08:00	24123	7628	31751	2520	34271	58689	58.39%	41.1%	45	49
8	臺中市東區	2018-11-25T00:03:26+08:00	25630	8056	33686	2722	36408	62441	58.31%	41.05%	48	49
8	臺中市東區	2018-11-24T22:56:30+08:00	24513	7744	32257	2591	34848	59642	58.43%	41.1%	46	49
8	臺中市東區	2018-11-25T03:48:21+08:00	26338	8256	34594	2732	37326	64291	58.06%	40.97%	49	49
8	臺中市東區	2018-11-25T06:22:38+08:00	26338	8256	34594	2732	37326	64291	58.06%	40.97%	49	49
8	臺中市東區	2018-11-25T03:30:51+08:00	26338	8256	34594	2732	37326	64291	58.06%	40.97%	49	49
8	臺中市東區	2018-11-25T04:01:21+08:00	26338	8256	34594	2732	37326	64291	58.06%	40.97%	49	49
8	臺中市東區	2018-11-24T22:25:17+08:00	21725	6882	28607	2286	30893	52698	58.62%	41.23%	41	49
8	臺中市東區	2018-11-25T06:07:15+08:00	26338	8256	34594	2732	37326	64291	58.06%	40.97%	49	49
8	臺中市東區	2018-11-24T23:29:40+08:00	24956	7914	32870	2657	35527	60748	58.48%	41.08%	47	49
8	臺中市東區	2018-11-24T22:18:12+08:00	20636	6496	27132	2196	29328	50060	58.59%	41.22%	39	49
8	臺中市東區	2018-11-24T23:54:18+08:00	25630	8056	33686	2722	36408	62441	58.31%	41.05%	48	49
8	臺中市東區	2018-11-25T00:07:57+08:00	25630	8056	33686	2722	36408	62441	58.31%	41.05%	48	49
8	臺中市東區	2018-11-25T01:16:14+08:00	26338	8256	34594	2732	37326	64291	58.06%	40.97%	49	49
8	臺中市東區	2018-11-24T23:41:55+08:00	25630	8056	33686	2722	36408	62441	58.31%	41.05%	48	49
8	臺中市東區	2018-11-24T22:28:33+08:00	21725	6882	28607	2286	30893	52698	58.62%	41.23%	41	49
8	臺中市東區	2018-11-24T23:58:34+08:00	25630	8056	33686	2722	36408	62441	58.31%	41.05%	48	49
8	臺中市東區	2018-11-24T23:50:08+08:00	25630	8056	33686	2722	36408	62441	58.31%	41.05%	48	49
8	臺中市東區	2018-11-25T01:24:16+08:00	26338	8256	34594	2732	37326	64291	58.06%	40.97%	49	49
8	臺中市東區	2018-11-24T22:35:38+08:00	22295	7071	29366	2365	31731	54189	58.56%	41.14%	42	49
8	臺中市東區	2018-11-24T23:07:12+08:00	24513	7744	32257	2591	34848	59642	58.43%	41.1%	46	49
8	臺中市東區	2018-11-24T22:39:02+08:00	22819	7255	30074	2405	32479	55575	58.44%	41.06%	43	49
8	臺中市東區	2018-11-25T06:27:48+08:00	26338	8256	34594	2732	37326	64291	58.06%	40.97%	49	49
8	臺中市東區	2018-11-24T23:03:41+08:00	24513	7744	32257	2591	34848	59642	58.43%	41.1%	46	49
8	臺中市東區	2018-11-25T01:00:53+08:00	26338	8256	34594	2732	37326	64291	58.06%	40.97%	49	49
8	臺中市東區	2018-11-24T22:21:38+08:00	21725	6882	28607	2286	30893	52698	58.62%	41.23%	41	49
8	臺中市東區	2018-11-25T03:42:40+08:00	26338	8256	34594	2732	37326	64291	58.06%	40.97%	49	49
8	臺中市東區	2018-11-24T23:00:07+08:00	24513	7744	32257	2591	34848	59642	58.43%	41.1%	46	49
8	臺中市東區	2018-11-25T00:21:36+08:00	25630	8056	33686	2722	36408	62441	58.31%	41.05%	48	49
8	臺中市東區	2018-11-24T22:32:12+08:00	21725	6882	28607	2286	30893	52698	58.62%	41.23%	41	49
8	臺中市東區	2018-11-25T06:12:30+08:00	26338	8256	34594	2732	37326	64291	58.06%	40.97%	49	49
8	臺中市東區	2018-11-24T22:40:12+08:00	24123	7628	31751	2520	34271	58689	58.39%	41.1%	45	49
8	臺中市東區	2018-11-25T00:17:01+08:00	25630	8056	33686	2722	36408	62441	58.31%	41.05%	48	49
8	臺中市東區	2018-11-24T22:53:07+08:00	24513	7744	32257	2591	34848	59642	58.43%	41.1%	46	49
8	臺中市東區	2018-11-24T22:11:56+08:00	20032	6326	26358	2160	28518	48579	58.7%	41.24%	38	49
8	臺中市東區	2018-11-25T03:54:33+08:00	26338	8256	34594	2732	37326	64291	58.06%	40.97%	49	49
8	臺中市東區	2018-11-25T01:05:51+08:00	26338	8256	34594	2732	37326	64291	58.06%	40.97%	49	49
8	臺中市東區	2018-11-24T23:33:43+08:00	25630	8056	33686	2722	36408	62441	58.31%	41.05%	48	49
8	臺中市東區	2018-11-24T23:18:20+08:00	24513	7744	32257	2591	34848	59642	58.43%	41.1%	46	49
8	臺中市東區	2018-11-25T06:17:29+08:00	26338	8256	34594	2732	37326	64291	58.06%	40.97%	49	49
8	臺中市東區	2018-11-24T23:37:42+08:00	25630	8056	33686	2722	36408	62441	58.31%	41.05%	48	49
8	臺中市東區	2018-11-24T22:14:41+08:00	20032	6326	26358	2160	28518	48579	58.7%	41.24%	38	49
8	臺中市東區	2018-11-24T23:26:00+08:00	24956	7914	32870	2657	35527	60748	58.48%	41.08%	47	49
8	臺中市東區	2018-11-24T23:45:57+08:00	25630	8056	33686	2722	36408	62441	58.31%	41.05%	48	49
8	臺中市清水區	2018-11-24T23:10:50+08:00	29182	8629	37811	3347	41158	70452	58.42%	41.42%	58	59
8	臺中市清水區	2018-11-25T00:56:06+08:00	29604	8760	38364	3373	41737	71528	58.35%	41.39%	59	59
8	臺中市清水區	2018-11-24T23:22:16+08:00	29604	8760	38364	3373	41737	71528	58.35%	41.39%	59	59
8	臺中市清水區	2018-11-24T22:49:17+08:00	29182	8629	37811	3347	41158	70452	58.42%	41.42%	58	59
8	臺中市清水區	2018-11-24T23:14:32+08:00	29182	8629	37811	3347	41158	70452	58.42%	41.42%	58	59
8	臺中市清水區	2018-11-25T03:37:18+08:00	29604	8760	38364	3373	41737	71528	58.35%	41.39%	59	59
8	臺中市清水區	2018-11-24T22:43:43+08:00	28400	8497	36897	3302	40199	68843	58.39%	41.25%	57	59
8	臺中市清水區	2018-11-25T00:03:26+08:00	29604	8760	38364	3373	41737	71528	58.35%	41.39%	59	59
8	臺中市清水區	2018-11-25T01:10:59+08:00	29604	8760	38364	3373	41737	71528	58.35%	41.39%	59	59
8	臺中市清水區	2018-11-24T22:56:30+08:00	29182	8629	37811	3347	41158	70452	58.42%	41.42%	58	59
8	臺中市清水區	2018-11-25T00:12:38+08:00	29604	8760	38364	3373	41737	71528	58.35%	41.39%	59	59
8	臺中市清水區	2018-11-25T06:22:39+08:00	29604	8760	38364	3373	41737	71528	58.35%	41.39%	59	59
8	臺中市清水區	2018-11-25T03:30:51+08:00	29604	8760	38364	3373	41737	71528	58.35%	41.39%	59	59
8	臺中市清水區	2018-11-24T22:25:17+08:00	27236	8163	35399	3150	38549	66108	58.31%	41.2%	55	59
8	臺中市清水區	2018-11-24T23:29:40+08:00	29604	8760	38364	3373	41737	71528	58.35%	41.39%	59	59
8	臺中市清水區	2018-11-24T23:54:18+08:00	29604	8760	38364	3373	41737	71528	58.35%	41.39%	59	59
8	臺中市清水區	2018-11-25T00:07:57+08:00	29604	8760	38364	3373	41737	71528	58.35%	41.39%	59	59
8	臺中市清水區	2018-11-25T01:16:14+08:00	29604	8760	38364	3373	41737	71528	58.35%	41.39%	59	59
8	臺中市清水區	2018-11-24T22:18:13+08:00	26594	7979	34573	3111	37684	64732	58.22%	41.08%	54	59
8	臺中市清水區	2018-11-24T22:28:33+08:00	27236	8163	35399	3150	38549	66108	58.31%	41.2%	55	59
8	臺中市清水區	2018-11-24T23:50:08+08:00	29604	8760	38364	3373	41737	71528	58.35%	41.39%	59	59
8	臺中市清水區	2018-11-25T01:24:16+08:00	29604	8760	38364	3373	41737	71528	58.35%	41.39%	59	59
8	臺中市清水區	2018-11-24T23:07:12+08:00	29182	8629	37811	3347	41158	70452	58.42%	41.42%	58	59
8	臺中市清水區	2018-11-24T22:39:02+08:00	27236	8163	35399	3150	38549	66108	58.31%	41.2%	55	59
8	臺中市清水區	2018-11-25T06:27:48+08:00	29604	8760	38364	3373	41737	71528	58.35%	41.39%	59	59
8	臺中市清水區	2018-11-24T22:35:39+08:00	27236	8163	35399	3150	38549	66108	58.31%	41.2%	55	59
8	臺中市清水區	2018-11-24T23:58:35+08:00	29604	8760	38364	3373	41737	71528	58.35%	41.39%	59	59
8	臺中市清水區	2018-11-24T23:03:41+08:00	29182	8629	37811	3347	41158	70452	58.42%	41.42%	58	59
8	臺中市清水區	2018-11-25T01:00:53+08:00	29604	8760	38364	3373	41737	71528	58.35%	41.39%	59	59
8	臺中市清水區	2018-11-25T03:48:22+08:00	29604	8760	38364	3373	41737	71528	58.35%	41.39%	59	59
8	臺中市清水區	2018-11-25T00:21:37+08:00	29604	8760	38364	3373	41737	71528	58.35%	41.39%	59	59
8	臺中市清水區	2018-11-25T03:42:40+08:00	29604	8760	38364	3373	41737	71528	58.35%	41.39%	59	59
8	臺中市清水區	2018-11-24T23:00:07+08:00	29182	8629	37811	3347	41158	70452	58.42%	41.42%	58	59
8	臺中市清水區	2018-11-24T22:21:39+08:00	27236	8163	35399	3150	38549	66108	58.31%	41.2%	55	59
8	臺中市清水區	2018-11-24T22:32:12+08:00	27236	8163	35399	3150	38549	66108	58.31%	41.2%	55	59
8	臺中市清水區	2018-11-25T04:01:22+08:00	29604	8760	38364	3373	41737	71528	58.35%	41.39%	59	59
8	臺中市清水區	2018-11-25T00:17:01+08:00	29604	8760	38364	3373	41737	71528	58.35%	41.39%	59	59
8	臺中市清水區	2018-11-24T22:40:13+08:00	27751	8320	36071	3222	39293	67319	58.37%	41.22%	56	59
8	臺中市清水區	2018-11-24T22:53:07+08:00	29182	8629	37811	3347	41158	70452	58.42%	41.42%	58	59
8	臺中市清水區	2018-11-25T06:12:31+08:00	29604	8760	38364	3373	41737	71528	58.35%	41.39%	59	59
8	臺中市清水區	2018-11-24T22:11:56+08:00	26594	7979	34573	3111	37684	64732	58.22%	41.08%	54	59
8	臺中市清水區	2018-11-25T06:07:16+08:00	29604	8760	38364	3373	41737	71528	58.35%	41.39%	59	59
8	臺中市清水區	2018-11-25T03:54:33+08:00	29604	8760	38364	3373	41737	71528	58.35%	41.39%	59	59
8	臺中市清水區	2018-11-25T01:05:51+08:00	29604	8760	38364	3373	41737	71528	58.35%	41.39%	59	59
8	臺中市清水區	2018-11-24T23:26:01+08:00	29604	8760	38364	3373	41737	71528	58.35%	41.39%	59	59
8	臺中市清水區	2018-11-24T23:33:43+08:00	29604	8760	38364	3373	41737	71528	58.35%	41.39%	59	59
8	臺中市清水區	2018-11-24T23:18:20+08:00	29182	8629	37811	3347	41158	70452	58.42%	41.42%	58	59
8	臺中市清水區	2018-11-25T06:17:29+08:00	29604	8760	38364	3373	41737	71528	58.35%	41.39%	59	59
8	臺中市清水區	2018-11-24T23:37:42+08:00	29604	8760	38364	3373	41737	71528	58.35%	41.39%	59	59
8	臺中市清水區	2018-11-24T22:14:41+08:00	26594	7979	34573	3111	37684	64732	58.22%	41.08%	54	59
8	臺中市清水區	2018-11-24T23:41:56+08:00	29604	8760	38364	3373	41737	71528	58.35%	41.39%	59	59
8	臺中市清水區	2018-11-24T23:45:57+08:00	29604	8760	38364	3373	41737	71528	58.35%	41.39%	59	59
8	臺北市內湖區	2018-11-24T23:07:11+08:00	51813	16030	67843	4243	72086	124486	57.91%	41.62%	82	150
8	臺北市內湖區	2018-11-25T01:05:49+08:00	94386	29205	123591	7670	131261	228383	57.47%	41.33%	145	150
8	臺北市內湖區	2018-11-24T22:49:16+08:00	42299	13090	55389	3460	58849	101583	57.93%	41.64%	67	150
8	臺北市內湖區	2018-11-24T22:39:01+08:00	38758	11992	50750	3162	53912	92226	58.46%	42.03%	62	150
8	臺北市內湖區	2018-11-24T22:43:42+08:00	38758	11992	50750	3162	53912	92226	58.46%	42.03%	62	150
8	臺北市內湖區	2018-11-25T01:24:15+08:00	95756	29620	125376	7790	133166	231674	57.48%	41.33%	147	150
8	臺北市內湖區	2018-11-24T23:50:05+08:00	74839	23193	98032	6064	104096	181176	57.46%	41.31%	116	150
8	臺北市內湖區	2018-11-24T22:39:00+08:00	38758	11992	50750	3162	53912	92226	58.46%	42.03%	62	150
8	臺北市內湖區	2018-11-25T03:37:16+08:00	97954	30319	128273	7966	136239	236824	57.53%	41.36%	150	150
8	臺北市內湖區	2018-11-25T01:10:57+08:00	94386	29205	123591	7670	131261	228383	57.47%	41.33%	145	150
8	臺北市內湖區	2018-11-24T23:50:04+08:00	74839	23193	98032	6064	104096	181176	57.46%	41.31%	116	150
8	臺北市內湖區	2018-11-25T01:24:14+08:00	95756	29620	125376	7790	133166	231674	57.48%	41.33%	147	150
8	臺北市內湖區	2018-11-25T00:12:36+08:00	80261	24886	105147	6476	111623	194036	57.53%	41.36%	124	150
8	臺北市內湖區	2018-11-25T06:22:37+08:00	97954	30319	128273	7966	136239	236824	57.53%	41.36%	150	150
8	臺北市內湖區	2018-11-24T22:32:10+08:00	38081	11789	49870	3097	52967	90572	58.48%	42.05%	61	150
8	臺北市內湖區	2018-11-24T23:29:38+08:00	67010	20728	87738	5450	93188	162582	57.32%	41.22%	105	150
8	臺北市內湖區	2018-11-25T06:22:36+08:00	97954	30319	128273	7966	136239	236824	57.53%	41.36%	150	150
8	臺北市內湖區	2018-11-25T06:12:29+08:00	97954	30319	128273	7966	136239	236824	57.53%	41.36%	150	150
8	臺北市內湖區	2018-11-25T00:21:35+08:00	84472	26086	110558	6855	117413	204213	57.5%	41.36%	130	150
8	臺北市內湖區	2018-11-24T23:00:03+08:00	46219	14199	60418	3765	64183	110787	57.93%	41.72%	73	150
8	臺北市內湖區	2018-11-25T03:48:20+08:00	97954	30319	128273	7966	136239	236824	57.53%	41.36%	150	150
8	臺北市內湖區	2018-11-24T23:25:59+08:00	65024	20120	85144	5309	90453	157661	57.37%	41.24%	102	150
8	臺北市內湖區	2018-11-24T23:29:39+08:00	67010	20728	87738	5450	93188	162582	57.32%	41.22%	105	150
8	臺北市內湖區	2018-11-24T23:00:04+08:00	46219	14199	60418	3765	64183	110787	57.93%	41.72%	73	150
8	臺北市內湖區	2018-11-25T01:00:51+08:00	94386	29205	123591	7670	131261	228383	57.47%	41.33%	145	150
8	臺北市內湖區	2018-11-25T06:07:14+08:00	97954	30319	128273	7966	136239	236824	57.53%	41.36%	150	150
8	臺北市內湖區	2018-11-24T22:53:05+08:00	45543	13984	59527	3715	63242	109038	58%	41.77%	72	150
8	臺北市內湖區	2018-11-24T22:40:11+08:00	38758	11992	50750	3162	53912	92226	58.46%	42.03%	62	150
8	臺北市內湖區	2018-11-24T22:25:16+08:00	36867	11395	48262	2991	51253	87782	58.39%	42%	59	150
8	臺北市內湖區	2018-11-24T22:11:55+08:00	30747	9607	40354	2535	42889	73547	58.32%	41.81%	50	150
8	臺北市內湖區	2018-11-25T04:01:20+08:00	97954	30319	128273	7966	136239	236824	57.53%	41.36%	150	150
8	臺北市內湖區	2018-11-25T01:16:12+08:00	94386	29205	123591	7670	131261	228383	57.47%	41.33%	145	150
8	臺北市內湖區	2018-11-25T00:07:56+08:00	77639	24022	101661	6308	107969	187810	57.49%	41.34%	120	150
8	臺北市內湖區	2018-11-24T23:37:41+08:00	71886	22305	94191	5824	100015	174344	57.37%	41.23%	112	150
8	臺北市內湖區	2018-11-24T23:41:54+08:00	73424	22740	96164	5932	102096	177822	57.41%	41.29%	114	150
8	臺北市內湖區	2018-11-24T22:28:32+08:00	36867	11395	48262	2991	51253	87782	58.39%	42%	59	150
8	臺北市內湖區	2018-11-25T01:16:13+08:00	94386	29205	123591	7670	131261	228383	57.47%	41.33%	145	150
8	臺北市內湖區	2018-11-25T03:54:31+08:00	97954	30319	128273	7966	136239	236824	57.53%	41.36%	150	150
8	臺北市內湖區	2018-11-24T23:54:17+08:00	75518	23366	98884	6099	104983	182622	57.49%	41.35%	117	150
8	臺北市內湖區	2018-11-25T00:03:24+08:00	77622	24039	101661	6311	107972	187663	57.54%	41.36%	120	150
8	臺北市內湖區	2018-11-24T22:35:36+08:00	38081	11789	49870	3097	52967	90572	58.48%	42.05%	61	150
8	臺北市內湖區	2018-11-25T00:16:59+08:00	81647	25255	106902	6607	113509	197486	57.48%	41.34%	126	150
8	臺北市內湖區	2018-11-24T23:22:15+08:00	62825	19439	82264	5111	87375	152475	57.3%	41.2%	99	150
8	臺北市內湖區	2018-11-24T23:58:33+08:00	76280	23600	99880	6175	106055	184365	57.52%	41.37%	118	150
8	臺北市內湖區	2018-11-24T22:14:39+08:00	32906	10233	43139	2686	45825	78643	58.27%	41.84%	53	150
8	臺北市內湖區	2018-11-24T23:03:40+08:00	48868	14982	63850	3974	67824	116786	58.08%	41.84%	77	150
8	臺北市內湖區	2018-11-24T23:14:30+08:00	55097	17034	72131	4484	76615	132357	57.89%	41.63%	87	150
8	臺北市內湖區	2018-11-24T23:22:14+08:00	62825	19439	82264	5111	87375	152475	57.3%	41.2%	99	150
8	臺北市內湖區	2018-11-24T23:58:32+08:00	76280	23600	99880	6175	106055	184365	57.52%	41.37%	118	150
8	臺北市內湖區	2018-11-24T22:35:37+08:00	38081	11789	49870	3097	52967	90572	58.48%	42.05%	61	150
8	臺北市內湖區	2018-11-25T03:37:15+08:00	97954	30319	128273	7966	136239	236824	57.53%	41.36%	150	150
8	臺北市內湖區	2018-11-25T00:56:04+08:00	93727	28976	122703	7595	130298	226651	57.49%	41.35%	144	150
8	臺北市內湖區	2018-11-24T23:14:31+08:00	55097	17034	72131	4484	76615	132357	57.89%	41.63%	87	150
8	臺北市內湖區	2018-11-25T06:27:47+08:00	97954	30319	128273	7966	136239	236824	57.53%	41.36%	150	150
8	臺北市內湖區	2018-11-24T22:21:36+08:00	36867	11395	48262	2991	51253	87782	58.39%	42%	59	150
8	臺北市內湖區	2018-11-24T22:21:37+08:00	36867	11395	48262	2991	51253	87782	58.39%	42%	59	150
8	臺北市內湖區	2018-11-25T00:17:00+08:00	81647	25255	106902	6607	113509	197486	57.48%	41.34%	126	150
8	臺北市內湖區	2018-11-25T03:30:49+08:00	97954	30319	128273	7966	136239	236824	57.53%	41.36%	150	150
8	臺北市內湖區	2018-11-25T03:42:36+08:00	97954	30319	128273	7966	136239	236824	57.53%	41.36%	150	150
8	臺北市內湖區	2018-11-24T22:25:15+08:00	36867	11395	48262	2991	51253	87782	58.39%	42%	59	150
8	臺北市內湖區	2018-11-25T03:42:38+08:00	97954	30319	128273	7966	136239	236824	57.53%	41.36%	150	150
8	臺北市內湖區	2018-11-24T22:18:11+08:00	34262	10618	44880	2818	47698	81714	58.37%	41.93%	55	150
8	臺北市內湖區	2018-11-24T22:28:31+08:00	36867	11395	48262	2991	51253	87782	58.39%	42%	59	150
8	臺北市內湖區	2018-11-24T23:10:48+08:00	53074	16455	69529	4342	73871	127531	57.92%	41.62%	84	150
8	臺北市內湖區	2018-11-24T22:14:40+08:00	32906	10233	43139	2686	45825	78643	58.27%	41.84%	53	150
8	臺北市內湖區	2018-11-25T06:17:27+08:00	97954	30319	128273	7966	136239	236824	57.53%	41.36%	150	150
8	臺北市內湖區	2018-11-24T22:56:29+08:00	46219	14199	60418	3765	64183	110787	57.93%	41.72%	73	150
8	臺北市內湖區	2018-11-24T23:45:56+08:00	74115	22936	97051	6004	103055	179448	57.43%	41.3%	115	150
8	臺北市內湖區	2018-11-25T00:07:55+08:00	77639	24022	101661	6308	107969	187810	57.49%	41.34%	120	150
8	臺北市內湖區	2018-11-24T23:33:42+08:00	69228	21413	90641	5642	96283	167803	57.38%	41.26%	108	150
8	臺北市內湖區	2018-11-24T23:10:49+08:00	53074	16455	69529	4342	73871	127531	57.92%	41.62%	84	150
8	臺北市內湖區	2018-11-25T03:54:32+08:00	97954	30319	128273	7966	136239	236824	57.53%	41.36%	150	150
8	臺北市內湖區	2018-11-24T23:18:19+08:00	57039	17623	74662	4637	79299	136996	57.88%	41.64%	90	150
8	臺北市	2018-11-24T23:07:11+08:00	516308	172423	688731	50749	739480	1293279	57.18%	39.92%	939	1
8	臺北市	2018-11-25T01:05:49+08:00	805361	267112	1072473	77893	1150366	2008933	57.26%	40.09%	420	1
8	臺北市	2018-11-25T01:10:56+08:00	813680	269429	1083109	78607	1161716	2027843	57.29%	40.13%	433	1
8	臺北市	2018-11-24T22:39:00+08:00	406576	136511	543087	40458	583545	1020231	57.2%	39.85%	750	1
8	臺北市	2018-11-24T23:50:04+08:00	643780	214322	858102	62380	920482	1609443	57.19%	40%	153	1
8	臺北市	2018-11-25T01:24:14+08:00	825254	273323	1098577	79701	1178278	2057341	57.27%	40.11%	452	1
8	臺北市	2018-11-25T00:12:36+08:00	696446	231657	928103	67499	995602	1740513	57.2%	40.01%	242	1
8	臺北市	2018-11-24T22:32:10+08:00	393901	132310	526211	39215	565426	988075	57.23%	39.87%	728	1
8	臺北市	2018-11-25T01:00:50+08:00	802831	266282	1069113	77675	1146788	2002888	57.26%	40.08%	416	1
8	臺北市	2018-11-24T23:29:38+08:00	588246	195701	783947	57256	841203	1473182	57.1%	39.93%	061	1
8	臺北市	2018-11-25T03:48:19+08:00	892660	295984	1188644	86198	1274842	2228430	57.21%	40.06%	563	1
8	臺北市	2018-11-25T06:22:36+08:00	892660	295984	1188644	86198	1274842	2228430	57.21%	40.06%	563	1
8	臺北市	2018-11-25T06:12:29+08:00	892660	295984	1188644	86198	1274842	2228430	57.21%	40.06%	563	1
8	臺北市	2018-11-25T00:21:35+08:00	733013	243644	976657	71035	1047692	1832172	57.18%	40.01%	302	1
8	臺北市	2018-11-24T23:00:03+08:00	474450	158502	632952	46844	679796	1189496	57.15%	39.89%	867	1
8	臺北市	2018-11-24T23:25:59+08:00	578727	192837	771564	56509	828073	1450340	57.1%	39.9%	046	1
8	臺北市	2018-11-25T06:07:13+08:00	892660	295984	1188644	86198	1274842	2228430	57.21%	40.06%	563	1
8	臺北市	2018-11-24T22:40:11+08:00	414655	139049	553704	41224	594928	1039484	57.23%	39.89%	763	1
8	臺北市	2018-11-24T22:11:55+08:00	320340	107705	428045	32095	460140	804448	57.2%	39.82%	600	1
8	臺北市	2018-11-25T04:01:20+08:00	892660	295984	1188644	86198	1274842	2228430	57.21%	40.06%	563	1
8	臺北市	2018-11-24T22:53:04+08:00	451383	151011	602394	44681	647075	1131842	57.17%	39.88%	828	1
8	臺北市	2018-11-25T01:16:12+08:00	819254	271357	1090611	79128	1169739	2042051	57.28%	40.12%	442	1
8	臺北市	2018-11-24T23:45:55+08:00	639815	213021	852836	62005	914841	1599653	57.19%	40%	146	1
8	臺北市	2018-11-24T23:37:41+08:00	611007	203232	814239	59346	873585	1529120	57.13%	39.96%	099	1
8	臺北市	2018-11-24T23:54:16+08:00	652380	217021	869401	63224	932625	1630433	57.2%	40.01%	168	1
8	臺北市	2018-11-24T23:41:53+08:00	620331	206403	826734	60224	886958	1551499	57.17%	39.98%	114	1
8	臺北市	2018-11-25T03:54:31+08:00	892660	295984	1188644	86198	1274842	2228430	57.21%	40.06%	563	1
8	臺北市	2018-11-24T23:33:41+08:00	595599	198160	793759	57875	851634	1491170	57.11%	39.94%	073	1
8	臺北市	2018-11-24T22:35:36+08:00	401139	134675	535814	39854	575668	1005848	57.23%	39.88%	740	1
8	臺北市	2018-11-25T00:16:59+08:00	717455	238569	956024	69470	1025494	1793986	57.16%	39.99%	277	1
8	臺北市	2018-11-25T00:03:23+08:00	679795	226439	906234	66012	972246	1699893	57.19%	39.99%	215	1
8	臺北市	2018-11-24T22:14:39+08:00	334844	112660	447504	33484	480988	842430	57.1%	39.75%	626	1
8	臺北市	2018-11-24T22:43:41+08:00	420092	140851	560943	41777	602720	1054108	57.18%	39.85%	773	1
8	臺北市	2018-11-25T06:27:46+08:00	892660	295984	1188644	86198	1274842	2228430	57.21%	40.06%	563	1
8	臺北市	2018-11-24T22:49:15+08:00	442064	148042	590106	43776	633882	1109090	57.15%	39.86%	812	1
8	臺北市	2018-11-24T23:14:30+08:00	535008	178670	713678	52431	766109	1340379	57.16%	39.91%	972	1
8	臺北市	2018-11-24T23:22:14+08:00	566035	188567	754602	55274	809876	1417619	57.13%	39.93%	024	1
8	臺北市	2018-11-24T23:58:32+08:00	672802	223869	896671	65242	961913	1681711	57.2%	40.01%	203	1
8	臺北市	2018-11-25T03:37:15+08:00	892660	295984	1188644	86198	1274842	2228430	57.21%	40.06%	563	1
8	臺北市	2018-11-25T00:56:03+08:00	792726	263030	1055756	76764	1132520	1978368	57.25%	40.07%	400	1
8	臺北市	2018-11-24T22:21:36+08:00	355153	119721	474874	35388	510262	892714	57.16%	39.78%	661	1
8	臺北市	2018-11-25T03:30:49+08:00	892247	295828	1188075	86167	1274242	2227286	57.21%	40.06%	562	1
8	臺北市	2018-11-25T03:42:36+08:00	892660	295984	1188644	86198	1274842	2228430	57.21%	40.06%	563	1
8	臺北市	2018-11-24T22:25:15+08:00	376568	126445	503013	37367	540380	944434	57.22%	39.87%	697	1
8	臺北市	2018-11-24T22:28:31+08:00	384216	128946	513162	38205	551367	963764	57.21%	39.87%	711	1
8	臺北市	2018-11-24T23:10:48+08:00	525070	175334	700404	51503	751907	1315223	57.17%	39.92%	954	1
8	臺北市	2018-11-25T06:17:27+08:00	892660	295984	1188644	86198	1274842	2228430	57.21%	40.06%	563	1
8	臺北市	2018-11-24T22:56:29+08:00	461236	154344	615580	45572	661152	1156398	57.17%	39.89%	845	1
8	臺北市	2018-11-24T23:18:18+08:00	544507	181764	726271	53331	779602	1362857	57.2%	39.95%	988	1
8	臺北市	2018-11-24T23:03:39+08:00	501911	167556	669467	49412	718879	1256913	57.19%	39.93%	914	1
8	臺北市	2018-11-25T00:07:55+08:00	687837	229001	916838	66798	983636	1719904	57.19%	39.99%	228	1
8	臺北市	2018-11-24T22:18:10+08:00	344419	116025	460444	34392	494836	866102	57.13%	39.77%	643	1
8	基隆市安樂區	2018-11-24T23:10:59+08:00	14866	4285	19151	1193	20344	39337	51.72%	37.79%	31	49
8	基隆市安樂區	2018-11-24T23:22:27+08:00	17569	4900	22469	1357	23826	46237	51.53%	38%	35	49
8	基隆市安樂區	2018-11-24T23:18:31+08:00	16857	4779	21636	1312	22948	44336	51.76%	38.02%	34	49
8	基隆市安樂區	2018-11-24T22:49:28+08:00	12783	3719	16502	1042	17544	33386	52.55%	38.29%	27	49
8	基隆市安樂區	2018-11-24T23:33:54+08:00	19342	5326	24668	1468	26136	50712	51.54%	38.14%	37	49
8	基隆市安樂區	2018-11-24T22:12:06+08:00	8626	2524	11150	751	11901	22830	52.13%	37.78%	20	49
8	基隆市安樂區	2018-11-24T23:26:11+08:00	17569	4900	22469	1357	23826	46237	51.53%	38%	35	49
8	基隆市安樂區	2018-11-24T22:28:44+08:00	10522	3038	13560	890	14450	27794	51.99%	37.86%	23	49
8	基隆市安樂區	2018-11-24T23:37:52+08:00	19761	5443	25204	1511	26715	51925	51.45%	38.06%	38	49
8	基隆市安樂區	2018-11-24T22:53:19+08:00	12783	3719	16502	1042	17544	33386	52.55%	38.29%	27	49
8	基隆市安樂區	2018-11-24T22:21:50+08:00	9971	2874	12845	845	13690	26395	51.87%	37.78%	22	49
8	基隆市安樂區	2018-11-25T04:01:33+08:00	26895	7380	34275	1970	36245	70396	51.49%	38.21%	49	49
8	基隆市安樂區	2018-11-25T00:08:09+08:00	23469	6403	29872	1775	31647	61453	51.5%	38.19%	44	49
8	基隆市安樂區	2018-11-24T23:46:07+08:00	21828	5950	27778	1611	29389	57496	51.11%	37.96%	41	49
8	基隆市安樂區	2018-11-25T01:11:12+08:00	26363	7229	33592	1928	35520	68996	51.48%	38.21%	48	49
8	基隆市安樂區	2018-11-24T23:00:20+08:00	13402	3863	17265	1071	18336	35059	52.3%	38.23%	28	49
8	基隆市安樂區	2018-11-24T22:25:29+08:00	9971	2874	12845	845	13690	26395	51.87%	37.78%	22	49
8	基隆市安樂區	2018-11-25T06:22:48+08:00	26895	7380	34275	1970	36245	70396	51.49%	38.21%	49	49
8	基隆市安樂區	2018-11-25T03:48:35+08:00	26895	7380	34275	1970	36245	70396	51.49%	38.21%	49	49
8	基隆市安樂區	2018-11-25T06:27:59+08:00	26895	7380	34275	1970	36245	70396	51.49%	38.21%	49	49
8	基隆市安樂區	2018-11-25T06:17:41+08:00	26895	7380	34275	1970	36245	70396	51.49%	38.21%	49	49
8	基隆市安樂區	2018-11-24T22:39:13+08:00	10522	3038	13560	890	14450	27794	51.99%	37.86%	23	49
8	基隆市安樂區	2018-11-25T03:37:34+08:00	26895	7380	34275	1970	36245	70396	51.49%	38.21%	49	49
8	基隆市安樂區	2018-11-25T00:12:49+08:00	24072	6603	30675	1819	32494	63094	51.5%	38.15%	45	49
8	基隆市安樂區	2018-11-24T22:18:23+08:00	9971	2874	12845	845	13690	26395	51.87%	37.78%	22	49
8	基隆市安樂區	2018-11-24T23:50:18+08:00	22782	6229	29011	1747	30758	59885	51.36%	38.04%	43	49
8	基隆市安樂區	2018-11-24T23:14:45+08:00	16178	4600	20778	1266	22044	42735	51.58%	37.86%	33	49
8	基隆市安樂區	2018-11-24T23:58:46+08:00	22782	6229	29011	1747	30758	59885	51.36%	38.04%	43	49
8	基隆市安樂區	2018-11-24T22:56:40+08:00	13402	3863	17265	1071	18336	35059	52.3%	38.23%	28	49
8	基隆市安樂區	2018-11-24T23:03:50+08:00	14380	4140	18520	1166	19686	37780	52.11%	38.06%	30	49
8	基隆市安樂區	2018-11-25T01:01:06+08:00	26363	7229	33592	1928	35520	68996	51.48%	38.21%	48	49
8	基隆市安樂區	2018-11-25T01:24:29+08:00	26895	7380	34275	1970	36245	70396	51.49%	38.21%	49	49
8	基隆市安樂區	2018-11-24T23:54:31+08:00	22782	6229	29011	1747	30758	59885	51.36%	38.04%	43	49
8	基隆市安樂區	2018-11-24T23:07:23+08:00	14866	4285	19151	1193	20344	39337	51.72%	37.79%	31	49
8	基隆市安樂區	2018-11-25T03:54:45+08:00	26895	7380	34275	1970	36245	70396	51.49%	38.21%	49	49
8	基隆市安樂區	2018-11-25T00:03:40+08:00	22782	6229	29011	1747	30758	59885	51.36%	38.04%	43	49
8	基隆市安樂區	2018-11-24T22:14:53+08:00	8626	2524	11150	751	11901	22830	52.13%	37.78%	20	49
8	基隆市安樂區	2018-11-24T23:29:50+08:00	18636	5111	23747	1407	25154	48750	51.6%	38.23%	36	49
8	基隆市安樂區	2018-11-25T00:17:12+08:00	24790	6827	31617	1859	33476	64996	51.5%	38.14%	46	49
8	基隆市安樂區	2018-11-24T22:32:22+08:00	10522	3038	13560	890	14450	27794	51.99%	37.86%	23	49
8	基隆市安樂區	2018-11-24T23:42:05+08:00	20380	5598	25978	1544	27522	53848	51.11%	37.85%	39	49
8	基隆市安樂區	2018-11-25T06:12:41+08:00	26895	7380	34275	1970	36245	70396	51.49%	38.21%	49	49
8	基隆市安樂區	2018-11-25T01:06:04+08:00	26363	7229	33592	1928	35520	68996	51.48%	38.21%	48	49
8	基隆市安樂區	2018-11-25T03:42:52+08:00	26895	7380	34275	1970	36245	70396	51.49%	38.21%	49	49
8	基隆市安樂區	2018-11-24T22:40:22+08:00	10522	3038	13560	890	14450	27794	51.99%	37.86%	23	49
8	基隆市安樂區	2018-11-25T00:21:48+08:00	25598	7005	32603	1871	34474	67036	51.43%	38.19%	47	49
8	基隆市安樂區	2018-11-25T06:07:27+08:00	26895	7380	34275	1970	36245	70396	51.49%	38.21%	49	49
8	基隆市安樂區	2018-11-25T00:56:17+08:00	26363	7229	33592	1928	35520	68996	51.48%	38.21%	48	49
8	基隆市安樂區	2018-11-24T22:35:48+08:00	10522	3038	13560	890	14450	27794	51.99%	37.86%	23	49
8	基隆市安樂區	2018-11-24T22:43:54+08:00	11019	3145	14164	907	15071	28934	52.09%	38.08%	24	49
8	基隆市安樂區	2018-11-25T03:31:03+08:00	26895	7380	34275	1970	36245	70396	51.49%	38.21%	49	49
8	基隆市安樂區	2018-11-25T01:16:26+08:00	26895	7380	34275	1970	36245	70396	51.49%	38.21%	49	49
8	高雄市岡山區	2018-11-24T22:49:20+08:00	21331	6661	27992	2185	30177	49858	60.53%	42.78%	48	72
8	高雄市岡山區	2018-11-25T03:37:21+08:00	35021	10410	45431	3363	48794	81244	60.06%	43.11%	72	72
8	高雄市岡山區	2018-11-24T23:03:43+08:00	23596	7306	30902	2409	33311	55473	60.05%	42.54%	52	72
8	高雄市岡山區	2018-11-24T23:58:37+08:00	31256	9441	40697	3074	43771	73131	59.85%	42.74%	66	72
8	高雄市岡山區	2018-11-25T00:03:29+08:00	31943	9637	41580	3147	44727	74724	59.86%	42.75%	67	72
8	高雄市岡山區	2018-11-25T00:56:09+08:00	35021	10410	45431	3363	48794	81244	60.06%	43.11%	72	72
8	高雄市岡山區	2018-11-24T23:22:19+08:00	27466	8343	35809	2755	38564	64580	59.72%	42.53%	59	72
8	高雄市岡山區	2018-11-25T03:42:43+08:00	35021	10410	45431	3363	48794	81244	60.06%	43.11%	72	72
8	高雄市岡山區	2018-11-24T22:53:10+08:00	22409	6989	29398	2297	31695	52634	60.22%	42.58%	50	72
8	高雄市岡山區	2018-11-25T00:08:00+08:00	31943	9637	41580	3147	44727	74724	59.86%	42.75%	67	72
8	高雄市岡山區	2018-11-24T23:46:00+08:00	30165	9128	39293	2982	42275	70670	59.82%	42.68%	64	72
8	高雄市岡山區	2018-11-25T01:00:56+08:00	35021	10410	45431	3363	48794	81244	60.06%	43.11%	72	72
8	高雄市岡山區	2018-11-25T06:12:33+08:00	35021	10410	45431	3363	48794	81244	60.06%	43.11%	72	72
8	高雄市岡山區	2018-11-25T00:17:04+08:00	31943	9637	41580	3147	44727	74724	59.86%	42.75%	67	72
8	高雄市岡山區	2018-11-25T06:22:41+08:00	35021	10410	45431	3363	48794	81244	60.06%	43.11%	72	72
8	高雄市岡山區	2018-11-24T22:25:20+08:00	17061	5400	22461	1817	24278	40365	60.15%	42.27%	40	72
8	高雄市岡山區	2018-11-24T23:18:23+08:00	25725	7938	33663	2612	36275	60301	60.16%	42.66%	56	72
8	高雄市岡山區	2018-11-24T22:18:15+08:00	16504	5207	21711	1764	23475	39070	60.08%	42.24%	39	72
8	高雄市岡山區	2018-11-24T22:14:44+08:00	15291	4832	20123	1664	21787	36297	60.02%	42.13%	37	72
8	高雄市岡山區	2018-11-24T23:50:11+08:00	30648	9278	39926	3037	42963	71767	59.86%	42.7%	65	72
8	高雄市岡山區	2018-11-25T01:05:54+08:00	35021	10410	45431	3363	48794	81244	60.06%	43.11%	72	72
8	高雄市岡山區	2018-11-24T23:33:46+08:00	28616	8589	37205	2807	40012	66854	59.85%	42.8%	61	72
8	高雄市岡山區	2018-11-25T06:27:51+08:00	35021	10410	45431	3363	48794	81244	60.06%	43.11%	72	72
8	高雄市岡山區	2018-11-24T23:26:03+08:00	27466	8343	35809	2755	38564	64580	59.72%	42.53%	59	72
8	高雄市岡山區	2018-11-25T03:54:36+08:00	35021	10410	45431	3363	48794	81244	60.06%	43.11%	72	72
8	高雄市岡山區	2018-11-25T00:12:41+08:00	31943	9637	41580	3147	44727	74724	59.86%	42.75%	67	72
8	高雄市岡山區	2018-11-25T01:24:20+08:00	35021	10410	45431	3363	48794	81244	60.06%	43.11%	72	72
8	高雄市岡山區	2018-11-24T22:43:46+08:00	20280	6326	26606	2070	28676	47488	60.39%	42.71%	46	72
8	高雄市岡山區	2018-11-25T06:17:32+08:00	35021	10410	45431	3363	48794	81244	60.06%	43.11%	72	72
8	高雄市岡山區	2018-11-24T23:07:15+08:00	23596	7306	30902	2409	33311	55473	60.05%	42.54%	52	72
8	高雄市岡山區	2018-11-24T22:39:05+08:00	19150	6102	25252	2022	27274	45293	60.22%	42.28%	44	72
8	高雄市岡山區	2018-11-24T22:56:33+08:00	23009	7163	30172	2345	32517	54146	60.05%	42.49%	51	72
8	高雄市岡山區	2018-11-24T23:14:36+08:00	24642	7629	32271	2506	34777	57753	60.22%	42.67%	54	72
8	高雄市岡山區	2018-11-24T23:10:52+08:00	24159	7476	31635	2465	34100	56710	60.13%	42.6%	53	72
8	高雄市岡山區	2018-11-25T03:48:25+08:00	35021	10410	45431	3363	48794	81244	60.06%	43.11%	72	72
8	高雄市岡山區	2018-11-24T22:32:14+08:00	18021	5729	23750	1964	25714	42562	60.42%	42.34%	42	72
8	高雄市岡山區	2018-11-25T03:30:54+08:00	35021	10410	45431	3363	48794	81244	60.06%	43.11%	72	72
8	高雄市岡山區	2018-11-24T22:40:15+08:00	19150	6102	25252	2022	27274	45293	60.22%	42.28%	44	72
8	高雄市岡山區	2018-11-25T00:21:40+08:00	32542	9816	42358	3210	45568	76149	59.84%	42.73%	68	72
8	高雄市岡山區	2018-11-24T23:29:42+08:00	27466	8343	35809	2755	38564	64580	59.72%	42.53%	59	72
8	高雄市岡山區	2018-11-25T01:11:02+08:00	35021	10410	45431	3363	48794	81244	60.06%	43.11%	72	72
8	高雄市岡山區	2018-11-24T23:00:13+08:00	23009	7163	30172	2345	32517	54146	60.05%	42.49%	51	72
8	高雄市岡山區	2018-11-24T22:11:59+08:00	14352	4544	18896	1585	20481	34129	60.01%	42.05%	35	72
8	高雄市岡山區	2018-11-24T22:21:41+08:00	17061	5400	22461	1817	24278	40365	60.15%	42.27%	40	72
8	高雄市岡山區	2018-11-25T06:07:18+08:00	35021	10410	45431	3363	48794	81244	60.06%	43.11%	72	72
8	高雄市岡山區	2018-11-25T04:01:24+08:00	35021	10410	45431	3363	48794	81244	60.06%	43.11%	72	72
8	高雄市岡山區	2018-11-24T22:28:36+08:00	17559	5588	23147	1897	25044	41524	60.31%	42.29%	41	72
8	高雄市岡山區	2018-11-24T22:35:41+08:00	19150	6102	25252	2022	27274	45293	60.22%	42.28%	44	72
8	高雄市岡山區	2018-11-24T23:37:45+08:00	29103	8766	37869	2842	40711	68267	59.63%	42.63%	62	72
8	高雄市岡山區	2018-11-24T23:41:58+08:00	29103	8766	37869	2842	40711	68267	59.63%	42.63%	62	72
8	高雄市岡山區	2018-11-24T23:54:22+08:00	31256	9441	40697	3074	43771	73131	59.85%	42.74%	66	72
8	高雄市岡山區	2018-11-25T01:16:17+08:00	35021	10410	45431	3363	48794	81244	60.06%	43.11%	72	72
8	高雄市前鎮區	2018-11-24T22:49:20+08:00	32394	10879	43273	3960	47233	82521	57.24%	39.26%	65	119
8	高雄市前鎮區	2018-11-25T03:37:21+08:00	63622	21376	84998	7668	92666	161797	57.27%	39.32%	119	119
8	高雄市前鎮區	2018-11-24T23:03:43+08:00	36920	12441	49361	4522	53883	93896	57.39%	39.32%	73	119
8	高雄市前鎮區	2018-11-24T23:58:37+08:00	56837	18715	75552	6760	82312	143903	57.2%	39.5%	107	119
8	高雄市前鎮區	2018-11-25T06:17:31+08:00	63622	21376	84998	7668	92666	161797	57.27%	39.32%	119	119
8	高雄市前鎮區	2018-11-24T23:22:18+08:00	44310	14660	58970	5323	64293	112841	56.98%	39.27%	86	119
8	高雄市前鎮區	2018-11-25T00:03:29+08:00	56837	18715	75552	6760	82312	143903	57.2%	39.5%	107	119
8	高雄市前鎮區	2018-11-24T23:14:35+08:00	41867	13942	55809	5047	60856	106116	57.35%	39.45%	82	119
8	高雄市前鎮區	2018-11-25T00:56:09+08:00	62442	20904	83346	7536	90882	158629	57.29%	39.36%	116	119
8	高雄市前鎮區	2018-11-25T03:42:43+08:00	63622	21376	84998	7668	92666	161797	57.27%	39.32%	119	119
8	高雄市前鎮區	2018-11-24T22:53:10+08:00	33444	11285	44729	4115	48844	85285	57.27%	39.21%	67	119
8	高雄市前鎮區	2018-11-25T00:08:00+08:00	57969	19201	77170	6913	84083	146938	57.22%	39.45%	109	119
8	高雄市前鎮區	2018-11-25T01:00:56+08:00	62442	20904	83346	7536	90882	158629	57.29%	39.36%	116	119
8	高雄市前鎮區	2018-11-24T22:25:19+08:00	25097	8507	33604	3237	36841	64238	57.35%	39.07%	53	119
8	高雄市前鎮區	2018-11-25T06:12:33+08:00	63622	21376	84998	7668	92666	161797	57.27%	39.32%	119	119
8	高雄市前鎮區	2018-11-25T00:17:03+08:00	59407	19739	79146	7103	86249	150498	57.31%	39.47%	111	119
8	高雄市前鎮區	2018-11-25T06:22:41+08:00	63622	21376	84998	7668	92666	161797	57.27%	39.32%	119	119
8	高雄市前鎮區	2018-11-24T23:18:23+08:00	42420	14132	56552	5152	61704	107842	57.22%	39.34%	83	119
8	高雄市前鎮區	2018-11-24T23:50:10+08:00	55836	18427	74263	6668	80931	141423	57.23%	39.48%	105	119
8	高雄市前鎮區	2018-11-24T22:18:15+08:00	23353	7896	31249	2979	34228	59883	57.16%	39%	50	119
8	高雄市前鎮區	2018-11-24T22:14:44+08:00	21589	7299	28888	2758	31646	55499	57.02%	38.9%	47	119
8	高雄市前鎮區	2018-11-25T01:05:54+08:00	62442	20904	83346	7536	90882	158629	57.29%	39.36%	116	119
8	高雄市前鎮區	2018-11-24T23:54:21+08:00	56300	18575	74875	6703	81578	142519	57.24%	39.5%	106	119
8	高雄市前鎮區	2018-11-24T23:33:46+08:00	48023	15987	64010	5820	69830	122421	57.04%	39.23%	92	119
8	高雄市前鎮區	2018-11-25T06:27:51+08:00	63622	21376	84998	7668	92666	161797	57.27%	39.32%	119	119
8	高雄市前鎮區	2018-11-24T23:26:03+08:00	45661	15166	60827	5508	66335	116217	57.08%	39.29%	88	119
8	高雄市前鎮區	2018-11-25T03:54:36+08:00	63622	21376	84998	7668	92666	161797	57.27%	39.32%	119	119
8	高雄市前鎮區	2018-11-25T00:12:41+08:00	59407	19739	79146	7103	86249	150498	57.31%	39.47%	111	119
8	高雄市前鎮區	2018-11-24T22:56:32+08:00	34010	11487	45497	4217	49714	86888	57.22%	39.14%	68	119
8	高雄市前鎮區	2018-11-24T22:43:46+08:00	29291	9948	39239	3648	42887	75055	57.14%	39.03%	60	119
8	高雄市前鎮區	2018-11-25T01:24:19+08:00	62442	20904	83346	7536	90882	158629	57.29%	39.36%	116	119
8	高雄市前鎮區	2018-11-24T22:39:04+08:00	29291	9948	39239	3648	42887	75055	57.14%	39.03%	60	119
8	高雄市前鎮區	2018-11-24T23:10:52+08:00	40133	13435	53568	4894	58462	102121	57.25%	39.3%	79	119
8	高雄市前鎮區	2018-11-24T23:07:14+08:00	38480	12910	51390	4713	56103	97752	57.39%	39.36%	76	119
8	高雄市前鎮區	2018-11-25T00:21:39+08:00	60059	19992	80051	7197	87248	152333	57.27%	39.43%	112	119
8	高雄市前鎮區	2018-11-24T22:32:14+08:00	26138	8898	35036	3340	38376	67067	57.22%	38.97%	55	119
8	高雄市前鎮區	2018-11-25T03:30:54+08:00	63622	21376	84998	7668	92666	161797	57.27%	39.32%	119	119
8	高雄市前鎮區	2018-11-25T03:48:24+08:00	63622	21376	84998	7668	92666	161797	57.27%	39.32%	119	119
8	高雄市前鎮區	2018-11-24T22:40:15+08:00	29291	9948	39239	3648	42887	75055	57.14%	39.03%	60	119
8	高雄市前鎮區	2018-11-24T23:29:42+08:00	46323	15405	61728	5579	67307	118230	56.93%	39.18%	89	119
8	高雄市前鎮區	2018-11-25T01:11:02+08:00	62442	20904	83346	7536	90882	158629	57.29%	39.36%	116	119
8	高雄市前鎮區	2018-11-24T23:00:13+08:00	34010	11487	45497	4217	49714	86888	57.22%	39.14%	68	119
8	高雄市前鎮區	2018-11-24T22:21:41+08:00	24414	8286	32700	3163	35863	62643	57.25%	38.97%	52	119
8	高雄市前鎮區	2018-11-25T06:07:18+08:00	63622	21376	84998	7668	92666	161797	57.27%	39.32%	119	119
8	高雄市前鎮區	2018-11-24T22:11:58+08:00	20664	6976	27640	2627	30267	52826	57.3%	39.12%	45	119
8	高雄市前鎮區	2018-11-25T04:01:24+08:00	63622	21376	84998	7668	92666	161797	57.27%	39.32%	119	119
8	高雄市前鎮區	2018-11-24T22:28:36+08:00	25588	8716	34304	3265	37569	65545	57.32%	39.04%	54	119
8	高雄市前鎮區	2018-11-24T23:41:57+08:00	52565	17397	69962	6281	76243	132894	57.37%	39.55%	100	119
8	高雄市前鎮區	2018-11-24T22:35:41+08:00	27923	9569	37492	3557	41049	71901	57.09%	38.84%	58	119
8	高雄市前鎮區	2018-11-24T23:37:45+08:00	50400	16690	67090	6037	73127	128086	57.09%	39.35%	96	119
8	高雄市前鎮區	2018-11-24T23:45:59+08:00	54458	17940	72398	6466	78864	137010	57.56%	39.75%	103	119
8	高雄市前鎮區	2018-11-25T01:16:17+08:00	62442	20904	83346	7536	90882	158629	57.29%	39.36%	116	119
8	新竹縣湖口鄉	2018-11-24T22:39:06+08:00	11516	3068	14584	1012	15596	27506	56.7%	41.87%	22	47
8	新竹縣湖口鄉	2018-11-24T23:03:44+08:00	15408	4074	19482	1281	20763	36848	56.35%	41.82%	29	47
8	新竹縣湖口鄉	2018-11-24T23:22:20+08:00	17102	4592	21694	1417	23111	40961	56.42%	41.75%	32	47
8	新竹縣湖口鄉	2018-11-24T23:58:39+08:00	21549	5714	27263	1709	28972	52099	55.61%	41.36%	39	47
8	新竹縣湖口鄉	2018-11-24T22:49:21+08:00	13735	3605	17340	1135	18475	32686	56.52%	42.02%	26	47
8	新竹縣湖口鄉	2018-11-25T03:42:44+08:00	26304	7039	33343	2124	35467	63511	55.84%	41.42%	47	47
8	新竹縣湖口鄉	2018-11-24T23:46:01+08:00	20306	5384	25690	1614	27304	49112	55.6%	41.35%	37	47
8	新竹縣湖口鄉	2018-11-25T01:00:57+08:00	26304	7039	33343	2124	35467	63511	55.84%	41.42%	47	47
8	新竹縣湖口鄉	2018-11-25T03:48:26+08:00	26304	7039	33343	2124	35467	63511	55.84%	41.42%	47	47
8	新竹縣湖口鄉	2018-11-24T22:53:11+08:00	13735	3605	17340	1135	18475	32686	56.52%	42.02%	26	47
8	新竹縣湖口鄉	2018-11-25T00:08:01+08:00	22156	5869	28025	1779	29804	53446	55.76%	41.45%	40	47
8	新竹縣湖口鄉	2018-11-24T22:21:42+08:00	8699	2331	11030	789	11819	21251	55.62%	40.93%	17	47
8	新竹縣湖口鄉	2018-11-25T04:01:26+08:00	26304	7039	33343	2124	35467	63511	55.84%	41.42%	47	47
8	新竹縣湖口鄉	2018-11-25T06:12:34+08:00	26304	7039	33343	2124	35467	63511	55.84%	41.42%	47	47
8	新竹縣湖口鄉	2018-11-24T22:40:16+08:00	12055	3196	15251	1031	16282	28708	56.72%	41.99%	23	47
8	新竹縣湖口鄉	2018-11-24T22:25:20+08:00	8699	2331	11030	789	11819	21251	55.62%	40.93%	17	47
8	新竹縣湖口鄉	2018-11-25T00:17:05+08:00	22903	6041	28944	1837	30781	55175	55.79%	41.51%	41	47
8	新竹縣湖口鄉	2018-11-24T23:18:24+08:00	16477	4388	20865	1369	22234	39456	56.35%	41.76%	31	47
8	新竹縣湖口鄉	2018-11-24T23:37:46+08:00	19885	5245	25130	1566	26696	48062	55.54%	41.37%	36	47
8	新竹縣湖口鄉	2018-11-24T22:35:42+08:00	11006	2954	13960	971	14931	26403	56.55%	41.68%	21	47
8	新竹縣湖口鄉	2018-11-25T03:54:37+08:00	26304	7039	33343	2124	35467	63511	55.84%	41.42%	47	47
8	新竹縣湖口鄉	2018-11-24T23:33:47+08:00	18436	4866	23302	1463	24765	44282	55.93%	41.63%	34	47
8	新竹縣湖口鄉	2018-11-25T01:05:55+08:00	26304	7039	33343	2124	35467	63511	55.84%	41.42%	47	47
8	新竹縣湖口鄉	2018-11-24T23:26:04+08:00	17102	4592	21694	1417	23111	40961	56.42%	41.75%	32	47
8	新竹縣湖口鄉	2018-11-24T22:14:45+08:00	7103	1905	9008	626	9634	17196	56.02%	41.31%	14	47
8	新竹縣湖口鄉	2018-11-24T23:07:15+08:00	15921	4235	20156	1330	21486	38123	56.36%	41.76%	30	47
8	新竹縣湖口鄉	2018-11-24T23:14:37+08:00	16477	4388	20865	1369	22234	39456	56.35%	41.76%	31	47
8	新竹縣湖口鄉	2018-11-24T23:10:53+08:00	15921	4235	20156	1330	21486	38123	56.36%	41.76%	30	47
8	新竹縣湖口鄉	2018-11-25T06:17:33+08:00	26304	7039	33343	2124	35467	63511	55.84%	41.42%	47	47
8	新竹縣湖口鄉	2018-11-24T22:43:47+08:00	12658	3343	16001	1062	17063	30342	56.24%	41.72%	24	47
8	新竹縣湖口鄉	2018-11-24T22:56:33+08:00	14287	3770	18057	1196	19253	33958	56.7%	42.07%	27	47
8	新竹縣湖口鄉	2018-11-25T01:24:21+08:00	26304	7039	33343	2124	35467	63511	55.84%	41.42%	47	47
8	新竹縣湖口鄉	2018-11-25T03:37:23+08:00	26304	7039	33343	2124	35467	63511	55.84%	41.42%	47	47
8	新竹縣湖口鄉	2018-11-25T03:30:55+08:00	26304	7039	33343	2124	35467	63511	55.84%	41.42%	47	47
8	新竹縣湖口鄉	2018-11-24T22:32:15+08:00	10461	2786	13247	928	14175	25215	56.22%	41.49%	20	47
8	新竹縣湖口鄉	2018-11-24T22:11:59+08:00	7103	1905	9008	626	9634	17196	56.02%	41.31%	14	47
8	新竹縣湖口鄉	2018-11-24T23:00:14+08:00	14854	3912	18766	1253	20019	35419	56.52%	41.94%	28	47
8	新竹縣湖口鄉	2018-11-25T06:07:19+08:00	26304	7039	33343	2124	35467	63511	55.84%	41.42%	47	47
8	新竹縣湖口鄉	2018-11-25T01:11:03+08:00	26304	7039	33343	2124	35467	63511	55.84%	41.42%	47	47
8	新竹縣湖口鄉	2018-11-24T23:29:43+08:00	17905	4752	22657	1442	24099	42838	56.26%	41.8%	33	47
8	新竹縣湖口鄉	2018-11-25T00:21:41+08:00	23356	6150	29506	1876	31382	56233	55.81%	41.53%	42	47
8	新竹縣湖口鄉	2018-11-25T06:22:42+08:00	26304	7039	33343	2124	35467	63511	55.84%	41.42%	47	47
8	新竹縣湖口鄉	2018-11-25T00:56:10+08:00	26304	7039	33343	2124	35467	63511	55.84%	41.42%	47	47
8	新竹縣湖口鄉	2018-11-24T22:18:16+08:00	7655	2059	9714	672	10386	18598	55.84%	41.16%	15	47
8	新竹縣湖口鄉	2018-11-24T23:54:24+08:00	20997	5572	26569	1662	28231	50605	55.79%	41.49%	38	47
8	新竹縣湖口鄉	2018-11-24T23:41:59+08:00	20306	5384	25690	1614	27304	49112	55.6%	41.35%	37	47
8	新竹縣湖口鄉	2018-11-25T01:16:18+08:00	26304	7039	33343	2124	35467	63511	55.84%	41.42%	47	47
8	新竹縣湖口鄉	2018-11-25T06:27:52+08:00	26304	7039	33343	2124	35467	63511	55.84%	41.42%	47	47
8	新竹縣湖口鄉	2018-11-25T00:12:42+08:00	22156	5869	28025	1779	29804	53446	55.76%	41.45%	40	47
8	新竹縣湖口鄉	2018-11-24T22:28:37+08:00	9204	2461	11665	825	12490	22333	55.93%	41.21%	18	47
8	新竹縣湖口鄉	2018-11-25T00:03:30+08:00	21549	5714	27263	1709	28972	52099	55.61%	41.36%	39	47
8	新竹縣湖口鄉	2018-11-24T23:50:12+08:00	20997	5572	26569	1662	28231	50605	55.79%	41.49%	38	47
8	雲林縣崙背鄉	2018-11-24T22:39:08+08:00	6216	2154	8370	982	9352	19830	47.16%	31.35%	19	20
8	雲林縣崙背鄉	2018-11-25T03:37:28+08:00	6625	2318	8943	1083	10026	21050	47.63%	31.47%	20	20
8	雲林縣崙背鄉	2018-11-24T23:07:18+08:00	6625	2318	8943	1083	10026	21050	47.63%	31.47%	20	20
8	雲林縣崙背鄉	2018-11-25T01:24:23+08:00	6625	2318	8943	1083	10026	21050	47.63%	31.47%	20	20
8	雲林縣崙背鄉	2018-11-25T03:54:40+08:00	6625	2318	8943	1083	10026	21050	47.63%	31.47%	20	20
8	雲林縣崙背鄉	2018-11-24T22:32:18+08:00	6216	2154	8370	982	9352	19830	47.16%	31.35%	19	20
8	雲林縣崙背鄉	2018-11-25T03:30:58+08:00	6625	2318	8943	1083	10026	21050	47.63%	31.47%	20	20
8	雲林縣崙背鄉	2018-11-24T23:42:01+08:00	6625	2318	8943	1083	10026	21050	47.63%	31.47%	20	20
8	雲林縣崙背鄉	2018-11-25T03:48:29+08:00	6625	2318	8943	1083	10026	21050	47.63%	31.47%	20	20
8	雲林縣崙背鄉	2018-11-24T22:21:45+08:00	5599	1945	7544	858	8402	17468	48.1%	32.05%	17	20
8	雲林縣崙背鄉	2018-11-25T06:07:22+08:00	6625	2318	8943	1083	10026	21050	47.63%	31.47%	20	20
8	雲林縣崙背鄉	2018-11-25T04:01:28+08:00	6625	2318	8943	1083	10026	21050	47.63%	31.47%	20	20
8	雲林縣崙背鄉	2018-11-25T00:21:43+08:00	6625	2318	8943	1083	10026	21050	47.63%	31.47%	20	20
8	雲林縣崙背鄉	2018-11-25T01:11:06+08:00	6625	2318	8943	1083	10026	21050	47.63%	31.47%	20	20
8	雲林縣崙背鄉	2018-11-24T22:40:18+08:00	6216	2154	8370	982	9352	19830	47.16%	31.35%	19	20
8	雲林縣崙背鄉	2018-11-24T23:00:16+08:00	6625	2318	8943	1083	10026	21050	47.63%	31.47%	20	20
8	雲林縣崙背鄉	2018-11-24T23:37:48+08:00	6625	2318	8943	1083	10026	21050	47.63%	31.47%	20	20
8	雲林縣崙背鄉	2018-11-25T00:56:13+08:00	6625	2318	8943	1083	10026	21050	47.63%	31.47%	20	20
8	雲林縣崙背鄉	2018-11-25T01:01:00+08:00	6625	2318	8943	1083	10026	21050	47.63%	31.47%	20	20
8	雲林縣崙背鄉	2018-11-24T23:33:49+08:00	6625	2318	8943	1083	10026	21050	47.63%	31.47%	20	20
8	雲林縣崙背鄉	2018-11-25T00:03:33+08:00	6625	2318	8943	1083	10026	21050	47.63%	31.47%	20	20
8	雲林縣崙背鄉	2018-11-24T22:35:44+08:00	6216	2154	8370	982	9352	19830	47.16%	31.35%	19	20
8	雲林縣崙背鄉	2018-11-24T23:54:26+08:00	6625	2318	8943	1083	10026	21050	47.63%	31.47%	20	20
8	雲林縣崙背鄉	2018-11-24T23:58:41+08:00	6625	2318	8943	1083	10026	21050	47.63%	31.47%	20	20
8	雲林縣崙背鄉	2018-11-24T22:56:35+08:00	6625	2318	8943	1083	10026	21050	47.63%	31.47%	20	20
8	雲林縣崙背鄉	2018-11-25T06:17:35+08:00	6625	2318	8943	1083	10026	21050	47.63%	31.47%	20	20
8	雲林縣崙背鄉	2018-11-24T22:49:23+08:00	6625	2318	8943	1083	10026	21050	47.63%	31.47%	20	20
8	雲林縣崙背鄉	2018-11-24T23:22:22+08:00	6625	2318	8943	1083	10026	21050	47.63%	31.47%	20	20
8	雲林縣崙背鄉	2018-11-24T22:43:49+08:00	6216	2154	8370	982	9352	19830	47.16%	31.35%	19	20
8	雲林縣崙背鄉	2018-11-24T23:03:46+08:00	6625	2318	8943	1083	10026	21050	47.63%	31.47%	20	20
8	雲林縣崙背鄉	2018-11-24T23:10:55+08:00	6625	2318	8943	1083	10026	21050	47.63%	31.47%	20	20
8	雲林縣崙背鄉	2018-11-24T22:12:02+08:00	5599	1945	7544	858	8402	17468	48.1%	32.05%	17	20
8	雲林縣崙背鄉	2018-11-25T00:08:04+08:00	6625	2318	8943	1083	10026	21050	47.63%	31.47%	20	20
8	雲林縣崙背鄉	2018-11-25T03:42:47+08:00	6625	2318	8943	1083	10026	21050	47.63%	31.47%	20	20
8	雲林縣崙背鄉	2018-11-24T22:53:14+08:00	6625	2318	8943	1083	10026	21050	47.63%	31.47%	20	20
8	雲林縣崙背鄉	2018-11-24T23:46:03+08:00	6625	2318	8943	1083	10026	21050	47.63%	31.47%	20	20
8	雲林縣崙背鄉	2018-11-25T00:17:07+08:00	6625	2318	8943	1083	10026	21050	47.63%	31.47%	20	20
8	雲林縣崙背鄉	2018-11-24T23:29:45+08:00	6625	2318	8943	1083	10026	21050	47.63%	31.47%	20	20
8	雲林縣崙背鄉	2018-11-25T06:22:44+08:00	6625	2318	8943	1083	10026	21050	47.63%	31.47%	20	20
8	雲林縣崙背鄉	2018-11-25T06:12:36+08:00	6625	2318	8943	1083	10026	21050	47.63%	31.47%	20	20
8	雲林縣崙背鄉	2018-11-24T22:25:24+08:00	5835	2020	7855	886	8741	18354	47.62%	31.79%	18	20
8	雲林縣崙背鄉	2018-11-25T01:05:58+08:00	6625	2318	8943	1083	10026	21050	47.63%	31.47%	20	20
8	雲林縣崙背鄉	2018-11-25T00:12:44+08:00	6625	2318	8943	1083	10026	21050	47.63%	31.47%	20	20
8	雲林縣崙背鄉	2018-11-24T23:26:06+08:00	6625	2318	8943	1083	10026	21050	47.63%	31.47%	20	20
8	雲林縣崙背鄉	2018-11-25T06:27:54+08:00	6625	2318	8943	1083	10026	21050	47.63%	31.47%	20	20
8	雲林縣崙背鄉	2018-11-24T23:50:14+08:00	6625	2318	8943	1083	10026	21050	47.63%	31.47%	20	20
8	雲林縣崙背鄉	2018-11-24T23:14:40+08:00	6625	2318	8943	1083	10026	21050	47.63%	31.47%	20	20
8	雲林縣崙背鄉	2018-11-24T22:18:19+08:00	5599	1945	7544	858	8402	17468	48.1%	32.05%	17	20
8	雲林縣崙背鄉	2018-11-24T22:28:39+08:00	6216	2154	8370	982	9352	19830	47.16%	31.35%	19	20
8	雲林縣崙背鄉	2018-11-24T22:14:48+08:00	5599	1945	7544	858	8402	17468	48.1%	32.05%	17	20
8	雲林縣崙背鄉	2018-11-25T01:16:21+08:00	6625	2318	8943	1083	10026	21050	47.63%	31.47%	20	20
8	雲林縣崙背鄉	2018-11-24T23:18:26+08:00	6625	2318	8943	1083	10026	21050	47.63%	31.47%	20	20
8	雲林縣斗南鎮	2018-11-24T22:39:08+08:00	10487	3252	13739	1265	15004	27446	54.67%	38.21%	26	33
8	雲林縣斗南鎮	2018-11-25T03:37:28+08:00	14869	4663	19532	1803	21335	38138	55.94%	38.99%	33	33
8	雲林縣斗南鎮	2018-11-25T01:24:23+08:00	14869	4663	19532	1803	21335	38138	55.94%	38.99%	33	33
8	雲林縣斗南鎮	2018-11-24T23:07:17+08:00	11828	3687	15515	1428	16943	30712	55.17%	38.51%	28	33
8	雲林縣斗南鎮	2018-11-24T22:12:01+08:00	9868	3017	12885	1174	14059	25737	54.63%	38.34%	25	33
8	雲林縣斗南鎮	2018-11-24T22:32:17+08:00	9868	3017	12885	1174	14059	25737	54.63%	38.34%	25	33
8	雲林縣斗南鎮	2018-11-25T03:48:28+08:00	14869	4663	19532	1803	21335	38138	55.94%	38.99%	33	33
8	雲林縣斗南鎮	2018-11-25T03:30:58+08:00	14869	4663	19532	1803	21335	38138	55.94%	38.99%	33	33
8	雲林縣斗南鎮	2018-11-24T23:42:01+08:00	14869	4663	19532	1803	21335	38138	55.94%	38.99%	33	33
8	雲林縣斗南鎮	2018-11-24T22:21:45+08:00	9868	3017	12885	1174	14059	25737	54.63%	38.34%	25	33
8	雲林縣斗南鎮	2018-11-25T06:07:22+08:00	14869	4663	19532	1803	21335	38138	55.94%	38.99%	33	33
8	雲林縣斗南鎮	2018-11-25T04:01:28+08:00	14869	4663	19532	1803	21335	38138	55.94%	38.99%	33	33
8	雲林縣斗南鎮	2018-11-25T00:21:43+08:00	14869	4663	19532	1803	21335	38138	55.94%	38.99%	33	33
8	雲林縣斗南鎮	2018-11-25T01:11:06+08:00	14869	4663	19532	1803	21335	38138	55.94%	38.99%	33	33
8	雲林縣斗南鎮	2018-11-24T22:40:18+08:00	10487	3252	13739	1265	15004	27446	54.67%	38.21%	26	33
8	雲林縣斗南鎮	2018-11-24T23:00:16+08:00	11828	3687	15515	1428	16943	30712	55.17%	38.51%	28	33
8	雲林縣斗南鎮	2018-11-24T23:37:48+08:00	14222	4479	18701	1697	20398	36552	55.81%	38.91%	32	33
8	雲林縣斗南鎮	2018-11-25T03:54:39+08:00	14869	4663	19532	1803	21335	38138	55.94%	38.99%	33	33
8	雲林縣斗南鎮	2018-11-25T01:01:00+08:00	14869	4663	19532	1803	21335	38138	55.94%	38.99%	33	33
8	雲林縣斗南鎮	2018-11-24T23:33:49+08:00	14222	4479	18701	1697	20398	36552	55.81%	38.91%	32	33
8	雲林縣斗南鎮	2018-11-25T00:03:33+08:00	14869	4663	19532	1803	21335	38138	55.94%	38.99%	33	33
8	雲林縣斗南鎮	2018-11-24T22:35:43+08:00	10487	3252	13739	1265	15004	27446	54.67%	38.21%	26	33
8	雲林縣斗南鎮	2018-11-24T23:54:26+08:00	14869	4663	19532	1803	21335	38138	55.94%	38.99%	33	33
8	雲林縣斗南鎮	2018-11-24T23:58:41+08:00	14869	4663	19532	1803	21335	38138	55.94%	38.99%	33	33
8	雲林縣斗南鎮	2018-11-25T00:56:12+08:00	14869	4663	19532	1803	21335	38138	55.94%	38.99%	33	33
8	雲林縣斗南鎮	2018-11-24T22:56:35+08:00	11203	3469	14672	1359	16031	29148	55%	38.43%	27	33
8	雲林縣斗南鎮	2018-11-25T06:17:35+08:00	14869	4663	19532	1803	21335	38138	55.94%	38.99%	33	33
8	雲林縣斗南鎮	2018-11-24T22:49:23+08:00	10487	3252	13739	1265	15004	27446	54.67%	38.21%	26	33
8	雲林縣斗南鎮	2018-11-24T23:22:22+08:00	13699	4267	17966	1630	19596	35275	55.55%	38.83%	31	33
8	雲林縣斗南鎮	2018-11-24T22:43:49+08:00	10487	3252	13739	1265	15004	27446	54.67%	38.21%	26	33
8	雲林縣斗南鎮	2018-11-24T23:03:46+08:00	11828	3687	15515	1428	16943	30712	55.17%	38.51%	28	33
8	雲林縣斗南鎮	2018-11-24T23:10:55+08:00	11828	3687	15515	1428	16943	30712	55.17%	38.51%	28	33
8	雲林縣斗南鎮	2018-11-25T00:08:03+08:00	14869	4663	19532	1803	21335	38138	55.94%	38.99%	33	33
8	雲林縣斗南鎮	2018-11-25T03:42:47+08:00	14869	4663	19532	1803	21335	38138	55.94%	38.99%	33	33
8	雲林縣斗南鎮	2018-11-24T22:53:14+08:00	10487	3252	13739	1265	15004	27446	54.67%	38.21%	26	33
8	雲林縣斗南鎮	2018-11-24T23:46:02+08:00	14869	4663	19532	1803	21335	38138	55.94%	38.99%	33	33
8	雲林縣斗南鎮	2018-11-25T00:17:07+08:00	14869	4663	19532	1803	21335	38138	55.94%	38.99%	33	33
8	雲林縣斗南鎮	2018-11-24T23:29:45+08:00	13699	4267	17966	1630	19596	35275	55.55%	38.83%	31	33
8	雲林縣斗南鎮	2018-11-25T06:22:44+08:00	14869	4663	19532	1803	21335	38138	55.94%	38.99%	33	33
8	雲林縣斗南鎮	2018-11-25T06:12:36+08:00	14869	4663	19532	1803	21335	38138	55.94%	38.99%	33	33
8	雲林縣斗南鎮	2018-11-24T22:25:24+08:00	9868	3017	12885	1174	14059	25737	54.63%	38.34%	25	33
8	雲林縣斗南鎮	2018-11-25T01:05:58+08:00	14869	4663	19532	1803	21335	38138	55.94%	38.99%	33	33
8	雲林縣斗南鎮	2018-11-25T00:12:44+08:00	14869	4663	19532	1803	21335	38138	55.94%	38.99%	33	33
8	雲林縣斗南鎮	2018-11-24T23:26:06+08:00	13699	4267	17966	1630	19596	35275	55.55%	38.83%	31	33
8	雲林縣斗南鎮	2018-11-24T22:18:18+08:00	9868	3017	12885	1174	14059	25737	54.63%	38.34%	25	33
8	雲林縣斗南鎮	2018-11-25T06:27:54+08:00	14869	4663	19532	1803	21335	38138	55.94%	38.99%	33	33
8	雲林縣斗南鎮	2018-11-24T23:50:14+08:00	14869	4663	19532	1803	21335	38138	55.94%	38.99%	33	33
8	雲林縣斗南鎮	2018-11-24T23:14:40+08:00	12457	3864	16321	1477	17798	32171	55.32%	38.72%	29	33
8	雲林縣斗南鎮	2018-11-24T22:28:39+08:00	9868	3017	12885	1174	14059	25737	54.63%	38.34%	25	33
8	雲林縣斗南鎮	2018-11-24T22:14:48+08:00	9868	3017	12885	1174	14059	25737	54.63%	38.34%	25	33
8	雲林縣斗南鎮	2018-11-25T01:16:21+08:00	14869	4663	19532	1803	21335	38138	55.94%	38.99%	33	33
8	雲林縣斗南鎮	2018-11-24T23:18:26+08:00	13699	4267	17966	1630	19596	35275	55.55%	38.83%	31	33
8	花蓮縣萬榮鄉	2018-11-24T22:14:51+08:00	521	165	686	102	788	1677	46.99%	31.07%	3	7
8	花蓮縣萬榮鄉	2018-11-24T23:33:52+08:00	1398	458	1856	233	2089	4183	49.94%	33.42%	6	7
8	花蓮縣萬榮鄉	2018-11-24T22:28:42+08:00	1022	323	1345	151	1496	3111	48.09%	32.85%	5	7
8	花蓮縣萬榮鄉	2018-11-24T22:56:38+08:00	1022	323	1345	151	1496	3111	48.09%	32.85%	5	7
8	花蓮縣萬榮鄉	2018-11-24T23:07:21+08:00	1022	323	1345	151	1496	3111	48.09%	32.85%	5	7
8	花蓮縣萬榮鄉	2018-11-24T22:49:26+08:00	1022	323	1345	151	1496	3111	48.09%	32.85%	5	7
8	花蓮縣萬榮鄉	2018-11-24T23:10:58+08:00	1022	323	1345	151	1496	3111	48.09%	32.85%	5	7
8	花蓮縣萬榮鄉	2018-11-25T06:17:39+08:00	1802	667	2469	355	2824	5269	53.6%	34.2%	7	7
8	花蓮縣萬榮鄉	2018-11-24T22:53:17+08:00	1022	323	1345	151	1496	3111	48.09%	32.85%	5	7
8	花蓮縣萬榮鄉	2018-11-24T23:46:06+08:00	1398	458	1856	233	2089	4183	49.94%	33.42%	6	7
8	花蓮縣萬榮鄉	2018-11-25T00:08:07+08:00	1398	458	1856	233	2089	4183	49.94%	33.42%	6	7
8	花蓮縣萬榮鄉	2018-11-24T22:32:20+08:00	1022	323	1345	151	1496	3111	48.09%	32.85%	5	7
8	花蓮縣萬榮鄉	2018-11-25T00:17:10+08:00	1398	458	1856	233	2089	4183	49.94%	33.42%	6	7
8	花蓮縣萬榮鄉	2018-11-25T03:48:33+08:00	1802	667	2469	355	2824	5269	53.6%	34.2%	7	7
8	花蓮縣萬榮鄉	2018-11-24T23:00:19+08:00	1022	323	1345	151	1496	3111	48.09%	32.85%	5	7
8	花蓮縣萬榮鄉	2018-11-25T06:07:25+08:00	1802	667	2469	355	2824	5269	53.6%	34.2%	7	7
8	花蓮縣萬榮鄉	2018-11-25T06:22:47+08:00	1802	667	2469	355	2824	5269	53.6%	34.2%	7	7
8	花蓮縣萬榮鄉	2018-11-25T03:42:51+08:00	1802	667	2469	355	2824	5269	53.6%	34.2%	7	7
8	花蓮縣萬榮鄉	2018-11-24T22:25:27+08:00	1022	323	1345	151	1496	3111	48.09%	32.85%	5	7
8	花蓮縣萬榮鄉	2018-11-24T22:40:21+08:00	1022	323	1345	151	1496	3111	48.09%	32.85%	5	7
8	花蓮縣萬榮鄉	2018-11-24T23:29:49+08:00	1398	458	1856	233	2089	4183	49.94%	33.42%	6	7
8	花蓮縣萬榮鄉	2018-11-24T23:50:17+08:00	1398	458	1856	233	2089	4183	49.94%	33.42%	6	7
8	花蓮縣萬榮鄉	2018-11-24T23:14:43+08:00	1022	323	1345	151	1496	3111	48.09%	32.85%	5	7
8	花蓮縣萬榮鄉	2018-11-25T00:12:47+08:00	1398	458	1856	233	2089	4183	49.94%	33.42%	6	7
8	花蓮縣萬榮鄉	2018-11-24T23:54:29+08:00	1398	458	1856	233	2089	4183	49.94%	33.42%	6	7
8	花蓮縣萬榮鄉	2018-11-25T06:27:57+08:00	1802	667	2469	355	2824	5269	53.6%	34.2%	7	7
8	花蓮縣萬榮鄉	2018-11-25T01:16:25+08:00	1398	458	1856	233	2089	4183	49.94%	33.42%	6	7
8	花蓮縣萬榮鄉	2018-11-24T22:18:22+08:00	521	165	686	102	788	1677	46.99%	31.07%	3	7
8	花蓮縣萬榮鄉	2018-11-25T03:37:32+08:00	1802	667	2469	355	2824	5269	53.6%	34.2%	7	7
8	花蓮縣萬榮鄉	2018-11-25T01:24:27+08:00	1398	458	1856	233	2089	4183	49.94%	33.42%	6	7
8	花蓮縣萬榮鄉	2018-11-25T03:54:44+08:00	1802	667	2469	355	2824	5269	53.6%	34.2%	7	7
8	花蓮縣萬榮鄉	2018-11-24T23:03:49+08:00	1022	323	1345	151	1496	3111	48.09%	32.85%	5	7
8	花蓮縣萬榮鄉	2018-11-24T23:22:25+08:00	1398	458	1856	233	2089	4183	49.94%	33.42%	6	7
8	花蓮縣萬榮鄉	2018-11-24T23:37:51+08:00	1398	458	1856	233	2089	4183	49.94%	33.42%	6	7
8	花蓮縣萬榮鄉	2018-11-24T22:12:05+08:00	521	165	686	102	788	1677	46.99%	31.07%	3	7
8	花蓮縣萬榮鄉	2018-11-25T01:06:02+08:00	1398	458	1856	233	2089	4183	49.94%	33.42%	6	7
8	花蓮縣萬榮鄉	2018-11-24T23:42:04+08:00	1398	458	1856	233	2089	4183	49.94%	33.42%	6	7
8	花蓮縣萬榮鄉	2018-11-25T01:11:10+08:00	1398	458	1856	233	2089	4183	49.94%	33.42%	6	7
8	花蓮縣萬榮鄉	2018-11-25T04:01:31+08:00	1802	667	2469	355	2824	5269	53.6%	34.2%	7	7
8	花蓮縣萬榮鄉	2018-11-25T06:12:39+08:00	1802	667	2469	355	2824	5269	53.6%	34.2%	7	7
8	花蓮縣萬榮鄉	2018-11-25T00:21:46+08:00	1398	458	1856	233	2089	4183	49.94%	33.42%	6	7
8	花蓮縣萬榮鄉	2018-11-24T22:21:49+08:00	697	226	923	115	1038	2338	44.4%	29.81%	4	7
8	花蓮縣萬榮鄉	2018-11-25T01:01:04+08:00	1398	458	1856	233	2089	4183	49.94%	33.42%	6	7
8	花蓮縣萬榮鄉	2018-11-24T22:43:53+08:00	1022	323	1345	151	1496	3111	48.09%	32.85%	5	7
8	花蓮縣萬榮鄉	2018-11-24T23:18:29+08:00	1398	458	1856	233	2089	4183	49.94%	33.42%	6	7
8	花蓮縣萬榮鄉	2018-11-24T22:35:47+08:00	1022	323	1345	151	1496	3111	48.09%	32.85%	5	7
8	花蓮縣萬榮鄉	2018-11-24T23:58:45+08:00	1398	458	1856	233	2089	4183	49.94%	33.42%	6	7
8	花蓮縣萬榮鄉	2018-11-25T00:56:16+08:00	1398	458	1856	233	2089	4183	49.94%	33.42%	6	7
8	花蓮縣萬榮鄉	2018-11-24T22:39:11+08:00	1022	323	1345	151	1496	3111	48.09%	32.85%	5	7
8	花蓮縣萬榮鄉	2018-11-24T23:26:09+08:00	1398	458	1856	233	2089	4183	49.94%	33.42%	6	7
8	花蓮縣萬榮鄉	2018-11-25T03:31:02+08:00	1802	667	2469	355	2824	5269	53.6%	34.2%	7	7
8	花蓮縣萬榮鄉	2018-11-25T00:03:37+08:00	1398	458	1856	233	2089	4183	49.94%	33.42%	6	7
8	花蓮縣鳳林鎮	2018-11-24T22:14:51+08:00	2377	598	2975	355	3330	6157	54.08%	38.61%	11	15
8	花蓮縣鳳林鎮	2018-11-24T23:33:52+08:00	3223	826	4049	503	4552	8484	53.65%	37.99%	14	15
8	花蓮縣鳳林鎮	2018-11-24T22:28:42+08:00	2377	598	2975	355	3330	6157	54.08%	38.61%	11	15
8	花蓮縣鳳林鎮	2018-11-24T22:56:38+08:00	2942	744	3686	449	4135	7742	53.41%	38%	13	15
8	花蓮縣鳳林鎮	2018-11-24T23:07:21+08:00	2942	744	3686	449	4135	7742	53.41%	38%	13	15
8	花蓮縣鳳林鎮	2018-11-24T22:49:26+08:00	2942	744	3686	449	4135	7742	53.41%	38%	13	15
8	花蓮縣鳳林鎮	2018-11-24T23:10:58+08:00	2942	744	3686	449	4135	7742	53.41%	38%	13	15
8	花蓮縣鳳林鎮	2018-11-25T06:17:39+08:00	3783	934	4717	573	5290	9676	54.67%	39.1%	15	15
8	花蓮縣鳳林鎮	2018-11-24T22:53:17+08:00	2942	744	3686	449	4135	7742	53.41%	38%	13	15
8	花蓮縣鳳林鎮	2018-11-25T00:08:07+08:00	3223	826	4049	503	4552	8484	53.65%	37.99%	14	15
8	花蓮縣鳳林鎮	2018-11-24T22:32:20+08:00	2377	598	2975	355	3330	6157	54.08%	38.61%	11	15
8	花蓮縣鳳林鎮	2018-11-25T00:17:10+08:00	3783	934	4717	573	5290	9676	54.67%	39.1%	15	15
8	花蓮縣鳳林鎮	2018-11-25T03:48:33+08:00	3783	934	4717	573	5290	9676	54.67%	39.1%	15	15
8	花蓮縣鳳林鎮	2018-11-25T06:07:25+08:00	3783	934	4717	573	5290	9676	54.67%	39.1%	15	15
8	花蓮縣鳳林鎮	2018-11-24T23:29:48+08:00	3223	826	4049	503	4552	8484	53.65%	37.99%	14	15
8	花蓮縣鳳林鎮	2018-11-24T22:40:20+08:00	2661	667	3328	402	3730	6758	55.19%	39.38%	12	15
8	花蓮縣鳳林鎮	2018-11-25T06:22:46+08:00	3783	934	4717	573	5290	9676	54.67%	39.1%	15	15
8	花蓮縣鳳林鎮	2018-11-24T23:00:18+08:00	2942	744	3686	449	4135	7742	53.41%	38%	13	15
8	花蓮縣鳳林鎮	2018-11-24T22:25:27+08:00	2377	598	2975	355	3330	6157	54.08%	38.61%	11	15
8	花蓮縣鳳林鎮	2018-11-25T03:42:50+08:00	3783	934	4717	573	5290	9676	54.67%	39.1%	15	15
8	花蓮縣鳳林鎮	2018-11-25T01:11:09+08:00	3783	934	4717	573	5290	9676	54.67%	39.1%	15	15
8	花蓮縣鳳林鎮	2018-11-24T23:50:17+08:00	3223	826	4049	503	4552	8484	53.65%	37.99%	14	15
8	花蓮縣鳳林鎮	2018-11-24T23:14:43+08:00	2942	744	3686	449	4135	7742	53.41%	38%	13	15
8	花蓮縣鳳林鎮	2018-11-25T01:16:24+08:00	3783	934	4717	573	5290	9676	54.67%	39.1%	15	15
8	花蓮縣鳳林鎮	2018-11-25T00:12:47+08:00	3223	826	4049	503	4552	8484	53.65%	37.99%	14	15
8	花蓮縣鳳林鎮	2018-11-24T23:54:29+08:00	3223	826	4049	503	4552	8484	53.65%	37.99%	14	15
8	花蓮縣鳳林鎮	2018-11-25T06:27:57+08:00	3783	934	4717	573	5290	9676	54.67%	39.1%	15	15
8	花蓮縣鳳林鎮	2018-11-25T03:31:01+08:00	3783	934	4717	573	5290	9676	54.67%	39.1%	15	15
8	花蓮縣鳳林鎮	2018-11-25T00:56:15+08:00	3783	934	4717	573	5290	9676	54.67%	39.1%	15	15
8	花蓮縣鳳林鎮	2018-11-24T23:37:50+08:00	3223	826	4049	503	4552	8484	53.65%	37.99%	14	15
8	花蓮縣鳳林鎮	2018-11-25T01:24:27+08:00	3783	934	4717	573	5290	9676	54.67%	39.1%	15	15
8	花蓮縣鳳林鎮	2018-11-25T03:54:43+08:00	3783	934	4717	573	5290	9676	54.67%	39.1%	15	15
8	花蓮縣鳳林鎮	2018-11-24T23:03:49+08:00	2942	744	3686	449	4135	7742	53.41%	38%	13	15
8	花蓮縣鳳林鎮	2018-11-24T22:12:04+08:00	2377	598	2975	355	3330	6157	54.08%	38.61%	11	15
8	花蓮縣鳳林鎮	2018-11-24T23:22:25+08:00	2942	744	3686	449	4135	7742	53.41%	38%	13	15
8	花蓮縣鳳林鎮	2018-11-25T01:06:02+08:00	3783	934	4717	573	5290	9676	54.67%	39.1%	15	15
8	花蓮縣鳳林鎮	2018-11-24T23:42:04+08:00	3223	826	4049	503	4552	8484	53.65%	37.99%	14	15
8	花蓮縣鳳林鎮	2018-11-24T23:46:05+08:00	3223	826	4049	503	4552	8484	53.65%	37.99%	14	15
8	花蓮縣鳳林鎮	2018-11-25T04:01:31+08:00	3783	934	4717	573	5290	9676	54.67%	39.1%	15	15
8	花蓮縣鳳林鎮	2018-11-25T06:12:39+08:00	3783	934	4717	573	5290	9676	54.67%	39.1%	15	15
8	花蓮縣鳳林鎮	2018-11-24T22:21:48+08:00	2377	598	2975	355	3330	6157	54.08%	38.61%	11	15
8	花蓮縣鳳林鎮	2018-11-25T00:21:46+08:00	3783	934	4717	573	5290	9676	54.67%	39.1%	15	15
8	花蓮縣鳳林鎮	2018-11-25T01:01:04+08:00	3783	934	4717	573	5290	9676	54.67%	39.1%	15	15
8	花蓮縣鳳林鎮	2018-11-24T22:35:46+08:00	2377	598	2975	355	3330	6157	54.08%	38.61%	11	15
8	花蓮縣鳳林鎮	2018-11-24T23:58:44+08:00	3223	826	4049	503	4552	8484	53.65%	37.99%	14	15
8	花蓮縣鳳林鎮	2018-11-24T23:18:29+08:00	2942	744	3686	449	4135	7742	53.41%	38%	13	15
8	花蓮縣鳳林鎮	2018-11-25T03:37:31+08:00	3783	934	4717	573	5290	9676	54.67%	39.1%	15	15
8	花蓮縣鳳林鎮	2018-11-24T22:18:21+08:00	2377	598	2975	355	3330	6157	54.08%	38.61%	11	15
8	花蓮縣鳳林鎮	2018-11-24T22:39:11+08:00	2377	598	2975	355	3330	6157	54.08%	38.61%	11	15
8	花蓮縣鳳林鎮	2018-11-24T23:26:09+08:00	2942	744	3686	449	4135	7742	53.41%	38%	13	15
8	花蓮縣鳳林鎮	2018-11-25T00:03:37+08:00	3223	826	4049	503	4552	8484	53.65%	37.99%	14	15
8	花蓮縣鳳林鎮	2018-11-24T22:43:52+08:00	2661	667	3328	402	3730	6758	55.19%	39.38%	12	15
8	臺南市學甲區	2018-11-25T03:37:19+08:00	7007	2508	9515	926	10441	22567	46.27%	31.05%	26	26
8	臺南市學甲區	2018-11-24T22:49:18+08:00	7007	2508	9515	926	10441	22567	46.27%	31.05%	26	26
8	臺南市學甲區	2018-11-24T23:14:34+08:00	7007	2508	9515	926	10441	22567	46.27%	31.05%	26	26
8	臺南市學甲區	2018-11-24T22:56:31+08:00	7007	2508	9515	926	10441	22567	46.27%	31.05%	26	26
8	臺南市學甲區	2018-11-25T00:03:27+08:00	7007	2508	9515	926	10441	22567	46.27%	31.05%	26	26
8	臺南市學甲區	2018-11-25T00:56:07+08:00	7007	2508	9515	926	10441	22567	46.27%	31.05%	26	26
8	臺南市學甲區	2018-11-24T23:03:42+08:00	7007	2508	9515	926	10441	22567	46.27%	31.05%	26	26
8	臺南市學甲區	2018-11-24T23:10:51+08:00	7007	2508	9515	926	10441	22567	46.27%	31.05%	26	26
8	臺南市學甲區	2018-11-24T22:43:44+08:00	7007	2508	9515	926	10441	22567	46.27%	31.05%	26	26
8	臺南市學甲區	2018-11-25T06:17:30+08:00	7007	2508	9515	926	10441	22567	46.27%	31.05%	26	26
8	臺南市學甲區	2018-11-24T23:58:36+08:00	7007	2508	9515	926	10441	22567	46.27%	31.05%	26	26
8	臺南市學甲區	2018-11-24T23:22:17+08:00	7007	2508	9515	926	10441	22567	46.27%	31.05%	26	26
8	臺南市學甲區	2018-11-25T06:22:40+08:00	7007	2508	9515	926	10441	22567	46.27%	31.05%	26	26
8	臺南市學甲區	2018-11-24T23:29:41+08:00	7007	2508	9515	926	10441	22567	46.27%	31.05%	26	26
8	臺南市學甲區	2018-11-24T22:25:18+08:00	7007	2508	9515	926	10441	22567	46.27%	31.05%	26	26
8	臺南市學甲區	2018-11-25T01:11:00+08:00	7007	2508	9515	926	10441	22567	46.27%	31.05%	26	26
8	臺南市學甲區	2018-11-25T00:17:02+08:00	7007	2508	9515	926	10441	22567	46.27%	31.05%	26	26
8	臺南市學甲區	2018-11-25T06:12:32+08:00	7007	2508	9515	926	10441	22567	46.27%	31.05%	26	26
8	臺南市學甲區	2018-11-25T00:07:58+08:00	7007	2508	9515	926	10441	22567	46.27%	31.05%	26	26
8	臺南市學甲區	2018-11-25T00:12:40+08:00	7007	2508	9515	926	10441	22567	46.27%	31.05%	26	26
8	臺南市學甲區	2018-11-24T22:14:43+08:00	7007	2508	9515	926	10441	22567	46.27%	31.05%	26	26
8	臺南市學甲區	2018-11-24T23:26:02+08:00	7007	2508	9515	926	10441	22567	46.27%	31.05%	26	26
8	臺南市學甲區	2018-11-25T01:05:52+08:00	7007	2508	9515	926	10441	22567	46.27%	31.05%	26	26
8	臺南市學甲區	2018-11-25T06:27:50+08:00	7007	2508	9515	926	10441	22567	46.27%	31.05%	26	26
8	臺南市學甲區	2018-11-24T23:18:22+08:00	7007	2508	9515	926	10441	22567	46.27%	31.05%	26	26
8	臺南市學甲區	2018-11-24T23:54:19+08:00	7007	2508	9515	926	10441	22567	46.27%	31.05%	26	26
8	臺南市學甲區	2018-11-24T22:28:34+08:00	7007	2508	9515	926	10441	22567	46.27%	31.05%	26	26
8	臺南市學甲區	2018-11-24T22:18:14+08:00	7007	2508	9515	926	10441	22567	46.27%	31.05%	26	26
8	臺南市學甲區	2018-11-25T01:24:18+08:00	7007	2508	9515	926	10441	22567	46.27%	31.05%	26	26
8	臺南市學甲區	2018-11-24T23:50:09+08:00	7007	2508	9515	926	10441	22567	46.27%	31.05%	26	26
8	臺南市學甲區	2018-11-24T22:39:03+08:00	7007	2508	9515	926	10441	22567	46.27%	31.05%	26	26
8	臺南市學甲區	2018-11-24T23:07:13+08:00	7007	2508	9515	926	10441	22567	46.27%	31.05%	26	26
8	臺南市學甲區	2018-11-25T01:00:54+08:00	7007	2508	9515	926	10441	22567	46.27%	31.05%	26	26
8	臺南市學甲區	2018-11-24T22:32:13+08:00	7007	2508	9515	926	10441	22567	46.27%	31.05%	26	26
8	臺南市學甲區	2018-11-25T03:48:23+08:00	7007	2508	9515	926	10441	22567	46.27%	31.05%	26	26
8	臺南市學甲區	2018-11-24T23:00:09+08:00	7007	2508	9515	926	10441	22567	46.27%	31.05%	26	26
8	臺南市學甲區	2018-11-25T00:21:38+08:00	7007	2508	9515	926	10441	22567	46.27%	31.05%	26	26
8	臺南市學甲區	2018-11-25T03:30:52+08:00	7007	2508	9515	926	10441	22567	46.27%	31.05%	26	26
8	臺南市學甲區	2018-11-25T03:42:41+08:00	7007	2508	9515	926	10441	22567	46.27%	31.05%	26	26
8	臺南市學甲區	2018-11-24T22:53:08+08:00	7007	2508	9515	926	10441	22567	46.27%	31.05%	26	26
8	臺南市學甲區	2018-11-25T06:07:17+08:00	7007	2508	9515	926	10441	22567	46.27%	31.05%	26	26
8	臺南市學甲區	2018-11-24T22:11:57+08:00	7007	2508	9515	926	10441	22567	46.27%	31.05%	26	26
8	臺南市學甲區	2018-11-24T22:40:14+08:00	7007	2508	9515	926	10441	22567	46.27%	31.05%	26	26
8	臺南市學甲區	2018-11-25T04:01:23+08:00	7007	2508	9515	926	10441	22567	46.27%	31.05%	26	26
8	臺南市學甲區	2018-11-24T22:21:40+08:00	7007	2508	9515	926	10441	22567	46.27%	31.05%	26	26
8	臺南市學甲區	2018-11-24T23:33:44+08:00	7007	2508	9515	926	10441	22567	46.27%	31.05%	26	26
8	臺南市學甲區	2018-11-25T03:54:34+08:00	7007	2508	9515	926	10441	22567	46.27%	31.05%	26	26
8	臺南市學甲區	2018-11-25T01:16:16+08:00	7007	2508	9515	926	10441	22567	46.27%	31.05%	26	26
8	臺南市學甲區	2018-11-24T23:45:58+08:00	7007	2508	9515	926	10441	22567	46.27%	31.05%	26	26
8	臺南市學甲區	2018-11-24T22:35:40+08:00	7007	2508	9515	926	10441	22567	46.27%	31.05%	26	26
8	臺南市學甲區	2018-11-24T23:41:56+08:00	7007	2508	9515	926	10441	22567	46.27%	31.05%	26	26
8	臺南市學甲區	2018-11-24T23:37:44+08:00	7007	2508	9515	926	10441	22567	46.27%	31.05%	26	26
8	屏東縣霧臺鄉	2018-11-24T23:07:20+08:00	961	313	1274	74	1348	2654	50.79%	36.21%	7	8
8	屏東縣霧臺鄉	2018-11-24T23:10:57+08:00	961	313	1274	74	1348	2654	50.79%	36.21%	7	8
8	屏東縣霧臺鄉	2018-11-24T22:14:50+08:00	530	165	695	50	745	1494	49.87%	35.48%	5	8
8	屏東縣霧臺鄉	2018-11-25T06:17:37+08:00	1106	340	1446	112	1558	2950	52.81%	37.49%	8	8
8	屏東縣霧臺鄉	2018-11-24T22:56:37+08:00	704	244	948	62	1010	1977	51.09%	35.61%	6	8
8	屏東縣霧臺鄉	2018-11-24T22:32:19+08:00	530	165	695	50	745	1494	49.87%	35.48%	5	8
8	屏東縣霧臺鄉	2018-11-25T01:06:01+08:00	1106	340	1446	112	1558	2950	52.81%	37.49%	8	8
8	屏東縣霧臺鄉	2018-11-24T22:53:16+08:00	704	244	948	62	1010	1977	51.09%	35.61%	6	8
8	屏東縣霧臺鄉	2018-11-25T00:08:06+08:00	1106	340	1446	112	1558	2950	52.81%	37.49%	8	8
8	屏東縣霧臺鄉	2018-11-24T22:25:26+08:00	530	165	695	50	745	1494	49.87%	35.48%	5	8
8	屏東縣霧臺鄉	2018-11-25T01:11:08+08:00	1106	340	1446	112	1558	2950	52.81%	37.49%	8	8
8	屏東縣霧臺鄉	2018-11-24T22:40:20+08:00	704	244	948	62	1010	1977	51.09%	35.61%	6	8
8	屏東縣霧臺鄉	2018-11-25T06:22:46+08:00	1106	340	1446	112	1558	2950	52.81%	37.49%	8	8
8	屏東縣霧臺鄉	2018-11-25T06:07:24+08:00	1106	340	1446	112	1558	2950	52.81%	37.49%	8	8
8	屏東縣霧臺鄉	2018-11-24T23:00:18+08:00	704	244	948	62	1010	1977	51.09%	35.61%	6	8
8	屏東縣霧臺鄉	2018-11-25T03:48:32+08:00	1106	340	1446	112	1558	2950	52.81%	37.49%	8	8
8	屏東縣霧臺鄉	2018-11-24T23:29:47+08:00	1106	340	1446	112	1558	2950	52.81%	37.49%	8	8
8	屏東縣霧臺鄉	2018-11-25T00:21:45+08:00	1106	340	1446	112	1558	2950	52.81%	37.49%	8	8
8	屏東縣霧臺鄉	2018-11-25T03:31:00+08:00	1106	340	1446	112	1558	2950	52.81%	37.49%	8	8
8	屏東縣霧臺鄉	2018-11-25T01:16:23+08:00	1106	340	1446	112	1558	2950	52.81%	37.49%	8	8
8	屏東縣霧臺鄉	2018-11-25T00:56:14+08:00	1106	340	1446	112	1558	2950	52.81%	37.49%	8	8
8	屏東縣霧臺鄉	2018-11-24T23:14:42+08:00	961	313	1274	74	1348	2654	50.79%	36.21%	7	8
8	屏東縣霧臺鄉	2018-11-24T23:50:16+08:00	1106	340	1446	112	1558	2950	52.81%	37.49%	8	8
8	屏東縣霧臺鄉	2018-11-24T22:43:51+08:00	704	244	948	62	1010	1977	51.09%	35.61%	6	8
8	屏東縣霧臺鄉	2018-11-25T06:27:56+08:00	1106	340	1446	112	1558	2950	52.81%	37.49%	8	8
8	屏東縣霧臺鄉	2018-11-25T00:12:46+08:00	1106	340	1446	112	1558	2950	52.81%	37.49%	8	8
8	屏東縣霧臺鄉	2018-11-24T23:54:28+08:00	1106	340	1446	112	1558	2950	52.81%	37.49%	8	8
8	屏東縣霧臺鄉	2018-11-24T23:37:50+08:00	1106	340	1446	112	1558	2950	52.81%	37.49%	8	8
8	屏東縣霧臺鄉	2018-11-24T23:22:24+08:00	1106	340	1446	112	1558	2950	52.81%	37.49%	8	8
8	屏東縣霧臺鄉	2018-11-24T22:28:41+08:00	530	165	695	50	745	1494	49.87%	35.48%	5	8
8	屏東縣霧臺鄉	2018-11-24T22:12:03+08:00	530	165	695	50	745	1494	49.87%	35.48%	5	8
8	屏東縣霧臺鄉	2018-11-24T23:33:51+08:00	1106	340	1446	112	1558	2950	52.81%	37.49%	8	8
8	屏東縣霧臺鄉	2018-11-25T01:24:26+08:00	1106	340	1446	112	1558	2950	52.81%	37.49%	8	8
8	屏東縣霧臺鄉	2018-11-25T03:54:42+08:00	1106	340	1446	112	1558	2950	52.81%	37.49%	8	8
8	屏東縣霧臺鄉	2018-11-24T23:03:48+08:00	704	244	948	62	1010	1977	51.09%	35.61%	6	8
8	屏東縣霧臺鄉	2018-11-24T22:49:25+08:00	704	244	948	62	1010	1977	51.09%	35.61%	6	8
8	屏東縣霧臺鄉	2018-11-24T23:42:03+08:00	1106	340	1446	112	1558	2950	52.81%	37.49%	8	8
8	屏東縣霧臺鄉	2018-11-25T04:01:30+08:00	1106	340	1446	112	1558	2950	52.81%	37.49%	8	8
8	屏東縣霧臺鄉	2018-11-24T23:46:05+08:00	1106	340	1446	112	1558	2950	52.81%	37.49%	8	8
8	屏東縣霧臺鄉	2018-11-25T03:42:49+08:00	1106	340	1446	112	1558	2950	52.81%	37.49%	8	8
8	屏東縣霧臺鄉	2018-11-25T00:17:09+08:00	1106	340	1446	112	1558	2950	52.81%	37.49%	8	8
8	屏東縣霧臺鄉	2018-11-25T06:12:38+08:00	1106	340	1446	112	1558	2950	52.81%	37.49%	8	8
8	屏東縣霧臺鄉	2018-11-24T22:21:47+08:00	530	165	695	50	745	1494	49.87%	35.48%	5	8
8	屏東縣霧臺鄉	2018-11-25T01:01:03+08:00	1106	340	1446	112	1558	2950	52.81%	37.49%	8	8
8	屏東縣霧臺鄉	2018-11-24T22:39:10+08:00	704	244	948	62	1010	1977	51.09%	35.61%	6	8
8	屏東縣霧臺鄉	2018-11-24T23:26:08+08:00	1106	340	1446	112	1558	2950	52.81%	37.49%	8	8
8	屏東縣霧臺鄉	2018-11-24T22:35:46+08:00	704	244	948	62	1010	1977	51.09%	35.61%	6	8
8	屏東縣霧臺鄉	2018-11-24T23:58:44+08:00	1106	340	1446	112	1558	2950	52.81%	37.49%	8	8
8	屏東縣霧臺鄉	2018-11-25T00:03:36+08:00	1106	340	1446	112	1558	2950	52.81%	37.49%	8	8
8	屏東縣霧臺鄉	2018-11-25T03:37:31+08:00	1106	340	1446	112	1558	2950	52.81%	37.49%	8	8
8	屏東縣霧臺鄉	2018-11-24T22:18:21+08:00	530	165	695	50	745	1494	49.87%	35.48%	5	8
8	屏東縣霧臺鄉	2018-11-24T23:18:28+08:00	1106	340	1446	112	1558	2950	52.81%	37.49%	8	8
8	臺南市白河區	2018-11-24T22:49:18+08:00	6685	2443	9128	1081	10209	24894	41.01%	26.85%	32	32
8	臺南市白河區	2018-11-24T23:14:33+08:00	6685	2443	9128	1081	10209	24894	41.01%	26.85%	32	32
8	臺南市白河區	2018-11-24T22:56:31+08:00	6685	2443	9128	1081	10209	24894	41.01%	26.85%	32	32
8	臺南市白河區	2018-11-25T00:12:39+08:00	6685	2443	9128	1081	10209	24894	41.01%	26.85%	32	32
8	臺南市白河區	2018-11-25T00:03:27+08:00	6685	2443	9128	1081	10209	24894	41.01%	26.85%	32	32
8	臺南市白河區	2018-11-25T00:56:07+08:00	6685	2443	9128	1081	10209	24894	41.01%	26.85%	32	32
8	臺南市白河區	2018-11-24T23:03:42+08:00	6685	2443	9128	1081	10209	24894	41.01%	26.85%	32	32
8	臺南市白河區	2018-11-24T23:10:51+08:00	6685	2443	9128	1081	10209	24894	41.01%	26.85%	32	32
8	臺南市白河區	2018-11-25T03:37:18+08:00	6685	2443	9128	1081	10209	24894	41.01%	26.85%	32	32
8	臺南市白河區	2018-11-24T22:43:44+08:00	6685	2443	9128	1081	10209	24894	41.01%	26.85%	32	32
8	臺南市白河區	2018-11-25T06:17:30+08:00	6685	2443	9128	1081	10209	24894	41.01%	26.85%	32	32
8	臺南市白河區	2018-11-24T23:22:17+08:00	6685	2443	9128	1081	10209	24894	41.01%	26.85%	32	32
8	臺南市白河區	2018-11-25T06:22:40+08:00	6685	2443	9128	1081	10209	24894	41.01%	26.85%	32	32
8	臺南市白河區	2018-11-24T23:29:41+08:00	6685	2443	9128	1081	10209	24894	41.01%	26.85%	32	32
8	臺南市白河區	2018-11-24T22:25:18+08:00	6685	2443	9128	1081	10209	24894	41.01%	26.85%	32	32
8	臺南市白河區	2018-11-25T01:11:00+08:00	6685	2443	9128	1081	10209	24894	41.01%	26.85%	32	32
8	臺南市白河區	2018-11-25T00:17:02+08:00	6685	2443	9128	1081	10209	24894	41.01%	26.85%	32	32
8	臺南市白河區	2018-11-25T00:07:58+08:00	6685	2443	9128	1081	10209	24894	41.01%	26.85%	32	32
8	臺南市白河區	2018-11-25T01:16:15+08:00	6685	2443	9128	1081	10209	24894	41.01%	26.85%	32	32
8	臺南市白河區	2018-11-25T01:05:52+08:00	6685	2443	9128	1081	10209	24894	41.01%	26.85%	32	32
8	臺南市白河區	2018-11-24T22:14:42+08:00	6685	2443	9128	1081	10209	24894	41.01%	26.85%	32	32
8	臺南市白河區	2018-11-24T23:54:19+08:00	6685	2443	9128	1081	10209	24894	41.01%	26.85%	32	32
8	臺南市白河區	2018-11-24T22:28:34+08:00	6685	2443	9128	1081	10209	24894	41.01%	26.85%	32	32
8	臺南市白河區	2018-11-24T22:18:13+08:00	6685	2443	9128	1081	10209	24894	41.01%	26.85%	32	32
8	臺南市白河區	2018-11-25T01:24:18+08:00	6685	2443	9128	1081	10209	24894	41.01%	26.85%	32	32
8	臺南市白河區	2018-11-24T22:35:39+08:00	6685	2443	9128	1081	10209	24894	41.01%	26.85%	32	32
8	臺南市白河區	2018-11-24T23:50:09+08:00	6685	2443	9128	1081	10209	24894	41.01%	26.85%	32	32
8	臺南市白河區	2018-11-24T23:58:35+08:00	6685	2443	9128	1081	10209	24894	41.01%	26.85%	32	32
8	臺南市白河區	2018-11-25T06:27:49+08:00	6685	2443	9128	1081	10209	24894	41.01%	26.85%	32	32
8	臺南市白河區	2018-11-24T22:39:03+08:00	6685	2443	9128	1081	10209	24894	41.01%	26.85%	32	32
8	臺南市白河區	2018-11-24T23:07:13+08:00	6685	2443	9128	1081	10209	24894	41.01%	26.85%	32	32
8	臺南市白河區	2018-11-25T01:00:54+08:00	6685	2443	9128	1081	10209	24894	41.01%	26.85%	32	32
8	臺南市白河區	2018-11-25T00:21:37+08:00	6685	2443	9128	1081	10209	24894	41.01%	26.85%	32	32
8	臺南市白河區	2018-11-25T03:48:23+08:00	6685	2443	9128	1081	10209	24894	41.01%	26.85%	32	32
8	臺南市白河區	2018-11-24T23:00:09+08:00	6685	2443	9128	1081	10209	24894	41.01%	26.85%	32	32
8	臺南市白河區	2018-11-25T03:30:52+08:00	6685	2443	9128	1081	10209	24894	41.01%	26.85%	32	32
8	臺南市白河區	2018-11-25T03:42:41+08:00	6685	2443	9128	1081	10209	24894	41.01%	26.85%	32	32
8	臺南市白河區	2018-11-24T22:21:39+08:00	6685	2443	9128	1081	10209	24894	41.01%	26.85%	32	32
8	臺南市白河區	2018-11-24T22:32:12+08:00	6685	2443	9128	1081	10209	24894	41.01%	26.85%	32	32
8	臺南市白河區	2018-11-24T22:53:08+08:00	6685	2443	9128	1081	10209	24894	41.01%	26.85%	32	32
8	臺南市白河區	2018-11-25T04:01:22+08:00	6685	2443	9128	1081	10209	24894	41.01%	26.85%	32	32
8	臺南市白河區	2018-11-24T22:11:57+08:00	6685	2443	9128	1081	10209	24894	41.01%	26.85%	32	32
8	臺南市白河區	2018-11-24T22:40:13+08:00	6685	2443	9128	1081	10209	24894	41.01%	26.85%	32	32
8	臺南市白河區	2018-11-25T06:12:31+08:00	6685	2443	9128	1081	10209	24894	41.01%	26.85%	32	32
8	臺南市白河區	2018-11-25T06:07:16+08:00	6685	2443	9128	1081	10209	24894	41.01%	26.85%	32	32
8	臺南市白河區	2018-11-24T23:33:44+08:00	6685	2443	9128	1081	10209	24894	41.01%	26.85%	32	32
8	臺南市白河區	2018-11-24T23:26:01+08:00	6685	2443	9128	1081	10209	24894	41.01%	26.85%	32	32
8	臺南市白河區	2018-11-25T03:54:34+08:00	6685	2443	9128	1081	10209	24894	41.01%	26.85%	32	32
8	臺南市白河區	2018-11-24T23:45:58+08:00	6685	2443	9128	1081	10209	24894	41.01%	26.85%	32	32
8	臺南市白河區	2018-11-24T23:41:56+08:00	6685	2443	9128	1081	10209	24894	41.01%	26.85%	32	32
8	臺南市白河區	2018-11-24T23:37:43+08:00	6685	2443	9128	1081	10209	24894	41.01%	26.85%	32	32
8	臺南市白河區	2018-11-24T23:18:21+08:00	6685	2443	9128	1081	10209	24894	41.01%	26.85%	32	32
8	嘉義縣布袋鎮	2018-11-24T22:39:08+08:00	7035	2386	9421	1459	10880	22781	47.76%	30.88%	28	29
8	嘉義縣布袋鎮	2018-11-24T23:07:18+08:00	7385	2490	9875	1525	11400	23965	47.57%	30.82%	29	29
8	嘉義縣布袋鎮	2018-11-24T22:56:36+08:00	7035	2386	9421	1459	10880	22781	47.76%	30.88%	28	29
8	嘉義縣布袋鎮	2018-11-25T01:24:24+08:00	7385	2490	9875	1525	11400	23965	47.57%	30.82%	29	29
8	嘉義縣布袋鎮	2018-11-25T03:54:40+08:00	7385	2490	9875	1525	11400	23965	47.57%	30.82%	29	29
8	嘉義縣布袋鎮	2018-11-25T06:17:36+08:00	7385	2490	9875	1525	11400	23965	47.57%	30.82%	29	29
8	嘉義縣布袋鎮	2018-11-24T23:10:56+08:00	7385	2490	9875	1525	11400	23965	47.57%	30.82%	29	29
8	嘉義縣布袋鎮	2018-11-25T03:37:29+08:00	7385	2490	9875	1525	11400	23965	47.57%	30.82%	29	29
8	嘉義縣布袋鎮	2018-11-25T03:30:59+08:00	7385	2490	9875	1525	11400	23965	47.57%	30.82%	29	29
8	嘉義縣布袋鎮	2018-11-24T22:32:18+08:00	6670	2266	8936	1386	10322	21358	48.33%	31.23%	27	29
8	嘉義縣布袋鎮	2018-11-24T23:42:01+08:00	7385	2490	9875	1525	11400	23965	47.57%	30.82%	29	29
8	嘉義縣布袋鎮	2018-11-25T03:48:29+08:00	7385	2490	9875	1525	11400	23965	47.57%	30.82%	29	29
8	嘉義縣布袋鎮	2018-11-25T06:07:22+08:00	7385	2490	9875	1525	11400	23965	47.57%	30.82%	29	29
8	嘉義縣布袋鎮	2018-11-25T00:21:44+08:00	7385	2490	9875	1525	11400	23965	47.57%	30.82%	29	29
8	嘉義縣布袋鎮	2018-11-24T23:29:46+08:00	7385	2490	9875	1525	11400	23965	47.57%	30.82%	29	29
8	嘉義縣布袋鎮	2018-11-24T22:40:18+08:00	7035	2386	9421	1459	10880	22781	47.76%	30.88%	28	29
8	嘉義縣布袋鎮	2018-11-25T04:01:29+08:00	7385	2490	9875	1525	11400	23965	47.57%	30.82%	29	29
8	嘉義縣布袋鎮	2018-11-24T23:00:16+08:00	7035	2386	9421	1459	10880	22781	47.76%	30.88%	28	29
8	嘉義縣布袋鎮	2018-11-25T01:11:07+08:00	7385	2490	9875	1525	11400	23965	47.57%	30.82%	29	29
8	嘉義縣布袋鎮	2018-11-24T23:37:48+08:00	7385	2490	9875	1525	11400	23965	47.57%	30.82%	29	29
8	嘉義縣布袋鎮	2018-11-24T22:43:50+08:00	7035	2386	9421	1459	10880	22781	47.76%	30.88%	28	29
8	嘉義縣布袋鎮	2018-11-25T00:56:13+08:00	7385	2490	9875	1525	11400	23965	47.57%	30.82%	29	29
8	嘉義縣布袋鎮	2018-11-24T23:54:27+08:00	7385	2490	9875	1525	11400	23965	47.57%	30.82%	29	29
8	嘉義縣布袋鎮	2018-11-25T01:16:22+08:00	7385	2490	9875	1525	11400	23965	47.57%	30.82%	29	29
8	嘉義縣布袋鎮	2018-11-25T00:03:34+08:00	7385	2490	9875	1525	11400	23965	47.57%	30.82%	29	29
8	嘉義縣布袋鎮	2018-11-24T22:35:44+08:00	7035	2386	9421	1459	10880	22781	47.76%	30.88%	28	29
8	嘉義縣布袋鎮	2018-11-25T01:01:01+08:00	7385	2490	9875	1525	11400	23965	47.57%	30.82%	29	29
8	嘉義縣布袋鎮	2018-11-24T23:22:23+08:00	7385	2490	9875	1525	11400	23965	47.57%	30.82%	29	29
8	嘉義縣布袋鎮	2018-11-24T22:49:24+08:00	7035	2386	9421	1459	10880	22781	47.76%	30.88%	28	29
8	嘉義縣布袋鎮	2018-11-24T23:03:47+08:00	7385	2490	9875	1525	11400	23965	47.57%	30.82%	29	29
8	嘉義縣布袋鎮	2018-11-24T22:28:40+08:00	6467	2216	8683	1347	10030	20744	48.35%	31.18%	26	29
8	嘉義縣布袋鎮	2018-11-24T23:33:50+08:00	7385	2490	9875	1525	11400	23965	47.57%	30.82%	29	29
8	嘉義縣布袋鎮	2018-11-24T22:12:02+08:00	5659	1990	7649	1117	8766	18239	48.06%	31.03%	23	29
8	嘉義縣布袋鎮	2018-11-25T00:08:04+08:00	7385	2490	9875	1525	11400	23965	47.57%	30.82%	29	29
8	嘉義縣布袋鎮	2018-11-25T03:42:48+08:00	7385	2490	9875	1525	11400	23965	47.57%	30.82%	29	29
8	嘉義縣布袋鎮	2018-11-24T22:53:15+08:00	7035	2386	9421	1459	10880	22781	47.76%	30.88%	28	29
8	嘉義縣布袋鎮	2018-11-24T23:46:03+08:00	7385	2490	9875	1525	11400	23965	47.57%	30.82%	29	29
8	嘉義縣布袋鎮	2018-11-25T00:17:07+08:00	7385	2490	9875	1525	11400	23965	47.57%	30.82%	29	29
8	嘉義縣布袋鎮	2018-11-24T22:21:46+08:00	6125	2122	8247	1261	9508	19631	48.43%	31.2%	25	29
8	嘉義縣布袋鎮	2018-11-24T22:25:25+08:00	6467	2216	8683	1347	10030	20744	48.35%	31.18%	26	29
8	嘉義縣布袋鎮	2018-11-25T06:22:44+08:00	7385	2490	9875	1525	11400	23965	47.57%	30.82%	29	29
8	嘉義縣布袋鎮	2018-11-25T06:12:36+08:00	7385	2490	9875	1525	11400	23965	47.57%	30.82%	29	29
8	嘉義縣布袋鎮	2018-11-25T00:12:44+08:00	7385	2490	9875	1525	11400	23965	47.57%	30.82%	29	29
8	嘉義縣布袋鎮	2018-11-24T23:26:06+08:00	7385	2490	9875	1525	11400	23965	47.57%	30.82%	29	29
8	嘉義縣布袋鎮	2018-11-24T23:18:27+08:00	7385	2490	9875	1525	11400	23965	47.57%	30.82%	29	29
8	嘉義縣布袋鎮	2018-11-24T23:50:14+08:00	7385	2490	9875	1525	11400	23965	47.57%	30.82%	29	29
8	嘉義縣布袋鎮	2018-11-24T23:14:40+08:00	7385	2490	9875	1525	11400	23965	47.57%	30.82%	29	29
8	嘉義縣布袋鎮	2018-11-24T22:18:19+08:00	5924	2059	7983	1162	9145	18970	48.21%	31.23%	24	29
8	嘉義縣布袋鎮	2018-11-24T23:58:42+08:00	7385	2490	9875	1525	11400	23965	47.57%	30.82%	29	29
8	嘉義縣布袋鎮	2018-11-25T06:27:55+08:00	7385	2490	9875	1525	11400	23965	47.57%	30.82%	29	29
8	嘉義縣布袋鎮	2018-11-24T22:14:48+08:00	5659	1990	7649	1117	8766	18239	48.06%	31.03%	23	29
8	嘉義縣布袋鎮	2018-11-25T01:05:59+08:00	7385	2490	9875	1525	11400	23965	47.57%	30.82%	29	29
8	金門縣金寧鄉	2018-11-24T23:26:10+08:00	7251	1722	8973	604	9577	26328	36.38%	27.54%	16	17
8	金門縣金寧鄉	2018-11-24T23:10:59+08:00	7251	1722	8973	604	9577	26328	36.38%	27.54%	16	17
8	金門縣金寧鄉	2018-11-24T22:49:27+08:00	7251	1722	8973	604	9577	26328	36.38%	27.54%	16	17
8	金門縣金寧鄉	2018-11-24T23:33:53+08:00	7708	1798	9506	651	10157	28162	36.07%	27.37%	17	17
8	金門縣金寧鄉	2018-11-24T22:12:06+08:00	5783	1262	7045	499	7544	21243	35.51%	27.22%	13	17
8	金門縣金寧鄉	2018-11-24T22:56:39+08:00	7251	1722	8973	604	9577	26328	36.38%	27.54%	16	17
8	金門縣金寧鄉	2018-11-24T23:22:26+08:00	7251	1722	8973	604	9577	26328	36.38%	27.54%	16	17
8	金門縣金寧鄉	2018-11-24T22:28:43+08:00	6243	1341	7584	528	8112	22716	35.71%	27.48%	14	17
8	金門縣金寧鄉	2018-11-24T23:18:30+08:00	7251	1722	8973	604	9577	26328	36.38%	27.54%	16	17
8	金門縣金寧鄉	2018-11-24T23:37:52+08:00	7708	1798	9506	651	10157	28162	36.07%	27.37%	17	17
8	金門縣金寧鄉	2018-11-25T00:17:11+08:00	7708	1798	9506	651	10157	28162	36.07%	27.37%	17	17
8	金門縣金寧鄉	2018-11-24T22:32:21+08:00	6243	1341	7584	528	8112	22716	35.71%	27.48%	14	17
8	金門縣金寧鄉	2018-11-24T22:21:50+08:00	6243	1341	7584	528	8112	22716	35.71%	27.48%	14	17
8	金門縣金寧鄉	2018-11-25T04:01:33+08:00	7708	1798	9506	651	10157	28162	36.07%	27.37%	17	17
8	金門縣金寧鄉	2018-11-24T23:46:07+08:00	7708	1798	9506	651	10157	28162	36.07%	27.37%	17	17
8	金門縣金寧鄉	2018-11-24T22:53:18+08:00	7251	1722	8973	604	9577	26328	36.38%	27.54%	16	17
8	金門縣金寧鄉	2018-11-25T00:08:08+08:00	7708	1798	9506	651	10157	28162	36.07%	27.37%	17	17
8	金門縣金寧鄉	2018-11-24T22:25:28+08:00	6243	1341	7584	528	8112	22716	35.71%	27.48%	14	17
8	金門縣金寧鄉	2018-11-24T23:00:20+08:00	7251	1722	8973	604	9577	26328	36.38%	27.54%	16	17
8	金門縣金寧鄉	2018-11-25T06:22:48+08:00	7708	1798	9506	651	10157	28162	36.07%	27.37%	17	17
8	金門縣金寧鄉	2018-11-25T03:48:35+08:00	7708	1798	9506	651	10157	28162	36.07%	27.37%	17	17
8	金門縣金寧鄉	2018-11-24T23:14:44+08:00	7251	1722	8973	604	9577	26328	36.38%	27.54%	16	17
8	金門縣金寧鄉	2018-11-25T03:37:33+08:00	7708	1798	9506	651	10157	28162	36.07%	27.37%	17	17
8	金門縣金寧鄉	2018-11-24T22:18:23+08:00	6243	1341	7584	528	8112	22716	35.71%	27.48%	14	17
8	金門縣金寧鄉	2018-11-24T23:50:18+08:00	7708	1798	9506	651	10157	28162	36.07%	27.37%	17	17
8	金門縣金寧鄉	2018-11-24T23:58:46+08:00	7708	1798	9506	651	10157	28162	36.07%	27.37%	17	17
8	金門縣金寧鄉	2018-11-25T00:12:48+08:00	7708	1798	9506	651	10157	28162	36.07%	27.37%	17	17
8	金門縣金寧鄉	2018-11-24T23:03:50+08:00	7251	1722	8973	604	9577	26328	36.38%	27.54%	16	17
8	金門縣金寧鄉	2018-11-24T22:39:12+08:00	6651	1434	8085	561	8646	24407	35.42%	27.25%	15	17
8	金門縣金寧鄉	2018-11-25T06:27:58+08:00	7708	1798	9506	651	10157	28162	36.07%	27.37%	17	17
8	金門縣金寧鄉	2018-11-25T06:17:40+08:00	7708	1798	9506	651	10157	28162	36.07%	27.37%	17	17
8	金門縣金寧鄉	2018-11-24T23:54:31+08:00	7708	1798	9506	651	10157	28162	36.07%	27.37%	17	17
8	金門縣金寧鄉	2018-11-24T22:14:52+08:00	6243	1341	7584	528	8112	22716	35.71%	27.48%	14	17
8	金門縣金寧鄉	2018-11-25T01:24:28+08:00	7708	1798	9506	651	10157	28162	36.07%	27.37%	17	17
8	金門縣金寧鄉	2018-11-25T03:54:45+08:00	7708	1798	9506	651	10157	28162	36.07%	27.37%	17	17
8	金門縣金寧鄉	2018-11-24T23:07:22+08:00	7251	1722	8973	604	9577	26328	36.38%	27.54%	16	17
8	金門縣金寧鄉	2018-11-25T06:12:40+08:00	7708	1798	9506	651	10157	28162	36.07%	27.37%	17	17
8	金門縣金寧鄉	2018-11-24T23:29:50+08:00	7251	1722	8973	604	9577	26328	36.38%	27.54%	16	17
8	金門縣金寧鄉	2018-11-24T23:42:05+08:00	7708	1798	9506	651	10157	28162	36.07%	27.37%	17	17
8	金門縣金寧鄉	2018-11-25T01:06:03+08:00	7708	1798	9506	651	10157	28162	36.07%	27.37%	17	17
8	金門縣金寧鄉	2018-11-25T01:11:11+08:00	7708	1798	9506	651	10157	28162	36.07%	27.37%	17	17
8	金門縣金寧鄉	2018-11-25T00:21:47+08:00	7708	1798	9506	651	10157	28162	36.07%	27.37%	17	17
8	金門縣金寧鄉	2018-11-25T03:42:52+08:00	7708	1798	9506	651	10157	28162	36.07%	27.37%	17	17
8	金門縣金寧鄉	2018-11-25T06:07:26+08:00	7708	1798	9506	651	10157	28162	36.07%	27.37%	17	17
8	金門縣金寧鄉	2018-11-24T22:40:22+08:00	6651	1434	8085	561	8646	24407	35.42%	27.25%	15	17
8	金門縣金寧鄉	2018-11-25T00:56:17+08:00	7708	1798	9506	651	10157	28162	36.07%	27.37%	17	17
8	金門縣金寧鄉	2018-11-24T22:43:54+08:00	6651	1434	8085	561	8646	24407	35.42%	27.25%	15	17
8	金門縣金寧鄉	2018-11-25T03:31:03+08:00	7708	1798	9506	651	10157	28162	36.07%	27.37%	17	17
8	金門縣金寧鄉	2018-11-24T22:35:47+08:00	6651	1434	8085	561	8646	24407	35.42%	27.25%	15	17
8	金門縣金寧鄉	2018-11-25T01:01:05+08:00	7708	1798	9506	651	10157	28162	36.07%	27.37%	17	17
8	金門縣金寧鄉	2018-11-25T01:16:26+08:00	7708	1798	9506	651	10157	28162	36.07%	27.37%	17	17
8	金門縣金寧鄉	2018-11-25T00:03:39+08:00	7708	1798	9506	651	10157	28162	36.07%	27.37%	17	17
8	嘉義縣中埔鄉	2018-11-24T23:07:18+08:00	8347	2821	11168	1224	12392	27240	45.49%	30.64%	26	34
8	嘉義縣中埔鄉	2018-11-24T22:56:36+08:00	7210	2424	9634	1056	10690	23570	45.35%	30.59%	24	34
8	嘉義縣中埔鄉	2018-11-25T01:24:24+08:00	12092	4090	16182	1719	17901	39139	45.74%	30.9%	34	34
8	嘉義縣中埔鄉	2018-11-25T06:17:36+08:00	12092	4090	16182	1719	17901	39139	45.74%	30.9%	34	34
8	嘉義縣中埔鄉	2018-11-24T23:10:56+08:00	8788	3003	11791	1311	13102	28839	45.43%	30.47%	27	34
8	嘉義縣中埔鄉	2018-11-25T03:37:29+08:00	12092	4090	16182	1719	17901	39139	45.74%	30.9%	34	34
8	嘉義縣中埔鄉	2018-11-24T22:39:09+08:00	6176	2091	8267	972	9239	20173	45.8%	30.62%	22	34
8	嘉義縣中埔鄉	2018-11-25T03:54:41+08:00	12092	4090	16182	1719	17901	39139	45.74%	30.9%	34	34
8	嘉義縣中埔鄉	2018-11-25T03:30:59+08:00	12092	4090	16182	1719	17901	39139	45.74%	30.9%	34	34
8	嘉義縣中埔鄉	2018-11-24T22:32:18+08:00	5742	1931	7673	899	8572	18732	45.76%	30.65%	21	34
8	嘉義縣中埔鄉	2018-11-25T03:48:29+08:00	12092	4090	16182	1719	17901	39139	45.74%	30.9%	34	34
8	嘉義縣中埔鄉	2018-11-24T23:00:17+08:00	7807	2622	10429	1126	11555	25452	45.4%	30.67%	25	34
8	嘉義縣中埔鄉	2018-11-25T00:21:44+08:00	12092	4090	16182	1719	17901	39139	45.74%	30.9%	34	34
8	嘉義縣中埔鄉	2018-11-24T23:29:46+08:00	9782	3311	13093	1420	14513	32171	45.11%	30.41%	29	34
8	嘉義縣中埔鄉	2018-11-25T06:07:23+08:00	12092	4090	16182	1719	17901	39139	45.74%	30.9%	34	34
8	嘉義縣中埔鄉	2018-11-25T04:01:29+08:00	12092	4090	16182	1719	17901	39139	45.74%	30.9%	34	34
8	嘉義縣中埔鄉	2018-11-25T01:11:07+08:00	12092	4090	16182	1719	17901	39139	45.74%	30.9%	34	34
8	嘉義縣中埔鄉	2018-11-24T22:40:19+08:00	6176	2091	8267	972	9239	20173	45.8%	30.62%	22	34
8	嘉義縣中埔鄉	2018-11-24T22:43:50+08:00	6176	2091	8267	972	9239	20173	45.8%	30.62%	22	34
8	嘉義縣中埔鄉	2018-11-25T00:56:13+08:00	12092	4090	16182	1719	17901	39139	45.74%	30.9%	34	34
8	嘉義縣中埔鄉	2018-11-24T23:54:27+08:00	10310	3503	13813	1519	15332	33980	45.12%	30.34%	30	34
8	嘉義縣中埔鄉	2018-11-24T22:35:45+08:00	5742	1931	7673	899	8572	18732	45.76%	30.65%	21	34
8	嘉義縣中埔鄉	2018-11-25T01:16:22+08:00	12092	4090	16182	1719	17901	39139	45.74%	30.9%	34	34
8	嘉義縣中埔鄉	2018-11-25T00:03:34+08:00	11381	3844	15225	1647	16872	37042	45.55%	30.72%	32	34
8	嘉義縣中埔鄉	2018-11-24T23:37:49+08:00	10310	3503	13813	1519	15332	33980	45.12%	30.34%	30	34
8	嘉義縣中埔鄉	2018-11-25T01:01:01+08:00	12092	4090	16182	1719	17901	39139	45.74%	30.9%	34	34
8	嘉義縣中埔鄉	2018-11-24T23:22:23+08:00	9427	3194	12621	1392	14013	30701	45.64%	30.71%	28	34
8	嘉義縣中埔鄉	2018-11-24T22:49:24+08:00	6724	2274	8998	1011	10009	21976	45.55%	30.6%	23	34
8	嘉義縣中埔鄉	2018-11-24T23:03:47+08:00	8347	2821	11168	1224	12392	27240	45.49%	30.64%	26	34
8	嘉義縣中埔鄉	2018-11-24T22:28:40+08:00	5228	1790	7018	804	7822	17033	45.92%	30.69%	20	34
8	嘉義縣中埔鄉	2018-11-24T23:33:50+08:00	9782	3311	13093	1420	14513	32171	45.11%	30.41%	29	34
8	嘉義縣中埔鄉	2018-11-24T22:12:02+08:00	3656	1223	4879	578	5457	11605	47.02%	31.5%	15	34
8	嘉義縣中埔鄉	2018-11-24T23:42:02+08:00	10310	3503	13813	1519	15332	33980	45.12%	30.34%	30	34
8	嘉義縣中埔鄉	2018-11-25T00:08:05+08:00	12000	4051	16051	1702	17753	38843	45.7%	30.89%	33	34
8	嘉義縣中埔鄉	2018-11-25T03:42:48+08:00	12092	4090	16182	1719	17901	39139	45.74%	30.9%	34	34
8	嘉義縣中埔鄉	2018-11-24T22:53:15+08:00	7210	2424	9634	1056	10690	23570	45.35%	30.59%	24	34
8	嘉義縣中埔鄉	2018-11-24T23:46:03+08:00	10310	3503	13813	1519	15332	33980	45.12%	30.34%	30	34
8	嘉義縣中埔鄉	2018-11-25T06:12:37+08:00	12092	4090	16182	1719	17901	39139	45.74%	30.9%	34	34
8	嘉義縣中埔鄉	2018-11-24T22:21:46+08:00	4639	1598	6237	695	6932	15273	45.39%	30.37%	18	34
8	嘉義縣中埔鄉	2018-11-24T22:25:25+08:00	4983	1693	6676	755	7431	16154	46%	30.85%	19	34
8	嘉義縣中埔鄉	2018-11-25T00:17:08+08:00	12092	4090	16182	1719	17901	39139	45.74%	30.9%	34	34
8	嘉義縣中埔鄉	2018-11-25T06:22:45+08:00	12092	4090	16182	1719	17901	39139	45.74%	30.9%	34	34
8	嘉義縣中埔鄉	2018-11-24T22:14:49+08:00	3656	1223	4879	578	5457	11605	47.02%	31.5%	15	34
8	嘉義縣中埔鄉	2018-11-24T22:18:20+08:00	4151	1432	5583	639	6222	13335	46.66%	31.13%	16	34
8	嘉義縣中埔鄉	2018-11-24T23:18:27+08:00	9427	3194	12621	1392	14013	30701	45.64%	30.71%	28	34
8	嘉義縣中埔鄉	2018-11-24T23:58:42+08:00	10851	3665	14516	1584	16100	35461	45.4%	30.6%	31	34
8	嘉義縣中埔鄉	2018-11-25T06:27:55+08:00	12092	4090	16182	1719	17901	39139	45.74%	30.9%	34	34
8	嘉義縣中埔鄉	2018-11-24T23:26:07+08:00	9782	3311	13093	1420	14513	32171	45.11%	30.41%	29	34
8	嘉義縣中埔鄉	2018-11-25T00:12:45+08:00	12092	4090	16182	1719	17901	39139	45.74%	30.9%	34	34
8	嘉義縣中埔鄉	2018-11-25T01:05:59+08:00	12092	4090	16182	1719	17901	39139	45.74%	30.9%	34	34
8	嘉義縣中埔鄉	2018-11-24T23:14:41+08:00	8788	3003	11791	1311	13102	28839	45.43%	30.47%	27	34
8	嘉義縣中埔鄉	2018-11-24T23:50:15+08:00	10310	3503	13813	1519	15332	33980	45.12%	30.34%	30	34
8	高雄市茄萣區	2018-11-24T22:49:20+08:00	8933	3368	12301	1321	13622	26212	51.97%	34.08%	21	21
8	高雄市茄萣區	2018-11-25T03:37:21+08:00	8933	3368	12301	1321	13622	26212	51.97%	34.08%	21	21
8	高雄市茄萣區	2018-11-24T23:03:44+08:00	8933	3368	12301	1321	13622	26212	51.97%	34.08%	21	21
8	高雄市茄萣區	2018-11-25T00:03:29+08:00	8933	3368	12301	1321	13622	26212	51.97%	34.08%	21	21
8	高雄市茄萣區	2018-11-25T00:56:09+08:00	8933	3368	12301	1321	13622	26212	51.97%	34.08%	21	21
8	高雄市茄萣區	2018-11-24T23:58:38+08:00	8933	3368	12301	1321	13622	26212	51.97%	34.08%	21	21
8	高雄市茄萣區	2018-11-24T23:22:19+08:00	8933	3368	12301	1321	13622	26212	51.97%	34.08%	21	21
8	高雄市茄萣區	2018-11-25T03:42:44+08:00	8933	3368	12301	1321	13622	26212	51.97%	34.08%	21	21
8	高雄市茄萣區	2018-11-25T01:00:57+08:00	8933	3368	12301	1321	13622	26212	51.97%	34.08%	21	21
8	高雄市茄萣區	2018-11-25T00:08:00+08:00	8933	3368	12301	1321	13622	26212	51.97%	34.08%	21	21
8	高雄市茄萣區	2018-11-24T22:53:11+08:00	8933	3368	12301	1321	13622	26212	51.97%	34.08%	21	21
8	高雄市茄萣區	2018-11-24T23:46:00+08:00	8933	3368	12301	1321	13622	26212	51.97%	34.08%	21	21
8	高雄市茄萣區	2018-11-24T22:21:42+08:00	8933	3368	12301	1321	13622	26212	51.97%	34.08%	21	21
8	高雄市茄萣區	2018-11-25T06:12:33+08:00	8933	3368	12301	1321	13622	26212	51.97%	34.08%	21	21
8	高雄市茄萣區	2018-11-25T00:17:04+08:00	8933	3368	12301	1321	13622	26212	51.97%	34.08%	21	21
8	高雄市茄萣區	2018-11-25T06:22:41+08:00	8933	3368	12301	1321	13622	26212	51.97%	34.08%	21	21
8	高雄市茄萣區	2018-11-24T22:25:20+08:00	8933	3368	12301	1321	13622	26212	51.97%	34.08%	21	21
8	高雄市茄萣區	2018-11-24T23:18:23+08:00	8933	3368	12301	1321	13622	26212	51.97%	34.08%	21	21
8	高雄市茄萣區	2018-11-25T01:05:55+08:00	8933	3368	12301	1321	13622	26212	51.97%	34.08%	21	21
8	高雄市茄萣區	2018-11-24T23:50:11+08:00	8933	3368	12301	1321	13622	26212	51.97%	34.08%	21	21
8	高雄市茄萣區	2018-11-24T22:14:45+08:00	8302	3136	11438	1200	12638	24427	51.74%	33.99%	20	21
8	高雄市茄萣區	2018-11-24T23:33:46+08:00	8933	3368	12301	1321	13622	26212	51.97%	34.08%	21	21
8	高雄市茄萣區	2018-11-25T06:27:51+08:00	8933	3368	12301	1321	13622	26212	51.97%	34.08%	21	21
8	高雄市茄萣區	2018-11-24T23:26:03+08:00	8933	3368	12301	1321	13622	26212	51.97%	34.08%	21	21
8	高雄市茄萣區	2018-11-25T03:54:36+08:00	8933	3368	12301	1321	13622	26212	51.97%	34.08%	21	21
8	高雄市茄萣區	2018-11-25T00:12:41+08:00	8933	3368	12301	1321	13622	26212	51.97%	34.08%	21	21
8	高雄市茄萣區	2018-11-25T01:24:20+08:00	8933	3368	12301	1321	13622	26212	51.97%	34.08%	21	21
8	高雄市茄萣區	2018-11-24T22:43:46+08:00	8933	3368	12301	1321	13622	26212	51.97%	34.08%	21	21
8	高雄市茄萣區	2018-11-25T06:17:32+08:00	8933	3368	12301	1321	13622	26212	51.97%	34.08%	21	21
8	高雄市茄萣區	2018-11-24T23:07:15+08:00	8933	3368	12301	1321	13622	26212	51.97%	34.08%	21	21
8	高雄市茄萣區	2018-11-24T22:39:05+08:00	8933	3368	12301	1321	13622	26212	51.97%	34.08%	21	21
8	高雄市茄萣區	2018-11-24T23:10:53+08:00	8933	3368	12301	1321	13622	26212	51.97%	34.08%	21	21
8	高雄市茄萣區	2018-11-24T22:56:33+08:00	8933	3368	12301	1321	13622	26212	51.97%	34.08%	21	21
8	高雄市茄萣區	2018-11-24T23:14:36+08:00	8933	3368	12301	1321	13622	26212	51.97%	34.08%	21	21
8	高雄市茄萣區	2018-11-25T03:48:25+08:00	8933	3368	12301	1321	13622	26212	51.97%	34.08%	21	21
8	高雄市茄萣區	2018-11-24T22:32:14+08:00	8933	3368	12301	1321	13622	26212	51.97%	34.08%	21	21
8	高雄市茄萣區	2018-11-25T03:30:54+08:00	8933	3368	12301	1321	13622	26212	51.97%	34.08%	21	21
8	高雄市茄萣區	2018-11-24T22:40:15+08:00	8933	3368	12301	1321	13622	26212	51.97%	34.08%	21	21
8	高雄市茄萣區	2018-11-25T00:21:40+08:00	8933	3368	12301	1321	13622	26212	51.97%	34.08%	21	21
8	高雄市茄萣區	2018-11-24T23:29:42+08:00	8933	3368	12301	1321	13622	26212	51.97%	34.08%	21	21
8	高雄市茄萣區	2018-11-25T01:11:02+08:00	8933	3368	12301	1321	13622	26212	51.97%	34.08%	21	21
8	高雄市茄萣區	2018-11-25T04:01:25+08:00	8933	3368	12301	1321	13622	26212	51.97%	34.08%	21	21
8	高雄市茄萣區	2018-11-24T22:11:59+08:00	8302	3136	11438	1200	12638	24427	51.74%	33.99%	20	21
8	高雄市茄萣區	2018-11-24T23:00:14+08:00	8933	3368	12301	1321	13622	26212	51.97%	34.08%	21	21
8	高雄市茄萣區	2018-11-25T06:07:19+08:00	8933	3368	12301	1321	13622	26212	51.97%	34.08%	21	21
8	高雄市茄萣區	2018-11-24T22:28:36+08:00	8933	3368	12301	1321	13622	26212	51.97%	34.08%	21	21
8	高雄市茄萣區	2018-11-24T22:18:16+08:00	8302	3136	11438	1200	12638	24427	51.74%	33.99%	20	21
8	高雄市茄萣區	2018-11-24T23:54:23+08:00	8933	3368	12301	1321	13622	26212	51.97%	34.08%	21	21
8	高雄市茄萣區	2018-11-24T22:35:41+08:00	8933	3368	12301	1321	13622	26212	51.97%	34.08%	21	21
8	高雄市茄萣區	2018-11-24T23:37:45+08:00	8933	3368	12301	1321	13622	26212	51.97%	34.08%	21	21
8	高雄市茄萣區	2018-11-24T23:41:58+08:00	8933	3368	12301	1321	13622	26212	51.97%	34.08%	21	21
8	高雄市茄萣區	2018-11-25T01:16:17+08:00	8933	3368	12301	1321	13622	26212	51.97%	34.08%	21	21
8	高雄市茂林區	2018-11-24T22:49:20+08:00	532	116	648	54	702	1108	63.36%	48.01%	2	3
8	高雄市茂林區	2018-11-24T23:03:44+08:00	532	116	648	54	702	1108	63.36%	48.01%	2	3
8	高雄市茂林區	2018-11-24T23:22:20+08:00	532	116	648	54	702	1108	63.36%	48.01%	2	3
8	高雄市茂林區	2018-11-24T23:58:38+08:00	784	183	967	91	1058	1615	65.51%	48.54%	3	3
8	高雄市茂林區	2018-11-25T03:42:44+08:00	784	183	967	91	1058	1615	65.51%	48.54%	3	3
8	高雄市茂林區	2018-11-25T01:00:57+08:00	784	183	967	91	1058	1615	65.51%	48.54%	3	3
8	高雄市茂林區	2018-11-24T22:53:11+08:00	532	116	648	54	702	1108	63.36%	48.01%	2	3
8	高雄市茂林區	2018-11-24T23:46:00+08:00	532	116	648	54	702	1108	63.36%	48.01%	2	3
8	高雄市茂林區	2018-11-25T00:08:01+08:00	784	183	967	91	1058	1615	65.51%	48.54%	3	3
8	高雄市茂林區	2018-11-24T22:21:42+08:00	532	116	648	54	702	1108	63.36%	48.01%	2	3
8	高雄市茂林區	2018-11-25T06:12:33+08:00	784	183	967	91	1058	1615	65.51%	48.54%	3	3
8	高雄市茂林區	2018-11-25T00:17:04+08:00	784	183	967	91	1058	1615	65.51%	48.54%	3	3
8	高雄市茂林區	2018-11-24T22:25:20+08:00	532	116	648	54	702	1108	63.36%	48.01%	2	3
8	高雄市茂林區	2018-11-24T23:18:24+08:00	532	116	648	54	702	1108	63.36%	48.01%	2	3
8	高雄市茂林區	2018-11-24T23:37:46+08:00	532	116	648	54	702	1108	63.36%	48.01%	2	3
8	高雄市茂林區	2018-11-25T03:54:37+08:00	784	183	967	91	1058	1615	65.51%	48.54%	3	3
8	高雄市茂林區	2018-11-24T23:33:47+08:00	532	116	648	54	702	1108	63.36%	48.01%	2	3
8	高雄市茂林區	2018-11-25T01:05:55+08:00	784	183	967	91	1058	1615	65.51%	48.54%	3	3
8	高雄市茂林區	2018-11-24T23:50:11+08:00	784	183	967	91	1058	1615	65.51%	48.54%	3	3
8	高雄市茂林區	2018-11-24T23:26:04+08:00	532	116	648	54	702	1108	63.36%	48.01%	2	3
8	高雄市茂林區	2018-11-24T22:14:45+08:00	193	45	238	23	261	382	68.32%	50.52%	1	3
8	高雄市茂林區	2018-11-25T01:24:20+08:00	784	183	967	91	1058	1615	65.51%	48.54%	3	3
8	高雄市茂林區	2018-11-24T22:43:46+08:00	532	116	648	54	702	1108	63.36%	48.01%	2	3
8	高雄市茂林區	2018-11-25T06:17:32+08:00	784	183	967	91	1058	1615	65.51%	48.54%	3	3
8	高雄市茂林區	2018-11-25T03:37:22+08:00	784	183	967	91	1058	1615	65.51%	48.54%	3	3
8	高雄市茂林區	2018-11-24T23:07:15+08:00	532	116	648	54	702	1108	63.36%	48.01%	2	3
8	高雄市茂林區	2018-11-24T22:39:05+08:00	532	116	648	54	702	1108	63.36%	48.01%	2	3
8	高雄市茂林區	2018-11-24T23:10:53+08:00	532	116	648	54	702	1108	63.36%	48.01%	2	3
8	高雄市茂林區	2018-11-24T22:56:33+08:00	532	116	648	54	702	1108	63.36%	48.01%	2	3
8	高雄市茂林區	2018-11-24T23:14:36+08:00	532	116	648	54	702	1108	63.36%	48.01%	2	3
8	高雄市茂林區	2018-11-25T03:48:25+08:00	784	183	967	91	1058	1615	65.51%	48.54%	3	3
8	高雄市茂林區	2018-11-25T03:30:55+08:00	784	183	967	91	1058	1615	65.51%	48.54%	3	3
8	高雄市茂林區	2018-11-24T22:32:15+08:00	532	116	648	54	702	1108	63.36%	48.01%	2	3
8	高雄市茂林區	2018-11-24T22:40:15+08:00	532	116	648	54	702	1108	63.36%	48.01%	2	3
8	高雄市茂林區	2018-11-25T04:01:25+08:00	784	183	967	91	1058	1615	65.51%	48.54%	3	3
8	高雄市茂林區	2018-11-24T22:11:59+08:00	193	45	238	23	261	382	68.32%	50.52%	1	3
8	高雄市茂林區	2018-11-24T23:00:14+08:00	532	116	648	54	702	1108	63.36%	48.01%	2	3
8	高雄市茂林區	2018-11-25T06:07:19+08:00	784	183	967	91	1058	1615	65.51%	48.54%	3	3
8	高雄市茂林區	2018-11-25T01:11:03+08:00	784	183	967	91	1058	1615	65.51%	48.54%	3	3
8	高雄市茂林區	2018-11-24T23:29:43+08:00	532	116	648	54	702	1108	63.36%	48.01%	2	3
8	高雄市茂林區	2018-11-25T00:21:41+08:00	784	183	967	91	1058	1615	65.51%	48.54%	3	3
8	高雄市茂林區	2018-11-25T06:22:42+08:00	784	183	967	91	1058	1615	65.51%	48.54%	3	3
8	高雄市茂林區	2018-11-24T22:28:36+08:00	532	116	648	54	702	1108	63.36%	48.01%	2	3
8	高雄市茂林區	2018-11-25T00:56:10+08:00	784	183	967	91	1058	1615	65.51%	48.54%	3	3
8	高雄市茂林區	2018-11-24T22:18:16+08:00	193	45	238	23	261	382	68.32%	50.52%	1	3
8	高雄市茂林區	2018-11-24T23:54:24+08:00	784	183	967	91	1058	1615	65.51%	48.54%	3	3
8	高雄市茂林區	2018-11-24T22:35:41+08:00	532	116	648	54	702	1108	63.36%	48.01%	2	3
8	高雄市茂林區	2018-11-25T01:16:18+08:00	784	183	967	91	1058	1615	65.51%	48.54%	3	3
8	高雄市茂林區	2018-11-24T23:41:58+08:00	532	116	648	54	702	1108	63.36%	48.01%	2	3
8	高雄市茂林區	2018-11-25T06:27:52+08:00	784	183	967	91	1058	1615	65.51%	48.54%	3	3
8	高雄市茂林區	2018-11-25T00:12:42+08:00	784	183	967	91	1058	1615	65.51%	48.54%	3	3
8	高雄市茂林區	2018-11-25T00:03:30+08:00	784	183	967	91	1058	1615	65.51%	48.54%	3	3
8	臺中市沙鹿區	2018-11-24T23:10:50+08:00	24887	7392	32279	2433	34712	60938	56.96%	40.84%	45	53
8	臺中市沙鹿區	2018-11-25T00:56:06+08:00	29978	8985	38963	2982	41945	74207	56.52%	40.4%	53	53
8	臺中市沙鹿區	2018-11-24T23:14:33+08:00	24887	7392	32279	2433	34712	60938	56.96%	40.84%	45	53
8	臺中市沙鹿區	2018-11-24T23:22:16+08:00	26863	7988	34851	2616	37467	66330	56.49%	40.5%	48	53
8	臺中市沙鹿區	2018-11-24T22:49:17+08:00	20382	6042	26424	1992	28416	49674	57.2%	41.03%	38	53
8	臺中市沙鹿區	2018-11-25T03:37:18+08:00	29978	8985	38963	2982	41945	74207	56.52%	40.4%	53	53
8	臺中市沙鹿區	2018-11-24T22:43:43+08:00	19590	5888	25478	1989	27467	48041	57.17%	40.78%	37	53
8	臺中市沙鹿區	2018-11-25T00:03:26+08:00	29978	8985	38963	2982	41945	74207	56.52%	40.4%	53	53
8	臺中市沙鹿區	2018-11-25T01:10:59+08:00	29978	8985	38963	2982	41945	74207	56.52%	40.4%	53	53
8	臺中市沙鹿區	2018-11-24T22:56:30+08:00	21069	6266	27335	2076	29411	51302	57.33%	41.07%	39	53
8	臺中市沙鹿區	2018-11-25T00:12:38+08:00	29978	8985	38963	2982	41945	74207	56.52%	40.4%	53	53
8	臺中市沙鹿區	2018-11-25T06:22:39+08:00	29978	8985	38963	2982	41945	74207	56.52%	40.4%	53	53
8	臺中市沙鹿區	2018-11-25T03:30:51+08:00	29978	8985	38963	2982	41945	74207	56.52%	40.4%	53	53
8	臺中市沙鹿區	2018-11-24T22:25:17+08:00	16760	5035	21795	1722	23517	40905	57.49%	40.97%	32	53
8	臺中市沙鹿區	2018-11-24T23:29:40+08:00	28738	8559	37297	2817	40114	71020	56.48%	40.46%	51	53
8	臺中市沙鹿區	2018-11-24T23:54:18+08:00	29978	8985	38963	2982	41945	74207	56.52%	40.4%	53	53
8	臺中市沙鹿區	2018-11-25T00:07:57+08:00	29978	8985	38963	2982	41945	74207	56.52%	40.4%	53	53
8	臺中市沙鹿區	2018-11-25T01:16:14+08:00	29978	8985	38963	2982	41945	74207	56.52%	40.4%	53	53
8	臺中市沙鹿區	2018-11-24T22:14:42+08:00	14999	4525	19524	1570	21094	36732	57.43%	40.83%	29	53
8	臺中市沙鹿區	2018-11-24T22:18:13+08:00	14999	4525	19524	1570	21094	36732	57.43%	40.83%	29	53
8	臺中市沙鹿區	2018-11-24T22:28:33+08:00	17957	5442	23399	1837	25236	43773	57.65%	41.02%	34	53
8	臺中市沙鹿區	2018-11-24T23:50:08+08:00	29978	8985	38963	2982	41945	74207	56.52%	40.4%	53	53
8	臺中市沙鹿區	2018-11-25T01:24:16+08:00	29978	8985	38963	2982	41945	74207	56.52%	40.4%	53	53
8	臺中市沙鹿區	2018-11-24T23:07:12+08:00	24887	7392	32279	2433	34712	60938	56.96%	40.84%	45	53
8	臺中市沙鹿區	2018-11-24T22:39:02+08:00	19590	5888	25478	1989	27467	48041	57.17%	40.78%	37	53
8	臺中市沙鹿區	2018-11-25T06:27:48+08:00	29978	8985	38963	2982	41945	74207	56.52%	40.4%	53	53
8	臺中市沙鹿區	2018-11-24T22:35:39+08:00	18967	5695	24662	1932	26594	46413	57.3%	40.87%	36	53
8	臺中市沙鹿區	2018-11-24T23:58:35+08:00	29978	8985	38963	2982	41945	74207	56.52%	40.4%	53	53
8	臺中市沙鹿區	2018-11-24T23:03:41+08:00	23448	6981	30429	2338	32767	57432	57.05%	40.83%	43	53
8	臺中市沙鹿區	2018-11-25T01:00:53+08:00	29978	8985	38963	2982	41945	74207	56.52%	40.4%	53	53
8	臺中市沙鹿區	2018-11-24T23:00:08+08:00	21740	6430	28170	2116	30286	52996	57.15%	41.02%	40	53
8	臺中市沙鹿區	2018-11-25T03:48:22+08:00	29978	8985	38963	2982	41945	74207	56.52%	40.4%	53	53
8	臺中市沙鹿區	2018-11-25T00:21:37+08:00	29978	8985	38963	2982	41945	74207	56.52%	40.4%	53	53
8	臺中市沙鹿區	2018-11-25T03:42:40+08:00	29978	8985	38963	2982	41945	74207	56.52%	40.4%	53	53
8	臺中市沙鹿區	2018-11-24T22:21:39+08:00	16310	4920	21230	1689	22919	39866	57.49%	40.91%	31	53
8	臺中市沙鹿區	2018-11-24T22:32:12+08:00	18568	5604	24172	1889	26061	45389	57.42%	40.91%	35	53
8	臺中市沙鹿區	2018-11-25T04:01:22+08:00	29978	8985	38963	2982	41945	74207	56.52%	40.4%	53	53
8	臺中市沙鹿區	2018-11-25T00:17:01+08:00	29978	8985	38963	2982	41945	74207	56.52%	40.4%	53	53
8	臺中市沙鹿區	2018-11-24T22:40:13+08:00	19590	5888	25478	1989	27467	48041	57.17%	40.78%	37	53
8	臺中市沙鹿區	2018-11-24T22:53:07+08:00	20382	6042	26424	1992	28416	49674	57.2%	41.03%	38	53
8	臺中市沙鹿區	2018-11-25T06:12:31+08:00	29978	8985	38963	2982	41945	74207	56.52%	40.4%	53	53
8	臺中市沙鹿區	2018-11-24T22:11:56+08:00	14999	4525	19524	1570	21094	36732	57.43%	40.83%	29	53
8	臺中市沙鹿區	2018-11-25T06:07:16+08:00	29978	8985	38963	2982	41945	74207	56.52%	40.4%	53	53
8	臺中市沙鹿區	2018-11-25T03:54:33+08:00	29978	8985	38963	2982	41945	74207	56.52%	40.4%	53	53
8	臺中市沙鹿區	2018-11-25T01:05:51+08:00	29978	8985	38963	2982	41945	74207	56.52%	40.4%	53	53
8	臺中市沙鹿區	2018-11-24T23:26:01+08:00	27451	8177	35628	2701	38329	67774	56.55%	40.5%	49	53
8	臺中市沙鹿區	2018-11-24T23:33:43+08:00	29978	8985	38963	2982	41945	74207	56.52%	40.4%	53	53
8	臺中市沙鹿區	2018-11-25T06:17:29+08:00	29978	8985	38963	2982	41945	74207	56.52%	40.4%	53	53
8	臺中市沙鹿區	2018-11-24T23:41:56+08:00	29978	8985	38963	2982	41945	74207	56.52%	40.4%	53	53
8	臺中市沙鹿區	2018-11-24T23:37:43+08:00	29978	8985	38963	2982	41945	74207	56.52%	40.4%	53	53
8	臺中市沙鹿區	2018-11-24T23:18:21+08:00	24887	7392	32279	2433	34712	60938	56.96%	40.84%	45	53
8	臺中市沙鹿區	2018-11-24T23:45:57+08:00	29978	8985	38963	2982	41945	74207	56.52%	40.4%	53	53
8	臺中市南區	2018-11-25T03:37:17+08:00	45430	13472	58902	4366	63268	103643	61.04%	43.83%	74	74
8	臺中市南區	2018-11-24T23:10:50+08:00	41279	12272	53551	3920	57471	94235	60.99%	43.8%	68	74
8	臺中市南區	2018-11-25T00:56:06+08:00	45430	13472	58902	4366	63268	103643	61.04%	43.83%	74	74
8	臺中市南區	2018-11-24T23:22:16+08:00	41279	12272	53551	3920	57471	94235	60.99%	43.8%	68	74
8	臺中市南區	2018-11-25T01:10:58+08:00	45430	13472	58902	4366	63268	103643	61.04%	43.83%	74	74
8	臺中市南區	2018-11-25T00:12:37+08:00	42750	12683	55433	4057	59490	97600	60.95%	43.8%	70	74
8	臺中市南區	2018-11-24T22:49:17+08:00	40240	11940	52180	3815	55995	91636	61.11%	43.91%	66	74
8	臺中市南區	2018-11-24T23:14:32+08:00	41279	12272	53551	3920	57471	94235	60.99%	43.8%	68	74
8	臺中市南區	2018-11-24T22:43:43+08:00	39773	11778	51551	3730	55281	90506	61.08%	43.95%	65	74
8	臺中市南區	2018-11-25T00:03:26+08:00	41866	12464	54330	4023	58353	95539	61.08%	43.82%	69	74
8	臺中市南區	2018-11-24T22:56:30+08:00	40776	12111	52887	3852	56739	93028	60.99%	43.83%	67	74
8	臺中市南區	2018-11-25T03:48:21+08:00	45430	13472	58902	4366	63268	103643	61.04%	43.83%	74	74
8	臺中市南區	2018-11-25T06:22:38+08:00	45430	13472	58902	4366	63268	103643	61.04%	43.83%	74	74
8	臺中市南區	2018-11-25T03:30:51+08:00	45430	13472	58902	4366	63268	103643	61.04%	43.83%	74	74
8	臺中市南區	2018-11-25T04:01:21+08:00	45430	13472	58902	4366	63268	103643	61.04%	43.83%	74	74
8	臺中市南區	2018-11-24T22:25:17+08:00	35745	10629	46374	3391	49765	82024	60.67%	43.58%	59	74
8	臺中市南區	2018-11-25T06:07:15+08:00	45430	13472	58902	4366	63268	103643	61.04%	43.83%	74	74
8	臺中市南區	2018-11-24T23:29:40+08:00	41279	12272	53551	3920	57471	94235	60.99%	43.8%	68	74
8	臺中市南區	2018-11-24T22:18:12+08:00	33144	9885	43029	3165	46194	76164	60.65%	43.52%	55	74
8	臺中市南區	2018-11-24T23:54:18+08:00	41866	12464	54330	4023	58353	95539	61.08%	43.82%	69	74
8	臺中市南區	2018-11-25T00:07:57+08:00	41216	12287	53503	3946	57449	94152	61.02%	43.78%	68	74
8	臺中市南區	2018-11-25T01:16:14+08:00	45430	13472	58902	4366	63268	103643	61.04%	43.83%	74	74
8	臺中市南區	2018-11-24T23:41:55+08:00	41866	12464	54330	4023	58353	95539	61.08%	43.82%	69	74
8	臺中市南區	2018-11-24T22:28:33+08:00	36372	10789	47161	3429	50590	83418	60.65%	43.6%	60	74
8	臺中市南區	2018-11-24T23:58:34+08:00	41866	12464	54330	4023	58353	95539	61.08%	43.82%	69	74
8	臺中市南區	2018-11-24T23:50:08+08:00	41866	12464	54330	4023	58353	95539	61.08%	43.82%	69	74
8	臺中市南區	2018-11-25T01:24:16+08:00	45430	13472	58902	4366	63268	103643	61.04%	43.83%	74	74
8	臺中市南區	2018-11-24T22:35:38+08:00	38163	11302	49465	3588	53053	87057	60.94%	43.84%	63	74
8	臺中市南區	2018-11-24T23:07:12+08:00	41279	12272	53551	3920	57471	94235	60.99%	43.8%	68	74
8	臺中市南區	2018-11-24T22:39:02+08:00	38163	11302	49465	3588	53053	87057	60.94%	43.84%	63	74
8	臺中市南區	2018-11-25T06:27:48+08:00	45430	13472	58902	4366	63268	103643	61.04%	43.83%	74	74
8	臺中市南區	2018-11-24T23:03:41+08:00	41279	12272	53551	3920	57471	94235	60.99%	43.8%	68	74
8	臺中市南區	2018-11-25T01:00:53+08:00	45430	13472	58902	4366	63268	103643	61.04%	43.83%	74	74
8	臺中市南區	2018-11-24T22:21:38+08:00	34467	10249	44716	3280	47996	79040	60.72%	43.61%	57	74
8	臺中市南區	2018-11-25T03:42:40+08:00	45430	13472	58902	4366	63268	103643	61.04%	43.83%	74	74
8	臺中市南區	2018-11-24T23:00:07+08:00	40776	12111	52887	3852	56739	93028	60.99%	43.83%	67	74
8	臺中市南區	2018-11-25T00:21:36+08:00	43400	12860	56260	4134	60394	98987	61.01%	43.84%	71	74
8	臺中市南區	2018-11-24T22:32:12+08:00	36942	10975	47917	3495	51412	84667	60.72%	43.63%	61	74
8	臺中市南區	2018-11-25T06:12:30+08:00	45430	13472	58902	4366	63268	103643	61.04%	43.83%	74	74
8	臺中市南區	2018-11-24T22:40:12+08:00	38942	11521	50463	3672	54135	88780	60.98%	43.86%	64	74
8	臺中市南區	2018-11-25T00:17:01+08:00	42750	12683	55433	4057	59490	97600	60.95%	43.8%	70	74
8	臺中市南區	2018-11-24T22:53:07+08:00	40776	12111	52887	3852	56739	93028	60.99%	43.83%	67	74
8	臺中市南區	2018-11-24T22:11:56+08:00	31367	9329	40696	2995	43691	71995	60.69%	43.57%	52	74
8	臺中市南區	2018-11-25T03:54:33+08:00	45430	13472	58902	4366	63268	103643	61.04%	43.83%	74	74
8	臺中市南區	2018-11-25T01:05:51+08:00	45430	13472	58902	4366	63268	103643	61.04%	43.83%	74	74
8	臺中市南區	2018-11-24T23:33:43+08:00	41279	12272	53551	3920	57471	94235	60.99%	43.8%	68	74
8	臺中市南區	2018-11-24T23:18:20+08:00	41279	12272	53551	3920	57471	94235	60.99%	43.8%	68	74
8	臺中市南區	2018-11-25T06:17:29+08:00	45430	13472	58902	4366	63268	103643	61.04%	43.83%	74	74
8	臺中市南區	2018-11-24T23:37:42+08:00	41866	12464	54330	4023	58353	95539	61.08%	43.82%	69	74
8	臺中市南區	2018-11-24T22:14:41+08:00	32626	9710	42336	3118	45454	74880	60.7%	43.57%	54	74
8	臺中市南區	2018-11-24T23:26:00+08:00	41279	12272	53551	3920	57471	94235	60.99%	43.8%	68	74
8	臺中市南區	2018-11-24T23:45:57+08:00	41866	12464	54330	4023	58353	95539	61.08%	43.82%	69	74
8	臺北市松山區	2018-11-24T23:07:11+08:00	34433	11370	45803	3136	48939	83057	58.92%	41.46%	59	117
8	臺北市松山區	2018-11-25T01:05:49+08:00	60049	19782	79831	5574	85405	144854	58.96%	41.45%	101	117
8	臺北市松山區	2018-11-25T01:10:56+08:00	63132	20538	83670	5846	89516	151882	58.94%	41.57%	106	117
8	臺北市松山區	2018-11-24T22:39:00+08:00	25350	8531	33881	2389	36270	61228	59.24%	41.4%	44	117
8	臺北市松山區	2018-11-24T23:50:04+08:00	43926	14485	58411	4069	62480	105750	59.08%	41.54%	75	117
8	臺北市松山區	2018-11-25T01:24:14+08:00	63132	20538	83670	5846	89516	151882	58.94%	41.57%	106	117
8	臺北市松山區	2018-11-25T00:12:36+08:00	48812	15967	64779	4453	69232	117339	59%	41.6%	83	117
8	臺北市松山區	2018-11-24T22:32:10+08:00	24659	8389	33048	2348	35396	59732	59.26%	41.28%	43	117
8	臺北市松山區	2018-11-25T01:00:50+08:00	60049	19782	79831	5574	85405	144854	58.96%	41.45%	101	117
8	臺北市松山區	2018-11-24T23:29:38+08:00	39189	13006	52195	3595	55790	94545	59.01%	41.45%	67	117
8	臺北市松山區	2018-11-25T03:48:19+08:00	70346	22879	93225	6471	99696	169278	58.89%	41.56%	117	117
8	臺北市松山區	2018-11-25T06:22:36+08:00	70346	22879	93225	6471	99696	169278	58.89%	41.56%	117	117
8	臺北市松山區	2018-11-25T06:12:29+08:00	70346	22879	93225	6471	99696	169278	58.89%	41.56%	117	117
8	臺北市松山區	2018-11-25T00:21:35+08:00	54042	17791	71833	4991	76824	130566	58.84%	41.39%	91	117
8	臺北市松山區	2018-11-24T23:00:03+08:00	31925	10537	42462	2939	45401	76905	59.04%	41.51%	55	117
8	臺北市松山區	2018-11-24T23:25:59+08:00	39189	13006	52195	3595	55790	94545	59.01%	41.45%	67	117
8	臺北市松山區	2018-11-25T06:07:13+08:00	70346	22879	93225	6471	99696	169278	58.89%	41.56%	117	117
8	臺北市松山區	2018-11-24T22:40:11+08:00	25350	8531	33881	2389	36270	61228	59.24%	41.4%	44	117
8	臺北市松山區	2018-11-24T22:11:55+08:00	13760	4624	18384	1253	19637	33281	59%	41.34%	24	117
8	臺北市松山區	2018-11-25T04:01:20+08:00	70346	22879	93225	6471	99696	169278	58.89%	41.56%	117	117
8	臺北市松山區	2018-11-24T22:53:04+08:00	28868	9612	38480	2680	41160	69277	59.41%	41.67%	50	117
8	臺北市松山區	2018-11-25T01:16:12+08:00	63132	20538	83670	5846	89516	151882	58.94%	41.57%	106	117
8	臺北市松山區	2018-11-24T23:45:55+08:00	43926	14485	58411	4069	62480	105750	59.08%	41.54%	75	117
8	臺北市松山區	2018-11-24T23:37:41+08:00	41548	13678	55226	3808	59034	100153	58.94%	41.48%	71	117
8	臺北市松山區	2018-11-24T23:54:16+08:00	43926	14485	58411	4069	62480	105750	59.08%	41.54%	75	117
8	臺北市松山區	2018-11-24T23:41:53+08:00	43432	14286	57718	4016	61734	104536	59.06%	41.55%	74	117
8	臺北市松山區	2018-11-25T03:54:31+08:00	70346	22879	93225	6471	99696	169278	58.89%	41.56%	117	117
8	臺北市松山區	2018-11-24T23:33:41+08:00	40429	13362	53791	3682	57473	97507	58.94%	41.46%	69	117
8	臺北市松山區	2018-11-24T22:35:36+08:00	25350	8531	33881	2389	36270	61228	59.24%	41.4%	44	117
8	臺北市松山區	2018-11-25T00:16:59+08:00	50812	16674	67486	4646	72132	122625	58.82%	41.44%	86	117
8	臺北市松山區	2018-11-25T00:03:23+08:00	45704	15066	60770	4226	64996	110003	59.09%	41.55%	78	117
8	臺北市松山區	2018-11-24T22:14:39+08:00	14321	4837	19158	1317	20475	34667	59.06%	41.31%	25	117
8	臺北市松山區	2018-11-24T22:43:41+08:00	25906	8716	34622	2448	37070	62504	59.31%	41.45%	45	117
8	臺北市松山區	2018-11-25T06:27:46+08:00	70346	22879	93225	6471	99696	169278	58.89%	41.56%	117	117
8	臺北市松山區	2018-11-24T22:49:15+08:00	28169	9481	37650	2636	40286	67787	59.43%	41.56%	49	117
8	臺北市松山區	2018-11-24T23:14:30+08:00	35058	11582	46640	3181	49821	84520	58.95%	41.48%	60	117
8	臺北市松山區	2018-11-24T23:22:14+08:00	37350	12419	49769	3432	53201	90236	58.96%	41.39%	64	117
8	臺北市松山區	2018-11-24T23:58:32+08:00	45095	14909	60004	4176	64180	108587	59.1%	41.53%	77	117
8	臺北市松山區	2018-11-25T03:37:15+08:00	70346	22879	93225	6471	99696	169278	58.89%	41.56%	117	117
8	臺北市松山區	2018-11-25T00:56:03+08:00	58050	19201	77251	5396	82647	140165	58.96%	41.42%	98	117
8	臺北市松山區	2018-11-24T22:21:36+08:00	17653	6033	23686	1634	25320	42883	59.04%	41.17%	31	117
8	臺北市松山區	2018-11-25T03:30:49+08:00	70346	22879	93225	6471	99696	169278	58.89%	41.56%	117	117
8	臺北市松山區	2018-11-25T03:42:36+08:00	70346	22879	93225	6471	99696	169278	58.89%	41.56%	117	117
8	臺北市松山區	2018-11-24T22:25:15+08:00	21883	7425	29308	2064	31372	52982	59.21%	41.3%	38	117
8	臺北市松山區	2018-11-24T22:28:31+08:00	23557	7987	31544	2241	33785	57019	59.25%	41.31%	41	117
8	臺北市松山區	2018-11-24T23:10:48+08:00	35058	11582	46640	3181	49821	84520	58.95%	41.48%	60	117
8	臺北市松山區	2018-11-25T06:17:27+08:00	70346	22879	93225	6471	99696	169278	58.89%	41.56%	117	117
8	臺北市松山區	2018-11-24T22:56:29+08:00	29932	10019	39951	2793	42744	72204	59.2%	41.45%	52	117
8	臺北市松山區	2018-11-24T23:18:18+08:00	36138	11955	48093	3301	51394	87084	59.02%	41.5%	62	117
8	臺北市松山區	2018-11-24T23:03:39+08:00	33215	10961	44176	3040	47216	80134	58.92%	41.45%	57	117
8	臺北市松山區	2018-11-25T00:07:55+08:00	46892	15471	62363	4311	66674	112986	59.01%	41.5%	80	117
8	臺北市松山區	2018-11-24T22:18:10+08:00	15336	5212	20548	1376	21924	37142	59.03%	41.29%	27	117
8	臺北市士林區	2018-11-24T23:07:11+08:00	34642	12815	47457	4552	52009	91678	56.73%	37.79%	66	163
8	臺北市士林區	2018-11-25T01:05:49+08:00	69818	25509	95327	8295	103622	182168	56.88%	38.33%	126	163
8	臺北市士林區	2018-11-24T22:49:16+08:00	26335	9894	36229	3608	39837	70522	56.49%	37.34%	52	163
8	臺北市士林區	2018-11-24T22:39:01+08:00	23812	9010	32822	3278	36100	64093	56.32%	37.15%	48	163
8	臺北市士林區	2018-11-24T22:43:42+08:00	25663	9691	35354	3519	38873	68854	56.46%	37.27%	51	163
8	臺北市士林區	2018-11-25T01:24:15+08:00	74117	27125	101242	8813	110055	193589	56.85%	38.29%	133	163
8	臺北市士林區	2018-11-24T23:50:05+08:00	50684	18661	69345	6182	75527	132654	56.94%	38.21%	94	163
8	臺北市士林區	2018-11-24T22:39:00+08:00	23812	9010	32822	3278	36100	64093	56.32%	37.15%	48	163
8	臺北市士林區	2018-11-25T03:37:16+08:00	92720	33559	126279	10881	137160	241854	56.71%	38.34%	163	163
8	臺北市士林區	2018-11-25T01:10:57+08:00	70477	25779	96256	8382	104638	183816	56.93%	38.34%	127	163
8	臺北市士林區	2018-11-24T23:50:04+08:00	50684	18661	69345	6182	75527	132654	56.94%	38.21%	94	163
8	臺北市士林區	2018-11-25T01:24:14+08:00	74117	27125	101242	8813	110055	193589	56.85%	38.29%	133	163
8	臺北市士林區	2018-11-25T00:12:36+08:00	58222	21365	79587	7075	86662	152269	56.91%	38.24%	107	163
8	臺北市士林區	2018-11-25T06:22:37+08:00	92720	33559	126279	10881	137160	241854	56.71%	38.34%	163	163
8	臺北市士林區	2018-11-24T22:32:10+08:00	23259	8781	32040	3199	35239	62563	56.33%	37.18%	47	163
8	臺北市士林區	2018-11-24T23:29:38+08:00	40957	15175	56132	5193	61325	107998	56.78%	37.92%	78	163
8	臺北市士林區	2018-11-25T06:22:36+08:00	92720	33559	126279	10881	137160	241854	56.71%	38.34%	163	163
8	臺北市士林區	2018-11-25T06:12:29+08:00	92720	33559	126279	10881	137160	241854	56.71%	38.34%	163	163
8	臺北市士林區	2018-11-25T00:21:35+08:00	59368	21850	81218	7197	88415	155286	56.94%	38.23%	109	163
8	臺北市士林區	2018-11-25T03:48:20+08:00	92720	33559	126279	10881	137160	241854	56.71%	38.34%	163	163
8	臺北市士林區	2018-11-24T23:25:59+08:00	40957	15175	56132	5193	61325	107998	56.78%	37.92%	78	163
8	臺北市士林區	2018-11-24T23:29:39+08:00	40957	15175	56132	5193	61325	107998	56.78%	37.92%	78	163
8	臺北市士林區	2018-11-24T23:00:04+08:00	30428	11330	41758	4107	45865	81078	56.57%	37.53%	59	163
8	臺北市士林區	2018-11-25T01:00:51+08:00	69219	25306	94525	8241	102766	180748	56.86%	38.3%	125	163
8	臺北市士林區	2018-11-25T06:07:14+08:00	92720	33559	126279	10881	137160	241854	56.71%	38.34%	163	163
8	臺北市士林區	2018-11-24T22:53:05+08:00	27911	10511	38422	3810	42232	74885	56.4%	37.27%	55	163
8	臺北市士林區	2018-11-24T22:40:11+08:00	25074	9489	34563	3442	38005	67402	56.39%	37.2%	50	163
8	臺北市士林區	2018-11-24T22:25:16+08:00	21569	8105	29674	2917	32591	57852	56.34%	37.28%	44	163
8	臺北市士林區	2018-11-24T22:11:55+08:00	19301	7298	26599	2620	29219	50777	57.54%	38.01%	40	163
8	臺北市士林區	2018-11-25T04:01:20+08:00	92720	33559	126279	10881	137160	241854	56.71%	38.34%	163	163
8	臺北市士林區	2018-11-25T01:16:12+08:00	72309	26464	98773	8603	107376	188497	56.96%	38.36%	130	163
8	臺北市士林區	2018-11-25T00:07:56+08:00	56558	20859	77417	6871	84288	147789	57.03%	38.27%	104	163
8	臺北市士林區	2018-11-24T23:37:41+08:00	44668	16473	61141	5564	66705	117407	56.82%	38.05%	84	163
8	臺北市士林區	2018-11-24T23:41:54+08:00	45910	16933	62843	5681	68524	120478	56.88%	38.11%	86	163
8	臺北市士林區	2018-11-24T22:28:32+08:00	22072	8331	30403	3006	33409	59271	56.37%	37.24%	45	163
8	臺北市士林區	2018-11-25T01:16:13+08:00	72309	26464	98773	8603	107376	188497	56.96%	38.36%	130	163
8	臺北市士林區	2018-11-25T03:54:31+08:00	92720	33559	126279	10881	137160	241854	56.71%	38.34%	163	163
8	臺北市士林區	2018-11-24T23:54:17+08:00	52517	19278	71795	6376	78171	137200	56.98%	38.28%	97	163
8	臺北市士林區	2018-11-25T00:03:24+08:00	55984	20625	76609	6797	83406	146237	57.03%	38.28%	103	163
8	臺北市士林區	2018-11-24T22:35:36+08:00	23812	9010	32822	3278	36100	64093	56.32%	37.15%	48	163
8	臺北市士林區	2018-11-24T23:22:15+08:00	39869	14792	54661	5123	59784	105015	56.93%	37.97%	76	163
8	臺北市士林區	2018-11-24T23:58:33+08:00	54885	20119	75004	6636	81640	143153	57.03%	38.34%	101	163
8	臺北市士林區	2018-11-24T22:14:39+08:00	20315	7650	27965	2783	30748	54672	56.24%	37.16%	42	163
8	臺北市士林區	2018-11-24T23:03:40+08:00	33429	12485	45914	4470	50384	88788	56.75%	37.65%	64	163
8	臺北市士林區	2018-11-24T23:22:14+08:00	39869	14792	54661	5123	59784	105015	56.93%	37.97%	76	163
8	臺北市士林區	2018-11-24T23:58:32+08:00	54885	20119	75004	6636	81640	143153	57.03%	38.34%	101	163
8	臺北市士林區	2018-11-24T22:35:37+08:00	23812	9010	32822	3278	36100	64093	56.32%	37.15%	48	163
8	臺北市士林區	2018-11-25T03:37:15+08:00	92720	33559	126279	10881	137160	241854	56.71%	38.34%	163	163
8	臺北市士林區	2018-11-25T00:56:04+08:00	67250	24614	91864	8075	99939	175815	56.84%	38.25%	122	163
8	臺北市士林區	2018-11-24T23:14:31+08:00	36699	13650	50349	4747	55096	97120	56.73%	37.79%	70	163
8	臺北市士林區	2018-11-25T06:27:47+08:00	92720	33559	126279	10881	137160	241854	56.71%	38.34%	163	163
8	臺北市士林區	2018-11-24T22:21:36+08:00	21569	8105	29674	2917	32591	57852	56.34%	37.28%	44	163
8	臺北市士林區	2018-11-24T22:21:37+08:00	21569	8105	29674	2917	32591	57852	56.34%	37.28%	44	163
8	臺北市士林區	2018-11-25T00:17:00+08:00	59368	21850	81218	7197	88415	155286	56.94%	38.23%	109	163
8	臺北市士林區	2018-11-25T03:30:49+08:00	92720	33559	126279	10881	137160	241854	56.71%	38.34%	163	163
8	臺北市士林區	2018-11-25T03:42:36+08:00	92720	33559	126279	10881	137160	241854	56.71%	38.34%	163	163
8	臺北市士林區	2018-11-24T22:25:15+08:00	21569	8105	29674	2917	32591	57852	56.34%	37.28%	44	163
8	臺北市士林區	2018-11-25T03:42:38+08:00	92720	33559	126279	10881	137160	241854	56.71%	38.34%	163	163
8	臺北市士林區	2018-11-24T22:18:11+08:00	20964	7887	28851	2854	31705	56331	56.28%	37.22%	43	163
8	臺北市士林區	2018-11-24T22:28:31+08:00	22072	8331	30403	3006	33409	59271	56.37%	37.24%	45	163
8	臺北市士林區	2018-11-24T22:14:40+08:00	20315	7650	27965	2783	30748	54672	56.24%	37.16%	42	163
8	臺北市士林區	2018-11-25T06:17:27+08:00	92720	33559	126279	10881	137160	241854	56.71%	38.34%	163	163
8	臺北市士林區	2018-11-24T22:56:29+08:00	28528	10725	39253	3873	43126	76261	56.55%	37.41%	56	163
8	臺北市士林區	2018-11-24T23:45:56+08:00	50157	18476	68633	6113	74746	131304	56.93%	38.2%	93	163
8	臺北市士林區	2018-11-25T00:07:55+08:00	56558	20859	77417	6871	84288	147789	57.03%	38.27%	104	163
8	臺北市士林區	2018-11-24T23:33:42+08:00	43422	15980	59402	5404	64806	114319	56.69%	37.98%	82	163
8	臺北市士林區	2018-11-24T23:10:49+08:00	35254	13054	48308	4589	52897	93316	56.69%	37.78%	67	163
8	臺北市士林區	2018-11-25T03:54:32+08:00	92720	33559	126279	10881	137160	241854	56.71%	38.34%	163	163
8	臺北市士林區	2018-11-24T23:18:19+08:00	37745	14110	51855	4906	56761	99688	56.94%	37.86%	72	163
8	屏東縣林邊鄉	2018-11-24T23:10:57+08:00	5553	1908	7461	1108	8569	15691	54.61%	35.39%	16	16
8	屏東縣林邊鄉	2018-11-24T23:07:19+08:00	5553	1908	7461	1108	8569	15691	54.61%	35.39%	16	16
8	屏東縣林邊鄉	2018-11-24T22:14:50+08:00	4009	1363	5372	839	6211	11383	54.56%	35.22%	12	16
8	屏東縣林邊鄉	2018-11-25T06:17:37+08:00	5553	1908	7461	1108	8569	15691	54.61%	35.39%	16	16
8	屏東縣林邊鄉	2018-11-24T22:56:37+08:00	5553	1908	7461	1108	8569	15691	54.61%	35.39%	16	16
8	屏東縣林邊鄉	2018-11-24T22:32:19+08:00	4638	1610	6248	926	7174	13230	54.23%	35.06%	14	16
8	屏東縣林邊鄉	2018-11-24T22:53:16+08:00	5553	1908	7461	1108	8569	15691	54.61%	35.39%	16	16
8	屏東縣林邊鄉	2018-11-25T00:08:06+08:00	5553	1908	7461	1108	8569	15691	54.61%	35.39%	16	16
8	屏東縣林邊鄉	2018-11-25T01:06:00+08:00	5553	1908	7461	1108	8569	15691	54.61%	35.39%	16	16
8	屏東縣林邊鄉	2018-11-24T22:25:26+08:00	4351	1486	5837	878	6715	12505	53.7%	34.79%	13	16
8	屏東縣林邊鄉	2018-11-25T01:11:08+08:00	5553	1908	7461	1108	8569	15691	54.61%	35.39%	16	16
8	屏東縣林邊鄉	2018-11-25T06:07:24+08:00	5553	1908	7461	1108	8569	15691	54.61%	35.39%	16	16
8	屏東縣林邊鄉	2018-11-24T23:00:18+08:00	5553	1908	7461	1108	8569	15691	54.61%	35.39%	16	16
8	屏東縣林邊鄉	2018-11-25T03:48:32+08:00	5553	1908	7461	1108	8569	15691	54.61%	35.39%	16	16
8	屏東縣林邊鄉	2018-11-24T22:40:19+08:00	5199	1799	6998	1048	8046	14688	54.78%	35.4%	15	16
8	屏東縣林邊鄉	2018-11-24T23:29:47+08:00	5553	1908	7461	1108	8569	15691	54.61%	35.39%	16	16
8	屏東縣林邊鄉	2018-11-25T00:21:45+08:00	5553	1908	7461	1108	8569	15691	54.61%	35.39%	16	16
8	屏東縣林邊鄉	2018-11-25T03:31:00+08:00	5553	1908	7461	1108	8569	15691	54.61%	35.39%	16	16
8	屏東縣林邊鄉	2018-11-25T01:16:23+08:00	5553	1908	7461	1108	8569	15691	54.61%	35.39%	16	16
8	屏東縣林邊鄉	2018-11-25T00:56:14+08:00	5553	1908	7461	1108	8569	15691	54.61%	35.39%	16	16
8	屏東縣林邊鄉	2018-11-24T22:35:45+08:00	4638	1610	6248	926	7174	13230	54.23%	35.06%	14	16
8	屏東縣林邊鄉	2018-11-24T23:14:42+08:00	5553	1908	7461	1108	8569	15691	54.61%	35.39%	16	16
8	屏東縣林邊鄉	2018-11-24T23:50:16+08:00	5553	1908	7461	1108	8569	15691	54.61%	35.39%	16	16
8	屏東縣林邊鄉	2018-11-24T23:37:49+08:00	5553	1908	7461	1108	8569	15691	54.61%	35.39%	16	16
8	屏東縣林邊鄉	2018-11-24T22:43:51+08:00	5553	1908	7461	1108	8569	15691	54.61%	35.39%	16	16
8	屏東縣林邊鄉	2018-11-25T06:27:56+08:00	5553	1908	7461	1108	8569	15691	54.61%	35.39%	16	16
8	屏東縣林邊鄉	2018-11-25T00:12:46+08:00	5553	1908	7461	1108	8569	15691	54.61%	35.39%	16	16
8	屏東縣林邊鄉	2018-11-24T23:54:28+08:00	5553	1908	7461	1108	8569	15691	54.61%	35.39%	16	16
8	屏東縣林邊鄉	2018-11-24T23:22:24+08:00	5553	1908	7461	1108	8569	15691	54.61%	35.39%	16	16
8	屏東縣林邊鄉	2018-11-24T22:28:41+08:00	4351	1486	5837	878	6715	12505	53.7%	34.79%	13	16
8	屏東縣林邊鄉	2018-11-24T22:12:03+08:00	4009	1363	5372	839	6211	11383	54.56%	35.22%	12	16
8	屏東縣林邊鄉	2018-11-24T23:33:51+08:00	5553	1908	7461	1108	8569	15691	54.61%	35.39%	16	16
8	屏東縣林邊鄉	2018-11-25T01:24:26+08:00	5553	1908	7461	1108	8569	15691	54.61%	35.39%	16	16
8	屏東縣林邊鄉	2018-11-25T03:54:42+08:00	5553	1908	7461	1108	8569	15691	54.61%	35.39%	16	16
8	屏東縣林邊鄉	2018-11-24T23:03:48+08:00	5553	1908	7461	1108	8569	15691	54.61%	35.39%	16	16
8	屏東縣林邊鄉	2018-11-24T22:49:25+08:00	5553	1908	7461	1108	8569	15691	54.61%	35.39%	16	16
8	屏東縣林邊鄉	2018-11-25T04:01:30+08:00	5553	1908	7461	1108	8569	15691	54.61%	35.39%	16	16
8	屏東縣林邊鄉	2018-11-25T03:42:49+08:00	5553	1908	7461	1108	8569	15691	54.61%	35.39%	16	16
8	屏東縣林邊鄉	2018-11-24T23:42:02+08:00	5553	1908	7461	1108	8569	15691	54.61%	35.39%	16	16
8	屏東縣林邊鄉	2018-11-24T23:46:04+08:00	5553	1908	7461	1108	8569	15691	54.61%	35.39%	16	16
8	屏東縣林邊鄉	2018-11-25T00:17:09+08:00	5553	1908	7461	1108	8569	15691	54.61%	35.39%	16	16
8	屏東縣林邊鄉	2018-11-25T06:12:37+08:00	5553	1908	7461	1108	8569	15691	54.61%	35.39%	16	16
8	屏東縣林邊鄉	2018-11-25T06:22:45+08:00	5553	1908	7461	1108	8569	15691	54.61%	35.39%	16	16
8	屏東縣林邊鄉	2018-11-24T22:21:47+08:00	4351	1486	5837	878	6715	12505	53.7%	34.79%	13	16
8	屏東縣林邊鄉	2018-11-24T22:39:10+08:00	5199	1799	6998	1048	8046	14688	54.78%	35.4%	15	16
8	屏東縣林邊鄉	2018-11-24T22:18:20+08:00	4009	1363	5372	839	6211	11383	54.56%	35.22%	12	16
8	屏東縣林邊鄉	2018-11-25T03:37:30+08:00	5553	1908	7461	1108	8569	15691	54.61%	35.39%	16	16
8	屏東縣林邊鄉	2018-11-24T23:58:43+08:00	5553	1908	7461	1108	8569	15691	54.61%	35.39%	16	16
8	屏東縣林邊鄉	2018-11-25T00:03:36+08:00	5553	1908	7461	1108	8569	15691	54.61%	35.39%	16	16
8	屏東縣林邊鄉	2018-11-24T23:26:07+08:00	5553	1908	7461	1108	8569	15691	54.61%	35.39%	16	16
8	屏東縣林邊鄉	2018-11-25T01:01:02+08:00	5553	1908	7461	1108	8569	15691	54.61%	35.39%	16	16
8	屏東縣林邊鄉	2018-11-24T23:18:28+08:00	5553	1908	7461	1108	8569	15691	54.61%	35.39%	16	16
8	屏東縣里港鄉	2018-11-25T06:17:36+08:00	7701	2799	10500	1576	12076	22128	54.57%	34.8%	20	20
8	屏東縣里港鄉	2018-11-24T23:07:19+08:00	7273	2612	9885	1514	11399	20594	55.35%	35.32%	19	20
8	屏東縣里港鄉	2018-11-24T23:10:56+08:00	7273	2612	9885	1514	11399	20594	55.35%	35.32%	19	20
8	屏東縣里港鄉	2018-11-24T22:39:09+08:00	6118	2228	8346	1287	9633	17464	55.16%	35.03%	17	20
8	屏東縣里港鄉	2018-11-25T01:24:25+08:00	7701	2799	10500	1576	12076	22128	54.57%	34.8%	20	20
8	屏東縣里港鄉	2018-11-24T22:56:37+08:00	6736	2429	9165	1384	10549	19016	55.47%	35.42%	18	20
8	屏東縣里港鄉	2018-11-25T03:54:41+08:00	7701	2799	10500	1576	12076	22128	54.57%	34.8%	20	20
8	屏東縣里港鄉	2018-11-24T22:32:19+08:00	6118	2228	8346	1287	9633	17464	55.16%	35.03%	17	20
8	屏東縣里港鄉	2018-11-25T01:06:00+08:00	7701	2799	10500	1576	12076	22128	54.57%	34.8%	20	20
8	屏東縣里港鄉	2018-11-24T22:25:26+08:00	6118	2228	8346	1287	9633	17464	55.16%	35.03%	17	20
8	屏東縣里港鄉	2018-11-24T23:00:17+08:00	7273	2612	9885	1514	11399	20594	55.35%	35.32%	19	20
8	屏東縣里港鄉	2018-11-25T01:11:08+08:00	7701	2799	10500	1576	12076	22128	54.57%	34.8%	20	20
8	屏東縣里港鄉	2018-11-25T06:07:23+08:00	7701	2799	10500	1576	12076	22128	54.57%	34.8%	20	20
8	屏東縣里港鄉	2018-11-24T22:40:19+08:00	6118	2228	8346	1287	9633	17464	55.16%	35.03%	17	20
8	屏東縣里港鄉	2018-11-24T23:29:47+08:00	7701	2799	10500	1576	12076	22128	54.57%	34.8%	20	20
8	屏東縣里港鄉	2018-11-25T00:21:45+08:00	7701	2799	10500	1576	12076	22128	54.57%	34.8%	20	20
8	屏東縣里港鄉	2018-11-25T03:31:00+08:00	7701	2799	10500	1576	12076	22128	54.57%	34.8%	20	20
8	屏東縣里港鄉	2018-11-25T00:03:35+08:00	7701	2799	10500	1576	12076	22128	54.57%	34.8%	20	20
8	屏東縣里港鄉	2018-11-25T00:56:14+08:00	7701	2799	10500	1576	12076	22128	54.57%	34.8%	20	20
8	屏東縣里港鄉	2018-11-24T23:54:27+08:00	7701	2799	10500	1576	12076	22128	54.57%	34.8%	20	20
8	屏東縣里港鄉	2018-11-24T22:35:45+08:00	6118	2228	8346	1287	9633	17464	55.16%	35.03%	17	20
8	屏東縣里港鄉	2018-11-25T01:16:22+08:00	7701	2799	10500	1576	12076	22128	54.57%	34.8%	20	20
8	屏東縣里港鄉	2018-11-24T23:37:49+08:00	7701	2799	10500	1576	12076	22128	54.57%	34.8%	20	20
8	屏東縣里港鄉	2018-11-24T22:43:51+08:00	6118	2228	8346	1287	9633	17464	55.16%	35.03%	17	20
8	屏東縣里港鄉	2018-11-25T06:27:56+08:00	7701	2799	10500	1576	12076	22128	54.57%	34.8%	20	20
8	屏東縣里港鄉	2018-11-24T23:22:24+08:00	7273	2612	9885	1514	11399	20594	55.35%	35.32%	19	20
8	屏東縣里港鄉	2018-11-24T22:28:41+08:00	6118	2228	8346	1287	9633	17464	55.16%	35.03%	17	20
8	屏東縣里港鄉	2018-11-24T22:49:24+08:00	6118	2228	8346	1287	9633	17464	55.16%	35.03%	17	20
8	屏東縣里港鄉	2018-11-24T22:12:03+08:00	6118	2228	8346	1287	9633	17464	55.16%	35.03%	17	20
8	屏東縣里港鄉	2018-11-24T23:33:51+08:00	7701	2799	10500	1576	12076	22128	54.57%	34.8%	20	20
8	屏東縣里港鄉	2018-11-24T23:03:48+08:00	7273	2612	9885	1514	11399	20594	55.35%	35.32%	19	20
8	屏東縣里港鄉	2018-11-25T04:01:30+08:00	7701	2799	10500	1576	12076	22128	54.57%	34.8%	20	20
8	屏東縣里港鄉	2018-11-25T03:42:49+08:00	7701	2799	10500	1576	12076	22128	54.57%	34.8%	20	20
8	屏東縣里港鄉	2018-11-24T23:42:02+08:00	7701	2799	10500	1576	12076	22128	54.57%	34.8%	20	20
8	屏東縣里港鄉	2018-11-25T00:08:05+08:00	7701	2799	10500	1576	12076	22128	54.57%	34.8%	20	20
8	屏東縣里港鄉	2018-11-24T22:53:15+08:00	6118	2228	8346	1287	9633	17464	55.16%	35.03%	17	20
8	屏東縣里港鄉	2018-11-24T23:46:04+08:00	7701	2799	10500	1576	12076	22128	54.57%	34.8%	20	20
8	屏東縣里港鄉	2018-11-25T00:17:09+08:00	7701	2799	10500	1576	12076	22128	54.57%	34.8%	20	20
8	屏東縣里港鄉	2018-11-25T06:12:37+08:00	7701	2799	10500	1576	12076	22128	54.57%	34.8%	20	20
8	屏東縣里港鄉	2018-11-25T06:22:45+08:00	7701	2799	10500	1576	12076	22128	54.57%	34.8%	20	20
8	屏東縣里港鄉	2018-11-24T22:21:47+08:00	6118	2228	8346	1287	9633	17464	55.16%	35.03%	17	20
8	屏東縣里港鄉	2018-11-25T03:48:31+08:00	7701	2799	10500	1576	12076	22128	54.57%	34.8%	20	20
8	屏東縣里港鄉	2018-11-24T22:14:49+08:00	6118	2228	8346	1287	9633	17464	55.16%	35.03%	17	20
8	屏東縣里港鄉	2018-11-24T22:18:20+08:00	6118	2228	8346	1287	9633	17464	55.16%	35.03%	17	20
8	屏東縣里港鄉	2018-11-25T03:37:30+08:00	7701	2799	10500	1576	12076	22128	54.57%	34.8%	20	20
8	屏東縣里港鄉	2018-11-24T23:58:43+08:00	7701	2799	10500	1576	12076	22128	54.57%	34.8%	20	20
8	屏東縣里港鄉	2018-11-24T23:26:07+08:00	7701	2799	10500	1576	12076	22128	54.57%	34.8%	20	20
8	屏東縣里港鄉	2018-11-25T00:12:45+08:00	7701	2799	10500	1576	12076	22128	54.57%	34.8%	20	20
8	屏東縣里港鄉	2018-11-25T01:01:02+08:00	7701	2799	10500	1576	12076	22128	54.57%	34.8%	20	20
8	屏東縣里港鄉	2018-11-24T23:18:28+08:00	7273	2612	9885	1514	11399	20594	55.35%	35.32%	19	20
8	屏東縣里港鄉	2018-11-24T23:14:41+08:00	7273	2612	9885	1514	11399	20594	55.35%	35.32%	19	20
8	屏東縣里港鄉	2018-11-24T23:50:15+08:00	7701	2799	10500	1576	12076	22128	54.57%	34.8%	20	20
8	雲林縣虎尾鎮	2018-11-24T22:39:08+08:00	10600	3173	13773	1219	14992	28744	52.16%	36.88%	24	46
8	雲林縣虎尾鎮	2018-11-25T03:37:28+08:00	21498	6641	28139	2288	30427	58167	52.31%	36.96%	46	46
8	雲林縣虎尾鎮	2018-11-25T01:24:23+08:00	21498	6641	28139	2288	30427	58167	52.31%	36.96%	46	46
8	雲林縣虎尾鎮	2018-11-24T23:07:17+08:00	12844	3942	16786	1475	18261	34521	52.9%	37.21%	28	46
8	雲林縣虎尾鎮	2018-11-24T22:12:01+08:00	6853	2197	9050	872	9922	18962	52.33%	36.14%	17	46
8	雲林縣虎尾鎮	2018-11-24T22:32:17+08:00	9005	2798	11803	1074	12877	24576	52.4%	36.64%	21	46
8	雲林縣虎尾鎮	2018-11-25T03:48:28+08:00	21498	6641	28139	2288	30427	58167	52.31%	36.96%	46	46
8	雲林縣虎尾鎮	2018-11-25T03:30:58+08:00	21498	6641	28139	2288	30427	58167	52.31%	36.96%	46	46
8	雲林縣虎尾鎮	2018-11-24T23:42:01+08:00	17711	5476	23187	1926	25113	47797	52.54%	37.05%	37	46
8	雲林縣虎尾鎮	2018-11-24T22:21:45+08:00	9005	2798	11803	1074	12877	24576	52.4%	36.64%	21	46
8	雲林縣虎尾鎮	2018-11-25T06:07:22+08:00	21498	6641	28139	2288	30427	58167	52.31%	36.96%	46	46
8	雲林縣虎尾鎮	2018-11-25T04:01:28+08:00	21498	6641	28139	2288	30427	58167	52.31%	36.96%	46	46
8	雲林縣虎尾鎮	2018-11-25T00:21:43+08:00	21498	6641	28139	2288	30427	58167	52.31%	36.96%	46	46
8	雲林縣虎尾鎮	2018-11-25T01:11:06+08:00	21498	6641	28139	2288	30427	58167	52.31%	36.96%	46	46
8	雲林縣虎尾鎮	2018-11-24T22:40:18+08:00	10600	3173	13773	1219	14992	28744	52.16%	36.88%	24	46
8	雲林縣虎尾鎮	2018-11-24T23:00:16+08:00	11717	3556	15273	1342	16615	31482	52.78%	37.22%	26	46
8	雲林縣虎尾鎮	2018-11-24T23:37:48+08:00	17284	5362	22646	1896	24542	46677	52.58%	37.03%	36	46
8	雲林縣虎尾鎮	2018-11-25T03:54:39+08:00	21498	6641	28139	2288	30427	58167	52.31%	36.96%	46	46
8	雲林縣虎尾鎮	2018-11-25T01:01:00+08:00	21498	6641	28139	2288	30427	58167	52.31%	36.96%	46	46
8	雲林縣虎尾鎮	2018-11-24T23:33:49+08:00	16571	5163	21734	1855	23589	44812	52.64%	36.98%	35	46
8	雲林縣虎尾鎮	2018-11-25T00:03:33+08:00	20728	6379	27107	2208	29315	55805	52.53%	37.14%	44	46
8	雲林縣虎尾鎮	2018-11-24T22:35:43+08:00	10141	3047	13188	1177	14365	27461	52.31%	36.93%	23	46
8	雲林縣虎尾鎮	2018-11-24T23:54:26+08:00	18707	5774	24481	2009	26490	50328	52.63%	37.17%	39	46
8	雲林縣虎尾鎮	2018-11-24T23:58:41+08:00	19002	5871	24873	2055	26928	51218	52.58%	37.1%	40	46
8	雲林縣虎尾鎮	2018-11-25T00:56:12+08:00	21498	6641	28139	2288	30427	58167	52.31%	36.96%	46	46
8	雲林縣虎尾鎮	2018-11-24T22:56:35+08:00	11717	3556	15273	1342	16615	31482	52.78%	37.22%	26	46
8	雲林縣虎尾鎮	2018-11-25T06:17:35+08:00	21498	6641	28139	2288	30427	58167	52.31%	36.96%	46	46
8	雲林縣虎尾鎮	2018-11-24T22:49:23+08:00	11228	3370	14598	1264	15862	30188	52.54%	37.19%	25	46
8	雲林縣虎尾鎮	2018-11-24T23:22:22+08:00	14935	4608	19543	1720	21263	40110	53.01%	37.24%	32	46
8	雲林縣虎尾鎮	2018-11-24T22:43:49+08:00	10600	3173	13773	1219	14992	28744	52.16%	36.88%	24	46
8	雲林縣虎尾鎮	2018-11-24T23:03:46+08:00	12177	3726	15903	1430	17333	33031	52.47%	36.87%	27	46
8	雲林縣虎尾鎮	2018-11-24T23:10:55+08:00	12844	3942	16786	1475	18261	34521	52.9%	37.21%	28	46
8	雲林縣虎尾鎮	2018-11-25T00:08:03+08:00	20728	6379	27107	2208	29315	55805	52.53%	37.14%	44	46
8	雲林縣虎尾鎮	2018-11-25T03:42:47+08:00	21498	6641	28139	2288	30427	58167	52.31%	36.96%	46	46
8	雲林縣虎尾鎮	2018-11-24T22:53:14+08:00	11228	3370	14598	1264	15862	30188	52.54%	37.19%	25	46
8	雲林縣虎尾鎮	2018-11-24T23:46:02+08:00	18316	5662	23978	1970	25948	49104	52.84%	37.3%	38	46
8	雲林縣虎尾鎮	2018-11-25T00:17:07+08:00	21498	6641	28139	2288	30427	58167	52.31%	36.96%	46	46
8	雲林縣虎尾鎮	2018-11-24T23:29:45+08:00	15506	4794	20300	1773	22073	41523	53.16%	37.34%	33	46
8	雲林縣虎尾鎮	2018-11-25T06:22:44+08:00	21498	6641	28139	2288	30427	58167	52.31%	36.96%	46	46
8	雲林縣虎尾鎮	2018-11-25T06:12:36+08:00	21498	6641	28139	2288	30427	58167	52.31%	36.96%	46	46
8	雲林縣虎尾鎮	2018-11-24T22:25:24+08:00	9005	2798	11803	1074	12877	24576	52.4%	36.64%	21	46
8	雲林縣虎尾鎮	2018-11-25T01:05:58+08:00	21498	6641	28139	2288	30427	58167	52.31%	36.96%	46	46
8	雲林縣虎尾鎮	2018-11-25T00:12:44+08:00	21088	6500	27588	2244	29832	56883	52.44%	37.07%	45	46
8	雲林縣虎尾鎮	2018-11-24T23:26:06+08:00	14935	4608	19543	1720	21263	40110	53.01%	37.24%	32	46
8	雲林縣虎尾鎮	2018-11-24T22:18:18+08:00	7271	2330	9601	920	10521	20275	51.89%	35.86%	18	46
8	雲林縣虎尾鎮	2018-11-25T06:27:54+08:00	21498	6641	28139	2288	30427	58167	52.31%	36.96%	46	46
8	雲林縣虎尾鎮	2018-11-24T23:50:14+08:00	18316	5662	23978	1970	25948	49104	52.84%	37.3%	38	46
8	雲林縣虎尾鎮	2018-11-24T23:14:40+08:00	12844	3942	16786	1475	18261	34521	52.9%	37.21%	28	46
8	雲林縣虎尾鎮	2018-11-24T22:28:39+08:00	9005	2798	11803	1074	12877	24576	52.4%	36.64%	21	46
8	雲林縣虎尾鎮	2018-11-24T22:14:48+08:00	6853	2197	9050	872	9922	18962	52.33%	36.14%	17	46
8	雲林縣虎尾鎮	2018-11-25T01:16:21+08:00	21498	6641	28139	2288	30427	58167	52.31%	36.96%	46	46
8	雲林縣虎尾鎮	2018-11-24T23:18:26+08:00	13356	4112	17468	1542	19010	35941	52.89%	37.16%	29	46
8	雲林縣麥寮鄉	2018-11-24T22:39:08+08:00	9880	3527	13407	1654	15061	31431	47.92%	31.43%	24	28
8	雲林縣麥寮鄉	2018-11-25T03:37:28+08:00	11823	4152	15975	1967	17942	37119	48.34%	31.85%	28	28
8	雲林縣麥寮鄉	2018-11-24T23:07:18+08:00	11282	3992	15274	1865	17139	35648	48.08%	31.65%	27	28
8	雲林縣麥寮鄉	2018-11-25T01:24:23+08:00	11823	4152	15975	1967	17942	37119	48.34%	31.85%	28	28
8	雲林縣麥寮鄉	2018-11-25T03:54:40+08:00	11823	4152	15975	1967	17942	37119	48.34%	31.85%	28	28
8	雲林縣麥寮鄉	2018-11-24T22:32:18+08:00	9880	3527	13407	1654	15061	31431	47.92%	31.43%	24	28
8	雲林縣麥寮鄉	2018-11-25T03:30:58+08:00	11823	4152	15975	1967	17942	37119	48.34%	31.85%	28	28
8	雲林縣麥寮鄉	2018-11-24T23:42:01+08:00	11823	4152	15975	1967	17942	37119	48.34%	31.85%	28	28
8	雲林縣麥寮鄉	2018-11-25T03:48:29+08:00	11823	4152	15975	1967	17942	37119	48.34%	31.85%	28	28
8	雲林縣麥寮鄉	2018-11-24T22:21:45+08:00	9880	3527	13407	1654	15061	31431	47.92%	31.43%	24	28
8	雲林縣麥寮鄉	2018-11-25T06:07:22+08:00	11823	4152	15975	1967	17942	37119	48.34%	31.85%	28	28
8	雲林縣麥寮鄉	2018-11-25T04:01:28+08:00	11823	4152	15975	1967	17942	37119	48.34%	31.85%	28	28
8	雲林縣麥寮鄉	2018-11-25T00:21:43+08:00	11823	4152	15975	1967	17942	37119	48.34%	31.85%	28	28
8	雲林縣麥寮鄉	2018-11-25T01:11:06+08:00	11823	4152	15975	1967	17942	37119	48.34%	31.85%	28	28
8	雲林縣麥寮鄉	2018-11-24T22:40:18+08:00	10290	3650	13940	1727	15667	32771	47.81%	31.4%	25	28
8	雲林縣麥寮鄉	2018-11-24T23:00:16+08:00	11282	3992	15274	1865	17139	35648	48.08%	31.65%	27	28
8	雲林縣麥寮鄉	2018-11-24T23:37:48+08:00	11823	4152	15975	1967	17942	37119	48.34%	31.85%	28	28
8	雲林縣麥寮鄉	2018-11-25T00:56:13+08:00	11823	4152	15975	1967	17942	37119	48.34%	31.85%	28	28
8	雲林縣麥寮鄉	2018-11-25T01:01:00+08:00	11823	4152	15975	1967	17942	37119	48.34%	31.85%	28	28
8	雲林縣麥寮鄉	2018-11-24T23:33:49+08:00	11823	4152	15975	1967	17942	37119	48.34%	31.85%	28	28
8	雲林縣麥寮鄉	2018-11-25T00:03:33+08:00	11823	4152	15975	1967	17942	37119	48.34%	31.85%	28	28
8	雲林縣麥寮鄉	2018-11-24T22:35:44+08:00	9880	3527	13407	1654	15061	31431	47.92%	31.43%	24	28
8	雲林縣麥寮鄉	2018-11-24T23:54:26+08:00	11823	4152	15975	1967	17942	37119	48.34%	31.85%	28	28
8	雲林縣麥寮鄉	2018-11-24T22:56:35+08:00	11282	3992	15274	1865	17139	35648	48.08%	31.65%	27	28
8	雲林縣麥寮鄉	2018-11-25T06:17:35+08:00	11823	4152	15975	1967	17942	37119	48.34%	31.85%	28	28
8	雲林縣麥寮鄉	2018-11-24T22:49:23+08:00	10648	3767	14415	1767	16182	33727	47.98%	31.57%	26	28
8	雲林縣麥寮鄉	2018-11-24T23:22:22+08:00	11823	4152	15975	1967	17942	37119	48.34%	31.85%	28	28
8	雲林縣麥寮鄉	2018-11-24T22:43:49+08:00	10290	3650	13940	1727	15667	32771	47.81%	31.4%	25	28
8	雲林縣麥寮鄉	2018-11-24T23:03:46+08:00	11282	3992	15274	1865	17139	35648	48.08%	31.65%	27	28
8	雲林縣麥寮鄉	2018-11-24T23:10:55+08:00	11282	3992	15274	1865	17139	35648	48.08%	31.65%	27	28
8	雲林縣麥寮鄉	2018-11-24T22:12:02+08:00	9005	3264	12269	1479	13748	28960	47.47%	31.09%	22	28
8	雲林縣麥寮鄉	2018-11-25T00:08:04+08:00	11823	4152	15975	1967	17942	37119	48.34%	31.85%	28	28
8	雲林縣麥寮鄉	2018-11-25T03:42:47+08:00	11823	4152	15975	1967	17942	37119	48.34%	31.85%	28	28
8	雲林縣麥寮鄉	2018-11-24T22:53:14+08:00	11282	3992	15274	1865	17139	35648	48.08%	31.65%	27	28
8	雲林縣麥寮鄉	2018-11-24T23:46:03+08:00	11823	4152	15975	1967	17942	37119	48.34%	31.85%	28	28
8	雲林縣麥寮鄉	2018-11-25T00:17:07+08:00	11823	4152	15975	1967	17942	37119	48.34%	31.85%	28	28
8	雲林縣麥寮鄉	2018-11-24T23:29:45+08:00	11823	4152	15975	1967	17942	37119	48.34%	31.85%	28	28
8	雲林縣麥寮鄉	2018-11-25T06:22:44+08:00	11823	4152	15975	1967	17942	37119	48.34%	31.85%	28	28
8	雲林縣麥寮鄉	2018-11-25T06:12:36+08:00	11823	4152	15975	1967	17942	37119	48.34%	31.85%	28	28
8	雲林縣麥寮鄉	2018-11-24T22:25:24+08:00	9880	3527	13407	1654	15061	31431	47.92%	31.43%	24	28
8	雲林縣麥寮鄉	2018-11-25T01:05:58+08:00	11823	4152	15975	1967	17942	37119	48.34%	31.85%	28	28
8	雲林縣麥寮鄉	2018-11-25T00:12:44+08:00	11823	4152	15975	1967	17942	37119	48.34%	31.85%	28	28
8	雲林縣麥寮鄉	2018-11-24T23:26:06+08:00	11823	4152	15975	1967	17942	37119	48.34%	31.85%	28	28
8	雲林縣麥寮鄉	2018-11-25T06:27:54+08:00	11823	4152	15975	1967	17942	37119	48.34%	31.85%	28	28
8	雲林縣麥寮鄉	2018-11-24T23:50:14+08:00	11823	4152	15975	1967	17942	37119	48.34%	31.85%	28	28
8	雲林縣麥寮鄉	2018-11-24T23:14:40+08:00	11282	3992	15274	1865	17139	35648	48.08%	31.65%	27	28
8	雲林縣麥寮鄉	2018-11-24T22:18:19+08:00	9880	3527	13407	1654	15061	31431	47.92%	31.43%	24	28
8	雲林縣麥寮鄉	2018-11-24T23:58:42+08:00	11823	4152	15975	1967	17942	37119	48.34%	31.85%	28	28
8	雲林縣麥寮鄉	2018-11-24T22:28:39+08:00	9880	3527	13407	1654	15061	31431	47.92%	31.43%	24	28
8	雲林縣麥寮鄉	2018-11-24T22:14:48+08:00	9880	3527	13407	1654	15061	31431	47.92%	31.43%	24	28
8	雲林縣麥寮鄉	2018-11-25T01:16:21+08:00	11823	4152	15975	1967	17942	37119	48.34%	31.85%	28	28
8	雲林縣麥寮鄉	2018-11-24T23:18:26+08:00	11282	3992	15274	1865	17139	35648	48.08%	31.65%	27	28
8	高雄市苓雅區	2018-11-25T03:37:21+08:00	60364	21461	81825	5570	87395	146786	59.54%	41.12%	116	116
8	高雄市苓雅區	2018-11-24T23:03:43+08:00	47985	16793	64778	4252	69030	115849	59.59%	41.42%	95	116
8	高雄市苓雅區	2018-11-24T23:58:37+08:00	54629	19441	74070	4975	79045	133068	59.4%	41.05%	107	116
8	高雄市苓雅區	2018-11-25T06:17:31+08:00	60364	21461	81825	5570	87395	146786	59.54%	41.12%	116	116
8	高雄市苓雅區	2018-11-24T23:22:18+08:00	50406	17667	68073	4485	72558	122374	59.29%	41.19%	99	116
8	高雄市苓雅區	2018-11-25T00:03:29+08:00	56143	19988	76131	5175	81306	136822	59.42%	41.03%	110	116
8	高雄市苓雅區	2018-11-24T23:14:35+08:00	48468	16987	65455	4305	69760	117293	59.47%	41.32%	96	116
8	高雄市苓雅區	2018-11-25T00:56:09+08:00	58648	20902	79550	5451	85001	143020	59.43%	41.01%	114	116
8	高雄市苓雅區	2018-11-24T22:49:19+08:00	44469	15573	60042	3879	63921	107450	59.49%	41.39%	89	116
8	高雄市苓雅區	2018-11-25T03:42:43+08:00	60364	21461	81825	5570	87395	146786	59.54%	41.12%	116	116
8	高雄市苓雅區	2018-11-24T22:53:10+08:00	44833	15703	60536	3948	64484	108300	59.54%	41.4%	90	116
8	高雄市苓雅區	2018-11-25T00:08:00+08:00	56143	19988	76131	5175	81306	136822	59.42%	41.03%	110	116
8	高雄市苓雅區	2018-11-25T01:00:56+08:00	58648	20902	79550	5451	85001	143020	59.43%	41.01%	114	116
8	高雄市苓雅區	2018-11-24T22:25:19+08:00	39712	13925	53637	3498	57135	95911	59.57%	41.41%	80	116
8	高雄市苓雅區	2018-11-25T06:12:33+08:00	60364	21461	81825	5570	87395	146786	59.54%	41.12%	116	116
8	高雄市苓雅區	2018-11-25T00:17:03+08:00	56917	20265	77182	5261	82443	138626	59.47%	41.06%	111	116
8	高雄市苓雅區	2018-11-25T06:22:41+08:00	60364	21461	81825	5570	87395	146786	59.54%	41.12%	116	116
8	高雄市苓雅區	2018-11-24T23:18:23+08:00	49193	17257	66450	4379	70829	119338	59.35%	41.22%	97	116
8	高雄市苓雅區	2018-11-24T23:50:10+08:00	53648	18997	72645	4829	77474	130470	59.38%	41.12%	105	116
8	高雄市苓雅區	2018-11-24T22:18:15+08:00	35340	12442	47782	3096	50878	85627	59.42%	41.27%	73	116
8	高雄市苓雅區	2018-11-24T22:28:35+08:00	40735	14258	54993	3547	58540	98231	59.59%	41.47%	82	116
8	高雄市苓雅區	2018-11-24T22:14:44+08:00	34879	12279	47158	3063	50221	84506	59.43%	41.27%	72	116
8	高雄市苓雅區	2018-11-25T01:05:54+08:00	58648	20902	79550	5451	85001	143020	59.43%	41.01%	114	116
8	高雄市苓雅區	2018-11-24T23:54:21+08:00	53648	18997	72645	4829	77474	130470	59.38%	41.12%	105	116
8	高雄市苓雅區	2018-11-24T23:33:46+08:00	51507	18098	69605	4581	74186	124991	59.35%	41.21%	101	116
8	高雄市苓雅區	2018-11-25T06:27:51+08:00	60364	21461	81825	5570	87395	146786	59.54%	41.12%	116	116
8	高雄市苓雅區	2018-11-24T23:26:03+08:00	50406	17667	68073	4485	72558	122374	59.29%	41.19%	99	116
8	高雄市苓雅區	2018-11-25T03:54:36+08:00	60364	21461	81825	5570	87395	146786	59.54%	41.12%	116	116
8	高雄市苓雅區	2018-11-25T00:12:41+08:00	56143	19988	76131	5175	81306	136822	59.42%	41.03%	110	116
8	高雄市苓雅區	2018-11-24T22:56:32+08:00	44833	15703	60536	3948	64484	108300	59.54%	41.4%	90	116
8	高雄市苓雅區	2018-11-24T22:43:46+08:00	42865	15004	57869	3800	61669	103411	59.63%	41.45%	86	116
8	高雄市苓雅區	2018-11-25T01:24:19+08:00	58648	20902	79550	5451	85001	143020	59.43%	41.01%	114	116
8	高雄市苓雅區	2018-11-24T22:39:04+08:00	42378	14839	57217	3758	60975	102127	59.71%	41.5%	85	116
8	高雄市苓雅區	2018-11-24T23:10:52+08:00	48468	16987	65455	4305	69760	117293	59.47%	41.32%	96	116
8	高雄市苓雅區	2018-11-24T23:07:14+08:00	47985	16793	64778	4252	69030	115849	59.59%	41.42%	95	116
8	高雄市苓雅區	2018-11-25T00:21:39+08:00	57367	20440	77807	5306	83113	139898	59.41%	41.01%	112	116
8	高雄市苓雅區	2018-11-24T22:32:14+08:00	41292	14437	55729	3612	59341	99467	59.66%	41.51%	83	116
8	高雄市苓雅區	2018-11-25T03:30:54+08:00	60364	21461	81825	5570	87395	146786	59.54%	41.12%	116	116
8	高雄市苓雅區	2018-11-25T03:48:24+08:00	60364	21461	81825	5570	87395	146786	59.54%	41.12%	116	116
8	高雄市苓雅區	2018-11-24T22:40:15+08:00	42865	15004	57869	3800	61669	103411	59.63%	41.45%	86	116
8	高雄市苓雅區	2018-11-24T23:29:42+08:00	50873	17856	68729	4521	73250	123475	59.32%	41.2%	100	116
8	高雄市苓雅區	2018-11-25T01:11:02+08:00	58648	20902	79550	5451	85001	143020	59.43%	41.01%	114	116
8	高雄市苓雅區	2018-11-24T23:00:13+08:00	45461	15931	61392	4008	65400	109731	59.6%	41.43%	91	116
8	高雄市苓雅區	2018-11-24T22:21:41+08:00	38446	13516	51962	3343	55305	93074	59.42%	41.31%	78	116
8	高雄市苓雅區	2018-11-25T06:07:18+08:00	60364	21461	81825	5570	87395	146786	59.54%	41.12%	116	116
8	高雄市苓雅區	2018-11-24T22:11:58+08:00	34459	12111	46570	3005	49575	83512	59.36%	41.26%	71	116
8	高雄市苓雅區	2018-11-25T04:01:24+08:00	60364	21461	81825	5570	87395	146786	59.54%	41.12%	116	116
8	高雄市苓雅區	2018-11-24T23:41:57+08:00	53648	18997	72645	4829	77474	130470	59.38%	41.12%	105	116
8	高雄市苓雅區	2018-11-24T22:35:41+08:00	41292	14437	55729	3612	59341	99467	59.66%	41.51%	83	116
8	高雄市苓雅區	2018-11-24T23:37:45+08:00	52721	18514	71235	4681	75916	127774	59.41%	41.26%	103	116
8	高雄市苓雅區	2018-11-24T23:45:59+08:00	53648	18997	72645	4829	77474	130470	59.38%	41.12%	105	116
8	高雄市苓雅區	2018-11-25T01:16:17+08:00	58648	20902	79550	5451	85001	143020	59.43%	41.01%	114	116
8	高雄市鳥松區	2018-11-24T22:49:20+08:00	11395	3976	15371	1121	16492	27752	59.43%	41.06%	21	28
8	高雄市鳥松區	2018-11-25T03:37:21+08:00	16185	5680	21865	1588	23453	39191	59.84%	41.3%	28	28
8	高雄市鳥松區	2018-11-24T23:03:43+08:00	12060	4218	16278	1172	17450	29531	59.09%	40.84%	22	28
8	高雄市鳥松區	2018-11-24T23:58:37+08:00	15004	5300	20304	1449	21753	36383	59.79%	41.24%	26	28
8	高雄市鳥松區	2018-11-25T00:03:29+08:00	15004	5300	20304	1449	21753	36383	59.79%	41.24%	26	28
8	高雄市鳥松區	2018-11-25T00:56:09+08:00	16185	5680	21865	1588	23453	39191	59.84%	41.3%	28	28
8	高雄市鳥松區	2018-11-24T23:22:19+08:00	12783	4510	17293	1216	18509	31219	59.29%	40.95%	23	28
8	高雄市鳥松區	2018-11-25T03:42:43+08:00	16185	5680	21865	1588	23453	39191	59.84%	41.3%	28	28
8	高雄市鳥松區	2018-11-24T22:53:10+08:00	11395	3976	15371	1121	16492	27752	59.43%	41.06%	21	28
8	高雄市鳥松區	2018-11-25T00:08:00+08:00	15004	5300	20304	1449	21753	36383	59.79%	41.24%	26	28
8	高雄市鳥松區	2018-11-24T23:46:00+08:00	14064	4952	19016	1380	20396	34164	59.7%	41.17%	25	28
8	高雄市鳥松區	2018-11-25T01:00:56+08:00	16185	5680	21865	1588	23453	39191	59.84%	41.3%	28	28
8	高雄市鳥松區	2018-11-25T06:12:33+08:00	16185	5680	21865	1588	23453	39191	59.84%	41.3%	28	28
8	高雄市鳥松區	2018-11-25T00:17:04+08:00	16185	5680	21865	1588	23453	39191	59.84%	41.3%	28	28
8	高雄市鳥松區	2018-11-25T06:22:41+08:00	16185	5680	21865	1588	23453	39191	59.84%	41.3%	28	28
8	高雄市鳥松區	2018-11-24T22:25:20+08:00	9064	3141	12205	904	13109	21893	59.88%	41.4%	17	28
8	高雄市鳥松區	2018-11-24T23:18:23+08:00	12783	4510	17293	1216	18509	31219	59.29%	40.95%	23	28
8	高雄市鳥松區	2018-11-24T22:18:15+08:00	6263	2190	8453	642	9095	14889	61.09%	42.06%	12	28
8	高雄市鳥松區	2018-11-24T22:14:44+08:00	6263	2190	8453	642	9095	14889	61.09%	42.06%	12	28
8	高雄市鳥松區	2018-11-24T23:50:11+08:00	14064	4952	19016	1380	20396	34164	59.7%	41.17%	25	28
8	高雄市鳥松區	2018-11-25T01:05:54+08:00	16185	5680	21865	1588	23453	39191	59.84%	41.3%	28	28
8	高雄市鳥松區	2018-11-24T23:33:46+08:00	14064	4952	19016	1380	20396	34164	59.7%	41.17%	25	28
8	高雄市鳥松區	2018-11-25T06:27:51+08:00	16185	5680	21865	1588	23453	39191	59.84%	41.3%	28	28
8	高雄市鳥松區	2018-11-24T23:26:03+08:00	13291	4676	17967	1310	19277	32420	59.46%	41%	24	28
8	高雄市鳥松區	2018-11-25T03:54:36+08:00	16185	5680	21865	1588	23453	39191	59.84%	41.3%	28	28
8	高雄市鳥松區	2018-11-25T00:12:41+08:00	15483	5464	20947	1520	22467	37638	59.69%	41.14%	27	28
8	高雄市鳥松區	2018-11-25T01:24:20+08:00	16185	5680	21865	1588	23453	39191	59.84%	41.3%	28	28
8	高雄市鳥松區	2018-11-24T22:43:46+08:00	10743	3736	14479	1089	15568	26118	59.61%	41.13%	20	28
8	高雄市鳥松區	2018-11-25T06:17:32+08:00	16185	5680	21865	1588	23453	39191	59.84%	41.3%	28	28
8	高雄市鳥松區	2018-11-24T23:07:15+08:00	12060	4218	16278	1172	17450	29531	59.09%	40.84%	22	28
8	高雄市鳥松區	2018-11-24T22:39:05+08:00	9574	3322	12896	957	13853	23118	59.92%	41.41%	18	28
8	高雄市鳥松區	2018-11-24T22:56:33+08:00	11395	3976	15371	1121	16492	27752	59.43%	41.06%	21	28
8	高雄市鳥松區	2018-11-24T23:14:36+08:00	12783	4510	17293	1216	18509	31219	59.29%	40.95%	23	28
8	高雄市鳥松區	2018-11-24T23:10:52+08:00	12060	4218	16278	1172	17450	29531	59.09%	40.84%	22	28
8	高雄市鳥松區	2018-11-25T03:48:25+08:00	16185	5680	21865	1588	23453	39191	59.84%	41.3%	28	28
8	高雄市鳥松區	2018-11-24T22:32:14+08:00	9574	3322	12896	957	13853	23118	59.92%	41.41%	18	28
8	高雄市鳥松區	2018-11-25T03:30:54+08:00	16185	5680	21865	1588	23453	39191	59.84%	41.3%	28	28
8	高雄市鳥松區	2018-11-24T22:40:15+08:00	10240	3574	13814	1021	14835	24796	59.83%	41.3%	19	28
8	高雄市鳥松區	2018-11-25T00:21:40+08:00	16185	5680	21865	1588	23453	39191	59.84%	41.3%	28	28
8	高雄市鳥松區	2018-11-24T23:29:42+08:00	14064	4952	19016	1380	20396	34164	59.7%	41.17%	25	28
8	高雄市鳥松區	2018-11-25T01:11:02+08:00	16185	5680	21865	1588	23453	39191	59.84%	41.3%	28	28
8	高雄市鳥松區	2018-11-24T23:00:13+08:00	11395	3976	15371	1121	16492	27752	59.43%	41.06%	21	28
8	高雄市鳥松區	2018-11-24T22:11:59+08:00	6263	2190	8453	642	9095	14889	61.09%	42.06%	12	28
8	高雄市鳥松區	2018-11-24T22:21:41+08:00	7911	2828	10739	787	11526	19097	60.36%	41.43%	15	28
8	高雄市鳥松區	2018-11-25T06:07:18+08:00	16185	5680	21865	1588	23453	39191	59.84%	41.3%	28	28
8	高雄市鳥松區	2018-11-25T04:01:24+08:00	16185	5680	21865	1588	23453	39191	59.84%	41.3%	28	28
8	高雄市鳥松區	2018-11-24T22:28:36+08:00	9064	3141	12205	904	13109	21893	59.88%	41.4%	17	28
8	高雄市鳥松區	2018-11-24T22:35:41+08:00	9574	3322	12896	957	13853	23118	59.92%	41.41%	18	28
8	高雄市鳥松區	2018-11-24T23:37:45+08:00	14064	4952	19016	1380	20396	34164	59.7%	41.17%	25	28
8	高雄市鳥松區	2018-11-24T23:41:58+08:00	14064	4952	19016	1380	20396	34164	59.7%	41.17%	25	28
8	高雄市鳥松區	2018-11-24T23:54:22+08:00	15004	5300	20304	1449	21753	36383	59.79%	41.24%	26	28
8	高雄市鳥松區	2018-11-25T01:16:17+08:00	16185	5680	21865	1588	23453	39191	59.84%	41.3%	28	28
8	基隆市信義區	2018-11-24T23:10:59+08:00	14948	3591	18539	1069	19608	38241	51.27%	39.09%	31	36
8	基隆市信義區	2018-11-24T23:22:27+08:00	15421	3731	19152	1114	20266	39429	51.4%	39.11%	32	36
8	基隆市信義區	2018-11-24T23:18:31+08:00	15421	3731	19152	1114	20266	39429	51.4%	39.11%	32	36
8	基隆市信義區	2018-11-24T22:49:28+08:00	11273	2750	14023	796	14819	28382	52.21%	39.72%	24	36
8	基隆市信義區	2018-11-24T23:33:54+08:00	15986	3877	19863	1150	21013	40984	51.27%	39.01%	33	36
8	基隆市信義區	2018-11-24T22:12:06+08:00	8121	1976	10097	579	10676	20541	51.97%	39.54%	17	36
8	基隆市信義區	2018-11-24T23:26:11+08:00	15986	3877	19863	1150	21013	40984	51.27%	39.01%	33	36
8	基隆市信義區	2018-11-24T22:28:44+08:00	9886	2424	12310	721	13031	25167	51.78%	39.28%	21	36
8	基隆市信義區	2018-11-24T23:37:52+08:00	15986	3877	19863	1150	21013	40984	51.27%	39.01%	33	36
8	基隆市信義區	2018-11-24T22:53:19+08:00	11789	2878	14667	835	15502	29867	51.9%	39.47%	25	36
8	基隆市信義區	2018-11-24T22:21:50+08:00	9492	2337	11829	696	12525	24168	51.82%	39.28%	20	36
8	基隆市信義區	2018-11-25T04:01:33+08:00	17958	4332	22290	1302	23592	46014	51.27%	39.03%	36	36
8	基隆市信義區	2018-11-25T00:08:09+08:00	16596	4039	20635	1204	21839	42553	51.32%	39%	34	36
8	基隆市信義區	2018-11-24T23:46:07+08:00	15986	3877	19863	1150	21013	40984	51.27%	39.01%	33	36
8	基隆市信義區	2018-11-25T01:11:12+08:00	17958	4332	22290	1302	23592	46014	51.27%	39.03%	36	36
8	基隆市信義區	2018-11-24T23:42:06+08:00	15986	3877	19863	1150	21013	40984	51.27%	39.01%	33	36
8	基隆市信義區	2018-11-24T23:00:20+08:00	12856	3105	15961	902	16863	32892	51.27%	39.09%	27	36
8	基隆市信義區	2018-11-24T22:25:29+08:00	9492	2337	11829	696	12525	24168	51.82%	39.28%	20	36
8	基隆市信義區	2018-11-25T06:22:48+08:00	17958	4332	22290	1302	23592	46014	51.27%	39.03%	36	36
8	基隆市信義區	2018-11-25T03:48:35+08:00	17958	4332	22290	1302	23592	46014	51.27%	39.03%	36	36
8	基隆市信義區	2018-11-25T06:27:59+08:00	17958	4332	22290	1302	23592	46014	51.27%	39.03%	36	36
8	基隆市信義區	2018-11-25T06:17:41+08:00	17958	4332	22290	1302	23592	46014	51.27%	39.03%	36	36
8	基隆市信義區	2018-11-24T22:39:13+08:00	9886	2424	12310	721	13031	25167	51.78%	39.28%	21	36
8	基隆市信義區	2018-11-25T03:37:34+08:00	17958	4332	22290	1302	23592	46014	51.27%	39.03%	36	36
8	基隆市信義區	2018-11-25T00:12:49+08:00	17236	4168	21404	1235	22639	44029	51.42%	39.15%	35	36
8	基隆市信義區	2018-11-24T22:18:23+08:00	8923	2204	11127	647	11774	22829	51.57%	39.09%	19	36
8	基隆市信義區	2018-11-24T23:50:18+08:00	15986	3877	19863	1150	21013	40984	51.27%	39.01%	33	36
8	基隆市信義區	2018-11-24T23:14:45+08:00	15421	3731	19152	1114	20266	39429	51.4%	39.11%	32	36
8	基隆市信義區	2018-11-24T23:58:46+08:00	16596	4039	20635	1204	21839	42553	51.32%	39%	34	36
8	基隆市信義區	2018-11-24T22:56:40+08:00	12187	2959	15146	861	16007	30876	51.84%	39.47%	26	36
8	基隆市信義區	2018-11-24T23:03:50+08:00	13833	3348	17181	983	18164	35209	51.59%	39.29%	29	36
8	基隆市信義區	2018-11-25T01:01:06+08:00	17958	4332	22290	1302	23592	46014	51.27%	39.03%	36	36
8	基隆市信義區	2018-11-25T01:24:29+08:00	17958	4332	22290	1302	23592	46014	51.27%	39.03%	36	36
8	基隆市信義區	2018-11-24T23:54:31+08:00	15986	3877	19863	1150	21013	40984	51.27%	39.01%	33	36
8	基隆市信義區	2018-11-24T23:07:23+08:00	14410	3458	17868	1022	18890	36973	51.09%	38.97%	30	36
8	基隆市信義區	2018-11-25T03:54:45+08:00	17958	4332	22290	1302	23592	46014	51.27%	39.03%	36	36
8	基隆市信義區	2018-11-25T00:03:40+08:00	16596	4039	20635	1204	21839	42553	51.32%	39%	34	36
8	基隆市信義區	2018-11-24T22:14:53+08:00	8121	1976	10097	579	10676	20541	51.97%	39.54%	17	36
8	基隆市信義區	2018-11-24T23:29:50+08:00	15986	3877	19863	1150	21013	40984	51.27%	39.01%	33	36
8	基隆市信義區	2018-11-25T00:17:12+08:00	17958	4332	22290	1302	23592	46014	51.27%	39.03%	36	36
8	基隆市信義區	2018-11-24T22:32:22+08:00	9886	2424	12310	721	13031	25167	51.78%	39.28%	21	36
8	基隆市信義區	2018-11-25T06:12:41+08:00	17958	4332	22290	1302	23592	46014	51.27%	39.03%	36	36
8	基隆市信義區	2018-11-25T01:06:04+08:00	17958	4332	22290	1302	23592	46014	51.27%	39.03%	36	36
8	基隆市信義區	2018-11-24T22:40:22+08:00	9886	2424	12310	721	13031	25167	51.78%	39.28%	21	36
8	基隆市信義區	2018-11-25T03:42:53+08:00	17958	4332	22290	1302	23592	46014	51.27%	39.03%	36	36
8	基隆市信義區	2018-11-25T00:21:48+08:00	17958	4332	22290	1302	23592	46014	51.27%	39.03%	36	36
8	基隆市信義區	2018-11-25T06:07:27+08:00	17958	4332	22290	1302	23592	46014	51.27%	39.03%	36	36
8	基隆市信義區	2018-11-25T00:56:17+08:00	17958	4332	22290	1302	23592	46014	51.27%	39.03%	36	36
8	基隆市信義區	2018-11-24T22:35:48+08:00	9886	2424	12310	721	13031	25167	51.78%	39.28%	21	36
8	基隆市信義區	2018-11-24T22:43:54+08:00	10311	2520	12831	743	13574	26096	52.02%	39.51%	22	36
8	基隆市信義區	2018-11-25T03:31:03+08:00	17958	4332	22290	1302	23592	46014	51.27%	39.03%	36	36
8	基隆市信義區	2018-11-25T01:16:26+08:00	17958	4332	22290	1302	23592	46014	51.27%	39.03%	36	36
8	新竹縣關西鎮	2018-11-24T22:39:06+08:00	8533	2274	10807	794	11601	20576	56.38%	41.47%	23	27
8	新竹縣關西鎮	2018-11-24T23:03:44+08:00	9820	2642	12462	923	13385	23735	56.39%	41.37%	26	27
8	新竹縣關西鎮	2018-11-24T23:22:20+08:00	10240	2754	12994	966	13960	24712	56.49%	41.44%	27	27
8	新竹縣關西鎮	2018-11-24T23:58:39+08:00	10240	2754	12994	966	13960	24712	56.49%	41.44%	27	27
8	新竹縣關西鎮	2018-11-24T22:49:21+08:00	9462	2522	11984	894	12878	22792	56.5%	41.51%	25	27
8	新竹縣關西鎮	2018-11-25T03:42:44+08:00	10240	2754	12994	966	13960	24712	56.49%	41.44%	27	27
8	新竹縣關西鎮	2018-11-24T23:46:01+08:00	10240	2754	12994	966	13960	24712	56.49%	41.44%	27	27
8	新竹縣關西鎮	2018-11-25T01:00:57+08:00	10240	2754	12994	966	13960	24712	56.49%	41.44%	27	27
8	新竹縣關西鎮	2018-11-25T03:48:26+08:00	10240	2754	12994	966	13960	24712	56.49%	41.44%	27	27
8	新竹縣關西鎮	2018-11-24T22:53:11+08:00	9820	2642	12462	923	13385	23735	56.39%	41.37%	26	27
8	新竹縣關西鎮	2018-11-25T00:08:01+08:00	10240	2754	12994	966	13960	24712	56.49%	41.44%	27	27
8	新竹縣關西鎮	2018-11-24T22:21:42+08:00	7274	1959	9233	675	9908	17714	55.93%	41.06%	20	27
8	新竹縣關西鎮	2018-11-25T04:01:26+08:00	10240	2754	12994	966	13960	24712	56.49%	41.44%	27	27
8	新竹縣關西鎮	2018-11-25T06:12:34+08:00	10240	2754	12994	966	13960	24712	56.49%	41.44%	27	27
8	新竹縣關西鎮	2018-11-24T22:40:16+08:00	8533	2274	10807	794	11601	20576	56.38%	41.47%	23	27
8	新竹縣關西鎮	2018-11-24T22:25:20+08:00	7274	1959	9233	675	9908	17714	55.93%	41.06%	20	27
8	新竹縣關西鎮	2018-11-25T00:17:05+08:00	10240	2754	12994	966	13960	24712	56.49%	41.44%	27	27
8	新竹縣關西鎮	2018-11-24T23:18:24+08:00	10240	2754	12994	966	13960	24712	56.49%	41.44%	27	27
8	新竹縣關西鎮	2018-11-24T23:37:46+08:00	10240	2754	12994	966	13960	24712	56.49%	41.44%	27	27
8	新竹縣關西鎮	2018-11-24T22:35:42+08:00	8217	2169	10386	747	11133	19768	56.32%	41.57%	22	27
8	新竹縣關西鎮	2018-11-25T03:54:37+08:00	10240	2754	12994	966	13960	24712	56.49%	41.44%	27	27
8	新竹縣關西鎮	2018-11-24T23:33:47+08:00	10240	2754	12994	966	13960	24712	56.49%	41.44%	27	27
8	新竹縣關西鎮	2018-11-25T01:05:55+08:00	10240	2754	12994	966	13960	24712	56.49%	41.44%	27	27
8	新竹縣關西鎮	2018-11-24T23:26:04+08:00	10240	2754	12994	966	13960	24712	56.49%	41.44%	27	27
8	新竹縣關西鎮	2018-11-24T22:14:45+08:00	6623	1787	8410	613	9023	16178	55.77%	40.94%	18	27
8	新竹縣關西鎮	2018-11-25T06:17:32+08:00	10240	2754	12994	966	13960	24712	56.49%	41.44%	27	27
8	新竹縣關西鎮	2018-11-24T23:07:15+08:00	10240	2754	12994	966	13960	24712	56.49%	41.44%	27	27
8	新竹縣關西鎮	2018-11-24T23:14:37+08:00	10240	2754	12994	966	13960	24712	56.49%	41.44%	27	27
8	新竹縣關西鎮	2018-11-24T23:10:53+08:00	10240	2754	12994	966	13960	24712	56.49%	41.44%	27	27
8	新竹縣關西鎮	2018-11-24T22:43:47+08:00	8933	2377	11310	825	12135	21430	56.63%	41.68%	24	27
8	新竹縣關西鎮	2018-11-24T22:56:33+08:00	9820	2642	12462	923	13385	23735	56.39%	41.37%	26	27
8	新竹縣關西鎮	2018-11-25T01:24:21+08:00	10240	2754	12994	966	13960	24712	56.49%	41.44%	27	27
8	新竹縣關西鎮	2018-11-25T03:37:23+08:00	10240	2754	12994	966	13960	24712	56.49%	41.44%	27	27
8	新竹縣關西鎮	2018-11-25T03:30:55+08:00	10240	2754	12994	966	13960	24712	56.49%	41.44%	27	27
8	新竹縣關西鎮	2018-11-24T22:32:15+08:00	8217	2169	10386	747	11133	19768	56.32%	41.57%	22	27
8	新竹縣關西鎮	2018-11-24T22:11:59+08:00	6623	1787	8410	613	9023	16178	55.77%	40.94%	18	27
8	新竹縣關西鎮	2018-11-24T23:00:14+08:00	9820	2642	12462	923	13385	23735	56.39%	41.37%	26	27
8	新竹縣關西鎮	2018-11-25T06:07:19+08:00	10240	2754	12994	966	13960	24712	56.49%	41.44%	27	27
8	新竹縣關西鎮	2018-11-25T01:11:03+08:00	10240	2754	12994	966	13960	24712	56.49%	41.44%	27	27
8	新竹縣關西鎮	2018-11-24T23:29:43+08:00	10240	2754	12994	966	13960	24712	56.49%	41.44%	27	27
8	新竹縣關西鎮	2018-11-25T00:21:41+08:00	10240	2754	12994	966	13960	24712	56.49%	41.44%	27	27
8	新竹縣關西鎮	2018-11-25T06:22:42+08:00	10240	2754	12994	966	13960	24712	56.49%	41.44%	27	27
8	新竹縣關西鎮	2018-11-25T00:56:10+08:00	10240	2754	12994	966	13960	24712	56.49%	41.44%	27	27
8	新竹縣關西鎮	2018-11-24T22:18:16+08:00	7043	1912	8955	646	9601	17234	55.71%	40.87%	19	27
8	新竹縣關西鎮	2018-11-24T23:54:24+08:00	10240	2754	12994	966	13960	24712	56.49%	41.44%	27	27
8	新竹縣關西鎮	2018-11-24T23:41:59+08:00	10240	2754	12994	966	13960	24712	56.49%	41.44%	27	27
8	新竹縣關西鎮	2018-11-25T01:16:18+08:00	10240	2754	12994	966	13960	24712	56.49%	41.44%	27	27
8	新竹縣關西鎮	2018-11-25T06:27:52+08:00	10240	2754	12994	966	13960	24712	56.49%	41.44%	27	27
8	新竹縣關西鎮	2018-11-25T00:12:42+08:00	10240	2754	12994	966	13960	24712	56.49%	41.44%	27	27
8	新竹縣關西鎮	2018-11-24T22:28:37+08:00	7808	2068	9876	720	10596	18922	56%	41.26%	21	27
8	新竹縣關西鎮	2018-11-25T00:03:30+08:00	10240	2754	12994	966	13960	24712	56.49%	41.44%	27	27
8	新竹縣關西鎮	2018-11-24T23:50:12+08:00	10240	2754	12994	966	13960	24712	56.49%	41.44%	27	27
8	臺南市鹽水區	2018-11-24T22:49:18+08:00	6294	2313	8607	975	9582	20748	46.18%	30.34%	30	31
8	臺南市鹽水區	2018-11-24T23:14:33+08:00	6743	2449	9192	1001	10193	22121	46.08%	30.48%	31	31
8	臺南市鹽水區	2018-11-24T22:56:31+08:00	6743	2449	9192	1001	10193	22121	46.08%	30.48%	31	31
8	臺南市鹽水區	2018-11-25T00:12:39+08:00	6743	2449	9192	1001	10193	22121	46.08%	30.48%	31	31
8	臺南市鹽水區	2018-11-25T00:03:27+08:00	6743	2449	9192	1001	10193	22121	46.08%	30.48%	31	31
8	臺南市鹽水區	2018-11-25T00:56:07+08:00	6743	2449	9192	1001	10193	22121	46.08%	30.48%	31	31
8	臺南市鹽水區	2018-11-24T23:03:42+08:00	6743	2449	9192	1001	10193	22121	46.08%	30.48%	31	31
8	臺南市鹽水區	2018-11-24T23:10:51+08:00	6743	2449	9192	1001	10193	22121	46.08%	30.48%	31	31
8	臺南市鹽水區	2018-11-25T03:37:18+08:00	6743	2449	9192	1001	10193	22121	46.08%	30.48%	31	31
8	臺南市鹽水區	2018-11-24T22:43:44+08:00	6294	2313	8607	975	9582	20748	46.18%	30.34%	30	31
8	臺南市鹽水區	2018-11-25T06:17:30+08:00	6743	2449	9192	1001	10193	22121	46.08%	30.48%	31	31
8	臺南市鹽水區	2018-11-24T23:22:17+08:00	6743	2449	9192	1001	10193	22121	46.08%	30.48%	31	31
8	臺南市鹽水區	2018-11-25T06:22:40+08:00	6743	2449	9192	1001	10193	22121	46.08%	30.48%	31	31
8	臺南市鹽水區	2018-11-24T23:29:41+08:00	6743	2449	9192	1001	10193	22121	46.08%	30.48%	31	31
8	臺南市鹽水區	2018-11-24T22:25:18+08:00	6294	2313	8607	975	9582	20748	46.18%	30.34%	30	31
8	臺南市鹽水區	2018-11-25T01:11:00+08:00	6743	2449	9192	1001	10193	22121	46.08%	30.48%	31	31
8	臺南市鹽水區	2018-11-25T00:17:02+08:00	6743	2449	9192	1001	10193	22121	46.08%	30.48%	31	31
8	臺南市鹽水區	2018-11-25T00:07:58+08:00	6743	2449	9192	1001	10193	22121	46.08%	30.48%	31	31
8	臺南市鹽水區	2018-11-25T01:16:15+08:00	6743	2449	9192	1001	10193	22121	46.08%	30.48%	31	31
8	臺南市鹽水區	2018-11-25T01:05:52+08:00	6743	2449	9192	1001	10193	22121	46.08%	30.48%	31	31
8	臺南市鹽水區	2018-11-24T22:14:42+08:00	5916	2186	8102	917	9019	19504	46.24%	30.33%	29	31
8	臺南市鹽水區	2018-11-24T23:54:19+08:00	6743	2449	9192	1001	10193	22121	46.08%	30.48%	31	31
8	臺南市鹽水區	2018-11-24T22:28:34+08:00	6294	2313	8607	975	9582	20748	46.18%	30.34%	30	31
8	臺南市鹽水區	2018-11-24T22:18:13+08:00	5916	2186	8102	917	9019	19504	46.24%	30.33%	29	31
8	臺南市鹽水區	2018-11-25T01:24:18+08:00	6743	2449	9192	1001	10193	22121	46.08%	30.48%	31	31
8	臺南市鹽水區	2018-11-24T22:35:39+08:00	6294	2313	8607	975	9582	20748	46.18%	30.34%	30	31
8	臺南市鹽水區	2018-11-24T23:50:09+08:00	6743	2449	9192	1001	10193	22121	46.08%	30.48%	31	31
8	臺南市鹽水區	2018-11-24T23:58:35+08:00	6743	2449	9192	1001	10193	22121	46.08%	30.48%	31	31
8	臺南市鹽水區	2018-11-25T06:27:49+08:00	6743	2449	9192	1001	10193	22121	46.08%	30.48%	31	31
8	臺南市鹽水區	2018-11-24T22:39:03+08:00	6294	2313	8607	975	9582	20748	46.18%	30.34%	30	31
8	臺南市鹽水區	2018-11-24T23:07:13+08:00	6743	2449	9192	1001	10193	22121	46.08%	30.48%	31	31
8	臺南市鹽水區	2018-11-25T01:00:54+08:00	6743	2449	9192	1001	10193	22121	46.08%	30.48%	31	31
8	臺南市鹽水區	2018-11-25T03:48:22+08:00	6743	2449	9192	1001	10193	22121	46.08%	30.48%	31	31
8	臺南市鹽水區	2018-11-25T00:21:37+08:00	6743	2449	9192	1001	10193	22121	46.08%	30.48%	31	31
8	臺南市鹽水區	2018-11-24T23:00:09+08:00	6743	2449	9192	1001	10193	22121	46.08%	30.48%	31	31
8	臺南市鹽水區	2018-11-25T03:30:52+08:00	6743	2449	9192	1001	10193	22121	46.08%	30.48%	31	31
8	臺南市鹽水區	2018-11-25T03:42:41+08:00	6743	2449	9192	1001	10193	22121	46.08%	30.48%	31	31
8	臺南市鹽水區	2018-11-24T22:21:39+08:00	6294	2313	8607	975	9582	20748	46.18%	30.34%	30	31
8	臺南市鹽水區	2018-11-24T22:32:12+08:00	6294	2313	8607	975	9582	20748	46.18%	30.34%	30	31
8	臺南市鹽水區	2018-11-24T22:53:08+08:00	6743	2449	9192	1001	10193	22121	46.08%	30.48%	31	31
8	臺南市鹽水區	2018-11-25T04:01:22+08:00	6743	2449	9192	1001	10193	22121	46.08%	30.48%	31	31
8	臺南市鹽水區	2018-11-24T22:11:57+08:00	5916	2186	8102	917	9019	19504	46.24%	30.33%	29	31
8	臺南市鹽水區	2018-11-24T22:40:13+08:00	6294	2313	8607	975	9582	20748	46.18%	30.34%	30	31
8	臺南市鹽水區	2018-11-25T06:12:31+08:00	6743	2449	9192	1001	10193	22121	46.08%	30.48%	31	31
8	臺南市鹽水區	2018-11-25T06:07:16+08:00	6743	2449	9192	1001	10193	22121	46.08%	30.48%	31	31
8	臺南市鹽水區	2018-11-24T23:33:44+08:00	6743	2449	9192	1001	10193	22121	46.08%	30.48%	31	31
8	臺南市鹽水區	2018-11-24T23:26:01+08:00	6743	2449	9192	1001	10193	22121	46.08%	30.48%	31	31
8	臺南市鹽水區	2018-11-25T03:54:34+08:00	6743	2449	9192	1001	10193	22121	46.08%	30.48%	31	31
8	臺南市鹽水區	2018-11-24T23:45:58+08:00	6743	2449	9192	1001	10193	22121	46.08%	30.48%	31	31
8	臺南市鹽水區	2018-11-24T23:41:56+08:00	6743	2449	9192	1001	10193	22121	46.08%	30.48%	31	31
8	臺南市鹽水區	2018-11-24T23:37:43+08:00	6743	2449	9192	1001	10193	22121	46.08%	30.48%	31	31
8	臺南市鹽水區	2018-11-24T23:18:21+08:00	6743	2449	9192	1001	10193	22121	46.08%	30.48%	31	31
8	屏東縣三地門鄉	2018-11-24T23:07:20+08:00	1533	439	1972	251	2223	4467	49.76%	34.32%	8	10
8	屏東縣三地門鄉	2018-11-24T23:10:57+08:00	1533	439	1972	251	2223	4467	49.76%	34.32%	8	10
8	屏東縣三地門鄉	2018-11-24T22:14:50+08:00	836	257	1093	83	1176	2641	44.53%	31.65%	5	10
8	屏東縣三地門鄉	2018-11-25T06:17:37+08:00	2208	644	2852	320	3172	6373	49.77%	34.65%	10	10
8	屏東縣三地門鄉	2018-11-24T22:56:37+08:00	1221	375	1596	181	1777	3829	46.41%	31.89%	7	10
8	屏東縣三地門鄉	2018-11-24T22:32:19+08:00	1035	326	1361	159	1520	3213	47.31%	32.21%	6	10
8	屏東縣三地門鄉	2018-11-25T01:06:01+08:00	2208	644	2852	320	3172	6373	49.77%	34.65%	10	10
8	屏東縣三地門鄉	2018-11-24T22:53:16+08:00	1221	375	1596	181	1777	3829	46.41%	31.89%	7	10
8	屏東縣三地門鄉	2018-11-25T00:08:06+08:00	1644	483	2127	252	2379	4925	48.3%	33.38%	9	10
8	屏東縣三地門鄉	2018-11-24T22:25:26+08:00	1035	326	1361	159	1520	3213	47.31%	32.21%	6	10
8	屏東縣三地門鄉	2018-11-25T01:11:08+08:00	2208	644	2852	320	3172	6373	49.77%	34.65%	10	10
8	屏東縣三地門鄉	2018-11-24T22:40:20+08:00	1035	326	1361	159	1520	3213	47.31%	32.21%	6	10
8	屏東縣三地門鄉	2018-11-25T06:22:46+08:00	2208	644	2852	320	3172	6373	49.77%	34.65%	10	10
8	屏東縣三地門鄉	2018-11-25T06:07:24+08:00	2208	644	2852	320	3172	6373	49.77%	34.65%	10	10
8	屏東縣三地門鄉	2018-11-24T23:00:18+08:00	1533	439	1972	251	2223	4467	49.76%	34.32%	8	10
8	屏東縣三地門鄉	2018-11-25T03:48:32+08:00	2208	644	2852	320	3172	6373	49.77%	34.65%	10	10
8	屏東縣三地門鄉	2018-11-24T23:29:47+08:00	1533	439	1972	251	2223	4467	49.76%	34.32%	8	10
8	屏東縣三地門鄉	2018-11-25T00:21:45+08:00	1644	483	2127	252	2379	4925	48.3%	33.38%	9	10
8	屏東縣三地門鄉	2018-11-25T03:31:00+08:00	2208	644	2852	320	3172	6373	49.77%	34.65%	10	10
8	屏東縣三地門鄉	2018-11-25T01:16:23+08:00	2208	644	2852	320	3172	6373	49.77%	34.65%	10	10
8	屏東縣三地門鄉	2018-11-25T00:56:14+08:00	2208	644	2852	320	3172	6373	49.77%	34.65%	10	10
8	屏東縣三地門鄉	2018-11-24T23:14:42+08:00	1533	439	1972	251	2223	4467	49.76%	34.32%	8	10
8	屏東縣三地門鄉	2018-11-24T23:50:16+08:00	1644	483	2127	252	2379	4925	48.3%	33.38%	9	10
8	屏東縣三地門鄉	2018-11-24T22:43:51+08:00	1035	326	1361	159	1520	3213	47.31%	32.21%	6	10
8	屏東縣三地門鄉	2018-11-25T06:27:56+08:00	2208	644	2852	320	3172	6373	49.77%	34.65%	10	10
8	屏東縣三地門鄉	2018-11-25T00:12:46+08:00	1644	483	2127	252	2379	4925	48.3%	33.38%	9	10
8	屏東縣三地門鄉	2018-11-24T23:54:28+08:00	1644	483	2127	252	2379	4925	48.3%	33.38%	9	10
8	屏東縣三地門鄉	2018-11-24T23:37:50+08:00	1644	483	2127	252	2379	4925	48.3%	33.38%	9	10
8	屏東縣三地門鄉	2018-11-24T23:22:24+08:00	1533	439	1972	251	2223	4467	49.76%	34.32%	8	10
8	屏東縣三地門鄉	2018-11-24T22:28:41+08:00	1035	326	1361	159	1520	3213	47.31%	32.21%	6	10
8	屏東縣三地門鄉	2018-11-24T22:12:03+08:00	836	257	1093	83	1176	2641	44.53%	31.65%	5	10
8	屏東縣三地門鄉	2018-11-24T23:33:51+08:00	1533	439	1972	251	2223	4467	49.76%	34.32%	8	10
8	屏東縣三地門鄉	2018-11-25T01:24:26+08:00	2208	644	2852	320	3172	6373	49.77%	34.65%	10	10
8	屏東縣三地門鄉	2018-11-25T03:54:42+08:00	2208	644	2852	320	3172	6373	49.77%	34.65%	10	10
8	屏東縣三地門鄉	2018-11-24T23:03:48+08:00	1533	439	1972	251	2223	4467	49.76%	34.32%	8	10
8	屏東縣三地門鄉	2018-11-24T22:49:25+08:00	1035	326	1361	159	1520	3213	47.31%	32.21%	6	10
8	屏東縣三地門鄉	2018-11-24T23:42:03+08:00	1644	483	2127	252	2379	4925	48.3%	33.38%	9	10
8	屏東縣三地門鄉	2018-11-25T04:01:30+08:00	2208	644	2852	320	3172	6373	49.77%	34.65%	10	10
8	屏東縣三地門鄉	2018-11-24T23:46:05+08:00	1644	483	2127	252	2379	4925	48.3%	33.38%	9	10
8	屏東縣三地門鄉	2018-11-25T03:42:49+08:00	2208	644	2852	320	3172	6373	49.77%	34.65%	10	10
8	屏東縣三地門鄉	2018-11-25T00:17:09+08:00	1644	483	2127	252	2379	4925	48.3%	33.38%	9	10
8	屏東縣三地門鄉	2018-11-25T06:12:38+08:00	2208	644	2852	320	3172	6373	49.77%	34.65%	10	10
8	屏東縣三地門鄉	2018-11-24T22:21:47+08:00	1035	326	1361	159	1520	3213	47.31%	32.21%	6	10
8	屏東縣三地門鄉	2018-11-25T01:01:03+08:00	2208	644	2852	320	3172	6373	49.77%	34.65%	10	10
8	屏東縣三地門鄉	2018-11-24T22:39:10+08:00	1035	326	1361	159	1520	3213	47.31%	32.21%	6	10
8	屏東縣三地門鄉	2018-11-24T23:26:08+08:00	1533	439	1972	251	2223	4467	49.76%	34.32%	8	10
8	屏東縣三地門鄉	2018-11-24T22:35:46+08:00	1035	326	1361	159	1520	3213	47.31%	32.21%	6	10
8	屏東縣三地門鄉	2018-11-24T23:58:43+08:00	1644	483	2127	252	2379	4925	48.3%	33.38%	9	10
8	屏東縣三地門鄉	2018-11-25T00:03:36+08:00	1644	483	2127	252	2379	4925	48.3%	33.38%	9	10
8	屏東縣三地門鄉	2018-11-25T03:37:31+08:00	2208	644	2852	320	3172	6373	49.77%	34.65%	10	10
8	屏東縣三地門鄉	2018-11-24T22:18:21+08:00	836	257	1093	83	1176	2641	44.53%	31.65%	5	10
8	屏東縣三地門鄉	2018-11-24T23:18:28+08:00	1533	439	1972	251	2223	4467	49.76%	34.32%	8	10
8	臺南市佳里區	2018-11-25T03:37:19+08:00	17798	5733	23531	2249	25780	50407	51.14%	35.31%	41	41
8	臺南市佳里區	2018-11-24T22:49:18+08:00	17798	5733	23531	2249	25780	50407	51.14%	35.31%	41	41
8	臺南市佳里區	2018-11-24T23:14:34+08:00	17798	5733	23531	2249	25780	50407	51.14%	35.31%	41	41
8	臺南市佳里區	2018-11-24T22:56:31+08:00	17798	5733	23531	2249	25780	50407	51.14%	35.31%	41	41
8	臺南市佳里區	2018-11-25T00:03:27+08:00	17798	5733	23531	2249	25780	50407	51.14%	35.31%	41	41
8	臺南市佳里區	2018-11-25T00:56:07+08:00	17798	5733	23531	2249	25780	50407	51.14%	35.31%	41	41
8	臺南市佳里區	2018-11-24T23:03:42+08:00	17798	5733	23531	2249	25780	50407	51.14%	35.31%	41	41
8	臺南市佳里區	2018-11-24T23:10:51+08:00	17798	5733	23531	2249	25780	50407	51.14%	35.31%	41	41
8	臺南市佳里區	2018-11-24T22:43:44+08:00	17798	5733	23531	2249	25780	50407	51.14%	35.31%	41	41
8	臺南市佳里區	2018-11-25T06:17:30+08:00	17798	5733	23531	2249	25780	50407	51.14%	35.31%	41	41
8	臺南市佳里區	2018-11-24T23:58:36+08:00	17798	5733	23531	2249	25780	50407	51.14%	35.31%	41	41
8	臺南市佳里區	2018-11-24T23:22:17+08:00	17798	5733	23531	2249	25780	50407	51.14%	35.31%	41	41
8	臺南市佳里區	2018-11-25T06:22:40+08:00	17798	5733	23531	2249	25780	50407	51.14%	35.31%	41	41
8	臺南市佳里區	2018-11-24T23:29:41+08:00	17798	5733	23531	2249	25780	50407	51.14%	35.31%	41	41
8	臺南市佳里區	2018-11-24T22:25:18+08:00	17798	5733	23531	2249	25780	50407	51.14%	35.31%	41	41
8	臺南市佳里區	2018-11-25T01:11:00+08:00	17798	5733	23531	2249	25780	50407	51.14%	35.31%	41	41
8	臺南市佳里區	2018-11-25T00:17:02+08:00	17798	5733	23531	2249	25780	50407	51.14%	35.31%	41	41
8	臺南市佳里區	2018-11-25T06:12:32+08:00	17798	5733	23531	2249	25780	50407	51.14%	35.31%	41	41
8	臺南市佳里區	2018-11-25T00:07:58+08:00	17798	5733	23531	2249	25780	50407	51.14%	35.31%	41	41
8	臺南市佳里區	2018-11-25T00:12:40+08:00	17798	5733	23531	2249	25780	50407	51.14%	35.31%	41	41
8	臺南市佳里區	2018-11-24T22:14:43+08:00	17798	5733	23531	2249	25780	50407	51.14%	35.31%	41	41
8	臺南市佳里區	2018-11-24T23:26:02+08:00	17798	5733	23531	2249	25780	50407	51.14%	35.31%	41	41
8	臺南市佳里區	2018-11-25T01:05:52+08:00	17798	5733	23531	2249	25780	50407	51.14%	35.31%	41	41
8	臺南市佳里區	2018-11-24T23:54:19+08:00	17798	5733	23531	2249	25780	50407	51.14%	35.31%	41	41
8	臺南市佳里區	2018-11-24T22:28:34+08:00	17798	5733	23531	2249	25780	50407	51.14%	35.31%	41	41
8	臺南市佳里區	2018-11-24T22:18:14+08:00	17798	5733	23531	2249	25780	50407	51.14%	35.31%	41	41
8	臺南市佳里區	2018-11-25T01:24:18+08:00	17798	5733	23531	2249	25780	50407	51.14%	35.31%	41	41
8	臺南市佳里區	2018-11-24T23:50:09+08:00	17798	5733	23531	2249	25780	50407	51.14%	35.31%	41	41
8	臺南市佳里區	2018-11-25T06:27:49+08:00	17798	5733	23531	2249	25780	50407	51.14%	35.31%	41	41
8	臺南市佳里區	2018-11-24T22:39:03+08:00	17798	5733	23531	2249	25780	50407	51.14%	35.31%	41	41
8	臺南市佳里區	2018-11-24T23:07:13+08:00	17798	5733	23531	2249	25780	50407	51.14%	35.31%	41	41
8	臺南市佳里區	2018-11-25T01:00:54+08:00	17798	5733	23531	2249	25780	50407	51.14%	35.31%	41	41
8	臺南市佳里區	2018-11-24T22:32:13+08:00	17798	5733	23531	2249	25780	50407	51.14%	35.31%	41	41
8	臺南市佳里區	2018-11-25T03:48:23+08:00	17798	5733	23531	2249	25780	50407	51.14%	35.31%	41	41
8	臺南市佳里區	2018-11-24T23:00:09+08:00	17798	5733	23531	2249	25780	50407	51.14%	35.31%	41	41
8	臺南市佳里區	2018-11-25T00:21:38+08:00	17798	5733	23531	2249	25780	50407	51.14%	35.31%	41	41
8	臺南市佳里區	2018-11-25T03:30:52+08:00	17798	5733	23531	2249	25780	50407	51.14%	35.31%	41	41
8	臺南市佳里區	2018-11-25T03:42:41+08:00	17798	5733	23531	2249	25780	50407	51.14%	35.31%	41	41
8	臺南市佳里區	2018-11-24T22:53:08+08:00	17798	5733	23531	2249	25780	50407	51.14%	35.31%	41	41
8	臺南市佳里區	2018-11-25T06:07:17+08:00	17798	5733	23531	2249	25780	50407	51.14%	35.31%	41	41
8	臺南市佳里區	2018-11-24T22:11:57+08:00	17318	5568	22886	2189	25075	48982	51.19%	35.36%	40	41
8	臺南市佳里區	2018-11-24T22:40:14+08:00	17798	5733	23531	2249	25780	50407	51.14%	35.31%	41	41
8	臺南市佳里區	2018-11-25T04:01:23+08:00	17798	5733	23531	2249	25780	50407	51.14%	35.31%	41	41
8	臺南市佳里區	2018-11-24T22:21:40+08:00	17798	5733	23531	2249	25780	50407	51.14%	35.31%	41	41
8	臺南市佳里區	2018-11-24T23:33:44+08:00	17798	5733	23531	2249	25780	50407	51.14%	35.31%	41	41
8	臺南市佳里區	2018-11-25T03:54:34+08:00	17798	5733	23531	2249	25780	50407	51.14%	35.31%	41	41
8	臺南市佳里區	2018-11-25T01:16:16+08:00	17798	5733	23531	2249	25780	50407	51.14%	35.31%	41	41
8	臺南市佳里區	2018-11-24T23:45:58+08:00	17798	5733	23531	2249	25780	50407	51.14%	35.31%	41	41
8	臺南市佳里區	2018-11-24T22:35:40+08:00	17798	5733	23531	2249	25780	50407	51.14%	35.31%	41	41
8	臺南市佳里區	2018-11-24T23:41:56+08:00	17798	5733	23531	2249	25780	50407	51.14%	35.31%	41	41
8	臺南市佳里區	2018-11-24T23:37:43+08:00	17798	5733	23531	2249	25780	50407	51.14%	35.31%	41	41
8	臺南市佳里區	2018-11-24T23:18:21+08:00	17798	5733	23531	2249	25780	50407	51.14%	35.31%	41	41
8	花蓮縣玉里鎮	2018-11-24T22:14:51+08:00	2594	792	3386	539	3925	8093	48.5%	32.05%	11	23
8	花蓮縣玉里鎮	2018-11-24T23:33:52+08:00	4435	1379	5814	919	6733	13940	48.3%	31.81%	17	23
8	花蓮縣玉里鎮	2018-11-24T22:28:42+08:00	2840	902	3742	644	4386	8959	48.96%	31.7%	12	23
8	花蓮縣玉里鎮	2018-11-24T22:56:38+08:00	3237	1019	4256	729	4985	10205	48.85%	31.72%	13	23
8	花蓮縣玉里鎮	2018-11-24T23:07:21+08:00	3627	1115	4742	774	5516	11184	49.32%	32.43%	14	23
8	花蓮縣玉里鎮	2018-11-24T22:49:26+08:00	3237	1019	4256	729	4985	10205	48.85%	31.72%	13	23
8	花蓮縣玉里鎮	2018-11-24T23:10:58+08:00	3825	1190	5015	816	5831	11953	48.78%	32%	15	23
8	花蓮縣玉里鎮	2018-11-25T06:17:39+08:00	6519	1916	8435	1232	9667	20650	46.81%	31.57%	23	23
8	花蓮縣玉里鎮	2018-11-24T22:53:17+08:00	3237	1019	4256	729	4985	10205	48.85%	31.72%	13	23
8	花蓮縣玉里鎮	2018-11-25T00:08:07+08:00	5441	1669	7110	1084	8194	17118	47.87%	31.79%	20	23
8	花蓮縣玉里鎮	2018-11-24T22:32:20+08:00	2840	902	3742	644	4386	8959	48.96%	31.7%	12	23
8	花蓮縣玉里鎮	2018-11-25T00:17:10+08:00	5441	1669	7110	1084	8194	17118	47.87%	31.79%	20	23
8	花蓮縣玉里鎮	2018-11-25T03:48:33+08:00	6519	1916	8435	1232	9667	20650	46.81%	31.57%	23	23
8	花蓮縣玉里鎮	2018-11-24T23:00:19+08:00	3237	1019	4256	729	4985	10205	48.85%	31.72%	13	23
8	花蓮縣玉里鎮	2018-11-25T06:07:25+08:00	6519	1916	8435	1232	9667	20650	46.81%	31.57%	23	23
8	花蓮縣玉里鎮	2018-11-24T23:29:48+08:00	4222	1289	5511	863	6374	12961	49.18%	32.57%	16	23
8	花蓮縣玉里鎮	2018-11-24T22:40:20+08:00	2840	902	3742	644	4386	8959	48.96%	31.7%	12	23
8	花蓮縣玉里鎮	2018-11-25T06:22:46+08:00	6519	1916	8435	1232	9667	20650	46.81%	31.57%	23	23
8	花蓮縣玉里鎮	2018-11-24T22:25:27+08:00	2594	792	3386	539	3925	8093	48.5%	32.05%	11	23
8	花蓮縣玉里鎮	2018-11-25T03:42:50+08:00	6519	1916	8435	1232	9667	20650	46.81%	31.57%	23	23
8	花蓮縣玉里鎮	2018-11-24T23:50:17+08:00	5234	1595	6829	1004	7833	16053	48.79%	32.6%	19	23
8	花蓮縣玉里鎮	2018-11-24T23:14:43+08:00	3825	1190	5015	816	5831	11953	48.78%	32%	15	23
8	花蓮縣玉里鎮	2018-11-25T01:16:24+08:00	6519	1916	8435	1232	9667	20650	46.81%	31.57%	23	23
8	花蓮縣玉里鎮	2018-11-25T00:12:47+08:00	5441	1669	7110	1084	8194	17118	47.87%	31.79%	20	23
8	花蓮縣玉里鎮	2018-11-24T23:54:29+08:00	5234	1595	6829	1004	7833	16053	48.79%	32.6%	19	23
8	花蓮縣玉里鎮	2018-11-25T06:27:57+08:00	6519	1916	8435	1232	9667	20650	46.81%	31.57%	23	23
8	花蓮縣玉里鎮	2018-11-25T03:31:01+08:00	6519	1916	8435	1232	9667	20650	46.81%	31.57%	23	23
8	花蓮縣玉里鎮	2018-11-25T03:37:32+08:00	6519	1916	8435	1232	9667	20650	46.81%	31.57%	23	23
8	花蓮縣玉里鎮	2018-11-25T00:56:15+08:00	6519	1916	8435	1232	9667	20650	46.81%	31.57%	23	23
8	花蓮縣玉里鎮	2018-11-24T23:37:50+08:00	4435	1379	5814	919	6733	13940	48.3%	31.81%	17	23
8	花蓮縣玉里鎮	2018-11-25T01:24:27+08:00	6519	1916	8435	1232	9667	20650	46.81%	31.57%	23	23
8	花蓮縣玉里鎮	2018-11-25T03:54:43+08:00	6519	1916	8435	1232	9667	20650	46.81%	31.57%	23	23
8	花蓮縣玉里鎮	2018-11-24T23:03:49+08:00	3627	1115	4742	774	5516	11184	49.32%	32.43%	14	23
8	花蓮縣玉里鎮	2018-11-24T22:12:04+08:00	2594	792	3386	539	3925	8093	48.5%	32.05%	11	23
8	花蓮縣玉里鎮	2018-11-24T23:22:25+08:00	3825	1190	5015	816	5831	11953	48.78%	32%	15	23
8	花蓮縣玉里鎮	2018-11-25T01:06:02+08:00	6519	1916	8435	1232	9667	20650	46.81%	31.57%	23	23
8	花蓮縣玉里鎮	2018-11-24T23:42:04+08:00	4986	1515	6501	962	7463	15184	49.15%	32.84%	18	23
8	花蓮縣玉里鎮	2018-11-25T01:11:10+08:00	6519	1916	8435	1232	9667	20650	46.81%	31.57%	23	23
8	花蓮縣玉里鎮	2018-11-24T23:46:05+08:00	4986	1515	6501	962	7463	15184	49.15%	32.84%	18	23
8	花蓮縣玉里鎮	2018-11-25T04:01:31+08:00	6519	1916	8435	1232	9667	20650	46.81%	31.57%	23	23
8	花蓮縣玉里鎮	2018-11-25T06:12:39+08:00	6519	1916	8435	1232	9667	20650	46.81%	31.57%	23	23
8	花蓮縣玉里鎮	2018-11-24T22:21:48+08:00	2594	792	3386	539	3925	8093	48.5%	32.05%	11	23
8	花蓮縣玉里鎮	2018-11-25T00:21:46+08:00	5605	1710	7315	1101	8416	18108	46.48%	30.95%	21	23
8	花蓮縣玉里鎮	2018-11-25T01:01:04+08:00	6519	1916	8435	1232	9667	20650	46.81%	31.57%	23	23
8	花蓮縣玉里鎮	2018-11-24T22:35:46+08:00	2840	902	3742	644	4386	8959	48.96%	31.7%	12	23
8	花蓮縣玉里鎮	2018-11-24T23:58:44+08:00	5441	1669	7110	1084	8194	17118	47.87%	31.79%	20	23
8	花蓮縣玉里鎮	2018-11-24T23:18:29+08:00	3825	1190	5015	816	5831	11953	48.78%	32%	15	23
8	花蓮縣玉里鎮	2018-11-24T22:18:21+08:00	2594	792	3386	539	3925	8093	48.5%	32.05%	11	23
8	花蓮縣玉里鎮	2018-11-24T22:39:11+08:00	2840	902	3742	644	4386	8959	48.96%	31.7%	12	23
8	花蓮縣玉里鎮	2018-11-24T23:26:09+08:00	3825	1190	5015	816	5831	11953	48.78%	32%	15	23
8	花蓮縣玉里鎮	2018-11-25T00:03:37+08:00	5441	1669	7110	1084	8194	17118	47.87%	31.79%	20	23
8	花蓮縣玉里鎮	2018-11-24T22:43:52+08:00	2840	902	3742	644	4386	8959	48.96%	31.7%	12	23
8	花蓮縣卓溪鄉	2018-11-24T22:14:51+08:00	1146	370	1516	224	1740	3285	52.97%	34.89%	7	10
8	花蓮縣卓溪鄉	2018-11-24T23:33:52+08:00	1819	555	2374	304	2678	4947	54.13%	36.77%	10	10
8	花蓮縣卓溪鄉	2018-11-24T22:28:42+08:00	1453	459	1912	266	2178	3986	54.64%	36.45%	8	10
8	花蓮縣卓溪鄉	2018-11-24T22:56:38+08:00	1453	459	1912	266	2178	3986	54.64%	36.45%	8	10
8	花蓮縣卓溪鄉	2018-11-24T23:07:21+08:00	1653	524	2177	283	2460	4519	54.44%	36.58%	9	10
8	花蓮縣卓溪鄉	2018-11-24T22:49:26+08:00	1453	459	1912	266	2178	3986	54.64%	36.45%	8	10
8	花蓮縣卓溪鄉	2018-11-24T23:10:58+08:00	1653	524	2177	283	2460	4519	54.44%	36.58%	9	10
8	花蓮縣卓溪鄉	2018-11-25T06:17:39+08:00	1819	555	2374	304	2678	4947	54.13%	36.77%	10	10
8	花蓮縣卓溪鄉	2018-11-24T22:53:17+08:00	1453	459	1912	266	2178	3986	54.64%	36.45%	8	10
8	花蓮縣卓溪鄉	2018-11-24T23:46:06+08:00	1819	555	2374	304	2678	4947	54.13%	36.77%	10	10
8	花蓮縣卓溪鄉	2018-11-25T00:08:07+08:00	1819	555	2374	304	2678	4947	54.13%	36.77%	10	10
8	花蓮縣卓溪鄉	2018-11-24T22:32:20+08:00	1453	459	1912	266	2178	3986	54.64%	36.45%	8	10
8	花蓮縣卓溪鄉	2018-11-25T00:17:10+08:00	1819	555	2374	304	2678	4947	54.13%	36.77%	10	10
8	花蓮縣卓溪鄉	2018-11-25T04:01:32+08:00	1819	555	2374	304	2678	4947	54.13%	36.77%	10	10
8	花蓮縣卓溪鄉	2018-11-25T03:48:33+08:00	1819	555	2374	304	2678	4947	54.13%	36.77%	10	10
8	花蓮縣卓溪鄉	2018-11-24T23:00:19+08:00	1453	459	1912	266	2178	3986	54.64%	36.45%	8	10
8	花蓮縣卓溪鄉	2018-11-25T06:07:25+08:00	1819	555	2374	304	2678	4947	54.13%	36.77%	10	10
8	花蓮縣卓溪鄉	2018-11-25T06:22:47+08:00	1819	555	2374	304	2678	4947	54.13%	36.77%	10	10
8	花蓮縣卓溪鄉	2018-11-25T03:42:51+08:00	1819	555	2374	304	2678	4947	54.13%	36.77%	10	10
8	花蓮縣卓溪鄉	2018-11-24T22:25:27+08:00	1146	370	1516	224	1740	3285	52.97%	34.89%	7	10
8	花蓮縣卓溪鄉	2018-11-24T22:40:21+08:00	1453	459	1912	266	2178	3986	54.64%	36.45%	8	10
8	花蓮縣卓溪鄉	2018-11-24T23:29:49+08:00	1819	555	2374	304	2678	4947	54.13%	36.77%	10	10
8	花蓮縣卓溪鄉	2018-11-24T23:50:17+08:00	1819	555	2374	304	2678	4947	54.13%	36.77%	10	10
8	花蓮縣卓溪鄉	2018-11-24T23:14:43+08:00	1653	524	2177	283	2460	4519	54.44%	36.58%	9	10
8	花蓮縣卓溪鄉	2018-11-25T00:12:47+08:00	1819	555	2374	304	2678	4947	54.13%	36.77%	10	10
8	花蓮縣卓溪鄉	2018-11-24T23:54:29+08:00	1819	555	2374	304	2678	4947	54.13%	36.77%	10	10
8	花蓮縣卓溪鄉	2018-11-25T06:27:57+08:00	1819	555	2374	304	2678	4947	54.13%	36.77%	10	10
8	花蓮縣卓溪鄉	2018-11-25T01:16:25+08:00	1819	555	2374	304	2678	4947	54.13%	36.77%	10	10
8	花蓮縣卓溪鄉	2018-11-24T22:18:22+08:00	1146	370	1516	224	1740	3285	52.97%	34.89%	7	10
8	花蓮縣卓溪鄉	2018-11-25T03:37:32+08:00	1819	555	2374	304	2678	4947	54.13%	36.77%	10	10
8	花蓮縣卓溪鄉	2018-11-25T01:24:27+08:00	1819	555	2374	304	2678	4947	54.13%	36.77%	10	10
8	花蓮縣卓溪鄉	2018-11-25T03:54:44+08:00	1819	555	2374	304	2678	4947	54.13%	36.77%	10	10
8	花蓮縣卓溪鄉	2018-11-24T23:03:49+08:00	1453	459	1912	266	2178	3986	54.64%	36.45%	8	10
8	花蓮縣卓溪鄉	2018-11-24T23:22:25+08:00	1819	555	2374	304	2678	4947	54.13%	36.77%	10	10
8	花蓮縣卓溪鄉	2018-11-24T23:37:51+08:00	1819	555	2374	304	2678	4947	54.13%	36.77%	10	10
8	花蓮縣卓溪鄉	2018-11-24T22:12:05+08:00	1146	370	1516	224	1740	3285	52.97%	34.89%	7	10
8	花蓮縣卓溪鄉	2018-11-25T01:06:02+08:00	1819	555	2374	304	2678	4947	54.13%	36.77%	10	10
8	花蓮縣卓溪鄉	2018-11-24T23:42:04+08:00	1819	555	2374	304	2678	4947	54.13%	36.77%	10	10
8	花蓮縣卓溪鄉	2018-11-25T01:11:10+08:00	1819	555	2374	304	2678	4947	54.13%	36.77%	10	10
8	花蓮縣卓溪鄉	2018-11-25T06:12:39+08:00	1819	555	2374	304	2678	4947	54.13%	36.77%	10	10
8	花蓮縣卓溪鄉	2018-11-25T00:21:46+08:00	1819	555	2374	304	2678	4947	54.13%	36.77%	10	10
8	花蓮縣卓溪鄉	2018-11-24T22:21:49+08:00	1146	370	1516	224	1740	3285	52.97%	34.89%	7	10
8	花蓮縣卓溪鄉	2018-11-25T01:01:04+08:00	1819	555	2374	304	2678	4947	54.13%	36.77%	10	10
8	花蓮縣卓溪鄉	2018-11-24T22:43:53+08:00	1453	459	1912	266	2178	3986	54.64%	36.45%	8	10
8	花蓮縣卓溪鄉	2018-11-24T23:18:29+08:00	1819	555	2374	304	2678	4947	54.13%	36.77%	10	10
8	花蓮縣卓溪鄉	2018-11-24T22:35:47+08:00	1453	459	1912	266	2178	3986	54.64%	36.45%	8	10
8	花蓮縣卓溪鄉	2018-11-24T23:58:45+08:00	1819	555	2374	304	2678	4947	54.13%	36.77%	10	10
8	花蓮縣卓溪鄉	2018-11-25T00:56:16+08:00	1819	555	2374	304	2678	4947	54.13%	36.77%	10	10
8	花蓮縣卓溪鄉	2018-11-24T22:39:11+08:00	1453	459	1912	266	2178	3986	54.64%	36.45%	8	10
8	花蓮縣卓溪鄉	2018-11-24T23:26:09+08:00	1819	555	2374	304	2678	4947	54.13%	36.77%	10	10
8	花蓮縣卓溪鄉	2018-11-25T03:31:02+08:00	1819	555	2374	304	2678	4947	54.13%	36.77%	10	10
8	花蓮縣卓溪鄉	2018-11-25T00:03:37+08:00	1819	555	2374	304	2678	4947	54.13%	36.77%	10	10
8	高雄市桃源區	2018-11-24T22:49:20+08:00	1284	348	1632	112	1744	3498	49.86%	36.71%	8	8
8	高雄市桃源區	2018-11-24T23:03:44+08:00	1284	348	1632	112	1744	3498	49.86%	36.71%	8	8
8	高雄市桃源區	2018-11-24T23:22:20+08:00	1284	348	1632	112	1744	3498	49.86%	36.71%	8	8
8	高雄市桃源區	2018-11-24T23:58:38+08:00	1284	348	1632	112	1744	3498	49.86%	36.71%	8	8
8	高雄市桃源區	2018-11-25T03:42:44+08:00	1284	348	1632	112	1744	3498	49.86%	36.71%	8	8
8	高雄市桃源區	2018-11-25T01:00:57+08:00	1284	348	1632	112	1744	3498	49.86%	36.71%	8	8
8	高雄市桃源區	2018-11-24T22:53:11+08:00	1284	348	1632	112	1744	3498	49.86%	36.71%	8	8
8	高雄市桃源區	2018-11-24T23:46:00+08:00	1284	348	1632	112	1744	3498	49.86%	36.71%	8	8
8	高雄市桃源區	2018-11-25T00:08:01+08:00	1284	348	1632	112	1744	3498	49.86%	36.71%	8	8
8	高雄市桃源區	2018-11-24T22:21:42+08:00	1039	288	1327	103	1430	2602	54.96%	39.93%	6	8
8	高雄市桃源區	2018-11-25T06:12:33+08:00	1284	348	1632	112	1744	3498	49.86%	36.71%	8	8
8	高雄市桃源區	2018-11-25T00:17:04+08:00	1284	348	1632	112	1744	3498	49.86%	36.71%	8	8
8	高雄市桃源區	2018-11-24T22:25:20+08:00	1097	306	1403	103	1506	2866	52.55%	38.28%	7	8
8	高雄市桃源區	2018-11-24T23:18:24+08:00	1284	348	1632	112	1744	3498	49.86%	36.71%	8	8
8	高雄市桃源區	2018-11-24T23:37:46+08:00	1284	348	1632	112	1744	3498	49.86%	36.71%	8	8
8	高雄市桃源區	2018-11-25T03:54:37+08:00	1284	348	1632	112	1744	3498	49.86%	36.71%	8	8
8	高雄市桃源區	2018-11-24T23:33:47+08:00	1284	348	1632	112	1744	3498	49.86%	36.71%	8	8
8	高雄市桃源區	2018-11-25T01:05:55+08:00	1284	348	1632	112	1744	3498	49.86%	36.71%	8	8
8	高雄市桃源區	2018-11-24T23:50:11+08:00	1284	348	1632	112	1744	3498	49.86%	36.71%	8	8
8	高雄市桃源區	2018-11-24T23:26:04+08:00	1284	348	1632	112	1744	3498	49.86%	36.71%	8	8
8	高雄市桃源區	2018-11-24T22:14:45+08:00	806	225	1031	87	1118	1819	61.46%	44.31%	5	8
8	高雄市桃源區	2018-11-25T01:24:20+08:00	1284	348	1632	112	1744	3498	49.86%	36.71%	8	8
8	高雄市桃源區	2018-11-25T06:17:32+08:00	1284	348	1632	112	1744	3498	49.86%	36.71%	8	8
8	高雄市桃源區	2018-11-25T03:37:22+08:00	1284	348	1632	112	1744	3498	49.86%	36.71%	8	8
8	高雄市桃源區	2018-11-24T23:07:15+08:00	1284	348	1632	112	1744	3498	49.86%	36.71%	8	8
8	高雄市桃源區	2018-11-24T22:39:05+08:00	1284	348	1632	112	1744	3498	49.86%	36.71%	8	8
8	高雄市桃源區	2018-11-24T23:10:53+08:00	1284	348	1632	112	1744	3498	49.86%	36.71%	8	8
8	高雄市桃源區	2018-11-24T22:43:47+08:00	1284	348	1632	112	1744	3498	49.86%	36.71%	8	8
8	高雄市桃源區	2018-11-24T22:56:33+08:00	1284	348	1632	112	1744	3498	49.86%	36.71%	8	8
8	高雄市桃源區	2018-11-24T23:14:36+08:00	1284	348	1632	112	1744	3498	49.86%	36.71%	8	8
8	高雄市桃源區	2018-11-25T03:48:25+08:00	1284	348	1632	112	1744	3498	49.86%	36.71%	8	8
8	高雄市桃源區	2018-11-25T03:30:55+08:00	1284	348	1632	112	1744	3498	49.86%	36.71%	8	8
8	高雄市桃源區	2018-11-24T22:32:15+08:00	1284	348	1632	112	1744	3498	49.86%	36.71%	8	8
8	高雄市桃源區	2018-11-24T22:40:15+08:00	1284	348	1632	112	1744	3498	49.86%	36.71%	8	8
8	高雄市桃源區	2018-11-25T04:01:25+08:00	1284	348	1632	112	1744	3498	49.86%	36.71%	8	8
8	高雄市桃源區	2018-11-24T22:11:59+08:00	806	225	1031	87	1118	1819	61.46%	44.31%	5	8
8	高雄市桃源區	2018-11-24T23:00:14+08:00	1284	348	1632	112	1744	3498	49.86%	36.71%	8	8
8	高雄市桃源區	2018-11-25T06:07:19+08:00	1284	348	1632	112	1744	3498	49.86%	36.71%	8	8
8	高雄市桃源區	2018-11-25T01:11:03+08:00	1284	348	1632	112	1744	3498	49.86%	36.71%	8	8
8	高雄市桃源區	2018-11-24T23:29:43+08:00	1284	348	1632	112	1744	3498	49.86%	36.71%	8	8
8	高雄市桃源區	2018-11-25T00:21:41+08:00	1284	348	1632	112	1744	3498	49.86%	36.71%	8	8
8	高雄市桃源區	2018-11-25T06:22:42+08:00	1284	348	1632	112	1744	3498	49.86%	36.71%	8	8
8	高雄市桃源區	2018-11-24T22:28:36+08:00	1284	348	1632	112	1744	3498	49.86%	36.71%	8	8
8	高雄市桃源區	2018-11-25T00:56:10+08:00	1284	348	1632	112	1744	3498	49.86%	36.71%	8	8
8	高雄市桃源區	2018-11-24T22:18:16+08:00	806	225	1031	87	1118	1819	61.46%	44.31%	5	8
8	高雄市桃源區	2018-11-24T23:54:24+08:00	1284	348	1632	112	1744	3498	49.86%	36.71%	8	8
8	高雄市桃源區	2018-11-24T22:35:41+08:00	1284	348	1632	112	1744	3498	49.86%	36.71%	8	8
8	高雄市桃源區	2018-11-25T01:16:18+08:00	1284	348	1632	112	1744	3498	49.86%	36.71%	8	8
8	高雄市桃源區	2018-11-24T23:41:58+08:00	1284	348	1632	112	1744	3498	49.86%	36.71%	8	8
8	高雄市桃源區	2018-11-25T06:27:52+08:00	1284	348	1632	112	1744	3498	49.86%	36.71%	8	8
8	高雄市桃源區	2018-11-25T00:12:42+08:00	1284	348	1632	112	1744	3498	49.86%	36.71%	8	8
8	高雄市桃源區	2018-11-25T00:03:30+08:00	1284	348	1632	112	1744	3498	49.86%	36.71%	8	8
8	高雄市永安區	2018-11-24T22:49:20+08:00	3519	1345	4864	546	5410	8692	62.24%	40.49%	10	12
8	高雄市永安區	2018-11-25T03:37:21+08:00	4954	1826	6780	691	7471	12001	62.25%	41.28%	12	12
8	高雄市永安區	2018-11-24T23:03:44+08:00	3519	1345	4864	546	5410	8692	62.24%	40.49%	10	12
8	高雄市永安區	2018-11-25T00:56:09+08:00	4954	1826	6780	691	7471	12001	62.25%	41.28%	12	12
8	高雄市永安區	2018-11-24T23:58:38+08:00	4954	1826	6780	691	7471	12001	62.25%	41.28%	12	12
8	高雄市永安區	2018-11-24T23:22:19+08:00	4337	1615	5952	645	6597	10583	62.34%	40.98%	11	12
8	高雄市永安區	2018-11-25T03:42:44+08:00	4954	1826	6780	691	7471	12001	62.25%	41.28%	12	12
8	高雄市永安區	2018-11-25T01:00:57+08:00	4954	1826	6780	691	7471	12001	62.25%	41.28%	12	12
8	高雄市永安區	2018-11-24T22:53:11+08:00	3519	1345	4864	546	5410	8692	62.24%	40.49%	10	12
8	高雄市永安區	2018-11-24T23:46:00+08:00	4337	1615	5952	645	6597	10583	62.34%	40.98%	11	12
8	高雄市永安區	2018-11-25T00:08:01+08:00	4954	1826	6780	691	7471	12001	62.25%	41.28%	12	12
8	高雄市永安區	2018-11-24T22:21:42+08:00	3519	1345	4864	546	5410	8692	62.24%	40.49%	10	12
8	高雄市永安區	2018-11-25T06:12:33+08:00	4954	1826	6780	691	7471	12001	62.25%	41.28%	12	12
8	高雄市永安區	2018-11-25T00:17:04+08:00	4954	1826	6780	691	7471	12001	62.25%	41.28%	12	12
8	高雄市永安區	2018-11-25T06:22:41+08:00	4954	1826	6780	691	7471	12001	62.25%	41.28%	12	12
8	高雄市永安區	2018-11-24T22:25:20+08:00	3519	1345	4864	546	5410	8692	62.24%	40.49%	10	12
8	高雄市永安區	2018-11-24T23:18:23+08:00	4337	1615	5952	645	6597	10583	62.34%	40.98%	11	12
8	高雄市永安區	2018-11-25T01:05:55+08:00	4954	1826	6780	691	7471	12001	62.25%	41.28%	12	12
8	高雄市永安區	2018-11-24T23:50:11+08:00	4337	1615	5952	645	6597	10583	62.34%	40.98%	11	12
8	高雄市永安區	2018-11-24T22:14:45+08:00	2882	1118	4000	458	4458	7215	61.79%	39.94%	9	12
8	高雄市永安區	2018-11-24T23:33:46+08:00	4337	1615	5952	645	6597	10583	62.34%	40.98%	11	12
8	高雄市永安區	2018-11-25T06:27:51+08:00	4954	1826	6780	691	7471	12001	62.25%	41.28%	12	12
8	高雄市永安區	2018-11-24T23:26:03+08:00	4337	1615	5952	645	6597	10583	62.34%	40.98%	11	12
8	高雄市永安區	2018-11-25T03:54:36+08:00	4954	1826	6780	691	7471	12001	62.25%	41.28%	12	12
8	高雄市永安區	2018-11-25T00:12:41+08:00	4954	1826	6780	691	7471	12001	62.25%	41.28%	12	12
8	高雄市永安區	2018-11-25T01:24:20+08:00	4954	1826	6780	691	7471	12001	62.25%	41.28%	12	12
8	高雄市永安區	2018-11-24T22:43:46+08:00	3519	1345	4864	546	5410	8692	62.24%	40.49%	10	12
8	高雄市永安區	2018-11-25T06:17:32+08:00	4954	1826	6780	691	7471	12001	62.25%	41.28%	12	12
8	高雄市永安區	2018-11-24T23:07:15+08:00	3519	1345	4864	546	5410	8692	62.24%	40.49%	10	12
8	高雄市永安區	2018-11-24T22:39:05+08:00	3519	1345	4864	546	5410	8692	62.24%	40.49%	10	12
8	高雄市永安區	2018-11-24T23:10:53+08:00	3519	1345	4864	546	5410	8692	62.24%	40.49%	10	12
8	高雄市永安區	2018-11-24T22:56:33+08:00	3519	1345	4864	546	5410	8692	62.24%	40.49%	10	12
8	高雄市永安區	2018-11-24T23:14:36+08:00	3519	1345	4864	546	5410	8692	62.24%	40.49%	10	12
8	高雄市永安區	2018-11-25T03:48:25+08:00	4954	1826	6780	691	7471	12001	62.25%	41.28%	12	12
8	高雄市永安區	2018-11-24T22:32:14+08:00	3519	1345	4864	546	5410	8692	62.24%	40.49%	10	12
8	高雄市永安區	2018-11-25T03:30:55+08:00	4954	1826	6780	691	7471	12001	62.25%	41.28%	12	12
8	高雄市永安區	2018-11-24T22:40:15+08:00	3519	1345	4864	546	5410	8692	62.24%	40.49%	10	12
8	高雄市永安區	2018-11-25T00:21:40+08:00	4954	1826	6780	691	7471	12001	62.25%	41.28%	12	12
8	高雄市永安區	2018-11-24T23:29:42+08:00	4337	1615	5952	645	6597	10583	62.34%	40.98%	11	12
8	高雄市永安區	2018-11-25T01:11:02+08:00	4954	1826	6780	691	7471	12001	62.25%	41.28%	12	12
8	高雄市永安區	2018-11-25T04:01:25+08:00	4954	1826	6780	691	7471	12001	62.25%	41.28%	12	12
8	高雄市永安區	2018-11-24T22:11:59+08:00	2882	1118	4000	458	4458	7215	61.79%	39.94%	9	12
8	高雄市永安區	2018-11-24T23:00:14+08:00	3519	1345	4864	546	5410	8692	62.24%	40.49%	10	12
8	高雄市永安區	2018-11-25T06:07:19+08:00	4954	1826	6780	691	7471	12001	62.25%	41.28%	12	12
8	高雄市永安區	2018-11-24T22:28:36+08:00	3519	1345	4864	546	5410	8692	62.24%	40.49%	10	12
8	高雄市永安區	2018-11-24T22:18:16+08:00	2882	1118	4000	458	4458	7215	61.79%	39.94%	9	12
8	高雄市永安區	2018-11-24T23:54:23+08:00	4337	1615	5952	645	6597	10583	62.34%	40.98%	11	12
8	高雄市永安區	2018-11-24T22:35:41+08:00	3519	1345	4864	546	5410	8692	62.24%	40.49%	10	12
8	高雄市永安區	2018-11-24T23:37:45+08:00	4337	1615	5952	645	6597	10583	62.34%	40.98%	11	12
8	高雄市永安區	2018-11-24T23:41:58+08:00	4337	1615	5952	645	6597	10583	62.34%	40.98%	11	12
8	高雄市永安區	2018-11-25T00:03:30+08:00	4954	1826	6780	691	7471	12001	62.25%	41.28%	12	12
8	高雄市永安區	2018-11-25T01:16:17+08:00	4954	1826	6780	691	7471	12001	62.25%	41.28%	12	12
8	嘉義縣水上鄉	2018-11-24T23:07:18+08:00	9318	3282	12600	1439	14039	26303	53.37%	35.43%	29	39
8	嘉義縣水上鄉	2018-11-24T22:56:36+08:00	9318	3282	12600	1439	14039	26303	53.37%	35.43%	29	39
8	嘉義縣水上鄉	2018-11-25T01:24:24+08:00	15249	5407	20656	2205	22861	43857	52.13%	34.77%	39	39
8	嘉義縣水上鄉	2018-11-25T06:17:36+08:00	15249	5407	20656	2205	22861	43857	52.13%	34.77%	39	39
8	嘉義縣水上鄉	2018-11-24T23:10:56+08:00	9318	3282	12600	1439	14039	26303	53.37%	35.43%	29	39
8	嘉義縣水上鄉	2018-11-25T03:37:29+08:00	15249	5407	20656	2205	22861	43857	52.13%	34.77%	39	39
8	嘉義縣水上鄉	2018-11-24T22:39:09+08:00	7669	2689	10358	1175	11533	21409	53.87%	35.82%	25	39
8	嘉義縣水上鄉	2018-11-25T03:54:41+08:00	15249	5407	20656	2205	22861	43857	52.13%	34.77%	39	39
8	嘉義縣水上鄉	2018-11-25T03:30:59+08:00	15249	5407	20656	2205	22861	43857	52.13%	34.77%	39	39
8	嘉義縣水上鄉	2018-11-24T22:32:18+08:00	7669	2689	10358	1175	11533	21409	53.87%	35.82%	25	39
8	嘉義縣水上鄉	2018-11-25T03:48:29+08:00	15249	5407	20656	2205	22861	43857	52.13%	34.77%	39	39
8	嘉義縣水上鄉	2018-11-24T23:00:17+08:00	9318	3282	12600	1439	14039	26303	53.37%	35.43%	29	39
8	嘉義縣水上鄉	2018-11-25T00:21:44+08:00	15249	5407	20656	2205	22861	43857	52.13%	34.77%	39	39
8	嘉義縣水上鄉	2018-11-24T23:29:46+08:00	11809	4224	16033	1776	17809	33425	53.28%	35.33%	33	39
8	嘉義縣水上鄉	2018-11-25T06:07:23+08:00	15249	5407	20656	2205	22861	43857	52.13%	34.77%	39	39
8	嘉義縣水上鄉	2018-11-25T04:01:29+08:00	15249	5407	20656	2205	22861	43857	52.13%	34.77%	39	39
8	嘉義縣水上鄉	2018-11-25T01:11:07+08:00	15249	5407	20656	2205	22861	43857	52.13%	34.77%	39	39
8	嘉義縣水上鄉	2018-11-24T22:40:19+08:00	7669	2689	10358	1175	11533	21409	53.87%	35.82%	25	39
8	嘉義縣水上鄉	2018-11-24T23:37:48+08:00	13111	4686	17797	1937	19734	37360	52.82%	35.09%	35	39
8	嘉義縣水上鄉	2018-11-24T22:43:50+08:00	7669	2689	10358	1175	11533	21409	53.87%	35.82%	25	39
8	嘉義縣水上鄉	2018-11-25T00:56:13+08:00	15249	5407	20656	2205	22861	43857	52.13%	34.77%	39	39
8	嘉義縣水上鄉	2018-11-24T23:54:27+08:00	13111	4686	17797	1937	19734	37360	52.82%	35.09%	35	39
8	嘉義縣水上鄉	2018-11-25T01:16:22+08:00	15249	5407	20656	2205	22861	43857	52.13%	34.77%	39	39
8	嘉義縣水上鄉	2018-11-25T00:03:34+08:00	14177	5040	19217	2049	21266	40616	52.36%	34.9%	37	39
8	嘉義縣水上鄉	2018-11-24T22:35:44+08:00	7669	2689	10358	1175	11533	21409	53.87%	35.82%	25	39
8	嘉義縣水上鄉	2018-11-25T01:01:01+08:00	15249	5407	20656	2205	22861	43857	52.13%	34.77%	39	39
8	嘉義縣水上鄉	2018-11-24T23:22:23+08:00	10470	3674	14144	1565	15709	29471	53.3%	35.53%	31	39
8	嘉義縣水上鄉	2018-11-24T22:49:24+08:00	8372	2942	11314	1312	12626	23466	53.81%	35.68%	27	39
8	嘉義縣水上鄉	2018-11-24T23:03:47+08:00	9318	3282	12600	1439	14039	26303	53.37%	35.43%	29	39
8	嘉義縣水上鄉	2018-11-24T22:28:40+08:00	7669	2689	10358	1175	11533	21409	53.87%	35.82%	25	39
8	嘉義縣水上鄉	2018-11-24T23:33:50+08:00	12448	4449	16897	1824	18721	35373	52.92%	35.19%	34	39
8	嘉義縣水上鄉	2018-11-24T22:12:02+08:00	7438	2615	10053	1143	11196	20839	53.73%	35.69%	24	39
8	嘉義縣水上鄉	2018-11-24T23:42:02+08:00	13111	4686	17797	1937	19734	37360	52.82%	35.09%	35	39
8	嘉義縣水上鄉	2018-11-25T00:08:05+08:00	14177	5040	19217	2049	21266	40616	52.36%	34.9%	37	39
8	嘉義縣水上鄉	2018-11-25T03:42:48+08:00	15249	5407	20656	2205	22861	43857	52.13%	34.77%	39	39
8	嘉義縣水上鄉	2018-11-24T22:53:15+08:00	8740	3076	11816	1384	13200	24531	53.81%	35.63%	28	39
8	嘉義縣水上鄉	2018-11-24T23:46:03+08:00	13111	4686	17797	1937	19734	37360	52.82%	35.09%	35	39
8	嘉義縣水上鄉	2018-11-25T06:12:37+08:00	15249	5407	20656	2205	22861	43857	52.13%	34.77%	39	39
8	嘉義縣水上鄉	2018-11-24T22:21:46+08:00	7438	2615	10053	1143	11196	20839	53.73%	35.69%	24	39
8	嘉義縣水上鄉	2018-11-24T22:25:25+08:00	7669	2689	10358	1175	11533	21409	53.87%	35.82%	25	39
8	嘉義縣水上鄉	2018-11-25T00:17:08+08:00	14177	5040	19217	2049	21266	40616	52.36%	34.9%	37	39
8	嘉義縣水上鄉	2018-11-25T06:22:45+08:00	15249	5407	20656	2205	22861	43857	52.13%	34.77%	39	39
8	嘉義縣水上鄉	2018-11-24T22:14:49+08:00	7438	2615	10053	1143	11196	20839	53.73%	35.69%	24	39
8	嘉義縣水上鄉	2018-11-24T23:18:27+08:00	10470	3674	14144	1565	15709	29471	53.3%	35.53%	31	39
8	嘉義縣水上鄉	2018-11-24T22:18:19+08:00	7438	2615	10053	1143	11196	20839	53.73%	35.69%	24	39
8	嘉義縣水上鄉	2018-11-24T23:58:42+08:00	13111	4686	17797	1937	19734	37360	52.82%	35.09%	35	39
8	嘉義縣水上鄉	2018-11-25T06:27:55+08:00	15249	5407	20656	2205	22861	43857	52.13%	34.77%	39	39
8	嘉義縣水上鄉	2018-11-24T23:26:07+08:00	11809	4224	16033	1776	17809	33425	53.28%	35.33%	33	39
8	嘉義縣水上鄉	2018-11-25T00:12:45+08:00	14177	5040	19217	2049	21266	40616	52.36%	34.9%	37	39
8	嘉義縣水上鄉	2018-11-25T01:05:59+08:00	15249	5407	20656	2205	22861	43857	52.13%	34.77%	39	39
8	嘉義縣水上鄉	2018-11-24T23:14:41+08:00	9700	3409	13109	1482	14591	27263	53.52%	35.58%	30	39
8	嘉義縣水上鄉	2018-11-24T23:50:15+08:00	13111	4686	17797	1937	19734	37360	52.82%	35.09%	35	39
8	金門縣烈嶼鄉	2018-11-24T23:26:10+08:00	3412	556	3968	279	4247	11676	36.37%	29.22%	8	8
8	金門縣烈嶼鄉	2018-11-24T23:10:59+08:00	3412	556	3968	279	4247	11676	36.37%	29.22%	8	8
8	金門縣烈嶼鄉	2018-11-24T22:49:27+08:00	3412	556	3968	279	4247	11676	36.37%	29.22%	8	8
8	金門縣烈嶼鄉	2018-11-24T23:33:53+08:00	3412	556	3968	279	4247	11676	36.37%	29.22%	8	8
8	金門縣烈嶼鄉	2018-11-24T22:12:06+08:00	3412	556	3968	279	4247	11676	36.37%	29.22%	8	8
8	金門縣烈嶼鄉	2018-11-24T22:56:39+08:00	3412	556	3968	279	4247	11676	36.37%	29.22%	8	8
8	金門縣烈嶼鄉	2018-11-24T23:22:26+08:00	3412	556	3968	279	4247	11676	36.37%	29.22%	8	8
8	金門縣烈嶼鄉	2018-11-24T22:28:43+08:00	3412	556	3968	279	4247	11676	36.37%	29.22%	8	8
8	金門縣烈嶼鄉	2018-11-24T23:18:30+08:00	3412	556	3968	279	4247	11676	36.37%	29.22%	8	8
8	金門縣烈嶼鄉	2018-11-24T23:37:52+08:00	3412	556	3968	279	4247	11676	36.37%	29.22%	8	8
8	金門縣烈嶼鄉	2018-11-25T00:17:11+08:00	3412	556	3968	279	4247	11676	36.37%	29.22%	8	8
8	金門縣烈嶼鄉	2018-11-24T22:32:21+08:00	3412	556	3968	279	4247	11676	36.37%	29.22%	8	8
8	金門縣烈嶼鄉	2018-11-24T22:21:50+08:00	3412	556	3968	279	4247	11676	36.37%	29.22%	8	8
8	金門縣烈嶼鄉	2018-11-25T04:01:33+08:00	3412	556	3968	279	4247	11676	36.37%	29.22%	8	8
8	金門縣烈嶼鄉	2018-11-24T23:46:07+08:00	3412	556	3968	279	4247	11676	36.37%	29.22%	8	8
8	金門縣烈嶼鄉	2018-11-24T22:53:18+08:00	3412	556	3968	279	4247	11676	36.37%	29.22%	8	8
8	金門縣烈嶼鄉	2018-11-25T00:08:08+08:00	3412	556	3968	279	4247	11676	36.37%	29.22%	8	8
8	金門縣烈嶼鄉	2018-11-24T22:25:28+08:00	3412	556	3968	279	4247	11676	36.37%	29.22%	8	8
8	金門縣烈嶼鄉	2018-11-24T23:00:20+08:00	3412	556	3968	279	4247	11676	36.37%	29.22%	8	8
8	金門縣烈嶼鄉	2018-11-25T06:22:48+08:00	3412	556	3968	279	4247	11676	36.37%	29.22%	8	8
8	金門縣烈嶼鄉	2018-11-25T03:48:35+08:00	3412	556	3968	279	4247	11676	36.37%	29.22%	8	8
8	金門縣烈嶼鄉	2018-11-24T23:14:44+08:00	3412	556	3968	279	4247	11676	36.37%	29.22%	8	8
8	金門縣烈嶼鄉	2018-11-25T03:37:33+08:00	3412	556	3968	279	4247	11676	36.37%	29.22%	8	8
8	金門縣烈嶼鄉	2018-11-24T22:18:23+08:00	3412	556	3968	279	4247	11676	36.37%	29.22%	8	8
8	金門縣烈嶼鄉	2018-11-24T23:50:18+08:00	3412	556	3968	279	4247	11676	36.37%	29.22%	8	8
8	金門縣烈嶼鄉	2018-11-24T23:58:46+08:00	3412	556	3968	279	4247	11676	36.37%	29.22%	8	8
8	金門縣烈嶼鄉	2018-11-25T00:12:48+08:00	3412	556	3968	279	4247	11676	36.37%	29.22%	8	8
8	金門縣烈嶼鄉	2018-11-24T23:03:50+08:00	3412	556	3968	279	4247	11676	36.37%	29.22%	8	8
8	金門縣烈嶼鄉	2018-11-24T22:39:12+08:00	3412	556	3968	279	4247	11676	36.37%	29.22%	8	8
8	金門縣烈嶼鄉	2018-11-25T06:27:58+08:00	3412	556	3968	279	4247	11676	36.37%	29.22%	8	8
8	金門縣烈嶼鄉	2018-11-25T06:17:40+08:00	3412	556	3968	279	4247	11676	36.37%	29.22%	8	8
8	金門縣烈嶼鄉	2018-11-24T23:54:31+08:00	3412	556	3968	279	4247	11676	36.37%	29.22%	8	8
8	金門縣烈嶼鄉	2018-11-24T22:14:52+08:00	3412	556	3968	279	4247	11676	36.37%	29.22%	8	8
8	金門縣烈嶼鄉	2018-11-25T01:24:28+08:00	3412	556	3968	279	4247	11676	36.37%	29.22%	8	8
8	金門縣烈嶼鄉	2018-11-25T03:54:45+08:00	3412	556	3968	279	4247	11676	36.37%	29.22%	8	8
8	金門縣烈嶼鄉	2018-11-24T23:07:22+08:00	3412	556	3968	279	4247	11676	36.37%	29.22%	8	8
8	金門縣烈嶼鄉	2018-11-25T06:12:40+08:00	3412	556	3968	279	4247	11676	36.37%	29.22%	8	8
8	金門縣烈嶼鄉	2018-11-24T23:29:50+08:00	3412	556	3968	279	4247	11676	36.37%	29.22%	8	8
8	金門縣烈嶼鄉	2018-11-24T23:42:05+08:00	3412	556	3968	279	4247	11676	36.37%	29.22%	8	8
8	金門縣烈嶼鄉	2018-11-25T01:06:03+08:00	3412	556	3968	279	4247	11676	36.37%	29.22%	8	8
8	金門縣烈嶼鄉	2018-11-25T01:11:11+08:00	3412	556	3968	279	4247	11676	36.37%	29.22%	8	8
8	金門縣烈嶼鄉	2018-11-25T00:21:47+08:00	3412	556	3968	279	4247	11676	36.37%	29.22%	8	8
8	金門縣烈嶼鄉	2018-11-25T03:42:52+08:00	3412	556	3968	279	4247	11676	36.37%	29.22%	8	8
8	金門縣烈嶼鄉	2018-11-25T06:07:26+08:00	3412	556	3968	279	4247	11676	36.37%	29.22%	8	8
8	金門縣烈嶼鄉	2018-11-24T22:40:22+08:00	3412	556	3968	279	4247	11676	36.37%	29.22%	8	8
8	金門縣烈嶼鄉	2018-11-25T00:56:17+08:00	3412	556	3968	279	4247	11676	36.37%	29.22%	8	8
8	金門縣烈嶼鄉	2018-11-24T22:35:48+08:00	3412	556	3968	279	4247	11676	36.37%	29.22%	8	8
8	金門縣烈嶼鄉	2018-11-24T22:43:54+08:00	3412	556	3968	279	4247	11676	36.37%	29.22%	8	8
8	金門縣烈嶼鄉	2018-11-25T03:31:03+08:00	3412	556	3968	279	4247	11676	36.37%	29.22%	8	8
8	金門縣烈嶼鄉	2018-11-25T01:01:05+08:00	3412	556	3968	279	4247	11676	36.37%	29.22%	8	8
8	金門縣烈嶼鄉	2018-11-25T01:16:26+08:00	3412	556	3968	279	4247	11676	36.37%	29.22%	8	8
8	金門縣烈嶼鄉	2018-11-25T00:03:39+08:00	3412	556	3968	279	4247	11676	36.37%	29.22%	8	8
8	嘉義縣朴子市	2018-11-24T22:39:08+08:00	8727	2866	11593	1569	13162	25353	51.91%	34.42%	27	35
8	嘉義縣朴子市	2018-11-24T23:07:18+08:00	9547	3093	12640	1663	14303	28252	50.63%	33.79%	29	35
8	嘉義縣朴子市	2018-11-24T22:56:36+08:00	9547	3093	12640	1663	14303	28252	50.63%	33.79%	29	35
8	嘉義縣朴子市	2018-11-25T01:24:24+08:00	12009	3835	15844	2053	17897	35191	50.86%	34.13%	35	35
8	嘉義縣朴子市	2018-11-25T03:54:40+08:00	12009	3835	15844	2053	17897	35191	50.86%	34.13%	35	35
8	嘉義縣朴子市	2018-11-25T06:17:36+08:00	12009	3835	15844	2053	17897	35191	50.86%	34.13%	35	35
8	嘉義縣朴子市	2018-11-25T03:37:29+08:00	12009	3835	15844	2053	17897	35191	50.86%	34.13%	35	35
8	嘉義縣朴子市	2018-11-25T03:30:59+08:00	12009	3835	15844	2053	17897	35191	50.86%	34.13%	35	35
8	嘉義縣朴子市	2018-11-24T22:32:18+08:00	8126	2688	10814	1492	12306	23857	51.58%	34.06%	26	35
8	嘉義縣朴子市	2018-11-24T23:42:01+08:00	10904	3496	14400	1897	16297	31914	51.07%	34.17%	32	35
8	嘉義縣朴子市	2018-11-25T03:48:29+08:00	12009	3835	15844	2053	17897	35191	50.86%	34.13%	35	35
8	嘉義縣朴子市	2018-11-25T06:07:22+08:00	12009	3835	15844	2053	17897	35191	50.86%	34.13%	35	35
8	嘉義縣朴子市	2018-11-25T00:21:44+08:00	12009	3835	15844	2053	17897	35191	50.86%	34.13%	35	35
8	嘉義縣朴子市	2018-11-24T23:29:46+08:00	10535	3394	13929	1821	15750	30974	50.85%	34.01%	31	35
8	嘉義縣朴子市	2018-11-24T22:40:18+08:00	8999	2942	11941	1609	13550	26581	50.98%	33.86%	28	35
8	嘉義縣朴子市	2018-11-25T04:01:29+08:00	12009	3835	15844	2053	17897	35191	50.86%	34.13%	35	35
8	嘉義縣朴子市	2018-11-24T23:00:16+08:00	9547	3093	12640	1663	14303	28252	50.63%	33.79%	29	35
8	嘉義縣朴子市	2018-11-25T01:11:07+08:00	12009	3835	15844	2053	17897	35191	50.86%	34.13%	35	35
8	嘉義縣朴子市	2018-11-24T23:37:48+08:00	10904	3496	14400	1897	16297	31914	51.07%	34.17%	32	35
8	嘉義縣朴子市	2018-11-24T22:43:50+08:00	8999	2942	11941	1609	13550	26581	50.98%	33.86%	28	35
8	嘉義縣朴子市	2018-11-25T00:56:13+08:00	12009	3835	15844	2053	17897	35191	50.86%	34.13%	35	35
8	嘉義縣朴子市	2018-11-24T23:54:27+08:00	11410	3661	15071	1984	17055	33712	50.59%	33.85%	34	35
8	嘉義縣朴子市	2018-11-25T01:16:22+08:00	12009	3835	15844	2053	17897	35191	50.86%	34.13%	35	35
8	嘉義縣朴子市	2018-11-25T00:03:34+08:00	11410	3661	15071	1984	17055	33712	50.59%	33.85%	34	35
8	嘉義縣朴子市	2018-11-24T22:35:44+08:00	8126	2688	10814	1492	12306	23857	51.58%	34.06%	26	35
8	嘉義縣朴子市	2018-11-25T01:01:01+08:00	12009	3835	15844	2053	17897	35191	50.86%	34.13%	35	35
8	嘉義縣朴子市	2018-11-24T23:22:23+08:00	10535	3394	13929	1821	15750	30974	50.85%	34.01%	31	35
8	嘉義縣朴子市	2018-11-24T22:49:24+08:00	9547	3093	12640	1663	14303	28252	50.63%	33.79%	29	35
8	嘉義縣朴子市	2018-11-24T23:03:47+08:00	9547	3093	12640	1663	14303	28252	50.63%	33.79%	29	35
8	嘉義縣朴子市	2018-11-24T22:28:40+08:00	8126	2688	10814	1492	12306	23857	51.58%	34.06%	26	35
8	嘉義縣朴子市	2018-11-24T23:10:55+08:00	10535	3394	13929	1821	15750	30974	50.85%	34.01%	31	35
8	嘉義縣朴子市	2018-11-24T23:33:50+08:00	10535	3394	13929	1821	15750	30974	50.85%	34.01%	31	35
8	嘉義縣朴子市	2018-11-24T22:12:02+08:00	6532	2175	8707	1236	9943	19489	51.02%	33.52%	22	35
8	嘉義縣朴子市	2018-11-25T00:08:04+08:00	11410	3661	15071	1984	17055	33712	50.59%	33.85%	34	35
8	嘉義縣朴子市	2018-11-24T22:53:14+08:00	9547	3093	12640	1663	14303	28252	50.63%	33.79%	29	35
8	嘉義縣朴子市	2018-11-25T03:42:48+08:00	12009	3835	15844	2053	17897	35191	50.86%	34.13%	35	35
8	嘉義縣朴子市	2018-11-24T23:46:03+08:00	10904	3496	14400	1897	16297	31914	51.07%	34.17%	32	35
8	嘉義縣朴子市	2018-11-25T00:17:07+08:00	12009	3835	15844	2053	17897	35191	50.86%	34.13%	35	35
8	嘉義縣朴子市	2018-11-24T22:21:46+08:00	7822	2578	10400	1421	11821	22819	51.8%	34.28%	25	35
8	嘉義縣朴子市	2018-11-24T22:25:25+08:00	7822	2578	10400	1421	11821	22819	51.8%	34.28%	25	35
8	嘉義縣朴子市	2018-11-25T06:22:44+08:00	12009	3835	15844	2053	17897	35191	50.86%	34.13%	35	35
8	嘉義縣朴子市	2018-11-25T06:12:36+08:00	12009	3835	15844	2053	17897	35191	50.86%	34.13%	35	35
8	嘉義縣朴子市	2018-11-25T00:12:44+08:00	11410	3661	15071	1984	17055	33712	50.59%	33.85%	34	35
8	嘉義縣朴子市	2018-11-24T23:26:06+08:00	10535	3394	13929	1821	15750	30974	50.85%	34.01%	31	35
8	嘉義縣朴子市	2018-11-24T23:18:27+08:00	10535	3394	13929	1821	15750	30974	50.85%	34.01%	31	35
8	嘉義縣朴子市	2018-11-24T23:50:14+08:00	10988	3528	14516	1927	16443	32165	51.12%	34.16%	33	35
8	嘉義縣朴子市	2018-11-24T23:14:40+08:00	10535	3394	13929	1821	15750	30974	50.85%	34.01%	31	35
8	嘉義縣朴子市	2018-11-24T22:18:19+08:00	7822	2578	10400	1421	11821	22819	51.8%	34.28%	25	35
8	嘉義縣朴子市	2018-11-24T23:58:42+08:00	11410	3661	15071	1984	17055	33712	50.59%	33.85%	34	35
8	嘉義縣朴子市	2018-11-25T06:27:55+08:00	12009	3835	15844	2053	17897	35191	50.86%	34.13%	35	35
8	嘉義縣朴子市	2018-11-24T22:14:48+08:00	7524	2495	10019	1358	11377	22009	51.69%	34.19%	24	35
8	嘉義縣朴子市	2018-11-25T01:05:59+08:00	12009	3835	15844	2053	17897	35191	50.86%	34.13%	35	35
8	南投縣集集鎮	2018-11-25T01:24:23+08:00	4010	1023	5033	502	5535	9611	57.59%	41.72%	13	13
8	南投縣集集鎮	2018-11-24T22:39:07+08:00	3468	900	4368	454	4822	8417	57.29%	41.2%	12	13
8	南投縣集集鎮	2018-11-24T23:07:17+08:00	3468	900	4368	454	4822	8417	57.29%	41.2%	12	13
8	南投縣集集鎮	2018-11-24T22:12:01+08:00	2834	739	3573	362	3935	6935	56.74%	40.87%	10	13
8	南投縣集集鎮	2018-11-25T03:37:27+08:00	4010	1023	5033	502	5535	9611	57.59%	41.72%	13	13
8	南投縣集集鎮	2018-11-24T22:32:17+08:00	3188	809	3997	423	4420	7708	57.34%	41.36%	11	13
8	南投縣集集鎮	2018-11-25T03:30:57+08:00	4010	1023	5033	502	5535	9611	57.59%	41.72%	13	13
8	南投縣集集鎮	2018-11-25T03:48:28+08:00	4010	1023	5033	502	5535	9611	57.59%	41.72%	13	13
8	南投縣集集鎮	2018-11-24T23:42:01+08:00	3468	900	4368	454	4822	8417	57.29%	41.2%	12	13
8	南投縣集集鎮	2018-11-25T04:01:28+08:00	4010	1023	5033	502	5535	9611	57.59%	41.72%	13	13
8	南投縣集集鎮	2018-11-25T00:21:43+08:00	4010	1023	5033	502	5535	9611	57.59%	41.72%	13	13
8	南投縣集集鎮	2018-11-24T22:21:44+08:00	3188	809	3997	423	4420	7708	57.34%	41.36%	11	13
8	南投縣集集鎮	2018-11-24T23:00:16+08:00	3468	900	4368	454	4822	8417	57.29%	41.2%	12	13
8	南投縣集集鎮	2018-11-24T22:40:17+08:00	3468	900	4368	454	4822	8417	57.29%	41.2%	12	13
8	南投縣集集鎮	2018-11-25T06:12:35+08:00	4010	1023	5033	502	5535	9611	57.59%	41.72%	13	13
8	南投縣集集鎮	2018-11-25T00:03:32+08:00	4010	1023	5033	502	5535	9611	57.59%	41.72%	13	13
8	南投縣集集鎮	2018-11-25T03:54:39+08:00	4010	1023	5033	502	5535	9611	57.59%	41.72%	13	13
8	南投縣集集鎮	2018-11-25T01:01:00+08:00	4010	1023	5033	502	5535	9611	57.59%	41.72%	13	13
8	南投縣集集鎮	2018-11-24T23:33:49+08:00	3468	900	4368	454	4822	8417	57.29%	41.2%	12	13
8	南投縣集集鎮	2018-11-24T23:26:05+08:00	3468	900	4368	454	4822	8417	57.29%	41.2%	12	13
8	南投縣集集鎮	2018-11-24T23:37:47+08:00	3468	900	4368	454	4822	8417	57.29%	41.2%	12	13
8	南投縣集集鎮	2018-11-24T22:35:43+08:00	3188	809	3997	423	4420	7708	57.34%	41.36%	11	13
8	南投縣集集鎮	2018-11-24T23:54:26+08:00	4010	1023	5033	502	5535	9611	57.59%	41.72%	13	13
8	南投縣集集鎮	2018-11-24T23:58:41+08:00	4010	1023	5033	502	5535	9611	57.59%	41.72%	13	13
8	南投縣集集鎮	2018-11-25T00:56:12+08:00	4010	1023	5033	502	5535	9611	57.59%	41.72%	13	13
8	南投縣集集鎮	2018-11-24T22:56:35+08:00	3468	900	4368	454	4822	8417	57.29%	41.2%	12	13
8	南投縣集集鎮	2018-11-24T23:14:39+08:00	3468	900	4368	454	4822	8417	57.29%	41.2%	12	13
8	南投縣集集鎮	2018-11-24T23:22:22+08:00	3468	900	4368	454	4822	8417	57.29%	41.2%	12	13
8	南投縣集集鎮	2018-11-25T06:17:34+08:00	4010	1023	5033	502	5535	9611	57.59%	41.72%	13	13
8	南投縣集集鎮	2018-11-24T22:43:49+08:00	3468	900	4368	454	4822	8417	57.29%	41.2%	12	13
8	南投縣集集鎮	2018-11-24T23:03:46+08:00	3468	900	4368	454	4822	8417	57.29%	41.2%	12	13
8	南投縣集集鎮	2018-11-24T23:10:55+08:00	3468	900	4368	454	4822	8417	57.29%	41.2%	12	13
8	南投縣集集鎮	2018-11-24T22:49:22+08:00	3468	900	4368	454	4822	8417	57.29%	41.2%	12	13
8	南投縣集集鎮	2018-11-25T00:08:03+08:00	4010	1023	5033	502	5535	9611	57.59%	41.72%	13	13
8	南投縣集集鎮	2018-11-24T22:53:13+08:00	3468	900	4368	454	4822	8417	57.29%	41.2%	12	13
8	南投縣集集鎮	2018-11-24T23:46:02+08:00	3468	900	4368	454	4822	8417	57.29%	41.2%	12	13
8	南投縣集集鎮	2018-11-25T03:42:46+08:00	4010	1023	5033	502	5535	9611	57.59%	41.72%	13	13
8	南投縣集集鎮	2018-11-25T01:11:05+08:00	4010	1023	5033	502	5535	9611	57.59%	41.72%	13	13
8	南投縣集集鎮	2018-11-24T23:29:45+08:00	3468	900	4368	454	4822	8417	57.29%	41.2%	12	13
8	南投縣集集鎮	2018-11-25T06:07:21+08:00	4010	1023	5033	502	5535	9611	57.59%	41.72%	13	13
8	南投縣集集鎮	2018-11-25T06:22:43+08:00	4010	1023	5033	502	5535	9611	57.59%	41.72%	13	13
8	南投縣集集鎮	2018-11-25T00:17:06+08:00	4010	1023	5033	502	5535	9611	57.59%	41.72%	13	13
8	南投縣集集鎮	2018-11-24T22:25:23+08:00	3188	809	3997	423	4420	7708	57.34%	41.36%	11	13
8	南投縣集集鎮	2018-11-25T00:12:43+08:00	4010	1023	5033	502	5535	9611	57.59%	41.72%	13	13
8	南投縣集集鎮	2018-11-24T22:14:47+08:00	2834	739	3573	362	3935	6935	56.74%	40.87%	10	13
8	南投縣集集鎮	2018-11-24T22:18:18+08:00	3188	809	3997	423	4420	7708	57.34%	41.36%	11	13
8	南投縣集集鎮	2018-11-25T06:27:54+08:00	4010	1023	5033	502	5535	9611	57.59%	41.72%	13	13
8	南投縣集集鎮	2018-11-24T23:50:13+08:00	4010	1023	5033	502	5535	9611	57.59%	41.72%	13	13
8	南投縣集集鎮	2018-11-25T01:16:20+08:00	4010	1023	5033	502	5535	9611	57.59%	41.72%	13	13
8	南投縣集集鎮	2018-11-25T01:05:57+08:00	4010	1023	5033	502	5535	9611	57.59%	41.72%	13	13
8	南投縣集集鎮	2018-11-24T22:28:39+08:00	3188	809	3997	423	4420	7708	57.34%	41.36%	11	13
8	南投縣集集鎮	2018-11-24T23:18:26+08:00	3468	900	4368	454	4822	8417	57.29%	41.2%	12	13
8	高雄市小港區	2018-11-24T22:49:20+08:00	39958	12880	52838	3989	56827	98891	57.46%	40.41%	68	89
8	高雄市小港區	2018-11-25T03:37:21+08:00	53331	17489	70820	5365	76185	132733	57.4%	40.18%	89	89
8	高雄市小港區	2018-11-24T23:03:43+08:00	43803	14147	57950	4415	62365	108079	57.7%	40.53%	74	89
8	高雄市小港區	2018-11-24T23:58:37+08:00	50378	16474	66852	4990	71842	124849	57.54%	40.35%	85	89
8	高雄市小港區	2018-11-25T06:17:31+08:00	53331	17489	70820	5365	76185	132733	57.4%	40.18%	89	89
8	高雄市小港區	2018-11-24T23:22:18+08:00	46756	15195	61951	4606	66557	115621	57.56%	40.44%	79	89
8	高雄市小港區	2018-11-25T00:03:29+08:00	50378	16474	66852	4990	71842	124849	57.54%	40.35%	85	89
8	高雄市小港區	2018-11-24T23:14:35+08:00	43803	14147	57950	4415	62365	108079	57.7%	40.53%	74	89
8	高雄市小港區	2018-11-25T00:56:09+08:00	51872	17046	68918	5206	74124	129106	57.41%	40.18%	87	89
8	高雄市小港區	2018-11-25T03:42:43+08:00	53331	17489	70820	5365	76185	132733	57.4%	40.18%	89	89
8	高雄市小港區	2018-11-24T22:53:10+08:00	39958	12880	52838	3989	56827	98891	57.46%	40.41%	68	89
8	高雄市小港區	2018-11-25T00:08:00+08:00	50378	16474	66852	4990	71842	124849	57.54%	40.35%	85	89
8	高雄市小港區	2018-11-25T01:00:56+08:00	51872	17046	68918	5206	74124	129106	57.41%	40.18%	87	89
8	高雄市小港區	2018-11-24T22:25:19+08:00	32905	10524	43429	3399	46828	80033	58.51%	41.11%	56	89
8	高雄市小港區	2018-11-25T06:12:33+08:00	53331	17489	70820	5365	76185	132733	57.4%	40.18%	89	89
8	高雄市小港區	2018-11-25T00:17:03+08:00	51140	16774	67914	5085	72999	126706	57.61%	40.36%	86	89
8	高雄市小港區	2018-11-25T06:22:41+08:00	53331	17489	70820	5365	76185	132733	57.4%	40.18%	89	89
8	高雄市小港區	2018-11-24T23:18:23+08:00	45008	14514	59522	4526	64048	111045	57.68%	40.53%	76	89
8	高雄市小港區	2018-11-24T23:50:10+08:00	50378	16474	66852	4990	71842	124849	57.54%	40.35%	85	89
8	高雄市小港區	2018-11-24T22:18:15+08:00	28328	9194	37522	2973	40495	68740	58.91%	41.21%	49	89
8	高雄市小港區	2018-11-24T22:14:44+08:00	28328	9194	37522	2973	40495	68740	58.91%	41.21%	49	89
8	高雄市小港區	2018-11-25T01:05:54+08:00	51872	17046	68918	5206	74124	129106	57.41%	40.18%	87	89
8	高雄市小港區	2018-11-24T23:54:21+08:00	50378	16474	66852	4990	71842	124849	57.54%	40.35%	85	89
8	高雄市小港區	2018-11-24T23:33:46+08:00	47303	15407	62710	4642	67352	117054	57.54%	40.41%	80	89
8	高雄市小港區	2018-11-25T06:27:51+08:00	53331	17489	70820	5365	76185	132733	57.4%	40.18%	89	89
8	高雄市小港區	2018-11-24T23:26:03+08:00	46756	15195	61951	4606	66557	115621	57.56%	40.44%	79	89
8	高雄市小港區	2018-11-25T03:54:36+08:00	53331	17489	70820	5365	76185	132733	57.4%	40.18%	89	89
8	高雄市小港區	2018-11-25T00:12:41+08:00	51140	16774	67914	5085	72999	126706	57.61%	40.36%	86	89
8	高雄市小港區	2018-11-24T22:56:32+08:00	40671	13068	53739	4048	57787	100454	57.53%	40.49%	69	89
8	高雄市小港區	2018-11-24T22:43:46+08:00	38229	12441	50670	3846	54516	94158	57.9%	40.6%	65	89
8	高雄市小港區	2018-11-25T01:24:19+08:00	52561	17248	69809	5291	75100	130750	57.44%	40.2%	88	89
8	高雄市小港區	2018-11-24T22:39:04+08:00	36991	12048	49039	3695	52734	91307	57.75%	40.51%	63	89
8	高雄市小港區	2018-11-24T23:10:52+08:00	43803	14147	57950	4415	62365	108079	57.7%	40.53%	74	89
8	高雄市小港區	2018-11-24T23:07:14+08:00	43803	14147	57950	4415	62365	108079	57.7%	40.53%	74	89
8	高雄市小港區	2018-11-24T22:32:14+08:00	33559	10735	44294	3440	47734	81910	58.28%	40.97%	57	89
8	高雄市小港區	2018-11-25T03:30:54+08:00	53331	17489	70820	5365	76185	132733	57.4%	40.18%	89	89
8	高雄市小港區	2018-11-25T03:48:24+08:00	53331	17489	70820	5365	76185	132733	57.4%	40.18%	89	89
8	高雄市小港區	2018-11-24T22:40:15+08:00	37592	12241	49833	3779	53612	92650	57.87%	40.57%	64	89
8	高雄市小港區	2018-11-25T00:21:40+08:00	51140	16774	67914	5085	72999	126706	57.61%	40.36%	86	89
8	高雄市小港區	2018-11-24T23:29:42+08:00	46756	15195	61951	4606	66557	115621	57.56%	40.44%	79	89
8	高雄市小港區	2018-11-25T01:11:02+08:00	52561	17248	69809	5291	75100	130750	57.44%	40.2%	88	89
8	高雄市小港區	2018-11-24T23:00:13+08:00	42008	13563	55571	4186	59757	103701	57.62%	40.51%	71	89
8	高雄市小港區	2018-11-24T22:21:41+08:00	31656	10116	41772	3287	45059	76933	58.57%	41.15%	54	89
8	高雄市小港區	2018-11-25T06:07:18+08:00	53331	17489	70820	5365	76185	132733	57.4%	40.18%	89	89
8	高雄市小港區	2018-11-24T22:11:58+08:00	28328	9194	37522	2973	40495	68740	58.91%	41.21%	49	89
8	高雄市小港區	2018-11-25T04:01:24+08:00	53331	17489	70820	5365	76185	132733	57.4%	40.18%	89	89
8	高雄市小港區	2018-11-24T22:28:36+08:00	32905	10524	43429	3399	46828	80033	58.51%	41.11%	56	89
8	高雄市小港區	2018-11-24T23:41:57+08:00	48550	15772	64322	4775	69097	119933	57.61%	40.48%	82	89
8	高雄市小港區	2018-11-24T22:35:41+08:00	35203	11268	46471	3566	50037	86295	57.98%	40.79%	60	89
8	高雄市小港區	2018-11-24T23:37:45+08:00	47853	15527	63380	4675	68055	118293	57.53%	40.45%	81	89
8	高雄市小港區	2018-11-24T23:45:59+08:00	50378	16474	66852	4990	71842	124849	57.54%	40.35%	85	89
8	高雄市小港區	2018-11-25T01:16:17+08:00	52561	17248	69809	5291	75100	130750	57.44%	40.2%	88	89
8	高雄市鹽埕區	2018-11-25T00:56:08+08:00	8031	3161	11192	705	11897	21617	55.04%	37.15%	24	24
8	高雄市鹽埕區	2018-11-24T23:03:43+08:00	8031	3161	11192	705	11897	21617	55.04%	37.15%	24	24
8	高雄市鹽埕區	2018-11-24T23:58:37+08:00	8031	3161	11192	705	11897	21617	55.04%	37.15%	24	24
8	高雄市鹽埕區	2018-11-25T06:17:31+08:00	8031	3161	11192	705	11897	21617	55.04%	37.15%	24	24
8	高雄市鹽埕區	2018-11-24T23:22:18+08:00	8031	3161	11192	705	11897	21617	55.04%	37.15%	24	24
8	高雄市鹽埕區	2018-11-24T22:43:45+08:00	7608	3014	10622	673	11295	20487	55.13%	37.14%	23	24
8	高雄市鹽埕區	2018-11-24T23:14:35+08:00	8031	3161	11192	705	11897	21617	55.04%	37.15%	24	24
8	高雄市鹽埕區	2018-11-25T03:37:20+08:00	8031	3161	11192	705	11897	21617	55.04%	37.15%	24	24
8	高雄市鹽埕區	2018-11-24T22:49:19+08:00	7608	3014	10622	673	11295	20487	55.13%	37.14%	23	24
8	高雄市鹽埕區	2018-11-25T00:03:28+08:00	8031	3161	11192	705	11897	21617	55.04%	37.15%	24	24
8	高雄市鹽埕區	2018-11-25T03:42:43+08:00	8031	3161	11192	705	11897	21617	55.04%	37.15%	24	24
8	高雄市鹽埕區	2018-11-24T22:53:10+08:00	7608	3014	10622	673	11295	20487	55.13%	37.14%	23	24
8	高雄市鹽埕區	2018-11-25T00:08:00+08:00	8031	3161	11192	705	11897	21617	55.04%	37.15%	24	24
8	高雄市鹽埕區	2018-11-25T01:00:56+08:00	8031	3161	11192	705	11897	21617	55.04%	37.15%	24	24
8	高雄市鹽埕區	2018-11-24T22:25:19+08:00	7608	3014	10622	673	11295	20487	55.13%	37.14%	23	24
8	高雄市鹽埕區	2018-11-25T00:17:03+08:00	8031	3161	11192	705	11897	21617	55.04%	37.15%	24	24
8	高雄市鹽埕區	2018-11-25T01:11:01+08:00	8031	3161	11192	705	11897	21617	55.04%	37.15%	24	24
8	高雄市鹽埕區	2018-11-25T06:22:41+08:00	8031	3161	11192	705	11897	21617	55.04%	37.15%	24	24
8	高雄市鹽埕區	2018-11-25T06:12:32+08:00	8031	3161	11192	705	11897	21617	55.04%	37.15%	24	24
8	高雄市鹽埕區	2018-11-24T23:50:10+08:00	8031	3161	11192	705	11897	21617	55.04%	37.15%	24	24
8	高雄市鹽埕區	2018-11-24T22:18:15+08:00	7137	2816	9953	630	10583	19090	55.44%	37.39%	22	24
8	高雄市鹽埕區	2018-11-25T00:12:40+08:00	8031	3161	11192	705	11897	21617	55.04%	37.15%	24	24
8	高雄市鹽埕區	2018-11-24T22:28:35+08:00	7608	3014	10622	673	11295	20487	55.13%	37.14%	23	24
8	高雄市鹽埕區	2018-11-24T23:54:20+08:00	8031	3161	11192	705	11897	21617	55.04%	37.15%	24	24
8	高雄市鹽埕區	2018-11-24T22:14:44+08:00	7137	2816	9953	630	10583	19090	55.44%	37.39%	22	24
8	高雄市鹽埕區	2018-11-25T06:27:50+08:00	8031	3161	11192	705	11897	21617	55.04%	37.15%	24	24
8	高雄市鹽埕區	2018-11-24T23:18:22+08:00	8031	3161	11192	705	11897	21617	55.04%	37.15%	24	24
8	高雄市鹽埕區	2018-11-24T23:26:03+08:00	8031	3161	11192	705	11897	21617	55.04%	37.15%	24	24
8	高雄市鹽埕區	2018-11-25T01:05:53+08:00	8031	3161	11192	705	11897	21617	55.04%	37.15%	24	24
8	高雄市鹽埕區	2018-11-24T22:56:32+08:00	7608	3014	10622	673	11295	20487	55.13%	37.14%	23	24
8	高雄市鹽埕區	2018-11-25T01:24:19+08:00	8031	3161	11192	705	11897	21617	55.04%	37.15%	24	24
8	高雄市鹽埕區	2018-11-24T22:39:04+08:00	7608	3014	10622	673	11295	20487	55.13%	37.14%	23	24
8	高雄市鹽埕區	2018-11-24T23:10:52+08:00	8031	3161	11192	705	11897	21617	55.04%	37.15%	24	24
8	高雄市鹽埕區	2018-11-24T23:07:14+08:00	8031	3161	11192	705	11897	21617	55.04%	37.15%	24	24
8	高雄市鹽埕區	2018-11-25T00:21:39+08:00	8031	3161	11192	705	11897	21617	55.04%	37.15%	24	24
8	高雄市鹽埕區	2018-11-24T22:32:14+08:00	7608	3014	10622	673	11295	20487	55.13%	37.14%	23	24
8	高雄市鹽埕區	2018-11-25T03:30:53+08:00	8031	3161	11192	705	11897	21617	55.04%	37.15%	24	24
8	高雄市鹽埕區	2018-11-25T03:48:24+08:00	8031	3161	11192	705	11897	21617	55.04%	37.15%	24	24
8	高雄市鹽埕區	2018-11-24T23:29:42+08:00	8031	3161	11192	705	11897	21617	55.04%	37.15%	24	24
8	高雄市鹽埕區	2018-11-24T23:00:13+08:00	8031	3161	11192	705	11897	21617	55.04%	37.15%	24	24
8	高雄市鹽埕區	2018-11-24T22:21:41+08:00	7608	3014	10622	673	11295	20487	55.13%	37.14%	23	24
8	高雄市鹽埕區	2018-11-24T22:40:14+08:00	7608	3014	10622	673	11295	20487	55.13%	37.14%	23	24
8	高雄市鹽埕區	2018-11-25T06:07:18+08:00	8031	3161	11192	705	11897	21617	55.04%	37.15%	24	24
8	高雄市鹽埕區	2018-11-24T22:11:58+08:00	7137	2816	9953	630	10583	19090	55.44%	37.39%	22	24
8	高雄市鹽埕區	2018-11-25T04:01:24+08:00	8031	3161	11192	705	11897	21617	55.04%	37.15%	24	24
8	高雄市鹽埕區	2018-11-24T23:41:57+08:00	8031	3161	11192	705	11897	21617	55.04%	37.15%	24	24
8	高雄市鹽埕區	2018-11-24T22:35:40+08:00	7608	3014	10622	673	11295	20487	55.13%	37.14%	23	24
8	高雄市鹽埕區	2018-11-25T03:54:35+08:00	8031	3161	11192	705	11897	21617	55.04%	37.15%	24	24
8	高雄市鹽埕區	2018-11-24T23:33:45+08:00	8031	3161	11192	705	11897	21617	55.04%	37.15%	24	24
8	高雄市鹽埕區	2018-11-24T23:37:44+08:00	8031	3161	11192	705	11897	21617	55.04%	37.15%	24	24
8	高雄市鹽埕區	2018-11-24T23:45:59+08:00	8031	3161	11192	705	11897	21617	55.04%	37.15%	24	24
8	高雄市鹽埕區	2018-11-25T01:16:17+08:00	8031	3161	11192	705	11897	21617	55.04%	37.15%	24	24
8	苗栗縣苑裡鎮	2018-11-24T23:07:16+08:00	14136	4897	19033	1798	20831	36747	56.69%	38.47%	38	40
8	苗栗縣苑裡鎮	2018-11-24T22:12:00+08:00	7929	2696	10625	1089	11714	20472	57.22%	38.73%	24	40
8	苗栗縣苑裡鎮	2018-11-24T22:39:06+08:00	11382	3873	15255	1448	16703	29453	56.71%	38.64%	32	40
8	苗栗縣苑裡鎮	2018-11-24T23:22:20+08:00	14932	5203	20135	1912	22047	38890	56.69%	38.4%	40	40
8	苗栗縣苑裡鎮	2018-11-24T23:58:39+08:00	14932	5203	20135	1912	22047	38890	56.69%	38.4%	40	40
8	苗栗縣苑裡鎮	2018-11-24T23:03:45+08:00	13712	4761	18473	1724	20197	35516	56.87%	38.61%	37	40
8	苗栗縣苑裡鎮	2018-11-24T22:49:21+08:00	12538	4405	16943	1582	18525	32589	56.84%	38.47%	35	40
8	苗栗縣苑裡鎮	2018-11-24T23:46:01+08:00	14932	5203	20135	1912	22047	38890	56.69%	38.4%	40	40
8	苗栗縣苑裡鎮	2018-11-25T03:48:26+08:00	14932	5203	20135	1912	22047	38890	56.69%	38.4%	40	40
8	苗栗縣苑裡鎮	2018-11-25T03:30:56+08:00	14932	5203	20135	1912	22047	38890	56.69%	38.4%	40	40
8	苗栗縣苑裡鎮	2018-11-25T03:42:45+08:00	14932	5203	20135	1912	22047	38890	56.69%	38.4%	40	40
8	苗栗縣苑裡鎮	2018-11-24T22:32:16+08:00	10442	3553	13995	1336	15331	27110	56.55%	38.52%	30	40
8	苗栗縣苑裡鎮	2018-11-25T01:00:58+08:00	14932	5203	20135	1912	22047	38890	56.69%	38.4%	40	40
8	苗栗縣苑裡鎮	2018-11-25T04:01:26+08:00	14932	5203	20135	1912	22047	38890	56.69%	38.4%	40	40
8	苗栗縣苑裡鎮	2018-11-24T22:25:21+08:00	9789	3310	13099	1271	14370	25097	57.26%	39%	28	40
8	苗栗縣苑裡鎮	2018-11-25T06:12:34+08:00	14932	5203	20135	1912	22047	38890	56.69%	38.4%	40	40
8	苗栗縣苑裡鎮	2018-11-24T22:40:16+08:00	11589	4072	15661	1476	17137	30241	56.67%	38.32%	33	40
8	苗栗縣苑裡鎮	2018-11-24T22:21:43+08:00	9238	3132	12370	1227	13597	23751	57.25%	38.9%	27	40
8	苗栗縣苑裡鎮	2018-11-25T00:17:05+08:00	14932	5203	20135	1912	22047	38890	56.69%	38.4%	40	40
8	苗栗縣苑裡鎮	2018-11-24T23:18:24+08:00	14932	5203	20135	1912	22047	38890	56.69%	38.4%	40	40
8	苗栗縣苑裡鎮	2018-11-24T23:37:46+08:00	14932	5203	20135	1912	22047	38890	56.69%	38.4%	40	40
8	苗栗縣苑裡鎮	2018-11-24T22:35:42+08:00	10923	3712	14635	1404	16039	28259	56.76%	38.65%	31	40
8	苗栗縣苑裡鎮	2018-11-25T03:54:37+08:00	14932	5203	20135	1912	22047	38890	56.69%	38.4%	40	40
8	苗栗縣苑裡鎮	2018-11-24T23:33:47+08:00	14932	5203	20135	1912	22047	38890	56.69%	38.4%	40	40
8	苗栗縣苑裡鎮	2018-11-24T23:26:04+08:00	14932	5203	20135	1912	22047	38890	56.69%	38.4%	40	40
8	苗栗縣苑裡鎮	2018-11-24T23:14:37+08:00	14932	5203	20135	1912	22047	38890	56.69%	38.4%	40	40
8	苗栗縣苑裡鎮	2018-11-24T23:10:53+08:00	14467	5036	19503	1851	21354	37620	56.76%	38.46%	39	40
8	苗栗縣苑裡鎮	2018-11-25T06:17:33+08:00	14932	5203	20135	1912	22047	38890	56.69%	38.4%	40	40
8	苗栗縣苑裡鎮	2018-11-24T22:43:47+08:00	12027	4229	16256	1520	17776	31355	56.69%	38.36%	34	40
8	苗栗縣苑裡鎮	2018-11-25T01:24:21+08:00	14932	5203	20135	1912	22047	38890	56.69%	38.4%	40	40
8	苗栗縣苑裡鎮	2018-11-24T22:56:34+08:00	13183	4598	17781	1644	19425	34168	56.85%	38.58%	36	40
8	苗栗縣苑裡鎮	2018-11-25T03:37:24+08:00	14932	5203	20135	1912	22047	38890	56.69%	38.4%	40	40
8	苗栗縣苑裡鎮	2018-11-25T00:08:02+08:00	14932	5203	20135	1912	22047	38890	56.69%	38.4%	40	40
8	苗栗縣苑裡鎮	2018-11-24T22:53:12+08:00	12538	4405	16943	1582	18525	32589	56.84%	38.47%	35	40
8	苗栗縣苑裡鎮	2018-11-25T01:11:03+08:00	14932	5203	20135	1912	22047	38890	56.69%	38.4%	40	40
8	苗栗縣苑裡鎮	2018-11-24T23:29:43+08:00	14932	5203	20135	1912	22047	38890	56.69%	38.4%	40	40
8	苗栗縣苑裡鎮	2018-11-25T00:21:41+08:00	14932	5203	20135	1912	22047	38890	56.69%	38.4%	40	40
8	苗栗縣苑裡鎮	2018-11-25T06:22:42+08:00	14932	5203	20135	1912	22047	38890	56.69%	38.4%	40	40
8	苗栗縣苑裡鎮	2018-11-25T06:07:20+08:00	14932	5203	20135	1912	22047	38890	56.69%	38.4%	40	40
8	苗栗縣苑裡鎮	2018-11-24T23:00:15+08:00	13183	4598	17781	1644	19425	34168	56.85%	38.58%	36	40
8	苗栗縣苑裡鎮	2018-11-25T01:05:56+08:00	14932	5203	20135	1912	22047	38890	56.69%	38.4%	40	40
8	苗栗縣苑裡鎮	2018-11-24T23:54:24+08:00	14932	5203	20135	1912	22047	38890	56.69%	38.4%	40	40
8	苗栗縣苑裡鎮	2018-11-24T23:41:59+08:00	14932	5203	20135	1912	22047	38890	56.69%	38.4%	40	40
8	苗栗縣苑裡鎮	2018-11-25T01:16:18+08:00	14932	5203	20135	1912	22047	38890	56.69%	38.4%	40	40
8	苗栗縣苑裡鎮	2018-11-25T00:03:31+08:00	14932	5203	20135	1912	22047	38890	56.69%	38.4%	40	40
8	苗栗縣苑裡鎮	2018-11-24T22:14:46+08:00	8396	2849	11245	1141	12386	21617	57.3%	38.84%	25	40
8	苗栗縣苑裡鎮	2018-11-25T06:27:52+08:00	14932	5203	20135	1912	22047	38890	56.69%	38.4%	40	40
8	苗栗縣苑裡鎮	2018-11-25T00:56:11+08:00	14932	5203	20135	1912	22047	38890	56.69%	38.4%	40	40
8	苗栗縣苑裡鎮	2018-11-24T22:18:17+08:00	8865	2980	11845	1173	13018	22699	57.35%	39.05%	26	40
8	苗栗縣苑裡鎮	2018-11-25T00:12:42+08:00	14932	5203	20135	1912	22047	38890	56.69%	38.4%	40	40
8	苗栗縣苑裡鎮	2018-11-24T22:28:37+08:00	10442	3553	13995	1336	15331	27110	56.55%	38.52%	30	40
8	苗栗縣苑裡鎮	2018-11-24T23:50:12+08:00	14932	5203	20135	1912	22047	38890	56.69%	38.4%	40	40
8	苗栗縣頭屋鄉	2018-11-25T03:37:26+08:00	4533	1161	5694	392	6086	9390	64.81%	48.27%	12	12
8	苗栗縣頭屋鄉	2018-11-24T23:07:16+08:00	4533	1161	5694	392	6086	9390	64.81%	48.27%	12	12
8	苗栗縣頭屋鄉	2018-11-24T22:12:00+08:00	4533	1161	5694	392	6086	9390	64.81%	48.27%	12	12
8	苗栗縣頭屋鄉	2018-11-24T22:39:06+08:00	4533	1161	5694	392	6086	9390	64.81%	48.27%	12	12
8	苗栗縣頭屋鄉	2018-11-24T23:58:39+08:00	4533	1161	5694	392	6086	9390	64.81%	48.27%	12	12
8	苗栗縣頭屋鄉	2018-11-24T23:03:45+08:00	4533	1161	5694	392	6086	9390	64.81%	48.27%	12	12
8	苗栗縣頭屋鄉	2018-11-24T22:49:21+08:00	4533	1161	5694	392	6086	9390	64.81%	48.27%	12	12
8	苗栗縣頭屋鄉	2018-11-24T23:22:21+08:00	4533	1161	5694	392	6086	9390	64.81%	48.27%	12	12
8	苗栗縣頭屋鄉	2018-11-25T01:24:22+08:00	4533	1161	5694	392	6086	9390	64.81%	48.27%	12	12
8	苗栗縣頭屋鄉	2018-11-24T23:46:01+08:00	4533	1161	5694	392	6086	9390	64.81%	48.27%	12	12
8	苗栗縣頭屋鄉	2018-11-24T23:42:00+08:00	4533	1161	5694	392	6086	9390	64.81%	48.27%	12	12
8	苗栗縣頭屋鄉	2018-11-25T03:30:56+08:00	4533	1161	5694	392	6086	9390	64.81%	48.27%	12	12
8	苗栗縣頭屋鄉	2018-11-25T03:42:45+08:00	4533	1161	5694	392	6086	9390	64.81%	48.27%	12	12
8	苗栗縣頭屋鄉	2018-11-24T22:32:16+08:00	4533	1161	5694	392	6086	9390	64.81%	48.27%	12	12
8	苗栗縣頭屋鄉	2018-11-25T03:48:27+08:00	4533	1161	5694	392	6086	9390	64.81%	48.27%	12	12
8	苗栗縣頭屋鄉	2018-11-25T01:00:58+08:00	4533	1161	5694	392	6086	9390	64.81%	48.27%	12	12
8	苗栗縣頭屋鄉	2018-11-24T22:25:21+08:00	4533	1161	5694	392	6086	9390	64.81%	48.27%	12	12
8	苗栗縣頭屋鄉	2018-11-25T06:12:34+08:00	4533	1161	5694	392	6086	9390	64.81%	48.27%	12	12
8	苗栗縣頭屋鄉	2018-11-24T22:40:16+08:00	4533	1161	5694	392	6086	9390	64.81%	48.27%	12	12
8	苗栗縣頭屋鄉	2018-11-25T04:01:27+08:00	4533	1161	5694	392	6086	9390	64.81%	48.27%	12	12
8	苗栗縣頭屋鄉	2018-11-24T22:21:43+08:00	4533	1161	5694	392	6086	9390	64.81%	48.27%	12	12
8	苗栗縣頭屋鄉	2018-11-25T00:17:05+08:00	4533	1161	5694	392	6086	9390	64.81%	48.27%	12	12
8	苗栗縣頭屋鄉	2018-11-25T00:21:42+08:00	4533	1161	5694	392	6086	9390	64.81%	48.27%	12	12
8	苗栗縣頭屋鄉	2018-11-24T23:37:46+08:00	4533	1161	5694	392	6086	9390	64.81%	48.27%	12	12
8	苗栗縣頭屋鄉	2018-11-24T22:35:42+08:00	4533	1161	5694	392	6086	9390	64.81%	48.27%	12	12
8	苗栗縣頭屋鄉	2018-11-24T23:26:05+08:00	4533	1161	5694	392	6086	9390	64.81%	48.27%	12	12
8	苗栗縣頭屋鄉	2018-11-24T23:18:25+08:00	4533	1161	5694	392	6086	9390	64.81%	48.27%	12	12
8	苗栗縣頭屋鄉	2018-11-24T23:33:48+08:00	4533	1161	5694	392	6086	9390	64.81%	48.27%	12	12
8	苗栗縣頭屋鄉	2018-11-25T03:54:38+08:00	4533	1161	5694	392	6086	9390	64.81%	48.27%	12	12
8	苗栗縣頭屋鄉	2018-11-24T23:10:54+08:00	4533	1161	5694	392	6086	9390	64.81%	48.27%	12	12
8	苗栗縣頭屋鄉	2018-11-24T23:14:37+08:00	4533	1161	5694	392	6086	9390	64.81%	48.27%	12	12
8	苗栗縣頭屋鄉	2018-11-25T06:17:33+08:00	4533	1161	5694	392	6086	9390	64.81%	48.27%	12	12
8	苗栗縣頭屋鄉	2018-11-24T22:43:47+08:00	4533	1161	5694	392	6086	9390	64.81%	48.27%	12	12
8	苗栗縣頭屋鄉	2018-11-24T22:56:34+08:00	4533	1161	5694	392	6086	9390	64.81%	48.27%	12	12
8	苗栗縣頭屋鄉	2018-11-25T00:08:02+08:00	4533	1161	5694	392	6086	9390	64.81%	48.27%	12	12
8	苗栗縣頭屋鄉	2018-11-24T22:53:12+08:00	4533	1161	5694	392	6086	9390	64.81%	48.27%	12	12
8	苗栗縣頭屋鄉	2018-11-25T06:22:43+08:00	4533	1161	5694	392	6086	9390	64.81%	48.27%	12	12
8	苗栗縣頭屋鄉	2018-11-24T23:29:44+08:00	4533	1161	5694	392	6086	9390	64.81%	48.27%	12	12
8	苗栗縣頭屋鄉	2018-11-25T01:11:04+08:00	4533	1161	5694	392	6086	9390	64.81%	48.27%	12	12
8	苗栗縣頭屋鄉	2018-11-25T06:07:20+08:00	4533	1161	5694	392	6086	9390	64.81%	48.27%	12	12
8	苗栗縣頭屋鄉	2018-11-24T23:00:15+08:00	4533	1161	5694	392	6086	9390	64.81%	48.27%	12	12
8	苗栗縣頭屋鄉	2018-11-25T01:05:56+08:00	4533	1161	5694	392	6086	9390	64.81%	48.27%	12	12
8	苗栗縣頭屋鄉	2018-11-25T06:27:53+08:00	4533	1161	5694	392	6086	9390	64.81%	48.27%	12	12
8	苗栗縣頭屋鄉	2018-11-25T00:03:31+08:00	4533	1161	5694	392	6086	9390	64.81%	48.27%	12	12
8	苗栗縣頭屋鄉	2018-11-24T23:54:25+08:00	4533	1161	5694	392	6086	9390	64.81%	48.27%	12	12
8	苗栗縣頭屋鄉	2018-11-24T22:14:46+08:00	4533	1161	5694	392	6086	9390	64.81%	48.27%	12	12
8	苗栗縣頭屋鄉	2018-11-25T00:56:11+08:00	4533	1161	5694	392	6086	9390	64.81%	48.27%	12	12
8	苗栗縣頭屋鄉	2018-11-24T22:18:17+08:00	4533	1161	5694	392	6086	9390	64.81%	48.27%	12	12
8	苗栗縣頭屋鄉	2018-11-25T00:12:42+08:00	4533	1161	5694	392	6086	9390	64.81%	48.27%	12	12
8	苗栗縣頭屋鄉	2018-11-24T22:28:37+08:00	4533	1161	5694	392	6086	9390	64.81%	48.27%	12	12
8	苗栗縣頭屋鄉	2018-11-25T01:16:19+08:00	4533	1161	5694	392	6086	9390	64.81%	48.27%	12	12
8	苗栗縣頭屋鄉	2018-11-24T23:50:12+08:00	4533	1161	5694	392	6086	9390	64.81%	48.27%	12	12
8	澎湖縣馬公市	2018-11-24T23:26:10+08:00	13141	3679	16820	1516	18336	38344	47.82%	34.27%	39	50
8	澎湖縣馬公市	2018-11-24T23:10:59+08:00	11255	3009	14264	1298	15562	32700	47.59%	34.42%	34	50
8	澎湖縣馬公市	2018-11-24T22:49:27+08:00	10788	2867	13655	1235	14890	31307	47.56%	34.46%	33	50
8	澎湖縣馬公市	2018-11-24T23:10:58+08:00	11255	3009	14264	1298	15562	32700	47.59%	34.42%	34	50
8	澎湖縣馬公市	2018-11-24T23:33:53+08:00	14533	4034	18567	1650	20217	42622	47.43%	34.1%	42	50
8	澎湖縣馬公市	2018-11-24T22:56:39+08:00	10788	2867	13655	1235	14890	31307	47.56%	34.46%	33	50
8	澎湖縣馬公市	2018-11-24T23:22:26+08:00	12878	3478	16356	1489	17845	37343	47.79%	34.49%	38	50
8	澎湖縣馬公市	2018-11-24T22:28:43+08:00	9016	2444	11460	1072	12532	26436	47.41%	34.11%	29	50
8	澎湖縣馬公市	2018-11-24T23:18:30+08:00	12878	3478	16356	1489	17845	37343	47.79%	34.49%	38	50
8	澎湖縣馬公市	2018-11-25T00:17:11+08:00	17993	4987	22980	1950	24930	52307	47.66%	34.4%	49	50
8	澎湖縣馬公市	2018-11-24T22:32:21+08:00	9355	2528	11883	1089	12972	27609	46.98%	33.88%	30	50
8	澎湖縣馬公市	2018-11-24T23:46:06+08:00	14533	4034	18567	1650	20217	42622	47.43%	34.1%	42	50
8	澎湖縣馬公市	2018-11-24T22:53:18+08:00	10788	2867	13655	1235	14890	31307	47.56%	34.46%	33	50
8	澎湖縣馬公市	2018-11-25T00:08:08+08:00	16386	4511	20897	1807	22704	47497	47.8%	34.5%	46	50
8	澎湖縣馬公市	2018-11-25T04:01:32+08:00	18487	5114	23601	1997	25598	53655	47.71%	34.46%	50	50
8	澎湖縣馬公市	2018-11-25T03:48:34+08:00	18487	5114	23601	1997	25598	53655	47.71%	34.46%	50	50
8	澎湖縣馬公市	2018-11-24T23:00:19+08:00	10788	2867	13655	1235	14890	31307	47.56%	34.46%	33	50
8	澎湖縣馬公市	2018-11-24T22:25:28+08:00	8620	2309	10929	1017	11946	25221	47.37%	34.18%	28	50
8	澎湖縣馬公市	2018-11-25T06:22:47+08:00	18487	5114	23601	1997	25598	53655	47.71%	34.46%	50	50
8	澎湖縣馬公市	2018-11-24T22:40:21+08:00	10788	2867	13655	1235	14890	31307	47.56%	34.46%	33	50
8	澎湖縣馬公市	2018-11-24T23:29:49+08:00	14003	3894	17897	1581	19478	41122	47.37%	34.05%	41	50
8	澎湖縣馬公市	2018-11-24T23:14:44+08:00	11845	3171	15016	1340	16356	34338	47.63%	34.5%	35	50
8	澎湖縣馬公市	2018-11-24T23:50:17+08:00	14533	4034	18567	1650	20217	42622	47.43%	34.1%	42	50
8	澎湖縣馬公市	2018-11-25T00:12:47+08:00	17528	4877	22405	1894	24299	51023	47.62%	34.35%	48	50
8	澎湖縣馬公市	2018-11-25T03:37:33+08:00	18487	5114	23601	1997	25598	53655	47.71%	34.46%	50	50
8	澎湖縣馬公市	2018-11-24T23:50:18+08:00	14533	4034	18567	1650	20217	42622	47.43%	34.1%	42	50
8	澎湖縣馬公市	2018-11-25T01:16:25+08:00	18487	5114	23601	1997	25598	53655	47.71%	34.46%	50	50
8	澎湖縣馬公市	2018-11-24T23:58:46+08:00	15091	4176	19267	1697	20964	44062	47.58%	34.25%	43	50
8	澎湖縣馬公市	2018-11-24T22:18:22+08:00	7315	1931	9246	847	10093	21430	47.1%	34.13%	25	50
8	澎湖縣馬公市	2018-11-25T00:12:48+08:00	17528	4877	22405	1894	24299	51023	47.62%	34.35%	48	50
8	澎湖縣馬公市	2018-11-24T23:03:50+08:00	11255	3009	14264	1298	15562	32700	47.59%	34.42%	34	50
8	澎湖縣馬公市	2018-11-24T22:39:12+08:00	10191	2715	12906	1180	14086	29753	47.34%	34.25%	32	50
8	澎湖縣馬公市	2018-11-25T06:27:58+08:00	18487	5114	23601	1997	25598	53655	47.71%	34.46%	50	50
8	澎湖縣馬公市	2018-11-25T06:17:40+08:00	18487	5114	23601	1997	25598	53655	47.71%	34.46%	50	50
8	澎湖縣馬公市	2018-11-25T03:54:44+08:00	18487	5114	23601	1997	25598	53655	47.71%	34.46%	50	50
8	澎湖縣馬公市	2018-11-24T22:14:52+08:00	6635	1801	8436	802	9238	19949	46.31%	33.26%	24	50
8	澎湖縣馬公市	2018-11-25T01:24:28+08:00	18487	5114	23601	1997	25598	53655	47.71%	34.46%	50	50
8	澎湖縣馬公市	2018-11-24T23:37:51+08:00	14533	4034	18567	1650	20217	42622	47.43%	34.1%	42	50
8	澎湖縣馬公市	2018-11-24T23:07:22+08:00	11255	3009	14264	1298	15562	32700	47.59%	34.42%	34	50
8	澎湖縣馬公市	2018-11-24T22:12:05+08:00	6202	1720	7922	759	8681	18829	46.1%	32.94%	23	50
8	澎湖縣馬公市	2018-11-24T23:54:30+08:00	14533	4034	18567	1650	20217	42622	47.43%	34.1%	42	50
8	澎湖縣馬公市	2018-11-25T06:12:40+08:00	18487	5114	23601	1997	25598	53655	47.71%	34.46%	50	50
8	澎湖縣馬公市	2018-11-24T23:42:04+08:00	14533	4034	18567	1650	20217	42622	47.43%	34.1%	42	50
8	澎湖縣馬公市	2018-11-24T23:29:50+08:00	14003	3894	17897	1581	19478	41122	47.37%	34.05%	41	50
8	澎湖縣馬公市	2018-11-24T23:42:05+08:00	14533	4034	18567	1650	20217	42622	47.43%	34.1%	42	50
8	澎湖縣馬公市	2018-11-25T01:06:03+08:00	18487	5114	23601	1997	25598	53655	47.71%	34.46%	50	50
8	澎湖縣馬公市	2018-11-25T01:11:11+08:00	18487	5114	23601	1997	25598	53655	47.71%	34.46%	50	50
8	澎湖縣馬公市	2018-11-25T00:21:47+08:00	17993	4987	22980	1950	24930	52307	47.66%	34.4%	49	50
8	澎湖縣馬公市	2018-11-25T03:42:52+08:00	18487	5114	23601	1997	25598	53655	47.71%	34.46%	50	50
8	澎湖縣馬公市	2018-11-25T06:07:26+08:00	18487	5114	23601	1997	25598	53655	47.71%	34.46%	50	50
8	澎湖縣馬公市	2018-11-24T22:21:49+08:00	8180	2159	10339	950	11289	23834	47.37%	34.32%	27	50
8	澎湖縣馬公市	2018-11-24T22:43:53+08:00	10788	2867	13655	1235	14890	31307	47.56%	34.46%	33	50
8	澎湖縣馬公市	2018-11-25T03:31:03+08:00	18487	5114	23601	1997	25598	53655	47.71%	34.46%	50	50
8	澎湖縣馬公市	2018-11-24T22:35:47+08:00	9755	2609	12364	1123	13487	28559	47.23%	34.16%	31	50
8	澎湖縣馬公市	2018-11-25T01:01:05+08:00	18487	5114	23601	1997	25598	53655	47.71%	34.46%	50	50
8	澎湖縣馬公市	2018-11-25T00:56:16+08:00	18487	5114	23601	1997	25598	53655	47.71%	34.46%	50	50
8	澎湖縣馬公市	2018-11-25T03:31:02+08:00	18487	5114	23601	1997	25598	53655	47.71%	34.46%	50	50
8	澎湖縣馬公市	2018-11-25T00:03:39+08:00	16386	4511	20897	1807	22704	47497	47.8%	34.5%	46	50
8	桃園市觀音區	2018-11-25T03:37:17+08:00	19477	5998	25475	1935	27410	55149	49.7%	35.32%	41	41
8	桃園市觀音區	2018-11-24T23:10:50+08:00	17938	5523	23461	1830	25291	50851	49.74%	35.28%	38	41
8	桃園市觀音區	2018-11-24T23:22:16+08:00	19477	5998	25475	1935	27410	55149	49.7%	35.32%	41	41
8	桃園市觀音區	2018-11-25T01:10:58+08:00	19477	5998	25475	1935	27410	55149	49.7%	35.32%	41	41
8	桃園市觀音區	2018-11-25T00:12:37+08:00	19477	5998	25475	1935	27410	55149	49.7%	35.32%	41	41
8	桃園市觀音區	2018-11-24T22:49:17+08:00	15630	5014	20644	1685	22329	44723	49.93%	34.95%	33	41
8	桃園市觀音區	2018-11-24T23:14:32+08:00	18409	5660	24069	1853	25922	52008	49.84%	35.4%	39	41
8	桃園市觀音區	2018-11-24T22:43:43+08:00	15105	4844	19949	1614	21563	43262	49.84%	34.92%	32	41
8	桃園市觀音區	2018-11-24T22:56:30+08:00	17023	5269	22292	1780	24072	48221	49.92%	35.3%	36	41
8	桃園市觀音區	2018-11-25T06:22:37+08:00	19477	5998	25475	1935	27410	55149	49.7%	35.32%	41	41
8	桃園市觀音區	2018-11-25T03:48:21+08:00	19477	5998	25475	1935	27410	55149	49.7%	35.32%	41	41
8	桃園市觀音區	2018-11-25T03:30:51+08:00	19477	5998	25475	1935	27410	55149	49.7%	35.32%	41	41
8	桃園市觀音區	2018-11-24T22:32:11+08:00	13458	4260	17718	1487	19205	38598	49.76%	34.87%	29	41
8	桃園市觀音區	2018-11-25T04:01:21+08:00	19477	5998	25475	1935	27410	55149	49.7%	35.32%	41	41
8	桃園市觀音區	2018-11-24T22:25:17+08:00	13458	4260	17718	1487	19205	38598	49.76%	34.87%	29	41
8	桃園市觀音區	2018-11-25T06:07:15+08:00	19477	5998	25475	1935	27410	55149	49.7%	35.32%	41	41
8	桃園市觀音區	2018-11-24T23:29:40+08:00	19477	5998	25475	1935	27410	55149	49.7%	35.32%	41	41
8	桃園市觀音區	2018-11-24T22:18:12+08:00	10880	3397	14277	1186	15463	31382	49.27%	34.67%	24	41
8	桃園市觀音區	2018-11-24T23:54:18+08:00	19477	5998	25475	1935	27410	55149	49.7%	35.32%	41	41
8	桃園市觀音區	2018-11-25T00:07:57+08:00	19477	5998	25475	1935	27410	55149	49.7%	35.32%	41	41
8	桃園市觀音區	2018-11-25T01:16:14+08:00	19477	5998	25475	1935	27410	55149	49.7%	35.32%	41	41
8	桃園市觀音區	2018-11-24T23:41:55+08:00	19477	5998	25475	1935	27410	55149	49.7%	35.32%	41	41
8	桃園市觀音區	2018-11-24T22:28:33+08:00	13458	4260	17718	1487	19205	38598	49.76%	34.87%	29	41
8	桃園市觀音區	2018-11-24T23:58:34+08:00	19477	5998	25475	1935	27410	55149	49.7%	35.32%	41	41
8	桃園市觀音區	2018-11-24T23:50:08+08:00	19477	5998	25475	1935	27410	55149	49.7%	35.32%	41	41
8	桃園市觀音區	2018-11-25T01:24:16+08:00	19477	5998	25475	1935	27410	55149	49.7%	35.32%	41	41
8	桃園市觀音區	2018-11-24T22:35:38+08:00	13458	4260	17718	1487	19205	38598	49.76%	34.87%	29	41
8	桃園市觀音區	2018-11-24T23:07:12+08:00	17938	5523	23461	1830	25291	50851	49.74%	35.28%	38	41
8	桃園市觀音區	2018-11-24T22:39:02+08:00	14611	4623	19234	1580	20814	41745	49.86%	35%	31	41
8	桃園市觀音區	2018-11-25T00:56:05+08:00	19477	5998	25475	1935	27410	55149	49.7%	35.32%	41	41
8	桃園市觀音區	2018-11-25T06:27:48+08:00	19477	5998	25475	1935	27410	55149	49.7%	35.32%	41	41
8	桃園市觀音區	2018-11-25T00:03:25+08:00	19477	5998	25475	1935	27410	55149	49.7%	35.32%	41	41
8	桃園市觀音區	2018-11-24T23:03:41+08:00	17507	5402	22909	1805	24714	49500	49.93%	35.37%	37	41
8	桃園市觀音區	2018-11-24T23:00:06+08:00	17023	5269	22292	1780	24072	48221	49.92%	35.3%	36	41
8	桃園市觀音區	2018-11-24T22:21:38+08:00	12430	3964	16394	1326	17720	35813	49.48%	34.71%	27	41
8	桃園市觀音區	2018-11-25T03:42:40+08:00	19477	5998	25475	1935	27410	55149	49.7%	35.32%	41	41
8	桃園市觀音區	2018-11-25T00:21:36+08:00	19477	5998	25475	1935	27410	55149	49.7%	35.32%	41	41
8	桃園市觀音區	2018-11-25T01:00:52+08:00	19477	5998	25475	1935	27410	55149	49.7%	35.32%	41	41
8	桃園市觀音區	2018-11-25T06:12:30+08:00	19477	5998	25475	1935	27410	55149	49.7%	35.32%	41	41
8	桃園市觀音區	2018-11-24T22:40:12+08:00	14611	4623	19234	1580	20814	41745	49.86%	35%	31	41
8	桃園市觀音區	2018-11-25T00:17:01+08:00	19477	5998	25475	1935	27410	55149	49.7%	35.32%	41	41
8	桃園市觀音區	2018-11-24T22:53:07+08:00	16152	5165	21317	1740	23057	45985	50.14%	35.12%	34	41
8	桃園市觀音區	2018-11-24T22:11:56+08:00	10230	3194	13424	1144	14568	29513	49.36%	34.66%	23	41
8	桃園市觀音區	2018-11-25T03:54:33+08:00	19477	5998	25475	1935	27410	55149	49.7%	35.32%	41	41
8	桃園市觀音區	2018-11-25T01:05:51+08:00	19477	5998	25475	1935	27410	55149	49.7%	35.32%	41	41
8	桃園市觀音區	2018-11-24T23:33:43+08:00	19477	5998	25475	1935	27410	55149	49.7%	35.32%	41	41
8	桃園市觀音區	2018-11-24T23:18:20+08:00	19033	5855	24888	1896	26784	54037	49.57%	35.22%	40	41
8	桃園市觀音區	2018-11-24T23:37:42+08:00	19477	5998	25475	1935	27410	55149	49.7%	35.32%	41	41
8	桃園市觀音區	2018-11-24T22:14:41+08:00	10230	3194	13424	1144	14568	29513	49.36%	34.66%	23	41
8	桃園市觀音區	2018-11-24T23:26:00+08:00	19477	5998	25475	1935	27410	55149	49.7%	35.32%	41	41
8	桃園市觀音區	2018-11-25T06:17:28+08:00	19477	5998	25475	1935	27410	55149	49.7%	35.32%	41	41
8	桃園市觀音區	2018-11-24T23:45:57+08:00	19477	5998	25475	1935	27410	55149	49.7%	35.32%	41	41
8	桃園市中壢區	2018-11-25T03:37:17+08:00	130138	34651	164789	10142	174931	334402	52.31%	38.92%	210	210
8	桃園市中壢區	2018-11-24T22:49:16+08:00	50557	13888	64445	3982	68427	129908	52.67%	38.92%	89	210
8	桃園市中壢區	2018-11-24T22:39:01+08:00	44186	12230	56416	3542	59958	113524	52.82%	38.92%	79	210
8	桃園市中壢區	2018-11-25T01:10:58+08:00	116087	31030	147117	8992	156109	297123	52.54%	39.07%	189	210
8	桃園市中壢區	2018-11-24T22:43:42+08:00	47325	12949	60274	3725	63999	121650	52.61%	38.9%	84	210
8	桃園市中壢區	2018-11-25T00:12:37+08:00	97161	26041	123202	7384	130586	248285	52.6%	39.13%	161	210
8	桃園市中壢區	2018-11-25T01:24:15+08:00	118493	31742	150235	9179	159414	303481	52.53%	39.04%	193	210
8	桃園市中壢區	2018-11-24T23:14:32+08:00	68171	18462	86633	5241	91874	174125	52.76%	39.15%	117	210
8	桃園市中壢區	2018-11-24T22:56:30+08:00	54528	14929	69457	4246	73703	139686	52.76%	39.04%	95	210
8	桃園市中壢區	2018-11-25T06:22:37+08:00	130138	34651	164789	10142	174931	334402	52.31%	38.92%	210	210
8	桃園市中壢區	2018-11-25T03:30:50+08:00	130138	34651	164789	10142	174931	334402	52.31%	38.92%	210	210
8	桃園市中壢區	2018-11-24T23:00:05+08:00	57806	15518	73324	4460	77784	146877	52.96%	39.36%	100	210
8	桃園市中壢區	2018-11-25T03:48:21+08:00	130138	34651	164789	10142	174931	334402	52.31%	38.92%	210	210
8	桃園市中壢區	2018-11-24T22:32:11+08:00	39870	11220	51090	3206	54296	102918	52.76%	38.74%	72	210
8	桃園市中壢區	2018-11-24T23:29:39+08:00	75259	20444	95703	5800	101503	192616	52.7%	39.07%	128	210
8	桃園市中壢區	2018-11-25T04:01:21+08:00	130138	34651	164789	10142	174931	334402	52.31%	38.92%	210	210
8	桃園市中壢區	2018-11-24T22:25:16+08:00	37638	10527	48165	3036	51201	96997	52.79%	38.8%	68	210
8	桃園市中壢區	2018-11-25T06:07:15+08:00	130138	34651	164789	10142	174931	334402	52.31%	38.92%	210	210
8	桃園市中壢區	2018-11-25T00:07:56+08:00	95223	25540	120763	7250	128013	243505	52.57%	39.11%	158	210
8	桃園市中壢區	2018-11-24T22:28:32+08:00	38985	10952	49937	3131	53068	100474	52.82%	38.8%	70	210
8	桃園市中壢區	2018-11-24T22:18:12+08:00	30801	8739	39540	2542	42082	79582	52.88%	38.7%	57	210
8	桃園市中壢區	2018-11-25T01:16:14+08:00	116679	31142	147821	9028	156849	298565	52.53%	39.08%	190	210
8	桃園市中壢區	2018-11-24T23:54:17+08:00	89108	23994	113102	6834	119936	227467	52.73%	39.17%	149	210
8	桃園市中壢區	2018-11-24T23:41:55+08:00	81682	22133	103815	6274	110089	208621	52.77%	39.15%	138	210
8	桃園市中壢區	2018-11-24T23:58:34+08:00	92668	24836	117504	7077	124581	236734	52.62%	39.14%	154	210
8	桃園市中壢區	2018-11-24T23:22:15+08:00	72513	19687	92200	5581	97781	185661	52.67%	39.06%	124	210
8	桃園市中壢區	2018-11-24T22:35:38+08:00	41743	11743	53486	3367	56853	107608	52.83%	38.79%	75	210
8	桃園市中壢區	2018-11-24T23:07:12+08:00	63258	17106	80364	4892	85256	161051	52.94%	39.28%	109	210
8	桃園市中壢區	2018-11-24T23:03:40+08:00	61908	16748	78656	4817	83473	157868	52.88%	39.22%	107	210
8	桃園市中壢區	2018-11-25T00:56:05+08:00	111190	29639	140829	8517	149346	284422	52.51%	39.09%	182	210
8	桃園市中壢區	2018-11-25T06:27:48+08:00	130138	34651	164789	10142	174931	334402	52.31%	38.92%	210	210
8	桃園市中壢區	2018-11-24T23:50:07+08:00	87585	23641	111226	6751	117977	223842	52.71%	39.13%	147	210
8	桃園市中壢區	2018-11-25T00:03:25+08:00	93942	25229	119171	7187	126358	239951	52.66%	39.15%	156	210
8	桃園市中壢區	2018-11-25T00:21:36+08:00	102339	27262	129601	7812	137413	261367	52.57%	39.16%	168	210
8	桃園市中壢區	2018-11-25T01:00:52+08:00	111855	29868	141723	8597	150320	286152	52.53%	39.09%	183	210
8	桃園市中壢區	2018-11-24T22:21:37+08:00	34538	9650	44188	2763	46951	89287	52.58%	38.68%	63	210
8	桃園市中壢區	2018-11-25T06:12:30+08:00	130138	34651	164789	10142	174931	334402	52.31%	38.92%	210	210
8	桃園市中壢區	2018-11-24T22:53:06+08:00	52611	14420	67031	4138	71169	135229	52.63%	38.91%	92	210
8	桃園市中壢區	2018-11-24T22:40:12+08:00	45912	12603	58515	3644	62159	118018	52.67%	38.9%	82	210
8	桃園市中壢區	2018-11-25T00:17:00+08:00	98614	26385	124999	7473	132472	251631	52.65%	39.19%	163	210
8	桃園市中壢區	2018-11-25T03:42:39+08:00	130138	34651	164789	10142	174931	334402	52.31%	38.92%	210	210
8	桃園市中壢區	2018-11-24T22:11:56+08:00	28474	7987	36461	2342	38803	73301	52.94%	38.85%	53	210
8	桃園市中壢區	2018-11-24T23:33:43+08:00	78533	21310	99843	6045	105888	200895	52.71%	39.09%	133	210
8	桃園市中壢區	2018-11-24T23:18:20+08:00	69954	18948	88902	5373	94275	178876	52.7%	39.11%	120	210
8	桃園市中壢區	2018-11-24T23:37:42+08:00	80400	21776	102176	6178	108354	205558	52.71%	39.11%	136	210
8	桃園市中壢區	2018-11-24T22:14:41+08:00	29739	8375	38114	2466	40580	76622	52.96%	38.81%	55	210
8	桃園市中壢區	2018-11-25T01:05:50+08:00	112539	30016	142555	8668	151223	287706	52.56%	39.12%	184	210
8	桃園市中壢區	2018-11-24T23:26:00+08:00	73846	20070	93916	5688	99604	188996	52.7%	39.07%	126	210
8	桃園市中壢區	2018-11-24T23:10:49+08:00	65583	17849	83432	5043	88475	167379	52.86%	39.18%	113	210
8	桃園市中壢區	2018-11-25T03:54:32+08:00	130138	34651	164789	10142	174931	334402	52.31%	38.92%	210	210
8	桃園市中壢區	2018-11-25T06:17:28+08:00	130138	34651	164789	10142	174931	334402	52.31%	38.92%	210	210
8	桃園市中壢區	2018-11-24T23:45:57+08:00	86274	23299	109573	6638	116211	220717	52.65%	39.09%	145	210
8	臺北市文山區	2018-11-24T23:07:11+08:00	49669	14223	63892	4554	68446	114518	59.77%	43.37%	86	162
8	臺北市文山區	2018-11-25T01:05:49+08:00	89826	25617	115443	8198	123641	206781	59.79%	43.44%	149	162
8	臺北市文山區	2018-11-24T22:49:16+08:00	39998	11566	51564	3711	55275	92291	59.89%	43.34%	70	162
8	臺北市文山區	2018-11-24T22:39:01+08:00	34649	10101	44750	3273	48023	80104	59.95%	43.26%	61	162
8	臺北市文山區	2018-11-24T22:43:42+08:00	36715	10657	47372	3442	50814	84742	59.96%	43.33%	64	162
8	臺北市文山區	2018-11-25T01:24:15+08:00	93228	26516	119744	8471	128215	214279	59.84%	43.51%	154	162
8	臺北市文山區	2018-11-24T23:50:05+08:00	64050	18334	82384	5761	88145	147283	59.85%	43.49%	109	162
8	臺北市文山區	2018-11-25T01:10:56+08:00	91228	25989	117217	8310	125527	209841	59.82%	43.47%	151	162
8	臺北市文山區	2018-11-24T22:39:00+08:00	34649	10101	44750	3273	48023	80104	59.95%	43.26%	61	162
8	臺北市文山區	2018-11-25T03:37:16+08:00	98167	28002	126169	8977	135146	227211	59.48%	43.21%	162	162
8	臺北市文山區	2018-11-25T01:10:57+08:00	91228	25989	117217	8310	125527	209841	59.82%	43.47%	151	162
8	臺北市文山區	2018-11-24T23:50:04+08:00	64050	18334	82384	5761	88145	147283	59.85%	43.49%	109	162
8	臺北市文山區	2018-11-25T01:24:14+08:00	93228	26516	119744	8471	128215	214279	59.84%	43.51%	154	162
8	臺北市文山區	2018-11-25T00:12:36+08:00	74451	21187	95638	6641	102279	171048	59.8%	43.53%	125	162
8	臺北市文山區	2018-11-24T22:32:10+08:00	34050	9909	43959	3210	47169	78688	59.94%	43.27%	60	162
8	臺北市文山區	2018-11-24T23:29:38+08:00	54593	15623	70216	4948	75164	125570	59.86%	43.48%	94	162
8	臺北市文山區	2018-11-25T06:22:36+08:00	98167	28002	126169	8977	135146	227211	59.48%	43.21%	162	162
8	臺北市文山區	2018-11-25T06:12:29+08:00	98167	28002	126169	8977	135146	227211	59.48%	43.21%	162	162
8	臺北市文山區	2018-11-25T00:21:35+08:00	77614	22116	99730	6971	106701	178359	59.82%	43.52%	130	162
8	臺北市文山區	2018-11-24T23:00:03+08:00	43524	12513	56037	4032	60069	100475	59.79%	43.32%	76	162
8	臺北市文山區	2018-11-25T03:48:20+08:00	98167	28002	126169	8977	135146	227211	59.48%	43.21%	162	162
8	臺北市文山區	2018-11-24T23:25:59+08:00	53859	15431	69290	4905	74195	124055	59.81%	43.42%	93	162
8	臺北市文山區	2018-11-24T23:29:39+08:00	54593	15623	70216	4948	75164	125570	59.86%	43.48%	94	162
8	臺北市文山區	2018-11-24T23:00:04+08:00	43524	12513	56037	4032	60069	100475	59.79%	43.32%	76	162
8	臺北市文山區	2018-11-25T01:00:51+08:00	89826	25617	115443	8198	123641	206781	59.79%	43.44%	149	162
8	臺北市文山區	2018-11-25T06:07:14+08:00	98167	28002	126169	8977	135146	227211	59.48%	43.21%	162	162
8	臺北市文山區	2018-11-24T22:53:05+08:00	39998	11566	51564	3711	55275	92291	59.89%	43.34%	70	162
8	臺北市文山區	2018-11-24T22:40:11+08:00	36715	10657	47372	3442	50814	84742	59.96%	43.33%	64	162
8	臺北市文山區	2018-11-24T22:25:16+08:00	34050	9909	43959	3210	47169	78688	59.94%	43.27%	60	162
8	臺北市文山區	2018-11-24T22:11:55+08:00	26869	7937	34806	2550	37356	61757	60.49%	43.51%	48	162
8	臺北市文山區	2018-11-25T04:01:20+08:00	98167	28002	126169	8977	135146	227211	59.48%	43.21%	162	162
8	臺北市文山區	2018-11-25T01:16:12+08:00	91931	26212	118143	8373	126516	211563	59.8%	43.45%	152	162
8	臺北市文山區	2018-11-25T00:07:56+08:00	72417	20606	93023	6491	99514	166489	59.77%	43.5%	122	162
8	臺北市文山區	2018-11-24T23:37:41+08:00	57591	16534	74125	5205	79330	132692	59.79%	43.4%	99	162
8	臺北市文山區	2018-11-24T23:41:54+08:00	58910	16909	75819	5308	81127	135560	59.85%	43.46%	101	162
8	臺北市文山區	2018-11-24T22:28:32+08:00	34050	9909	43959	3210	47169	78688	59.94%	43.27%	60	162
8	臺北市文山區	2018-11-25T01:16:13+08:00	91931	26212	118143	8373	126516	211563	59.8%	43.45%	152	162
8	臺北市文山區	2018-11-25T03:54:31+08:00	98167	28002	126169	8977	135146	227211	59.48%	43.21%	162	162
8	臺北市文山區	2018-11-24T23:54:17+08:00	65872	18828	84700	5908	90608	151489	59.81%	43.48%	112	162
8	臺北市文山區	2018-11-25T00:03:24+08:00	69841	19910	89751	6261	96012	160408	59.85%	43.54%	118	162
8	臺北市文山區	2018-11-24T22:35:36+08:00	34050	9909	43959	3210	47169	78688	59.94%	43.27%	60	162
8	臺北市文山區	2018-11-25T00:16:59+08:00	76263	21781	98044	6865	104909	175489	59.78%	43.46%	128	162
8	臺北市文山區	2018-11-24T23:22:15+08:00	53353	15268	68621	4857	73478	122936	59.77%	43.4%	92	162
8	臺北市文山區	2018-11-24T23:58:33+08:00	69216	19710	88926	6216	95142	158960	59.85%	43.54%	117	162
8	臺北市文山區	2018-11-24T22:14:39+08:00	28462	8422	36884	2675	39559	65689	60.22%	43.33%	51	162
8	臺北市文山區	2018-11-24T22:43:41+08:00	36715	10657	47372	3442	50814	84742	59.96%	43.33%	64	162
8	臺北市文山區	2018-11-24T23:03:40+08:00	48550	13846	62396	4444	66840	111870	59.75%	43.4%	84	162
8	臺北市文山區	2018-11-24T23:14:30+08:00	50814	14553	65367	4639	70006	117176	59.74%	43.37%	88	162
8	臺北市文山區	2018-11-24T23:22:14+08:00	53353	15268	68621	4857	73478	122936	59.77%	43.4%	92	162
8	臺北市文山區	2018-11-24T23:58:32+08:00	69216	19710	88926	6216	95142	158960	59.85%	43.54%	117	162
8	臺北市文山區	2018-11-25T03:37:15+08:00	98167	28002	126169	8977	135146	227211	59.48%	43.21%	162	162
8	臺北市文山區	2018-11-25T00:56:03+08:00	89140	25416	114556	8153	122709	205300	59.77%	43.42%	148	162
8	臺北市文山區	2018-11-25T00:56:04+08:00	89140	25416	114556	8153	122709	205300	59.77%	43.42%	148	162
8	臺北市文山區	2018-11-24T23:14:31+08:00	50814	14553	65367	4639	70006	117176	59.74%	43.37%	88	162
8	臺北市文山區	2018-11-25T06:27:47+08:00	98167	28002	126169	8977	135146	227211	59.48%	43.21%	162	162
8	臺北市文山區	2018-11-24T22:21:36+08:00	33419	9748	43167	3146	46313	77244	59.96%	43.26%	59	162
8	臺北市文山區	2018-11-24T22:21:37+08:00	33419	9748	43167	3146	46313	77244	59.96%	43.26%	59	162
8	臺北市文山區	2018-11-25T00:17:00+08:00	76263	21781	98044	6865	104909	175489	59.78%	43.46%	128	162
8	臺北市文山區	2018-11-25T03:42:37+08:00	98167	28002	126169	8977	135146	227211	59.48%	43.21%	162	162
8	臺北市文山區	2018-11-25T03:30:49+08:00	98167	28002	126169	8977	135146	227211	59.48%	43.21%	162	162
8	臺北市文山區	2018-11-25T03:42:36+08:00	98167	28002	126169	8977	135146	227211	59.48%	43.21%	162	162
8	臺北市文山區	2018-11-24T22:25:15+08:00	34050	9909	43959	3210	47169	78688	59.94%	43.27%	60	162
8	臺北市文山區	2018-11-24T22:18:11+08:00	28984	8586	37570	2723	40293	66960	60.17%	43.29%	52	162
8	臺北市文山區	2018-11-24T22:28:31+08:00	34050	9909	43959	3210	47169	78688	59.94%	43.27%	60	162
8	臺北市文山區	2018-11-24T23:10:48+08:00	49669	14223	63892	4554	68446	114518	59.77%	43.37%	86	162
8	臺北市文山區	2018-11-24T22:14:40+08:00	28462	8422	36884	2675	39559	65689	60.22%	43.33%	51	162
8	臺北市文山區	2018-11-25T06:17:27+08:00	98167	28002	126169	8977	135146	227211	59.48%	43.21%	162	162
8	臺北市文山區	2018-11-24T22:56:29+08:00	41849	12073	53922	3877	57799	96786	59.72%	43.24%	73	162
8	臺北市文山區	2018-11-24T23:45:56+08:00	62845	18035	80880	5659	86539	144522	59.88%	43.48%	107	162
8	臺北市文山區	2018-11-25T00:07:55+08:00	72417	20606	93023	6491	99514	166489	59.77%	43.5%	122	162
8	臺北市文山區	2018-11-24T23:33:42+08:00	55781	15996	71777	5024	76801	128357	59.83%	43.46%	96	162
8	臺北市文山區	2018-11-24T23:10:49+08:00	49669	14223	63892	4554	68446	114518	59.77%	43.37%	86	162
8	臺北市文山區	2018-11-25T03:54:32+08:00	98167	28002	126169	8977	135146	227211	59.48%	43.21%	162	162
8	臺北市文山區	2018-11-24T23:18:19+08:00	51406	14706	66112	4684	70796	118561	59.71%	43.36%	89	162
8	臺南市楠西區	2018-11-25T03:37:19+08:00	2534	745	3279	380	3659	8528	42.91%	29.71%	9	9
8	臺南市楠西區	2018-11-25T00:56:08+08:00	2534	745	3279	380	3659	8528	42.91%	29.71%	9	9
8	臺南市楠西區	2018-11-24T22:49:18+08:00	2534	745	3279	380	3659	8528	42.91%	29.71%	9	9
8	臺南市楠西區	2018-11-24T23:14:34+08:00	2534	745	3279	380	3659	8528	42.91%	29.71%	9	9
8	臺南市楠西區	2018-11-24T23:22:18+08:00	2534	745	3279	380	3659	8528	42.91%	29.71%	9	9
8	臺南市楠西區	2018-11-24T22:43:45+08:00	2534	745	3279	380	3659	8528	42.91%	29.71%	9	9
8	臺南市楠西區	2018-11-24T23:03:42+08:00	2534	745	3279	380	3659	8528	42.91%	29.71%	9	9
8	臺南市楠西區	2018-11-24T23:10:51+08:00	2534	745	3279	380	3659	8528	42.91%	29.71%	9	9
8	臺南市楠西區	2018-11-25T00:03:28+08:00	2534	745	3279	380	3659	8528	42.91%	29.71%	9	9
8	臺南市楠西區	2018-11-25T06:17:30+08:00	2534	745	3279	380	3659	8528	42.91%	29.71%	9	9
8	臺南市楠西區	2018-11-24T23:58:36+08:00	2534	745	3279	380	3659	8528	42.91%	29.71%	9	9
8	臺南市楠西區	2018-11-25T03:42:42+08:00	2534	745	3279	380	3659	8528	42.91%	29.71%	9	9
8	臺南市楠西區	2018-11-24T22:25:19+08:00	2534	745	3279	380	3659	8528	42.91%	29.71%	9	9
8	臺南市楠西區	2018-11-25T06:22:40+08:00	2534	745	3279	380	3659	8528	42.91%	29.71%	9	9
8	臺南市楠西區	2018-11-25T00:17:03+08:00	2534	745	3279	380	3659	8528	42.91%	29.71%	9	9
8	臺南市楠西區	2018-11-25T01:11:01+08:00	2534	745	3279	380	3659	8528	42.91%	29.71%	9	9
8	臺南市楠西區	2018-11-24T23:29:41+08:00	2534	745	3279	380	3659	8528	42.91%	29.71%	9	9
8	臺南市楠西區	2018-11-25T06:12:32+08:00	2534	745	3279	380	3659	8528	42.91%	29.71%	9	9
8	臺南市楠西區	2018-11-24T23:50:10+08:00	2534	745	3279	380	3659	8528	42.91%	29.71%	9	9
8	臺南市楠西區	2018-11-25T00:12:40+08:00	2534	745	3279	380	3659	8528	42.91%	29.71%	9	9
8	臺南市楠西區	2018-11-24T22:28:35+08:00	2534	745	3279	380	3659	8528	42.91%	29.71%	9	9
8	臺南市楠西區	2018-11-24T22:14:43+08:00	2534	745	3279	380	3659	8528	42.91%	29.71%	9	9
8	臺南市楠西區	2018-11-24T23:26:02+08:00	2534	745	3279	380	3659	8528	42.91%	29.71%	9	9
8	臺南市楠西區	2018-11-24T23:54:20+08:00	2534	745	3279	380	3659	8528	42.91%	29.71%	9	9
8	臺南市楠西區	2018-11-25T06:27:50+08:00	2534	745	3279	380	3659	8528	42.91%	29.71%	9	9
8	臺南市楠西區	2018-11-25T00:07:59+08:00	2534	745	3279	380	3659	8528	42.91%	29.71%	9	9
8	臺南市楠西區	2018-11-24T23:18:22+08:00	2534	745	3279	380	3659	8528	42.91%	29.71%	9	9
8	臺南市楠西區	2018-11-25T01:05:53+08:00	2534	745	3279	380	3659	8528	42.91%	29.71%	9	9
8	臺南市楠西區	2018-11-24T22:18:14+08:00	2534	745	3279	380	3659	8528	42.91%	29.71%	9	9
8	臺南市楠西區	2018-11-25T01:24:18+08:00	2534	745	3279	380	3659	8528	42.91%	29.71%	9	9
8	臺南市楠西區	2018-11-24T22:56:32+08:00	2534	745	3279	380	3659	8528	42.91%	29.71%	9	9
8	臺南市楠西區	2018-11-24T22:39:04+08:00	2534	745	3279	380	3659	8528	42.91%	29.71%	9	9
8	臺南市楠西區	2018-11-24T23:07:14+08:00	2534	745	3279	380	3659	8528	42.91%	29.71%	9	9
8	臺南市楠西區	2018-11-24T22:32:13+08:00	2534	745	3279	380	3659	8528	42.91%	29.71%	9	9
8	臺南市楠西區	2018-11-25T03:30:53+08:00	2534	745	3279	380	3659	8528	42.91%	29.71%	9	9
8	臺南市楠西區	2018-11-25T03:48:23+08:00	2534	745	3279	380	3659	8528	42.91%	29.71%	9	9
8	臺南市楠西區	2018-11-25T01:00:55+08:00	2534	745	3279	380	3659	8528	42.91%	29.71%	9	9
8	臺南市楠西區	2018-11-24T23:00:09+08:00	2534	745	3279	380	3659	8528	42.91%	29.71%	9	9
8	臺南市楠西區	2018-11-25T00:21:38+08:00	2534	745	3279	380	3659	8528	42.91%	29.71%	9	9
8	臺南市楠西區	2018-11-25T06:07:17+08:00	2534	745	3279	380	3659	8528	42.91%	29.71%	9	9
8	臺南市楠西區	2018-11-24T22:53:09+08:00	2534	745	3279	380	3659	8528	42.91%	29.71%	9	9
8	臺南市楠西區	2018-11-24T22:40:14+08:00	2534	745	3279	380	3659	8528	42.91%	29.71%	9	9
8	臺南市楠西區	2018-11-24T22:11:58+08:00	2534	745	3279	380	3659	8528	42.91%	29.71%	9	9
8	臺南市楠西區	2018-11-25T04:01:23+08:00	2534	745	3279	380	3659	8528	42.91%	29.71%	9	9
8	臺南市楠西區	2018-11-24T22:21:40+08:00	2534	745	3279	380	3659	8528	42.91%	29.71%	9	9
8	臺南市楠西區	2018-11-24T23:41:57+08:00	2534	745	3279	380	3659	8528	42.91%	29.71%	9	9
8	臺南市楠西區	2018-11-25T01:16:16+08:00	2534	745	3279	380	3659	8528	42.91%	29.71%	9	9
8	臺南市楠西區	2018-11-24T22:35:40+08:00	2534	745	3279	380	3659	8528	42.91%	29.71%	9	9
8	臺南市楠西區	2018-11-25T03:54:35+08:00	2534	745	3279	380	3659	8528	42.91%	29.71%	9	9
8	臺南市楠西區	2018-11-24T23:33:45+08:00	2534	745	3279	380	3659	8528	42.91%	29.71%	9	9
8	臺南市楠西區	2018-11-24T23:37:44+08:00	2534	745	3279	380	3659	8528	42.91%	29.71%	9	9
8	臺南市楠西區	2018-11-24T23:45:59+08:00	2534	745	3279	380	3659	8528	42.91%	29.71%	9	9
8	屏東縣	2018-11-24T23:07:18+08:00	216659	71584	288243	33783	322026	631028	51.03%	34.33%	628	689
8	屏東縣	2018-11-24T22:56:36+08:00	209607	69511	279118	32885	312003	611261	51.04%	34.29%	611	689
8	屏東縣	2018-11-25T06:17:36+08:00	245566	79966	325532	37095	362627	711720	50.95%	34.5%	689	689
8	屏東縣	2018-11-24T23:10:56+08:00	217606	71861	289467	33950	323417	633828	51.03%	34.33%	630	689
8	屏東縣	2018-11-25T03:37:29+08:00	245566	79966	325532	37095	362627	711720	50.95%	34.5%	689	689
8	屏東縣	2018-11-24T22:39:09+08:00	192476	64449	256925	30827	287752	564344	50.99%	34.11%	572	689
8	屏東縣	2018-11-25T01:24:25+08:00	245566	79966	325532	37095	362627	711720	50.95%	34.5%	689	689
8	屏東縣	2018-11-25T03:54:41+08:00	245566	79966	325532	37095	362627	711720	50.95%	34.5%	689	689
8	屏東縣	2018-11-25T03:30:59+08:00	245566	79966	325532	37095	362627	711720	50.95%	34.5%	689	689
8	屏東縣	2018-11-24T22:32:18+08:00	183314	61428	244742	29691	274433	538303	50.98%	34.05%	551	689
8	屏東縣	2018-11-24T23:00:17+08:00	211638	70093	281731	33203	314934	616838	51.06%	34.31%	616	689
8	屏東縣	2018-11-25T00:21:44+08:00	241271	78779	320050	36667	356717	699908	50.97%	34.47%	681	689
8	屏東縣	2018-11-24T23:29:46+08:00	228957	75104	304061	35196	339257	665121	51.01%	34.42%	654	689
8	屏東縣	2018-11-25T06:07:23+08:00	245566	79966	325532	37095	362627	711720	50.95%	34.5%	689	689
8	屏東縣	2018-11-25T04:01:29+08:00	245566	79966	325532	37095	362627	711720	50.95%	34.5%	689	689
8	屏東縣	2018-11-25T01:11:07+08:00	245566	79966	325532	37095	362627	711720	50.95%	34.5%	689	689
8	屏東縣	2018-11-24T22:40:19+08:00	196076	65518	261594	31225	292819	574326	50.98%	34.14%	581	689
8	屏東縣	2018-11-24T22:43:50+08:00	200960	66983	267943	31807	299750	588099	50.97%	34.17%	592	689
8	屏東縣	2018-11-25T00:03:35+08:00	239383	78220	317603	36431	354034	694578	50.97%	34.46%	677	689
8	屏東縣	2018-11-25T00:56:13+08:00	245068	79811	324879	37011	361890	710201	50.96%	34.51%	688	689
8	屏東縣	2018-11-24T23:54:27+08:00	236987	77572	314559	36167	350726	687876	50.99%	34.45%	672	689
8	屏東縣	2018-11-24T22:35:45+08:00	187444	62879	250323	30228	280551	550421	50.97%	34.05%	562	689
8	屏東縣	2018-11-25T01:16:22+08:00	245566	79966	325532	37095	362627	711720	50.95%	34.5%	689	689
8	屏東縣	2018-11-24T23:37:49+08:00	233435	76506	309941	35852	345793	678178	50.99%	34.42%	664	689
8	屏東縣	2018-11-24T23:22:23+08:00	225810	74115	299925	34933	334858	655936	51.05%	34.43%	648	689
8	屏東縣	2018-11-24T22:49:24+08:00	206258	68534	274792	32522	307314	602382	51.02%	34.24%	604	689
8	屏東縣	2018-11-24T22:12:03+08:00	157007	52934	209941	26232	236173	463669	50.94%	33.86%	488	689
8	屏東縣	2018-11-24T23:03:47+08:00	214593	70958	285551	33529	319080	625419	51.02%	34.31%	623	689
8	屏東縣	2018-11-24T22:28:40+08:00	178838	59975	238813	29063	267876	525587	50.97%	34.03%	540	689
8	屏東縣	2018-11-24T23:33:50+08:00	232202	76101	308303	35660	343963	674368	51.01%	34.43%	661	689
8	屏東縣	2018-11-24T23:42:02+08:00	233774	76610	310384	35890	346274	679074	50.99%	34.43%	665	689
8	屏東縣	2018-11-25T00:08:05+08:00	240155	78400	318555	36479	355034	696528	50.97%	34.48%	678	689
8	屏東縣	2018-11-25T03:42:48+08:00	245566	79966	325532	37095	362627	711720	50.95%	34.5%	689	689
8	屏東縣	2018-11-24T22:53:15+08:00	207404	68899	276303	32637	308940	605578	51.02%	34.25%	607	689
8	屏東縣	2018-11-24T23:46:04+08:00	236443	77438	313881	36120	350001	686506	50.98%	34.44%	671	689
8	屏東縣	2018-11-25T06:12:37+08:00	245566	79966	325532	37095	362627	711720	50.95%	34.5%	689	689
8	屏東縣	2018-11-24T22:21:46+08:00	174850	58659	233509	28690	262199	513816	51.03%	34.03%	531	689
8	屏東縣	2018-11-24T22:25:25+08:00	176436	59155	235591	28876	264467	518774	50.98%	34.01%	535	689
8	屏東縣	2018-11-25T00:17:08+08:00	241025	78656	319681	36614	356295	699240	50.95%	34.47%	680	689
8	屏東縣	2018-11-25T06:22:45+08:00	245566	79966	325532	37095	362627	711720	50.95%	34.5%	689	689
8	屏東縣	2018-11-25T03:48:31+08:00	245566	79966	325532	37095	362627	711720	50.95%	34.5%	689	689
8	屏東縣	2018-11-24T22:14:49+08:00	160292	53960	214252	26665	240917	472960	50.94%	33.89%	497	689
8	屏東縣	2018-11-24T22:18:20+08:00	165205	55480	220685	27343	248028	486619	50.97%	33.95%	508	689
8	屏東縣	2018-11-24T23:18:27+08:00	223468	73596	297064	34645	331709	649744	51.05%	34.39%	643	689
8	屏東縣	2018-11-24T23:58:42+08:00	236987	77572	314559	36167	350726	687876	50.99%	34.45%	672	689
8	屏東縣	2018-11-25T06:27:55+08:00	245566	79966	325532	37095	362627	711720	50.95%	34.5%	689	689
8	屏東縣	2018-11-24T23:26:07+08:00	227795	74735	302530	35132	337662	661895	51.01%	34.42%	652	689
8	屏東縣	2018-11-25T00:12:45+08:00	241025	78656	319681	36614	356295	699240	50.95%	34.47%	680	689
8	屏東縣	2018-11-25T01:01:02+08:00	245566	79966	325532	37095	362627	711720	50.95%	34.5%	689	689
8	屏東縣	2018-11-25T01:05:59+08:00	245566	79966	325532	37095	362627	711720	50.95%	34.5%	689	689
8	屏東縣	2018-11-24T23:14:41+08:00	219504	72434	291938	34149	326087	639001	51.03%	34.35%	634	689
8	屏東縣	2018-11-24T23:50:15+08:00	236443	77438	313881	36120	350001	686506	50.98%	34.44%	671	689
8	臺南市北區	2018-11-25T00:56:08+08:00	39802	14099	53901	4263	58164	110906	52.44%	35.89%	81	81
8	臺南市北區	2018-11-24T23:03:43+08:00	33598	11967	45565	3550	49115	93271	52.66%	36.02%	70	81
8	臺南市北區	2018-11-24T23:58:37+08:00	39180	13911	53091	4207	57298	109322	52.41%	35.84%	80	81
8	臺南市北區	2018-11-25T06:17:31+08:00	39802	14099	53901	4263	58164	110906	52.44%	35.89%	81	81
8	臺南市北區	2018-11-24T23:22:18+08:00	38011	13523	51534	4030	55564	106058	52.39%	35.84%	78	81
8	臺南市北區	2018-11-24T22:43:45+08:00	32080	11371	43451	3365	46816	88870	52.68%	36.1%	67	81
8	臺南市北區	2018-11-24T23:14:35+08:00	36018	12772	48790	3791	52581	99541	52.82%	36.18%	74	81
8	臺南市北區	2018-11-25T03:37:20+08:00	39802	14099	53901	4263	58164	110906	52.44%	35.89%	81	81
8	臺南市北區	2018-11-24T22:49:19+08:00	32605	11548	44153	3449	47602	90210	52.77%	36.14%	68	81
8	臺南市北區	2018-11-25T00:03:28+08:00	39180	13911	53091	4207	57298	109322	52.41%	35.84%	80	81
8	臺南市北區	2018-11-25T03:42:42+08:00	39802	14099	53901	4263	58164	110906	52.44%	35.89%	81	81
8	臺南市北區	2018-11-24T22:25:19+08:00	28415	10072	38487	2992	41479	79092	52.44%	35.93%	60	81
8	臺南市北區	2018-11-25T06:22:40+08:00	39802	14099	53901	4263	58164	110906	52.44%	35.89%	81	81
8	臺南市北區	2018-11-25T00:17:03+08:00	39180	13911	53091	4207	57298	109322	52.41%	35.84%	80	81
8	臺南市北區	2018-11-25T01:11:01+08:00	39802	14099	53901	4263	58164	110906	52.44%	35.89%	81	81
8	臺南市北區	2018-11-25T06:12:32+08:00	39802	14099	53901	4263	58164	110906	52.44%	35.89%	81	81
8	臺南市北區	2018-11-24T23:50:10+08:00	39180	13911	53091	4207	57298	109322	52.41%	35.84%	80	81
8	臺南市北區	2018-11-24T22:18:15+08:00	25998	9262	35260	2819	38079	72626	52.43%	35.8%	55	81
8	臺南市北區	2018-11-25T00:12:40+08:00	39180	13911	53091	4207	57298	109322	52.41%	35.84%	80	81
8	臺南市北區	2018-11-24T22:28:35+08:00	29323	10420	39743	3063	42806	81505	52.52%	35.98%	62	81
8	臺南市北區	2018-11-24T22:14:43+08:00	24954	8913	33867	2689	36556	69726	52.43%	35.79%	53	81
8	臺南市北區	2018-11-24T23:26:02+08:00	38011	13523	51534	4030	55564	106058	52.39%	35.84%	78	81
8	臺南市北區	2018-11-24T23:54:20+08:00	39180	13911	53091	4207	57298	109322	52.41%	35.84%	80	81
8	臺南市北區	2018-11-25T06:27:50+08:00	39802	14099	53901	4263	58164	110906	52.44%	35.89%	81	81
8	臺南市北區	2018-11-25T00:07:59+08:00	39180	13911	53091	4207	57298	109322	52.41%	35.84%	80	81
8	臺南市北區	2018-11-24T23:18:22+08:00	36386	12915	49301	3872	53173	101108	52.59%	35.99%	75	81
8	臺南市北區	2018-11-25T01:05:53+08:00	39802	14099	53901	4263	58164	110906	52.44%	35.89%	81	81
8	臺南市北區	2018-11-24T22:56:32+08:00	33177	11822	44999	3502	48501	92082	52.67%	36.03%	69	81
8	臺南市北區	2018-11-25T01:24:19+08:00	39802	14099	53901	4263	58164	110906	52.44%	35.89%	81	81
8	臺南市北區	2018-11-24T22:39:04+08:00	30447	10808	41255	3176	44431	84429	52.63%	36.06%	64	81
8	臺南市北區	2018-11-24T23:10:52+08:00	36018	12772	48790	3791	52581	99541	52.82%	36.18%	74	81
8	臺南市北區	2018-11-24T23:07:14+08:00	34815	12371	47186	3669	50855	96390	52.76%	36.12%	72	81
8	臺南市北區	2018-11-25T00:21:39+08:00	39180	13911	53091	4207	57298	109322	52.41%	35.84%	80	81
8	臺南市北區	2018-11-24T22:32:13+08:00	29923	10639	40562	3128	43690	83167	52.53%	35.98%	63	81
8	臺南市北區	2018-11-25T03:30:53+08:00	39802	14099	53901	4263	58164	110906	52.44%	35.89%	81	81
8	臺南市北區	2018-11-25T03:48:24+08:00	39802	14099	53901	4263	58164	110906	52.44%	35.89%	81	81
8	臺南市北區	2018-11-25T01:00:55+08:00	39802	14099	53901	4263	58164	110906	52.44%	35.89%	81	81
8	臺南市北區	2018-11-24T23:29:42+08:00	38011	13523	51534	4030	55564	106058	52.39%	35.84%	78	81
8	臺南市北區	2018-11-24T23:00:13+08:00	33177	11822	44999	3502	48501	92082	52.67%	36.03%	69	81
8	臺南市北區	2018-11-24T22:21:41+08:00	27556	9748	37304	2911	40215	76540	52.54%	36%	58	81
8	臺南市北區	2018-11-24T22:53:09+08:00	33177	11822	44999	3502	48501	92082	52.67%	36.03%	69	81
8	臺南市北區	2018-11-24T22:40:14+08:00	31089	11008	42097	3223	45320	86024	52.68%	36.14%	65	81
8	臺南市北區	2018-11-25T06:07:18+08:00	39802	14099	53901	4263	58164	110906	52.44%	35.89%	81	81
8	臺南市北區	2018-11-24T22:11:58+08:00	24954	8913	33867	2689	36556	69726	52.43%	35.79%	53	81
8	臺南市北區	2018-11-25T04:01:24+08:00	39802	14099	53901	4263	58164	110906	52.44%	35.89%	81	81
8	臺南市北區	2018-11-24T23:41:57+08:00	38645	13777	52422	4149	56571	107932	52.41%	35.8%	79	81
8	臺南市北區	2018-11-25T01:16:16+08:00	39802	14099	53901	4263	58164	110906	52.44%	35.89%	81	81
8	臺南市北區	2018-11-24T22:35:40+08:00	29923	10639	40562	3128	43690	83167	52.53%	35.98%	63	81
8	臺南市北區	2018-11-25T03:54:35+08:00	39802	14099	53901	4263	58164	110906	52.44%	35.89%	81	81
8	臺南市北區	2018-11-24T23:33:45+08:00	38645	13777	52422	4149	56571	107932	52.41%	35.8%	79	81
8	臺南市北區	2018-11-24T23:37:44+08:00	38645	13777	52422	4149	56571	107932	52.41%	35.8%	79	81
8	臺南市北區	2018-11-24T23:45:59+08:00	39180	13911	53091	4207	57298	109322	52.41%	35.84%	80	81
8	屏東縣鹽埔鄉	2018-11-25T06:17:36+08:00	7560	2514	10074	1294	11368	22402	50.75%	33.75%	20	20
8	屏東縣鹽埔鄉	2018-11-24T23:07:19+08:00	7560	2514	10074	1294	11368	22402	50.75%	33.75%	20	20
8	屏東縣鹽埔鄉	2018-11-24T23:10:56+08:00	7560	2514	10074	1294	11368	22402	50.75%	33.75%	20	20
8	屏東縣鹽埔鄉	2018-11-24T22:39:09+08:00	7175	2400	9575	1202	10777	21418	50.32%	33.5%	19	20
8	屏東縣鹽埔鄉	2018-11-25T01:24:25+08:00	7560	2514	10074	1294	11368	22402	50.75%	33.75%	20	20
8	屏東縣鹽埔鄉	2018-11-24T22:56:37+08:00	7560	2514	10074	1294	11368	22402	50.75%	33.75%	20	20
8	屏東縣鹽埔鄉	2018-11-25T03:54:41+08:00	7560	2514	10074	1294	11368	22402	50.75%	33.75%	20	20
8	屏東縣鹽埔鄉	2018-11-24T22:32:19+08:00	7175	2400	9575	1202	10777	21418	50.32%	33.5%	19	20
8	屏東縣鹽埔鄉	2018-11-24T22:53:16+08:00	7560	2514	10074	1294	11368	22402	50.75%	33.75%	20	20
8	屏東縣鹽埔鄉	2018-11-25T01:06:00+08:00	7560	2514	10074	1294	11368	22402	50.75%	33.75%	20	20
8	屏東縣鹽埔鄉	2018-11-24T22:25:26+08:00	7175	2400	9575	1202	10777	21418	50.32%	33.5%	19	20
8	屏東縣鹽埔鄉	2018-11-24T23:00:17+08:00	7560	2514	10074	1294	11368	22402	50.75%	33.75%	20	20
8	屏東縣鹽埔鄉	2018-11-25T01:11:08+08:00	7560	2514	10074	1294	11368	22402	50.75%	33.75%	20	20
8	屏東縣鹽埔鄉	2018-11-25T06:07:23+08:00	7560	2514	10074	1294	11368	22402	50.75%	33.75%	20	20
8	屏東縣鹽埔鄉	2018-11-24T22:40:19+08:00	7175	2400	9575	1202	10777	21418	50.32%	33.5%	19	20
8	屏東縣鹽埔鄉	2018-11-24T23:29:47+08:00	7560	2514	10074	1294	11368	22402	50.75%	33.75%	20	20
8	屏東縣鹽埔鄉	2018-11-25T00:21:45+08:00	7560	2514	10074	1294	11368	22402	50.75%	33.75%	20	20
8	屏東縣鹽埔鄉	2018-11-25T03:31:00+08:00	7560	2514	10074	1294	11368	22402	50.75%	33.75%	20	20
8	屏東縣鹽埔鄉	2018-11-25T01:16:23+08:00	7560	2514	10074	1294	11368	22402	50.75%	33.75%	20	20
8	屏東縣鹽埔鄉	2018-11-25T00:03:35+08:00	7560	2514	10074	1294	11368	22402	50.75%	33.75%	20	20
8	屏東縣鹽埔鄉	2018-11-25T00:56:14+08:00	7560	2514	10074	1294	11368	22402	50.75%	33.75%	20	20
8	屏東縣鹽埔鄉	2018-11-24T23:54:27+08:00	7560	2514	10074	1294	11368	22402	50.75%	33.75%	20	20
8	屏東縣鹽埔鄉	2018-11-24T22:35:45+08:00	7175	2400	9575	1202	10777	21418	50.32%	33.5%	19	20
8	屏東縣鹽埔鄉	2018-11-24T23:37:49+08:00	7560	2514	10074	1294	11368	22402	50.75%	33.75%	20	20
8	屏東縣鹽埔鄉	2018-11-24T22:43:51+08:00	7560	2514	10074	1294	11368	22402	50.75%	33.75%	20	20
8	屏東縣鹽埔鄉	2018-11-25T06:27:56+08:00	7560	2514	10074	1294	11368	22402	50.75%	33.75%	20	20
8	屏東縣鹽埔鄉	2018-11-24T23:22:24+08:00	7560	2514	10074	1294	11368	22402	50.75%	33.75%	20	20
8	屏東縣鹽埔鄉	2018-11-24T22:28:41+08:00	7175	2400	9575	1202	10777	21418	50.32%	33.5%	19	20
8	屏東縣鹽埔鄉	2018-11-24T22:49:24+08:00	7560	2514	10074	1294	11368	22402	50.75%	33.75%	20	20
8	屏東縣鹽埔鄉	2018-11-24T22:12:03+08:00	6155	2013	8168	1050	9218	18432	50.01%	33.39%	17	20
8	屏東縣鹽埔鄉	2018-11-24T23:33:51+08:00	7560	2514	10074	1294	11368	22402	50.75%	33.75%	20	20
8	屏東縣鹽埔鄉	2018-11-24T23:03:48+08:00	7560	2514	10074	1294	11368	22402	50.75%	33.75%	20	20
8	屏東縣鹽埔鄉	2018-11-25T04:01:30+08:00	7560	2514	10074	1294	11368	22402	50.75%	33.75%	20	20
8	屏東縣鹽埔鄉	2018-11-25T03:42:49+08:00	7560	2514	10074	1294	11368	22402	50.75%	33.75%	20	20
8	屏東縣鹽埔鄉	2018-11-24T23:42:02+08:00	7560	2514	10074	1294	11368	22402	50.75%	33.75%	20	20
8	屏東縣鹽埔鄉	2018-11-25T00:08:05+08:00	7560	2514	10074	1294	11368	22402	50.75%	33.75%	20	20
8	屏東縣鹽埔鄉	2018-11-24T23:46:04+08:00	7560	2514	10074	1294	11368	22402	50.75%	33.75%	20	20
8	屏東縣鹽埔鄉	2018-11-25T00:17:09+08:00	7560	2514	10074	1294	11368	22402	50.75%	33.75%	20	20
8	屏東縣鹽埔鄉	2018-11-25T06:12:37+08:00	7560	2514	10074	1294	11368	22402	50.75%	33.75%	20	20
8	屏東縣鹽埔鄉	2018-11-25T06:22:45+08:00	7560	2514	10074	1294	11368	22402	50.75%	33.75%	20	20
8	屏東縣鹽埔鄉	2018-11-24T22:21:47+08:00	7175	2400	9575	1202	10777	21418	50.32%	33.5%	19	20
8	屏東縣鹽埔鄉	2018-11-25T03:48:31+08:00	7560	2514	10074	1294	11368	22402	50.75%	33.75%	20	20
8	屏東縣鹽埔鄉	2018-11-24T22:14:49+08:00	6155	2013	8168	1050	9218	18432	50.01%	33.39%	17	20
8	屏東縣鹽埔鄉	2018-11-24T22:18:20+08:00	6155	2013	8168	1050	9218	18432	50.01%	33.39%	17	20
8	屏東縣鹽埔鄉	2018-11-25T03:37:30+08:00	7560	2514	10074	1294	11368	22402	50.75%	33.75%	20	20
8	屏東縣鹽埔鄉	2018-11-24T23:58:43+08:00	7560	2514	10074	1294	11368	22402	50.75%	33.75%	20	20
8	屏東縣鹽埔鄉	2018-11-24T23:26:07+08:00	7560	2514	10074	1294	11368	22402	50.75%	33.75%	20	20
8	屏東縣鹽埔鄉	2018-11-25T00:12:45+08:00	7560	2514	10074	1294	11368	22402	50.75%	33.75%	20	20
8	屏東縣鹽埔鄉	2018-11-25T01:01:02+08:00	7560	2514	10074	1294	11368	22402	50.75%	33.75%	20	20
8	屏東縣鹽埔鄉	2018-11-24T23:18:28+08:00	7560	2514	10074	1294	11368	22402	50.75%	33.75%	20	20
8	屏東縣鹽埔鄉	2018-11-24T23:14:41+08:00	7560	2514	10074	1294	11368	22402	50.75%	33.75%	20	20
8	屏東縣鹽埔鄉	2018-11-24T23:50:15+08:00	7560	2514	10074	1294	11368	22402	50.75%	33.75%	20	20
8	宜蘭縣員山鄉	2018-11-24T22:14:51+08:00	7173	2139	9312	1255	10567	20003	52.83%	35.86%	24	31
8	宜蘭縣員山鄉	2018-11-24T23:33:52+08:00	10219	3058	13277	1740	15017	28131	53.38%	36.33%	31	31
8	宜蘭縣員山鄉	2018-11-24T23:10:57+08:00	9304	2792	12096	1557	13653	25693	53.14%	36.21%	29	31
8	宜蘭縣員山鄉	2018-11-25T06:17:38+08:00	10219	3058	13277	1740	15017	28131	53.38%	36.33%	31	31
8	宜蘭縣員山鄉	2018-11-24T22:28:42+08:00	7173	2139	9312	1255	10567	20003	52.83%	35.86%	24	31
8	宜蘭縣員山鄉	2018-11-24T22:56:38+08:00	8337	2545	10882	1443	12325	23212	53.1%	35.92%	27	31
8	宜蘭縣員山鄉	2018-11-24T23:07:21+08:00	9304	2792	12096	1557	13653	25693	53.14%	36.21%	29	31
8	宜蘭縣員山鄉	2018-11-24T22:49:26+08:00	8337	2545	10882	1443	12325	23212	53.1%	35.92%	27	31
8	宜蘭縣員山鄉	2018-11-24T22:53:17+08:00	8337	2545	10882	1443	12325	23212	53.1%	35.92%	27	31
8	宜蘭縣員山鄉	2018-11-25T01:06:01+08:00	10219	3058	13277	1740	15017	28131	53.38%	36.33%	31	31
8	宜蘭縣員山鄉	2018-11-24T22:32:20+08:00	7173	2139	9312	1255	10567	20003	52.83%	35.86%	24	31
8	宜蘭縣員山鄉	2018-11-25T00:17:10+08:00	10219	3058	13277	1740	15017	28131	53.38%	36.33%	31	31
8	宜蘭縣員山鄉	2018-11-25T00:08:06+08:00	10219	3058	13277	1740	15017	28131	53.38%	36.33%	31	31
8	宜蘭縣員山鄉	2018-11-25T03:48:33+08:00	10219	3058	13277	1740	15017	28131	53.38%	36.33%	31	31
8	宜蘭縣員山鄉	2018-11-24T23:29:48+08:00	10219	3058	13277	1740	15017	28131	53.38%	36.33%	31	31
8	宜蘭縣員山鄉	2018-11-24T22:40:20+08:00	7795	2412	10207	1414	11621	21819	53.26%	35.73%	26	31
8	宜蘭縣員山鄉	2018-11-25T06:22:46+08:00	10219	3058	13277	1740	15017	28131	53.38%	36.33%	31	31
8	宜蘭縣員山鄉	2018-11-25T06:07:24+08:00	10219	3058	13277	1740	15017	28131	53.38%	36.33%	31	31
8	宜蘭縣員山鄉	2018-11-24T23:00:18+08:00	8337	2545	10882	1443	12325	23212	53.1%	35.92%	27	31
8	宜蘭縣員山鄉	2018-11-24T22:25:27+08:00	7173	2139	9312	1255	10567	20003	52.83%	35.86%	24	31
8	宜蘭縣員山鄉	2018-11-25T03:42:50+08:00	10219	3058	13277	1740	15017	28131	53.38%	36.33%	31	31
8	宜蘭縣員山鄉	2018-11-25T01:11:09+08:00	10219	3058	13277	1740	15017	28131	53.38%	36.33%	31	31
8	宜蘭縣員山鄉	2018-11-24T23:14:43+08:00	9304	2792	12096	1557	13653	25693	53.14%	36.21%	29	31
8	宜蘭縣員山鄉	2018-11-25T01:16:24+08:00	10219	3058	13277	1740	15017	28131	53.38%	36.33%	31	31
8	宜蘭縣員山鄉	2018-11-24T23:54:29+08:00	10219	3058	13277	1740	15017	28131	53.38%	36.33%	31	31
8	宜蘭縣員山鄉	2018-11-25T06:27:57+08:00	10219	3058	13277	1740	15017	28131	53.38%	36.33%	31	31
8	宜蘭縣員山鄉	2018-11-25T03:31:01+08:00	10219	3058	13277	1740	15017	28131	53.38%	36.33%	31	31
8	宜蘭縣員山鄉	2018-11-24T23:50:16+08:00	10219	3058	13277	1740	15017	28131	53.38%	36.33%	31	31
8	宜蘭縣員山鄉	2018-11-25T00:56:15+08:00	10219	3058	13277	1740	15017	28131	53.38%	36.33%	31	31
8	宜蘭縣員山鄉	2018-11-25T00:12:46+08:00	10219	3058	13277	1740	15017	28131	53.38%	36.33%	31	31
8	宜蘭縣員山鄉	2018-11-24T23:37:50+08:00	10219	3058	13277	1740	15017	28131	53.38%	36.33%	31	31
8	宜蘭縣員山鄉	2018-11-25T03:54:43+08:00	10219	3058	13277	1740	15017	28131	53.38%	36.33%	31	31
8	宜蘭縣員山鄉	2018-11-24T22:12:04+08:00	6778	2008	8786	1203	9989	19024	52.51%	35.63%	23	31
8	宜蘭縣員山鄉	2018-11-24T23:22:25+08:00	9304	2792	12096	1557	13653	25693	53.14%	36.21%	29	31
8	宜蘭縣員山鄉	2018-11-25T01:24:26+08:00	10219	3058	13277	1740	15017	28131	53.38%	36.33%	31	31
8	宜蘭縣員山鄉	2018-11-24T23:03:48+08:00	9304	2792	12096	1557	13653	25693	53.14%	36.21%	29	31
8	宜蘭縣員山鄉	2018-11-24T23:42:03+08:00	10219	3058	13277	1740	15017	28131	53.38%	36.33%	31	31
8	宜蘭縣員山鄉	2018-11-24T23:46:05+08:00	10219	3058	13277	1740	15017	28131	53.38%	36.33%	31	31
8	宜蘭縣員山鄉	2018-11-25T04:01:31+08:00	10219	3058	13277	1740	15017	28131	53.38%	36.33%	31	31
8	宜蘭縣員山鄉	2018-11-25T06:12:39+08:00	10219	3058	13277	1740	15017	28131	53.38%	36.33%	31	31
8	宜蘭縣員山鄉	2018-11-24T22:21:48+08:00	7173	2139	9312	1255	10567	20003	52.83%	35.86%	24	31
8	宜蘭縣員山鄉	2018-11-25T00:21:46+08:00	10219	3058	13277	1740	15017	28131	53.38%	36.33%	31	31
8	宜蘭縣員山鄉	2018-11-25T01:01:03+08:00	10219	3058	13277	1740	15017	28131	53.38%	36.33%	31	31
8	宜蘭縣員山鄉	2018-11-24T22:39:10+08:00	7795	2412	10207	1414	11621	21819	53.26%	35.73%	26	31
8	宜蘭縣員山鄉	2018-11-24T22:35:46+08:00	7795	2412	10207	1414	11621	21819	53.26%	35.73%	26	31
8	宜蘭縣員山鄉	2018-11-24T23:58:44+08:00	10219	3058	13277	1740	15017	28131	53.38%	36.33%	31	31
8	宜蘭縣員山鄉	2018-11-24T23:18:29+08:00	9304	2792	12096	1557	13653	25693	53.14%	36.21%	29	31
8	宜蘭縣員山鄉	2018-11-25T03:37:31+08:00	10219	3058	13277	1740	15017	28131	53.38%	36.33%	31	31
8	宜蘭縣員山鄉	2018-11-24T22:18:21+08:00	7173	2139	9312	1255	10567	20003	52.83%	35.86%	24	31
8	宜蘭縣員山鄉	2018-11-24T23:26:09+08:00	9713	2903	12616	1649	14265	26775	53.28%	36.28%	30	31
8	宜蘭縣員山鄉	2018-11-25T00:03:37+08:00	10219	3058	13277	1740	15017	28131	53.38%	36.33%	31	31
8	宜蘭縣員山鄉	2018-11-24T22:43:52+08:00	7795	2412	10207	1414	11621	21819	53.26%	35.73%	26	31
8	臺東縣鹿野鄉	2018-11-24T22:14:51+08:00	1674	594	2268	303	2571	5832	44.08%	28.7%	9	10
8	臺東縣鹿野鄉	2018-11-24T22:56:38+08:00	2011	727	2738	343	3081	6936	44.42%	28.99%	10	10
8	臺東縣鹿野鄉	2018-11-24T23:07:21+08:00	2011	727	2738	343	3081	6936	44.42%	28.99%	10	10
8	臺東縣鹿野鄉	2018-11-24T22:49:26+08:00	2011	727	2738	343	3081	6936	44.42%	28.99%	10	10
8	臺東縣鹿野鄉	2018-11-24T23:10:58+08:00	2011	727	2738	343	3081	6936	44.42%	28.99%	10	10
8	臺東縣鹿野鄉	2018-11-24T23:33:53+08:00	2011	727	2738	343	3081	6936	44.42%	28.99%	10	10
8	臺東縣鹿野鄉	2018-11-24T23:22:26+08:00	2011	727	2738	343	3081	6936	44.42%	28.99%	10	10
8	臺東縣鹿野鄉	2018-11-24T22:28:43+08:00	1674	594	2268	303	2571	5832	44.08%	28.7%	9	10
8	臺東縣鹿野鄉	2018-11-24T23:18:30+08:00	2011	727	2738	343	3081	6936	44.42%	28.99%	10	10
8	臺東縣鹿野鄉	2018-11-25T06:17:39+08:00	2011	727	2738	343	3081	6936	44.42%	28.99%	10	10
8	臺東縣鹿野鄉	2018-11-25T00:17:11+08:00	2011	727	2738	343	3081	6936	44.42%	28.99%	10	10
8	臺東縣鹿野鄉	2018-11-24T23:46:06+08:00	2011	727	2738	343	3081	6936	44.42%	28.99%	10	10
8	臺東縣鹿野鄉	2018-11-25T00:08:07+08:00	2011	727	2738	343	3081	6936	44.42%	28.99%	10	10
8	臺東縣鹿野鄉	2018-11-24T22:32:20+08:00	1674	594	2268	303	2571	5832	44.08%	28.7%	9	10
8	臺東縣鹿野鄉	2018-11-24T22:53:18+08:00	2011	727	2738	343	3081	6936	44.42%	28.99%	10	10
8	臺東縣鹿野鄉	2018-11-25T04:01:32+08:00	2011	727	2738	343	3081	6936	44.42%	28.99%	10	10
8	臺東縣鹿野鄉	2018-11-25T03:48:34+08:00	2011	727	2738	343	3081	6936	44.42%	28.99%	10	10
8	臺東縣鹿野鄉	2018-11-24T23:00:19+08:00	2011	727	2738	343	3081	6936	44.42%	28.99%	10	10
8	臺東縣鹿野鄉	2018-11-25T06:07:25+08:00	2011	727	2738	343	3081	6936	44.42%	28.99%	10	10
8	臺東縣鹿野鄉	2018-11-24T22:25:28+08:00	1674	594	2268	303	2571	5832	44.08%	28.7%	9	10
8	臺東縣鹿野鄉	2018-11-25T06:22:47+08:00	2011	727	2738	343	3081	6936	44.42%	28.99%	10	10
8	臺東縣鹿野鄉	2018-11-25T03:42:51+08:00	2011	727	2738	343	3081	6936	44.42%	28.99%	10	10
8	臺東縣鹿野鄉	2018-11-24T22:40:21+08:00	2011	727	2738	343	3081	6936	44.42%	28.99%	10	10
8	臺東縣鹿野鄉	2018-11-24T23:29:49+08:00	2011	727	2738	343	3081	6936	44.42%	28.99%	10	10
8	臺東縣鹿野鄉	2018-11-24T23:50:17+08:00	2011	727	2738	343	3081	6936	44.42%	28.99%	10	10
8	臺東縣鹿野鄉	2018-11-24T23:14:43+08:00	2011	727	2738	343	3081	6936	44.42%	28.99%	10	10
8	臺東縣鹿野鄉	2018-11-25T00:12:47+08:00	2011	727	2738	343	3081	6936	44.42%	28.99%	10	10
8	臺東縣鹿野鄉	2018-11-25T06:27:57+08:00	2011	727	2738	343	3081	6936	44.42%	28.99%	10	10
8	臺東縣鹿野鄉	2018-11-25T01:16:25+08:00	2011	727	2738	343	3081	6936	44.42%	28.99%	10	10
8	臺東縣鹿野鄉	2018-11-24T22:18:22+08:00	1674	594	2268	303	2571	5832	44.08%	28.7%	9	10
8	臺東縣鹿野鄉	2018-11-25T03:37:32+08:00	2011	727	2738	343	3081	6936	44.42%	28.99%	10	10
8	臺東縣鹿野鄉	2018-11-25T01:24:27+08:00	2011	727	2738	343	3081	6936	44.42%	28.99%	10	10
8	臺東縣鹿野鄉	2018-11-25T03:54:44+08:00	2011	727	2738	343	3081	6936	44.42%	28.99%	10	10
8	臺東縣鹿野鄉	2018-11-24T23:03:49+08:00	2011	727	2738	343	3081	6936	44.42%	28.99%	10	10
8	臺東縣鹿野鄉	2018-11-24T23:37:51+08:00	2011	727	2738	343	3081	6936	44.42%	28.99%	10	10
8	臺東縣鹿野鄉	2018-11-24T22:12:05+08:00	1674	594	2268	303	2571	5832	44.08%	28.7%	9	10
8	臺東縣鹿野鄉	2018-11-24T23:54:30+08:00	2011	727	2738	343	3081	6936	44.42%	28.99%	10	10
8	臺東縣鹿野鄉	2018-11-25T01:06:02+08:00	2011	727	2738	343	3081	6936	44.42%	28.99%	10	10
8	臺東縣鹿野鄉	2018-11-24T23:42:04+08:00	2011	727	2738	343	3081	6936	44.42%	28.99%	10	10
8	臺東縣鹿野鄉	2018-11-25T01:11:10+08:00	2011	727	2738	343	3081	6936	44.42%	28.99%	10	10
8	臺東縣鹿野鄉	2018-11-25T00:21:47+08:00	2011	727	2738	343	3081	6936	44.42%	28.99%	10	10
8	臺東縣鹿野鄉	2018-11-25T06:12:39+08:00	2011	727	2738	343	3081	6936	44.42%	28.99%	10	10
8	臺東縣鹿野鄉	2018-11-24T22:21:49+08:00	1674	594	2268	303	2571	5832	44.08%	28.7%	9	10
8	臺東縣鹿野鄉	2018-11-25T01:01:04+08:00	2011	727	2738	343	3081	6936	44.42%	28.99%	10	10
8	臺東縣鹿野鄉	2018-11-25T00:03:38+08:00	2011	727	2738	343	3081	6936	44.42%	28.99%	10	10
8	臺東縣鹿野鄉	2018-11-24T22:43:53+08:00	2011	727	2738	343	3081	6936	44.42%	28.99%	10	10
8	臺東縣鹿野鄉	2018-11-24T22:35:47+08:00	1674	594	2268	303	2571	5832	44.08%	28.7%	9	10
8	臺東縣鹿野鄉	2018-11-24T23:58:45+08:00	2011	727	2738	343	3081	6936	44.42%	28.99%	10	10
8	臺東縣鹿野鄉	2018-11-25T00:56:16+08:00	2011	727	2738	343	3081	6936	44.42%	28.99%	10	10
8	臺東縣鹿野鄉	2018-11-24T22:39:11+08:00	2011	727	2738	343	3081	6936	44.42%	28.99%	10	10
8	臺東縣鹿野鄉	2018-11-24T23:26:09+08:00	2011	727	2738	343	3081	6936	44.42%	28.99%	10	10
8	臺東縣鹿野鄉	2018-11-25T03:31:02+08:00	2011	727	2738	343	3081	6936	44.42%	28.99%	10	10
8	臺東縣達仁鄉	2018-11-24T23:26:10+08:00	1291	270	1561	198	1759	3137	56.07%	41.15%	7	7
8	臺東縣達仁鄉	2018-11-24T22:49:27+08:00	890	267	1157	140	1297	2270	57.14%	39.21%	6	7
8	臺東縣達仁鄉	2018-11-24T23:10:58+08:00	890	267	1157	140	1297	2270	57.14%	39.21%	6	7
8	臺東縣達仁鄉	2018-11-24T23:33:53+08:00	1291	270	1561	198	1759	3137	56.07%	41.15%	7	7
8	臺東縣達仁鄉	2018-11-24T22:56:39+08:00	890	267	1157	140	1297	2270	57.14%	39.21%	6	7
8	臺東縣達仁鄉	2018-11-24T23:22:26+08:00	1291	270	1561	198	1759	3137	56.07%	41.15%	7	7
8	臺東縣達仁鄉	2018-11-24T22:28:43+08:00	890	267	1157	140	1297	2270	57.14%	39.21%	6	7
8	臺東縣達仁鄉	2018-11-24T23:18:30+08:00	1291	270	1561	198	1759	3137	56.07%	41.15%	7	7
8	臺東縣達仁鄉	2018-11-25T00:17:11+08:00	1291	270	1561	198	1759	3137	56.07%	41.15%	7	7
8	臺東縣達仁鄉	2018-11-24T22:32:21+08:00	890	267	1157	140	1297	2270	57.14%	39.21%	6	7
8	臺東縣達仁鄉	2018-11-24T23:46:06+08:00	1291	270	1561	198	1759	3137	56.07%	41.15%	7	7
8	臺東縣達仁鄉	2018-11-25T00:08:07+08:00	1291	270	1561	198	1759	3137	56.07%	41.15%	7	7
8	臺東縣達仁鄉	2018-11-24T22:53:18+08:00	890	267	1157	140	1297	2270	57.14%	39.21%	6	7
8	臺東縣達仁鄉	2018-11-25T04:01:32+08:00	1291	270	1561	198	1759	3137	56.07%	41.15%	7	7
8	臺東縣達仁鄉	2018-11-25T03:48:34+08:00	1291	270	1561	198	1759	3137	56.07%	41.15%	7	7
8	臺東縣達仁鄉	2018-11-24T23:00:19+08:00	890	267	1157	140	1297	2270	57.14%	39.21%	6	7
8	臺東縣達仁鄉	2018-11-24T22:25:28+08:00	890	267	1157	140	1297	2270	57.14%	39.21%	6	7
8	臺東縣達仁鄉	2018-11-25T06:22:47+08:00	1291	270	1561	198	1759	3137	56.07%	41.15%	7	7
8	臺東縣達仁鄉	2018-11-25T03:42:51+08:00	1291	270	1561	198	1759	3137	56.07%	41.15%	7	7
8	臺東縣達仁鄉	2018-11-24T22:40:21+08:00	890	267	1157	140	1297	2270	57.14%	39.21%	6	7
8	臺東縣達仁鄉	2018-11-24T23:29:49+08:00	1291	270	1561	198	1759	3137	56.07%	41.15%	7	7
8	臺東縣達仁鄉	2018-11-24T23:14:44+08:00	890	267	1157	140	1297	2270	57.14%	39.21%	6	7
8	臺東縣達仁鄉	2018-11-24T23:50:17+08:00	1291	270	1561	198	1759	3137	56.07%	41.15%	7	7
8	臺東縣達仁鄉	2018-11-25T00:12:47+08:00	1291	270	1561	198	1759	3137	56.07%	41.15%	7	7
8	臺東縣達仁鄉	2018-11-25T03:37:33+08:00	1291	270	1561	198	1759	3137	56.07%	41.15%	7	7
8	臺東縣達仁鄉	2018-11-25T01:16:25+08:00	1291	270	1561	198	1759	3137	56.07%	41.15%	7	7
8	臺東縣達仁鄉	2018-11-24T22:18:22+08:00	890	267	1157	140	1297	2270	57.14%	39.21%	6	7
8	臺東縣達仁鄉	2018-11-24T23:03:50+08:00	890	267	1157	140	1297	2270	57.14%	39.21%	6	7
8	臺東縣達仁鄉	2018-11-24T22:39:12+08:00	890	267	1157	140	1297	2270	57.14%	39.21%	6	7
8	臺東縣達仁鄉	2018-11-25T06:27:58+08:00	1291	270	1561	198	1759	3137	56.07%	41.15%	7	7
8	臺東縣達仁鄉	2018-11-25T06:17:40+08:00	1291	270	1561	198	1759	3137	56.07%	41.15%	7	7
8	臺東縣達仁鄉	2018-11-25T03:54:44+08:00	1291	270	1561	198	1759	3137	56.07%	41.15%	7	7
8	臺東縣達仁鄉	2018-11-24T22:14:52+08:00	890	267	1157	140	1297	2270	57.14%	39.21%	6	7
8	臺東縣達仁鄉	2018-11-25T01:24:28+08:00	1291	270	1561	198	1759	3137	56.07%	41.15%	7	7
8	臺東縣達仁鄉	2018-11-24T23:37:51+08:00	1291	270	1561	198	1759	3137	56.07%	41.15%	7	7
8	臺東縣達仁鄉	2018-11-24T23:07:22+08:00	890	267	1157	140	1297	2270	57.14%	39.21%	6	7
8	臺東縣達仁鄉	2018-11-24T22:12:05+08:00	890	267	1157	140	1297	2270	57.14%	39.21%	6	7
8	臺東縣達仁鄉	2018-11-24T23:54:30+08:00	1291	270	1561	198	1759	3137	56.07%	41.15%	7	7
8	臺東縣達仁鄉	2018-11-25T06:12:40+08:00	1291	270	1561	198	1759	3137	56.07%	41.15%	7	7
8	臺東縣達仁鄉	2018-11-24T23:42:04+08:00	1291	270	1561	198	1759	3137	56.07%	41.15%	7	7
8	臺東縣達仁鄉	2018-11-25T01:06:03+08:00	1291	270	1561	198	1759	3137	56.07%	41.15%	7	7
8	臺東縣達仁鄉	2018-11-25T01:11:11+08:00	1291	270	1561	198	1759	3137	56.07%	41.15%	7	7
8	臺東縣達仁鄉	2018-11-25T00:21:47+08:00	1291	270	1561	198	1759	3137	56.07%	41.15%	7	7
8	臺東縣達仁鄉	2018-11-25T06:07:26+08:00	1291	270	1561	198	1759	3137	56.07%	41.15%	7	7
8	臺東縣達仁鄉	2018-11-24T22:21:49+08:00	890	267	1157	140	1297	2270	57.14%	39.21%	6	7
8	臺東縣達仁鄉	2018-11-25T00:03:38+08:00	1291	270	1561	198	1759	3137	56.07%	41.15%	7	7
8	臺東縣達仁鄉	2018-11-24T22:43:53+08:00	890	267	1157	140	1297	2270	57.14%	39.21%	6	7
8	臺東縣達仁鄉	2018-11-24T22:35:47+08:00	890	267	1157	140	1297	2270	57.14%	39.21%	6	7
8	臺東縣達仁鄉	2018-11-24T23:58:45+08:00	1291	270	1561	198	1759	3137	56.07%	41.15%	7	7
8	臺東縣達仁鄉	2018-11-25T01:01:05+08:00	1291	270	1561	198	1759	3137	56.07%	41.15%	7	7
8	臺東縣達仁鄉	2018-11-25T00:56:16+08:00	1291	270	1561	198	1759	3137	56.07%	41.15%	7	7
8	臺東縣達仁鄉	2018-11-25T03:31:02+08:00	1291	270	1561	198	1759	3137	56.07%	41.15%	7	7
8	臺中市龍井區	2018-11-24T22:49:18+08:00	22567	6930	29497	2186	31683	57167	55.42%	39.48%	41	45
8	臺中市龍井區	2018-11-24T23:14:33+08:00	25170	7724	32894	2476	35370	63584	55.63%	39.59%	45	45
8	臺中市龍井區	2018-11-24T22:56:31+08:00	23986	7354	31340	2330	33670	60477	55.67%	39.66%	43	45
8	臺中市龍井區	2018-11-25T00:12:39+08:00	25170	7724	32894	2476	35370	63584	55.63%	39.59%	45	45
8	臺中市龍井區	2018-11-25T00:56:07+08:00	25170	7724	32894	2476	35370	63584	55.63%	39.59%	45	45
8	臺中市龍井區	2018-11-24T23:03:42+08:00	24581	7573	32154	2410	34564	62256	55.52%	39.48%	44	45
8	臺中市龍井區	2018-11-24T23:10:51+08:00	25170	7724	32894	2476	35370	63584	55.63%	39.59%	45	45
8	臺中市龍井區	2018-11-25T03:37:18+08:00	25170	7724	32894	2476	35370	63584	55.63%	39.59%	45	45
8	臺中市龍井區	2018-11-24T22:43:44+08:00	20578	6424	27002	1993	28995	52392	55.34%	39.28%	38	45
8	臺中市龍井區	2018-11-25T00:03:26+08:00	25170	7724	32894	2476	35370	63584	55.63%	39.59%	45	45
8	臺中市龍井區	2018-11-25T01:10:59+08:00	25170	7724	32894	2476	35370	63584	55.63%	39.59%	45	45
8	臺中市龍井區	2018-11-24T23:22:17+08:00	25170	7724	32894	2476	35370	63584	55.63%	39.59%	45	45
8	臺中市龍井區	2018-11-25T06:22:39+08:00	25170	7724	32894	2476	35370	63584	55.63%	39.59%	45	45
8	臺中市龍井區	2018-11-24T22:25:18+08:00	19291	6009	25300	1912	27212	49105	55.42%	39.29%	36	45
8	臺中市龍井區	2018-11-24T23:29:40+08:00	25170	7724	32894	2476	35370	63584	55.63%	39.59%	45	45
8	臺中市龍井區	2018-11-25T00:17:02+08:00	25170	7724	32894	2476	35370	63584	55.63%	39.59%	45	45
8	臺中市龍井區	2018-11-25T00:07:58+08:00	25170	7724	32894	2476	35370	63584	55.63%	39.59%	45	45
8	臺中市龍井區	2018-11-25T01:16:15+08:00	25170	7724	32894	2476	35370	63584	55.63%	39.59%	45	45
8	臺中市龍井區	2018-11-25T01:05:52+08:00	25170	7724	32894	2476	35370	63584	55.63%	39.59%	45	45
8	臺中市龍井區	2018-11-24T22:14:42+08:00	16692	5239	21931	1666	23597	42547	55.46%	39.23%	32	45
8	臺中市龍井區	2018-11-24T23:54:19+08:00	25170	7724	32894	2476	35370	63584	55.63%	39.59%	45	45
8	臺中市龍井區	2018-11-24T22:28:34+08:00	19291	6009	25300	1912	27212	49105	55.42%	39.29%	36	45
8	臺中市龍井區	2018-11-24T22:18:13+08:00	17357	5425	22782	1720	24502	44160	55.48%	39.3%	33	45
8	臺中市龍井區	2018-11-25T01:24:17+08:00	25170	7724	32894	2476	35370	63584	55.63%	39.59%	45	45
8	臺中市龍井區	2018-11-24T22:35:39+08:00	19291	6009	25300	1912	27212	49105	55.42%	39.29%	36	45
8	臺中市龍井區	2018-11-24T23:50:09+08:00	25170	7724	32894	2476	35370	63584	55.63%	39.59%	45	45
8	臺中市龍井區	2018-11-24T23:58:35+08:00	25170	7724	32894	2476	35370	63584	55.63%	39.59%	45	45
8	臺中市龍井區	2018-11-25T06:27:49+08:00	25170	7724	32894	2476	35370	63584	55.63%	39.59%	45	45
8	臺中市龍井區	2018-11-24T22:39:03+08:00	19291	6009	25300	1912	27212	49105	55.42%	39.29%	36	45
8	臺中市龍井區	2018-11-24T23:07:13+08:00	24581	7573	32154	2410	34564	62256	55.52%	39.48%	44	45
8	臺中市龍井區	2018-11-25T01:00:54+08:00	25170	7724	32894	2476	35370	63584	55.63%	39.59%	45	45
8	臺中市龍井區	2018-11-24T23:00:08+08:00	23986	7354	31340	2330	33670	60477	55.67%	39.66%	43	45
8	臺中市龍井區	2018-11-25T03:48:22+08:00	25170	7724	32894	2476	35370	63584	55.63%	39.59%	45	45
8	臺中市龍井區	2018-11-25T00:21:37+08:00	25170	7724	32894	2476	35370	63584	55.63%	39.59%	45	45
8	臺中市龍井區	2018-11-25T03:30:52+08:00	25170	7724	32894	2476	35370	63584	55.63%	39.59%	45	45
8	臺中市龍井區	2018-11-25T03:42:41+08:00	25170	7724	32894	2476	35370	63584	55.63%	39.59%	45	45
8	臺中市龍井區	2018-11-24T22:21:39+08:00	18679	5811	24490	1851	26341	47596	55.34%	39.24%	35	45
8	臺中市龍井區	2018-11-24T22:32:12+08:00	19291	6009	25300	1912	27212	49105	55.42%	39.29%	36	45
8	臺中市龍井區	2018-11-24T22:53:08+08:00	22567	6930	29497	2186	31683	57167	55.42%	39.48%	41	45
8	臺中市龍井區	2018-11-25T04:01:22+08:00	25170	7724	32894	2476	35370	63584	55.63%	39.59%	45	45
8	臺中市龍井區	2018-11-24T22:11:57+08:00	15965	5051	21016	1618	22634	40822	55.45%	39.11%	31	45
8	臺中市龍井區	2018-11-24T22:40:13+08:00	19914	6213	26127	1961	28088	50768	55.33%	39.23%	37	45
8	臺中市龍井區	2018-11-25T06:12:31+08:00	25170	7724	32894	2476	35370	63584	55.63%	39.59%	45	45
8	臺中市龍井區	2018-11-25T06:07:16+08:00	25170	7724	32894	2476	35370	63584	55.63%	39.59%	45	45
8	臺中市龍井區	2018-11-24T23:33:44+08:00	25170	7724	32894	2476	35370	63584	55.63%	39.59%	45	45
8	臺中市龍井區	2018-11-24T23:26:01+08:00	25170	7724	32894	2476	35370	63584	55.63%	39.59%	45	45
8	臺中市龍井區	2018-11-25T03:54:34+08:00	25170	7724	32894	2476	35370	63584	55.63%	39.59%	45	45
8	臺中市龍井區	2018-11-24T23:45:58+08:00	25170	7724	32894	2476	35370	63584	55.63%	39.59%	45	45
8	臺中市龍井區	2018-11-25T06:17:29+08:00	25170	7724	32894	2476	35370	63584	55.63%	39.59%	45	45
8	臺中市龍井區	2018-11-24T23:41:56+08:00	25170	7724	32894	2476	35370	63584	55.63%	39.59%	45	45
8	臺中市龍井區	2018-11-24T23:37:43+08:00	25170	7724	32894	2476	35370	63584	55.63%	39.59%	45	45
8	臺中市龍井區	2018-11-24T23:18:21+08:00	25170	7724	32894	2476	35370	63584	55.63%	39.59%	45	45
8	雲林縣二崙鄉	2018-11-24T22:39:08+08:00	6708	2378	9086	1336	10422	22518	46.28%	29.79%	22	23
8	雲林縣二崙鄉	2018-11-25T03:37:28+08:00	7014	2497	9511	1410	10921	23367	46.74%	30.02%	23	23
8	雲林縣二崙鄉	2018-11-24T23:07:18+08:00	7014	2497	9511	1410	10921	23367	46.74%	30.02%	23	23
8	雲林縣二崙鄉	2018-11-25T01:24:23+08:00	7014	2497	9511	1410	10921	23367	46.74%	30.02%	23	23
8	雲林縣二崙鄉	2018-11-25T03:54:40+08:00	7014	2497	9511	1410	10921	23367	46.74%	30.02%	23	23
8	雲林縣二崙鄉	2018-11-24T22:32:17+08:00	6708	2378	9086	1336	10422	22518	46.28%	29.79%	22	23
8	雲林縣二崙鄉	2018-11-25T03:30:58+08:00	7014	2497	9511	1410	10921	23367	46.74%	30.02%	23	23
8	雲林縣二崙鄉	2018-11-24T23:42:01+08:00	7014	2497	9511	1410	10921	23367	46.74%	30.02%	23	23
8	雲林縣二崙鄉	2018-11-25T03:48:29+08:00	7014	2497	9511	1410	10921	23367	46.74%	30.02%	23	23
8	雲林縣二崙鄉	2018-11-24T22:21:45+08:00	5983	2135	8118	1179	9297	20339	45.71%	29.42%	20	23
8	雲林縣二崙鄉	2018-11-25T06:07:22+08:00	7014	2497	9511	1410	10921	23367	46.74%	30.02%	23	23
8	雲林縣二崙鄉	2018-11-25T04:01:28+08:00	7014	2497	9511	1410	10921	23367	46.74%	30.02%	23	23
8	雲林縣二崙鄉	2018-11-25T00:21:43+08:00	7014	2497	9511	1410	10921	23367	46.74%	30.02%	23	23
8	雲林縣二崙鄉	2018-11-25T01:11:06+08:00	7014	2497	9511	1410	10921	23367	46.74%	30.02%	23	23
8	雲林縣二崙鄉	2018-11-24T22:40:18+08:00	6708	2378	9086	1336	10422	22518	46.28%	29.79%	22	23
8	雲林縣二崙鄉	2018-11-24T23:00:16+08:00	7014	2497	9511	1410	10921	23367	46.74%	30.02%	23	23
8	雲林縣二崙鄉	2018-11-24T23:37:48+08:00	7014	2497	9511	1410	10921	23367	46.74%	30.02%	23	23
8	雲林縣二崙鄉	2018-11-25T00:56:13+08:00	7014	2497	9511	1410	10921	23367	46.74%	30.02%	23	23
8	雲林縣二崙鄉	2018-11-25T01:01:00+08:00	7014	2497	9511	1410	10921	23367	46.74%	30.02%	23	23
8	雲林縣二崙鄉	2018-11-24T23:33:49+08:00	7014	2497	9511	1410	10921	23367	46.74%	30.02%	23	23
8	雲林縣二崙鄉	2018-11-25T00:03:33+08:00	7014	2497	9511	1410	10921	23367	46.74%	30.02%	23	23
8	雲林縣二崙鄉	2018-11-24T22:35:44+08:00	6708	2378	9086	1336	10422	22518	46.28%	29.79%	22	23
8	雲林縣二崙鄉	2018-11-24T23:54:26+08:00	7014	2497	9511	1410	10921	23367	46.74%	30.02%	23	23
8	雲林縣二崙鄉	2018-11-24T23:58:41+08:00	7014	2497	9511	1410	10921	23367	46.74%	30.02%	23	23
8	雲林縣二崙鄉	2018-11-24T22:56:35+08:00	7014	2497	9511	1410	10921	23367	46.74%	30.02%	23	23
8	雲林縣二崙鄉	2018-11-25T06:17:35+08:00	7014	2497	9511	1410	10921	23367	46.74%	30.02%	23	23
8	雲林縣二崙鄉	2018-11-24T22:49:23+08:00	7014	2497	9511	1410	10921	23367	46.74%	30.02%	23	23
8	雲林縣二崙鄉	2018-11-24T23:22:22+08:00	7014	2497	9511	1410	10921	23367	46.74%	30.02%	23	23
8	雲林縣二崙鄉	2018-11-24T22:43:49+08:00	6708	2378	9086	1336	10422	22518	46.28%	29.79%	22	23
8	雲林縣二崙鄉	2018-11-24T23:03:46+08:00	7014	2497	9511	1410	10921	23367	46.74%	30.02%	23	23
8	雲林縣二崙鄉	2018-11-24T23:10:55+08:00	7014	2497	9511	1410	10921	23367	46.74%	30.02%	23	23
8	雲林縣二崙鄉	2018-11-24T22:12:02+08:00	5438	1985	7423	1105	8528	18601	45.85%	29.23%	19	23
8	雲林縣二崙鄉	2018-11-25T00:08:04+08:00	7014	2497	9511	1410	10921	23367	46.74%	30.02%	23	23
8	雲林縣二崙鄉	2018-11-25T03:42:47+08:00	7014	2497	9511	1410	10921	23367	46.74%	30.02%	23	23
8	雲林縣二崙鄉	2018-11-24T22:53:14+08:00	7014	2497	9511	1410	10921	23367	46.74%	30.02%	23	23
8	雲林縣二崙鄉	2018-11-24T23:46:03+08:00	7014	2497	9511	1410	10921	23367	46.74%	30.02%	23	23
8	雲林縣二崙鄉	2018-11-25T00:17:07+08:00	7014	2497	9511	1410	10921	23367	46.74%	30.02%	23	23
8	雲林縣二崙鄉	2018-11-24T23:29:45+08:00	7014	2497	9511	1410	10921	23367	46.74%	30.02%	23	23
8	雲林縣二崙鄉	2018-11-25T06:22:44+08:00	7014	2497	9511	1410	10921	23367	46.74%	30.02%	23	23
8	雲林縣二崙鄉	2018-11-25T06:12:36+08:00	7014	2497	9511	1410	10921	23367	46.74%	30.02%	23	23
8	雲林縣二崙鄉	2018-11-24T22:25:24+08:00	6379	2285	8664	1262	9926	21500	46.17%	29.67%	21	23
8	雲林縣二崙鄉	2018-11-25T01:05:58+08:00	7014	2497	9511	1410	10921	23367	46.74%	30.02%	23	23
8	雲林縣二崙鄉	2018-11-25T00:12:44+08:00	7014	2497	9511	1410	10921	23367	46.74%	30.02%	23	23
8	雲林縣二崙鄉	2018-11-24T23:26:06+08:00	7014	2497	9511	1410	10921	23367	46.74%	30.02%	23	23
8	雲林縣二崙鄉	2018-11-25T06:27:54+08:00	7014	2497	9511	1410	10921	23367	46.74%	30.02%	23	23
8	雲林縣二崙鄉	2018-11-24T23:50:14+08:00	7014	2497	9511	1410	10921	23367	46.74%	30.02%	23	23
8	雲林縣二崙鄉	2018-11-24T23:14:40+08:00	7014	2497	9511	1410	10921	23367	46.74%	30.02%	23	23
8	雲林縣二崙鄉	2018-11-24T22:18:19+08:00	5438	1985	7423	1105	8528	18601	45.85%	29.23%	19	23
8	雲林縣二崙鄉	2018-11-24T22:28:39+08:00	6379	2285	8664	1262	9926	21500	46.17%	29.67%	21	23
8	雲林縣二崙鄉	2018-11-24T22:14:48+08:00	5438	1985	7423	1105	8528	18601	45.85%	29.23%	19	23
8	雲林縣二崙鄉	2018-11-25T01:16:21+08:00	7014	2497	9511	1410	10921	23367	46.74%	30.02%	23	23
8	雲林縣二崙鄉	2018-11-24T23:18:26+08:00	7014	2497	9511	1410	10921	23367	46.74%	30.02%	23	23
8	雲林縣斗六市	2018-11-24T22:39:08+08:00	20497	6130	26627	1807	28434	49607	57.32%	41.32%	42	69
8	雲林縣斗六市	2018-11-25T03:37:28+08:00	37013	10854	47867	3212	51079	89761	56.91%	41.24%	69	69
8	雲林縣斗六市	2018-11-25T01:24:23+08:00	37013	10854	47867	3212	51079	89761	56.91%	41.24%	69	69
8	雲林縣斗六市	2018-11-24T23:07:17+08:00	24700	7124	31824	2115	33939	59090	57.44%	41.8%	49	69
8	雲林縣斗六市	2018-11-24T22:12:01+08:00	16608	4879	21487	1463	22950	39857	57.58%	41.67%	35	69
8	雲林縣斗六市	2018-11-24T22:32:17+08:00	18699	5445	24144	1631	25775	44775	57.57%	41.76%	39	69
8	雲林縣斗六市	2018-11-25T03:48:28+08:00	37013	10854	47867	3212	51079	89761	56.91%	41.24%	69	69
8	雲林縣斗六市	2018-11-25T03:30:58+08:00	37013	10854	47867	3212	51079	89761	56.91%	41.24%	69	69
8	雲林縣斗六市	2018-11-24T23:42:01+08:00	29275	8501	37776	2524	40300	70114	57.48%	41.75%	56	69
8	雲林縣斗六市	2018-11-24T22:21:45+08:00	17991	5241	23232	1565	24797	43203	57.4%	41.64%	38	69
8	雲林縣斗六市	2018-11-25T04:01:28+08:00	37013	10854	47867	3212	51079	89761	56.91%	41.24%	69	69
8	雲林縣斗六市	2018-11-25T00:21:43+08:00	33803	9890	43693	3000	46693	81661	57.18%	41.39%	64	69
8	雲林縣斗六市	2018-11-25T01:11:06+08:00	37013	10854	47867	3212	51079	89761	56.91%	41.24%	69	69
8	雲林縣斗六市	2018-11-24T22:40:18+08:00	20497	6130	26627	1807	28434	49607	57.32%	41.32%	42	69
8	雲林縣斗六市	2018-11-24T23:00:16+08:00	23048	6782	29830	2009	31839	55335	57.54%	41.65%	46	69
8	雲林縣斗六市	2018-11-25T03:54:39+08:00	37013	10854	47867	3212	51079	89761	56.91%	41.24%	69	69
8	雲林縣斗六市	2018-11-25T01:01:00+08:00	37013	10854	47867	3212	51079	89761	56.91%	41.24%	69	69
8	雲林縣斗六市	2018-11-24T23:33:49+08:00	28832	8344	37176	2478	39654	69003	57.47%	41.78%	55	69
8	雲林縣斗六市	2018-11-25T00:03:33+08:00	30066	8753	38819	2581	41400	72164	57.37%	41.66%	58	69
8	雲林縣斗六市	2018-11-24T23:37:47+08:00	29275	8501	37776	2524	40300	70114	57.48%	41.75%	56	69
8	雲林縣斗六市	2018-11-24T22:35:43+08:00	19883	5980	25863	1770	27633	48019	57.55%	41.41%	41	69
8	雲林縣斗六市	2018-11-24T23:54:26+08:00	29275	8501	37776	2524	40300	70114	57.48%	41.75%	56	69
8	雲林縣斗六市	2018-11-24T23:58:41+08:00	29649	8628	38277	2557	40834	71237	57.32%	41.62%	57	69
8	雲林縣斗六市	2018-11-25T00:56:12+08:00	37013	10854	47867	3212	51079	89761	56.91%	41.24%	69	69
8	雲林縣斗六市	2018-11-24T22:56:35+08:00	22282	6559	28841	1936	30777	53588	57.43%	41.58%	45	69
8	雲林縣斗六市	2018-11-25T06:17:35+08:00	37013	10854	47867	3212	51079	89761	56.91%	41.24%	69	69
8	雲林縣斗六市	2018-11-24T22:49:23+08:00	22282	6559	28841	1936	30777	53588	57.43%	41.58%	45	69
8	雲林縣斗六市	2018-11-24T23:22:22+08:00	26652	7712	34364	2279	36643	63940	57.31%	41.68%	52	69
8	雲林縣斗六市	2018-11-24T22:43:49+08:00	21068	6277	27345	1854	29199	51077	57.17%	41.25%	43	69
8	雲林縣斗六市	2018-11-24T23:03:46+08:00	23999	7030	31029	2079	33108	57736	57.34%	41.57%	48	69
8	雲林縣斗六市	2018-11-24T23:10:55+08:00	24700	7124	31824	2115	33939	59090	57.44%	41.8%	49	69
8	雲林縣斗六市	2018-11-25T00:08:03+08:00	30428	8852	39280	2625	41905	73011	57.4%	41.68%	59	69
8	雲林縣斗六市	2018-11-25T03:42:47+08:00	37013	10854	47867	3212	51079	89761	56.91%	41.24%	69	69
8	雲林縣斗六市	2018-11-24T22:53:14+08:00	22282	6559	28841	1936	30777	53588	57.43%	41.58%	45	69
8	雲林縣斗六市	2018-11-24T23:46:02+08:00	29275	8501	37776	2524	40300	70114	57.48%	41.75%	56	69
8	雲林縣斗六市	2018-11-25T00:17:07+08:00	32653	9560	42213	2905	45118	78695	57.33%	41.49%	62	69
8	雲林縣斗六市	2018-11-24T23:29:45+08:00	27268	7882	35150	2330	37480	65352	57.35%	41.72%	53	69
8	雲林縣斗六市	2018-11-25T06:22:44+08:00	37013	10854	47867	3212	51079	89761	56.91%	41.24%	69	69
8	雲林縣斗六市	2018-11-25T06:07:21+08:00	37013	10854	47867	3212	51079	89761	56.91%	41.24%	69	69
8	雲林縣斗六市	2018-11-25T06:12:36+08:00	37013	10854	47867	3212	51079	89761	56.91%	41.24%	69	69
8	雲林縣斗六市	2018-11-24T22:25:24+08:00	17991	5241	23232	1565	24797	43203	57.4%	41.64%	38	69
8	雲林縣斗六市	2018-11-25T01:05:58+08:00	37013	10854	47867	3212	51079	89761	56.91%	41.24%	69	69
8	雲林縣斗六市	2018-11-25T00:12:44+08:00	31073	9080	40153	2734	42887	74719	57.4%	41.59%	60	69
8	雲林縣斗六市	2018-11-24T23:26:06+08:00	27268	7882	35150	2330	37480	65352	57.35%	41.72%	53	69
8	雲林縣斗六市	2018-11-24T22:18:18+08:00	17557	5126	22683	1533	24216	42057	57.58%	41.75%	37	69
8	雲林縣斗六市	2018-11-25T06:27:54+08:00	37013	10854	47867	3212	51079	89761	56.91%	41.24%	69	69
8	雲林縣斗六市	2018-11-24T23:50:14+08:00	29275	8501	37776	2524	40300	70114	57.48%	41.75%	56	69
8	雲林縣斗六市	2018-11-24T23:14:40+08:00	25525	7385	32910	2202	35112	61261	57.32%	41.67%	50	69
8	雲林縣斗六市	2018-11-24T22:28:39+08:00	17991	5241	23232	1565	24797	43203	57.4%	41.64%	38	69
8	雲林縣斗六市	2018-11-24T22:14:48+08:00	17110	5004	22114	1509	23623	40960	57.67%	41.77%	36	69
8	雲林縣斗六市	2018-11-25T01:16:21+08:00	37013	10854	47867	3212	51079	89761	56.91%	41.24%	69	69
8	雲林縣斗六市	2018-11-24T23:18:26+08:00	25525	7385	32910	2202	35112	61261	57.32%	41.67%	50	69
8	新竹縣新豐鄉	2018-11-24T22:39:06+08:00	10681	3026	13707	999	14706	26444	55.61%	40.39%	24	39
8	新竹縣新豐鄉	2018-11-24T23:03:44+08:00	12838	3712	16550	1254	17804	32077	55.5%	40.02%	29	39
8	新竹縣新豐鄉	2018-11-24T23:22:20+08:00	15782	4468	20250	1479	21729	38880	55.89%	40.59%	34	39
8	新竹縣新豐鄉	2018-11-24T23:58:39+08:00	16334	4655	20989	1508	22497	40366	55.73%	40.46%	35	39
8	新竹縣新豐鄉	2018-11-24T22:49:21+08:00	11495	3296	14791	1075	15866	28724	55.24%	40.02%	26	39
8	新竹縣新豐鄉	2018-11-25T03:42:44+08:00	18567	5228	23795	1691	25486	45790	55.66%	40.55%	39	39
8	新竹縣新豐鄉	2018-11-24T23:46:01+08:00	15782	4468	20250	1479	21729	38880	55.89%	40.59%	34	39
8	新竹縣新豐鄉	2018-11-25T01:00:57+08:00	18567	5228	23795	1691	25486	45790	55.66%	40.55%	39	39
8	新竹縣新豐鄉	2018-11-25T03:48:26+08:00	18567	5228	23795	1691	25486	45790	55.66%	40.55%	39	39
8	新竹縣新豐鄉	2018-11-24T22:53:11+08:00	11495	3296	14791	1075	15866	28724	55.24%	40.02%	26	39
8	新竹縣新豐鄉	2018-11-25T00:08:01+08:00	17522	4991	22513	1591	24104	43265	55.71%	40.5%	37	39
8	新竹縣新豐鄉	2018-11-24T22:21:42+08:00	8456	2353	10809	732	11541	20815	55.45%	40.62%	19	39
8	新竹縣新豐鄉	2018-11-25T04:01:26+08:00	18567	5228	23795	1691	25486	45790	55.66%	40.55%	39	39
8	新竹縣新豐鄉	2018-11-24T22:25:21+08:00	8456	2353	10809	732	11541	20815	55.45%	40.62%	19	39
8	新竹縣新豐鄉	2018-11-25T06:12:34+08:00	18567	5228	23795	1691	25486	45790	55.66%	40.55%	39	39
8	新竹縣新豐鄉	2018-11-24T22:40:16+08:00	11050	3172	14222	1052	15274	27507	55.53%	40.17%	25	39
8	新竹縣新豐鄉	2018-11-25T00:17:05+08:00	17922	5106	23028	1653	24681	44345	55.66%	40.41%	38	39
8	新竹縣新豐鄉	2018-11-24T23:18:24+08:00	13859	4025	17884	1369	19253	34645	55.57%	40%	31	39
8	新竹縣新豐鄉	2018-11-24T23:37:46+08:00	15782	4468	20250	1479	21729	38880	55.89%	40.59%	34	39
8	新竹縣新豐鄉	2018-11-24T22:35:42+08:00	10293	2903	13196	961	14157	25441	55.65%	40.46%	23	39
8	新竹縣新豐鄉	2018-11-25T03:54:37+08:00	18567	5228	23795	1691	25486	45790	55.66%	40.55%	39	39
8	新竹縣新豐鄉	2018-11-24T23:33:47+08:00	15782	4468	20250	1479	21729	38880	55.89%	40.59%	34	39
8	新竹縣新豐鄉	2018-11-25T01:05:55+08:00	18567	5228	23795	1691	25486	45790	55.66%	40.55%	39	39
8	新竹縣新豐鄉	2018-11-24T23:26:04+08:00	15782	4468	20250	1479	21729	38880	55.89%	40.59%	34	39
8	新竹縣新豐鄉	2018-11-24T22:14:45+08:00	7555	2087	9642	647	10289	18457	55.75%	40.93%	17	39
8	新竹縣新豐鄉	2018-11-24T23:07:15+08:00	12838	3712	16550	1254	17804	32077	55.5%	40.02%	29	39
8	新竹縣新豐鄉	2018-11-24T23:14:37+08:00	13279	3880	17159	1310	18469	33343	55.39%	39.83%	30	39
8	新竹縣新豐鄉	2018-11-24T23:10:53+08:00	13279	3880	17159	1310	18469	33343	55.39%	39.83%	30	39
8	新竹縣新豐鄉	2018-11-25T06:17:33+08:00	18567	5228	23795	1691	25486	45790	55.66%	40.55%	39	39
8	新竹縣新豐鄉	2018-11-24T22:43:47+08:00	11050	3172	14222	1052	15274	27507	55.53%	40.17%	25	39
8	新竹縣新豐鄉	2018-11-24T22:56:33+08:00	11495	3296	14791	1075	15866	28724	55.24%	40.02%	26	39
8	新竹縣新豐鄉	2018-11-25T01:24:21+08:00	18567	5228	23795	1691	25486	45790	55.66%	40.55%	39	39
8	新竹縣新豐鄉	2018-11-25T03:37:23+08:00	18567	5228	23795	1691	25486	45790	55.66%	40.55%	39	39
8	新竹縣新豐鄉	2018-11-25T03:30:55+08:00	18567	5228	23795	1691	25486	45790	55.66%	40.55%	39	39
8	新竹縣新豐鄉	2018-11-24T22:32:15+08:00	9379	2644	12023	875	12898	23183	55.64%	40.46%	21	39
8	新竹縣新豐鄉	2018-11-24T22:11:59+08:00	6610	1840	8450	607	9057	16234	55.79%	40.72%	15	39
8	新竹縣新豐鄉	2018-11-24T23:00:14+08:00	11861	3417	15278	1147	16425	29753	55.2%	39.86%	27	39
8	新竹縣新豐鄉	2018-11-25T06:07:19+08:00	18567	5228	23795	1691	25486	45790	55.66%	40.55%	39	39
8	新竹縣新豐鄉	2018-11-25T01:11:03+08:00	18567	5228	23795	1691	25486	45790	55.66%	40.55%	39	39
8	新竹縣新豐鄉	2018-11-24T23:29:43+08:00	15782	4468	20250	1479	21729	38880	55.89%	40.59%	34	39
8	新竹縣新豐鄉	2018-11-25T00:21:41+08:00	17922	5106	23028	1653	24681	44345	55.66%	40.41%	38	39
8	新竹縣新豐鄉	2018-11-25T06:22:42+08:00	18567	5228	23795	1691	25486	45790	55.66%	40.55%	39	39
8	新竹縣新豐鄉	2018-11-25T00:56:10+08:00	18567	5228	23795	1691	25486	45790	55.66%	40.55%	39	39
8	新竹縣新豐鄉	2018-11-24T22:18:16+08:00	8037	2232	10269	700	10969	19726	55.61%	40.74%	18	39
8	新竹縣新豐鄉	2018-11-24T23:54:24+08:00	16334	4655	20989	1508	22497	40366	55.73%	40.46%	35	39
8	新竹縣新豐鄉	2018-11-24T23:41:59+08:00	15782	4468	20250	1479	21729	38880	55.89%	40.59%	34	39
8	新竹縣新豐鄉	2018-11-25T01:16:18+08:00	18567	5228	23795	1691	25486	45790	55.66%	40.55%	39	39
8	新竹縣新豐鄉	2018-11-25T06:27:52+08:00	18567	5228	23795	1691	25486	45790	55.66%	40.55%	39	39
8	新竹縣新豐鄉	2018-11-25T00:12:42+08:00	17922	5106	23028	1653	24681	44345	55.66%	40.41%	38	39
8	新竹縣新豐鄉	2018-11-24T22:28:37+08:00	9020	2527	11547	825	12372	22292	55.5%	40.46%	20	39
8	新竹縣新豐鄉	2018-11-25T00:03:30+08:00	16926	4821	21747	1551	23298	41822	55.71%	40.47%	36	39
8	新竹縣新豐鄉	2018-11-24T23:50:12+08:00	16334	4655	20989	1508	22497	40366	55.73%	40.46%	35	39
8	基隆市中山區	2018-11-24T23:10:59+08:00	13424	4226	17650	1367	19017	38033	50%	35.3%	33	35
8	基隆市中山區	2018-11-24T23:22:27+08:00	13424	4226	17650	1367	19017	38033	50%	35.3%	33	35
8	基隆市中山區	2018-11-24T23:18:31+08:00	13424	4226	17650	1367	19017	38033	50%	35.3%	33	35
8	基隆市中山區	2018-11-24T22:49:28+08:00	13424	4226	17650	1367	19017	38033	50%	35.3%	33	35
8	基隆市中山區	2018-11-24T23:33:54+08:00	14063	4436	18499	1420	19919	39910	49.91%	35.24%	34	35
8	基隆市中山區	2018-11-24T22:12:06+08:00	9682	3073	12755	991	13746	27411	50.15%	35.32%	26	35
8	基隆市中山區	2018-11-24T23:26:11+08:00	13424	4226	17650	1367	19017	38033	50%	35.3%	33	35
8	基隆市中山區	2018-11-24T22:28:44+08:00	12610	4082	16692	1334	18026	35945	50.15%	35.08%	32	35
8	基隆市中山區	2018-11-24T23:37:52+08:00	14063	4436	18499	1420	19919	39910	49.91%	35.24%	34	35
8	基隆市中山區	2018-11-24T22:53:19+08:00	13424	4226	17650	1367	19017	38033	50%	35.3%	33	35
8	基隆市中山區	2018-11-24T22:21:50+08:00	12187	3932	16119	1247	17366	34765	49.95%	35.06%	31	35
8	基隆市中山區	2018-11-25T04:01:33+08:00	14924	4550	19474	1463	20937	41856	50.02%	35.66%	35	35
8	基隆市中山區	2018-11-25T00:08:09+08:00	14924	4550	19474	1463	20937	41856	50.02%	35.66%	35	35
8	基隆市中山區	2018-11-24T23:46:07+08:00	14063	4436	18499	1420	19919	39910	49.91%	35.24%	34	35
8	基隆市中山區	2018-11-25T01:11:12+08:00	14924	4550	19474	1463	20937	41856	50.02%	35.66%	35	35
8	基隆市中山區	2018-11-24T23:00:20+08:00	13424	4226	17650	1367	19017	38033	50%	35.3%	33	35
8	基隆市中山區	2018-11-24T22:25:29+08:00	12610	4082	16692	1334	18026	35945	50.15%	35.08%	32	35
8	基隆市中山區	2018-11-25T06:22:48+08:00	14924	4550	19474	1463	20937	41856	50.02%	35.66%	35	35
8	基隆市中山區	2018-11-25T03:48:35+08:00	14924	4550	19474	1463	20937	41856	50.02%	35.66%	35	35
8	基隆市中山區	2018-11-25T06:27:59+08:00	14924	4550	19474	1463	20937	41856	50.02%	35.66%	35	35
8	基隆市中山區	2018-11-25T06:17:41+08:00	14924	4550	19474	1463	20937	41856	50.02%	35.66%	35	35
8	基隆市中山區	2018-11-24T22:39:13+08:00	12610	4082	16692	1334	18026	35945	50.15%	35.08%	32	35
8	基隆市中山區	2018-11-25T03:37:34+08:00	14924	4550	19474	1463	20937	41856	50.02%	35.66%	35	35
8	基隆市中山區	2018-11-25T00:12:49+08:00	14924	4550	19474	1463	20937	41856	50.02%	35.66%	35	35
8	基隆市中山區	2018-11-24T22:18:23+08:00	11159	3589	14748	1121	15869	31555	50.29%	35.36%	29	35
8	基隆市中山區	2018-11-24T23:50:18+08:00	14924	4550	19474	1463	20937	41856	50.02%	35.66%	35	35
8	基隆市中山區	2018-11-24T23:14:45+08:00	13424	4226	17650	1367	19017	38033	50%	35.3%	33	35
8	基隆市中山區	2018-11-24T23:58:46+08:00	14924	4550	19474	1463	20937	41856	50.02%	35.66%	35	35
8	基隆市中山區	2018-11-24T22:56:40+08:00	13424	4226	17650	1367	19017	38033	50%	35.3%	33	35
8	基隆市中山區	2018-11-24T23:03:50+08:00	13424	4226	17650	1367	19017	38033	50%	35.3%	33	35
8	基隆市中山區	2018-11-25T01:01:06+08:00	14924	4550	19474	1463	20937	41856	50.02%	35.66%	35	35
8	基隆市中山區	2018-11-25T01:24:29+08:00	14924	4550	19474	1463	20937	41856	50.02%	35.66%	35	35
8	基隆市中山區	2018-11-24T23:54:31+08:00	14924	4550	19474	1463	20937	41856	50.02%	35.66%	35	35
8	基隆市中山區	2018-11-24T23:07:23+08:00	13424	4226	17650	1367	19017	38033	50%	35.3%	33	35
8	基隆市中山區	2018-11-25T03:54:45+08:00	14924	4550	19474	1463	20937	41856	50.02%	35.66%	35	35
8	基隆市中山區	2018-11-25T00:03:40+08:00	14924	4550	19474	1463	20937	41856	50.02%	35.66%	35	35
8	基隆市中山區	2018-11-24T22:14:53+08:00	10483	3359	13842	1045	14887	29617	50.27%	35.4%	28	35
8	基隆市中山區	2018-11-25T06:12:40+08:00	14924	4550	19474	1463	20937	41856	50.02%	35.66%	35	35
8	基隆市中山區	2018-11-24T23:29:50+08:00	14063	4436	18499	1420	19919	39910	49.91%	35.24%	34	35
8	基隆市中山區	2018-11-25T00:17:12+08:00	14924	4550	19474	1463	20937	41856	50.02%	35.66%	35	35
8	基隆市中山區	2018-11-24T22:32:22+08:00	12610	4082	16692	1334	18026	35945	50.15%	35.08%	32	35
8	基隆市中山區	2018-11-24T23:42:05+08:00	14063	4436	18499	1420	19919	39910	49.91%	35.24%	34	35
8	基隆市中山區	2018-11-25T01:06:04+08:00	14924	4550	19474	1463	20937	41856	50.02%	35.66%	35	35
8	基隆市中山區	2018-11-25T03:42:52+08:00	14924	4550	19474	1463	20937	41856	50.02%	35.66%	35	35
8	基隆市中山區	2018-11-24T22:40:22+08:00	12610	4082	16692	1334	18026	35945	50.15%	35.08%	32	35
8	基隆市中山區	2018-11-25T00:21:48+08:00	14924	4550	19474	1463	20937	41856	50.02%	35.66%	35	35
8	基隆市中山區	2018-11-25T06:07:27+08:00	14924	4550	19474	1463	20937	41856	50.02%	35.66%	35	35
8	基隆市中山區	2018-11-25T00:56:17+08:00	14924	4550	19474	1463	20937	41856	50.02%	35.66%	35	35
8	基隆市中山區	2018-11-24T22:35:48+08:00	12610	4082	16692	1334	18026	35945	50.15%	35.08%	32	35
8	基隆市中山區	2018-11-24T22:43:54+08:00	12610	4082	16692	1334	18026	35945	50.15%	35.08%	32	35
8	基隆市中山區	2018-11-25T03:31:03+08:00	14924	4550	19474	1463	20937	41856	50.02%	35.66%	35	35
8	基隆市中山區	2018-11-25T01:16:26+08:00	14924	4550	19474	1463	20937	41856	50.02%	35.66%	35	35
8	苗栗縣公館鄉	2018-11-24T23:07:16+08:00	11979	3364	15343	1361	16704	28318	58.99%	42.3%	28	28
8	苗栗縣公館鄉	2018-11-24T22:12:00+08:00	10324	2955	13279	1211	14490	24514	59.11%	42.11%	25	28
8	苗栗縣公館鄉	2018-11-24T22:39:06+08:00	11499	3240	14739	1313	16052	27086	59.26%	42.45%	27	28
8	苗栗縣公館鄉	2018-11-24T23:58:39+08:00	11979	3364	15343	1361	16704	28318	58.99%	42.3%	28	28
8	苗栗縣公館鄉	2018-11-24T23:03:45+08:00	11979	3364	15343	1361	16704	28318	58.99%	42.3%	28	28
8	苗栗縣公館鄉	2018-11-24T22:49:21+08:00	11499	3240	14739	1313	16052	27086	59.26%	42.45%	27	28
8	苗栗縣公館鄉	2018-11-24T23:22:21+08:00	11979	3364	15343	1361	16704	28318	58.99%	42.3%	28	28
8	苗栗縣公館鄉	2018-11-25T01:24:22+08:00	11979	3364	15343	1361	16704	28318	58.99%	42.3%	28	28
8	苗栗縣公館鄉	2018-11-24T23:46:01+08:00	11979	3364	15343	1361	16704	28318	58.99%	42.3%	28	28
8	苗栗縣公館鄉	2018-11-25T03:48:26+08:00	11979	3364	15343	1361	16704	28318	58.99%	42.3%	28	28
8	苗栗縣公館鄉	2018-11-24T23:42:00+08:00	11979	3364	15343	1361	16704	28318	58.99%	42.3%	28	28
8	苗栗縣公館鄉	2018-11-25T03:30:56+08:00	11979	3364	15343	1361	16704	28318	58.99%	42.3%	28	28
8	苗栗縣公館鄉	2018-11-25T03:42:45+08:00	11979	3364	15343	1361	16704	28318	58.99%	42.3%	28	28
8	苗栗縣公館鄉	2018-11-24T22:32:16+08:00	10324	2955	13279	1211	14490	24514	59.11%	42.11%	25	28
8	苗栗縣公館鄉	2018-11-25T01:00:58+08:00	11979	3364	15343	1361	16704	28318	58.99%	42.3%	28	28
8	苗栗縣公館鄉	2018-11-24T22:25:21+08:00	10324	2955	13279	1211	14490	24514	59.11%	42.11%	25	28
8	苗栗縣公館鄉	2018-11-25T06:12:34+08:00	11979	3364	15343	1361	16704	28318	58.99%	42.3%	28	28
8	苗栗縣公館鄉	2018-11-24T22:40:16+08:00	11499	3240	14739	1313	16052	27086	59.26%	42.45%	27	28
8	苗栗縣公館鄉	2018-11-25T04:01:27+08:00	11979	3364	15343	1361	16704	28318	58.99%	42.3%	28	28
8	苗栗縣公館鄉	2018-11-24T22:21:43+08:00	10324	2955	13279	1211	14490	24514	59.11%	42.11%	25	28
8	苗栗縣公館鄉	2018-11-25T00:17:05+08:00	11979	3364	15343	1361	16704	28318	58.99%	42.3%	28	28
8	苗栗縣公館鄉	2018-11-25T00:21:42+08:00	11979	3364	15343	1361	16704	28318	58.99%	42.3%	28	28
8	苗栗縣公館鄉	2018-11-24T23:37:46+08:00	11979	3364	15343	1361	16704	28318	58.99%	42.3%	28	28
8	苗栗縣公館鄉	2018-11-24T22:35:42+08:00	10934	3074	14008	1257	15265	25764	59.25%	42.44%	26	28
8	苗栗縣公館鄉	2018-11-24T23:18:25+08:00	11979	3364	15343	1361	16704	28318	58.99%	42.3%	28	28
8	苗栗縣公館鄉	2018-11-24T23:26:04+08:00	11979	3364	15343	1361	16704	28318	58.99%	42.3%	28	28
8	苗栗縣公館鄉	2018-11-24T23:33:48+08:00	11979	3364	15343	1361	16704	28318	58.99%	42.3%	28	28
8	苗栗縣公館鄉	2018-11-25T03:54:38+08:00	11979	3364	15343	1361	16704	28318	58.99%	42.3%	28	28
8	苗栗縣公館鄉	2018-11-25T03:37:25+08:00	11979	3364	15343	1361	16704	28318	58.99%	42.3%	28	28
8	苗栗縣公館鄉	2018-11-24T23:10:54+08:00	11979	3364	15343	1361	16704	28318	58.99%	42.3%	28	28
8	苗栗縣公館鄉	2018-11-24T23:14:37+08:00	11979	3364	15343	1361	16704	28318	58.99%	42.3%	28	28
8	苗栗縣公館鄉	2018-11-25T06:17:33+08:00	11979	3364	15343	1361	16704	28318	58.99%	42.3%	28	28
8	苗栗縣公館鄉	2018-11-24T22:43:47+08:00	11499	3240	14739	1313	16052	27086	59.26%	42.45%	27	28
8	苗栗縣公館鄉	2018-11-24T22:56:34+08:00	11499	3240	14739	1313	16052	27086	59.26%	42.45%	27	28
8	苗栗縣公館鄉	2018-11-25T00:08:02+08:00	11979	3364	15343	1361	16704	28318	58.99%	42.3%	28	28
8	苗栗縣公館鄉	2018-11-24T22:53:12+08:00	11499	3240	14739	1313	16052	27086	59.26%	42.45%	27	28
8	苗栗縣公館鄉	2018-11-25T01:11:04+08:00	11979	3364	15343	1361	16704	28318	58.99%	42.3%	28	28
8	苗栗縣公館鄉	2018-11-24T23:29:43+08:00	11979	3364	15343	1361	16704	28318	58.99%	42.3%	28	28
8	苗栗縣公館鄉	2018-11-25T06:22:42+08:00	11979	3364	15343	1361	16704	28318	58.99%	42.3%	28	28
8	苗栗縣公館鄉	2018-11-25T06:07:20+08:00	11979	3364	15343	1361	16704	28318	58.99%	42.3%	28	28
8	苗栗縣公館鄉	2018-11-24T23:00:15+08:00	11979	3364	15343	1361	16704	28318	58.99%	42.3%	28	28
8	苗栗縣公館鄉	2018-11-25T01:05:56+08:00	11979	3364	15343	1361	16704	28318	58.99%	42.3%	28	28
8	苗栗縣公館鄉	2018-11-25T00:03:31+08:00	11979	3364	15343	1361	16704	28318	58.99%	42.3%	28	28
8	苗栗縣公館鄉	2018-11-24T23:54:25+08:00	11979	3364	15343	1361	16704	28318	58.99%	42.3%	28	28
8	苗栗縣公館鄉	2018-11-24T22:14:46+08:00	10324	2955	13279	1211	14490	24514	59.11%	42.11%	25	28
8	苗栗縣公館鄉	2018-11-25T06:27:52+08:00	11979	3364	15343	1361	16704	28318	58.99%	42.3%	28	28
8	苗栗縣公館鄉	2018-11-25T00:56:11+08:00	11979	3364	15343	1361	16704	28318	58.99%	42.3%	28	28
8	苗栗縣公館鄉	2018-11-24T22:18:17+08:00	10324	2955	13279	1211	14490	24514	59.11%	42.11%	25	28
8	苗栗縣公館鄉	2018-11-25T00:12:42+08:00	11979	3364	15343	1361	16704	28318	58.99%	42.3%	28	28
8	苗栗縣公館鄉	2018-11-24T22:28:37+08:00	10324	2955	13279	1211	14490	24514	59.11%	42.11%	25	28
8	苗栗縣公館鄉	2018-11-25T01:16:19+08:00	11979	3364	15343	1361	16704	28318	58.99%	42.3%	28	28
8	苗栗縣公館鄉	2018-11-24T23:50:12+08:00	11979	3364	15343	1361	16704	28318	58.99%	42.3%	28	28
8	桃園市龍潭區	2018-11-25T03:37:17+08:00	40185	10399	50584	3133	53717	101574	52.88%	39.56%	64	64
8	桃園市龍潭區	2018-11-25T01:10:58+08:00	38508	10074	48582	3032	51614	97911	52.72%	39.33%	62	64
8	桃園市龍潭區	2018-11-25T00:12:37+08:00	36333	9559	45892	2906	48798	92636	52.68%	39.22%	59	64
8	桃園市龍潭區	2018-11-24T22:49:17+08:00	23672	6292	29964	1940	31904	60938	52.35%	38.85%	41	64
8	桃園市龍潭區	2018-11-24T23:14:32+08:00	28487	7563	36050	2329	38379	73572	52.17%	38.72%	48	64
8	桃園市龍潭區	2018-11-24T22:43:43+08:00	22446	5855	28301	1868	30169	57557	52.42%	39%	39	64
8	桃園市龍潭區	2018-11-24T22:56:30+08:00	26073	6789	32862	2078	34940	66661	52.41%	39.11%	44	64
8	桃園市龍潭區	2018-11-25T06:22:37+08:00	40185	10399	50584	3133	53717	101574	52.88%	39.56%	64	64
8	桃園市龍潭區	2018-11-25T03:30:50+08:00	40185	10399	50584	3133	53717	101574	52.88%	39.56%	64	64
8	桃園市龍潭區	2018-11-25T03:48:21+08:00	40185	10399	50584	3133	53717	101574	52.88%	39.56%	64	64
8	桃園市龍潭區	2018-11-24T22:32:11+08:00	19748	5199	24947	1656	26603	50520	52.66%	39.09%	35	64
8	桃園市龍潭區	2018-11-24T23:29:39+08:00	30070	8018	38088	2454	40542	77483	52.32%	38.81%	50	64
8	桃園市龍潭區	2018-11-25T04:01:21+08:00	40185	10399	50584	3133	53717	101574	52.88%	39.56%	64	64
8	桃園市龍潭區	2018-11-24T22:25:17+08:00	19056	4993	24049	1579	25628	48794	52.52%	39.05%	34	64
8	桃園市龍潭區	2018-11-25T06:07:15+08:00	40185	10399	50584	3133	53717	101574	52.88%	39.56%	64	64
8	桃園市龍潭區	2018-11-24T22:18:12+08:00	19056	4993	24049	1579	25628	48794	52.52%	39.05%	34	64
8	桃園市龍潭區	2018-11-24T23:54:18+08:00	33772	8875	42647	2689	45336	86093	52.66%	39.23%	55	64
8	桃園市龍潭區	2018-11-25T00:07:57+08:00	35624	9354	44978	2846	47824	90844	52.64%	39.21%	58	64
8	桃園市龍潭區	2018-11-25T01:16:14+08:00	38508	10074	48582	3032	51614	97911	52.72%	39.33%	62	64
8	桃園市龍潭區	2018-11-24T23:41:55+08:00	31749	8428	40177	2566	42743	81494	52.45%	38.96%	52	64
8	桃園市龍潭區	2018-11-24T22:28:33+08:00	19056	4993	24049	1579	25628	48794	52.52%	39.05%	34	64
8	桃園市龍潭區	2018-11-24T23:58:34+08:00	34442	9063	43505	2751	46256	87814	52.67%	39.22%	56	64
8	桃園市龍潭區	2018-11-24T23:22:15+08:00	29258	7813	37071	2395	39466	75481	52.29%	38.76%	49	64
8	桃園市龍潭區	2018-11-25T01:24:16+08:00	38508	10074	48582	3032	51614	97911	52.72%	39.33%	62	64
8	桃園市龍潭區	2018-11-24T22:35:38+08:00	20239	5338	25577	1720	27297	51817	52.68%	39.06%	36	64
8	桃園市龍潭區	2018-11-24T23:07:12+08:00	28487	7563	36050	2329	38379	73572	52.17%	38.72%	48	64
8	桃園市龍潭區	2018-11-24T22:39:02+08:00	20955	5541	26496	1782	28278	53898	52.47%	38.88%	37	64
8	桃園市龍潭區	2018-11-25T00:56:05+08:00	37124	9732	46856	2938	49794	94333	52.79%	39.35%	60	64
8	桃園市龍潭區	2018-11-25T06:27:48+08:00	40185	10399	50584	3133	53717	101574	52.88%	39.56%	64	64
8	桃園市龍潭區	2018-11-24T23:50:07+08:00	33772	8875	42647	2689	45336	86093	52.66%	39.23%	55	64
8	桃園市龍潭區	2018-11-25T00:03:25+08:00	35144	9224	44368	2801	47169	89400	52.76%	39.31%	57	64
8	桃園市龍潭區	2018-11-24T23:03:41+08:00	28487	7563	36050	2329	38379	73572	52.17%	38.72%	48	64
8	桃園市龍潭區	2018-11-24T23:00:06+08:00	26743	6986	33729	2160	35889	68749	52.2%	38.9%	45	64
8	桃園市龍潭區	2018-11-24T22:21:38+08:00	19056	4993	24049	1579	25628	48794	52.52%	39.05%	34	64
8	桃園市龍潭區	2018-11-25T03:42:40+08:00	40185	10399	50584	3133	53717	101574	52.88%	39.56%	64	64
8	桃園市龍潭區	2018-11-25T00:21:36+08:00	36333	9559	45892	2906	48798	92636	52.68%	39.22%	59	64
8	桃園市龍潭區	2018-11-25T01:00:52+08:00	37124	9732	46856	2938	49794	94333	52.79%	39.35%	60	64
8	桃園市龍潭區	2018-11-25T06:12:30+08:00	40185	10399	50584	3133	53717	101574	52.88%	39.56%	64	64
8	桃園市龍潭區	2018-11-24T22:40:12+08:00	21518	5701	27219	1831	29050	55462	52.38%	38.8%	38	64
8	桃園市龍潭區	2018-11-25T00:17:01+08:00	36333	9559	45892	2906	48798	92636	52.68%	39.22%	59	64
8	桃園市龍潭區	2018-11-24T22:53:07+08:00	24577	6448	31025	1988	33013	62785	52.58%	39.14%	42	64
8	桃園市龍潭區	2018-11-24T22:11:56+08:00	18382	4830	23212	1529	24741	46989	52.65%	39.12%	33	64
8	桃園市龍潭區	2018-11-25T03:54:33+08:00	40185	10399	50584	3133	53717	101574	52.88%	39.56%	64	64
8	桃園市龍潭區	2018-11-25T01:05:51+08:00	38508	10074	48582	3032	51614	97911	52.72%	39.33%	62	64
8	桃園市龍潭區	2018-11-24T23:33:43+08:00	30898	8223	39121	2533	41654	79470	52.41%	38.88%	51	64
8	桃園市龍潭區	2018-11-24T23:18:20+08:00	28487	7563	36050	2329	38379	73572	52.17%	38.72%	48	64
8	桃園市龍潭區	2018-11-24T23:37:42+08:00	31749	8428	40177	2566	42743	81494	52.45%	38.96%	52	64
8	桃園市龍潭區	2018-11-24T22:14:41+08:00	19056	4993	24049	1579	25628	48794	52.52%	39.05%	34	64
8	桃園市龍潭區	2018-11-24T23:26:00+08:00	29258	7813	37071	2395	39466	75481	52.29%	38.76%	49	64
8	桃園市龍潭區	2018-11-24T23:10:49+08:00	28487	7563	36050	2329	38379	73572	52.17%	38.72%	48	64
8	桃園市龍潭區	2018-11-25T06:17:28+08:00	40185	10399	50584	3133	53717	101574	52.88%	39.56%	64	64
8	桃園市龍潭區	2018-11-24T23:45:57+08:00	33772	8875	42647	2689	45336	86093	52.66%	39.23%	55	64
8	臺北市大安區	2018-11-24T23:07:11+08:00	36632	12776	49408	2897	52305	93517	55.93%	39.17%	73	188
8	臺北市大安區	2018-11-25T01:05:49+08:00	76293	25760	102053	6088	108141	190629	56.73%	40.02%	144	188
8	臺北市大安區	2018-11-24T22:49:16+08:00	27838	9583	37421	2208	39629	71922	55.1%	38.71%	57	188
8	臺北市大安區	2018-11-24T22:43:42+08:00	24894	8569	33463	1961	35424	64402	55%	38.65%	51	188
8	臺北市大安區	2018-11-25T01:10:56+08:00	77789	26085	103874	6166	110040	193667	56.82%	40.17%	146	188
8	臺北市大安區	2018-11-24T22:39:00+08:00	24482	8446	32928	1931	34859	63403	54.98%	38.61%	50	188
8	臺北市大安區	2018-11-25T03:37:16+08:00	101321	33964	135285	8129	143414	252645	56.77%	40.1%	188	188
8	臺北市大安區	2018-11-25T01:10:57+08:00	77789	26085	103874	6166	110040	193667	56.82%	40.17%	146	188
8	臺北市大安區	2018-11-24T23:50:04+08:00	54983	18718	73701	4338	78039	138589	56.31%	39.67%	106	188
8	臺北市大安區	2018-11-25T01:24:14+08:00	78847	26396	105243	6215	111458	196222	56.8%	40.18%	148	188
8	臺北市大安區	2018-11-25T00:12:36+08:00	63333	21566	84899	5081	89980	159530	56.4%	39.7%	121	188
8	臺北市大安區	2018-11-24T22:32:10+08:00	22745	7850	30595	1786	32381	58969	54.91%	38.57%	47	188
8	臺北市大安區	2018-11-25T01:00:50+08:00	75709	25616	101325	6063	107388	189301	56.73%	39.99%	143	188
8	臺北市大安區	2018-11-24T23:29:38+08:00	49232	16864	66096	3921	70017	124778	56.11%	39.46%	96	188
8	臺北市大安區	2018-11-25T03:48:19+08:00	101321	33964	135285	8129	143414	252645	56.77%	40.1%	188	188
8	臺北市大安區	2018-11-25T06:22:36+08:00	101321	33964	135285	8129	143414	252645	56.77%	40.1%	188	188
8	臺北市大安區	2018-11-25T06:12:29+08:00	101321	33964	135285	8129	143414	252645	56.77%	40.1%	188	188
8	臺北市大安區	2018-11-25T00:21:35+08:00	66717	22635	89352	5396	94748	167725	56.49%	39.78%	127	188
8	臺北市大安區	2018-11-24T23:00:03+08:00	32256	11205	43461	2520	45981	82696	55.6%	39.01%	65	188
8	臺北市大安區	2018-11-25T03:48:20+08:00	101321	33964	135285	8129	143414	252645	56.77%	40.1%	188	188
8	臺北市大安區	2018-11-24T23:25:59+08:00	46767	16180	62947	3740	66687	118947	56.06%	39.32%	92	188
8	臺北市大安區	2018-11-24T23:00:04+08:00	32256	11205	43461	2520	45981	82696	55.6%	39.01%	65	188
8	臺北市大安區	2018-11-25T01:00:51+08:00	75709	25616	101325	6063	107388	189301	56.73%	39.99%	143	188
8	臺北市大安區	2018-11-25T06:07:14+08:00	101321	33964	135285	8129	143414	252645	56.77%	40.1%	188	188
8	臺北市大安區	2018-11-25T06:07:13+08:00	101321	33964	135285	8129	143414	252645	56.77%	40.1%	188	188
8	臺北市大安區	2018-11-24T22:53:05+08:00	28899	9933	38832	2281	41113	74336	55.31%	38.88%	59	188
8	臺北市大安區	2018-11-24T22:40:11+08:00	24482	8446	32928	1931	34859	63403	54.98%	38.61%	50	188
8	臺北市大安區	2018-11-24T22:25:16+08:00	21105	7319	28424	1688	30112	54903	54.85%	38.44%	44	188
8	臺北市大安區	2018-11-24T22:11:55+08:00	15305	5259	20564	1176	21740	40071	54.25%	38.19%	33	188
8	臺北市大安區	2018-11-25T04:01:20+08:00	101321	33964	135285	8129	143414	252645	56.77%	40.1%	188	188
8	臺北市大安區	2018-11-24T22:53:04+08:00	28899	9933	38832	2281	41113	74336	55.31%	38.88%	59	188
8	臺北市大安區	2018-11-25T01:16:12+08:00	78369	26224	104593	6189	110782	194913	56.84%	40.21%	147	188
8	臺北市大安區	2018-11-24T23:45:55+08:00	54466	18514	72980	4308	77288	137304	56.29%	39.67%	105	188
8	臺北市大安區	2018-11-24T23:37:41+08:00	50797	17357	68154	4039	72193	128498	56.18%	39.53%	99	188
8	臺北市大安區	2018-11-24T23:41:54+08:00	51980	17781	69761	4137	73898	131522	56.19%	39.52%	101	188
8	臺北市大安區	2018-11-24T23:54:16+08:00	54983	18718	73701	4338	78039	138589	56.31%	39.67%	106	188
8	臺北市大安區	2018-11-24T22:28:32+08:00	21571	7460	29031	1711	30742	56032	54.87%	38.5%	45	188
8	臺北市大安區	2018-11-24T23:41:53+08:00	51980	17781	69761	4137	73898	131522	56.19%	39.52%	101	188
8	臺北市大安區	2018-11-25T01:16:13+08:00	78369	26224	104593	6189	110782	194913	56.84%	40.21%	147	188
8	臺北市大安區	2018-11-25T03:54:31+08:00	101321	33964	135285	8129	143414	252645	56.77%	40.1%	188	188
8	臺北市大安區	2018-11-24T23:33:41+08:00	50797	17357	68154	4039	72193	128498	56.18%	39.53%	99	188
8	臺北市大安區	2018-11-24T23:54:17+08:00	54983	18718	73701	4338	78039	138589	56.31%	39.67%	106	188
8	臺北市大安區	2018-11-25T00:03:24+08:00	58827	20093	78920	4697	83617	148303	56.38%	39.67%	113	188
8	臺北市大安區	2018-11-24T22:35:36+08:00	23968	8292	32260	1891	34151	62007	55.08%	38.65%	49	188
8	臺北市大安區	2018-11-25T00:16:59+08:00	64485	21913	86398	5189	91587	162313	56.43%	39.73%	123	188
8	臺北市大安區	2018-11-24T23:58:33+08:00	58827	20093	78920	4697	83617	148303	56.38%	39.67%	113	188
8	臺北市大安區	2018-11-24T22:14:39+08:00	16600	5859	22459	1332	23791	44080	53.97%	37.66%	36	188
8	臺北市大安區	2018-11-24T22:43:41+08:00	24894	8569	33463	1961	35424	64402	55%	38.65%	51	188
8	臺北市大安區	2018-11-25T06:27:46+08:00	101321	33964	135285	8129	143414	252645	56.77%	40.1%	188	188
8	臺北市大安區	2018-11-24T22:49:15+08:00	27838	9583	37421	2208	39629	71922	55.1%	38.71%	57	188
8	臺北市大安區	2018-11-24T23:03:40+08:00	34429	11961	46390	2684	49074	87972	55.78%	39.14%	69	188
8	臺北市大安區	2018-11-24T23:14:30+08:00	38199	13353	51552	3009	54561	97647	55.88%	39.12%	76	188
8	臺北市大安區	2018-11-24T23:22:14+08:00	42938	14932	57870	3406	61276	109161	56.13%	39.33%	85	188
8	臺北市大安區	2018-11-24T23:58:32+08:00	58827	20093	78920	4697	83617	148303	56.38%	39.67%	113	188
8	臺北市大安區	2018-11-25T03:37:15+08:00	101321	33964	135285	8129	143414	252645	56.77%	40.1%	188	188
8	臺北市大安區	2018-11-25T00:56:03+08:00	74035	25083	99118	5914	105032	185108	56.74%	40%	140	188
8	臺北市大安區	2018-11-25T00:56:04+08:00	74035	25083	99118	5914	105032	185108	56.74%	40%	140	188
8	臺北市大安區	2018-11-24T23:14:31+08:00	38199	13353	51552	3009	54561	97647	55.88%	39.12%	76	188
8	臺北市大安區	2018-11-25T06:27:47+08:00	101321	33964	135285	8129	143414	252645	56.77%	40.1%	188	188
8	臺北市大安區	2018-11-24T22:21:36+08:00	19927	6991	26918	1619	28537	52208	54.66%	38.17%	42	188
8	臺北市大安區	2018-11-25T00:17:00+08:00	64485	21913	86398	5189	91587	162313	56.43%	39.73%	123	188
8	臺北市大安區	2018-11-25T03:42:37+08:00	101321	33964	135285	8129	143414	252645	56.77%	40.1%	188	188
8	臺北市大安區	2018-11-25T03:30:49+08:00	100908	33808	134716	8098	142814	251501	56.78%	40.12%	187	188
8	臺北市大安區	2018-11-25T03:42:36+08:00	101321	33964	135285	8129	143414	252645	56.77%	40.1%	188	188
8	臺北市大安區	2018-11-24T22:25:15+08:00	21105	7319	28424	1688	30112	54903	54.85%	38.44%	44	188
8	臺北市大安區	2018-11-24T22:18:11+08:00	17758	6277	24035	1431	25466	47018	54.16%	37.77%	38	188
8	臺北市大安區	2018-11-24T22:28:31+08:00	21571	7460	29031	1711	30742	56032	54.87%	38.5%	45	188
8	臺北市大安區	2018-11-24T23:10:48+08:00	37157	13004	50161	2939	53100	94946	55.93%	39.13%	74	188
8	臺北市大安區	2018-11-24T22:14:40+08:00	16600	5859	22459	1332	23791	44080	53.97%	37.66%	36	188
8	臺北市大安區	2018-11-25T06:17:27+08:00	101321	33964	135285	8129	143414	252645	56.77%	40.1%	188	188
8	臺北市大安區	2018-11-24T22:56:29+08:00	30100	10405	40505	2347	42852	77316	55.42%	38.93%	61	188
8	臺北市大安區	2018-11-24T23:18:18+08:00	40421	14103	54524	3195	57719	103020	56.03%	39.24%	80	188
8	臺北市大安區	2018-11-24T23:45:56+08:00	54466	18514	72980	4308	77288	137304	56.29%	39.67%	105	188
8	臺北市大安區	2018-11-24T23:03:39+08:00	34429	11961	46390	2684	49074	87972	55.78%	39.14%	69	188
8	臺北市大安區	2018-11-25T00:07:55+08:00	58827	20093	78920	4697	83617	148303	56.38%	39.67%	113	188
8	臺北市大安區	2018-11-24T23:33:42+08:00	50797	17357	68154	4039	72193	128498	56.18%	39.53%	99	188
8	臺北市大安區	2018-11-24T23:10:49+08:00	37157	13004	50161	2939	53100	94946	55.93%	39.13%	74	188
8	臺北市大安區	2018-11-24T22:18:10+08:00	17758	6277	24035	1431	25466	47018	54.16%	37.77%	38	188
8	臺北市大安區	2018-11-24T23:18:19+08:00	40421	14103	54524	3195	57719	103020	56.03%	39.24%	80	188
8	臺中市中區	2018-11-25T03:37:17+08:00	5704	1769	7473	656	8129	14696	55.31%	38.81%	12	12
8	臺中市中區	2018-11-24T23:10:50+08:00	5704	1769	7473	656	8129	14696	55.31%	38.81%	12	12
8	臺中市中區	2018-11-25T00:56:06+08:00	5704	1769	7473	656	8129	14696	55.31%	38.81%	12	12
8	臺中市中區	2018-11-24T23:22:16+08:00	5704	1769	7473	656	8129	14696	55.31%	38.81%	12	12
8	臺中市中區	2018-11-25T01:10:58+08:00	5704	1769	7473	656	8129	14696	55.31%	38.81%	12	12
8	臺中市中區	2018-11-25T00:12:37+08:00	5704	1769	7473	656	8129	14696	55.31%	38.81%	12	12
8	臺中市中區	2018-11-24T22:49:17+08:00	5704	1769	7473	656	8129	14696	55.31%	38.81%	12	12
8	臺中市中區	2018-11-24T23:14:32+08:00	5704	1769	7473	656	8129	14696	55.31%	38.81%	12	12
8	臺中市中區	2018-11-24T22:43:43+08:00	5704	1769	7473	656	8129	14696	55.31%	38.81%	12	12
8	臺中市中區	2018-11-25T00:03:26+08:00	5704	1769	7473	656	8129	14696	55.31%	38.81%	12	12
8	臺中市中區	2018-11-24T22:56:30+08:00	5704	1769	7473	656	8129	14696	55.31%	38.81%	12	12
8	臺中市中區	2018-11-25T03:48:21+08:00	5704	1769	7473	656	8129	14696	55.31%	38.81%	12	12
8	臺中市中區	2018-11-25T06:22:38+08:00	5704	1769	7473	656	8129	14696	55.31%	38.81%	12	12
8	臺中市中區	2018-11-25T03:30:51+08:00	5704	1769	7473	656	8129	14696	55.31%	38.81%	12	12
8	臺中市中區	2018-11-24T22:32:11+08:00	5035	1519	6554	563	7117	13044	54.56%	38.6%	11	12
8	臺中市中區	2018-11-25T04:01:21+08:00	5704	1769	7473	656	8129	14696	55.31%	38.81%	12	12
8	臺中市中區	2018-11-24T22:25:17+08:00	5035	1519	6554	563	7117	13044	54.56%	38.6%	11	12
8	臺中市中區	2018-11-25T06:07:15+08:00	5704	1769	7473	656	8129	14696	55.31%	38.81%	12	12
8	臺中市中區	2018-11-24T23:29:40+08:00	5704	1769	7473	656	8129	14696	55.31%	38.81%	12	12
8	臺中市中區	2018-11-24T22:18:12+08:00	5035	1519	6554	563	7117	13044	54.56%	38.6%	11	12
8	臺中市中區	2018-11-24T23:54:18+08:00	5704	1769	7473	656	8129	14696	55.31%	38.81%	12	12
8	臺中市中區	2018-11-25T00:07:57+08:00	5704	1769	7473	656	8129	14696	55.31%	38.81%	12	12
8	臺中市中區	2018-11-25T01:16:14+08:00	5704	1769	7473	656	8129	14696	55.31%	38.81%	12	12
8	臺中市中區	2018-11-24T23:41:55+08:00	5704	1769	7473	656	8129	14696	55.31%	38.81%	12	12
8	臺中市中區	2018-11-24T22:28:33+08:00	5035	1519	6554	563	7117	13044	54.56%	38.6%	11	12
8	臺中市中區	2018-11-24T23:58:34+08:00	5704	1769	7473	656	8129	14696	55.31%	38.81%	12	12
8	臺中市中區	2018-11-24T23:50:08+08:00	5704	1769	7473	656	8129	14696	55.31%	38.81%	12	12
8	臺中市中區	2018-11-25T01:24:16+08:00	5704	1769	7473	656	8129	14696	55.31%	38.81%	12	12
8	臺中市中區	2018-11-24T22:35:38+08:00	5704	1769	7473	656	8129	14696	55.31%	38.81%	12	12
8	臺中市中區	2018-11-24T23:07:12+08:00	5704	1769	7473	656	8129	14696	55.31%	38.81%	12	12
8	臺中市中區	2018-11-24T22:39:02+08:00	5704	1769	7473	656	8129	14696	55.31%	38.81%	12	12
8	臺中市中區	2018-11-25T06:27:48+08:00	5704	1769	7473	656	8129	14696	55.31%	38.81%	12	12
8	臺中市中區	2018-11-24T23:03:41+08:00	5704	1769	7473	656	8129	14696	55.31%	38.81%	12	12
8	臺中市中區	2018-11-25T01:00:53+08:00	5704	1769	7473	656	8129	14696	55.31%	38.81%	12	12
8	臺中市中區	2018-11-24T22:21:38+08:00	5035	1519	6554	563	7117	13044	54.56%	38.6%	11	12
8	臺中市中區	2018-11-25T03:42:40+08:00	5704	1769	7473	656	8129	14696	55.31%	38.81%	12	12
8	臺中市中區	2018-11-24T23:00:07+08:00	5704	1769	7473	656	8129	14696	55.31%	38.81%	12	12
8	臺中市中區	2018-11-25T00:21:36+08:00	5704	1769	7473	656	8129	14696	55.31%	38.81%	12	12
8	臺中市中區	2018-11-25T06:12:30+08:00	5704	1769	7473	656	8129	14696	55.31%	38.81%	12	12
8	臺中市中區	2018-11-24T22:40:12+08:00	5704	1769	7473	656	8129	14696	55.31%	38.81%	12	12
8	臺中市中區	2018-11-25T00:17:01+08:00	5704	1769	7473	656	8129	14696	55.31%	38.81%	12	12
8	臺中市中區	2018-11-24T22:53:07+08:00	5704	1769	7473	656	8129	14696	55.31%	38.81%	12	12
8	臺中市中區	2018-11-24T22:11:56+08:00	5035	1519	6554	563	7117	13044	54.56%	38.6%	11	12
8	臺中市中區	2018-11-25T03:54:33+08:00	5704	1769	7473	656	8129	14696	55.31%	38.81%	12	12
8	臺中市中區	2018-11-25T01:05:51+08:00	5704	1769	7473	656	8129	14696	55.31%	38.81%	12	12
8	臺中市中區	2018-11-24T23:33:43+08:00	5704	1769	7473	656	8129	14696	55.31%	38.81%	12	12
8	臺中市中區	2018-11-24T23:18:20+08:00	5704	1769	7473	656	8129	14696	55.31%	38.81%	12	12
8	臺中市中區	2018-11-25T06:17:29+08:00	5704	1769	7473	656	8129	14696	55.31%	38.81%	12	12
8	臺中市中區	2018-11-24T23:37:42+08:00	5704	1769	7473	656	8129	14696	55.31%	38.81%	12	12
8	臺中市中區	2018-11-24T22:14:41+08:00	5035	1519	6554	563	7117	13044	54.56%	38.6%	11	12
8	臺中市中區	2018-11-24T23:26:00+08:00	5704	1769	7473	656	8129	14696	55.31%	38.81%	12	12
8	臺中市中區	2018-11-24T23:45:57+08:00	5704	1769	7473	656	8129	14696	55.31%	38.81%	12	12
8	臺中市大甲區	2018-11-24T23:10:50+08:00	25384	7620	33004	3018	36022	63069	57.12%	40.25%	54	54
8	臺中市大甲區	2018-11-25T00:56:06+08:00	25384	7620	33004	3018	36022	63069	57.12%	40.25%	54	54
8	臺中市大甲區	2018-11-24T23:22:16+08:00	25384	7620	33004	3018	36022	63069	57.12%	40.25%	54	54
8	臺中市大甲區	2018-11-24T22:49:17+08:00	23861	7215	31076	2892	33968	59537	57.05%	40.08%	52	54
8	臺中市大甲區	2018-11-24T23:14:32+08:00	25384	7620	33004	3018	36022	63069	57.12%	40.25%	54	54
8	臺中市大甲區	2018-11-25T03:37:18+08:00	25384	7620	33004	3018	36022	63069	57.12%	40.25%	54	54
8	臺中市大甲區	2018-11-24T22:43:43+08:00	23861	7215	31076	2892	33968	59537	57.05%	40.08%	52	54
8	臺中市大甲區	2018-11-25T00:03:26+08:00	25384	7620	33004	3018	36022	63069	57.12%	40.25%	54	54
8	臺中市大甲區	2018-11-25T01:10:59+08:00	25384	7620	33004	3018	36022	63069	57.12%	40.25%	54	54
8	臺中市大甲區	2018-11-24T22:56:30+08:00	24541	7419	31960	2956	34916	61135	57.11%	40.14%	53	54
8	臺中市大甲區	2018-11-25T00:12:38+08:00	25384	7620	33004	3018	36022	63069	57.12%	40.25%	54	54
8	臺中市大甲區	2018-11-25T06:22:39+08:00	25384	7620	33004	3018	36022	63069	57.12%	40.25%	54	54
8	臺中市大甲區	2018-11-25T03:30:51+08:00	25384	7620	33004	3018	36022	63069	57.12%	40.25%	54	54
8	臺中市大甲區	2018-11-24T22:25:17+08:00	23861	7215	31076	2892	33968	59537	57.05%	40.08%	52	54
8	臺中市大甲區	2018-11-24T23:29:40+08:00	25384	7620	33004	3018	36022	63069	57.12%	40.25%	54	54
8	臺中市大甲區	2018-11-24T23:54:18+08:00	25384	7620	33004	3018	36022	63069	57.12%	40.25%	54	54
8	臺中市大甲區	2018-11-25T00:07:57+08:00	25384	7620	33004	3018	36022	63069	57.12%	40.25%	54	54
8	臺中市大甲區	2018-11-25T01:16:14+08:00	25384	7620	33004	3018	36022	63069	57.12%	40.25%	54	54
8	臺中市大甲區	2018-11-24T22:18:13+08:00	23349	7055	30404	2839	33243	58370	56.95%	40%	51	54
8	臺中市大甲區	2018-11-24T23:41:55+08:00	25384	7620	33004	3018	36022	63069	57.12%	40.25%	54	54
8	臺中市大甲區	2018-11-24T22:28:33+08:00	23861	7215	31076	2892	33968	59537	57.05%	40.08%	52	54
8	臺中市大甲區	2018-11-24T23:58:34+08:00	25384	7620	33004	3018	36022	63069	57.12%	40.25%	54	54
8	臺中市大甲區	2018-11-24T23:50:08+08:00	25384	7620	33004	3018	36022	63069	57.12%	40.25%	54	54
8	臺中市大甲區	2018-11-25T01:24:16+08:00	25384	7620	33004	3018	36022	63069	57.12%	40.25%	54	54
8	臺中市大甲區	2018-11-24T23:07:12+08:00	25384	7620	33004	3018	36022	63069	57.12%	40.25%	54	54
8	臺中市大甲區	2018-11-24T22:39:02+08:00	23861	7215	31076	2892	33968	59537	57.05%	40.08%	52	54
8	臺中市大甲區	2018-11-25T06:27:48+08:00	25384	7620	33004	3018	36022	63069	57.12%	40.25%	54	54
8	臺中市大甲區	2018-11-24T22:35:39+08:00	23861	7215	31076	2892	33968	59537	57.05%	40.08%	52	54
8	臺中市大甲區	2018-11-24T23:03:41+08:00	25384	7620	33004	3018	36022	63069	57.12%	40.25%	54	54
8	臺中市大甲區	2018-11-25T01:00:53+08:00	25384	7620	33004	3018	36022	63069	57.12%	40.25%	54	54
8	臺中市大甲區	2018-11-25T03:48:22+08:00	25384	7620	33004	3018	36022	63069	57.12%	40.25%	54	54
8	臺中市大甲區	2018-11-25T00:21:37+08:00	25384	7620	33004	3018	36022	63069	57.12%	40.25%	54	54
8	臺中市大甲區	2018-11-24T22:21:38+08:00	23861	7215	31076	2892	33968	59537	57.05%	40.08%	52	54
8	臺中市大甲區	2018-11-25T03:42:40+08:00	25384	7620	33004	3018	36022	63069	57.12%	40.25%	54	54
8	臺中市大甲區	2018-11-24T23:00:07+08:00	24541	7419	31960	2956	34916	61135	57.11%	40.14%	53	54
8	臺中市大甲區	2018-11-24T22:32:12+08:00	23861	7215	31076	2892	33968	59537	57.05%	40.08%	52	54
8	臺中市大甲區	2018-11-25T04:01:22+08:00	25384	7620	33004	3018	36022	63069	57.12%	40.25%	54	54
8	臺中市大甲區	2018-11-25T00:17:01+08:00	25384	7620	33004	3018	36022	63069	57.12%	40.25%	54	54
8	臺中市大甲區	2018-11-24T22:40:13+08:00	23861	7215	31076	2892	33968	59537	57.05%	40.08%	52	54
8	臺中市大甲區	2018-11-24T22:53:07+08:00	23861	7215	31076	2892	33968	59537	57.05%	40.08%	52	54
8	臺中市大甲區	2018-11-25T06:12:31+08:00	25384	7620	33004	3018	36022	63069	57.12%	40.25%	54	54
8	臺中市大甲區	2018-11-24T22:11:56+08:00	22841	6889	29730	2802	32532	57039	57.03%	40.04%	50	54
8	臺中市大甲區	2018-11-25T06:07:16+08:00	25384	7620	33004	3018	36022	63069	57.12%	40.25%	54	54
8	臺中市大甲區	2018-11-25T03:54:33+08:00	25384	7620	33004	3018	36022	63069	57.12%	40.25%	54	54
8	臺中市大甲區	2018-11-25T01:05:51+08:00	25384	7620	33004	3018	36022	63069	57.12%	40.25%	54	54
8	臺中市大甲區	2018-11-24T23:26:01+08:00	25384	7620	33004	3018	36022	63069	57.12%	40.25%	54	54
8	臺中市大甲區	2018-11-24T23:33:43+08:00	25384	7620	33004	3018	36022	63069	57.12%	40.25%	54	54
8	臺中市大甲區	2018-11-24T23:18:20+08:00	25384	7620	33004	3018	36022	63069	57.12%	40.25%	54	54
8	臺中市大甲區	2018-11-25T06:17:29+08:00	25384	7620	33004	3018	36022	63069	57.12%	40.25%	54	54
8	臺中市大甲區	2018-11-24T23:37:42+08:00	25384	7620	33004	3018	36022	63069	57.12%	40.25%	54	54
8	臺中市大甲區	2018-11-24T22:14:41+08:00	23349	7055	30404	2839	33243	58370	56.95%	40%	51	54
8	臺中市大甲區	2018-11-24T23:45:57+08:00	25384	7620	33004	3018	36022	63069	57.12%	40.25%	54	54
8	高雄市湖內區	2018-11-24T22:49:20+08:00	9563	3311	12874	1074	13948	25729	54.21%	37.17%	24	24
8	高雄市湖內區	2018-11-25T03:37:21+08:00	9563	3311	12874	1074	13948	25729	54.21%	37.17%	24	24
8	高雄市湖內區	2018-11-24T23:03:44+08:00	9563	3311	12874	1074	13948	25729	54.21%	37.17%	24	24
8	高雄市湖內區	2018-11-25T00:03:29+08:00	9563	3311	12874	1074	13948	25729	54.21%	37.17%	24	24
8	高雄市湖內區	2018-11-25T00:56:09+08:00	9563	3311	12874	1074	13948	25729	54.21%	37.17%	24	24
8	高雄市湖內區	2018-11-24T23:58:38+08:00	9563	3311	12874	1074	13948	25729	54.21%	37.17%	24	24
8	高雄市湖內區	2018-11-24T23:22:19+08:00	9563	3311	12874	1074	13948	25729	54.21%	37.17%	24	24
8	高雄市湖內區	2018-11-25T03:42:44+08:00	9563	3311	12874	1074	13948	25729	54.21%	37.17%	24	24
8	高雄市湖內區	2018-11-24T22:53:10+08:00	9563	3311	12874	1074	13948	25729	54.21%	37.17%	24	24
8	高雄市湖內區	2018-11-25T01:00:57+08:00	9563	3311	12874	1074	13948	25729	54.21%	37.17%	24	24
8	高雄市湖內區	2018-11-25T00:08:00+08:00	9563	3311	12874	1074	13948	25729	54.21%	37.17%	24	24
8	高雄市湖內區	2018-11-24T23:46:00+08:00	9563	3311	12874	1074	13948	25729	54.21%	37.17%	24	24
8	高雄市湖內區	2018-11-24T22:21:42+08:00	9112	3164	12276	1036	13312	24712	53.87%	36.87%	23	24
8	高雄市湖內區	2018-11-25T06:12:33+08:00	9563	3311	12874	1074	13948	25729	54.21%	37.17%	24	24
8	高雄市湖內區	2018-11-25T00:17:04+08:00	9563	3311	12874	1074	13948	25729	54.21%	37.17%	24	24
8	高雄市湖內區	2018-11-25T06:22:41+08:00	9563	3311	12874	1074	13948	25729	54.21%	37.17%	24	24
8	高雄市湖內區	2018-11-24T22:25:20+08:00	9112	3164	12276	1036	13312	24712	53.87%	36.87%	23	24
8	高雄市湖內區	2018-11-24T23:18:23+08:00	9563	3311	12874	1074	13948	25729	54.21%	37.17%	24	24
8	高雄市湖內區	2018-11-25T01:05:55+08:00	9563	3311	12874	1074	13948	25729	54.21%	37.17%	24	24
8	高雄市湖內區	2018-11-24T23:50:11+08:00	9563	3311	12874	1074	13948	25729	54.21%	37.17%	24	24
8	高雄市湖內區	2018-11-24T22:14:45+08:00	9112	3164	12276	1036	13312	24712	53.87%	36.87%	23	24
8	高雄市湖內區	2018-11-24T23:33:46+08:00	9563	3311	12874	1074	13948	25729	54.21%	37.17%	24	24
8	高雄市湖內區	2018-11-25T06:27:51+08:00	9563	3311	12874	1074	13948	25729	54.21%	37.17%	24	24
8	高雄市湖內區	2018-11-24T23:26:03+08:00	9563	3311	12874	1074	13948	25729	54.21%	37.17%	24	24
8	高雄市湖內區	2018-11-25T03:54:36+08:00	9563	3311	12874	1074	13948	25729	54.21%	37.17%	24	24
8	高雄市湖內區	2018-11-25T00:12:41+08:00	9563	3311	12874	1074	13948	25729	54.21%	37.17%	24	24
8	高雄市湖內區	2018-11-25T01:24:20+08:00	9563	3311	12874	1074	13948	25729	54.21%	37.17%	24	24
8	高雄市湖內區	2018-11-24T22:43:46+08:00	9563	3311	12874	1074	13948	25729	54.21%	37.17%	24	24
8	高雄市湖內區	2018-11-25T06:17:32+08:00	9563	3311	12874	1074	13948	25729	54.21%	37.17%	24	24
8	高雄市湖內區	2018-11-24T23:07:15+08:00	9563	3311	12874	1074	13948	25729	54.21%	37.17%	24	24
8	高雄市湖內區	2018-11-24T22:39:05+08:00	9112	3164	12276	1036	13312	24712	53.87%	36.87%	23	24
8	高雄市湖內區	2018-11-24T22:56:33+08:00	9563	3311	12874	1074	13948	25729	54.21%	37.17%	24	24
8	高雄市湖內區	2018-11-24T23:14:36+08:00	9563	3311	12874	1074	13948	25729	54.21%	37.17%	24	24
8	高雄市湖內區	2018-11-24T23:10:52+08:00	9563	3311	12874	1074	13948	25729	54.21%	37.17%	24	24
8	高雄市湖內區	2018-11-25T03:48:25+08:00	9563	3311	12874	1074	13948	25729	54.21%	37.17%	24	24
8	高雄市湖內區	2018-11-24T22:32:14+08:00	9112	3164	12276	1036	13312	24712	53.87%	36.87%	23	24
8	高雄市湖內區	2018-11-25T03:30:54+08:00	9563	3311	12874	1074	13948	25729	54.21%	37.17%	24	24
8	高雄市湖內區	2018-11-24T22:40:15+08:00	9563	3311	12874	1074	13948	25729	54.21%	37.17%	24	24
8	高雄市湖內區	2018-11-25T00:21:40+08:00	9563	3311	12874	1074	13948	25729	54.21%	37.17%	24	24
8	高雄市湖內區	2018-11-24T23:29:42+08:00	9563	3311	12874	1074	13948	25729	54.21%	37.17%	24	24
8	高雄市湖內區	2018-11-25T01:11:02+08:00	9563	3311	12874	1074	13948	25729	54.21%	37.17%	24	24
8	高雄市湖內區	2018-11-25T04:01:25+08:00	9563	3311	12874	1074	13948	25729	54.21%	37.17%	24	24
8	高雄市湖內區	2018-11-24T22:11:59+08:00	9112	3164	12276	1036	13312	24712	53.87%	36.87%	23	24
8	高雄市湖內區	2018-11-24T23:00:14+08:00	9563	3311	12874	1074	13948	25729	54.21%	37.17%	24	24
8	高雄市湖內區	2018-11-25T06:07:19+08:00	9563	3311	12874	1074	13948	25729	54.21%	37.17%	24	24
8	高雄市湖內區	2018-11-24T22:28:36+08:00	9112	3164	12276	1036	13312	24712	53.87%	36.87%	23	24
8	高雄市湖內區	2018-11-24T22:18:16+08:00	9112	3164	12276	1036	13312	24712	53.87%	36.87%	23	24
8	高雄市湖內區	2018-11-24T23:54:23+08:00	9563	3311	12874	1074	13948	25729	54.21%	37.17%	24	24
8	高雄市湖內區	2018-11-24T22:35:41+08:00	9112	3164	12276	1036	13312	24712	53.87%	36.87%	23	24
8	高雄市湖內區	2018-11-24T23:37:45+08:00	9563	3311	12874	1074	13948	25729	54.21%	37.17%	24	24
8	高雄市湖內區	2018-11-24T23:41:58+08:00	9563	3311	12874	1074	13948	25729	54.21%	37.17%	24	24
8	高雄市湖內區	2018-11-25T01:16:17+08:00	9563	3311	12874	1074	13948	25729	54.21%	37.17%	24	24
8	高雄市內門區	2018-11-24T22:49:20+08:00	4045	1307	5352	732	6084	13002	46.79%	31.11%	18	18
8	高雄市內門區	2018-11-24T23:03:44+08:00	4045	1307	5352	732	6084	13002	46.79%	31.11%	18	18
8	高雄市內門區	2018-11-24T23:22:20+08:00	4045	1307	5352	732	6084	13002	46.79%	31.11%	18	18
8	高雄市內門區	2018-11-24T23:58:38+08:00	4045	1307	5352	732	6084	13002	46.79%	31.11%	18	18
8	高雄市內門區	2018-11-25T03:42:44+08:00	4045	1307	5352	732	6084	13002	46.79%	31.11%	18	18
8	高雄市內門區	2018-11-25T01:00:57+08:00	4045	1307	5352	732	6084	13002	46.79%	31.11%	18	18
8	高雄市內門區	2018-11-24T22:53:11+08:00	4045	1307	5352	732	6084	13002	46.79%	31.11%	18	18
8	高雄市內門區	2018-11-24T23:46:00+08:00	4045	1307	5352	732	6084	13002	46.79%	31.11%	18	18
8	高雄市內門區	2018-11-25T00:08:01+08:00	4045	1307	5352	732	6084	13002	46.79%	31.11%	18	18
8	高雄市內門區	2018-11-24T22:21:42+08:00	4045	1307	5352	732	6084	13002	46.79%	31.11%	18	18
8	高雄市內門區	2018-11-25T06:12:33+08:00	4045	1307	5352	732	6084	13002	46.79%	31.11%	18	18
8	高雄市內門區	2018-11-25T00:17:04+08:00	4045	1307	5352	732	6084	13002	46.79%	31.11%	18	18
8	高雄市內門區	2018-11-24T22:25:20+08:00	4045	1307	5352	732	6084	13002	46.79%	31.11%	18	18
8	高雄市內門區	2018-11-24T23:18:24+08:00	4045	1307	5352	732	6084	13002	46.79%	31.11%	18	18
8	高雄市內門區	2018-11-25T03:54:37+08:00	4045	1307	5352	732	6084	13002	46.79%	31.11%	18	18
8	高雄市內門區	2018-11-24T23:33:47+08:00	4045	1307	5352	732	6084	13002	46.79%	31.11%	18	18
8	高雄市內門區	2018-11-25T01:05:55+08:00	4045	1307	5352	732	6084	13002	46.79%	31.11%	18	18
8	高雄市內門區	2018-11-24T23:50:11+08:00	4045	1307	5352	732	6084	13002	46.79%	31.11%	18	18
8	高雄市內門區	2018-11-24T23:26:04+08:00	4045	1307	5352	732	6084	13002	46.79%	31.11%	18	18
8	高雄市內門區	2018-11-24T22:14:45+08:00	3462	1086	4548	590	5138	11280	45.55%	30.69%	17	18
8	高雄市內門區	2018-11-25T01:24:20+08:00	4045	1307	5352	732	6084	13002	46.79%	31.11%	18	18
8	高雄市內門區	2018-11-24T22:43:46+08:00	4045	1307	5352	732	6084	13002	46.79%	31.11%	18	18
8	高雄市內門區	2018-11-25T06:17:32+08:00	4045	1307	5352	732	6084	13002	46.79%	31.11%	18	18
8	高雄市內門區	2018-11-25T03:37:22+08:00	4045	1307	5352	732	6084	13002	46.79%	31.11%	18	18
8	高雄市內門區	2018-11-24T23:07:15+08:00	4045	1307	5352	732	6084	13002	46.79%	31.11%	18	18
8	高雄市內門區	2018-11-24T22:39:05+08:00	4045	1307	5352	732	6084	13002	46.79%	31.11%	18	18
8	高雄市內門區	2018-11-24T23:10:53+08:00	4045	1307	5352	732	6084	13002	46.79%	31.11%	18	18
8	高雄市內門區	2018-11-24T22:56:33+08:00	4045	1307	5352	732	6084	13002	46.79%	31.11%	18	18
8	高雄市內門區	2018-11-24T23:14:36+08:00	4045	1307	5352	732	6084	13002	46.79%	31.11%	18	18
8	高雄市內門區	2018-11-25T03:48:25+08:00	4045	1307	5352	732	6084	13002	46.79%	31.11%	18	18
8	高雄市內門區	2018-11-25T03:30:55+08:00	4045	1307	5352	732	6084	13002	46.79%	31.11%	18	18
8	高雄市內門區	2018-11-24T22:32:15+08:00	4045	1307	5352	732	6084	13002	46.79%	31.11%	18	18
8	高雄市內門區	2018-11-24T22:40:15+08:00	4045	1307	5352	732	6084	13002	46.79%	31.11%	18	18
8	高雄市內門區	2018-11-25T04:01:25+08:00	4045	1307	5352	732	6084	13002	46.79%	31.11%	18	18
8	高雄市內門區	2018-11-24T22:11:59+08:00	3462	1086	4548	590	5138	11280	45.55%	30.69%	17	18
8	高雄市內門區	2018-11-24T23:00:14+08:00	4045	1307	5352	732	6084	13002	46.79%	31.11%	18	18
8	高雄市內門區	2018-11-25T06:07:19+08:00	4045	1307	5352	732	6084	13002	46.79%	31.11%	18	18
8	高雄市內門區	2018-11-25T01:11:03+08:00	4045	1307	5352	732	6084	13002	46.79%	31.11%	18	18
8	高雄市內門區	2018-11-24T23:29:43+08:00	4045	1307	5352	732	6084	13002	46.79%	31.11%	18	18
8	高雄市內門區	2018-11-25T00:21:41+08:00	4045	1307	5352	732	6084	13002	46.79%	31.11%	18	18
8	高雄市內門區	2018-11-25T06:22:42+08:00	4045	1307	5352	732	6084	13002	46.79%	31.11%	18	18
8	高雄市內門區	2018-11-24T22:28:36+08:00	4045	1307	5352	732	6084	13002	46.79%	31.11%	18	18
8	高雄市內門區	2018-11-25T00:56:10+08:00	4045	1307	5352	732	6084	13002	46.79%	31.11%	18	18
8	高雄市內門區	2018-11-24T22:18:16+08:00	3462	1086	4548	590	5138	11280	45.55%	30.69%	17	18
8	高雄市內門區	2018-11-24T23:54:24+08:00	4045	1307	5352	732	6084	13002	46.79%	31.11%	18	18
8	高雄市內門區	2018-11-24T22:35:41+08:00	4045	1307	5352	732	6084	13002	46.79%	31.11%	18	18
8	高雄市內門區	2018-11-25T01:16:18+08:00	4045	1307	5352	732	6084	13002	46.79%	31.11%	18	18
8	高雄市內門區	2018-11-24T23:37:45+08:00	4045	1307	5352	732	6084	13002	46.79%	31.11%	18	18
8	高雄市內門區	2018-11-24T23:41:58+08:00	4045	1307	5352	732	6084	13002	46.79%	31.11%	18	18
8	高雄市內門區	2018-11-25T06:27:52+08:00	4045	1307	5352	732	6084	13002	46.79%	31.11%	18	18
8	高雄市內門區	2018-11-25T00:12:42+08:00	4045	1307	5352	732	6084	13002	46.79%	31.11%	18	18
8	高雄市內門區	2018-11-25T00:03:30+08:00	4045	1307	5352	732	6084	13002	46.79%	31.11%	18	18
8	嘉義縣	2018-11-24T22:39:08+08:00	101259	34136	135395	17773	153168	313126	48.92%	32.34%	395	486
8	嘉義縣	2018-11-24T23:07:18+08:00	113564	38120	151684	19541	171225	349414	49%	32.5%	423	486
8	嘉義縣	2018-11-24T22:56:36+08:00	109308	36679	145987	18892	164879	337069	48.92%	32.43%	414	486
8	嘉義縣	2018-11-25T01:24:24+08:00	144704	48963	193667	24072	217739	439687	49.52%	32.91%	484	486
8	嘉義縣	2018-11-25T03:54:40+08:00	145827	49345	195172	24257	219429	442775	49.56%	32.93%	486	486
8	嘉義縣	2018-11-25T03:37:29+08:00	145827	49345	195172	24257	219429	442775	49.56%	32.93%	486	486
8	嘉義縣	2018-11-24T22:32:18+08:00	97929	33049	130978	17351	148329	303145	48.93%	32.3%	387	486
8	嘉義縣	2018-11-25T03:30:58+08:00	145827	49345	195172	24257	219429	442775	49.56%	32.93%	486	486
8	嘉義縣	2018-11-24T23:42:01+08:00	127973	43316	171289	21706	192995	391945	49.24%	32.65%	451	486
8	嘉義縣	2018-11-25T03:48:29+08:00	145827	49345	195172	24257	219429	442775	49.56%	32.93%	486	486
8	嘉義縣	2018-11-24T22:21:45+08:00	92629	31274	123903	16304	140207	287316	48.8%	32.24%	371	486
8	嘉義縣	2018-11-25T06:07:22+08:00	145827	49345	195172	24257	219429	442775	49.56%	32.93%	486	486
8	嘉義縣	2018-11-25T00:21:44+08:00	139384	47111	186495	23238	209733	424129	49.45%	32.86%	473	486
8	嘉義縣	2018-11-24T23:29:46+08:00	123568	41767	165335	21058	186393	378840	49.2%	32.62%	442	486
8	嘉義縣	2018-11-24T22:40:18+08:00	101744	34248	135992	17867	153859	314787	48.88%	32.32%	397	486
8	嘉義縣	2018-11-25T04:01:29+08:00	145827	49345	195172	24257	219429	442775	49.56%	32.93%	486	486
8	嘉義縣	2018-11-24T23:00:16+08:00	110443	37073	147516	19036	166552	340386	48.93%	32.45%	416	486
8	嘉義縣	2018-11-25T01:11:07+08:00	144095	48784	192879	24013	216892	438075	49.51%	32.89%	483	486
8	嘉義縣	2018-11-24T23:37:48+08:00	126881	42898	169779	21546	191325	388778	49.21%	32.64%	449	486
8	嘉義縣	2018-11-24T22:43:50+08:00	102295	34423	136718	18031	154749	316389	48.91%	32.33%	399	486
8	嘉義縣	2018-11-25T00:56:13+08:00	142335	48175	190510	23786	214296	433201	49.47%	32.86%	480	486
8	嘉義縣	2018-11-24T23:54:27+08:00	130720	44139	174859	22054	196913	399468	49.29%	32.72%	457	486
8	嘉義縣	2018-11-25T01:16:22+08:00	144095	48784	192879	24013	216892	438075	49.51%	32.89%	483	486
8	嘉義縣	2018-11-25T00:03:34+08:00	134542	45457	179999	22522	202521	410318	49.36%	32.79%	464	486
8	嘉義縣	2018-11-24T22:35:44+08:00	99903	33720	133623	17611	151234	309219	48.91%	32.31%	392	486
8	嘉義縣	2018-11-25T01:01:01+08:00	142771	48327	191098	23882	214980	434403	49.49%	32.87%	481	486
8	嘉義縣	2018-11-24T23:22:23+08:00	119708	40233	159941	20416	180357	366857	49.16%	32.63%	435	486
8	嘉義縣	2018-11-25T06:17:35+08:00	145827	49345	195172	24257	219429	442775	49.56%	32.93%	486	486
8	嘉義縣	2018-11-24T22:49:23+08:00	104792	35258	140050	18351	158401	323980	48.89%	32.35%	405	486
8	嘉義縣	2018-11-24T23:03:47+08:00	112995	37936	150931	19453	170384	348014	48.96%	32.47%	422	486
8	嘉義縣	2018-11-24T22:28:40+08:00	96614	32595	129209	17038	146247	298821	48.94%	32.33%	383	486
8	嘉義縣	2018-11-24T23:10:55+08:00	114993	38603	153596	19786	173382	353735	49.01%	32.51%	426	486
8	嘉義縣	2018-11-24T23:33:50+08:00	125321	42367	167688	21258	188946	384042	49.2%	32.63%	446	486
8	嘉義縣	2018-11-24T22:12:02+08:00	84046	28391	112437	14813	127250	261865	48.59%	32.1%	347	486
8	嘉義縣	2018-11-25T00:08:04+08:00	135769	45895	181664	22691	204355	413994	49.36%	32.79%	466	486
8	嘉義縣	2018-11-24T22:53:14+08:00	106661	35857	142518	18554	161072	329325	48.91%	32.39%	409	486
8	嘉義縣	2018-11-25T03:42:48+08:00	145827	49345	195172	24257	219429	442775	49.56%	32.93%	486	486
8	嘉義縣	2018-11-24T23:46:03+08:00	129700	43820	173520	21905	195425	396403	49.3%	32.72%	454	486
8	嘉義縣	2018-11-25T00:17:07+08:00	137866	46607	184473	22998	207471	419596	49.45%	32.86%	470	486
8	嘉義縣	2018-11-24T22:25:25+08:00	94816	31943	126759	16689	143448	293493	48.88%	32.31%	378	486
8	嘉義縣	2018-11-25T06:22:44+08:00	145827	49345	195172	24257	219429	442775	49.56%	32.93%	486	486
8	嘉義縣	2018-11-25T06:12:36+08:00	145827	49345	195172	24257	219429	442775	49.56%	32.93%	486	486
8	嘉義縣	2018-11-25T00:12:44+08:00	137267	46433	183700	22929	206629	418117	49.42%	32.83%	469	486
8	嘉義縣	2018-11-24T23:26:06+08:00	123059	41541	164600	20887	185487	377089	49.19%	32.63%	441	486
8	嘉義縣	2018-11-24T23:18:27+08:00	117303	39363	156666	20042	176708	360071	49.08%	32.58%	430	486
8	嘉義縣	2018-11-24T23:50:14+08:00	129784	43852	173636	21935	195571	396654	49.31%	32.72%	455	486
8	嘉義縣	2018-11-24T23:14:40+08:00	115894	38907	154801	19878	174679	356001	49.07%	32.55%	428	486
8	嘉義縣	2018-11-24T22:18:19+08:00	88269	29830	118099	15447	133546	274218	48.7%	32.19%	359	486
8	嘉義縣	2018-11-24T23:58:42+08:00	131827	44478	176305	22222	198527	402478	49.33%	32.75%	459	486
8	嘉義縣	2018-11-25T06:27:55+08:00	145827	49345	195172	24257	219429	442775	49.56%	32.93%	486	486
8	嘉義縣	2018-11-24T22:14:48+08:00	86485	29178	115663	15167	130830	268591	48.71%	32.2%	354	486
8	嘉義縣	2018-11-25T01:05:59+08:00	144095	48784	192879	24013	216892	438075	49.51%	32.89%	483	486
8	嘉義縣義竹鄉	2018-11-24T23:07:18+08:00	5431	1796	7227	1014	8241	16647	49.5%	32.62%	26	26
8	嘉義縣義竹鄉	2018-11-24T22:56:36+08:00	5431	1796	7227	1014	8241	16647	49.5%	32.62%	26	26
8	嘉義縣義竹鄉	2018-11-25T01:24:24+08:00	5431	1796	7227	1014	8241	16647	49.5%	32.62%	26	26
8	嘉義縣義竹鄉	2018-11-25T06:17:36+08:00	5431	1796	7227	1014	8241	16647	49.5%	32.62%	26	26
8	嘉義縣義竹鄉	2018-11-24T23:10:56+08:00	5431	1796	7227	1014	8241	16647	49.5%	32.62%	26	26
8	嘉義縣義竹鄉	2018-11-25T03:37:29+08:00	5431	1796	7227	1014	8241	16647	49.5%	32.62%	26	26
8	嘉義縣義竹鄉	2018-11-24T22:39:09+08:00	5431	1796	7227	1014	8241	16647	49.5%	32.62%	26	26
8	嘉義縣義竹鄉	2018-11-25T03:54:41+08:00	5431	1796	7227	1014	8241	16647	49.5%	32.62%	26	26
8	嘉義縣義竹鄉	2018-11-25T03:30:59+08:00	5431	1796	7227	1014	8241	16647	49.5%	32.62%	26	26
8	嘉義縣義竹鄉	2018-11-24T22:32:18+08:00	5431	1796	7227	1014	8241	16647	49.5%	32.62%	26	26
8	嘉義縣義竹鄉	2018-11-25T03:48:29+08:00	5431	1796	7227	1014	8241	16647	49.5%	32.62%	26	26
8	嘉義縣義竹鄉	2018-11-24T23:00:17+08:00	5431	1796	7227	1014	8241	16647	49.5%	32.62%	26	26
8	嘉義縣義竹鄉	2018-11-25T00:21:44+08:00	5431	1796	7227	1014	8241	16647	49.5%	32.62%	26	26
8	嘉義縣義竹鄉	2018-11-24T23:29:46+08:00	5431	1796	7227	1014	8241	16647	49.5%	32.62%	26	26
8	嘉義縣義竹鄉	2018-11-25T06:07:23+08:00	5431	1796	7227	1014	8241	16647	49.5%	32.62%	26	26
8	嘉義縣義竹鄉	2018-11-25T04:01:29+08:00	5431	1796	7227	1014	8241	16647	49.5%	32.62%	26	26
8	嘉義縣義竹鄉	2018-11-25T01:11:07+08:00	5431	1796	7227	1014	8241	16647	49.5%	32.62%	26	26
8	嘉義縣義竹鄉	2018-11-24T22:40:19+08:00	5431	1796	7227	1014	8241	16647	49.5%	32.62%	26	26
8	嘉義縣義竹鄉	2018-11-24T23:37:48+08:00	5431	1796	7227	1014	8241	16647	49.5%	32.62%	26	26
8	嘉義縣義竹鄉	2018-11-24T22:43:50+08:00	5431	1796	7227	1014	8241	16647	49.5%	32.62%	26	26
8	嘉義縣義竹鄉	2018-11-25T00:56:13+08:00	5431	1796	7227	1014	8241	16647	49.5%	32.62%	26	26
8	嘉義縣義竹鄉	2018-11-24T23:54:27+08:00	5431	1796	7227	1014	8241	16647	49.5%	32.62%	26	26
8	嘉義縣義竹鄉	2018-11-25T01:16:22+08:00	5431	1796	7227	1014	8241	16647	49.5%	32.62%	26	26
8	嘉義縣義竹鄉	2018-11-25T00:03:34+08:00	5431	1796	7227	1014	8241	16647	49.5%	32.62%	26	26
8	嘉義縣義竹鄉	2018-11-24T22:35:44+08:00	5431	1796	7227	1014	8241	16647	49.5%	32.62%	26	26
8	嘉義縣義竹鄉	2018-11-25T01:01:01+08:00	5431	1796	7227	1014	8241	16647	49.5%	32.62%	26	26
8	嘉義縣義竹鄉	2018-11-24T23:22:23+08:00	5431	1796	7227	1014	8241	16647	49.5%	32.62%	26	26
8	嘉義縣義竹鄉	2018-11-24T22:49:24+08:00	5431	1796	7227	1014	8241	16647	49.5%	32.62%	26	26
8	嘉義縣義竹鄉	2018-11-24T23:03:47+08:00	5431	1796	7227	1014	8241	16647	49.5%	32.62%	26	26
8	嘉義縣義竹鄉	2018-11-24T22:28:40+08:00	5431	1796	7227	1014	8241	16647	49.5%	32.62%	26	26
8	嘉義縣義竹鄉	2018-11-24T23:33:50+08:00	5431	1796	7227	1014	8241	16647	49.5%	32.62%	26	26
8	嘉義縣義竹鄉	2018-11-24T22:12:02+08:00	4625	1521	6146	893	7039	14275	49.31%	32.4%	24	26
8	嘉義縣義竹鄉	2018-11-25T00:08:04+08:00	5431	1796	7227	1014	8241	16647	49.5%	32.62%	26	26
8	嘉義縣義竹鄉	2018-11-24T23:42:02+08:00	5431	1796	7227	1014	8241	16647	49.5%	32.62%	26	26
8	嘉義縣義竹鄉	2018-11-25T03:42:48+08:00	5431	1796	7227	1014	8241	16647	49.5%	32.62%	26	26
8	嘉義縣義竹鄉	2018-11-24T22:53:15+08:00	5431	1796	7227	1014	8241	16647	49.5%	32.62%	26	26
8	嘉義縣義竹鄉	2018-11-24T23:46:03+08:00	5431	1796	7227	1014	8241	16647	49.5%	32.62%	26	26
8	嘉義縣義竹鄉	2018-11-24T22:21:46+08:00	5431	1796	7227	1014	8241	16647	49.5%	32.62%	26	26
8	嘉義縣義竹鄉	2018-11-24T22:25:25+08:00	5431	1796	7227	1014	8241	16647	49.5%	32.62%	26	26
8	嘉義縣義竹鄉	2018-11-25T06:12:36+08:00	5431	1796	7227	1014	8241	16647	49.5%	32.62%	26	26
8	嘉義縣義竹鄉	2018-11-25T00:17:08+08:00	5431	1796	7227	1014	8241	16647	49.5%	32.62%	26	26
8	嘉義縣義竹鄉	2018-11-25T06:22:45+08:00	5431	1796	7227	1014	8241	16647	49.5%	32.62%	26	26
8	嘉義縣義竹鄉	2018-11-24T22:14:49+08:00	4625	1521	6146	893	7039	14275	49.31%	32.4%	24	26
8	嘉義縣義竹鄉	2018-11-24T23:18:27+08:00	5431	1796	7227	1014	8241	16647	49.5%	32.62%	26	26
8	嘉義縣義竹鄉	2018-11-24T22:18:19+08:00	4625	1521	6146	893	7039	14275	49.31%	32.4%	24	26
8	嘉義縣義竹鄉	2018-11-24T23:58:42+08:00	5431	1796	7227	1014	8241	16647	49.5%	32.62%	26	26
8	嘉義縣義竹鄉	2018-11-25T06:27:55+08:00	5431	1796	7227	1014	8241	16647	49.5%	32.62%	26	26
8	嘉義縣義竹鄉	2018-11-24T23:26:07+08:00	5431	1796	7227	1014	8241	16647	49.5%	32.62%	26	26
8	嘉義縣義竹鄉	2018-11-25T00:12:45+08:00	5431	1796	7227	1014	8241	16647	49.5%	32.62%	26	26
8	嘉義縣義竹鄉	2018-11-25T01:05:59+08:00	5431	1796	7227	1014	8241	16647	49.5%	32.62%	26	26
8	嘉義縣義竹鄉	2018-11-24T23:14:41+08:00	5431	1796	7227	1014	8241	16647	49.5%	32.62%	26	26
8	嘉義縣義竹鄉	2018-11-24T23:50:15+08:00	5431	1796	7227	1014	8241	16647	49.5%	32.62%	26	26
8	臺南市官田區	2018-11-25T03:37:19+08:00	5689	2207	7896	843	8739	18675	46.8%	30.46%	20	20
8	臺南市官田區	2018-11-24T22:49:18+08:00	5689	2207	7896	843	8739	18675	46.8%	30.46%	20	20
8	臺南市官田區	2018-11-24T23:14:34+08:00	5689	2207	7896	843	8739	18675	46.8%	30.46%	20	20
8	臺南市官田區	2018-11-24T22:56:31+08:00	5689	2207	7896	843	8739	18675	46.8%	30.46%	20	20
8	臺南市官田區	2018-11-25T00:03:27+08:00	5689	2207	7896	843	8739	18675	46.8%	30.46%	20	20
8	臺南市官田區	2018-11-25T00:56:07+08:00	5689	2207	7896	843	8739	18675	46.8%	30.46%	20	20
8	臺南市官田區	2018-11-24T23:03:42+08:00	5689	2207	7896	843	8739	18675	46.8%	30.46%	20	20
8	臺南市官田區	2018-11-24T23:10:51+08:00	5689	2207	7896	843	8739	18675	46.8%	30.46%	20	20
8	臺南市官田區	2018-11-24T22:43:44+08:00	5689	2207	7896	843	8739	18675	46.8%	30.46%	20	20
8	臺南市官田區	2018-11-25T06:17:30+08:00	5689	2207	7896	843	8739	18675	46.8%	30.46%	20	20
8	臺南市官田區	2018-11-24T23:58:36+08:00	5689	2207	7896	843	8739	18675	46.8%	30.46%	20	20
8	臺南市官田區	2018-11-24T23:22:17+08:00	5689	2207	7896	843	8739	18675	46.8%	30.46%	20	20
8	臺南市官田區	2018-11-25T06:22:40+08:00	5689	2207	7896	843	8739	18675	46.8%	30.46%	20	20
8	臺南市官田區	2018-11-24T23:29:41+08:00	5689	2207	7896	843	8739	18675	46.8%	30.46%	20	20
8	臺南市官田區	2018-11-24T22:25:18+08:00	5689	2207	7896	843	8739	18675	46.8%	30.46%	20	20
8	臺南市官田區	2018-11-25T01:11:00+08:00	5689	2207	7896	843	8739	18675	46.8%	30.46%	20	20
8	臺南市官田區	2018-11-25T00:17:02+08:00	5689	2207	7896	843	8739	18675	46.8%	30.46%	20	20
8	臺南市官田區	2018-11-25T00:07:58+08:00	5689	2207	7896	843	8739	18675	46.8%	30.46%	20	20
8	臺南市官田區	2018-11-25T01:16:15+08:00	5689	2207	7896	843	8739	18675	46.8%	30.46%	20	20
8	臺南市官田區	2018-11-25T00:12:40+08:00	5689	2207	7896	843	8739	18675	46.8%	30.46%	20	20
8	臺南市官田區	2018-11-24T22:14:43+08:00	5689	2207	7896	843	8739	18675	46.8%	30.46%	20	20
8	臺南市官田區	2018-11-24T23:26:02+08:00	5689	2207	7896	843	8739	18675	46.8%	30.46%	20	20
8	臺南市官田區	2018-11-25T01:05:52+08:00	5689	2207	7896	843	8739	18675	46.8%	30.46%	20	20
8	臺南市官田區	2018-11-24T23:54:19+08:00	5689	2207	7896	843	8739	18675	46.8%	30.46%	20	20
8	臺南市官田區	2018-11-24T22:28:34+08:00	5689	2207	7896	843	8739	18675	46.8%	30.46%	20	20
8	臺南市官田區	2018-11-24T22:18:14+08:00	5689	2207	7896	843	8739	18675	46.8%	30.46%	20	20
8	臺南市官田區	2018-11-25T01:24:18+08:00	5689	2207	7896	843	8739	18675	46.8%	30.46%	20	20
8	臺南市官田區	2018-11-24T22:35:39+08:00	5689	2207	7896	843	8739	18675	46.8%	30.46%	20	20
8	臺南市官田區	2018-11-24T23:50:09+08:00	5689	2207	7896	843	8739	18675	46.8%	30.46%	20	20
8	臺南市官田區	2018-11-25T06:27:49+08:00	5689	2207	7896	843	8739	18675	46.8%	30.46%	20	20
8	臺南市官田區	2018-11-24T22:39:03+08:00	5689	2207	7896	843	8739	18675	46.8%	30.46%	20	20
8	臺南市官田區	2018-11-24T23:07:13+08:00	5689	2207	7896	843	8739	18675	46.8%	30.46%	20	20
8	臺南市官田區	2018-11-25T01:00:54+08:00	5689	2207	7896	843	8739	18675	46.8%	30.46%	20	20
8	臺南市官田區	2018-11-24T22:32:13+08:00	5689	2207	7896	843	8739	18675	46.8%	30.46%	20	20
8	臺南市官田區	2018-11-25T03:48:23+08:00	5689	2207	7896	843	8739	18675	46.8%	30.46%	20	20
8	臺南市官田區	2018-11-24T23:00:09+08:00	5689	2207	7896	843	8739	18675	46.8%	30.46%	20	20
8	臺南市官田區	2018-11-25T00:21:38+08:00	5689	2207	7896	843	8739	18675	46.8%	30.46%	20	20
8	臺南市官田區	2018-11-25T03:30:52+08:00	5689	2207	7896	843	8739	18675	46.8%	30.46%	20	20
8	臺南市官田區	2018-11-25T03:42:41+08:00	5689	2207	7896	843	8739	18675	46.8%	30.46%	20	20
8	臺南市官田區	2018-11-24T22:53:08+08:00	5689	2207	7896	843	8739	18675	46.8%	30.46%	20	20
8	臺南市官田區	2018-11-25T06:07:17+08:00	5689	2207	7896	843	8739	18675	46.8%	30.46%	20	20
8	臺南市官田區	2018-11-24T22:11:57+08:00	5689	2207	7896	843	8739	18675	46.8%	30.46%	20	20
8	臺南市官田區	2018-11-24T22:40:14+08:00	5689	2207	7896	843	8739	18675	46.8%	30.46%	20	20
8	臺南市官田區	2018-11-25T06:12:31+08:00	5689	2207	7896	843	8739	18675	46.8%	30.46%	20	20
8	臺南市官田區	2018-11-25T04:01:23+08:00	5689	2207	7896	843	8739	18675	46.8%	30.46%	20	20
8	臺南市官田區	2018-11-24T22:21:40+08:00	5689	2207	7896	843	8739	18675	46.8%	30.46%	20	20
8	臺南市官田區	2018-11-24T23:33:44+08:00	5689	2207	7896	843	8739	18675	46.8%	30.46%	20	20
8	臺南市官田區	2018-11-25T03:54:34+08:00	5689	2207	7896	843	8739	18675	46.8%	30.46%	20	20
8	臺南市官田區	2018-11-24T23:45:58+08:00	5689	2207	7896	843	8739	18675	46.8%	30.46%	20	20
8	臺南市官田區	2018-11-24T23:41:56+08:00	5689	2207	7896	843	8739	18675	46.8%	30.46%	20	20
8	臺南市官田區	2018-11-24T23:37:43+08:00	5689	2207	7896	843	8739	18675	46.8%	30.46%	20	20
8	臺南市官田區	2018-11-24T23:18:21+08:00	5689	2207	7896	843	8739	18675	46.8%	30.46%	20	20
8	屏東縣滿州鄉	2018-11-24T23:10:57+08:00	2123	663	2786	255	3041	7206	42.2%	29.46%	8	8
8	屏東縣滿州鄉	2018-11-24T23:07:19+08:00	2123	663	2786	255	3041	7206	42.2%	29.46%	8	8
8	屏東縣滿州鄉	2018-11-24T22:14:50+08:00	2123	663	2786	255	3041	7206	42.2%	29.46%	8	8
8	屏東縣滿州鄉	2018-11-25T06:17:37+08:00	2123	663	2786	255	3041	7206	42.2%	29.46%	8	8
8	屏東縣滿州鄉	2018-11-24T22:56:37+08:00	2123	663	2786	255	3041	7206	42.2%	29.46%	8	8
8	屏東縣滿州鄉	2018-11-24T22:32:19+08:00	2123	663	2786	255	3041	7206	42.2%	29.46%	8	8
8	屏東縣滿州鄉	2018-11-25T01:06:01+08:00	2123	663	2786	255	3041	7206	42.2%	29.46%	8	8
8	屏東縣滿州鄉	2018-11-24T22:53:16+08:00	2123	663	2786	255	3041	7206	42.2%	29.46%	8	8
8	屏東縣滿州鄉	2018-11-25T00:08:06+08:00	2123	663	2786	255	3041	7206	42.2%	29.46%	8	8
8	屏東縣滿州鄉	2018-11-24T22:25:26+08:00	2123	663	2786	255	3041	7206	42.2%	29.46%	8	8
8	屏東縣滿州鄉	2018-11-25T01:11:08+08:00	2123	663	2786	255	3041	7206	42.2%	29.46%	8	8
8	屏東縣滿州鄉	2018-11-24T22:40:20+08:00	2123	663	2786	255	3041	7206	42.2%	29.46%	8	8
8	屏東縣滿州鄉	2018-11-25T06:22:46+08:00	2123	663	2786	255	3041	7206	42.2%	29.46%	8	8
8	屏東縣滿州鄉	2018-11-25T06:07:24+08:00	2123	663	2786	255	3041	7206	42.2%	29.46%	8	8
8	屏東縣滿州鄉	2018-11-24T23:00:18+08:00	2123	663	2786	255	3041	7206	42.2%	29.46%	8	8
8	屏東縣滿州鄉	2018-11-25T03:48:32+08:00	2123	663	2786	255	3041	7206	42.2%	29.46%	8	8
8	屏東縣滿州鄉	2018-11-24T23:29:47+08:00	2123	663	2786	255	3041	7206	42.2%	29.46%	8	8
8	屏東縣滿州鄉	2018-11-25T00:21:45+08:00	2123	663	2786	255	3041	7206	42.2%	29.46%	8	8
8	屏東縣滿州鄉	2018-11-25T03:31:00+08:00	2123	663	2786	255	3041	7206	42.2%	29.46%	8	8
8	屏東縣滿州鄉	2018-11-25T01:16:23+08:00	2123	663	2786	255	3041	7206	42.2%	29.46%	8	8
8	屏東縣滿州鄉	2018-11-25T00:56:14+08:00	2123	663	2786	255	3041	7206	42.2%	29.46%	8	8
8	屏東縣滿州鄉	2018-11-24T22:35:45+08:00	2123	663	2786	255	3041	7206	42.2%	29.46%	8	8
8	屏東縣滿州鄉	2018-11-24T23:14:42+08:00	2123	663	2786	255	3041	7206	42.2%	29.46%	8	8
8	屏東縣滿州鄉	2018-11-24T23:50:16+08:00	2123	663	2786	255	3041	7206	42.2%	29.46%	8	8
8	屏東縣滿州鄉	2018-11-24T23:37:49+08:00	2123	663	2786	255	3041	7206	42.2%	29.46%	8	8
8	屏東縣滿州鄉	2018-11-24T22:43:51+08:00	2123	663	2786	255	3041	7206	42.2%	29.46%	8	8
8	屏東縣滿州鄉	2018-11-25T06:27:56+08:00	2123	663	2786	255	3041	7206	42.2%	29.46%	8	8
8	屏東縣滿州鄉	2018-11-25T00:12:46+08:00	2123	663	2786	255	3041	7206	42.2%	29.46%	8	8
8	屏東縣滿州鄉	2018-11-24T23:54:28+08:00	2123	663	2786	255	3041	7206	42.2%	29.46%	8	8
8	屏東縣滿州鄉	2018-11-24T23:22:24+08:00	2123	663	2786	255	3041	7206	42.2%	29.46%	8	8
8	屏東縣滿州鄉	2018-11-24T22:28:41+08:00	2123	663	2786	255	3041	7206	42.2%	29.46%	8	8
8	屏東縣滿州鄉	2018-11-24T22:12:03+08:00	2123	663	2786	255	3041	7206	42.2%	29.46%	8	8
8	屏東縣滿州鄉	2018-11-24T23:33:51+08:00	2123	663	2786	255	3041	7206	42.2%	29.46%	8	8
8	屏東縣滿州鄉	2018-11-25T01:24:26+08:00	2123	663	2786	255	3041	7206	42.2%	29.46%	8	8
8	屏東縣滿州鄉	2018-11-25T03:54:42+08:00	2123	663	2786	255	3041	7206	42.2%	29.46%	8	8
8	屏東縣滿州鄉	2018-11-24T23:03:48+08:00	2123	663	2786	255	3041	7206	42.2%	29.46%	8	8
8	屏東縣滿州鄉	2018-11-24T22:49:25+08:00	2123	663	2786	255	3041	7206	42.2%	29.46%	8	8
8	屏東縣滿州鄉	2018-11-24T23:42:03+08:00	2123	663	2786	255	3041	7206	42.2%	29.46%	8	8
8	屏東縣滿州鄉	2018-11-25T04:01:30+08:00	2123	663	2786	255	3041	7206	42.2%	29.46%	8	8
8	屏東縣滿州鄉	2018-11-24T23:46:05+08:00	2123	663	2786	255	3041	7206	42.2%	29.46%	8	8
8	屏東縣滿州鄉	2018-11-25T03:42:49+08:00	2123	663	2786	255	3041	7206	42.2%	29.46%	8	8
8	屏東縣滿州鄉	2018-11-25T00:17:09+08:00	2123	663	2786	255	3041	7206	42.2%	29.46%	8	8
8	屏東縣滿州鄉	2018-11-25T06:12:38+08:00	2123	663	2786	255	3041	7206	42.2%	29.46%	8	8
8	屏東縣滿州鄉	2018-11-24T22:21:47+08:00	2123	663	2786	255	3041	7206	42.2%	29.46%	8	8
8	屏東縣滿州鄉	2018-11-25T01:01:03+08:00	2123	663	2786	255	3041	7206	42.2%	29.46%	8	8
8	屏東縣滿州鄉	2018-11-24T22:39:10+08:00	2123	663	2786	255	3041	7206	42.2%	29.46%	8	8
8	屏東縣滿州鄉	2018-11-24T23:26:08+08:00	2123	663	2786	255	3041	7206	42.2%	29.46%	8	8
8	屏東縣滿州鄉	2018-11-25T03:37:30+08:00	2123	663	2786	255	3041	7206	42.2%	29.46%	8	8
8	屏東縣滿州鄉	2018-11-24T23:58:43+08:00	2123	663	2786	255	3041	7206	42.2%	29.46%	8	8
8	屏東縣滿州鄉	2018-11-25T00:03:36+08:00	2123	663	2786	255	3041	7206	42.2%	29.46%	8	8
8	屏東縣滿州鄉	2018-11-24T22:18:21+08:00	2123	663	2786	255	3041	7206	42.2%	29.46%	8	8
8	屏東縣滿州鄉	2018-11-24T23:18:28+08:00	2123	663	2786	255	3041	7206	42.2%	29.46%	8	8
8	臺南市	2018-11-24T22:49:18+08:00	449124	155919	605043	57172	662215	1332461	49.7%	33.71%	167	1
8	臺南市	2018-11-24T23:14:33+08:00	486575	168741	655316	61071	716387	1437174	49.85%	33.86%	232	1
8	臺南市	2018-11-24T22:56:31+08:00	460654	159887	620541	58418	678959	1365168	49.73%	33.74%	186	1
8	臺南市	2018-11-25T00:12:39+08:00	531479	184538	716017	66636	782653	1564534	50.02%	33.97%	306	1
8	臺南市	2018-11-25T00:03:27+08:00	527274	183089	710363	66005	776368	1552640	50%	33.96%	299	1
8	臺南市	2018-11-25T00:56:07+08:00	540416	187727	728143	67721	795864	1590343	50.04%	33.98%	320	1
8	臺南市	2018-11-24T23:03:42+08:00	473209	164175	637384	59731	697115	1400334	49.78%	33.79%	209	1
8	臺南市	2018-11-24T23:10:51+08:00	482784	167431	650215	60678	710893	1426307	49.84%	33.85%	226	1
8	臺南市	2018-11-25T03:37:18+08:00	541984	188192	730176	67891	798067	1594821	50.04%	33.98%	322	1
8	臺南市	2018-11-24T22:43:44+08:00	440397	152344	592741	56053	648794	1307006	49.64%	33.7%	151	1
8	臺南市	2018-11-25T06:17:30+08:00	541984	188192	730176	67891	798067	1594821	50.04%	33.98%	322	1
8	臺南市	2018-11-24T23:22:17+08:00	498563	173063	671626	62465	734091	1471395	49.89%	33.88%	253	1
8	臺南市	2018-11-25T06:22:39+08:00	541984	188192	730176	67891	798067	1594821	50.04%	33.98%	322	1
8	臺南市	2018-11-24T23:29:41+08:00	504818	175257	680075	63317	743392	1489069	49.92%	33.9%	263	1
8	臺南市	2018-11-24T22:25:18+08:00	403411	139525	542936	51894	594830	1201950	49.49%	33.56%	082	1
8	臺南市	2018-11-25T01:11:00+08:00	541096	187921	729017	67797	796814	1592458	50.04%	33.98%	321	1
8	臺南市	2018-11-25T00:17:02+08:00	532547	184958	717505	66778	784283	1567581	50.03%	33.97%	308	1
8	臺南市	2018-11-25T00:07:58+08:00	530481	184129	714610	66514	781124	1561484	50.02%	33.97%	304	1
8	臺南市	2018-11-25T01:16:15+08:00	541984	188192	730176	67861	798037	1594821	50.04%	33.98%	322	1
8	臺南市	2018-11-25T01:05:52+08:00	541096	187921	729017	67797	796814	1592458	50.04%	33.98%	321	1
8	臺南市	2018-11-24T22:14:42+08:00	373173	129031	502204	48600	550804	1114060	49.44%	33.5%	024	1
8	臺南市	2018-11-24T23:54:19+08:00	523009	181538	704547	65520	770067	1539927	50.01%	33.96%	292	1
8	臺南市	2018-11-24T22:28:34+08:00	410413	141997	552410	52747	605157	1222218	49.51%	33.58%	095	1
8	臺南市	2018-11-24T22:18:13+08:00	381876	132228	514104	49698	563802	1138364	49.53%	33.55%	041	1
8	臺南市	2018-11-25T01:24:18+08:00	541786	188118	729904	67857	797761	1593720	50.06%	34%	321	1
8	臺南市	2018-11-24T22:35:39+08:00	420357	145385	565742	53985	619727	1250427	49.56%	33.62%	113	1
8	臺南市	2018-11-24T23:50:09+08:00	521833	181101	702934	65408	768342	1536400	50.01%	33.96%	290	1
8	臺南市	2018-11-24T23:58:35+08:00	526037	182611	708648	65806	774454	1549104	49.99%	33.96%	297	1
8	臺南市	2018-11-25T06:27:49+08:00	541984	188192	730176	67891	798067	1594821	50.04%	33.98%	322	1
8	臺南市	2018-11-24T22:39:03+08:00	425336	147202	572538	54471	627009	1264911	49.57%	33.63%	124	1
8	臺南市	2018-11-24T23:07:13+08:00	478444	165934	644378	60234	704612	1414199	49.82%	33.83%	218	1
8	臺南市	2018-11-25T01:00:54+08:00	541096	187921	729017	67797	796814	1592458	50.04%	33.98%	321	1
8	臺南市	2018-11-24T23:00:08+08:00	464349	161249	625598	58866	684464	1375505	49.76%	33.76%	193	1
8	臺南市	2018-11-25T03:48:22+08:00	541984	188192	730176	67891	798067	1594821	50.04%	33.98%	322	1
8	臺南市	2018-11-25T00:21:37+08:00	533917	185444	719361	66978	786339	1571627	50.03%	33.97%	310	1
8	臺南市	2018-11-25T03:30:52+08:00	541984	188192	730176	67891	798067	1594821	50.04%	33.98%	322	1
8	臺南市	2018-11-25T03:42:41+08:00	541984	188192	730176	67891	798067	1594821	50.04%	33.98%	322	1
8	臺南市	2018-11-24T22:21:39+08:00	389760	134886	524646	50515	575161	1161467	49.52%	33.56%	056	1
8	臺南市	2018-11-24T22:32:12+08:00	414418	143297	557715	53223	610938	1233457	49.53%	33.6%	102	1
8	臺南市	2018-11-24T22:53:08+08:00	455484	158195	613679	57843	671522	1350834	49.71%	33.72%	178	1
8	臺南市	2018-11-25T04:01:22+08:00	541984	188192	730176	67891	798067	1594821	50.04%	33.98%	322	1
8	臺南市	2018-11-24T22:11:57+08:00	366258	126645	492903	47789	540692	1094921	49.38%	33.45%	012	1
8	臺南市	2018-11-24T22:40:13+08:00	432704	149651	582355	55195	637550	1285282	49.6%	33.67%	136	1
8	臺南市	2018-11-25T06:12:31+08:00	541984	188192	730176	67891	798067	1594821	50.04%	33.98%	322	1
8	臺南市	2018-11-25T06:07:16+08:00	541984	188192	730176	67891	798067	1594821	50.04%	33.98%	322	1
8	臺南市	2018-11-24T23:33:44+08:00	513979	178585	692564	64547	757111	1514957	49.98%	33.93%	278	1
8	臺南市	2018-11-24T23:26:01+08:00	502488	174395	676883	62952	739835	1482236	49.91%	33.9%	259	1
8	臺南市	2018-11-25T03:54:34+08:00	541984	188192	730176	67891	798067	1594821	50.04%	33.98%	322	1
8	臺南市	2018-11-24T23:45:58+08:00	520721	180709	701430	65256	766686	1533235	50%	33.96%	288	1
8	臺南市	2018-11-24T23:41:56+08:00	517576	179738	697314	65032	762346	1525041	49.99%	33.94%	284	1
8	臺南市	2018-11-24T23:37:43+08:00	516580	179384	695964	64858	760822	1522001	49.99%	33.94%	282	1
8	臺南市	2018-11-24T23:18:21+08:00	489771	169940	659711	61504	721215	1447179	49.84%	33.84%	238	1
8	花蓮縣秀林鄉	2018-11-24T22:14:51+08:00	496	147	643	67	710	1503	47.24%	33%	4	14
8	花蓮縣秀林鄉	2018-11-24T23:33:52+08:00	1565	463	2028	208	2236	4617	48.43%	33.9%	7	14
8	花蓮縣秀林鄉	2018-11-24T22:28:42+08:00	496	147	643	67	710	1503	47.24%	33%	4	14
8	花蓮縣秀林鄉	2018-11-24T22:56:38+08:00	496	147	643	67	710	1503	47.24%	33%	4	14
8	花蓮縣秀林鄉	2018-11-24T23:07:21+08:00	496	147	643	67	710	1503	47.24%	33%	4	14
8	花蓮縣秀林鄉	2018-11-24T22:49:26+08:00	496	147	643	67	710	1503	47.24%	33%	4	14
8	花蓮縣秀林鄉	2018-11-24T23:10:58+08:00	496	147	643	67	710	1503	47.24%	33%	4	14
8	花蓮縣秀林鄉	2018-11-25T06:17:39+08:00	4254	1246	5500	518	6018	12562	47.91%	33.86%	14	14
8	花蓮縣秀林鄉	2018-11-24T22:53:17+08:00	496	147	643	67	710	1503	47.24%	33%	4	14
8	花蓮縣秀林鄉	2018-11-24T23:46:06+08:00	1565	463	2028	208	2236	4617	48.43%	33.9%	7	14
8	花蓮縣秀林鄉	2018-11-25T00:08:07+08:00	1565	463	2028	208	2236	4617	48.43%	33.9%	7	14
8	花蓮縣秀林鄉	2018-11-24T22:32:20+08:00	496	147	643	67	710	1503	47.24%	33%	4	14
8	花蓮縣秀林鄉	2018-11-25T00:17:10+08:00	1565	463	2028	208	2236	4617	48.43%	33.9%	7	14
8	花蓮縣秀林鄉	2018-11-25T03:48:33+08:00	4254	1246	5500	518	6018	12562	47.91%	33.86%	14	14
8	花蓮縣秀林鄉	2018-11-24T23:00:19+08:00	496	147	643	67	710	1503	47.24%	33%	4	14
8	花蓮縣秀林鄉	2018-11-25T06:07:25+08:00	4254	1246	5500	518	6018	12562	47.91%	33.86%	14	14
8	花蓮縣秀林鄉	2018-11-25T06:22:47+08:00	4254	1246	5500	518	6018	12562	47.91%	33.86%	14	14
8	花蓮縣秀林鄉	2018-11-25T03:42:51+08:00	4254	1246	5500	518	6018	12562	47.91%	33.86%	14	14
8	花蓮縣秀林鄉	2018-11-24T22:25:27+08:00	496	147	643	67	710	1503	47.24%	33%	4	14
8	花蓮縣秀林鄉	2018-11-24T22:40:21+08:00	496	147	643	67	710	1503	47.24%	33%	4	14
8	花蓮縣秀林鄉	2018-11-24T23:29:49+08:00	1565	463	2028	208	2236	4617	48.43%	33.9%	7	14
8	花蓮縣秀林鄉	2018-11-24T23:50:17+08:00	1565	463	2028	208	2236	4617	48.43%	33.9%	7	14
8	花蓮縣秀林鄉	2018-11-24T23:14:43+08:00	496	147	643	67	710	1503	47.24%	33%	4	14
8	花蓮縣秀林鄉	2018-11-25T00:12:47+08:00	1565	463	2028	208	2236	4617	48.43%	33.9%	7	14
8	花蓮縣秀林鄉	2018-11-24T23:54:29+08:00	1565	463	2028	208	2236	4617	48.43%	33.9%	7	14
8	花蓮縣秀林鄉	2018-11-25T06:27:57+08:00	4254	1246	5500	518	6018	12562	47.91%	33.86%	14	14
8	花蓮縣秀林鄉	2018-11-25T01:16:25+08:00	2390	713	3103	333	3436	6881	49.93%	34.73%	9	14
8	花蓮縣秀林鄉	2018-11-24T22:18:22+08:00	496	147	643	67	710	1503	47.24%	33%	4	14
8	花蓮縣秀林鄉	2018-11-25T03:37:32+08:00	4254	1246	5500	518	6018	12562	47.91%	33.86%	14	14
8	花蓮縣秀林鄉	2018-11-25T01:24:27+08:00	2390	713	3103	333	3436	6881	49.93%	34.73%	9	14
8	花蓮縣秀林鄉	2018-11-25T03:54:44+08:00	4254	1246	5500	518	6018	12562	47.91%	33.86%	14	14
8	花蓮縣秀林鄉	2018-11-24T23:03:49+08:00	496	147	643	67	710	1503	47.24%	33%	4	14
8	花蓮縣秀林鄉	2018-11-24T23:22:25+08:00	1565	463	2028	208	2236	4617	48.43%	33.9%	7	14
8	花蓮縣秀林鄉	2018-11-24T23:37:51+08:00	1565	463	2028	208	2236	4617	48.43%	33.9%	7	14
8	花蓮縣秀林鄉	2018-11-24T22:12:05+08:00	496	147	643	67	710	1503	47.24%	33%	4	14
8	花蓮縣秀林鄉	2018-11-25T01:06:02+08:00	2390	713	3103	333	3436	6881	49.93%	34.73%	9	14
8	花蓮縣秀林鄉	2018-11-24T23:42:04+08:00	1565	463	2028	208	2236	4617	48.43%	33.9%	7	14
8	花蓮縣秀林鄉	2018-11-25T01:11:10+08:00	2390	713	3103	333	3436	6881	49.93%	34.73%	9	14
8	花蓮縣秀林鄉	2018-11-25T04:01:31+08:00	4254	1246	5500	518	6018	12562	47.91%	33.86%	14	14
8	花蓮縣秀林鄉	2018-11-25T06:12:39+08:00	4254	1246	5500	518	6018	12562	47.91%	33.86%	14	14
8	花蓮縣秀林鄉	2018-11-24T22:21:48+08:00	496	147	643	67	710	1503	47.24%	33%	4	14
8	花蓮縣秀林鄉	2018-11-25T00:21:46+08:00	2007	610	2617	310	2927	5756	50.85%	34.87%	8	14
8	花蓮縣秀林鄉	2018-11-25T01:01:04+08:00	2390	713	3103	333	3436	6881	49.93%	34.73%	9	14
8	花蓮縣秀林鄉	2018-11-24T22:43:53+08:00	496	147	643	67	710	1503	47.24%	33%	4	14
8	花蓮縣秀林鄉	2018-11-24T23:18:29+08:00	1120	341	1461	157	1618	3630	44.57%	30.85%	6	14
8	花蓮縣秀林鄉	2018-11-24T22:35:47+08:00	496	147	643	67	710	1503	47.24%	33%	4	14
8	花蓮縣秀林鄉	2018-11-24T23:58:45+08:00	1565	463	2028	208	2236	4617	48.43%	33.9%	7	14
8	花蓮縣秀林鄉	2018-11-25T00:56:16+08:00	2390	713	3103	333	3436	6881	49.93%	34.73%	9	14
8	花蓮縣秀林鄉	2018-11-24T22:39:11+08:00	496	147	643	67	710	1503	47.24%	33%	4	14
8	花蓮縣秀林鄉	2018-11-24T23:26:09+08:00	1565	463	2028	208	2236	4617	48.43%	33.9%	7	14
8	花蓮縣秀林鄉	2018-11-25T03:31:02+08:00	4254	1246	5500	518	6018	12562	47.91%	33.86%	14	14
8	花蓮縣秀林鄉	2018-11-25T00:03:37+08:00	1565	463	2028	208	2236	4617	48.43%	33.9%	7	14
8	花蓮縣花蓮市	2018-11-24T22:14:51+08:00	7447	1797	9244	638	9882	18238	54.18%	40.83%	24	81
8	花蓮縣花蓮市	2018-11-24T23:33:52+08:00	18307	4607	22914	1645	24559	45648	53.8%	40.1%	49	81
8	花蓮縣花蓮市	2018-11-25T06:17:38+08:00	33828	8590	42418	2948	45366	84807	53.49%	39.89%	81	81
8	花蓮縣花蓮市	2018-11-24T22:28:42+08:00	7756	1876	9632	664	10296	18953	54.32%	40.92%	25	81
8	花蓮縣花蓮市	2018-11-24T22:56:38+08:00	11825	2828	14653	1012	15665	29162	53.72%	40.55%	34	81
8	花蓮縣花蓮市	2018-11-24T23:07:21+08:00	13501	3264	16765	1183	17948	33231	54.01%	40.63%	38	81
8	花蓮縣花蓮市	2018-11-24T22:49:26+08:00	11419	2730	14149	972	15121	28207	53.61%	40.48%	33	81
8	花蓮縣花蓮市	2018-11-24T23:10:58+08:00	13992	3374	17366	1226	18592	34570	53.78%	40.47%	39	81
8	花蓮縣花蓮市	2018-11-24T22:53:17+08:00	11825	2828	14653	1012	15665	29162	53.72%	40.55%	34	81
8	花蓮縣花蓮市	2018-11-25T00:08:07+08:00	23265	5857	29122	2081	31203	57960	53.84%	40.14%	60	81
8	花蓮縣花蓮市	2018-11-24T22:32:20+08:00	7756	1876	9632	664	10296	18953	54.32%	40.92%	25	81
8	花蓮縣花蓮市	2018-11-25T00:17:10+08:00	24815	6257	31072	2191	33263	61730	53.88%	40.2%	63	81
8	花蓮縣花蓮市	2018-11-25T03:48:33+08:00	33828	8590	42418	2948	45366	84807	53.49%	39.89%	81	81
8	花蓮縣花蓮市	2018-11-25T06:07:25+08:00	33828	8590	42418	2948	45366	84807	53.49%	39.89%	81	81
8	花蓮縣花蓮市	2018-11-24T23:29:48+08:00	16534	4045	20579	1509	22088	40877	54.04%	40.45%	45	81
8	花蓮縣花蓮市	2018-11-24T22:40:20+08:00	8550	2062	10612	736	11348	20883	54.34%	40.94%	27	81
8	花蓮縣花蓮市	2018-11-25T06:22:46+08:00	33828	8590	42418	2948	45366	84807	53.49%	39.89%	81	81
8	花蓮縣花蓮市	2018-11-24T23:00:18+08:00	11825	2828	14653	1012	15665	29162	53.72%	40.55%	34	81
8	花蓮縣花蓮市	2018-11-24T22:25:27+08:00	7756	1876	9632	664	10296	18953	54.32%	40.92%	25	81
8	花蓮縣花蓮市	2018-11-25T03:42:50+08:00	33828	8590	42418	2948	45366	84807	53.49%	39.89%	81	81
8	花蓮縣花蓮市	2018-11-25T01:11:09+08:00	31513	7971	39484	2751	42235	78222	53.99%	40.29%	76	81
8	花蓮縣花蓮市	2018-11-24T23:50:17+08:00	22298	5616	27914	2022	29936	55541	53.9%	40.15%	58	81
8	花蓮縣花蓮市	2018-11-24T23:14:43+08:00	14374	3509	17883	1292	19175	35641	53.8%	40.33%	40	81
8	花蓮縣花蓮市	2018-11-25T01:16:24+08:00	31513	7971	39484	2751	42235	78222	53.99%	40.29%	76	81
8	花蓮縣花蓮市	2018-11-25T00:12:47+08:00	24815	6257	31072	2191	33263	61730	53.88%	40.2%	63	81
8	花蓮縣花蓮市	2018-11-24T23:54:29+08:00	22298	5616	27914	2022	29936	55541	53.9%	40.15%	58	81
8	花蓮縣花蓮市	2018-11-25T06:27:57+08:00	33828	8590	42418	2948	45366	84807	53.49%	39.89%	81	81
8	花蓮縣花蓮市	2018-11-25T03:31:01+08:00	33828	8590	42418	2948	45366	84807	53.49%	39.89%	81	81
8	花蓮縣花蓮市	2018-11-25T00:56:15+08:00	30506	7670	38176	2638	40814	75560	54.02%	40.37%	74	81
8	花蓮縣花蓮市	2018-11-24T23:37:50+08:00	18806	4715	23521	1678	25199	46916	53.71%	40.08%	50	81
8	花蓮縣花蓮市	2018-11-25T01:24:27+08:00	32947	8350	41297	2853	44150	82106	53.77%	40.13%	79	81
8	花蓮縣花蓮市	2018-11-25T03:54:43+08:00	33828	8590	42418	2948	45366	84807	53.49%	39.89%	81	81
8	花蓮縣花蓮市	2018-11-24T23:03:49+08:00	13127	3151	16278	1143	17421	32306	53.92%	40.63%	37	81
8	花蓮縣花蓮市	2018-11-24T22:12:04+08:00	7447	1797	9244	638	9882	18238	54.18%	40.83%	24	81
8	花蓮縣花蓮市	2018-11-24T23:22:25+08:00	15106	3685	18791	1362	20153	37359	53.94%	40.43%	42	81
8	花蓮縣花蓮市	2018-11-25T01:06:02+08:00	31595	7964	39559	2719	42278	78403	53.92%	40.3%	76	81
8	花蓮縣花蓮市	2018-11-24T23:42:03+08:00	19706	4966	24672	1762	26434	49227	53.7%	40.03%	52	81
8	花蓮縣花蓮市	2018-11-24T23:46:05+08:00	21433	5407	26840	1953	28793	53393	53.93%	40.14%	56	81
8	花蓮縣花蓮市	2018-11-25T04:01:31+08:00	33828	8590	42418	2948	45366	84807	53.49%	39.89%	81	81
8	花蓮縣花蓮市	2018-11-25T06:12:39+08:00	33828	8590	42418	2948	45366	84807	53.49%	39.89%	81	81
8	花蓮縣花蓮市	2018-11-24T22:21:48+08:00	7756	1876	9632	664	10296	18953	54.32%	40.92%	25	81
8	花蓮縣花蓮市	2018-11-25T00:21:46+08:00	26262	6630	32892	2304	35196	65444	53.78%	40.13%	66	81
8	花蓮縣花蓮市	2018-11-25T01:01:03+08:00	31055	7822	38877	2686	41563	76891	54.05%	40.39%	75	81
8	花蓮縣花蓮市	2018-11-24T22:35:46+08:00	8550	2062	10612	736	11348	20883	54.34%	40.94%	27	81
8	花蓮縣花蓮市	2018-11-24T23:58:44+08:00	22298	5616	27914	2022	29936	55541	53.9%	40.15%	58	81
8	花蓮縣花蓮市	2018-11-24T23:18:29+08:00	14554	3558	18112	1307	19419	36110	53.78%	40.3%	41	81
8	花蓮縣花蓮市	2018-11-25T03:37:31+08:00	33828	8590	42418	2948	45366	84807	53.49%	39.89%	81	81
8	花蓮縣花蓮市	2018-11-24T22:18:21+08:00	7447	1797	9244	638	9882	18238	54.18%	40.83%	24	81
8	花蓮縣花蓮市	2018-11-24T22:39:11+08:00	8550	2062	10612	736	11348	20883	54.34%	40.94%	27	81
8	花蓮縣花蓮市	2018-11-24T23:26:09+08:00	15665	3815	19480	1424	20904	38618	54.13%	40.56%	43	81
8	花蓮縣花蓮市	2018-11-25T00:03:37+08:00	23265	5857	29122	2081	31203	57960	53.84%	40.14%	60	81
8	花蓮縣花蓮市	2018-11-24T22:43:52+08:00	10043	2395	12438	874	13312	24607	54.1%	40.81%	30	81
8	桃園市	2018-11-24T23:07:11+08:00	435150	126102	561252	38864	600116	1167779	51.39%	37.26%	781	1
8	桃園市	2018-11-25T03:37:17+08:00	669790	192616	862406	57577	919983	1801823	51.06%	37.17%	142	1
8	桃園市	2018-11-24T22:49:16+08:00	378146	110463	488609	34361	522970	1017727	51.39%	37.16%	688	1
8	桃園市	2018-11-24T22:39:01+08:00	343051	100978	444029	31633	475662	925151	51.41%	37.08%	633	1
8	桃園市	2018-11-25T01:10:58+08:00	640555	184701	825256	55369	880625	1722791	51.12%	37.18%	099	1
8	桃園市	2018-11-24T22:43:42+08:00	360752	105478	466230	32859	499089	971301	51.38%	37.14%	660	1
8	桃園市	2018-11-25T00:12:37+08:00	579236	167396	746632	50356	796988	1557603	51.17%	37.19%	006	1
8	桃園市	2018-11-25T01:24:15+08:00	648456	187050	835506	55958	891464	1744395	51.1%	37.17%	111	1
8	桃園市	2018-11-24T22:56:30+08:00	399919	116572	516491	36064	552555	1074928	51.4%	37.2%	724	1
8	桃園市	2018-11-25T06:22:37+08:00	669790	192616	862406	57577	919983	1801823	51.06%	37.17%	142	1
8	桃園市	2018-11-25T03:30:50+08:00	669790	192616	862406	57577	919983	1801823	51.06%	37.17%	142	1
8	桃園市	2018-11-24T23:00:05+08:00	411945	119462	531407	36952	568359	1105116	51.43%	37.28%	742	1
8	桃園市	2018-11-25T03:48:21+08:00	669790	192616	862406	57577	919983	1801823	51.06%	37.17%	142	1
8	桃園市	2018-11-24T22:32:11+08:00	324536	95755	420291	29952	450243	875444	51.43%	37.07%	602	1
8	桃園市	2018-11-24T23:29:39+08:00	486762	141351	628113	43166	671279	1308341	51.31%	37.2%	863	1
8	桃園市	2018-11-25T04:01:21+08:00	669790	192616	862406	57577	919983	1801823	51.06%	37.17%	142	1
8	桃園市	2018-11-24T22:25:16+08:00	310319	91483	401802	28754	430556	836172	51.49%	37.11%	578	1
8	桃園市	2018-11-25T06:07:15+08:00	669790	192616	862406	57577	919983	1801823	51.06%	37.17%	142	1
8	桃園市	2018-11-25T00:07:56+08:00	569376	164609	733985	49619	783604	1531801	51.16%	37.17%	991	1
8	桃園市	2018-11-24T22:28:32+08:00	317644	93699	411343	29315	440658	856632	51.44%	37.08%	590	1
8	桃園市	2018-11-24T22:18:12+08:00	280824	83247	364071	25965	390036	757740	51.47%	37.06%	528	1
8	桃園市	2018-11-25T01:16:13+08:00	645320	186054	831374	55720	887094	1735748	51.11%	37.18%	106	1
8	桃園市	2018-11-24T23:54:17+08:00	540172	156421	696593	47395	743988	1451809	51.25%	37.21%	946	1
8	桃園市	2018-11-24T23:41:55+08:00	515563	149540	665103	45505	710608	1384849	51.31%	37.23%	907	1
8	桃園市	2018-11-24T23:22:15+08:00	471567	136775	608342	41791	650133	1266842	51.32%	37.22%	839	1
8	桃園市	2018-11-24T23:58:33+08:00	554064	160181	714245	48481	762726	1489763	51.2%	37.19%	967	1
8	桃園市	2018-11-24T22:35:38+08:00	330981	97580	428561	30499	459060	892885	51.41%	37.07%	613	1
8	桃園市	2018-11-24T23:03:40+08:00	430467	124799	555266	38531	593797	1155354	51.4%	37.26%	773	1
8	桃園市	2018-11-25T00:56:05+08:00	625669	180369	806038	54118	860156	1682350	51.13%	37.19%	077	1
8	桃園市	2018-11-25T06:27:48+08:00	669790	192616	862406	57577	919983	1801823	51.06%	37.17%	142	1
8	桃園市	2018-11-24T23:50:07+08:00	536439	155427	691866	47155	739021	1441427	51.27%	37.22%	941	1
8	桃園市	2018-11-25T00:03:25+08:00	559703	161817	721520	48855	770375	1504510	51.2%	37.2%	976	1
8	桃園市	2018-11-24T23:14:31+08:00	447056	129511	576567	39779	616346	1200630	51.34%	37.24%	800	1
8	桃園市	2018-11-25T00:21:36+08:00	593191	171229	764420	51477	815897	1595692	51.13%	37.17%	027	1
8	桃園市	2018-11-25T01:00:52+08:00	631740	182222	813962	54630	868592	1699212	51.12%	37.18%	086	1
8	桃園市	2018-11-24T22:21:37+08:00	299586	88637	388223	27752	415975	807990	51.48%	37.08%	561	1
8	桃園市	2018-11-25T06:12:30+08:00	669790	192616	862406	57577	919983	1801823	51.06%	37.17%	142	1
8	桃園市	2018-11-24T22:53:06+08:00	388775	113377	502152	35243	537395	1045670	51.39%	37.18%	705	1
8	桃園市	2018-11-24T22:40:12+08:00	351530	103173	454703	32283	486986	946994	51.42%	37.12%	646	1
8	桃園市	2018-11-25T00:17:00+08:00	585398	168974	754372	50783	805155	1573545	51.17%	37.2%	015	1
8	桃園市	2018-11-25T03:42:39+08:00	669790	192616	862406	57577	919983	1801823	51.06%	37.17%	142	1
8	桃園市	2018-11-24T22:11:56+08:00	260746	77204	337950	24092	362042	704546	51.39%	37.01%	493	1
8	桃園市	2018-11-24T22:14:40+08:00	271207	80236	351443	25137	376580	732886	51.38%	37.01%	511	1
8	桃園市	2018-11-24T23:33:43+08:00	499981	145263	645244	44270	689514	1343641	51.32%	37.21%	883	1
8	桃園市	2018-11-24T23:45:56+08:00	530671	153711	684382	46750	731132	1425419	51.29%	37.23%	932	1
8	桃園市	2018-11-24T23:18:20+08:00	455296	131993	587289	40522	627811	1223037	51.33%	37.23%	814	1
8	桃園市	2018-11-24T23:37:42+08:00	510515	148120	658635	45038	703673	1371645	51.3%	37.22%	899	1
8	桃園市	2018-11-25T01:05:50+08:00	635645	183304	818949	54976	873925	1709419	51.12%	37.18%	092	1
8	桃園市	2018-11-24T23:26:00+08:00	478912	138994	617906	42474	660380	1287048	51.31%	37.21%	851	1
8	桃園市	2018-11-24T23:10:49+08:00	440471	127729	568200	39314	607514	1183215	51.34%	37.23%	790	1
8	桃園市	2018-11-25T03:54:32+08:00	669790	192616	862406	57577	919983	1801823	51.06%	37.17%	142	1
8	桃園市	2018-11-25T06:17:28+08:00	669790	192616	862406	57577	919983	1801823	51.06%	37.17%	142	1
8	桃園市平鎮區	2018-11-25T03:37:17+08:00	71904	18993	90897	5495	96392	183560	52.51%	39.17%	125	125
8	桃園市平鎮區	2018-11-24T23:10:50+08:00	56478	15129	71607	4428	76035	143819	52.87%	39.27%	100	125
8	桃園市平鎮區	2018-11-24T23:22:16+08:00	60405	16106	76511	4702	81213	153734	52.83%	39.29%	107	125
8	桃園市平鎮區	2018-11-25T01:10:58+08:00	71904	18993	90897	5495	96392	183560	52.51%	39.17%	125	125
8	桃園市平鎮區	2018-11-25T00:12:37+08:00	67964	18053	86017	5268	91285	173362	52.66%	39.2%	119	125
8	桃園市平鎮區	2018-11-24T22:49:17+08:00	51095	13767	64862	4026	68888	130222	52.9%	39.24%	91	125
8	桃園市平鎮區	2018-11-24T23:14:32+08:00	57085	15289	72374	4462	76836	145383	52.85%	39.27%	101	125
8	桃園市平鎮區	2018-11-24T22:43:43+08:00	47965	12974	60939	3775	64714	122144	52.98%	39.27%	86	125
8	桃園市平鎮區	2018-11-24T22:56:30+08:00	53234	14351	67585	4181	71766	135718	52.88%	39.22%	95	125
8	桃園市平鎮區	2018-11-25T06:22:37+08:00	71904	18993	90897	5495	96392	183560	52.51%	39.17%	125	125
8	桃園市平鎮區	2018-11-25T03:30:50+08:00	71904	18993	90897	5495	96392	183560	52.51%	39.17%	125	125
8	桃園市平鎮區	2018-11-25T03:48:21+08:00	71904	18993	90897	5495	96392	183560	52.51%	39.17%	125	125
8	桃園市平鎮區	2018-11-24T22:32:11+08:00	43291	11896	55187	3400	58587	110077	53.22%	39.33%	79	125
8	桃園市平鎮區	2018-11-24T23:29:39+08:00	62911	16776	79687	4882	84569	160442	52.71%	39.21%	111	125
8	桃園市平鎮區	2018-11-25T04:01:21+08:00	71904	18993	90897	5495	96392	183560	52.51%	39.17%	125	125
8	桃園市平鎮區	2018-11-24T22:25:17+08:00	42063	11576	53639	3343	56982	106881	53.31%	39.35%	77	125
8	桃園市平鎮區	2018-11-25T06:07:15+08:00	71904	18993	90897	5495	96392	183560	52.51%	39.17%	125	125
8	桃園市平鎮區	2018-11-24T22:18:12+08:00	39341	10867	50208	3124	53332	99914	53.38%	39.37%	73	125
8	桃園市平鎮區	2018-11-24T23:54:18+08:00	64713	17243	81956	5058	87014	164986	52.74%	39.22%	114	125
8	桃園市平鎮區	2018-11-25T00:07:57+08:00	67964	18053	86017	5268	91285	173362	52.66%	39.2%	119	125
8	桃園市平鎮區	2018-11-25T01:16:14+08:00	71904	18993	90897	5495	96392	183560	52.51%	39.17%	125	125
8	桃園市平鎮區	2018-11-24T23:41:55+08:00	64713	17243	81956	5058	87014	164986	52.74%	39.22%	114	125
8	桃園市平鎮區	2018-11-24T22:28:33+08:00	42732	11739	54471	3359	57830	108437	53.33%	39.41%	78	125
8	桃園市平鎮區	2018-11-24T23:58:34+08:00	66090	17590	83680	5153	88833	168286	52.79%	39.27%	116	125
8	桃園市平鎮區	2018-11-25T01:24:16+08:00	71904	18993	90897	5495	96392	183560	52.51%	39.17%	125	125
8	桃園市平鎮區	2018-11-24T22:35:38+08:00	44367	12248	56615	3506	60121	113018	53.2%	39.26%	81	125
8	桃園市平鎮區	2018-11-24T23:07:12+08:00	56478	15129	71607	4428	76035	143819	52.87%	39.27%	100	125
8	桃園市平鎮區	2018-11-24T22:39:02+08:00	46227	12792	59019	3688	62707	118162	53.07%	39.12%	84	125
8	桃園市平鎮區	2018-11-25T00:56:05+08:00	71211	18814	90025	5463	95488	181648	52.57%	39.2%	124	125
8	桃園市平鎮區	2018-11-25T06:27:48+08:00	71904	18993	90897	5495	96392	183560	52.51%	39.17%	125	125
8	桃園市平鎮區	2018-11-24T23:50:07+08:00	64713	17243	81956	5058	87014	164986	52.74%	39.22%	114	125
8	桃園市平鎮區	2018-11-25T00:03:25+08:00	66734	17767	84501	5196	89697	169841	52.81%	39.29%	117	125
8	桃園市平鎮區	2018-11-24T23:03:41+08:00	56478	15129	71607	4428	76035	143819	52.87%	39.27%	100	125
8	桃園市平鎮區	2018-11-24T23:00:06+08:00	54563	14736	69299	4267	73566	139160	52.86%	39.21%	97	125
8	桃園市平鎮區	2018-11-24T22:21:38+08:00	41361	11394	52755	3311	56066	104887	53.45%	39.43%	76	125
8	桃園市平鎮區	2018-11-25T03:42:40+08:00	71904	18993	90897	5495	96392	183560	52.51%	39.17%	125	125
8	桃園市平鎮區	2018-11-25T00:21:36+08:00	68605	18194	86799	5299	92098	175079	52.6%	39.19%	120	125
8	桃園市平鎮區	2018-11-25T01:00:52+08:00	71904	18993	90897	5495	96392	183560	52.51%	39.17%	125	125
8	桃園市平鎮區	2018-11-25T06:12:30+08:00	71904	18993	90897	5495	96392	183560	52.51%	39.17%	125	125
8	桃園市平鎮區	2018-11-24T22:40:12+08:00	47059	12955	60014	3740	63754	120093	53.09%	39.19%	85	125
8	桃園市平鎮區	2018-11-25T00:17:01+08:00	68605	18194	86799	5299	92098	175079	52.6%	39.19%	120	125
8	桃園市平鎮區	2018-11-24T22:53:07+08:00	52160	14031	66191	4084	70275	132780	52.93%	39.28%	93	125
8	桃園市平鎮區	2018-11-24T22:11:56+08:00	37147	10295	47442	2972	50414	94380	53.42%	39.36%	69	125
8	桃園市平鎮區	2018-11-25T03:54:33+08:00	71904	18993	90897	5495	96392	183560	52.51%	39.17%	125	125
8	桃園市平鎮區	2018-11-25T01:05:51+08:00	71904	18993	90897	5495	96392	183560	52.51%	39.17%	125	125
8	桃園市平鎮區	2018-11-24T23:33:43+08:00	62911	16776	79687	4882	84569	160442	52.71%	39.21%	111	125
8	桃園市平鎮區	2018-11-24T23:18:20+08:00	58124	15558	73682	4541	78223	147912	52.88%	39.3%	103	125
8	桃園市平鎮區	2018-11-24T23:37:42+08:00	64177	17115	81292	4975	86267	163601	52.73%	39.23%	113	125
8	桃園市平鎮區	2018-11-24T22:14:41+08:00	38383	10618	49001	3048	52049	97668	53.29%	39.3%	71	125
8	桃園市平鎮區	2018-11-24T23:26:00+08:00	61488	16424	77912	4799	82711	156769	52.76%	39.22%	109	125
8	桃園市平鎮區	2018-11-25T06:17:28+08:00	71904	18993	90897	5495	96392	183560	52.51%	39.17%	125	125
8	桃園市平鎮區	2018-11-24T23:45:57+08:00	64713	17243	81956	5058	87014	164986	52.74%	39.22%	114	125
8	臺中市大雅區	2018-11-24T23:10:50+08:00	29459	8040	37499	2638	40137	70871	56.63%	41.57%	42	46
8	臺中市大雅區	2018-11-25T00:56:06+08:00	32177	8781	40958	2890	43848	77189	56.81%	41.69%	46	46
8	臺中市大雅區	2018-11-24T23:14:33+08:00	29459	8040	37499	2638	40137	70871	56.63%	41.57%	42	46
8	臺中市大雅區	2018-11-24T23:22:16+08:00	30832	8440	39272	2781	42053	74074	56.77%	41.62%	44	46
8	臺中市大雅區	2018-11-24T22:56:31+08:00	27922	7606	35528	2507	38035	66960	56.8%	41.7%	40	46
8	臺中市大雅區	2018-11-25T00:12:39+08:00	32177	8781	40958	2890	43848	77189	56.81%	41.69%	46	46
8	臺中市大雅區	2018-11-24T22:49:17+08:00	27922	7606	35528	2507	38035	66960	56.8%	41.7%	40	46
8	臺中市大雅區	2018-11-25T03:37:18+08:00	32177	8781	40958	2890	43848	77189	56.81%	41.69%	46	46
8	臺中市大雅區	2018-11-24T22:43:44+08:00	27922	7606	35528	2507	38035	66960	56.8%	41.7%	40	46
8	臺中市大雅區	2018-11-25T00:03:26+08:00	32177	8781	40958	2890	43848	77189	56.81%	41.69%	46	46
8	臺中市大雅區	2018-11-25T01:10:59+08:00	32177	8781	40958	2890	43848	77189	56.81%	41.69%	46	46
8	臺中市大雅區	2018-11-25T06:22:39+08:00	32177	8781	40958	2890	43848	77189	56.81%	41.69%	46	46
8	臺中市大雅區	2018-11-25T03:30:51+08:00	32177	8781	40958	2890	43848	77189	56.81%	41.69%	46	46
8	臺中市大雅區	2018-11-24T22:25:17+08:00	24943	6719	31662	2286	33948	59740	56.83%	41.75%	36	46
8	臺中市大雅區	2018-11-24T23:29:40+08:00	31594	8597	40191	2852	43043	75807	56.78%	41.68%	45	46
8	臺中市大雅區	2018-11-25T01:16:15+08:00	32177	8781	40958	2890	43848	77189	56.81%	41.69%	46	46
8	臺中市大雅區	2018-11-25T01:05:52+08:00	32177	8781	40958	2890	43848	77189	56.81%	41.69%	46	46
8	臺中市大雅區	2018-11-24T23:54:18+08:00	32177	8781	40958	2890	43848	77189	56.81%	41.69%	46	46
8	臺中市大雅區	2018-11-25T00:07:57+08:00	32177	8781	40958	2890	43848	77189	56.81%	41.69%	46	46
8	臺中市大雅區	2018-11-24T22:14:42+08:00	21203	5995	27198	1958	29156	50873	57.31%	41.68%	31	46
8	臺中市大雅區	2018-11-24T22:18:13+08:00	21857	6144	28001	2013	30014	52752	56.9%	41.43%	32	46
8	臺中市大雅區	2018-11-24T22:28:33+08:00	26366	7162	33528	2376	35904	63160	56.85%	41.74%	38	46
8	臺中市大雅區	2018-11-24T23:50:08+08:00	32177	8781	40958	2890	43848	77189	56.81%	41.69%	46	46
8	臺中市大雅區	2018-11-24T23:07:12+08:00	29459	8040	37499	2638	40137	70871	56.63%	41.57%	42	46
8	臺中市大雅區	2018-11-24T22:39:02+08:00	27922	7606	35528	2507	38035	66960	56.8%	41.7%	40	46
8	臺中市大雅區	2018-11-25T01:24:17+08:00	32177	8781	40958	2890	43848	77189	56.81%	41.69%	46	46
8	臺中市大雅區	2018-11-24T22:35:39+08:00	27171	7395	34566	2439	37005	65144	56.8%	41.71%	39	46
8	臺中市大雅區	2018-11-24T23:58:35+08:00	32177	8781	40958	2890	43848	77189	56.81%	41.69%	46	46
8	臺中市大雅區	2018-11-25T06:27:49+08:00	32177	8781	40958	2890	43848	77189	56.81%	41.69%	46	46
8	臺中市大雅區	2018-11-24T23:03:41+08:00	29459	8040	37499	2638	40137	70871	56.63%	41.57%	42	46
8	臺中市大雅區	2018-11-25T01:00:53+08:00	32177	8781	40958	2890	43848	77189	56.81%	41.69%	46	46
8	臺中市大雅區	2018-11-24T23:00:08+08:00	27922	7606	35528	2507	38035	66960	56.8%	41.7%	40	46
8	臺中市大雅區	2018-11-25T03:48:22+08:00	32177	8781	40958	2890	43848	77189	56.81%	41.69%	46	46
8	臺中市大雅區	2018-11-25T00:21:37+08:00	32177	8781	40958	2890	43848	77189	56.81%	41.69%	46	46
8	臺中市大雅區	2018-11-25T03:42:41+08:00	32177	8781	40958	2890	43848	77189	56.81%	41.69%	46	46
8	臺中市大雅區	2018-11-24T22:21:39+08:00	23292	6509	29801	2166	31967	56362	56.72%	41.33%	34	46
8	臺中市大雅區	2018-11-24T22:32:12+08:00	27171	7395	34566	2439	37005	65144	56.8%	41.71%	39	46
8	臺中市大雅區	2018-11-25T04:01:22+08:00	32177	8781	40958	2890	43848	77189	56.81%	41.69%	46	46
8	臺中市大雅區	2018-11-24T22:11:57+08:00	19723	5571	25294	1816	27110	47448	57.14%	41.57%	29	46
8	臺中市大雅區	2018-11-25T00:17:01+08:00	32177	8781	40958	2890	43848	77189	56.81%	41.69%	46	46
8	臺中市大雅區	2018-11-24T22:40:13+08:00	27922	7606	35528	2507	38035	66960	56.8%	41.7%	40	46
8	臺中市大雅區	2018-11-24T22:53:07+08:00	27922	7606	35528	2507	38035	66960	56.8%	41.7%	40	46
8	臺中市大雅區	2018-11-25T06:12:31+08:00	32177	8781	40958	2890	43848	77189	56.81%	41.69%	46	46
8	臺中市大雅區	2018-11-25T06:07:16+08:00	32177	8781	40958	2890	43848	77189	56.81%	41.69%	46	46
8	臺中市大雅區	2018-11-24T23:33:44+08:00	31594	8597	40191	2852	43043	75807	56.78%	41.68%	45	46
8	臺中市大雅區	2018-11-25T03:54:33+08:00	32177	8781	40958	2890	43848	77189	56.81%	41.69%	46	46
8	臺中市大雅區	2018-11-24T23:26:01+08:00	30832	8440	39272	2781	42053	74074	56.77%	41.62%	44	46
8	臺中市大雅區	2018-11-25T06:17:29+08:00	32177	8781	40958	2890	43848	77189	56.81%	41.69%	46	46
8	臺中市大雅區	2018-11-24T23:41:56+08:00	32177	8781	40958	2890	43848	77189	56.81%	41.69%	46	46
8	臺中市大雅區	2018-11-24T23:37:43+08:00	31594	8597	40191	2852	43043	75807	56.78%	41.68%	45	46
8	臺中市大雅區	2018-11-24T23:18:21+08:00	30158	8265	38423	2700	41123	72439	56.77%	41.63%	43	46
8	臺中市大雅區	2018-11-24T23:45:57+08:00	32177	8781	40958	2890	43848	77189	56.81%	41.69%	46	46
8	臺中市北屯區	2018-11-25T03:37:17+08:00	95846	25843	121689	7633	129322	227720	56.79%	42.09%	137	137
8	臺中市北屯區	2018-11-24T23:10:50+08:00	74618	19980	94598	6030	100628	175315	57.4%	42.56%	108	137
8	臺中市北屯區	2018-11-25T00:56:06+08:00	92054	24791	116845	7339	124184	218374	56.87%	42.15%	132	137
8	臺中市北屯區	2018-11-24T23:22:16+08:00	78441	20972	99413	6322	105735	184855	57.2%	42.43%	113	137
8	臺中市北屯區	2018-11-25T01:10:58+08:00	92054	24791	116845	7339	124184	218374	56.87%	42.15%	132	137
8	臺中市北屯區	2018-11-24T22:49:17+08:00	69661	18649	88310	5579	93889	163505	57.42%	42.6%	101	137
8	臺中市北屯區	2018-11-24T23:14:32+08:00	75364	20174	95538	6101	101639	177238	57.35%	42.52%	109	137
8	臺中市北屯區	2018-11-24T22:43:43+08:00	67037	17993	85030	5397	90427	157404	57.45%	42.59%	97	137
8	臺中市北屯區	2018-11-25T00:03:26+08:00	86878	23308	110186	6966	117152	205543	57%	42.27%	125	137
8	臺中市北屯區	2018-11-24T22:56:30+08:00	71041	19012	90053	5683	95736	166780	57.4%	42.6%	103	137
8	臺中市北屯區	2018-11-25T00:12:38+08:00	89175	23984	113159	7095	120254	211066	56.97%	42.25%	128	137
8	臺中市北屯區	2018-11-25T06:22:38+08:00	95846	25843	121689	7633	129322	227720	56.79%	42.09%	137	137
8	臺中市北屯區	2018-11-25T03:30:51+08:00	95846	25843	121689	7633	129322	227720	56.79%	42.09%	137	137
8	臺中市北屯區	2018-11-24T22:25:17+08:00	58705	15725	74430	4733	79163	138070	57.34%	42.52%	86	137
8	臺中市北屯區	2018-11-25T06:07:15+08:00	95846	25843	121689	7633	129322	227720	56.79%	42.09%	137	137
8	臺中市北屯區	2018-11-24T23:29:40+08:00	81331	21895	103226	6597	109823	192179	57.15%	42.32%	117	137
8	臺中市北屯區	2018-11-24T23:54:18+08:00	84066	22625	106691	6763	113454	198735	57.09%	42.3%	121	137
8	臺中市北屯區	2018-11-25T00:07:57+08:00	88290	23773	112063	7037	119100	209192	56.93%	42.21%	127	137
8	臺中市北屯區	2018-11-25T01:16:14+08:00	92898	25019	117917	7423	125340	220525	56.84%	42.13%	133	137
8	臺中市北屯區	2018-11-24T22:18:13+08:00	52918	14136	67054	4282	71336	124354	57.37%	42.55%	78	137
8	臺中市北屯區	2018-11-24T23:41:55+08:00	82802	22295	105097	6692	111789	195649	57.14%	42.32%	119	137
8	臺中市北屯區	2018-11-24T22:28:33+08:00	61060	16391	77451	4899	82350	143257	57.48%	42.62%	89	137
8	臺中市北屯區	2018-11-24T23:58:34+08:00	85274	22944	108218	6885	115103	201782	57.04%	42.26%	123	137
8	臺中市北屯區	2018-11-24T23:50:08+08:00	84066	22625	106691	6763	113454	198735	57.09%	42.3%	121	137
8	臺中市北屯區	2018-11-25T01:24:16+08:00	92898	25019	117917	7423	125340	220525	56.84%	42.13%	133	137
8	臺中市北屯區	2018-11-24T22:35:38+08:00	62452	16782	79234	5036	84270	146640	57.47%	42.59%	91	137
8	臺中市北屯區	2018-11-24T23:07:12+08:00	74618	19980	94598	6030	100628	175315	57.4%	42.56%	108	137
8	臺中市北屯區	2018-11-24T22:39:02+08:00	63054	16954	80008	5102	85110	148199	57.43%	42.55%	92	137
8	臺中市北屯區	2018-11-25T06:27:48+08:00	95846	25843	121689	7633	129322	227720	56.79%	42.09%	137	137
8	臺中市北屯區	2018-11-24T23:03:41+08:00	72558	19419	91977	5817	97794	170461	57.37%	42.57%	105	137
8	臺中市北屯區	2018-11-25T01:00:53+08:00	92054	24791	116845	7339	124184	218374	56.87%	42.15%	132	137
8	臺中市北屯區	2018-11-25T03:48:22+08:00	95846	25843	121689	7633	129322	227720	56.79%	42.09%	137	137
8	臺中市北屯區	2018-11-25T00:21:37+08:00	91241	24559	115800	7270	123070	216322	56.89%	42.18%	131	137
8	臺中市北屯區	2018-11-24T22:21:38+08:00	58705	15725	74430	4733	79163	138070	57.34%	42.52%	86	137
8	臺中市北屯區	2018-11-25T03:42:40+08:00	95846	25843	121689	7633	129322	227720	56.79%	42.09%	137	137
8	臺中市北屯區	2018-11-24T23:00:07+08:00	71041	19012	90053	5683	95736	166780	57.4%	42.6%	103	137
8	臺中市北屯區	2018-11-24T22:32:12+08:00	61060	16391	77451	4899	82350	143257	57.48%	42.62%	89	137
8	臺中市北屯區	2018-11-25T06:12:30+08:00	95846	25843	121689	7633	129322	227720	56.79%	42.09%	137	137
8	臺中市北屯區	2018-11-25T04:01:22+08:00	95846	25843	121689	7633	129322	227720	56.79%	42.09%	137	137
8	臺中市北屯區	2018-11-25T00:17:01+08:00	89949	24208	114157	7162	121319	213099	56.93%	42.21%	129	137
8	臺中市北屯區	2018-11-24T22:40:13+08:00	64831	17386	82217	5226	87443	151863	57.58%	42.69%	94	137
8	臺中市北屯區	2018-11-24T22:53:07+08:00	71041	19012	90053	5683	95736	166780	57.4%	42.6%	103	137
8	臺中市北屯區	2018-11-24T22:11:56+08:00	49110	13086	62196	3985	66181	115252	57.42%	42.61%	73	137
8	臺中市北屯區	2018-11-25T03:54:33+08:00	95846	25843	121689	7633	129322	227720	56.79%	42.09%	137	137
8	臺中市北屯區	2018-11-25T01:05:51+08:00	92054	24791	116845	7339	124184	218374	56.87%	42.15%	132	137
8	臺中市北屯區	2018-11-24T23:26:01+08:00	79918	21385	101303	6455	107758	188439	57.18%	42.41%	115	137
8	臺中市北屯區	2018-11-24T23:33:43+08:00	81331	21895	103226	6597	109823	192179	57.15%	42.32%	117	137
8	臺中市北屯區	2018-11-24T23:18:20+08:00	76770	20551	97321	6232	103553	180576	57.35%	42.51%	111	137
8	臺中市北屯區	2018-11-25T06:17:29+08:00	95846	25843	121689	7633	129322	227720	56.79%	42.09%	137	137
8	臺中市北屯區	2018-11-24T23:37:42+08:00	82129	22109	104238	6655	110893	194054	57.15%	42.32%	118	137
8	臺中市北屯區	2018-11-24T22:14:41+08:00	52171	13927	66098	4236	70334	122857	57.25%	42.46%	77	137
8	臺中市北屯區	2018-11-24T23:45:57+08:00	83377	22457	105834	6731	112565	196966	57.15%	42.33%	120	137
8	屏東縣萬巒鄉	2018-11-24T23:07:19+08:00	5697	2105	7802	1120	8922	17945	49.72%	31.75%	18	18
8	屏東縣萬巒鄉	2018-11-24T23:10:56+08:00	5697	2105	7802	1120	8922	17945	49.72%	31.75%	18	18
8	屏東縣萬巒鄉	2018-11-24T22:39:09+08:00	5697	2105	7802	1120	8922	17945	49.72%	31.75%	18	18
8	屏東縣萬巒鄉	2018-11-25T06:17:37+08:00	5697	2105	7802	1120	8922	17945	49.72%	31.75%	18	18
8	屏東縣萬巒鄉	2018-11-25T01:24:25+08:00	5697	2105	7802	1120	8922	17945	49.72%	31.75%	18	18
8	屏東縣萬巒鄉	2018-11-24T22:56:37+08:00	5697	2105	7802	1120	8922	17945	49.72%	31.75%	18	18
8	屏東縣萬巒鄉	2018-11-25T03:54:41+08:00	5697	2105	7802	1120	8922	17945	49.72%	31.75%	18	18
8	屏東縣萬巒鄉	2018-11-24T22:32:19+08:00	5697	2105	7802	1120	8922	17945	49.72%	31.75%	18	18
8	屏東縣萬巒鄉	2018-11-24T22:53:16+08:00	5697	2105	7802	1120	8922	17945	49.72%	31.75%	18	18
8	屏東縣萬巒鄉	2018-11-25T01:06:00+08:00	5697	2105	7802	1120	8922	17945	49.72%	31.75%	18	18
8	屏東縣萬巒鄉	2018-11-24T22:25:26+08:00	5357	1972	7329	1095	8424	16717	50.39%	32.05%	17	18
8	屏東縣萬巒鄉	2018-11-24T23:00:17+08:00	5697	2105	7802	1120	8922	17945	49.72%	31.75%	18	18
8	屏東縣萬巒鄉	2018-11-25T01:11:08+08:00	5697	2105	7802	1120	8922	17945	49.72%	31.75%	18	18
8	屏東縣萬巒鄉	2018-11-25T06:07:23+08:00	5697	2105	7802	1120	8922	17945	49.72%	31.75%	18	18
8	屏東縣萬巒鄉	2018-11-24T22:40:19+08:00	5697	2105	7802	1120	8922	17945	49.72%	31.75%	18	18
8	屏東縣萬巒鄉	2018-11-24T23:29:47+08:00	5697	2105	7802	1120	8922	17945	49.72%	31.75%	18	18
8	屏東縣萬巒鄉	2018-11-25T00:21:45+08:00	5697	2105	7802	1120	8922	17945	49.72%	31.75%	18	18
8	屏東縣萬巒鄉	2018-11-25T03:31:00+08:00	5697	2105	7802	1120	8922	17945	49.72%	31.75%	18	18
8	屏東縣萬巒鄉	2018-11-25T01:16:23+08:00	5697	2105	7802	1120	8922	17945	49.72%	31.75%	18	18
8	屏東縣萬巒鄉	2018-11-25T00:03:35+08:00	5697	2105	7802	1120	8922	17945	49.72%	31.75%	18	18
8	屏東縣萬巒鄉	2018-11-25T00:56:14+08:00	5697	2105	7802	1120	8922	17945	49.72%	31.75%	18	18
8	屏東縣萬巒鄉	2018-11-24T22:35:45+08:00	5697	2105	7802	1120	8922	17945	49.72%	31.75%	18	18
8	屏東縣萬巒鄉	2018-11-24T23:37:49+08:00	5697	2105	7802	1120	8922	17945	49.72%	31.75%	18	18
8	屏東縣萬巒鄉	2018-11-24T22:43:51+08:00	5697	2105	7802	1120	8922	17945	49.72%	31.75%	18	18
8	屏東縣萬巒鄉	2018-11-25T06:27:56+08:00	5697	2105	7802	1120	8922	17945	49.72%	31.75%	18	18
8	屏東縣萬巒鄉	2018-11-24T23:54:28+08:00	5697	2105	7802	1120	8922	17945	49.72%	31.75%	18	18
8	屏東縣萬巒鄉	2018-11-24T23:22:24+08:00	5697	2105	7802	1120	8922	17945	49.72%	31.75%	18	18
8	屏東縣萬巒鄉	2018-11-24T22:28:41+08:00	5357	1972	7329	1095	8424	16717	50.39%	32.05%	17	18
8	屏東縣萬巒鄉	2018-11-24T22:12:03+08:00	4575	1660	6235	964	7199	13949	51.61%	32.8%	15	18
8	屏東縣萬巒鄉	2018-11-24T23:33:51+08:00	5697	2105	7802	1120	8922	17945	49.72%	31.75%	18	18
8	屏東縣萬巒鄉	2018-11-24T23:03:48+08:00	5697	2105	7802	1120	8922	17945	49.72%	31.75%	18	18
8	屏東縣萬巒鄉	2018-11-24T22:49:25+08:00	5697	2105	7802	1120	8922	17945	49.72%	31.75%	18	18
8	屏東縣萬巒鄉	2018-11-25T04:01:30+08:00	5697	2105	7802	1120	8922	17945	49.72%	31.75%	18	18
8	屏東縣萬巒鄉	2018-11-25T03:42:49+08:00	5697	2105	7802	1120	8922	17945	49.72%	31.75%	18	18
8	屏東縣萬巒鄉	2018-11-24T23:42:02+08:00	5697	2105	7802	1120	8922	17945	49.72%	31.75%	18	18
8	屏東縣萬巒鄉	2018-11-25T00:08:05+08:00	5697	2105	7802	1120	8922	17945	49.72%	31.75%	18	18
8	屏東縣萬巒鄉	2018-11-24T23:46:04+08:00	5697	2105	7802	1120	8922	17945	49.72%	31.75%	18	18
8	屏東縣萬巒鄉	2018-11-25T00:17:09+08:00	5697	2105	7802	1120	8922	17945	49.72%	31.75%	18	18
8	屏東縣萬巒鄉	2018-11-25T06:12:37+08:00	5697	2105	7802	1120	8922	17945	49.72%	31.75%	18	18
8	屏東縣萬巒鄉	2018-11-25T06:22:45+08:00	5697	2105	7802	1120	8922	17945	49.72%	31.75%	18	18
8	屏東縣萬巒鄉	2018-11-24T22:21:47+08:00	5357	1972	7329	1095	8424	16717	50.39%	32.05%	17	18
8	屏東縣萬巒鄉	2018-11-25T03:48:31+08:00	5697	2105	7802	1120	8922	17945	49.72%	31.75%	18	18
8	屏東縣萬巒鄉	2018-11-24T22:14:49+08:00	4940	1767	6707	988	7695	15069	51.07%	32.78%	16	18
8	屏東縣萬巒鄉	2018-11-24T22:18:20+08:00	4940	1767	6707	988	7695	15069	51.07%	32.78%	16	18
8	屏東縣萬巒鄉	2018-11-25T03:37:30+08:00	5697	2105	7802	1120	8922	17945	49.72%	31.75%	18	18
8	屏東縣萬巒鄉	2018-11-24T23:58:43+08:00	5697	2105	7802	1120	8922	17945	49.72%	31.75%	18	18
8	屏東縣萬巒鄉	2018-11-24T23:26:07+08:00	5697	2105	7802	1120	8922	17945	49.72%	31.75%	18	18
8	屏東縣萬巒鄉	2018-11-25T00:12:45+08:00	5697	2105	7802	1120	8922	17945	49.72%	31.75%	18	18
8	屏東縣萬巒鄉	2018-11-25T01:01:02+08:00	5697	2105	7802	1120	8922	17945	49.72%	31.75%	18	18
8	屏東縣萬巒鄉	2018-11-24T23:18:28+08:00	5697	2105	7802	1120	8922	17945	49.72%	31.75%	18	18
8	屏東縣萬巒鄉	2018-11-24T23:14:41+08:00	5697	2105	7802	1120	8922	17945	49.72%	31.75%	18	18
8	屏東縣萬巒鄉	2018-11-24T23:50:15+08:00	5697	2105	7802	1120	8922	17945	49.72%	31.75%	18	18
8	臺南市安平區	2018-11-25T00:56:08+08:00	19061	6603	25664	1803	27467	55379	49.6%	34.42%	32	32
8	臺南市安平區	2018-11-24T23:03:43+08:00	10633	3541	14174	903	15077	30003	50.25%	35.44%	18	32
8	臺南市安平區	2018-11-24T23:58:37+08:00	15354	5248	20602	1346	21948	44057	49.82%	34.85%	26	32
8	臺南市安平區	2018-11-25T06:17:31+08:00	19061	6603	25664	1803	27467	55379	49.6%	34.42%	32	32
8	臺南市安平區	2018-11-24T23:22:18+08:00	12367	4152	16519	1039	17558	34933	50.26%	35.4%	21	32
8	臺南市安平區	2018-11-24T22:43:45+08:00	7960	2619	10579	666	11245	22140	50.79%	35.95%	14	32
8	臺南市安平區	2018-11-24T23:14:35+08:00	11723	3952	15675	962	16637	33258	50.02%	35.25%	20	32
8	臺南市安平區	2018-11-25T03:37:20+08:00	19061	6603	25664	1803	27467	55379	49.6%	34.42%	32	32
8	臺南市安平區	2018-11-24T22:49:19+08:00	7960	2619	10579	666	11245	22140	50.79%	35.95%	14	32
8	臺南市安平區	2018-11-25T00:03:28+08:00	15354	5248	20602	1346	21948	44057	49.82%	34.85%	26	32
8	臺南市安平區	2018-11-25T03:42:43+08:00	19061	6603	25664	1803	27467	55379	49.6%	34.42%	32	32
8	臺南市安平區	2018-11-24T22:25:19+08:00	6024	1993	8017	498	8515	16783	50.74%	35.89%	11	32
8	臺南市安平區	2018-11-25T00:17:03+08:00	17040	5867	22907	1567	24474	49173	49.77%	34.65%	29	32
8	臺南市安平區	2018-11-25T01:11:01+08:00	19061	6603	25664	1803	27467	55379	49.6%	34.42%	32	32
8	臺南市安平區	2018-11-25T06:22:41+08:00	19061	6603	25664	1803	27467	55379	49.6%	34.42%	32	32
8	臺南市安平區	2018-11-25T06:12:32+08:00	19061	6603	25664	1803	27467	55379	49.6%	34.42%	32	32
8	臺南市安平區	2018-11-24T23:50:10+08:00	14301	4856	19157	1259	20416	40575	50.32%	35.25%	24	32
8	臺南市安平區	2018-11-24T22:18:15+08:00	4700	1570	6270	382	6652	13254	50.19%	35.46%	9	32
8	臺南市安平區	2018-11-25T00:12:40+08:00	16562	5655	22217	1475	23692	47681	49.69%	34.74%	28	32
8	臺南市安平區	2018-11-24T22:28:35+08:00	6662	2231	8893	587	9480	18536	51.14%	35.94%	12	32
8	臺南市安平區	2018-11-24T23:26:02+08:00	13106	4383	17489	1091	18580	37040	50.16%	35.38%	22	32
8	臺南市安平區	2018-11-24T23:54:20+08:00	14797	5046	19843	1292	21135	42329	49.93%	34.96%	25	32
8	臺南市安平區	2018-11-24T22:14:44+08:00	4700	1570	6270	382	6652	13254	50.19%	35.46%	9	32
8	臺南市安平區	2018-11-25T06:27:50+08:00	19061	6603	25664	1803	27467	55379	49.6%	34.42%	32	32
8	臺南市安平區	2018-11-25T00:07:59+08:00	16068	5437	21505	1430	22935	46058	49.8%	34.89%	27	32
8	臺南市安平區	2018-11-24T23:18:22+08:00	11723	3952	15675	962	16637	33258	50.02%	35.25%	20	32
8	臺南市安平區	2018-11-25T01:05:53+08:00	19061	6603	25664	1803	27467	55379	49.6%	34.42%	32	32
8	臺南市安平區	2018-11-24T22:56:32+08:00	9501	3133	12634	818	13452	26546	50.67%	35.79%	16	32
8	臺南市安平區	2018-11-25T01:24:19+08:00	19061	6603	25664	1803	27467	55379	49.6%	34.42%	32	32
8	臺南市安平區	2018-11-24T22:39:04+08:00	6662	2231	8893	587	9480	18536	51.14%	35.94%	12	32
8	臺南市安平區	2018-11-24T23:10:52+08:00	11174	3746	14920	926	15846	31656	50.06%	35.3%	19	32
8	臺南市安平區	2018-11-24T23:07:14+08:00	11174	3746	14920	926	15846	31656	50.06%	35.3%	19	32
8	臺南市安平區	2018-11-25T00:21:39+08:00	17714	6134	23848	1636	25484	51152	49.82%	34.63%	30	32
8	臺南市安平區	2018-11-24T22:32:13+08:00	6662	2231	8893	587	9480	18536	51.14%	35.94%	12	32
8	臺南市安平區	2018-11-25T03:30:53+08:00	19061	6603	25664	1803	27467	55379	49.6%	34.42%	32	32
8	臺南市安平區	2018-11-25T03:48:24+08:00	19061	6603	25664	1803	27467	55379	49.6%	34.42%	32	32
8	臺南市安平區	2018-11-25T01:00:55+08:00	19061	6603	25664	1803	27467	55379	49.6%	34.42%	32	32
8	臺南市安平區	2018-11-24T23:29:42+08:00	13106	4383	17489	1091	18580	37040	50.16%	35.38%	22	32
8	臺南市安平區	2018-11-24T23:00:13+08:00	9889	3266	13155	862	14017	27871	50.29%	35.48%	17	32
8	臺南市安平區	2018-11-24T22:21:41+08:00	6024	1993	8017	498	8515	16783	50.74%	35.89%	11	32
8	臺南市安平區	2018-11-24T22:53:09+08:00	8640	2823	11463	729	12192	23999	50.8%	36%	15	32
8	臺南市安平區	2018-11-24T22:40:14+08:00	7407	2437	9844	643	10487	20690	50.69%	35.8%	13	32
8	臺南市安平區	2018-11-25T06:07:18+08:00	19061	6603	25664	1803	27467	55379	49.6%	34.42%	32	32
8	臺南市安平區	2018-11-24T22:11:58+08:00	3820	1257	5077	323	5400	10847	49.78%	35.22%	8	32
8	臺南市安平區	2018-11-25T04:01:24+08:00	19061	6603	25664	1803	27467	55379	49.6%	34.42%	32	32
8	臺南市安平區	2018-11-24T23:41:57+08:00	14301	4856	19157	1259	20416	40575	50.32%	35.25%	24	32
8	臺南市安平區	2018-11-25T01:16:16+08:00	19061	6603	25664	1803	27467	55379	49.6%	34.42%	32	32
8	臺南市安平區	2018-11-24T22:35:40+08:00	6662	2231	8893	587	9480	18536	51.14%	35.94%	12	32
8	臺南市安平區	2018-11-25T03:54:35+08:00	19061	6603	25664	1803	27467	55379	49.6%	34.42%	32	32
8	臺南市安平區	2018-11-24T23:33:45+08:00	14301	4856	19157	1259	20416	40575	50.32%	35.25%	24	32
8	臺南市安平區	2018-11-24T23:37:44+08:00	14301	4856	19157	1259	20416	40575	50.32%	35.25%	24	32
8	臺南市安平區	2018-11-24T23:45:59+08:00	14301	4856	19157	1259	20416	40575	50.32%	35.25%	24	32
8	屏東縣潮州鎮	2018-11-24T23:07:18+08:00	13490	4227	17717	1716	19433	37686	51.57%	35.8%	34	40
8	屏東縣潮州鎮	2018-11-24T22:56:36+08:00	12493	3933	16426	1608	18034	35033	51.48%	35.66%	32	40
8	屏東縣潮州鎮	2018-11-25T06:17:36+08:00	16580	5151	21731	2123	23854	46444	51.36%	35.7%	40	40
8	屏東縣潮州鎮	2018-11-24T23:10:56+08:00	13490	4227	17717	1716	19433	37686	51.57%	35.8%	34	40
8	屏東縣潮州鎮	2018-11-24T22:39:09+08:00	10151	3229	13380	1321	14701	28267	52.01%	35.91%	27	40
8	屏東縣潮州鎮	2018-11-25T01:24:25+08:00	16580	5151	21731	2123	23854	46444	51.36%	35.7%	40	40
8	屏東縣潮州鎮	2018-11-25T03:54:41+08:00	16580	5151	21731	2123	23854	46444	51.36%	35.7%	40	40
8	屏東縣潮州鎮	2018-11-25T03:30:59+08:00	16580	5151	21731	2123	23854	46444	51.36%	35.7%	40	40
8	屏東縣潮州鎮	2018-11-24T22:32:18+08:00	8803	2771	11574	1152	12726	24389	52.18%	36.09%	24	40
8	屏東縣潮州鎮	2018-11-25T01:06:00+08:00	16580	5151	21731	2123	23854	46444	51.36%	35.7%	40	40
8	屏東縣潮州鎮	2018-11-24T23:00:17+08:00	13490	4227	17717	1716	19433	37686	51.57%	35.8%	34	40
8	屏東縣潮州鎮	2018-11-25T00:21:44+08:00	16580	5151	21731	2123	23854	46444	51.36%	35.7%	40	40
8	屏東縣潮州鎮	2018-11-25T06:07:23+08:00	16580	5151	21731	2123	23854	46444	51.36%	35.7%	40	40
8	屏東縣潮州鎮	2018-11-25T04:01:29+08:00	16580	5151	21731	2123	23854	46444	51.36%	35.7%	40	40
8	屏東縣潮州鎮	2018-11-25T01:11:07+08:00	16580	5151	21731	2123	23854	46444	51.36%	35.7%	40	40
8	屏東縣潮州鎮	2018-11-24T22:40:19+08:00	10536	3355	13891	1340	15231	29522	51.59%	35.69%	28	40
8	屏東縣潮州鎮	2018-11-24T23:29:47+08:00	15383	4796	20179	1997	22176	43069	51.49%	35.72%	38	40
8	屏東縣潮州鎮	2018-11-24T22:43:50+08:00	11432	3627	15059	1467	16526	31931	51.76%	35.8%	30	40
8	屏東縣潮州鎮	2018-11-25T00:03:35+08:00	16580	5151	21731	2123	23854	46444	51.36%	35.7%	40	40
8	屏東縣潮州鎮	2018-11-25T00:56:14+08:00	16580	5151	21731	2123	23854	46444	51.36%	35.7%	40	40
8	屏東縣潮州鎮	2018-11-24T23:54:27+08:00	16012	4968	20980	2067	23047	44813	51.43%	35.73%	39	40
8	屏東縣潮州鎮	2018-11-24T22:35:45+08:00	9216	2890	12106	1205	13311	25547	52.1%	36.07%	25	40
8	屏東縣潮州鎮	2018-11-25T01:16:22+08:00	16580	5151	21731	2123	23854	46444	51.36%	35.7%	40	40
8	屏東縣潮州鎮	2018-11-24T23:37:49+08:00	16012	4968	20980	2067	23047	44813	51.43%	35.73%	39	40
8	屏東縣潮州鎮	2018-11-24T23:22:23+08:00	15383	4796	20179	1997	22176	43069	51.49%	35.72%	38	40
8	屏東縣潮州鎮	2018-11-24T22:49:24+08:00	12493	3933	16426	1608	18034	35033	51.48%	35.66%	32	40
8	屏東縣潮州鎮	2018-11-24T22:12:03+08:00	6411	2021	8432	873	9305	17838	52.16%	35.94%	19	40
8	屏東縣潮州鎮	2018-11-24T23:03:47+08:00	13490	4227	17717	1716	19433	37686	51.57%	35.8%	34	40
8	屏東縣潮州鎮	2018-11-24T22:28:40+08:00	8360	2619	10979	1079	12058	23104	52.19%	36.18%	23	40
8	屏東縣潮州鎮	2018-11-24T23:33:50+08:00	16012	4968	20980	2067	23047	44813	51.43%	35.73%	39	40
8	屏東縣潮州鎮	2018-11-24T23:42:02+08:00	16012	4968	20980	2067	23047	44813	51.43%	35.73%	39	40
8	屏東縣潮州鎮	2018-11-25T00:08:05+08:00	16580	5151	21731	2123	23854	46444	51.36%	35.7%	40	40
8	屏東縣潮州鎮	2018-11-25T03:42:48+08:00	16580	5151	21731	2123	23854	46444	51.36%	35.7%	40	40
8	屏東縣潮州鎮	2018-11-24T22:53:15+08:00	12493	3933	16426	1608	18034	35033	51.48%	35.66%	32	40
8	屏東縣潮州鎮	2018-11-24T23:46:04+08:00	16012	4968	20980	2067	23047	44813	51.43%	35.73%	39	40
8	屏東縣潮州鎮	2018-11-25T06:12:37+08:00	16580	5151	21731	2123	23854	46444	51.36%	35.7%	40	40
8	屏東縣潮州鎮	2018-11-24T22:21:46+08:00	7774	2432	10206	1044	11250	21470	52.4%	36.21%	22	40
8	屏東縣潮州鎮	2018-11-24T22:25:25+08:00	7774	2432	10206	1044	11250	21470	52.4%	36.21%	22	40
8	屏東縣潮州鎮	2018-11-25T00:17:08+08:00	16580	5151	21731	2123	23854	46444	51.36%	35.7%	40	40
8	屏東縣潮州鎮	2018-11-25T06:22:45+08:00	16580	5151	21731	2123	23854	46444	51.36%	35.7%	40	40
8	屏東縣潮州鎮	2018-11-25T03:48:31+08:00	16580	5151	21731	2123	23854	46444	51.36%	35.7%	40	40
8	屏東縣潮州鎮	2018-11-24T22:14:49+08:00	6769	2127	8896	931	9827	18735	52.45%	36.13%	20	40
8	屏東縣潮州鎮	2018-11-24T22:18:20+08:00	7223	2268	9491	986	10477	20031	52.3%	36.06%	21	40
8	屏東縣潮州鎮	2018-11-25T03:37:30+08:00	16580	5151	21731	2123	23854	46444	51.36%	35.7%	40	40
8	屏東縣潮州鎮	2018-11-24T23:58:43+08:00	16012	4968	20980	2067	23047	44813	51.43%	35.73%	39	40
8	屏東縣潮州鎮	2018-11-24T23:18:27+08:00	15068	4696	19764	1925	21689	42173	51.43%	35.73%	37	40
8	屏東縣潮州鎮	2018-11-25T06:27:55+08:00	16580	5151	21731	2123	23854	46444	51.36%	35.7%	40	40
8	屏東縣潮州鎮	2018-11-24T23:26:07+08:00	15383	4796	20179	1997	22176	43069	51.49%	35.72%	38	40
8	屏東縣潮州鎮	2018-11-25T00:12:45+08:00	16580	5151	21731	2123	23854	46444	51.36%	35.7%	40	40
8	屏東縣潮州鎮	2018-11-25T01:01:02+08:00	16580	5151	21731	2123	23854	46444	51.36%	35.7%	40	40
8	屏東縣潮州鎮	2018-11-24T23:14:41+08:00	13973	4344	18317	1757	20074	39100	51.34%	35.74%	35	40
8	屏東縣潮州鎮	2018-11-24T23:50:15+08:00	16012	4968	20980	2067	23047	44813	51.43%	35.73%	39	40
8	臺南市左鎮區	2018-11-25T00:56:08+08:00	1219	412	1631	280	1911	4418	43.25%	27.59%	10	10
8	臺南市左鎮區	2018-11-24T22:49:18+08:00	1219	412	1631	280	1911	4418	43.25%	27.59%	10	10
8	臺南市左鎮區	2018-11-24T23:14:34+08:00	1219	412	1631	280	1911	4418	43.25%	27.59%	10	10
8	臺南市左鎮區	2018-11-24T23:03:43+08:00	1219	412	1631	280	1911	4418	43.25%	27.59%	10	10
8	臺南市左鎮區	2018-11-25T06:17:31+08:00	1219	412	1631	280	1911	4418	43.25%	27.59%	10	10
8	臺南市左鎮區	2018-11-24T23:22:18+08:00	1219	412	1631	280	1911	4418	43.25%	27.59%	10	10
8	臺南市左鎮區	2018-11-24T22:43:45+08:00	1219	412	1631	280	1911	4418	43.25%	27.59%	10	10
8	臺南市左鎮區	2018-11-24T23:10:51+08:00	1219	412	1631	280	1911	4418	43.25%	27.59%	10	10
8	臺南市左鎮區	2018-11-25T03:37:20+08:00	1219	412	1631	280	1911	4418	43.25%	27.59%	10	10
8	臺南市左鎮區	2018-11-25T00:03:28+08:00	1219	412	1631	280	1911	4418	43.25%	27.59%	10	10
8	臺南市左鎮區	2018-11-24T23:58:36+08:00	1219	412	1631	280	1911	4418	43.25%	27.59%	10	10
8	臺南市左鎮區	2018-11-25T03:42:42+08:00	1219	412	1631	280	1911	4418	43.25%	27.59%	10	10
8	臺南市左鎮區	2018-11-24T22:25:19+08:00	1219	412	1631	280	1911	4418	43.25%	27.59%	10	10
8	臺南市左鎮區	2018-11-25T06:22:40+08:00	1219	412	1631	280	1911	4418	43.25%	27.59%	10	10
8	臺南市左鎮區	2018-11-25T00:17:03+08:00	1219	412	1631	280	1911	4418	43.25%	27.59%	10	10
8	臺南市左鎮區	2018-11-25T01:11:01+08:00	1219	412	1631	280	1911	4418	43.25%	27.59%	10	10
8	臺南市左鎮區	2018-11-24T23:29:41+08:00	1219	412	1631	280	1911	4418	43.25%	27.59%	10	10
8	臺南市左鎮區	2018-11-25T06:12:32+08:00	1219	412	1631	280	1911	4418	43.25%	27.59%	10	10
8	臺南市左鎮區	2018-11-24T23:50:10+08:00	1219	412	1631	280	1911	4418	43.25%	27.59%	10	10
8	臺南市左鎮區	2018-11-25T00:12:40+08:00	1219	412	1631	280	1911	4418	43.25%	27.59%	10	10
8	臺南市左鎮區	2018-11-24T22:28:35+08:00	1219	412	1631	280	1911	4418	43.25%	27.59%	10	10
8	臺南市左鎮區	2018-11-24T22:14:43+08:00	1219	412	1631	280	1911	4418	43.25%	27.59%	10	10
8	臺南市左鎮區	2018-11-24T23:26:02+08:00	1219	412	1631	280	1911	4418	43.25%	27.59%	10	10
8	臺南市左鎮區	2018-11-24T23:54:20+08:00	1219	412	1631	280	1911	4418	43.25%	27.59%	10	10
8	臺南市左鎮區	2018-11-25T06:27:50+08:00	1219	412	1631	280	1911	4418	43.25%	27.59%	10	10
8	臺南市左鎮區	2018-11-25T00:07:59+08:00	1219	412	1631	280	1911	4418	43.25%	27.59%	10	10
8	臺南市左鎮區	2018-11-24T23:18:22+08:00	1219	412	1631	280	1911	4418	43.25%	27.59%	10	10
8	臺南市左鎮區	2018-11-25T01:05:53+08:00	1219	412	1631	280	1911	4418	43.25%	27.59%	10	10
8	臺南市左鎮區	2018-11-24T22:18:14+08:00	1219	412	1631	280	1911	4418	43.25%	27.59%	10	10
8	臺南市左鎮區	2018-11-24T22:56:32+08:00	1219	412	1631	280	1911	4418	43.25%	27.59%	10	10
8	臺南市左鎮區	2018-11-25T01:24:19+08:00	1219	412	1631	280	1911	4418	43.25%	27.59%	10	10
8	臺南市左鎮區	2018-11-24T22:39:04+08:00	1219	412	1631	280	1911	4418	43.25%	27.59%	10	10
8	臺南市左鎮區	2018-11-24T23:07:14+08:00	1219	412	1631	280	1911	4418	43.25%	27.59%	10	10
8	臺南市左鎮區	2018-11-25T00:21:39+08:00	1219	412	1631	280	1911	4418	43.25%	27.59%	10	10
8	臺南市左鎮區	2018-11-24T22:32:13+08:00	1219	412	1631	280	1911	4418	43.25%	27.59%	10	10
8	臺南市左鎮區	2018-11-25T03:30:53+08:00	1219	412	1631	280	1911	4418	43.25%	27.59%	10	10
8	臺南市左鎮區	2018-11-25T03:48:24+08:00	1219	412	1631	280	1911	4418	43.25%	27.59%	10	10
8	臺南市左鎮區	2018-11-25T01:00:55+08:00	1219	412	1631	280	1911	4418	43.25%	27.59%	10	10
8	臺南市左鎮區	2018-11-24T23:00:13+08:00	1219	412	1631	280	1911	4418	43.25%	27.59%	10	10
8	臺南市左鎮區	2018-11-25T06:07:17+08:00	1219	412	1631	280	1911	4418	43.25%	27.59%	10	10
8	臺南市左鎮區	2018-11-24T22:53:09+08:00	1219	412	1631	280	1911	4418	43.25%	27.59%	10	10
8	臺南市左鎮區	2018-11-24T22:40:14+08:00	1219	412	1631	280	1911	4418	43.25%	27.59%	10	10
8	臺南市左鎮區	2018-11-24T22:11:58+08:00	1219	412	1631	280	1911	4418	43.25%	27.59%	10	10
8	臺南市左鎮區	2018-11-25T04:01:23+08:00	1219	412	1631	280	1911	4418	43.25%	27.59%	10	10
8	臺南市左鎮區	2018-11-24T22:21:40+08:00	1219	412	1631	280	1911	4418	43.25%	27.59%	10	10
8	臺南市左鎮區	2018-11-24T23:41:57+08:00	1219	412	1631	280	1911	4418	43.25%	27.59%	10	10
8	臺南市左鎮區	2018-11-25T01:16:16+08:00	1219	412	1631	280	1911	4418	43.25%	27.59%	10	10
8	臺南市左鎮區	2018-11-24T22:35:40+08:00	1219	412	1631	280	1911	4418	43.25%	27.59%	10	10
8	臺南市左鎮區	2018-11-25T03:54:35+08:00	1219	412	1631	280	1911	4418	43.25%	27.59%	10	10
8	臺南市左鎮區	2018-11-24T23:33:45+08:00	1219	412	1631	280	1911	4418	43.25%	27.59%	10	10
8	臺南市左鎮區	2018-11-24T23:37:44+08:00	1219	412	1631	280	1911	4418	43.25%	27.59%	10	10
8	臺南市左鎮區	2018-11-24T23:45:59+08:00	1219	412	1631	280	1911	4418	43.25%	27.59%	10	10
8	南投縣鹿谷鄉	2018-11-25T01:24:23+08:00	6191	1574	7765	737	8502	15941	53.33%	38.84%	21	21
8	南投縣鹿谷鄉	2018-11-24T22:39:07+08:00	6191	1574	7765	737	8502	15941	53.33%	38.84%	21	21
8	南投縣鹿谷鄉	2018-11-24T23:07:17+08:00	6191	1574	7765	737	8502	15941	53.33%	38.84%	21	21
8	南投縣鹿谷鄉	2018-11-24T22:12:01+08:00	6191	1574	7765	737	8502	15941	53.33%	38.84%	21	21
8	南投縣鹿谷鄉	2018-11-25T03:37:27+08:00	6191	1574	7765	737	8502	15941	53.33%	38.84%	21	21
8	南投縣鹿谷鄉	2018-11-24T22:32:17+08:00	6191	1574	7765	737	8502	15941	53.33%	38.84%	21	21
8	南投縣鹿谷鄉	2018-11-25T03:30:57+08:00	6191	1574	7765	737	8502	15941	53.33%	38.84%	21	21
8	南投縣鹿谷鄉	2018-11-25T03:48:28+08:00	6191	1574	7765	737	8502	15941	53.33%	38.84%	21	21
8	南投縣鹿谷鄉	2018-11-24T23:42:01+08:00	6191	1574	7765	737	8502	15941	53.33%	38.84%	21	21
8	南投縣鹿谷鄉	2018-11-25T04:01:28+08:00	6191	1574	7765	737	8502	15941	53.33%	38.84%	21	21
8	南投縣鹿谷鄉	2018-11-25T00:21:43+08:00	6191	1574	7765	737	8502	15941	53.33%	38.84%	21	21
8	南投縣鹿谷鄉	2018-11-24T22:21:44+08:00	6191	1574	7765	737	8502	15941	53.33%	38.84%	21	21
8	南投縣鹿谷鄉	2018-11-24T23:00:16+08:00	6191	1574	7765	737	8502	15941	53.33%	38.84%	21	21
8	南投縣鹿谷鄉	2018-11-24T22:40:17+08:00	6191	1574	7765	737	8502	15941	53.33%	38.84%	21	21
8	南投縣鹿谷鄉	2018-11-25T06:12:35+08:00	6191	1574	7765	737	8502	15941	53.33%	38.84%	21	21
8	南投縣鹿谷鄉	2018-11-25T00:03:32+08:00	6191	1574	7765	737	8502	15941	53.33%	38.84%	21	21
8	南投縣鹿谷鄉	2018-11-25T03:54:39+08:00	6191	1574	7765	737	8502	15941	53.33%	38.84%	21	21
8	南投縣鹿谷鄉	2018-11-25T01:01:00+08:00	6191	1574	7765	737	8502	15941	53.33%	38.84%	21	21
8	南投縣鹿谷鄉	2018-11-24T23:33:49+08:00	6191	1574	7765	737	8502	15941	53.33%	38.84%	21	21
8	南投縣鹿谷鄉	2018-11-24T23:26:05+08:00	6191	1574	7765	737	8502	15941	53.33%	38.84%	21	21
8	南投縣鹿谷鄉	2018-11-24T23:37:47+08:00	6191	1574	7765	737	8502	15941	53.33%	38.84%	21	21
8	南投縣鹿谷鄉	2018-11-24T22:35:43+08:00	6191	1574	7765	737	8502	15941	53.33%	38.84%	21	21
8	南投縣鹿谷鄉	2018-11-24T23:54:26+08:00	6191	1574	7765	737	8502	15941	53.33%	38.84%	21	21
8	南投縣鹿谷鄉	2018-11-24T23:58:41+08:00	6191	1574	7765	737	8502	15941	53.33%	38.84%	21	21
8	南投縣鹿谷鄉	2018-11-25T00:56:12+08:00	6191	1574	7765	737	8502	15941	53.33%	38.84%	21	21
8	南投縣鹿谷鄉	2018-11-24T22:56:35+08:00	6191	1574	7765	737	8502	15941	53.33%	38.84%	21	21
8	南投縣鹿谷鄉	2018-11-24T22:49:23+08:00	6191	1574	7765	737	8502	15941	53.33%	38.84%	21	21
8	南投縣鹿谷鄉	2018-11-24T23:14:39+08:00	6191	1574	7765	737	8502	15941	53.33%	38.84%	21	21
8	南投縣鹿谷鄉	2018-11-24T23:22:22+08:00	6191	1574	7765	737	8502	15941	53.33%	38.84%	21	21
8	南投縣鹿谷鄉	2018-11-25T06:17:34+08:00	6191	1574	7765	737	8502	15941	53.33%	38.84%	21	21
8	南投縣鹿谷鄉	2018-11-24T22:43:49+08:00	6191	1574	7765	737	8502	15941	53.33%	38.84%	21	21
8	南投縣鹿谷鄉	2018-11-24T23:03:46+08:00	6191	1574	7765	737	8502	15941	53.33%	38.84%	21	21
8	南投縣鹿谷鄉	2018-11-24T23:10:55+08:00	6191	1574	7765	737	8502	15941	53.33%	38.84%	21	21
8	南投縣鹿谷鄉	2018-11-25T00:08:03+08:00	6191	1574	7765	737	8502	15941	53.33%	38.84%	21	21
8	南投縣鹿谷鄉	2018-11-25T03:42:47+08:00	6191	1574	7765	737	8502	15941	53.33%	38.84%	21	21
8	南投縣鹿谷鄉	2018-11-24T22:53:13+08:00	6191	1574	7765	737	8502	15941	53.33%	38.84%	21	21
8	南投縣鹿谷鄉	2018-11-24T23:46:02+08:00	6191	1574	7765	737	8502	15941	53.33%	38.84%	21	21
8	南投縣鹿谷鄉	2018-11-25T01:11:05+08:00	6191	1574	7765	737	8502	15941	53.33%	38.84%	21	21
8	南投縣鹿谷鄉	2018-11-24T23:29:45+08:00	6191	1574	7765	737	8502	15941	53.33%	38.84%	21	21
8	南投縣鹿谷鄉	2018-11-25T06:07:21+08:00	6191	1574	7765	737	8502	15941	53.33%	38.84%	21	21
8	南投縣鹿谷鄉	2018-11-25T06:22:43+08:00	6191	1574	7765	737	8502	15941	53.33%	38.84%	21	21
8	南投縣鹿谷鄉	2018-11-25T00:17:06+08:00	6191	1574	7765	737	8502	15941	53.33%	38.84%	21	21
8	南投縣鹿谷鄉	2018-11-24T22:25:23+08:00	6191	1574	7765	737	8502	15941	53.33%	38.84%	21	21
8	南投縣鹿谷鄉	2018-11-25T00:12:43+08:00	6191	1574	7765	737	8502	15941	53.33%	38.84%	21	21
8	南投縣鹿谷鄉	2018-11-24T22:14:47+08:00	6191	1574	7765	737	8502	15941	53.33%	38.84%	21	21
8	南投縣鹿谷鄉	2018-11-24T22:18:18+08:00	6191	1574	7765	737	8502	15941	53.33%	38.84%	21	21
8	南投縣鹿谷鄉	2018-11-25T06:27:54+08:00	6191	1574	7765	737	8502	15941	53.33%	38.84%	21	21
8	南投縣鹿谷鄉	2018-11-24T23:50:13+08:00	6191	1574	7765	737	8502	15941	53.33%	38.84%	21	21
8	南投縣鹿谷鄉	2018-11-25T01:16:20+08:00	6191	1574	7765	737	8502	15941	53.33%	38.84%	21	21
8	南投縣鹿谷鄉	2018-11-25T01:05:57+08:00	6191	1574	7765	737	8502	15941	53.33%	38.84%	21	21
8	南投縣鹿谷鄉	2018-11-24T22:28:39+08:00	6191	1574	7765	737	8502	15941	53.33%	38.84%	21	21
8	南投縣鹿谷鄉	2018-11-24T23:18:26+08:00	6191	1574	7765	737	8502	15941	53.33%	38.84%	21	21
8	雲林縣大埤鄉	2018-11-24T22:39:08+08:00	5714	1835	7549	848	8397	16509	50.86%	34.61%	18	18
8	雲林縣大埤鄉	2018-11-25T03:37:28+08:00	5714	1835	7549	848	8397	16509	50.86%	34.61%	18	18
8	雲林縣大埤鄉	2018-11-25T01:24:23+08:00	5714	1835	7549	848	8397	16509	50.86%	34.61%	18	18
8	雲林縣大埤鄉	2018-11-24T23:07:17+08:00	5714	1835	7549	848	8397	16509	50.86%	34.61%	18	18
8	雲林縣大埤鄉	2018-11-24T22:12:01+08:00	4987	1593	6580	752	7332	14131	51.89%	35.29%	16	18
8	雲林縣大埤鄉	2018-11-24T22:32:17+08:00	5229	1690	6919	775	7694	15079	51.02%	34.68%	17	18
8	雲林縣大埤鄉	2018-11-25T03:48:28+08:00	5714	1835	7549	848	8397	16509	50.86%	34.61%	18	18
8	雲林縣大埤鄉	2018-11-25T03:30:58+08:00	5714	1835	7549	848	8397	16509	50.86%	34.61%	18	18
8	雲林縣大埤鄉	2018-11-24T23:42:01+08:00	5714	1835	7549	848	8397	16509	50.86%	34.61%	18	18
8	雲林縣大埤鄉	2018-11-24T22:21:45+08:00	4987	1593	6580	752	7332	14131	51.89%	35.29%	16	18
8	雲林縣大埤鄉	2018-11-25T06:07:22+08:00	5714	1835	7549	848	8397	16509	50.86%	34.61%	18	18
8	雲林縣大埤鄉	2018-11-25T04:01:28+08:00	5714	1835	7549	848	8397	16509	50.86%	34.61%	18	18
8	雲林縣大埤鄉	2018-11-25T00:21:43+08:00	5714	1835	7549	848	8397	16509	50.86%	34.61%	18	18
8	雲林縣大埤鄉	2018-11-25T01:11:06+08:00	5714	1835	7549	848	8397	16509	50.86%	34.61%	18	18
8	雲林縣大埤鄉	2018-11-24T22:40:18+08:00	5714	1835	7549	848	8397	16509	50.86%	34.61%	18	18
8	雲林縣大埤鄉	2018-11-24T23:00:16+08:00	5714	1835	7549	848	8397	16509	50.86%	34.61%	18	18
8	雲林縣大埤鄉	2018-11-24T23:37:48+08:00	5714	1835	7549	848	8397	16509	50.86%	34.61%	18	18
8	雲林縣大埤鄉	2018-11-25T03:54:39+08:00	5714	1835	7549	848	8397	16509	50.86%	34.61%	18	18
8	雲林縣大埤鄉	2018-11-25T01:01:00+08:00	5714	1835	7549	848	8397	16509	50.86%	34.61%	18	18
8	雲林縣大埤鄉	2018-11-24T23:33:49+08:00	5714	1835	7549	848	8397	16509	50.86%	34.61%	18	18
8	雲林縣大埤鄉	2018-11-25T00:03:33+08:00	5714	1835	7549	848	8397	16509	50.86%	34.61%	18	18
8	雲林縣大埤鄉	2018-11-24T22:35:44+08:00	5229	1690	6919	775	7694	15079	51.02%	34.68%	17	18
8	雲林縣大埤鄉	2018-11-24T23:54:26+08:00	5714	1835	7549	848	8397	16509	50.86%	34.61%	18	18
8	雲林縣大埤鄉	2018-11-24T23:58:41+08:00	5714	1835	7549	848	8397	16509	50.86%	34.61%	18	18
8	雲林縣大埤鄉	2018-11-25T00:56:12+08:00	5714	1835	7549	848	8397	16509	50.86%	34.61%	18	18
8	雲林縣大埤鄉	2018-11-24T22:56:35+08:00	5714	1835	7549	848	8397	16509	50.86%	34.61%	18	18
8	雲林縣大埤鄉	2018-11-25T06:17:35+08:00	5714	1835	7549	848	8397	16509	50.86%	34.61%	18	18
8	雲林縣大埤鄉	2018-11-24T22:49:23+08:00	5714	1835	7549	848	8397	16509	50.86%	34.61%	18	18
8	雲林縣大埤鄉	2018-11-24T23:22:22+08:00	5714	1835	7549	848	8397	16509	50.86%	34.61%	18	18
8	雲林縣大埤鄉	2018-11-24T22:43:49+08:00	5714	1835	7549	848	8397	16509	50.86%	34.61%	18	18
8	雲林縣大埤鄉	2018-11-24T23:03:46+08:00	5714	1835	7549	848	8397	16509	50.86%	34.61%	18	18
8	雲林縣大埤鄉	2018-11-24T23:10:55+08:00	5714	1835	7549	848	8397	16509	50.86%	34.61%	18	18
8	雲林縣大埤鄉	2018-11-25T00:08:04+08:00	5714	1835	7549	848	8397	16509	50.86%	34.61%	18	18
8	雲林縣大埤鄉	2018-11-25T03:42:47+08:00	5714	1835	7549	848	8397	16509	50.86%	34.61%	18	18
8	雲林縣大埤鄉	2018-11-24T22:53:14+08:00	5714	1835	7549	848	8397	16509	50.86%	34.61%	18	18
8	雲林縣大埤鄉	2018-11-24T23:46:03+08:00	5714	1835	7549	848	8397	16509	50.86%	34.61%	18	18
8	雲林縣大埤鄉	2018-11-25T00:17:07+08:00	5714	1835	7549	848	8397	16509	50.86%	34.61%	18	18
8	雲林縣大埤鄉	2018-11-24T23:29:45+08:00	5714	1835	7549	848	8397	16509	50.86%	34.61%	18	18
8	雲林縣大埤鄉	2018-11-25T06:22:44+08:00	5714	1835	7549	848	8397	16509	50.86%	34.61%	18	18
8	雲林縣大埤鄉	2018-11-25T06:12:36+08:00	5714	1835	7549	848	8397	16509	50.86%	34.61%	18	18
8	雲林縣大埤鄉	2018-11-24T22:25:24+08:00	5229	1690	6919	775	7694	15079	51.02%	34.68%	17	18
8	雲林縣大埤鄉	2018-11-25T01:05:58+08:00	5714	1835	7549	848	8397	16509	50.86%	34.61%	18	18
8	雲林縣大埤鄉	2018-11-25T00:12:44+08:00	5714	1835	7549	848	8397	16509	50.86%	34.61%	18	18
8	雲林縣大埤鄉	2018-11-24T23:26:06+08:00	5714	1835	7549	848	8397	16509	50.86%	34.61%	18	18
8	雲林縣大埤鄉	2018-11-25T06:27:54+08:00	5714	1835	7549	848	8397	16509	50.86%	34.61%	18	18
8	雲林縣大埤鄉	2018-11-24T23:50:14+08:00	5714	1835	7549	848	8397	16509	50.86%	34.61%	18	18
8	雲林縣大埤鄉	2018-11-24T23:14:40+08:00	5714	1835	7549	848	8397	16509	50.86%	34.61%	18	18
8	雲林縣大埤鄉	2018-11-24T22:18:19+08:00	4987	1593	6580	752	7332	14131	51.89%	35.29%	16	18
8	雲林縣大埤鄉	2018-11-24T22:28:39+08:00	5229	1690	6919	775	7694	15079	51.02%	34.68%	17	18
8	雲林縣大埤鄉	2018-11-24T22:14:48+08:00	4987	1593	6580	752	7332	14131	51.89%	35.29%	16	18
8	雲林縣大埤鄉	2018-11-25T01:16:21+08:00	5714	1835	7549	848	8397	16509	50.86%	34.61%	18	18
8	雲林縣大埤鄉	2018-11-24T23:18:26+08:00	5714	1835	7549	848	8397	16509	50.86%	34.61%	18	18
8	雲林縣四湖鄉	2018-11-24T22:39:08+08:00	5233	1748	6981	1011	7992	20983	38.09%	24.94%	25	25
8	雲林縣四湖鄉	2018-11-24T23:07:18+08:00	5233	1748	6981	1011	7992	20983	38.09%	24.94%	25	25
8	雲林縣四湖鄉	2018-11-24T22:56:36+08:00	5233	1748	6981	1011	7992	20983	38.09%	24.94%	25	25
8	雲林縣四湖鄉	2018-11-25T01:24:24+08:00	5233	1748	6981	1011	7992	20983	38.09%	24.94%	25	25
8	雲林縣四湖鄉	2018-11-25T03:54:40+08:00	5233	1748	6981	1011	7992	20983	38.09%	24.94%	25	25
8	雲林縣四湖鄉	2018-11-25T03:37:29+08:00	5233	1748	6981	1011	7992	20983	38.09%	24.94%	25	25
8	雲林縣四湖鄉	2018-11-24T22:32:18+08:00	5233	1748	6981	1011	7992	20983	38.09%	24.94%	25	25
8	雲林縣四湖鄉	2018-11-25T03:30:58+08:00	5233	1748	6981	1011	7992	20983	38.09%	24.94%	25	25
8	雲林縣四湖鄉	2018-11-24T23:42:01+08:00	5233	1748	6981	1011	7992	20983	38.09%	24.94%	25	25
8	雲林縣四湖鄉	2018-11-25T03:48:29+08:00	5233	1748	6981	1011	7992	20983	38.09%	24.94%	25	25
8	雲林縣四湖鄉	2018-11-24T22:21:45+08:00	5233	1748	6981	1011	7992	20983	38.09%	24.94%	25	25
8	雲林縣四湖鄉	2018-11-25T06:07:22+08:00	5233	1748	6981	1011	7992	20983	38.09%	24.94%	25	25
8	雲林縣四湖鄉	2018-11-25T00:21:43+08:00	5233	1748	6981	1011	7992	20983	38.09%	24.94%	25	25
8	雲林縣四湖鄉	2018-11-24T23:29:46+08:00	5233	1748	6981	1011	7992	20983	38.09%	24.94%	25	25
8	雲林縣四湖鄉	2018-11-24T22:40:18+08:00	5233	1748	6981	1011	7992	20983	38.09%	24.94%	25	25
8	雲林縣四湖鄉	2018-11-25T04:01:29+08:00	5233	1748	6981	1011	7992	20983	38.09%	24.94%	25	25
8	雲林縣四湖鄉	2018-11-24T23:00:16+08:00	5233	1748	6981	1011	7992	20983	38.09%	24.94%	25	25
8	雲林縣四湖鄉	2018-11-25T01:11:07+08:00	5233	1748	6981	1011	7992	20983	38.09%	24.94%	25	25
8	雲林縣四湖鄉	2018-11-24T23:37:48+08:00	5233	1748	6981	1011	7992	20983	38.09%	24.94%	25	25
8	雲林縣四湖鄉	2018-11-24T22:43:50+08:00	5233	1748	6981	1011	7992	20983	38.09%	24.94%	25	25
8	雲林縣四湖鄉	2018-11-25T00:56:13+08:00	5233	1748	6981	1011	7992	20983	38.09%	24.94%	25	25
8	雲林縣四湖鄉	2018-11-24T23:54:27+08:00	5233	1748	6981	1011	7992	20983	38.09%	24.94%	25	25
8	雲林縣四湖鄉	2018-11-25T00:03:34+08:00	5233	1748	6981	1011	7992	20983	38.09%	24.94%	25	25
8	雲林縣四湖鄉	2018-11-24T22:35:44+08:00	5233	1748	6981	1011	7992	20983	38.09%	24.94%	25	25
8	雲林縣四湖鄉	2018-11-25T01:01:01+08:00	5233	1748	6981	1011	7992	20983	38.09%	24.94%	25	25
8	雲林縣四湖鄉	2018-11-24T23:22:23+08:00	5233	1748	6981	1011	7992	20983	38.09%	24.94%	25	25
8	雲林縣四湖鄉	2018-11-25T06:17:35+08:00	5233	1748	6981	1011	7992	20983	38.09%	24.94%	25	25
8	雲林縣四湖鄉	2018-11-24T22:49:23+08:00	5233	1748	6981	1011	7992	20983	38.09%	24.94%	25	25
8	雲林縣四湖鄉	2018-11-24T23:03:47+08:00	5233	1748	6981	1011	7992	20983	38.09%	24.94%	25	25
8	雲林縣四湖鄉	2018-11-24T23:10:55+08:00	5233	1748	6981	1011	7992	20983	38.09%	24.94%	25	25
8	雲林縣四湖鄉	2018-11-24T23:33:50+08:00	5233	1748	6981	1011	7992	20983	38.09%	24.94%	25	25
8	雲林縣四湖鄉	2018-11-24T22:12:02+08:00	5233	1748	6981	1011	7992	20983	38.09%	24.94%	25	25
8	雲林縣四湖鄉	2018-11-25T00:08:04+08:00	5233	1748	6981	1011	7992	20983	38.09%	24.94%	25	25
8	雲林縣四湖鄉	2018-11-24T22:53:14+08:00	5233	1748	6981	1011	7992	20983	38.09%	24.94%	25	25
8	雲林縣四湖鄉	2018-11-25T03:42:48+08:00	5233	1748	6981	1011	7992	20983	38.09%	24.94%	25	25
8	雲林縣四湖鄉	2018-11-24T23:46:03+08:00	5233	1748	6981	1011	7992	20983	38.09%	24.94%	25	25
8	雲林縣四湖鄉	2018-11-25T00:17:07+08:00	5233	1748	6981	1011	7992	20983	38.09%	24.94%	25	25
8	雲林縣四湖鄉	2018-11-24T22:25:25+08:00	5233	1748	6981	1011	7992	20983	38.09%	24.94%	25	25
8	雲林縣四湖鄉	2018-11-25T06:22:44+08:00	5233	1748	6981	1011	7992	20983	38.09%	24.94%	25	25
8	雲林縣四湖鄉	2018-11-25T06:12:36+08:00	5233	1748	6981	1011	7992	20983	38.09%	24.94%	25	25
8	雲林縣四湖鄉	2018-11-25T01:05:58+08:00	5233	1748	6981	1011	7992	20983	38.09%	24.94%	25	25
8	雲林縣四湖鄉	2018-11-25T00:12:44+08:00	5233	1748	6981	1011	7992	20983	38.09%	24.94%	25	25
8	雲林縣四湖鄉	2018-11-24T23:26:06+08:00	5233	1748	6981	1011	7992	20983	38.09%	24.94%	25	25
8	雲林縣四湖鄉	2018-11-25T06:27:54+08:00	5233	1748	6981	1011	7992	20983	38.09%	24.94%	25	25
8	雲林縣四湖鄉	2018-11-24T23:18:27+08:00	5233	1748	6981	1011	7992	20983	38.09%	24.94%	25	25
8	雲林縣四湖鄉	2018-11-24T23:50:14+08:00	5233	1748	6981	1011	7992	20983	38.09%	24.94%	25	25
8	雲林縣四湖鄉	2018-11-24T23:14:40+08:00	5233	1748	6981	1011	7992	20983	38.09%	24.94%	25	25
8	雲林縣四湖鄉	2018-11-24T22:18:19+08:00	5233	1748	6981	1011	7992	20983	38.09%	24.94%	25	25
8	雲林縣四湖鄉	2018-11-24T23:58:42+08:00	5233	1748	6981	1011	7992	20983	38.09%	24.94%	25	25
8	雲林縣四湖鄉	2018-11-24T22:28:39+08:00	5233	1748	6981	1011	7992	20983	38.09%	24.94%	25	25
8	雲林縣四湖鄉	2018-11-24T22:14:48+08:00	5233	1748	6981	1011	7992	20983	38.09%	24.94%	25	25
8	雲林縣四湖鄉	2018-11-25T01:16:21+08:00	5233	1748	6981	1011	7992	20983	38.09%	24.94%	25	25
8	澎湖縣白沙鄉	2018-11-24T23:26:10+08:00	2443	756	3199	389	3588	8625	41.6%	28.32%	15	15
8	澎湖縣白沙鄉	2018-11-24T23:10:59+08:00	1610	493	2103	218	2321	5491	42.27%	29.32%	13	15
8	澎湖縣白沙鄉	2018-11-24T22:49:27+08:00	1610	493	2103	218	2321	5491	42.27%	29.32%	13	15
8	澎湖縣白沙鄉	2018-11-24T23:33:53+08:00	2443	756	3199	389	3588	8625	41.6%	28.32%	15	15
8	澎湖縣白沙鄉	2018-11-24T22:56:39+08:00	1610	493	2103	218	2321	5491	42.27%	29.32%	13	15
8	澎湖縣白沙鄉	2018-11-24T23:22:26+08:00	2443	756	3199	389	3588	8625	41.6%	28.32%	15	15
8	澎湖縣白沙鄉	2018-11-24T22:28:43+08:00	1409	441	1850	185	2035	4717	43.14%	29.87%	12	15
8	澎湖縣白沙鄉	2018-11-24T23:18:30+08:00	2182	643	2825	276	3101	7196	43.09%	30.32%	14	15
8	澎湖縣白沙鄉	2018-11-25T00:17:11+08:00	2443	756	3199	389	3588	8625	41.6%	28.32%	15	15
8	澎湖縣白沙鄉	2018-11-24T22:32:21+08:00	1409	441	1850	185	2035	4717	43.14%	29.87%	12	15
8	澎湖縣白沙鄉	2018-11-24T23:46:06+08:00	2443	756	3199	389	3588	8625	41.6%	28.32%	15	15
8	澎湖縣白沙鄉	2018-11-24T22:53:18+08:00	1610	493	2103	218	2321	5491	42.27%	29.32%	13	15
8	澎湖縣白沙鄉	2018-11-25T00:08:08+08:00	2443	756	3199	389	3588	8625	41.6%	28.32%	15	15
8	澎湖縣白沙鄉	2018-11-25T04:01:32+08:00	2443	756	3199	389	3588	8625	41.6%	28.32%	15	15
8	澎湖縣白沙鄉	2018-11-25T03:48:34+08:00	2443	756	3199	389	3588	8625	41.6%	28.32%	15	15
8	澎湖縣白沙鄉	2018-11-24T23:00:19+08:00	1610	493	2103	218	2321	5491	42.27%	29.32%	13	15
8	澎湖縣白沙鄉	2018-11-24T22:25:28+08:00	1409	441	1850	185	2035	4717	43.14%	29.87%	12	15
8	澎湖縣白沙鄉	2018-11-25T06:22:47+08:00	2443	756	3199	389	3588	8625	41.6%	28.32%	15	15
8	澎湖縣白沙鄉	2018-11-24T22:40:21+08:00	1610	493	2103	218	2321	5491	42.27%	29.32%	13	15
8	澎湖縣白沙鄉	2018-11-24T23:14:44+08:00	1610	493	2103	218	2321	5491	42.27%	29.32%	13	15
8	澎湖縣白沙鄉	2018-11-25T03:37:33+08:00	2443	756	3199	389	3588	8625	41.6%	28.32%	15	15
8	澎湖縣白沙鄉	2018-11-24T22:18:23+08:00	1409	441	1850	185	2035	4717	43.14%	29.87%	12	15
8	澎湖縣白沙鄉	2018-11-24T23:50:18+08:00	2443	756	3199	389	3588	8625	41.6%	28.32%	15	15
8	澎湖縣白沙鄉	2018-11-25T01:16:25+08:00	2443	756	3199	389	3588	8625	41.6%	28.32%	15	15
8	澎湖縣白沙鄉	2018-11-24T23:58:46+08:00	2443	756	3199	389	3588	8625	41.6%	28.32%	15	15
8	澎湖縣白沙鄉	2018-11-25T00:12:48+08:00	2443	756	3199	389	3588	8625	41.6%	28.32%	15	15
8	澎湖縣白沙鄉	2018-11-24T23:03:50+08:00	1610	493	2103	218	2321	5491	42.27%	29.32%	13	15
8	澎湖縣白沙鄉	2018-11-24T22:39:12+08:00	1610	493	2103	218	2321	5491	42.27%	29.32%	13	15
8	澎湖縣白沙鄉	2018-11-25T06:27:58+08:00	2443	756	3199	389	3588	8625	41.6%	28.32%	15	15
8	澎湖縣白沙鄉	2018-11-25T06:17:40+08:00	2443	756	3199	389	3588	8625	41.6%	28.32%	15	15
8	澎湖縣白沙鄉	2018-11-24T22:14:52+08:00	1409	441	1850	185	2035	4717	43.14%	29.87%	12	15
8	澎湖縣白沙鄉	2018-11-25T01:24:28+08:00	2443	756	3199	389	3588	8625	41.6%	28.32%	15	15
8	澎湖縣白沙鄉	2018-11-25T03:54:45+08:00	2443	756	3199	389	3588	8625	41.6%	28.32%	15	15
8	澎湖縣白沙鄉	2018-11-24T23:37:51+08:00	2443	756	3199	389	3588	8625	41.6%	28.32%	15	15
8	澎湖縣白沙鄉	2018-11-24T23:07:22+08:00	1610	493	2103	218	2321	5491	42.27%	29.32%	13	15
8	澎湖縣白沙鄉	2018-11-24T22:12:05+08:00	1409	441	1850	185	2035	4717	43.14%	29.87%	12	15
8	澎湖縣白沙鄉	2018-11-24T23:54:30+08:00	2443	756	3199	389	3588	8625	41.6%	28.32%	15	15
8	澎湖縣白沙鄉	2018-11-25T06:12:40+08:00	2443	756	3199	389	3588	8625	41.6%	28.32%	15	15
8	澎湖縣白沙鄉	2018-11-24T23:29:50+08:00	2443	756	3199	389	3588	8625	41.6%	28.32%	15	15
8	澎湖縣白沙鄉	2018-11-24T23:42:05+08:00	2443	756	3199	389	3588	8625	41.6%	28.32%	15	15
8	澎湖縣白沙鄉	2018-11-25T01:06:03+08:00	2443	756	3199	389	3588	8625	41.6%	28.32%	15	15
8	澎湖縣白沙鄉	2018-11-25T01:11:11+08:00	2443	756	3199	389	3588	8625	41.6%	28.32%	15	15
8	澎湖縣白沙鄉	2018-11-25T00:21:47+08:00	2443	756	3199	389	3588	8625	41.6%	28.32%	15	15
8	澎湖縣白沙鄉	2018-11-25T03:42:52+08:00	2443	756	3199	389	3588	8625	41.6%	28.32%	15	15
8	澎湖縣白沙鄉	2018-11-25T06:07:26+08:00	2443	756	3199	389	3588	8625	41.6%	28.32%	15	15
8	澎湖縣白沙鄉	2018-11-24T22:21:49+08:00	1409	441	1850	185	2035	4717	43.14%	29.87%	12	15
8	澎湖縣白沙鄉	2018-11-24T22:43:53+08:00	1610	493	2103	218	2321	5491	42.27%	29.32%	13	15
8	澎湖縣白沙鄉	2018-11-25T03:31:03+08:00	2443	756	3199	389	3588	8625	41.6%	28.32%	15	15
8	澎湖縣白沙鄉	2018-11-24T22:35:47+08:00	1610	493	2103	218	2321	5491	42.27%	29.32%	13	15
8	澎湖縣白沙鄉	2018-11-25T01:01:05+08:00	2443	756	3199	389	3588	8625	41.6%	28.32%	15	15
8	澎湖縣白沙鄉	2018-11-25T00:56:16+08:00	2443	756	3199	389	3588	8625	41.6%	28.32%	15	15
8	澎湖縣白沙鄉	2018-11-25T00:03:39+08:00	2443	756	3199	389	3588	8625	41.6%	28.32%	15	15
8	苗栗縣銅鑼鄉	2018-11-24T23:07:16+08:00	6444	1608	8052	584	8636	15424	55.99%	41.78%	16	16
8	苗栗縣銅鑼鄉	2018-11-24T22:12:00+08:00	6444	1608	8052	584	8636	15424	55.99%	41.78%	16	16
8	苗栗縣銅鑼鄉	2018-11-24T22:39:06+08:00	6444	1608	8052	584	8636	15424	55.99%	41.78%	16	16
8	苗栗縣銅鑼鄉	2018-11-24T23:58:39+08:00	6444	1608	8052	584	8636	15424	55.99%	41.78%	16	16
8	苗栗縣銅鑼鄉	2018-11-24T23:03:45+08:00	6444	1608	8052	584	8636	15424	55.99%	41.78%	16	16
8	苗栗縣銅鑼鄉	2018-11-24T22:49:21+08:00	6444	1608	8052	584	8636	15424	55.99%	41.78%	16	16
8	苗栗縣銅鑼鄉	2018-11-24T23:22:21+08:00	6444	1608	8052	584	8636	15424	55.99%	41.78%	16	16
8	苗栗縣銅鑼鄉	2018-11-25T01:24:22+08:00	6444	1608	8052	584	8636	15424	55.99%	41.78%	16	16
8	苗栗縣銅鑼鄉	2018-11-24T23:46:01+08:00	6444	1608	8052	584	8636	15424	55.99%	41.78%	16	16
8	苗栗縣銅鑼鄉	2018-11-24T23:42:00+08:00	6444	1608	8052	584	8636	15424	55.99%	41.78%	16	16
8	苗栗縣銅鑼鄉	2018-11-25T03:30:56+08:00	6444	1608	8052	584	8636	15424	55.99%	41.78%	16	16
8	苗栗縣銅鑼鄉	2018-11-25T03:42:45+08:00	6444	1608	8052	584	8636	15424	55.99%	41.78%	16	16
8	苗栗縣銅鑼鄉	2018-11-24T22:32:16+08:00	6444	1608	8052	584	8636	15424	55.99%	41.78%	16	16
8	苗栗縣銅鑼鄉	2018-11-25T03:48:27+08:00	6444	1608	8052	584	8636	15424	55.99%	41.78%	16	16
8	苗栗縣銅鑼鄉	2018-11-25T01:00:58+08:00	6444	1608	8052	584	8636	15424	55.99%	41.78%	16	16
8	苗栗縣銅鑼鄉	2018-11-24T22:25:21+08:00	6444	1608	8052	584	8636	15424	55.99%	41.78%	16	16
8	苗栗縣銅鑼鄉	2018-11-25T06:12:34+08:00	6444	1608	8052	584	8636	15424	55.99%	41.78%	16	16
8	苗栗縣銅鑼鄉	2018-11-24T22:40:16+08:00	6444	1608	8052	584	8636	15424	55.99%	41.78%	16	16
8	苗栗縣銅鑼鄉	2018-11-25T04:01:27+08:00	6444	1608	8052	584	8636	15424	55.99%	41.78%	16	16
8	苗栗縣銅鑼鄉	2018-11-24T22:21:43+08:00	6444	1608	8052	584	8636	15424	55.99%	41.78%	16	16
8	苗栗縣銅鑼鄉	2018-11-25T00:17:05+08:00	6444	1608	8052	584	8636	15424	55.99%	41.78%	16	16
8	苗栗縣銅鑼鄉	2018-11-25T00:21:42+08:00	6444	1608	8052	584	8636	15424	55.99%	41.78%	16	16
8	苗栗縣銅鑼鄉	2018-11-24T23:37:46+08:00	6444	1608	8052	584	8636	15424	55.99%	41.78%	16	16
8	苗栗縣銅鑼鄉	2018-11-24T22:35:42+08:00	6444	1608	8052	584	8636	15424	55.99%	41.78%	16	16
8	苗栗縣銅鑼鄉	2018-11-24T23:18:25+08:00	6444	1608	8052	584	8636	15424	55.99%	41.78%	16	16
8	苗栗縣銅鑼鄉	2018-11-24T23:26:04+08:00	6444	1608	8052	584	8636	15424	55.99%	41.78%	16	16
8	苗栗縣銅鑼鄉	2018-11-24T23:33:48+08:00	6444	1608	8052	584	8636	15424	55.99%	41.78%	16	16
8	苗栗縣銅鑼鄉	2018-11-25T03:54:38+08:00	6444	1608	8052	584	8636	15424	55.99%	41.78%	16	16
8	苗栗縣銅鑼鄉	2018-11-25T03:37:25+08:00	6444	1608	8052	584	8636	15424	55.99%	41.78%	16	16
8	苗栗縣銅鑼鄉	2018-11-24T23:10:54+08:00	6444	1608	8052	584	8636	15424	55.99%	41.78%	16	16
8	苗栗縣銅鑼鄉	2018-11-24T23:14:37+08:00	6444	1608	8052	584	8636	15424	55.99%	41.78%	16	16
8	苗栗縣銅鑼鄉	2018-11-25T06:17:33+08:00	6444	1608	8052	584	8636	15424	55.99%	41.78%	16	16
8	苗栗縣銅鑼鄉	2018-11-24T22:43:47+08:00	6444	1608	8052	584	8636	15424	55.99%	41.78%	16	16
8	苗栗縣銅鑼鄉	2018-11-24T22:56:34+08:00	6444	1608	8052	584	8636	15424	55.99%	41.78%	16	16
8	苗栗縣銅鑼鄉	2018-11-25T00:08:02+08:00	6444	1608	8052	584	8636	15424	55.99%	41.78%	16	16
8	苗栗縣銅鑼鄉	2018-11-24T22:53:12+08:00	6444	1608	8052	584	8636	15424	55.99%	41.78%	16	16
8	苗栗縣銅鑼鄉	2018-11-24T23:29:44+08:00	6444	1608	8052	584	8636	15424	55.99%	41.78%	16	16
8	苗栗縣銅鑼鄉	2018-11-25T01:11:04+08:00	6444	1608	8052	584	8636	15424	55.99%	41.78%	16	16
8	苗栗縣銅鑼鄉	2018-11-25T06:22:42+08:00	6444	1608	8052	584	8636	15424	55.99%	41.78%	16	16
8	苗栗縣銅鑼鄉	2018-11-25T06:07:20+08:00	6444	1608	8052	584	8636	15424	55.99%	41.78%	16	16
8	苗栗縣銅鑼鄉	2018-11-24T23:00:15+08:00	6444	1608	8052	584	8636	15424	55.99%	41.78%	16	16
8	苗栗縣銅鑼鄉	2018-11-25T01:05:56+08:00	6444	1608	8052	584	8636	15424	55.99%	41.78%	16	16
8	苗栗縣銅鑼鄉	2018-11-25T06:27:53+08:00	6444	1608	8052	584	8636	15424	55.99%	41.78%	16	16
8	苗栗縣銅鑼鄉	2018-11-25T00:03:31+08:00	6444	1608	8052	584	8636	15424	55.99%	41.78%	16	16
8	苗栗縣銅鑼鄉	2018-11-24T23:54:25+08:00	6444	1608	8052	584	8636	15424	55.99%	41.78%	16	16
8	苗栗縣銅鑼鄉	2018-11-24T22:14:46+08:00	6444	1608	8052	584	8636	15424	55.99%	41.78%	16	16
8	苗栗縣銅鑼鄉	2018-11-25T00:56:11+08:00	6444	1608	8052	584	8636	15424	55.99%	41.78%	16	16
8	苗栗縣銅鑼鄉	2018-11-24T22:18:17+08:00	6444	1608	8052	584	8636	15424	55.99%	41.78%	16	16
8	苗栗縣銅鑼鄉	2018-11-25T00:12:42+08:00	6444	1608	8052	584	8636	15424	55.99%	41.78%	16	16
8	苗栗縣銅鑼鄉	2018-11-24T22:28:37+08:00	6444	1608	8052	584	8636	15424	55.99%	41.78%	16	16
8	苗栗縣銅鑼鄉	2018-11-25T01:16:19+08:00	6444	1608	8052	584	8636	15424	55.99%	41.78%	16	16
8	苗栗縣銅鑼鄉	2018-11-24T23:50:12+08:00	6444	1608	8052	584	8636	15424	55.99%	41.78%	16	16
8	苗栗縣	2018-11-24T23:07:16+08:00	174973	49821	224794	17857	242651	428693	56.6%	40.82%	444	470
8	苗栗縣	2018-11-24T22:12:00+08:00	127183	36424	163607	13487	177094	313517	56.49%	40.57%	346	470
8	苗栗縣	2018-11-24T22:39:06+08:00	151133	43164	194297	15651	209948	370890	56.61%	40.75%	396	470
8	苗栗縣	2018-11-24T23:22:20+08:00	183625	52180	235805	18646	254451	449939	56.55%	40.81%	461	470
8	苗栗縣	2018-11-24T23:58:39+08:00	187518	53113	240631	18915	259546	458997	56.55%	40.85%	468	470
8	苗栗縣	2018-11-24T23:03:45+08:00	172153	48938	221091	17571	238662	421720	56.59%	40.82%	438	470
8	苗栗縣	2018-11-24T22:49:21+08:00	160815	45934	206749	16484	223233	394417	56.6%	40.77%	416	470
8	苗栗縣	2018-11-24T23:46:01+08:00	186609	52864	239473	18844	258317	456783	56.55%	40.85%	466	470
8	苗栗縣	2018-11-25T03:48:26+08:00	188547	53465	242012	19013	261025	461580	56.55%	40.85%	470	470
8	苗栗縣	2018-11-25T03:30:56+08:00	188547	53465	242012	19013	261025	461580	56.55%	40.85%	470	470
8	苗栗縣	2018-11-25T03:42:45+08:00	188547	53465	242012	19013	261025	461580	56.55%	40.85%	470	470
8	苗栗縣	2018-11-25T01:00:58+08:00	188547	53465	242012	19013	261025	461580	56.55%	40.85%	470	470
8	苗栗縣	2018-11-25T00:08:01+08:00	187989	53282	241271	18979	260250	460092	56.56%	40.86%	469	470
8	苗栗縣	2018-11-25T04:01:26+08:00	188547	53465	242012	19013	261025	461580	56.55%	40.85%	470	470
8	苗栗縣	2018-11-24T22:25:21+08:00	140126	39966	180092	14587	194679	344287	56.55%	40.7%	373	470
8	苗栗縣	2018-11-25T06:12:34+08:00	188547	53465	242012	19013	261025	461580	56.55%	40.85%	470	470
8	苗栗縣	2018-11-24T22:40:16+08:00	153693	43959	197652	15835	213487	377216	56.6%	40.74%	402	470
8	苗栗縣	2018-11-24T22:21:43+08:00	137242	39194	176436	14394	190830	337366	56.56%	40.68%	367	470
8	苗栗縣	2018-11-25T00:17:05+08:00	187989	53282	241271	18979	260250	460092	56.56%	40.86%	469	470
8	苗栗縣	2018-11-24T23:18:24+08:00	181709	51735	233444	18503	251947	445397	56.57%	40.8%	458	470
8	苗栗縣	2018-11-24T23:37:46+08:00	186040	52702	238742	18804	257546	455445	56.55%	40.85%	465	470
8	苗栗縣	2018-11-24T22:35:42+08:00	148146	42311	190457	15407	205864	363581	56.62%	40.75%	390	470
8	苗栗縣	2018-11-25T03:54:37+08:00	188547	53465	242012	19013	261025	461580	56.55%	40.85%	470	470
8	苗栗縣	2018-11-24T23:33:47+08:00	186040	52702	238742	18804	257546	455445	56.55%	40.85%	465	470
8	苗栗縣	2018-11-24T23:26:04+08:00	184192	52307	236499	18687	255186	451125	56.57%	40.83%	462	470
8	苗栗縣	2018-11-24T23:14:37+08:00	180046	51274	231320	18357	249677	441049	56.61%	40.82%	455	470
8	苗栗縣	2018-11-24T23:10:53+08:00	177105	50423	227528	18047	245575	433786	56.61%	40.83%	449	470
8	苗栗縣	2018-11-25T06:17:33+08:00	188547	53465	242012	19013	261025	461580	56.55%	40.85%	470	470
8	苗栗縣	2018-11-24T22:43:47+08:00	156714	44800	201514	16079	217593	384725	56.56%	40.73%	408	470
8	苗栗縣	2018-11-25T01:24:21+08:00	188547	53465	242012	19013	261025	461580	56.55%	40.85%	470	470
8	苗栗縣	2018-11-24T22:56:34+08:00	165197	47063	212260	16958	229218	405067	56.59%	40.78%	425	470
8	苗栗縣	2018-11-25T03:37:24+08:00	188547	53465	242012	19013	261025	461580	56.55%	40.85%	470	470
8	苗栗縣	2018-11-24T22:53:12+08:00	163083	46511	209594	16695	226289	399892	56.59%	40.78%	421	470
8	苗栗縣	2018-11-24T22:32:15+08:00	144811	41347	186158	15029	201187	355614	56.57%	40.72%	383	470
8	苗栗縣	2018-11-24T23:00:14+08:00	168246	47908	216154	17246	233400	412610	56.57%	40.78%	431	470
8	苗栗縣	2018-11-25T01:11:03+08:00	188547	53465	242012	19013	261025	461580	56.55%	40.85%	470	470
8	苗栗縣	2018-11-24T23:29:43+08:00	184192	52307	236499	18687	255186	451125	56.57%	40.83%	462	470
8	苗栗縣	2018-11-25T00:21:41+08:00	187989	53282	241271	18979	260250	460092	56.56%	40.86%	469	470
8	苗栗縣	2018-11-25T06:22:42+08:00	188547	53465	242012	19013	261025	461580	56.55%	40.85%	470	470
8	苗栗縣	2018-11-25T06:07:20+08:00	188547	53465	242012	19013	261025	461580	56.55%	40.85%	470	470
8	苗栗縣	2018-11-25T01:05:56+08:00	188547	53465	242012	19013	261025	461580	56.55%	40.85%	470	470
8	苗栗縣	2018-11-24T23:54:24+08:00	187018	52987	240005	18879	258884	457856	56.54%	40.85%	467	470
8	苗栗縣	2018-11-24T23:41:59+08:00	186040	52702	238742	18804	257546	455445	56.55%	40.85%	465	470
8	苗栗縣	2018-11-25T01:16:18+08:00	188547	53465	242012	19013	261025	461580	56.55%	40.85%	470	470
8	苗栗縣	2018-11-25T00:03:31+08:00	187518	53113	240631	18915	259546	458997	56.55%	40.85%	468	470
8	苗栗縣	2018-11-24T22:14:46+08:00	128093	36729	164822	13579	178401	315963	56.46%	40.54%	348	470
8	苗栗縣	2018-11-25T06:27:52+08:00	188547	53465	242012	19013	261025	461580	56.55%	40.85%	470	470
8	苗栗縣	2018-11-25T00:56:11+08:00	187989	53282	241271	18979	260250	460092	56.56%	40.86%	469	470
8	苗栗縣	2018-11-24T22:18:17+08:00	131957	37735	169692	13885	183577	324943	56.5%	40.61%	355	470
8	苗栗縣	2018-11-25T00:12:42+08:00	187989	53282	241271	18979	260250	460092	56.56%	40.86%	469	470
8	苗栗縣	2018-11-24T22:28:37+08:00	143672	41051	184723	14922	199645	353273	56.51%	40.67%	381	470
8	苗栗縣	2018-11-24T23:50:12+08:00	187018	52987	240005	18879	258884	457856	56.54%	40.85%	467	470
8	高雄市左營區	2018-11-24T23:03:43+08:00	29948	8470	38418	2632	41050	68904	59.58%	43.46%	52	103
8	高雄市左營區	2018-11-24T23:58:37+08:00	50966	14320	65286	4207	69493	115851	59.98%	43.99%	79	103
8	高雄市左營區	2018-11-25T06:17:31+08:00	70034	20435	90469	5819	96288	161367	59.67%	43.4%	103	103
8	高雄市左營區	2018-11-24T23:22:18+08:00	35209	9942	45151	3031	48182	80413	59.92%	43.79%	59	103
8	高雄市左營區	2018-11-24T22:43:45+08:00	20678	5804	26482	2025	28507	47503	60.01%	43.53%	40	103
8	高雄市左營區	2018-11-24T23:14:35+08:00	32591	9222	41813	2895	44708	74802	59.77%	43.57%	56	103
8	高雄市左營區	2018-11-25T03:37:20+08:00	70034	20435	90469	5819	96288	161367	59.67%	43.4%	103	103
8	高雄市左營區	2018-11-25T00:56:09+08:00	63267	18104	81371	5195	86566	144087	60.08%	43.91%	94	103
8	高雄市左營區	2018-11-24T22:49:19+08:00	22826	6444	29270	2188	31458	52487	59.93%	43.49%	43	103
8	高雄市左營區	2018-11-25T00:03:28+08:00	50966	14320	65286	4207	69493	115851	59.98%	43.99%	79	103
8	高雄市左營區	2018-11-25T03:42:43+08:00	70034	20435	90469	5819	96288	161367	59.67%	43.4%	103	103
8	高雄市左營區	2018-11-24T22:53:10+08:00	25090	7098	32188	2370	34558	57642	59.95%	43.53%	46	103
8	高雄市左營區	2018-11-25T00:08:00+08:00	51757	14544	66301	4254	70555	117684	59.95%	43.98%	80	103
8	高雄市左營區	2018-11-25T01:00:56+08:00	63267	18104	81371	5195	86566	144087	60.08%	43.91%	94	103
8	高雄市左營區	2018-11-24T22:25:19+08:00	16324	4615	20939	1674	22613	37846	59.75%	43.13%	34	103
8	高雄市左營區	2018-11-25T00:17:03+08:00	52678	14783	67461	4322	71783	119702	59.97%	44.01%	81	103
8	高雄市左營區	2018-11-25T01:11:01+08:00	63267	18104	81371	5195	86566	144087	60.08%	43.91%	94	103
8	高雄市左營區	2018-11-25T06:22:41+08:00	70034	20435	90469	5819	96288	161367	59.67%	43.4%	103	103
8	高雄市左營區	2018-11-25T06:12:32+08:00	70034	20435	90469	5819	96288	161367	59.67%	43.4%	103	103
8	高雄市左營區	2018-11-24T23:18:23+08:00	32591	9222	41813	2895	44708	74802	59.77%	43.57%	56	103
8	高雄市左營區	2018-11-24T23:50:10+08:00	43832	12387	56219	3699	59918	99727	60.08%	43.95%	70	103
8	高雄市左營區	2018-11-24T22:18:15+08:00	14016	4109	18125	1497	19622	32992	59.48%	42.48%	31	103
8	高雄市左營區	2018-11-24T22:28:35+08:00	16324	4615	20939	1674	22613	37846	59.75%	43.13%	34	103
8	高雄市左營區	2018-11-24T23:54:20+08:00	47029	13256	60285	3911	64196	107147	59.91%	43.89%	74	103
8	高雄市左營區	2018-11-24T22:14:44+08:00	12728	3786	16514	1410	17924	29804	60.14%	42.71%	29	103
8	高雄市左營區	2018-11-25T06:27:50+08:00	70034	20435	90469	5819	96288	161367	59.67%	43.4%	103	103
8	高雄市左營區	2018-11-25T01:05:54+08:00	63267	18104	81371	5195	86566	144087	60.08%	43.91%	94	103
8	高雄市左營區	2018-11-24T23:26:03+08:00	35209	9942	45151	3031	48182	80413	59.92%	43.79%	59	103
8	高雄市左營區	2018-11-25T00:12:41+08:00	52678	14783	67461	4322	71783	119702	59.97%	44.01%	81	103
8	高雄市左營區	2018-11-24T22:56:32+08:00	25945	7365	33310	2417	35727	59692	59.85%	43.46%	47	103
8	高雄市左營區	2018-11-25T01:24:19+08:00	65713	18917	84630	5429	90059	149960	60.06%	43.82%	97	103
8	高雄市左營區	2018-11-24T22:39:04+08:00	20001	5564	25565	1970	27535	45965	59.9%	43.51%	39	103
8	高雄市左營區	2018-11-24T23:10:52+08:00	31000	8760	39760	2783	42543	71295	59.67%	43.48%	54	103
8	高雄市左營區	2018-11-24T23:07:14+08:00	31000	8760	39760	2783	42543	71295	59.67%	43.48%	54	103
8	高雄市左營區	2018-11-25T00:21:39+08:00	54099	15334	69433	4497	73930	123276	59.97%	43.88%	83	103
8	高雄市左營區	2018-11-24T22:32:14+08:00	17726	4926	22652	1749	24401	40941	59.6%	43.3%	36	103
8	高雄市左營區	2018-11-25T03:30:54+08:00	70034	20435	90469	5819	96288	161367	59.67%	43.4%	103	103
8	高雄市左營區	2018-11-25T03:48:24+08:00	70034	20435	90469	5819	96288	161367	59.67%	43.4%	103	103
8	高雄市左營區	2018-11-24T23:29:42+08:00	35912	10103	46015	3094	49109	82050	59.85%	43.77%	60	103
8	高雄市左營區	2018-11-24T23:00:13+08:00	27632	7810	35442	2499	37941	63473	59.78%	43.53%	49	103
8	高雄市左營區	2018-11-24T22:21:41+08:00	15604	4512	20116	1626	21742	36444	59.66%	42.82%	33	103
8	高雄市左營區	2018-11-24T22:40:14+08:00	20678	5804	26482	2025	28507	47503	60.01%	43.53%	40	103
8	高雄市左營區	2018-11-25T06:07:18+08:00	70034	20435	90469	5819	96288	161367	59.67%	43.4%	103	103
8	高雄市左營區	2018-11-24T22:11:58+08:00	11894	3564	15458	1371	16829	27988	60.13%	42.5%	28	103
8	高雄市左營區	2018-11-25T04:01:24+08:00	70034	20435	90469	5819	96288	161367	59.67%	43.4%	103	103
8	高雄市左營區	2018-11-24T23:41:57+08:00	41589	11647	53236	3487	56723	94589	59.97%	43.97%	67	103
8	高雄市左營區	2018-11-24T22:35:40+08:00	18463	5136	23599	1828	25427	42679	59.58%	43.26%	37	103
8	高雄市左營區	2018-11-25T03:54:35+08:00	70034	20435	90469	5819	96288	161367	59.67%	43.4%	103	103
8	高雄市左營區	2018-11-24T23:33:45+08:00	38107	10692	48799	3256	52055	86847	59.94%	43.88%	63	103
8	高雄市左營區	2018-11-24T23:37:44+08:00	38751	10811	49562	3281	52843	88206	59.91%	43.93%	64	103
8	高雄市左營區	2018-11-24T23:45:59+08:00	43285	12222	55507	3629	59136	98487	60.04%	43.95%	69	103
8	高雄市左營區	2018-11-25T01:16:17+08:00	65024	18699	83723	5344	89067	148311	60.05%	43.84%	96	103
8	高雄市林園區	2018-11-24T22:49:20+08:00	19786	6786	26572	2522	29094	54368	53.51%	36.39%	48	51
8	高雄市林園區	2018-11-25T03:37:21+08:00	21562	7309	28871	2647	31518	59129	53.3%	36.47%	51	51
8	高雄市林園區	2018-11-24T23:03:43+08:00	20932	7114	28046	2607	30653	57644	53.18%	36.31%	50	51
8	高雄市林園區	2018-11-24T23:58:37+08:00	21562	7309	28871	2647	31518	59129	53.3%	36.47%	51	51
8	高雄市林園區	2018-11-25T06:17:31+08:00	21562	7309	28871	2647	31518	59129	53.3%	36.47%	51	51
8	高雄市林園區	2018-11-25T00:03:29+08:00	21562	7309	28871	2647	31518	59129	53.3%	36.47%	51	51
8	高雄市林園區	2018-11-24T23:14:35+08:00	20932	7114	28046	2607	30653	57644	53.18%	36.31%	50	51
8	高雄市林園區	2018-11-25T00:56:09+08:00	21562	7309	28871	2647	31518	59129	53.3%	36.47%	51	51
8	高雄市林園區	2018-11-24T23:22:19+08:00	20932	7114	28046	2607	30653	57644	53.18%	36.31%	50	51
8	高雄市林園區	2018-11-25T03:42:43+08:00	21562	7309	28871	2647	31518	59129	53.3%	36.47%	51	51
8	高雄市林園區	2018-11-24T22:53:10+08:00	19786	6786	26572	2522	29094	54368	53.51%	36.39%	48	51
8	高雄市林園區	2018-11-25T00:08:00+08:00	21562	7309	28871	2647	31518	59129	53.3%	36.47%	51	51
8	高雄市林園區	2018-11-24T23:46:00+08:00	20932	7114	28046	2607	30653	57644	53.18%	36.31%	50	51
8	高雄市林園區	2018-11-25T01:00:56+08:00	21562	7309	28871	2647	31518	59129	53.3%	36.47%	51	51
8	高雄市林園區	2018-11-24T22:25:19+08:00	18326	6289	24615	2340	26955	50140	53.76%	36.55%	45	51
8	高雄市林園區	2018-11-25T06:12:33+08:00	21562	7309	28871	2647	31518	59129	53.3%	36.47%	51	51
8	高雄市林園區	2018-11-25T00:17:04+08:00	21562	7309	28871	2647	31518	59129	53.3%	36.47%	51	51
8	高雄市林園區	2018-11-25T06:22:41+08:00	21562	7309	28871	2647	31518	59129	53.3%	36.47%	51	51
8	高雄市林園區	2018-11-24T23:18:23+08:00	20932	7114	28046	2607	30653	57644	53.18%	36.31%	50	51
8	高雄市林園區	2018-11-24T23:50:10+08:00	20932	7114	28046	2607	30653	57644	53.18%	36.31%	50	51
8	高雄市林園區	2018-11-24T22:18:15+08:00	18326	6289	24615	2340	26955	50140	53.76%	36.55%	45	51
8	高雄市林園區	2018-11-24T22:14:44+08:00	18326	6289	24615	2340	26955	50140	53.76%	36.55%	45	51
8	高雄市林園區	2018-11-25T01:05:54+08:00	21562	7309	28871	2647	31518	59129	53.3%	36.47%	51	51
8	高雄市林園區	2018-11-24T23:33:46+08:00	20932	7114	28046	2607	30653	57644	53.18%	36.31%	50	51
8	高雄市林園區	2018-11-25T06:27:51+08:00	21562	7309	28871	2647	31518	59129	53.3%	36.47%	51	51
8	高雄市林園區	2018-11-24T23:26:03+08:00	20932	7114	28046	2607	30653	57644	53.18%	36.31%	50	51
8	高雄市林園區	2018-11-25T03:54:36+08:00	21562	7309	28871	2647	31518	59129	53.3%	36.47%	51	51
8	高雄市林園區	2018-11-25T00:12:41+08:00	21562	7309	28871	2647	31518	59129	53.3%	36.47%	51	51
8	高雄市林園區	2018-11-25T01:24:20+08:00	21562	7309	28871	2647	31518	59129	53.3%	36.47%	51	51
8	高雄市林園區	2018-11-24T22:56:32+08:00	19786	6786	26572	2522	29094	54368	53.51%	36.39%	48	51
8	高雄市林園區	2018-11-24T22:43:46+08:00	19786	6786	26572	2522	29094	54368	53.51%	36.39%	48	51
8	高雄市林園區	2018-11-24T22:39:05+08:00	19786	6786	26572	2522	29094	54368	53.51%	36.39%	48	51
8	高雄市林園區	2018-11-24T23:10:52+08:00	20932	7114	28046	2607	30653	57644	53.18%	36.31%	50	51
8	高雄市林園區	2018-11-24T23:07:14+08:00	20932	7114	28046	2607	30653	57644	53.18%	36.31%	50	51
8	高雄市林園區	2018-11-25T03:48:25+08:00	21562	7309	28871	2647	31518	59129	53.3%	36.47%	51	51
8	高雄市林園區	2018-11-24T22:32:14+08:00	18326	6289	24615	2340	26955	50140	53.76%	36.55%	45	51
8	高雄市林園區	2018-11-25T03:30:54+08:00	21562	7309	28871	2647	31518	59129	53.3%	36.47%	51	51
8	高雄市林園區	2018-11-24T22:40:15+08:00	19786	6786	26572	2522	29094	54368	53.51%	36.39%	48	51
8	高雄市林園區	2018-11-25T00:21:40+08:00	21562	7309	28871	2647	31518	59129	53.3%	36.47%	51	51
8	高雄市林園區	2018-11-24T23:29:42+08:00	20932	7114	28046	2607	30653	57644	53.18%	36.31%	50	51
8	高雄市林園區	2018-11-25T01:11:02+08:00	21562	7309	28871	2647	31518	59129	53.3%	36.47%	51	51
8	高雄市林園區	2018-11-24T23:00:13+08:00	19786	6786	26572	2522	29094	54368	53.51%	36.39%	48	51
8	高雄市林園區	2018-11-24T22:21:41+08:00	18326	6289	24615	2340	26955	50140	53.76%	36.55%	45	51
8	高雄市林園區	2018-11-25T06:07:18+08:00	21562	7309	28871	2647	31518	59129	53.3%	36.47%	51	51
8	高雄市林園區	2018-11-24T22:11:58+08:00	18326	6289	24615	2340	26955	50140	53.76%	36.55%	45	51
8	高雄市林園區	2018-11-25T04:01:24+08:00	21562	7309	28871	2647	31518	59129	53.3%	36.47%	51	51
8	高雄市林園區	2018-11-24T22:28:36+08:00	18326	6289	24615	2340	26955	50140	53.76%	36.55%	45	51
8	高雄市林園區	2018-11-24T22:35:41+08:00	19278	6611	25889	2452	28341	52988	53.49%	36.38%	47	51
8	高雄市林園區	2018-11-24T23:37:45+08:00	20932	7114	28046	2607	30653	57644	53.18%	36.31%	50	51
8	高雄市林園區	2018-11-24T23:41:58+08:00	20932	7114	28046	2607	30653	57644	53.18%	36.31%	50	51
8	高雄市林園區	2018-11-24T23:54:22+08:00	21562	7309	28871	2647	31518	59129	53.3%	36.47%	51	51
8	高雄市林園區	2018-11-25T01:16:17+08:00	21562	7309	28871	2647	31518	59129	53.3%	36.47%	51	51
8	臺南市六甲區	2018-11-25T03:37:19+08:00	5861	2209	8070	1018	9088	19144	47.47%	30.62%	19	19
8	臺南市六甲區	2018-11-24T22:49:18+08:00	5861	2209	8070	1018	9088	19144	47.47%	30.62%	19	19
8	臺南市六甲區	2018-11-24T23:14:33+08:00	5861	2209	8070	1018	9088	19144	47.47%	30.62%	19	19
8	臺南市六甲區	2018-11-24T22:56:31+08:00	5861	2209	8070	1018	9088	19144	47.47%	30.62%	19	19
8	臺南市六甲區	2018-11-25T00:12:39+08:00	5861	2209	8070	1018	9088	19144	47.47%	30.62%	19	19
8	臺南市六甲區	2018-11-25T00:03:27+08:00	5861	2209	8070	1018	9088	19144	47.47%	30.62%	19	19
8	臺南市六甲區	2018-11-25T00:56:07+08:00	5861	2209	8070	1018	9088	19144	47.47%	30.62%	19	19
8	臺南市六甲區	2018-11-24T23:03:42+08:00	5861	2209	8070	1018	9088	19144	47.47%	30.62%	19	19
8	臺南市六甲區	2018-11-24T23:10:51+08:00	5861	2209	8070	1018	9088	19144	47.47%	30.62%	19	19
8	臺南市六甲區	2018-11-24T22:43:44+08:00	5861	2209	8070	1018	9088	19144	47.47%	30.62%	19	19
8	臺南市六甲區	2018-11-25T06:17:30+08:00	5861	2209	8070	1018	9088	19144	47.47%	30.62%	19	19
8	臺南市六甲區	2018-11-24T23:58:36+08:00	5861	2209	8070	1018	9088	19144	47.47%	30.62%	19	19
8	臺南市六甲區	2018-11-24T23:22:17+08:00	5861	2209	8070	1018	9088	19144	47.47%	30.62%	19	19
8	臺南市六甲區	2018-11-25T06:22:40+08:00	5861	2209	8070	1018	9088	19144	47.47%	30.62%	19	19
8	臺南市六甲區	2018-11-24T23:29:41+08:00	5861	2209	8070	1018	9088	19144	47.47%	30.62%	19	19
8	臺南市六甲區	2018-11-24T22:25:18+08:00	5861	2209	8070	1018	9088	19144	47.47%	30.62%	19	19
8	臺南市六甲區	2018-11-25T01:11:00+08:00	5861	2209	8070	1018	9088	19144	47.47%	30.62%	19	19
8	臺南市六甲區	2018-11-25T00:17:02+08:00	5861	2209	8070	1018	9088	19144	47.47%	30.62%	19	19
8	臺南市六甲區	2018-11-25T00:07:58+08:00	5861	2209	8070	1018	9088	19144	47.47%	30.62%	19	19
8	臺南市六甲區	2018-11-25T01:16:15+08:00	5861	2209	8070	1018	9088	19144	47.47%	30.62%	19	19
8	臺南市六甲區	2018-11-24T22:14:43+08:00	5861	2209	8070	1018	9088	19144	47.47%	30.62%	19	19
8	臺南市六甲區	2018-11-24T23:26:02+08:00	5861	2209	8070	1018	9088	19144	47.47%	30.62%	19	19
8	臺南市六甲區	2018-11-25T01:05:52+08:00	5861	2209	8070	1018	9088	19144	47.47%	30.62%	19	19
8	臺南市六甲區	2018-11-24T23:54:19+08:00	5861	2209	8070	1018	9088	19144	47.47%	30.62%	19	19
8	臺南市六甲區	2018-11-24T22:28:34+08:00	5861	2209	8070	1018	9088	19144	47.47%	30.62%	19	19
8	臺南市六甲區	2018-11-24T22:18:14+08:00	5861	2209	8070	1018	9088	19144	47.47%	30.62%	19	19
8	臺南市六甲區	2018-11-25T01:24:18+08:00	5861	2209	8070	1018	9088	19144	47.47%	30.62%	19	19
8	臺南市六甲區	2018-11-24T22:35:39+08:00	5861	2209	8070	1018	9088	19144	47.47%	30.62%	19	19
8	臺南市六甲區	2018-11-24T23:50:09+08:00	5861	2209	8070	1018	9088	19144	47.47%	30.62%	19	19
8	臺南市六甲區	2018-11-25T06:27:49+08:00	5861	2209	8070	1018	9088	19144	47.47%	30.62%	19	19
8	臺南市六甲區	2018-11-24T22:39:03+08:00	5861	2209	8070	1018	9088	19144	47.47%	30.62%	19	19
8	臺南市六甲區	2018-11-24T23:07:13+08:00	5861	2209	8070	1018	9088	19144	47.47%	30.62%	19	19
8	臺南市六甲區	2018-11-25T01:00:54+08:00	5861	2209	8070	1018	9088	19144	47.47%	30.62%	19	19
8	臺南市六甲區	2018-11-24T22:32:13+08:00	5861	2209	8070	1018	9088	19144	47.47%	30.62%	19	19
8	臺南市六甲區	2018-11-25T03:48:23+08:00	5861	2209	8070	1018	9088	19144	47.47%	30.62%	19	19
8	臺南市六甲區	2018-11-24T23:00:09+08:00	5861	2209	8070	1018	9088	19144	47.47%	30.62%	19	19
8	臺南市六甲區	2018-11-25T00:21:38+08:00	5861	2209	8070	1018	9088	19144	47.47%	30.62%	19	19
8	臺南市六甲區	2018-11-25T03:30:52+08:00	5861	2209	8070	1018	9088	19144	47.47%	30.62%	19	19
8	臺南市六甲區	2018-11-25T03:42:41+08:00	5861	2209	8070	1018	9088	19144	47.47%	30.62%	19	19
8	臺南市六甲區	2018-11-24T22:53:08+08:00	5861	2209	8070	1018	9088	19144	47.47%	30.62%	19	19
8	臺南市六甲區	2018-11-25T06:07:17+08:00	5861	2209	8070	1018	9088	19144	47.47%	30.62%	19	19
8	臺南市六甲區	2018-11-24T22:11:57+08:00	5861	2209	8070	1018	9088	19144	47.47%	30.62%	19	19
8	臺南市六甲區	2018-11-24T22:40:13+08:00	5861	2209	8070	1018	9088	19144	47.47%	30.62%	19	19
8	臺南市六甲區	2018-11-25T06:12:31+08:00	5861	2209	8070	1018	9088	19144	47.47%	30.62%	19	19
8	臺南市六甲區	2018-11-25T04:01:23+08:00	5861	2209	8070	1018	9088	19144	47.47%	30.62%	19	19
8	臺南市六甲區	2018-11-24T22:21:40+08:00	5861	2209	8070	1018	9088	19144	47.47%	30.62%	19	19
8	臺南市六甲區	2018-11-24T23:33:44+08:00	5861	2209	8070	1018	9088	19144	47.47%	30.62%	19	19
8	臺南市六甲區	2018-11-25T03:54:34+08:00	5861	2209	8070	1018	9088	19144	47.47%	30.62%	19	19
8	臺南市六甲區	2018-11-24T23:45:58+08:00	5861	2209	8070	1018	9088	19144	47.47%	30.62%	19	19
8	臺南市六甲區	2018-11-24T23:41:56+08:00	5861	2209	8070	1018	9088	19144	47.47%	30.62%	19	19
8	臺南市六甲區	2018-11-24T23:37:43+08:00	5861	2209	8070	1018	9088	19144	47.47%	30.62%	19	19
8	臺南市六甲區	2018-11-24T23:18:21+08:00	5861	2209	8070	1018	9088	19144	47.47%	30.62%	19	19
8	臺南市善化區	2018-11-25T03:37:19+08:00	13391	4901	18292	1754	20046	39950	50.18%	33.52%	29	29
8	臺南市善化區	2018-11-25T00:56:08+08:00	13391	4901	18292	1754	20046	39950	50.18%	33.52%	29	29
8	臺南市善化區	2018-11-24T22:49:18+08:00	12739	4682	17421	1644	19065	38164	49.96%	33.38%	28	29
8	臺南市善化區	2018-11-24T23:14:34+08:00	12739	4682	17421	1644	19065	38164	49.96%	33.38%	28	29
8	臺南市善化區	2018-11-25T00:03:27+08:00	13391	4901	18292	1754	20046	39950	50.18%	33.52%	29	29
8	臺南市善化區	2018-11-24T22:43:45+08:00	12739	4682	17421	1644	19065	38164	49.96%	33.38%	28	29
8	臺南市善化區	2018-11-24T23:03:42+08:00	12739	4682	17421	1644	19065	38164	49.96%	33.38%	28	29
8	臺南市善化區	2018-11-24T23:10:51+08:00	12739	4682	17421	1644	19065	38164	49.96%	33.38%	28	29
8	臺南市善化區	2018-11-25T06:17:30+08:00	13391	4901	18292	1754	20046	39950	50.18%	33.52%	29	29
8	臺南市善化區	2018-11-24T23:58:36+08:00	13391	4901	18292	1754	20046	39950	50.18%	33.52%	29	29
8	臺南市善化區	2018-11-24T23:22:17+08:00	12739	4682	17421	1644	19065	38164	49.96%	33.38%	28	29
8	臺南市善化區	2018-11-25T03:42:42+08:00	13391	4901	18292	1754	20046	39950	50.18%	33.52%	29	29
8	臺南市善化區	2018-11-25T06:22:40+08:00	13391	4901	18292	1754	20046	39950	50.18%	33.52%	29	29
8	臺南市善化區	2018-11-24T23:29:41+08:00	12739	4682	17421	1644	19065	38164	49.96%	33.38%	28	29
8	臺南市善化區	2018-11-24T22:25:18+08:00	11135	4039	15174	1438	16612	33526	49.55%	33.21%	25	29
8	臺南市善化區	2018-11-25T01:11:00+08:00	13391	4901	18292	1754	20046	39950	50.18%	33.52%	29	29
8	臺南市善化區	2018-11-25T00:17:02+08:00	13391	4901	18292	1754	20046	39950	50.18%	33.52%	29	29
8	臺南市善化區	2018-11-25T06:12:32+08:00	13391	4901	18292	1754	20046	39950	50.18%	33.52%	29	29
8	臺南市善化區	2018-11-25T00:12:40+08:00	13391	4901	18292	1754	20046	39950	50.18%	33.52%	29	29
8	臺南市善化區	2018-11-24T22:28:35+08:00	11660	4253	15913	1515	17428	35100	49.65%	33.22%	26	29
8	臺南市善化區	2018-11-24T22:14:43+08:00	10803	3912	14715	1405	16120	32394	49.76%	33.35%	24	29
8	臺南市善化區	2018-11-24T23:26:02+08:00	12739	4682	17421	1644	19065	38164	49.96%	33.38%	28	29
8	臺南市善化區	2018-11-24T23:54:20+08:00	13391	4901	18292	1754	20046	39950	50.18%	33.52%	29	29
8	臺南市善化區	2018-11-25T06:27:50+08:00	13391	4901	18292	1754	20046	39950	50.18%	33.52%	29	29
8	臺南市善化區	2018-11-25T00:07:59+08:00	13391	4901	18292	1754	20046	39950	50.18%	33.52%	29	29
8	臺南市善化區	2018-11-24T23:18:22+08:00	12739	4682	17421	1644	19065	38164	49.96%	33.38%	28	29
8	臺南市善化區	2018-11-25T01:05:53+08:00	13391	4901	18292	1754	20046	39950	50.18%	33.52%	29	29
8	臺南市善化區	2018-11-24T22:18:14+08:00	10803	3912	14715	1405	16120	32394	49.76%	33.35%	24	29
8	臺南市善化區	2018-11-25T01:24:18+08:00	13391	4901	18292	1754	20046	39950	50.18%	33.52%	29	29
8	臺南市善化區	2018-11-24T22:56:32+08:00	12739	4682	17421	1644	19065	38164	49.96%	33.38%	28	29
8	臺南市善化區	2018-11-24T23:50:09+08:00	13391	4901	18292	1754	20046	39950	50.18%	33.52%	29	29
8	臺南市善化區	2018-11-24T22:39:03+08:00	12293	4499	16792	1578	18370	36918	49.76%	33.3%	27	29
8	臺南市善化區	2018-11-24T23:07:13+08:00	12739	4682	17421	1644	19065	38164	49.96%	33.38%	28	29
8	臺南市善化區	2018-11-24T22:32:13+08:00	12293	4499	16792	1578	18370	36918	49.76%	33.3%	27	29
8	臺南市善化區	2018-11-25T03:30:53+08:00	13391	4901	18292	1754	20046	39950	50.18%	33.52%	29	29
8	臺南市善化區	2018-11-25T03:48:23+08:00	13391	4901	18292	1754	20046	39950	50.18%	33.52%	29	29
8	臺南市善化區	2018-11-25T01:00:55+08:00	13391	4901	18292	1754	20046	39950	50.18%	33.52%	29	29
8	臺南市善化區	2018-11-24T23:00:09+08:00	12739	4682	17421	1644	19065	38164	49.96%	33.38%	28	29
8	臺南市善化區	2018-11-25T00:21:38+08:00	13391	4901	18292	1754	20046	39950	50.18%	33.52%	29	29
8	臺南市善化區	2018-11-25T06:07:17+08:00	13391	4901	18292	1754	20046	39950	50.18%	33.52%	29	29
8	臺南市善化區	2018-11-24T22:53:09+08:00	12739	4682	17421	1644	19065	38164	49.96%	33.38%	28	29
8	臺南市善化區	2018-11-24T22:40:14+08:00	12739	4682	17421	1644	19065	38164	49.96%	33.38%	28	29
8	臺南市善化區	2018-11-24T22:11:58+08:00	10450	3758	14208	1334	15542	31288	49.67%	33.4%	23	29
8	臺南市善化區	2018-11-25T04:01:23+08:00	13391	4901	18292	1754	20046	39950	50.18%	33.52%	29	29
8	臺南市善化區	2018-11-24T22:21:40+08:00	11135	4039	15174	1438	16612	33526	49.55%	33.21%	25	29
8	臺南市善化區	2018-11-24T23:41:57+08:00	13391	4901	18292	1754	20046	39950	50.18%	33.52%	29	29
8	臺南市善化區	2018-11-25T01:16:16+08:00	13391	4901	18292	1754	20046	39950	50.18%	33.52%	29	29
8	臺南市善化區	2018-11-24T22:35:40+08:00	12293	4499	16792	1578	18370	36918	49.76%	33.3%	27	29
8	臺南市善化區	2018-11-25T03:54:35+08:00	13391	4901	18292	1754	20046	39950	50.18%	33.52%	29	29
8	臺南市善化區	2018-11-24T23:33:45+08:00	12739	4682	17421	1644	19065	38164	49.96%	33.38%	28	29
8	臺南市善化區	2018-11-24T23:37:44+08:00	12739	4682	17421	1644	19065	38164	49.96%	33.38%	28	29
8	臺南市善化區	2018-11-24T23:45:59+08:00	13391	4901	18292	1754	20046	39950	50.18%	33.52%	29	29
8	臺中市太平區	2018-11-24T22:49:18+08:00	48060	13495	61555	4872	66427	121937	54.48%	39.41%	74	93
8	臺中市太平區	2018-11-24T23:14:33+08:00	51650	14484	66134	5181	71315	130756	54.54%	39.5%	79	93
8	臺中市太平區	2018-11-24T22:56:31+08:00	48060	13495	61555	4872	66427	121937	54.48%	39.41%	74	93
8	臺中市太平區	2018-11-25T00:12:39+08:00	58197	16333	74530	5951	80481	147696	54.49%	39.4%	88	93
8	臺中市太平區	2018-11-25T00:03:27+08:00	57394	16125	73519	5855	79374	145648	54.5%	39.41%	87	93
8	臺中市太平區	2018-11-25T00:56:07+08:00	61930	17365	79295	6258	85553	157926	54.17%	39.21%	93	93
8	臺中市太平區	2018-11-24T23:03:42+08:00	49426	13884	63310	4977	68287	125445	54.44%	39.4%	76	93
8	臺中市太平區	2018-11-24T23:10:51+08:00	50690	14203	64893	5080	69973	128586	54.42%	39.42%	78	93
8	臺中市太平區	2018-11-25T03:37:18+08:00	61930	17365	79295	6258	85553	157926	54.17%	39.21%	93	93
8	臺中市太平區	2018-11-24T22:43:44+08:00	46680	13088	59768	4727	64495	118511	54.42%	39.39%	72	93
8	臺中市太平區	2018-11-25T01:10:59+08:00	61930	17365	79295	6258	85553	157926	54.17%	39.21%	93	93
8	臺中市太平區	2018-11-24T23:22:17+08:00	52434	14719	67153	5292	72445	132703	54.59%	39.51%	80	93
8	臺中市太平區	2018-11-25T06:22:39+08:00	61930	17365	79295	6258	85553	157926	54.17%	39.21%	93	93
8	臺中市太平區	2018-11-24T22:25:18+08:00	42085	11886	53971	4315	58286	107554	54.19%	39.13%	66	93
8	臺中市太平區	2018-11-24T23:29:40+08:00	53899	15126	69025	5418	74443	136371	54.59%	39.52%	82	93
8	臺中市太平區	2018-11-25T00:17:02+08:00	58197	16333	74530	5951	80481	147696	54.49%	39.4%	88	93
8	臺中市太平區	2018-11-25T00:07:58+08:00	57394	16125	73519	5855	79374	145648	54.5%	39.41%	87	93
8	臺中市太平區	2018-11-25T01:16:15+08:00	61930	17365	79295	6258	85553	157926	54.17%	39.21%	93	93
8	臺中市太平區	2018-11-25T01:05:52+08:00	61930	17365	79295	6258	85553	157926	54.17%	39.21%	93	93
8	臺中市太平區	2018-11-24T22:14:42+08:00	36984	10494	47478	3893	51371	94654	54.27%	39.07%	59	93
8	臺中市太平區	2018-11-24T23:54:19+08:00	56598	15918	72516	5773	78289	143522	54.55%	39.44%	86	93
8	臺中市太平區	2018-11-24T22:28:34+08:00	43851	12389	56240	4486	60726	111949	54.24%	39.17%	68	93
8	臺中市太平區	2018-11-24T22:18:13+08:00	38231	10816	49047	3984	53031	97847	54.2%	39.07%	61	93
8	臺中市太平區	2018-11-25T01:24:17+08:00	61930	17365	79295	6258	85553	157926	54.17%	39.21%	93	93
8	臺中市太平區	2018-11-24T22:35:39+08:00	45940	12880	58820	4643	63463	116635	54.41%	39.39%	71	93
8	臺中市太平區	2018-11-24T23:50:09+08:00	56598	15918	72516	5773	78289	143522	54.55%	39.44%	86	93
8	臺中市太平區	2018-11-24T23:58:35+08:00	57394	16125	73519	5855	79374	145648	54.5%	39.41%	87	93
8	臺中市太平區	2018-11-25T06:27:49+08:00	61930	17365	79295	6258	85553	157926	54.17%	39.21%	93	93
8	臺中市太平區	2018-11-24T22:39:03+08:00	46680	13088	59768	4727	64495	118511	54.42%	39.39%	72	93
8	臺中市太平區	2018-11-24T23:07:13+08:00	49988	14044	64032	4992	69024	127004	54.35%	39.36%	77	93
8	臺中市太平區	2018-11-25T01:00:54+08:00	61930	17365	79295	6258	85553	157926	54.17%	39.21%	93	93
8	臺中市太平區	2018-11-24T23:00:08+08:00	48828	13696	62524	4925	67449	123765	54.5%	39.45%	75	93
8	臺中市太平區	2018-11-25T03:48:22+08:00	61930	17365	79295	6258	85553	157926	54.17%	39.21%	93	93
8	臺中市太平區	2018-11-25T00:21:37+08:00	59659	16735	76394	6062	82456	151606	54.39%	39.35%	90	93
8	臺中市太平區	2018-11-25T03:30:52+08:00	61930	17365	79295	6258	85553	157926	54.17%	39.21%	93	93
8	臺中市太平區	2018-11-25T03:42:41+08:00	61930	17365	79295	6258	85553	157926	54.17%	39.21%	93	93
8	臺中市太平區	2018-11-24T22:21:39+08:00	40628	11508	52136	4170	56306	103872	54.21%	39.11%	64	93
8	臺中市太平區	2018-11-24T22:32:12+08:00	45164	12698	57862	4585	62447	115098	54.26%	39.24%	70	93
8	臺中市太平區	2018-11-24T22:53:08+08:00	48060	13495	61555	4872	66427	121937	54.48%	39.41%	74	93
8	臺中市太平區	2018-11-25T04:01:22+08:00	61930	17365	79295	6258	85553	157926	54.17%	39.21%	93	93
8	臺中市太平區	2018-11-24T22:11:57+08:00	36247	10284	46531	3817	50348	92820	54.24%	39.05%	58	93
8	臺中市太平區	2018-11-24T22:40:13+08:00	46680	13088	59768	4727	64495	118511	54.42%	39.39%	72	93
8	臺中市太平區	2018-11-25T06:12:31+08:00	61930	17365	79295	6258	85553	157926	54.17%	39.21%	93	93
8	臺中市太平區	2018-11-25T06:07:16+08:00	61930	17365	79295	6258	85553	157926	54.17%	39.21%	93	93
8	臺中市太平區	2018-11-24T23:33:44+08:00	55295	15486	70781	5569	76350	140170	54.47%	39.45%	84	93
8	臺中市太平區	2018-11-24T23:26:01+08:00	53142	14889	68031	5330	73361	134186	54.67%	39.6%	81	93
8	臺中市太平區	2018-11-25T03:54:34+08:00	61930	17365	79295	6258	85553	157926	54.17%	39.21%	93	93
8	臺中市太平區	2018-11-24T23:45:58+08:00	56598	15918	72516	5773	78289	143522	54.55%	39.44%	86	93
8	臺中市太平區	2018-11-25T06:17:29+08:00	61930	17365	79295	6258	85553	157926	54.17%	39.21%	93	93
8	臺中市太平區	2018-11-24T23:41:56+08:00	56059	15750	71809	5689	77498	142080	54.55%	39.46%	85	93
8	臺中市太平區	2018-11-24T23:37:43+08:00	56059	15750	71809	5689	77498	142080	54.55%	39.46%	85	93
8	臺中市太平區	2018-11-24T23:18:21+08:00	51650	14484	66134	5181	71315	130756	54.54%	39.5%	79	93
8	花蓮縣豐濱鄉	2018-11-24T22:14:51+08:00	634	186	820	100	920	2396	38.4%	26.46%	4	7
8	花蓮縣豐濱鄉	2018-11-24T23:33:52+08:00	987	333	1320	227	1547	3678	42.06%	26.84%	6	7
8	花蓮縣豐濱鄉	2018-11-24T22:28:42+08:00	634	186	820	100	920	2396	38.4%	26.46%	4	7
8	花蓮縣豐濱鄉	2018-11-24T22:56:38+08:00	987	333	1320	227	1547	3678	42.06%	26.84%	6	7
8	花蓮縣豐濱鄉	2018-11-24T23:07:21+08:00	987	333	1320	227	1547	3678	42.06%	26.84%	6	7
8	花蓮縣豐濱鄉	2018-11-24T22:49:26+08:00	987	333	1320	227	1547	3678	42.06%	26.84%	6	7
8	花蓮縣豐濱鄉	2018-11-24T23:10:58+08:00	987	333	1320	227	1547	3678	42.06%	26.84%	6	7
8	花蓮縣豐濱鄉	2018-11-25T06:17:39+08:00	1172	403	1575	314	1889	4395	42.98%	26.67%	7	7
8	花蓮縣豐濱鄉	2018-11-24T22:53:17+08:00	987	333	1320	227	1547	3678	42.06%	26.84%	6	7
8	花蓮縣豐濱鄉	2018-11-24T23:46:06+08:00	987	333	1320	227	1547	3678	42.06%	26.84%	6	7
8	花蓮縣豐濱鄉	2018-11-25T00:08:07+08:00	987	333	1320	227	1547	3678	42.06%	26.84%	6	7
8	花蓮縣豐濱鄉	2018-11-24T22:32:20+08:00	634	186	820	100	920	2396	38.4%	26.46%	4	7
8	花蓮縣豐濱鄉	2018-11-25T00:17:10+08:00	987	333	1320	227	1547	3678	42.06%	26.84%	6	7
8	花蓮縣豐濱鄉	2018-11-25T03:48:33+08:00	1172	403	1575	314	1889	4395	42.98%	26.67%	7	7
8	花蓮縣豐濱鄉	2018-11-24T23:00:19+08:00	987	333	1320	227	1547	3678	42.06%	26.84%	6	7
8	花蓮縣豐濱鄉	2018-11-25T06:07:25+08:00	1172	403	1575	314	1889	4395	42.98%	26.67%	7	7
8	花蓮縣豐濱鄉	2018-11-25T06:22:47+08:00	1172	403	1575	314	1889	4395	42.98%	26.67%	7	7
8	花蓮縣豐濱鄉	2018-11-25T03:42:51+08:00	1172	403	1575	314	1889	4395	42.98%	26.67%	7	7
8	花蓮縣豐濱鄉	2018-11-24T22:25:27+08:00	634	186	820	100	920	2396	38.4%	26.46%	4	7
8	花蓮縣豐濱鄉	2018-11-24T22:40:21+08:00	634	186	820	100	920	2396	38.4%	26.46%	4	7
8	花蓮縣豐濱鄉	2018-11-24T23:29:49+08:00	987	333	1320	227	1547	3678	42.06%	26.84%	6	7
8	花蓮縣豐濱鄉	2018-11-24T23:50:17+08:00	987	333	1320	227	1547	3678	42.06%	26.84%	6	7
8	花蓮縣豐濱鄉	2018-11-24T23:14:43+08:00	987	333	1320	227	1547	3678	42.06%	26.84%	6	7
8	花蓮縣豐濱鄉	2018-11-25T01:16:24+08:00	987	333	1320	227	1547	3678	42.06%	26.84%	6	7
8	花蓮縣豐濱鄉	2018-11-25T00:12:47+08:00	987	333	1320	227	1547	3678	42.06%	26.84%	6	7
8	花蓮縣豐濱鄉	2018-11-24T23:54:29+08:00	987	333	1320	227	1547	3678	42.06%	26.84%	6	7
8	花蓮縣豐濱鄉	2018-11-25T06:27:57+08:00	1172	403	1575	314	1889	4395	42.98%	26.67%	7	7
8	花蓮縣豐濱鄉	2018-11-24T22:18:22+08:00	634	186	820	100	920	2396	38.4%	26.46%	4	7
8	花蓮縣豐濱鄉	2018-11-25T03:37:32+08:00	1172	403	1575	314	1889	4395	42.98%	26.67%	7	7
8	花蓮縣豐濱鄉	2018-11-25T00:56:15+08:00	987	333	1320	227	1547	3678	42.06%	26.84%	6	7
8	花蓮縣豐濱鄉	2018-11-24T23:37:50+08:00	987	333	1320	227	1547	3678	42.06%	26.84%	6	7
8	花蓮縣豐濱鄉	2018-11-25T01:24:27+08:00	987	333	1320	227	1547	3678	42.06%	26.84%	6	7
8	花蓮縣豐濱鄉	2018-11-25T03:54:43+08:00	1172	403	1575	314	1889	4395	42.98%	26.67%	7	7
8	花蓮縣豐濱鄉	2018-11-24T23:03:49+08:00	987	333	1320	227	1547	3678	42.06%	26.84%	6	7
8	花蓮縣豐濱鄉	2018-11-24T23:22:25+08:00	987	333	1320	227	1547	3678	42.06%	26.84%	6	7
8	花蓮縣豐濱鄉	2018-11-24T22:12:05+08:00	634	186	820	100	920	2396	38.4%	26.46%	4	7
8	花蓮縣豐濱鄉	2018-11-25T01:06:02+08:00	987	333	1320	227	1547	3678	42.06%	26.84%	6	7
8	花蓮縣豐濱鄉	2018-11-24T23:42:04+08:00	987	333	1320	227	1547	3678	42.06%	26.84%	6	7
8	花蓮縣豐濱鄉	2018-11-25T01:11:10+08:00	987	333	1320	227	1547	3678	42.06%	26.84%	6	7
8	花蓮縣豐濱鄉	2018-11-25T04:01:31+08:00	1172	403	1575	314	1889	4395	42.98%	26.67%	7	7
8	花蓮縣豐濱鄉	2018-11-25T06:12:39+08:00	1172	403	1575	314	1889	4395	42.98%	26.67%	7	7
8	花蓮縣豐濱鄉	2018-11-24T22:21:48+08:00	634	186	820	100	920	2396	38.4%	26.46%	4	7
8	花蓮縣豐濱鄉	2018-11-25T00:21:46+08:00	987	333	1320	227	1547	3678	42.06%	26.84%	6	7
8	花蓮縣豐濱鄉	2018-11-25T01:01:04+08:00	987	333	1320	227	1547	3678	42.06%	26.84%	6	7
8	花蓮縣豐濱鄉	2018-11-24T22:35:46+08:00	634	186	820	100	920	2396	38.4%	26.46%	4	7
8	花蓮縣豐濱鄉	2018-11-24T23:18:29+08:00	987	333	1320	227	1547	3678	42.06%	26.84%	6	7
8	花蓮縣豐濱鄉	2018-11-24T23:58:45+08:00	987	333	1320	227	1547	3678	42.06%	26.84%	6	7
8	花蓮縣豐濱鄉	2018-11-24T22:39:11+08:00	634	186	820	100	920	2396	38.4%	26.46%	4	7
8	花蓮縣豐濱鄉	2018-11-24T23:26:09+08:00	987	333	1320	227	1547	3678	42.06%	26.84%	6	7
8	花蓮縣豐濱鄉	2018-11-25T03:31:02+08:00	1172	403	1575	314	1889	4395	42.98%	26.67%	7	7
8	花蓮縣豐濱鄉	2018-11-25T00:03:37+08:00	987	333	1320	227	1547	3678	42.06%	26.84%	6	7
8	花蓮縣豐濱鄉	2018-11-24T22:43:52+08:00	634	186	820	100	920	2396	38.4%	26.46%	4	7
8	臺東縣東河鄉	2018-11-24T23:26:10+08:00	2087	663	2750	463	3213	7635	42.08%	27.33%	11	11
8	臺東縣東河鄉	2018-11-24T23:07:21+08:00	2087	663	2750	463	3213	7635	42.08%	27.33%	11	11
8	臺東縣東河鄉	2018-11-24T22:49:26+08:00	1631	500	2131	342	2473	6439	38.41%	25.33%	10	11
8	臺東縣東河鄉	2018-11-24T23:10:58+08:00	2087	663	2750	463	3213	7635	42.08%	27.33%	11	11
8	臺東縣東河鄉	2018-11-24T23:33:53+08:00	2087	663	2750	463	3213	7635	42.08%	27.33%	11	11
8	臺東縣東河鄉	2018-11-24T22:56:39+08:00	1631	500	2131	342	2473	6439	38.41%	25.33%	10	11
8	臺東縣東河鄉	2018-11-24T23:22:26+08:00	2087	663	2750	463	3213	7635	42.08%	27.33%	11	11
8	臺東縣東河鄉	2018-11-24T22:28:43+08:00	1631	500	2131	342	2473	6439	38.41%	25.33%	10	11
8	臺東縣東河鄉	2018-11-24T23:18:30+08:00	2087	663	2750	463	3213	7635	42.08%	27.33%	11	11
8	臺東縣東河鄉	2018-11-25T00:17:11+08:00	2087	663	2750	463	3213	7635	42.08%	27.33%	11	11
8	臺東縣東河鄉	2018-11-24T22:32:21+08:00	1631	500	2131	342	2473	6439	38.41%	25.33%	10	11
8	臺東縣東河鄉	2018-11-24T23:46:06+08:00	2087	663	2750	463	3213	7635	42.08%	27.33%	11	11
8	臺東縣東河鄉	2018-11-25T00:08:07+08:00	2087	663	2750	463	3213	7635	42.08%	27.33%	11	11
8	臺東縣東河鄉	2018-11-24T22:53:18+08:00	1631	500	2131	342	2473	6439	38.41%	25.33%	10	11
8	臺東縣東河鄉	2018-11-25T04:01:32+08:00	2087	663	2750	463	3213	7635	42.08%	27.33%	11	11
8	臺東縣東河鄉	2018-11-25T03:48:34+08:00	2087	663	2750	463	3213	7635	42.08%	27.33%	11	11
8	臺東縣東河鄉	2018-11-24T23:00:19+08:00	1631	500	2131	342	2473	6439	38.41%	25.33%	10	11
8	臺東縣東河鄉	2018-11-25T06:07:25+08:00	2087	663	2750	463	3213	7635	42.08%	27.33%	11	11
8	臺東縣東河鄉	2018-11-24T22:25:28+08:00	1631	500	2131	342	2473	6439	38.41%	25.33%	10	11
8	臺東縣東河鄉	2018-11-25T06:22:47+08:00	2087	663	2750	463	3213	7635	42.08%	27.33%	11	11
8	臺東縣東河鄉	2018-11-25T03:42:51+08:00	2087	663	2750	463	3213	7635	42.08%	27.33%	11	11
8	臺東縣東河鄉	2018-11-24T22:40:21+08:00	1631	500	2131	342	2473	6439	38.41%	25.33%	10	11
8	臺東縣東河鄉	2018-11-24T23:29:49+08:00	2087	663	2750	463	3213	7635	42.08%	27.33%	11	11
8	臺東縣東河鄉	2018-11-24T23:14:44+08:00	2087	663	2750	463	3213	7635	42.08%	27.33%	11	11
8	臺東縣東河鄉	2018-11-24T23:50:17+08:00	2087	663	2750	463	3213	7635	42.08%	27.33%	11	11
8	臺東縣東河鄉	2018-11-25T00:12:47+08:00	2087	663	2750	463	3213	7635	42.08%	27.33%	11	11
8	臺東縣東河鄉	2018-11-25T01:16:25+08:00	2087	663	2750	463	3213	7635	42.08%	27.33%	11	11
8	臺東縣東河鄉	2018-11-24T22:18:22+08:00	1631	500	2131	342	2473	6439	38.41%	25.33%	10	11
8	臺東縣東河鄉	2018-11-25T03:37:32+08:00	2087	663	2750	463	3213	7635	42.08%	27.33%	11	11
8	臺東縣東河鄉	2018-11-25T06:27:58+08:00	2087	663	2750	463	3213	7635	42.08%	27.33%	11	11
8	臺東縣東河鄉	2018-11-25T06:17:40+08:00	2087	663	2750	463	3213	7635	42.08%	27.33%	11	11
8	臺東縣東河鄉	2018-11-25T01:24:27+08:00	2087	663	2750	463	3213	7635	42.08%	27.33%	11	11
8	臺東縣東河鄉	2018-11-25T03:54:44+08:00	2087	663	2750	463	3213	7635	42.08%	27.33%	11	11
8	臺東縣東河鄉	2018-11-24T23:03:49+08:00	2087	663	2750	463	3213	7635	42.08%	27.33%	11	11
8	臺東縣東河鄉	2018-11-24T22:14:52+08:00	1631	500	2131	342	2473	6439	38.41%	25.33%	10	11
8	臺東縣東河鄉	2018-11-24T23:37:51+08:00	2087	663	2750	463	3213	7635	42.08%	27.33%	11	11
8	臺東縣東河鄉	2018-11-24T22:12:05+08:00	1631	500	2131	342	2473	6439	38.41%	25.33%	10	11
8	臺東縣東河鄉	2018-11-24T23:54:30+08:00	2087	663	2750	463	3213	7635	42.08%	27.33%	11	11
8	臺東縣東河鄉	2018-11-24T23:42:04+08:00	2087	663	2750	463	3213	7635	42.08%	27.33%	11	11
8	臺東縣東河鄉	2018-11-25T01:11:10+08:00	2087	663	2750	463	3213	7635	42.08%	27.33%	11	11
8	臺東縣東河鄉	2018-11-25T01:06:03+08:00	2087	663	2750	463	3213	7635	42.08%	27.33%	11	11
8	臺東縣東河鄉	2018-11-25T00:21:47+08:00	2087	663	2750	463	3213	7635	42.08%	27.33%	11	11
8	臺東縣東河鄉	2018-11-25T06:12:39+08:00	2087	663	2750	463	3213	7635	42.08%	27.33%	11	11
8	臺東縣東河鄉	2018-11-24T22:21:49+08:00	1631	500	2131	342	2473	6439	38.41%	25.33%	10	11
8	臺東縣東河鄉	2018-11-25T01:01:04+08:00	2087	663	2750	463	3213	7635	42.08%	27.33%	11	11
8	臺東縣東河鄉	2018-11-25T00:03:38+08:00	2087	663	2750	463	3213	7635	42.08%	27.33%	11	11
8	臺東縣東河鄉	2018-11-24T22:43:53+08:00	1631	500	2131	342	2473	6439	38.41%	25.33%	10	11
8	臺東縣東河鄉	2018-11-24T22:35:47+08:00	1631	500	2131	342	2473	6439	38.41%	25.33%	10	11
8	臺東縣東河鄉	2018-11-24T23:58:45+08:00	2087	663	2750	463	3213	7635	42.08%	27.33%	11	11
8	臺東縣東河鄉	2018-11-25T00:56:16+08:00	2087	663	2750	463	3213	7635	42.08%	27.33%	11	11
8	臺東縣東河鄉	2018-11-24T22:39:11+08:00	1631	500	2131	342	2473	6439	38.41%	25.33%	10	11
8	臺東縣東河鄉	2018-11-25T03:31:02+08:00	2087	663	2750	463	3213	7635	42.08%	27.33%	11	11
8	嘉義縣東石鄉	2018-11-24T23:07:18+08:00	5381	1864	7245	1233	8478	21915	38.69%	24.55%	27	27
8	嘉義縣東石鄉	2018-11-24T22:56:36+08:00	5381	1864	7245	1233	8478	21915	38.69%	24.55%	27	27
8	嘉義縣東石鄉	2018-11-25T01:24:24+08:00	5381	1864	7245	1233	8478	21915	38.69%	24.55%	27	27
8	嘉義縣東石鄉	2018-11-25T03:54:40+08:00	5381	1864	7245	1233	8478	21915	38.69%	24.55%	27	27
8	嘉義縣東石鄉	2018-11-25T06:17:36+08:00	5381	1864	7245	1233	8478	21915	38.69%	24.55%	27	27
8	嘉義縣東石鄉	2018-11-24T23:10:56+08:00	5381	1864	7245	1233	8478	21915	38.69%	24.55%	27	27
8	嘉義縣東石鄉	2018-11-25T03:37:29+08:00	5381	1864	7245	1233	8478	21915	38.69%	24.55%	27	27
8	嘉義縣東石鄉	2018-11-24T22:39:09+08:00	5381	1864	7245	1233	8478	21915	38.69%	24.55%	27	27
8	嘉義縣東石鄉	2018-11-25T03:30:59+08:00	5381	1864	7245	1233	8478	21915	38.69%	24.55%	27	27
8	嘉義縣東石鄉	2018-11-24T22:32:18+08:00	5381	1864	7245	1233	8478	21915	38.69%	24.55%	27	27
8	嘉義縣東石鄉	2018-11-25T03:48:29+08:00	5381	1864	7245	1233	8478	21915	38.69%	24.55%	27	27
8	嘉義縣東石鄉	2018-11-24T23:00:17+08:00	5381	1864	7245	1233	8478	21915	38.69%	24.55%	27	27
8	嘉義縣東石鄉	2018-11-25T00:21:44+08:00	5381	1864	7245	1233	8478	21915	38.69%	24.55%	27	27
8	嘉義縣東石鄉	2018-11-24T23:29:46+08:00	5381	1864	7245	1233	8478	21915	38.69%	24.55%	27	27
8	嘉義縣東石鄉	2018-11-25T06:07:23+08:00	5381	1864	7245	1233	8478	21915	38.69%	24.55%	27	27
8	嘉義縣東石鄉	2018-11-25T04:01:29+08:00	5381	1864	7245	1233	8478	21915	38.69%	24.55%	27	27
8	嘉義縣東石鄉	2018-11-25T01:11:07+08:00	5381	1864	7245	1233	8478	21915	38.69%	24.55%	27	27
8	嘉義縣東石鄉	2018-11-24T22:40:19+08:00	5381	1864	7245	1233	8478	21915	38.69%	24.55%	27	27
8	嘉義縣東石鄉	2018-11-24T23:37:48+08:00	5381	1864	7245	1233	8478	21915	38.69%	24.55%	27	27
8	嘉義縣東石鄉	2018-11-24T22:43:50+08:00	5381	1864	7245	1233	8478	21915	38.69%	24.55%	27	27
8	嘉義縣東石鄉	2018-11-25T00:56:13+08:00	5381	1864	7245	1233	8478	21915	38.69%	24.55%	27	27
8	嘉義縣東石鄉	2018-11-24T23:54:27+08:00	5381	1864	7245	1233	8478	21915	38.69%	24.55%	27	27
8	嘉義縣東石鄉	2018-11-25T01:16:22+08:00	5381	1864	7245	1233	8478	21915	38.69%	24.55%	27	27
8	嘉義縣東石鄉	2018-11-25T00:03:34+08:00	5381	1864	7245	1233	8478	21915	38.69%	24.55%	27	27
8	嘉義縣東石鄉	2018-11-24T22:35:44+08:00	5381	1864	7245	1233	8478	21915	38.69%	24.55%	27	27
8	嘉義縣東石鄉	2018-11-25T01:01:01+08:00	5381	1864	7245	1233	8478	21915	38.69%	24.55%	27	27
8	嘉義縣東石鄉	2018-11-24T23:22:23+08:00	5381	1864	7245	1233	8478	21915	38.69%	24.55%	27	27
8	嘉義縣東石鄉	2018-11-24T22:49:24+08:00	5381	1864	7245	1233	8478	21915	38.69%	24.55%	27	27
8	嘉義縣東石鄉	2018-11-24T23:03:47+08:00	5381	1864	7245	1233	8478	21915	38.69%	24.55%	27	27
8	嘉義縣東石鄉	2018-11-24T22:28:40+08:00	5381	1864	7245	1233	8478	21915	38.69%	24.55%	27	27
8	嘉義縣東石鄉	2018-11-24T23:33:50+08:00	5381	1864	7245	1233	8478	21915	38.69%	24.55%	27	27
8	嘉義縣東石鄉	2018-11-24T22:12:02+08:00	5128	1762	6890	1178	8068	21014	38.39%	24.4%	26	27
8	嘉義縣東石鄉	2018-11-25T00:08:04+08:00	5381	1864	7245	1233	8478	21915	38.69%	24.55%	27	27
8	嘉義縣東石鄉	2018-11-24T23:42:02+08:00	5381	1864	7245	1233	8478	21915	38.69%	24.55%	27	27
8	嘉義縣東石鄉	2018-11-25T03:42:48+08:00	5381	1864	7245	1233	8478	21915	38.69%	24.55%	27	27
8	嘉義縣東石鄉	2018-11-24T22:53:15+08:00	5381	1864	7245	1233	8478	21915	38.69%	24.55%	27	27
8	嘉義縣東石鄉	2018-11-24T23:46:03+08:00	5381	1864	7245	1233	8478	21915	38.69%	24.55%	27	27
8	嘉義縣東石鄉	2018-11-24T22:21:46+08:00	5381	1864	7245	1233	8478	21915	38.69%	24.55%	27	27
8	嘉義縣東石鄉	2018-11-24T22:25:25+08:00	5381	1864	7245	1233	8478	21915	38.69%	24.55%	27	27
8	嘉義縣東石鄉	2018-11-25T06:22:44+08:00	5381	1864	7245	1233	8478	21915	38.69%	24.55%	27	27
8	嘉義縣東石鄉	2018-11-25T06:12:36+08:00	5381	1864	7245	1233	8478	21915	38.69%	24.55%	27	27
8	嘉義縣東石鄉	2018-11-25T00:17:08+08:00	5381	1864	7245	1233	8478	21915	38.69%	24.55%	27	27
8	嘉義縣東石鄉	2018-11-24T22:14:49+08:00	5128	1762	6890	1178	8068	21014	38.39%	24.4%	26	27
8	嘉義縣東石鄉	2018-11-24T23:18:27+08:00	5381	1864	7245	1233	8478	21915	38.69%	24.55%	27	27
8	嘉義縣東石鄉	2018-11-24T22:18:19+08:00	5128	1762	6890	1178	8068	21014	38.39%	24.4%	26	27
8	嘉義縣東石鄉	2018-11-24T23:58:42+08:00	5381	1864	7245	1233	8478	21915	38.69%	24.55%	27	27
8	嘉義縣東石鄉	2018-11-25T06:27:55+08:00	5381	1864	7245	1233	8478	21915	38.69%	24.55%	27	27
8	嘉義縣東石鄉	2018-11-24T23:26:07+08:00	5381	1864	7245	1233	8478	21915	38.69%	24.55%	27	27
8	嘉義縣東石鄉	2018-11-25T00:12:45+08:00	5381	1864	7245	1233	8478	21915	38.69%	24.55%	27	27
8	嘉義縣東石鄉	2018-11-25T01:05:59+08:00	5381	1864	7245	1233	8478	21915	38.69%	24.55%	27	27
8	嘉義縣東石鄉	2018-11-24T23:14:41+08:00	5381	1864	7245	1233	8478	21915	38.69%	24.55%	27	27
8	嘉義縣東石鄉	2018-11-24T23:50:15+08:00	5381	1864	7245	1233	8478	21915	38.69%	24.55%	27	27
8	宜蘭縣礁溪鄉	2018-11-24T23:33:52+08:00	11552	3510	15062	1503	16565	31084	53.29%	37.16%	32	32
8	宜蘭縣礁溪鄉	2018-11-24T23:10:57+08:00	11176	3411	14587	1466	16053	29952	53.6%	37.31%	31	32
8	宜蘭縣礁溪鄉	2018-11-25T06:17:38+08:00	11552	3510	15062	1503	16565	31084	53.29%	37.16%	32	32
8	宜蘭縣礁溪鄉	2018-11-24T22:28:42+08:00	9646	2924	12570	1237	13807	25891	53.33%	37.26%	27	32
8	宜蘭縣礁溪鄉	2018-11-24T23:07:21+08:00	11176	3411	14587	1466	16053	29952	53.6%	37.31%	31	32
8	宜蘭縣礁溪鄉	2018-11-24T22:14:50+08:00	8721	2650	11371	1137	12508	23572	53.06%	37%	25	32
8	宜蘭縣礁溪鄉	2018-11-24T22:56:37+08:00	10525	3206	13731	1381	15112	28327	53.35%	37.16%	29	32
8	宜蘭縣礁溪鄉	2018-11-24T22:53:17+08:00	10525	3206	13731	1381	15112	28327	53.35%	37.16%	29	32
8	宜蘭縣礁溪鄉	2018-11-25T01:06:01+08:00	11552	3510	15062	1503	16565	31084	53.29%	37.16%	32	32
8	宜蘭縣礁溪鄉	2018-11-24T22:32:20+08:00	9646	2924	12570	1237	13807	25891	53.33%	37.26%	27	32
8	宜蘭縣礁溪鄉	2018-11-25T00:17:10+08:00	11552	3510	15062	1503	16565	31084	53.29%	37.16%	32	32
8	宜蘭縣礁溪鄉	2018-11-25T00:08:06+08:00	11552	3510	15062	1503	16565	31084	53.29%	37.16%	32	32
8	宜蘭縣礁溪鄉	2018-11-25T03:48:33+08:00	11552	3510	15062	1503	16565	31084	53.29%	37.16%	32	32
8	宜蘭縣礁溪鄉	2018-11-24T23:29:48+08:00	11552	3510	15062	1503	16565	31084	53.29%	37.16%	32	32
8	宜蘭縣礁溪鄉	2018-11-24T22:40:20+08:00	10028	3023	13051	1287	14338	27013	53.08%	37.12%	28	32
8	宜蘭縣礁溪鄉	2018-11-25T06:22:46+08:00	11552	3510	15062	1503	16565	31084	53.29%	37.16%	32	32
8	宜蘭縣礁溪鄉	2018-11-25T06:07:24+08:00	11552	3510	15062	1503	16565	31084	53.29%	37.16%	32	32
8	宜蘭縣礁溪鄉	2018-11-24T23:00:18+08:00	10525	3206	13731	1381	15112	28327	53.35%	37.16%	29	32
8	宜蘭縣礁溪鄉	2018-11-24T22:25:27+08:00	9646	2924	12570	1237	13807	25891	53.33%	37.26%	27	32
8	宜蘭縣礁溪鄉	2018-11-25T03:42:50+08:00	11552	3510	15062	1503	16565	31084	53.29%	37.16%	32	32
8	宜蘭縣礁溪鄉	2018-11-25T01:11:09+08:00	11552	3510	15062	1503	16565	31084	53.29%	37.16%	32	32
8	宜蘭縣礁溪鄉	2018-11-25T01:16:24+08:00	11552	3510	15062	1503	16565	31084	53.29%	37.16%	32	32
8	宜蘭縣礁溪鄉	2018-11-25T06:27:57+08:00	11552	3510	15062	1503	16565	31084	53.29%	37.16%	32	32
8	宜蘭縣礁溪鄉	2018-11-25T03:31:01+08:00	11552	3510	15062	1503	16565	31084	53.29%	37.16%	32	32
8	宜蘭縣礁溪鄉	2018-11-24T23:14:42+08:00	11176	3411	14587	1466	16053	29952	53.6%	37.31%	31	32
8	宜蘭縣礁溪鄉	2018-11-24T23:50:16+08:00	11552	3510	15062	1503	16565	31084	53.29%	37.16%	32	32
8	宜蘭縣礁溪鄉	2018-11-25T00:56:15+08:00	11552	3510	15062	1503	16565	31084	53.29%	37.16%	32	32
8	宜蘭縣礁溪鄉	2018-11-25T00:12:46+08:00	11552	3510	15062	1503	16565	31084	53.29%	37.16%	32	32
8	宜蘭縣礁溪鄉	2018-11-24T23:54:28+08:00	11552	3510	15062	1503	16565	31084	53.29%	37.16%	32	32
8	宜蘭縣礁溪鄉	2018-11-24T23:37:50+08:00	11552	3510	15062	1503	16565	31084	53.29%	37.16%	32	32
8	宜蘭縣礁溪鄉	2018-11-25T03:54:43+08:00	11552	3510	15062	1503	16565	31084	53.29%	37.16%	32	32
8	宜蘭縣礁溪鄉	2018-11-24T22:12:04+08:00	8721	2650	11371	1137	12508	23572	53.06%	37%	25	32
8	宜蘭縣礁溪鄉	2018-11-24T23:22:25+08:00	11552	3510	15062	1503	16565	31084	53.29%	37.16%	32	32
8	宜蘭縣礁溪鄉	2018-11-25T01:24:26+08:00	11552	3510	15062	1503	16565	31084	53.29%	37.16%	32	32
8	宜蘭縣礁溪鄉	2018-11-24T23:03:48+08:00	11176	3411	14587	1466	16053	29952	53.6%	37.31%	31	32
8	宜蘭縣礁溪鄉	2018-11-24T22:49:25+08:00	10525	3206	13731	1381	15112	28327	53.35%	37.16%	29	32
8	宜蘭縣礁溪鄉	2018-11-24T23:42:03+08:00	11552	3510	15062	1503	16565	31084	53.29%	37.16%	32	32
8	宜蘭縣礁溪鄉	2018-11-24T23:46:05+08:00	11552	3510	15062	1503	16565	31084	53.29%	37.16%	32	32
8	宜蘭縣礁溪鄉	2018-11-25T04:01:31+08:00	11552	3510	15062	1503	16565	31084	53.29%	37.16%	32	32
8	宜蘭縣礁溪鄉	2018-11-24T22:21:48+08:00	9222	2777	11999	1210	13209	24766	53.34%	37.24%	26	32
8	宜蘭縣礁溪鄉	2018-11-25T06:12:38+08:00	11552	3510	15062	1503	16565	31084	53.29%	37.16%	32	32
8	宜蘭縣礁溪鄉	2018-11-25T00:21:46+08:00	11552	3510	15062	1503	16565	31084	53.29%	37.16%	32	32
8	宜蘭縣礁溪鄉	2018-11-25T01:01:03+08:00	11552	3510	15062	1503	16565	31084	53.29%	37.16%	32	32
8	宜蘭縣礁溪鄉	2018-11-24T22:39:10+08:00	10028	3023	13051	1287	14338	27013	53.08%	37.12%	28	32
8	宜蘭縣礁溪鄉	2018-11-24T23:26:08+08:00	11552	3510	15062	1503	16565	31084	53.29%	37.16%	32	32
8	宜蘭縣礁溪鄉	2018-11-24T22:35:46+08:00	10028	3023	13051	1287	14338	27013	53.08%	37.12%	28	32
8	宜蘭縣礁溪鄉	2018-11-24T23:58:44+08:00	11552	3510	15062	1503	16565	31084	53.29%	37.16%	32	32
8	宜蘭縣礁溪鄉	2018-11-24T23:18:29+08:00	11552	3510	15062	1503	16565	31084	53.29%	37.16%	32	32
8	宜蘭縣礁溪鄉	2018-11-25T03:37:31+08:00	11552	3510	15062	1503	16565	31084	53.29%	37.16%	32	32
8	宜蘭縣礁溪鄉	2018-11-24T22:18:21+08:00	9222	2777	11999	1210	13209	24766	53.34%	37.24%	26	32
8	宜蘭縣礁溪鄉	2018-11-25T00:03:37+08:00	11552	3510	15062	1503	16565	31084	53.29%	37.16%	32	32
8	宜蘭縣礁溪鄉	2018-11-24T22:43:52+08:00	10028	3023	13051	1287	14338	27013	53.08%	37.12%	28	32
8	臺南市仁德區	2018-11-25T00:56:08+08:00	23085	7505	30590	2993	33583	64632	51.96%	35.72%	49	49
8	臺南市仁德區	2018-11-24T22:49:18+08:00	15707	5172	20879	2008	22887	44390	51.56%	35.38%	35	49
8	臺南市仁德區	2018-11-24T23:14:34+08:00	19573	6330	25903	2537	28440	54724	51.97%	35.77%	42	49
8	臺南市仁德區	2018-11-24T23:03:43+08:00	18509	6060	24569	2417	26986	51949	51.95%	35.63%	40	49
8	臺南市仁德區	2018-11-25T06:17:31+08:00	23085	7505	30590	2993	33583	64632	51.96%	35.72%	49	49
8	臺南市仁德區	2018-11-24T23:22:18+08:00	21516	6994	28510	2860	31370	60372	51.96%	35.64%	46	49
8	臺南市仁德區	2018-11-24T22:43:45+08:00	14422	4725	19147	1865	21012	40911	51.36%	35.25%	33	49
8	臺南市仁德區	2018-11-24T23:10:51+08:00	18979	6164	25143	2471	27614	53259	51.85%	35.64%	41	49
8	臺南市仁德區	2018-11-25T03:37:20+08:00	23085	7505	30590	2993	33583	64632	51.96%	35.72%	49	49
8	臺南市仁德區	2018-11-25T00:03:28+08:00	23085	7505	30590	2993	33583	64632	51.96%	35.72%	49	49
8	臺南市仁德區	2018-11-24T23:58:36+08:00	23085	7505	30590	2993	33583	64632	51.96%	35.72%	49	49
8	臺南市仁德區	2018-11-25T03:42:42+08:00	23085	7505	30590	2993	33583	64632	51.96%	35.72%	49	49
8	臺南市仁德區	2018-11-24T22:25:19+08:00	11966	3860	15826	1574	17400	33870	51.37%	35.33%	28	49
8	臺南市仁德區	2018-11-25T06:22:40+08:00	23085	7505	30590	2993	33583	64632	51.96%	35.72%	49	49
8	臺南市仁德區	2018-11-25T00:17:03+08:00	23085	7505	30590	2993	33583	64632	51.96%	35.72%	49	49
8	臺南市仁德區	2018-11-25T01:11:01+08:00	23085	7505	30590	2993	33583	64632	51.96%	35.72%	49	49
8	臺南市仁德區	2018-11-24T23:29:41+08:00	22609	7363	29972	2965	32937	63308	52.03%	35.71%	48	49
8	臺南市仁德區	2018-11-25T06:12:32+08:00	23085	7505	30590	2993	33583	64632	51.96%	35.72%	49	49
8	臺南市仁德區	2018-11-24T23:50:10+08:00	23085	7505	30590	2993	33583	64632	51.96%	35.72%	49	49
8	臺南市仁德區	2018-11-25T00:12:40+08:00	23085	7505	30590	2993	33583	64632	51.96%	35.72%	49	49
8	臺南市仁德區	2018-11-24T22:28:35+08:00	12471	4037	16508	1650	18158	35200	51.59%	35.43%	29	49
8	臺南市仁德區	2018-11-24T22:14:43+08:00	10082	3268	13350	1315	14665	28601	51.27%	35.25%	24	49
8	臺南市仁德區	2018-11-24T23:26:02+08:00	22054	7191	29245	2920	32165	61762	52.08%	35.71%	47	49
8	臺南市仁德區	2018-11-24T23:54:20+08:00	23085	7505	30590	2993	33583	64632	51.96%	35.72%	49	49
8	臺南市仁德區	2018-11-25T06:27:50+08:00	23085	7505	30590	2993	33583	64632	51.96%	35.72%	49	49
8	臺南市仁德區	2018-11-25T00:07:59+08:00	23085	7505	30590	2993	33583	64632	51.96%	35.72%	49	49
8	臺南市仁德區	2018-11-24T23:18:22+08:00	20489	6674	27163	2679	29842	57586	51.82%	35.58%	44	49
8	臺南市仁德區	2018-11-25T01:05:53+08:00	23085	7505	30590	2993	33583	64632	51.96%	35.72%	49	49
8	臺南市仁德區	2018-11-24T22:18:14+08:00	10546	3434	13980	1404	15384	29919	51.42%	35.25%	25	49
8	臺南市仁德區	2018-11-24T22:56:32+08:00	16632	5465	22097	2200	24297	47061	51.63%	35.34%	37	49
8	臺南市仁德區	2018-11-25T01:24:19+08:00	23085	7505	30590	2993	33583	64632	51.96%	35.72%	49	49
8	臺南市仁德區	2018-11-24T22:39:04+08:00	13415	4355	17770	1740	19510	38085	51.23%	35.22%	31	49
8	臺南市仁德區	2018-11-24T23:07:14+08:00	18509	6060	24569	2417	26986	51949	51.95%	35.63%	40	49
8	臺南市仁德區	2018-11-25T00:21:39+08:00	23085	7505	30590	2993	33583	64632	51.96%	35.72%	49	49
8	臺南市仁德區	2018-11-24T22:32:13+08:00	12471	4037	16508	1650	18158	35200	51.59%	35.43%	29	49
8	臺南市仁德區	2018-11-25T03:30:53+08:00	23085	7505	30590	2993	33583	64632	51.96%	35.72%	49	49
8	臺南市仁德區	2018-11-25T03:48:24+08:00	23085	7505	30590	2993	33583	64632	51.96%	35.72%	49	49
8	臺南市仁德區	2018-11-25T01:00:55+08:00	23085	7505	30590	2993	33583	64632	51.96%	35.72%	49	49
8	臺南市仁德區	2018-11-24T23:00:13+08:00	17249	5655	22904	2314	25218	48809	51.67%	35.34%	38	49
8	臺南市仁德區	2018-11-25T06:07:17+08:00	23085	7505	30590	2993	33583	64632	51.96%	35.72%	49	49
8	臺南市仁德區	2018-11-24T22:53:09+08:00	16202	5337	21539	2112	23651	45855	51.58%	35.33%	36	49
8	臺南市仁德區	2018-11-24T22:40:14+08:00	13915	4541	18456	1808	20264	39576	51.2%	35.16%	32	49
8	臺南市仁德區	2018-11-24T22:11:58+08:00	10082	3268	13350	1315	14665	28601	51.27%	35.25%	24	49
8	臺南市仁德區	2018-11-25T04:01:23+08:00	23085	7505	30590	2993	33583	64632	51.96%	35.72%	49	49
8	臺南市仁德區	2018-11-24T22:21:40+08:00	11535	3724	15259	1543	16802	32593	51.55%	35.39%	27	49
8	臺南市仁德區	2018-11-24T23:41:57+08:00	23085	7505	30590	2993	33583	64632	51.96%	35.72%	49	49
8	臺南市仁德區	2018-11-25T01:16:16+08:00	23085	7505	30590	2993	33583	64632	51.96%	35.72%	49	49
8	臺南市仁德區	2018-11-24T22:35:40+08:00	12965	4204	17169	1691	18860	36671	51.43%	35.35%	30	49
8	臺南市仁德區	2018-11-25T03:54:35+08:00	23085	7505	30590	2993	33583	64632	51.96%	35.72%	49	49
8	臺南市仁德區	2018-11-24T23:33:45+08:00	23085	7505	30590	2993	33583	64632	51.96%	35.72%	49	49
8	臺南市仁德區	2018-11-24T23:37:44+08:00	23085	7505	30590	2993	33583	64632	51.96%	35.72%	49	49
8	臺南市仁德區	2018-11-24T23:45:59+08:00	23085	7505	30590	2993	33583	64632	51.96%	35.72%	49	49
8	屏東縣東港鎮	2018-11-24T22:56:36+08:00	13572	4579	18151	2671	20822	39495	52.72%	34.36%	38	38
8	屏東縣東港鎮	2018-11-25T06:17:36+08:00	13572	4579	18151	2671	20822	39495	52.72%	34.36%	38	38
8	屏東縣東港鎮	2018-11-24T23:07:19+08:00	13572	4579	18151	2671	20822	39495	52.72%	34.36%	38	38
8	屏東縣東港鎮	2018-11-24T23:10:56+08:00	13572	4579	18151	2671	20822	39495	52.72%	34.36%	38	38
8	屏東縣東港鎮	2018-11-24T22:39:09+08:00	13572	4579	18151	2671	20822	39495	52.72%	34.36%	38	38
8	屏東縣東港鎮	2018-11-25T01:24:25+08:00	13572	4579	18151	2671	20822	39495	52.72%	34.36%	38	38
8	屏東縣東港鎮	2018-11-25T03:54:41+08:00	13572	4579	18151	2671	20822	39495	52.72%	34.36%	38	38
8	屏東縣東港鎮	2018-11-25T03:30:59+08:00	13572	4579	18151	2671	20822	39495	52.72%	34.36%	38	38
8	屏東縣東港鎮	2018-11-24T22:32:19+08:00	13572	4579	18151	2671	20822	39495	52.72%	34.36%	38	38
8	屏東縣東港鎮	2018-11-25T01:06:00+08:00	13572	4579	18151	2671	20822	39495	52.72%	34.36%	38	38
8	屏東縣東港鎮	2018-11-24T23:00:17+08:00	13572	4579	18151	2671	20822	39495	52.72%	34.36%	38	38
8	屏東縣東港鎮	2018-11-25T00:21:44+08:00	13572	4579	18151	2671	20822	39495	52.72%	34.36%	38	38
8	屏東縣東港鎮	2018-11-25T01:11:08+08:00	13572	4579	18151	2671	20822	39495	52.72%	34.36%	38	38
8	屏東縣東港鎮	2018-11-25T06:07:23+08:00	13572	4579	18151	2671	20822	39495	52.72%	34.36%	38	38
8	屏東縣東港鎮	2018-11-24T22:40:19+08:00	13572	4579	18151	2671	20822	39495	52.72%	34.36%	38	38
8	屏東縣東港鎮	2018-11-24T23:29:47+08:00	13572	4579	18151	2671	20822	39495	52.72%	34.36%	38	38
8	屏東縣東港鎮	2018-11-24T22:43:50+08:00	13572	4579	18151	2671	20822	39495	52.72%	34.36%	38	38
8	屏東縣東港鎮	2018-11-25T00:03:35+08:00	13572	4579	18151	2671	20822	39495	52.72%	34.36%	38	38
8	屏東縣東港鎮	2018-11-25T00:56:14+08:00	13572	4579	18151	2671	20822	39495	52.72%	34.36%	38	38
8	屏東縣東港鎮	2018-11-24T23:54:27+08:00	13572	4579	18151	2671	20822	39495	52.72%	34.36%	38	38
8	屏東縣東港鎮	2018-11-24T22:35:45+08:00	13572	4579	18151	2671	20822	39495	52.72%	34.36%	38	38
8	屏東縣東港鎮	2018-11-25T01:16:22+08:00	13572	4579	18151	2671	20822	39495	52.72%	34.36%	38	38
8	屏東縣東港鎮	2018-11-24T23:37:49+08:00	13572	4579	18151	2671	20822	39495	52.72%	34.36%	38	38
8	屏東縣東港鎮	2018-11-24T23:22:23+08:00	13572	4579	18151	2671	20822	39495	52.72%	34.36%	38	38
8	屏東縣東港鎮	2018-11-24T22:49:24+08:00	13572	4579	18151	2671	20822	39495	52.72%	34.36%	38	38
8	屏東縣東港鎮	2018-11-24T22:12:03+08:00	11522	3889	15411	2181	17592	33419	52.64%	34.48%	33	38
8	屏東縣東港鎮	2018-11-24T23:03:47+08:00	13572	4579	18151	2671	20822	39495	52.72%	34.36%	38	38
8	屏東縣東港鎮	2018-11-24T22:28:40+08:00	13189	4432	17621	2580	20201	38401	52.61%	34.35%	37	38
8	屏東縣東港鎮	2018-11-24T23:33:50+08:00	13572	4579	18151	2671	20822	39495	52.72%	34.36%	38	38
8	屏東縣東港鎮	2018-11-25T04:01:30+08:00	13572	4579	18151	2671	20822	39495	52.72%	34.36%	38	38
8	屏東縣東港鎮	2018-11-25T03:42:49+08:00	13572	4579	18151	2671	20822	39495	52.72%	34.36%	38	38
8	屏東縣東港鎮	2018-11-24T23:42:02+08:00	13572	4579	18151	2671	20822	39495	52.72%	34.36%	38	38
8	屏東縣東港鎮	2018-11-25T00:08:05+08:00	13572	4579	18151	2671	20822	39495	52.72%	34.36%	38	38
8	屏東縣東港鎮	2018-11-24T22:53:15+08:00	13572	4579	18151	2671	20822	39495	52.72%	34.36%	38	38
8	屏東縣東港鎮	2018-11-24T23:46:04+08:00	13572	4579	18151	2671	20822	39495	52.72%	34.36%	38	38
8	屏東縣東港鎮	2018-11-25T06:12:37+08:00	13572	4579	18151	2671	20822	39495	52.72%	34.36%	38	38
8	屏東縣東港鎮	2018-11-24T22:21:46+08:00	12826	4298	17124	2528	19652	37047	53.05%	34.62%	36	38
8	屏東縣東港鎮	2018-11-24T22:25:25+08:00	13189	4432	17621	2580	20201	38401	52.61%	34.35%	37	38
8	屏東縣東港鎮	2018-11-25T00:17:08+08:00	13572	4579	18151	2671	20822	39495	52.72%	34.36%	38	38
8	屏東縣東港鎮	2018-11-25T06:22:45+08:00	13572	4579	18151	2671	20822	39495	52.72%	34.36%	38	38
8	屏東縣東港鎮	2018-11-25T03:48:31+08:00	13572	4579	18151	2671	20822	39495	52.72%	34.36%	38	38
8	屏東縣東港鎮	2018-11-24T22:14:49+08:00	11522	3889	15411	2181	17592	33419	52.64%	34.48%	33	38
8	屏東縣東港鎮	2018-11-24T22:18:20+08:00	11941	4020	15961	2311	18272	34623	52.77%	34.49%	34	38
8	屏東縣東港鎮	2018-11-25T03:37:30+08:00	13572	4579	18151	2671	20822	39495	52.72%	34.36%	38	38
8	屏東縣東港鎮	2018-11-24T23:58:43+08:00	13572	4579	18151	2671	20822	39495	52.72%	34.36%	38	38
8	屏東縣東港鎮	2018-11-25T06:27:55+08:00	13572	4579	18151	2671	20822	39495	52.72%	34.36%	38	38
8	屏東縣東港鎮	2018-11-24T23:26:07+08:00	13572	4579	18151	2671	20822	39495	52.72%	34.36%	38	38
8	屏東縣東港鎮	2018-11-25T00:12:45+08:00	13572	4579	18151	2671	20822	39495	52.72%	34.36%	38	38
8	屏東縣東港鎮	2018-11-25T01:01:02+08:00	13572	4579	18151	2671	20822	39495	52.72%	34.36%	38	38
8	屏東縣東港鎮	2018-11-24T23:18:28+08:00	13572	4579	18151	2671	20822	39495	52.72%	34.36%	38	38
8	屏東縣東港鎮	2018-11-24T23:14:41+08:00	13572	4579	18151	2671	20822	39495	52.72%	34.36%	38	38
8	屏東縣東港鎮	2018-11-24T23:50:15+08:00	13572	4579	18151	2671	20822	39495	52.72%	34.36%	38	38
8	臺南市中西區	2018-11-25T00:56:08+08:00	23255	9332	32587	3058	35645	65261	54.62%	35.63%	52	52
8	臺南市中西區	2018-11-24T23:03:43+08:00	17160	6971	24131	2309	26440	48340	54.7%	35.5%	40	52
8	臺南市中西區	2018-11-24T23:58:37+08:00	22842	9168	32010	3000	35010	64097	54.62%	35.64%	51	52
8	臺南市中西區	2018-11-25T06:17:31+08:00	23255	9332	32587	3058	35645	65261	54.62%	35.63%	52	52
8	臺南市中西區	2018-11-24T23:22:18+08:00	19701	7993	27694	2603	30297	55326	54.76%	35.61%	45	52
8	臺南市中西區	2018-11-24T22:43:45+08:00	14748	6042	20790	2045	22835	41932	54.46%	35.17%	35	52
8	臺南市中西區	2018-11-24T23:14:35+08:00	18212	7367	25579	2443	28022	51096	54.84%	35.64%	42	52
8	臺南市中西區	2018-11-25T03:37:20+08:00	23255	9332	32587	3058	35645	65261	54.62%	35.63%	52	52
8	臺南市中西區	2018-11-24T22:49:19+08:00	16119	6552	22671	2199	24870	45534	54.62%	35.4%	38	52
8	臺南市中西區	2018-11-25T00:03:28+08:00	22842	9168	32010	3000	35010	64097	54.62%	35.64%	51	52
8	臺南市中西區	2018-11-25T03:42:43+08:00	23255	9332	32587	3058	35645	65261	54.62%	35.63%	52	52
8	臺南市中西區	2018-11-25T01:00:56+08:00	23255	9332	32587	3058	35645	65261	54.62%	35.63%	52	52
8	臺南市中西區	2018-11-24T22:25:19+08:00	12263	5081	17344	1681	19025	35190	54.06%	34.85%	29	52
8	臺南市中西區	2018-11-25T00:17:03+08:00	22842	9168	32010	3000	35010	64097	54.62%	35.64%	51	52
8	臺南市中西區	2018-11-25T01:11:01+08:00	23255	9332	32587	3058	35645	65261	54.62%	35.63%	52	52
8	臺南市中西區	2018-11-25T06:22:41+08:00	23255	9332	32587	3058	35645	65261	54.62%	35.63%	52	52
8	臺南市中西區	2018-11-25T06:12:32+08:00	23255	9332	32587	3058	35645	65261	54.62%	35.63%	52	52
8	臺南市中西區	2018-11-24T23:50:10+08:00	22279	8943	31222	2925	34147	62502	54.63%	35.65%	50	52
8	臺南市中西區	2018-11-24T22:18:15+08:00	11411	4717	16128	1562	17690	32318	54.74%	35.31%	27	52
8	臺南市中西區	2018-11-25T00:12:40+08:00	22842	9168	32010	3000	35010	64097	54.62%	35.64%	51	52
8	臺南市中西區	2018-11-24T22:28:35+08:00	12685	5260	17945	1753	19698	36391	54.13%	34.86%	30	52
8	臺南市中西區	2018-11-24T23:26:02+08:00	19701	7993	27694	2603	30297	55326	54.76%	35.61%	45	52
8	臺南市中西區	2018-11-24T23:54:20+08:00	22279	8943	31222	2925	34147	62502	54.63%	35.65%	50	52
8	臺南市中西區	2018-11-24T22:14:44+08:00	11003	4536	15539	1484	17023	31042	54.84%	35.45%	26	52
8	臺南市中西區	2018-11-25T06:27:50+08:00	23255	9332	32587	3058	35645	65261	54.62%	35.63%	52	52
8	臺南市中西區	2018-11-25T00:07:59+08:00	22842	9168	32010	3000	35010	64097	54.62%	35.64%	51	52
8	臺南市中西區	2018-11-24T23:18:22+08:00	18806	7625	26431	2500	28931	52756	54.84%	35.65%	43	52
8	臺南市中西區	2018-11-25T01:05:53+08:00	23255	9332	32587	3058	35645	65261	54.62%	35.63%	52	52
8	臺南市中西區	2018-11-24T22:56:32+08:00	16712	6777	23489	2263	25752	47117	54.66%	35.47%	39	52
8	臺南市中西區	2018-11-25T01:24:19+08:00	23255	9332	32587	3058	35645	65261	54.62%	35.63%	52	52
8	臺南市中西區	2018-11-24T22:39:04+08:00	13463	5588	19051	1889	20940	38616	54.23%	34.86%	32	52
8	臺南市中西區	2018-11-24T23:10:52+08:00	18212	7367	25579	2443	28022	51096	54.84%	35.64%	42	52
8	臺南市中西區	2018-11-24T23:07:14+08:00	18212	7367	25579	2443	28022	51096	54.84%	35.64%	42	52
8	臺南市中西區	2018-11-25T00:21:39+08:00	22842	9168	32010	3000	35010	64097	54.62%	35.64%	51	52
8	臺南市中西區	2018-11-24T22:32:14+08:00	12685	5260	17945	1753	19698	36391	54.13%	34.86%	30	52
8	臺南市中西區	2018-11-25T03:30:53+08:00	23255	9332	32587	3058	35645	65261	54.62%	35.63%	52	52
8	臺南市中西區	2018-11-25T03:48:24+08:00	23255	9332	32587	3058	35645	65261	54.62%	35.63%	52	52
8	臺南市中西區	2018-11-24T23:29:42+08:00	19701	7993	27694	2603	30297	55326	54.76%	35.61%	45	52
8	臺南市中西區	2018-11-24T23:00:13+08:00	17160	6971	24131	2309	26440	48340	54.7%	35.5%	40	52
8	臺南市中西區	2018-11-24T22:21:41+08:00	12263	5081	17344	1681	19025	35190	54.06%	34.85%	29	52
8	臺南市中西區	2018-11-24T22:53:09+08:00	16712	6777	23489	2263	25752	47117	54.66%	35.47%	39	52
8	臺南市中西區	2018-11-24T22:40:14+08:00	13943	5758	19701	1926	21627	39828	54.3%	35.01%	33	52
8	臺南市中西區	2018-11-25T06:07:18+08:00	23255	9332	32587	3058	35645	65261	54.62%	35.63%	52	52
8	臺南市中西區	2018-11-24T22:11:58+08:00	10128	4204	14332	1340	15672	28691	54.62%	35.3%	24	52
8	臺南市中西區	2018-11-25T04:01:24+08:00	23255	9332	32587	3058	35645	65261	54.62%	35.63%	52	52
8	臺南市中西區	2018-11-24T23:41:57+08:00	22279	8943	31222	2925	34147	62502	54.63%	35.65%	50	52
8	臺南市中西區	2018-11-24T22:35:40+08:00	12685	5260	17945	1753	19698	36391	54.13%	34.86%	30	52
8	臺南市中西區	2018-11-25T03:54:35+08:00	23255	9332	32587	3058	35645	65261	54.62%	35.63%	52	52
8	臺南市中西區	2018-11-24T23:33:45+08:00	21339	8591	29930	2788	32718	59503	54.99%	35.86%	48	52
8	臺南市中西區	2018-11-24T23:37:44+08:00	21935	8808	30743	2861	33604	61248	54.87%	35.81%	49	52
8	臺南市中西區	2018-11-24T23:45:59+08:00	22279	8943	31222	2925	34147	62502	54.63%	35.65%	50	52
8	臺南市中西區	2018-11-25T01:16:17+08:00	23255	9332	32587	3058	35645	65261	54.62%	35.63%	52	52
8	屏東縣內埔鄉	2018-11-24T23:10:57+08:00	12666	4227	16893	1823	18716	40719	45.96%	31.11%	35	40
8	屏東縣內埔鄉	2018-11-24T23:07:19+08:00	12666	4227	16893	1823	18716	40719	45.96%	31.11%	35	40
8	屏東縣內埔鄉	2018-11-24T22:39:09+08:00	11442	3840	15282	1720	17002	36798	46.2%	31.09%	32	40
8	屏東縣內埔鄉	2018-11-25T06:17:37+08:00	14890	4816	19706	2111	21817	47558	45.87%	31.31%	40	40
8	屏東縣內埔鄉	2018-11-25T01:24:25+08:00	14890	4816	19706	2111	21817	47558	45.87%	31.31%	40	40
8	屏東縣內埔鄉	2018-11-24T22:56:37+08:00	12666	4227	16893	1823	18716	40719	45.96%	31.11%	35	40
8	屏東縣內埔鄉	2018-11-25T03:54:41+08:00	14890	4816	19706	2111	21817	47558	45.87%	31.31%	40	40
8	屏東縣內埔鄉	2018-11-24T22:32:19+08:00	10566	3510	14076	1623	15699	33668	46.63%	31.38%	30	40
8	屏東縣內埔鄉	2018-11-24T22:53:16+08:00	12165	4086	16251	1769	18020	39471	45.65%	30.82%	34	40
8	屏東縣內埔鄉	2018-11-25T01:06:00+08:00	14890	4816	19706	2111	21817	47558	45.87%	31.31%	40	40
8	屏東縣內埔鄉	2018-11-24T22:25:26+08:00	10197	3397	13594	1582	15176	32438	46.78%	31.44%	29	40
8	屏東縣內埔鄉	2018-11-24T23:00:17+08:00	12666	4227	16893	1823	18716	40719	45.96%	31.11%	35	40
8	屏東縣內埔鄉	2018-11-25T01:11:08+08:00	14890	4816	19706	2111	21817	47558	45.87%	31.31%	40	40
8	屏東縣內埔鄉	2018-11-25T06:07:23+08:00	14890	4816	19706	2111	21817	47558	45.87%	31.31%	40	40
8	屏東縣內埔鄉	2018-11-24T22:40:19+08:00	11442	3840	15282	1720	17002	36798	46.2%	31.09%	32	40
8	屏東縣內埔鄉	2018-11-24T23:29:47+08:00	13081	4284	17365	1892	19257	41997	45.85%	31.15%	36	40
8	屏東縣內埔鄉	2018-11-25T00:21:45+08:00	14055	4561	18616	1995	20611	44835	45.97%	31.35%	38	40
8	屏東縣內埔鄉	2018-11-25T03:31:00+08:00	14890	4816	19706	2111	21817	47558	45.87%	31.31%	40	40
8	屏東縣內埔鄉	2018-11-25T01:16:23+08:00	14890	4816	19706	2111	21817	47558	45.87%	31.31%	40	40
8	屏東縣內埔鄉	2018-11-25T00:03:35+08:00	14055	4561	18616	1995	20611	44835	45.97%	31.35%	38	40
8	屏東縣內埔鄉	2018-11-25T00:56:14+08:00	14392	4661	19053	2027	21080	46039	45.79%	31.26%	39	40
8	屏東縣內埔鄉	2018-11-24T22:35:45+08:00	11077	3699	14776	1684	16460	35273	46.66%	31.4%	31	40
8	屏東縣內埔鄉	2018-11-24T23:37:49+08:00	13521	4395	17916	1927	19843	43350	45.77%	31.19%	37	40
8	屏東縣內埔鄉	2018-11-24T22:43:51+08:00	12165	4086	16251	1769	18020	39471	45.65%	30.82%	34	40
8	屏東縣內埔鄉	2018-11-25T06:27:56+08:00	14890	4816	19706	2111	21817	47558	45.87%	31.31%	40	40
8	屏東縣內埔鄉	2018-11-24T23:54:28+08:00	14055	4561	18616	1995	20611	44835	45.97%	31.35%	38	40
8	屏東縣內埔鄉	2018-11-24T23:22:24+08:00	13081	4284	17365	1892	19257	41997	45.85%	31.15%	36	40
8	屏東縣內埔鄉	2018-11-24T22:28:41+08:00	10566	3510	14076	1623	15699	33668	46.63%	31.38%	30	40
8	屏東縣內埔鄉	2018-11-24T22:12:03+08:00	9276	3143	12419	1500	13919	29653	46.94%	31.28%	27	40
8	屏東縣內埔鄉	2018-11-24T23:33:51+08:00	13081	4284	17365	1892	19257	41997	45.85%	31.15%	36	40
8	屏東縣內埔鄉	2018-11-24T23:03:48+08:00	12666	4227	16893	1823	18716	40719	45.96%	31.11%	35	40
8	屏東縣內埔鄉	2018-11-24T22:49:25+08:00	12165	4086	16251	1769	18020	39471	45.65%	30.82%	34	40
8	屏東縣內埔鄉	2018-11-25T04:01:30+08:00	14890	4816	19706	2111	21817	47558	45.87%	31.31%	40	40
8	屏東縣內埔鄉	2018-11-25T03:42:49+08:00	14890	4816	19706	2111	21817	47558	45.87%	31.31%	40	40
8	屏東縣內埔鄉	2018-11-24T23:42:02+08:00	13521	4395	17916	1927	19843	43350	45.77%	31.19%	37	40
8	屏東縣內埔鄉	2018-11-25T00:08:05+08:00	14055	4561	18616	1995	20611	44835	45.97%	31.35%	38	40
8	屏東縣內埔鄉	2018-11-24T23:46:04+08:00	14055	4561	18616	1995	20611	44835	45.97%	31.35%	38	40
8	屏東縣內埔鄉	2018-11-25T00:17:09+08:00	14055	4561	18616	1995	20611	44835	45.97%	31.35%	38	40
8	屏東縣內埔鄉	2018-11-25T06:12:37+08:00	14890	4816	19706	2111	21817	47558	45.87%	31.31%	40	40
8	屏東縣內埔鄉	2018-11-25T06:22:45+08:00	14890	4816	19706	2111	21817	47558	45.87%	31.31%	40	40
8	屏東縣內埔鄉	2018-11-24T22:21:47+08:00	10197	3397	13594	1582	15176	32438	46.78%	31.44%	29	40
8	屏東縣內埔鄉	2018-11-25T03:48:31+08:00	14890	4816	19706	2111	21817	47558	45.87%	31.31%	40	40
8	屏東縣內埔鄉	2018-11-24T22:14:49+08:00	9276	3143	12419	1500	13919	29653	46.94%	31.28%	27	40
8	屏東縣內埔鄉	2018-11-24T22:18:20+08:00	9844	3288	13132	1556	14688	31222	47.04%	31.53%	28	40
8	屏東縣內埔鄉	2018-11-25T03:37:30+08:00	14890	4816	19706	2111	21817	47558	45.87%	31.31%	40	40
8	屏東縣內埔鄉	2018-11-24T23:58:43+08:00	14055	4561	18616	1995	20611	44835	45.97%	31.35%	38	40
8	屏東縣內埔鄉	2018-11-24T23:26:07+08:00	13081	4284	17365	1892	19257	41997	45.85%	31.15%	36	40
8	屏東縣內埔鄉	2018-11-25T00:12:45+08:00	14055	4561	18616	1995	20611	44835	45.97%	31.35%	38	40
8	屏東縣內埔鄉	2018-11-25T01:01:02+08:00	14890	4816	19706	2111	21817	47558	45.87%	31.31%	40	40
8	屏東縣內埔鄉	2018-11-24T23:18:28+08:00	12666	4227	16893	1823	18716	40719	45.96%	31.11%	35	40
8	屏東縣內埔鄉	2018-11-24T23:14:41+08:00	12666	4227	16893	1823	18716	40719	45.96%	31.11%	35	40
8	屏東縣內埔鄉	2018-11-24T23:50:15+08:00	14055	4561	18616	1995	20611	44835	45.97%	31.35%	38	40
8	桃園市新屋區	2018-11-25T03:37:17+08:00	16095	5142	21237	1573	22810	41461	55.02%	38.82%	30	30
8	桃園市新屋區	2018-11-24T23:10:50+08:00	14637	4678	19315	1445	20760	37573	55.25%	38.96%	28	30
8	桃園市新屋區	2018-11-24T23:22:16+08:00	14637	4678	19315	1445	20760	37573	55.25%	38.96%	28	30
8	桃園市新屋區	2018-11-25T01:10:58+08:00	16095	5142	21237	1573	22810	41461	55.02%	38.82%	30	30
8	桃園市新屋區	2018-11-25T00:12:37+08:00	16095	5142	21237	1573	22810	41461	55.02%	38.82%	30	30
8	桃園市新屋區	2018-11-24T22:49:17+08:00	14637	4678	19315	1445	20760	37573	55.25%	38.96%	28	30
8	桃園市新屋區	2018-11-24T23:14:32+08:00	14637	4678	19315	1445	20760	37573	55.25%	38.96%	28	30
8	桃園市新屋區	2018-11-24T22:43:43+08:00	14637	4678	19315	1445	20760	37573	55.25%	38.96%	28	30
8	桃園市新屋區	2018-11-24T22:56:30+08:00	14637	4678	19315	1445	20760	37573	55.25%	38.96%	28	30
8	桃園市新屋區	2018-11-25T06:22:37+08:00	16095	5142	21237	1573	22810	41461	55.02%	38.82%	30	30
8	桃園市新屋區	2018-11-25T03:48:21+08:00	16095	5142	21237	1573	22810	41461	55.02%	38.82%	30	30
8	桃園市新屋區	2018-11-25T03:30:51+08:00	16095	5142	21237	1573	22810	41461	55.02%	38.82%	30	30
8	桃園市新屋區	2018-11-24T22:32:11+08:00	12366	4057	16423	1241	17664	32117	55%	38.5%	25	30
8	桃園市新屋區	2018-11-25T04:01:21+08:00	16095	5142	21237	1573	22810	41461	55.02%	38.82%	30	30
8	桃園市新屋區	2018-11-24T22:25:17+08:00	12366	4057	16423	1241	17664	32117	55%	38.5%	25	30
8	桃園市新屋區	2018-11-25T06:07:15+08:00	16095	5142	21237	1573	22810	41461	55.02%	38.82%	30	30
8	桃園市新屋區	2018-11-24T23:29:40+08:00	14637	4678	19315	1445	20760	37573	55.25%	38.96%	28	30
8	桃園市新屋區	2018-11-24T22:18:12+08:00	11829	3864	15693	1190	16883	30846	54.73%	38.35%	24	30
8	桃園市新屋區	2018-11-24T23:54:18+08:00	16095	5142	21237	1573	22810	41461	55.02%	38.82%	30	30
8	桃園市新屋區	2018-11-25T00:07:57+08:00	16095	5142	21237	1573	22810	41461	55.02%	38.82%	30	30
8	桃園市新屋區	2018-11-25T01:16:14+08:00	16095	5142	21237	1573	22810	41461	55.02%	38.82%	30	30
8	桃園市新屋區	2018-11-24T23:41:55+08:00	16095	5142	21237	1573	22810	41461	55.02%	38.82%	30	30
8	桃園市新屋區	2018-11-24T22:28:33+08:00	12366	4057	16423	1241	17664	32117	55%	38.5%	25	30
8	桃園市新屋區	2018-11-24T23:58:34+08:00	16095	5142	21237	1573	22810	41461	55.02%	38.82%	30	30
8	桃園市新屋區	2018-11-25T01:24:16+08:00	16095	5142	21237	1573	22810	41461	55.02%	38.82%	30	30
8	桃園市新屋區	2018-11-24T22:35:38+08:00	12366	4057	16423	1241	17664	32117	55%	38.5%	25	30
8	桃園市新屋區	2018-11-24T23:07:12+08:00	14637	4678	19315	1445	20760	37573	55.25%	38.96%	28	30
8	桃園市新屋區	2018-11-24T22:39:02+08:00	13247	4304	17551	1313	18864	34212	55.14%	38.72%	26	30
8	桃園市新屋區	2018-11-25T00:56:05+08:00	16095	5142	21237	1573	22810	41461	55.02%	38.82%	30	30
8	桃園市新屋區	2018-11-25T06:27:48+08:00	16095	5142	21237	1573	22810	41461	55.02%	38.82%	30	30
8	桃園市新屋區	2018-11-24T23:50:07+08:00	16095	5142	21237	1573	22810	41461	55.02%	38.82%	30	30
8	桃園市新屋區	2018-11-25T00:03:25+08:00	16095	5142	21237	1573	22810	41461	55.02%	38.82%	30	30
8	桃園市新屋區	2018-11-24T23:03:41+08:00	14637	4678	19315	1445	20760	37573	55.25%	38.96%	28	30
8	桃園市新屋區	2018-11-24T23:00:06+08:00	14637	4678	19315	1445	20760	37573	55.25%	38.96%	28	30
8	桃園市新屋區	2018-11-24T22:21:38+08:00	12366	4057	16423	1241	17664	32117	55%	38.5%	25	30
8	桃園市新屋區	2018-11-25T03:42:40+08:00	16095	5142	21237	1573	22810	41461	55.02%	38.82%	30	30
8	桃園市新屋區	2018-11-25T00:21:36+08:00	16095	5142	21237	1573	22810	41461	55.02%	38.82%	30	30
8	桃園市新屋區	2018-11-25T01:00:52+08:00	16095	5142	21237	1573	22810	41461	55.02%	38.82%	30	30
8	桃園市新屋區	2018-11-25T06:12:30+08:00	16095	5142	21237	1573	22810	41461	55.02%	38.82%	30	30
8	桃園市新屋區	2018-11-24T22:40:12+08:00	13825	4454	18279	1403	19682	35581	55.32%	38.86%	27	30
8	桃園市新屋區	2018-11-25T00:17:01+08:00	16095	5142	21237	1573	22810	41461	55.02%	38.82%	30	30
8	桃園市新屋區	2018-11-24T22:53:07+08:00	14637	4678	19315	1445	20760	37573	55.25%	38.96%	28	30
8	桃園市新屋區	2018-11-24T22:11:56+08:00	11829	3864	15693	1190	16883	30846	54.73%	38.35%	24	30
8	桃園市新屋區	2018-11-25T03:54:33+08:00	16095	5142	21237	1573	22810	41461	55.02%	38.82%	30	30
8	桃園市新屋區	2018-11-25T01:05:51+08:00	16095	5142	21237	1573	22810	41461	55.02%	38.82%	30	30
8	桃園市新屋區	2018-11-24T23:33:43+08:00	16095	5142	21237	1573	22810	41461	55.02%	38.82%	30	30
8	桃園市新屋區	2018-11-24T23:18:20+08:00	14637	4678	19315	1445	20760	37573	55.25%	38.96%	28	30
8	桃園市新屋區	2018-11-24T23:37:42+08:00	16095	5142	21237	1573	22810	41461	55.02%	38.82%	30	30
8	桃園市新屋區	2018-11-24T22:14:41+08:00	11829	3864	15693	1190	16883	30846	54.73%	38.35%	24	30
8	桃園市新屋區	2018-11-24T23:26:00+08:00	14637	4678	19315	1445	20760	37573	55.25%	38.96%	28	30
8	桃園市新屋區	2018-11-25T06:17:28+08:00	16095	5142	21237	1573	22810	41461	55.02%	38.82%	30	30
8	桃園市新屋區	2018-11-24T23:45:57+08:00	16095	5142	21237	1573	22810	41461	55.02%	38.82%	30	30
8	桃園市桃園區	2018-11-25T03:37:17+08:00	130494	39403	169897	10996	180893	359790	50.28%	36.27%	216	216
8	桃園市桃園區	2018-11-24T22:49:16+08:00	47306	14280	61586	4156	65742	128678	51.09%	36.76%	85	216
8	桃園市桃園區	2018-11-24T22:39:01+08:00	39971	12065	52036	3563	55599	108869	51.07%	36.71%	73	216
8	桃園市桃園區	2018-11-25T01:10:58+08:00	124405	37663	162068	10527	172595	342700	50.36%	36.3%	207	216
8	桃園市桃園區	2018-11-24T22:43:42+08:00	43681	13134	56815	3863	60678	118933	51.02%	36.73%	79	216
8	桃園市桃園區	2018-11-25T00:12:37+08:00	99321	30285	129606	8492	138098	274135	50.38%	36.23%	169	216
8	桃園市桃園區	2018-11-25T01:24:15+08:00	127104	38439	165543	10748	176291	350187	50.34%	36.3%	211	216
8	桃園市桃園區	2018-11-24T23:14:32+08:00	59965	18139	78104	5171	83275	163918	50.8%	36.58%	106	216
8	桃園市桃園區	2018-11-24T22:56:30+08:00	51481	15613	67094	4506	71600	140587	50.93%	36.62%	92	216
8	桃園市桃園區	2018-11-25T06:22:37+08:00	130494	39403	169897	10996	180893	359790	50.28%	36.27%	216	216
8	桃園市桃園區	2018-11-25T03:30:50+08:00	130494	39403	169897	10996	180893	359790	50.28%	36.27%	216	216
8	桃園市桃園區	2018-11-24T23:00:05+08:00	52950	15989	68939	4585	73524	144099	51.02%	36.75%	94	216
8	桃園市桃園區	2018-11-25T03:48:21+08:00	130494	39403	169897	10996	180893	359790	50.28%	36.27%	216	216
8	桃園市桃園區	2018-11-24T22:32:11+08:00	38241	11612	49853	3448	53301	104389	51.06%	36.63%	70	216
8	桃園市桃園區	2018-11-24T23:29:39+08:00	70195	21432	91627	6076	97703	192628	50.72%	36.44%	122	216
8	桃園市桃園區	2018-11-25T04:01:21+08:00	130494	39403	169897	10996	180893	359790	50.28%	36.27%	216	216
8	桃園市桃園區	2018-11-24T22:25:16+08:00	35889	10952	46841	3245	50086	98139	51.04%	36.57%	66	216
8	桃園市桃園區	2018-11-25T06:07:15+08:00	130494	39403	169897	10996	180893	359790	50.28%	36.27%	216	216
8	桃園市桃園區	2018-11-25T00:07:56+08:00	95665	29203	124868	8188	133056	264177	50.37%	36.21%	163	216
8	桃園市桃園區	2018-11-24T22:28:32+08:00	37137	11293	48430	3348	51778	101447	51.04%	36.61%	68	216
8	桃園市桃園區	2018-11-24T22:18:12+08:00	33062	10073	43135	2944	46079	90684	50.81%	36.46%	61	216
8	桃園市桃園區	2018-11-25T01:16:14+08:00	125782	38043	163825	10661	174486	346456	50.36%	36.31%	209	216
8	桃園市桃園區	2018-11-24T23:54:17+08:00	86706	26512	113218	7470	120688	238962	50.51%	36.28%	149	216
8	桃園市桃園區	2018-11-24T23:41:55+08:00	80983	24683	105666	6961	112627	222279	50.67%	36.43%	139	216
8	桃園市桃園區	2018-11-24T23:22:15+08:00	66821	20210	87031	5729	92760	182391	50.86%	36.64%	116	216
8	桃園市桃園區	2018-11-24T23:58:33+08:00	90894	27745	118639	7836	126475	251059	50.38%	36.2%	156	216
8	桃園市桃園區	2018-11-24T22:35:38+08:00	38728	11749	50477	3481	53958	105697	51.05%	36.64%	71	216
8	桃園市桃園區	2018-11-24T23:07:12+08:00	56879	17213	74092	4920	79012	155026	50.97%	36.69%	101	216
8	桃園市桃園區	2018-11-24T23:03:40+08:00	55121	16700	71821	4739	76560	150089	51.01%	36.73%	98	216
8	桃園市桃園區	2018-11-25T00:56:05+08:00	118284	35777	154061	10065	164126	325911	50.36%	36.29%	198	216
8	桃園市桃園區	2018-11-25T06:27:48+08:00	130494	39403	169897	10996	180893	359790	50.28%	36.27%	216	216
8	桃園市桃園區	2018-11-24T23:50:07+08:00	86012	26308	112320	7412	119732	236907	50.54%	36.31%	148	216
8	桃園市桃園區	2018-11-25T00:03:25+08:00	92398	28202	120600	7930	128530	255014	50.4%	36.23%	158	216
8	桃園市桃園區	2018-11-25T00:21:36+08:00	105223	32006	137229	8970	146199	290422	50.34%	36.23%	178	216
8	桃園市桃園區	2018-11-25T01:00:52+08:00	121618	36854	158472	10349	168821	334898	50.41%	36.31%	203	216
8	桃園市桃園區	2018-11-24T22:21:37+08:00	35365	10760	46125	3177	49302	96786	50.94%	36.54%	65	216
8	桃園市桃園區	2018-11-25T06:12:30+08:00	130494	39403	169897	10996	180893	359790	50.28%	36.27%	216	216
8	桃園市桃園區	2018-11-24T22:53:06+08:00	49076	14830	63906	4313	68219	133886	50.95%	36.66%	88	216
8	桃園市桃園區	2018-11-24T22:40:12+08:00	41947	12674	54621	3734	58355	114332	51.04%	36.69%	76	216
8	桃園市桃園區	2018-11-25T00:17:00+08:00	102792	31188	133980	8749	142729	283460	50.35%	36.26%	174	216
8	桃園市桃園區	2018-11-25T03:42:39+08:00	130494	39403	169897	10996	180893	359790	50.28%	36.27%	216	216
8	桃園市桃園區	2018-11-24T22:11:56+08:00	27078	8231	35309	2385	37694	74801	50.39%	36.2%	51	216
8	桃園市桃園區	2018-11-24T23:33:43+08:00	75598	23137	98735	6549	105284	207511	50.74%	36.43%	131	216
8	桃園市桃園區	2018-11-24T23:45:56+08:00	84922	25977	110899	7327	118226	233909	50.54%	36.31%	146	216
8	桃園市桃園區	2018-11-24T23:18:20+08:00	61864	18709	80573	5327	85900	168875	50.87%	36.63%	109	216
8	桃園市桃園區	2018-11-24T23:37:42+08:00	78932	24104	103036	6776	109812	216848	50.64%	36.4%	136	216
8	桃園市桃園區	2018-11-24T22:14:41+08:00	29539	8972	38511	2626	41137	81630	50.39%	36.19%	55	216
8	桃園市桃園區	2018-11-25T01:05:50+08:00	123043	37280	160323	10458	170781	338745	50.42%	36.32%	205	216
8	桃園市桃園區	2018-11-24T23:26:00+08:00	68618	20789	89407	5887	95294	187556	50.81%	36.59%	119	216
8	桃園市桃園區	2018-11-24T23:10:49+08:00	57982	17530	75512	5012	80524	158492	50.81%	36.58%	103	216
8	桃園市桃園區	2018-11-25T03:54:32+08:00	130494	39403	169897	10996	180893	359790	50.28%	36.27%	216	216
8	桃園市桃園區	2018-11-25T06:17:28+08:00	130494	39403	169897	10996	180893	359790	50.28%	36.27%	216	216
8	臺中市豐原區	2018-11-25T03:37:17+08:00	58195	17585	75780	6078	81858	136658	59.9%	42.58%	88	88
8	臺中市豐原區	2018-11-24T23:10:50+08:00	47420	14474	61894	5021	66915	111828	59.84%	42.4%	74	88
8	臺中市豐原區	2018-11-25T00:56:06+08:00	58195	17585	75780	6078	81858	136658	59.9%	42.58%	88	88
8	臺中市豐原區	2018-11-24T23:22:16+08:00	48928	14898	63826	5234	69060	115563	59.76%	42.34%	76	88
8	臺中市豐原區	2018-11-24T22:49:17+08:00	43039	13337	56376	4603	60979	101655	59.99%	42.34%	68	88
8	臺中市豐原區	2018-11-24T23:14:32+08:00	47420	14474	61894	5021	66915	111828	59.84%	42.4%	74	88
8	臺中市豐原區	2018-11-24T22:43:43+08:00	40120	12587	52707	4293	57000	95077	59.95%	42.2%	64	88
8	臺中市豐原區	2018-11-25T00:03:26+08:00	53476	16303	69779	5711	75490	126088	59.87%	42.41%	82	88
8	臺中市豐原區	2018-11-25T01:10:59+08:00	58195	17585	75780	6078	81858	136658	59.9%	42.58%	88	88
8	臺中市豐原區	2018-11-24T22:56:30+08:00	45267	13882	59149	4797	63946	106720	59.92%	42.42%	71	88
8	臺中市豐原區	2018-11-25T00:12:38+08:00	55893	16876	72769	5848	78617	131250	59.9%	42.59%	85	88
8	臺中市豐原區	2018-11-25T06:22:38+08:00	58195	17585	75780	6078	81858	136658	59.9%	42.58%	88	88
8	臺中市豐原區	2018-11-25T03:30:51+08:00	58195	17585	75780	6078	81858	136658	59.9%	42.58%	88	88
8	臺中市豐原區	2018-11-24T22:25:17+08:00	34064	10746	44810	3699	48509	80845	60%	42.13%	54	88
8	臺中市豐原區	2018-11-25T06:07:15+08:00	58195	17585	75780	6078	81858	136658	59.9%	42.58%	88	88
8	臺中市豐原區	2018-11-24T23:29:40+08:00	48928	14898	63826	5234	69060	115563	59.76%	42.34%	76	88
8	臺中市豐原區	2018-11-24T23:54:18+08:00	52566	16019	68585	5590	74175	123831	59.9%	42.45%	81	88
8	臺中市豐原區	2018-11-25T00:07:57+08:00	55059	16643	71702	5798	77500	129479	59.86%	42.52%	84	88
8	臺中市豐原區	2018-11-25T01:16:14+08:00	58195	17585	75780	6078	81858	136658	59.9%	42.58%	88	88
8	臺中市豐原區	2018-11-24T22:18:13+08:00	31260	9901	41161	3469	44630	74328	60.04%	42.06%	50	88
8	臺中市豐原區	2018-11-24T23:41:55+08:00	50882	15490	66372	5436	71808	119940	59.87%	42.42%	79	88
8	臺中市豐原區	2018-11-24T22:28:33+08:00	35367	11102	46469	3793	50262	84040	59.81%	42.08%	56	88
8	臺中市豐原區	2018-11-24T23:58:34+08:00	52566	16019	68585	5590	74175	123831	59.9%	42.45%	81	88
8	臺中市豐原區	2018-11-24T23:50:08+08:00	50882	15490	66372	5436	71808	119940	59.87%	42.42%	79	88
8	臺中市豐原區	2018-11-25T01:24:16+08:00	58195	17585	75780	6078	81858	136658	59.9%	42.58%	88	88
8	臺中市豐原區	2018-11-24T22:35:38+08:00	38169	11933	50102	4066	54168	90420	59.91%	42.21%	60	88
8	臺中市豐原區	2018-11-24T23:07:12+08:00	46671	14258	60929	4926	65855	110005	59.87%	42.43%	73	88
8	臺中市豐原區	2018-11-24T22:39:02+08:00	38169	11933	50102	4066	54168	90420	59.91%	42.21%	60	88
8	臺中市豐原區	2018-11-25T06:27:48+08:00	58195	17585	75780	6078	81858	136658	59.9%	42.58%	88	88
8	臺中市豐原區	2018-11-24T23:03:41+08:00	45886	14052	59938	4859	64797	108138	59.92%	42.43%	72	88
8	臺中市豐原區	2018-11-25T01:00:53+08:00	58195	17585	75780	6078	81858	136658	59.9%	42.58%	88	88
8	臺中市豐原區	2018-11-25T03:48:22+08:00	58195	17585	75780	6078	81858	136658	59.9%	42.58%	88	88
8	臺中市豐原區	2018-11-25T00:21:37+08:00	56598	17087	73685	5920	79605	132796	59.95%	42.62%	86	88
8	臺中市豐原區	2018-11-24T22:21:38+08:00	32434	10265	42699	3567	46266	76889	60.17%	42.18%	52	88
8	臺中市豐原區	2018-11-25T03:42:40+08:00	58195	17585	75780	6078	81858	136658	59.9%	42.58%	88	88
8	臺中市豐原區	2018-11-24T23:00:07+08:00	45886	14052	59938	4859	64797	108138	59.92%	42.43%	72	88
8	臺中市豐原區	2018-11-24T22:32:12+08:00	35975	11289	47264	3868	51132	85300	59.94%	42.17%	57	88
8	臺中市豐原區	2018-11-25T06:12:30+08:00	58195	17585	75780	6078	81858	136658	59.9%	42.58%	88	88
8	臺中市豐原區	2018-11-25T04:01:22+08:00	58195	17585	75780	6078	81858	136658	59.9%	42.58%	88	88
8	臺中市豐原區	2018-11-25T00:17:01+08:00	55893	16876	72769	5848	78617	131250	59.9%	42.59%	85	88
8	臺中市豐原區	2018-11-24T22:40:13+08:00	39748	12457	52205	4237	56442	94094	59.98%	42.24%	63	88
8	臺中市豐原區	2018-11-24T22:53:07+08:00	44642	13722	58364	4746	63110	105331	59.92%	42.38%	70	88
8	臺中市豐原區	2018-11-24T22:11:56+08:00	30528	9662	40190	3363	43553	72570	60.02%	42.07%	49	88
8	臺中市豐原區	2018-11-25T03:54:33+08:00	58195	17585	75780	6078	81858	136658	59.9%	42.58%	88	88
8	臺中市豐原區	2018-11-25T01:05:51+08:00	58195	17585	75780	6078	81858	136658	59.9%	42.58%	88	88
8	臺中市豐原區	2018-11-24T23:26:01+08:00	48928	14898	63826	5234	69060	115563	59.76%	42.34%	76	88
8	臺中市豐原區	2018-11-24T23:33:43+08:00	48928	14898	63826	5234	69060	115563	59.76%	42.34%	76	88
8	臺中市豐原區	2018-11-24T23:18:20+08:00	48110	14693	62803	5116	67919	113549	59.81%	42.37%	75	88
8	臺中市豐原區	2018-11-25T06:17:29+08:00	58195	17585	75780	6078	81858	136658	59.9%	42.58%	88	88
8	臺中市豐原區	2018-11-24T23:37:42+08:00	50268	15298	65566	5358	70924	118534	59.83%	42.41%	78	88
8	臺中市豐原區	2018-11-24T22:14:41+08:00	30528	9662	40190	3363	43553	72570	60.02%	42.07%	49	88
8	臺中市豐原區	2018-11-24T23:45:57+08:00	50882	15490	66372	5436	71808	119940	59.87%	42.42%	79	88
8	臺中市新社區	2018-11-24T23:10:50+08:00	7705	2101	9806	956	10762	20860	51.59%	36.94%	23	23
8	臺中市新社區	2018-11-25T00:56:06+08:00	7705	2101	9806	956	10762	20860	51.59%	36.94%	23	23
8	臺中市新社區	2018-11-24T23:14:33+08:00	7705	2101	9806	956	10762	20860	51.59%	36.94%	23	23
8	臺中市新社區	2018-11-24T23:22:16+08:00	7705	2101	9806	956	10762	20860	51.59%	36.94%	23	23
8	臺中市新社區	2018-11-24T22:56:31+08:00	7705	2101	9806	956	10762	20860	51.59%	36.94%	23	23
8	臺中市新社區	2018-11-25T00:12:39+08:00	7705	2101	9806	956	10762	20860	51.59%	36.94%	23	23
8	臺中市新社區	2018-11-24T22:49:17+08:00	7705	2101	9806	956	10762	20860	51.59%	36.94%	23	23
8	臺中市新社區	2018-11-25T03:37:18+08:00	7705	2101	9806	956	10762	20860	51.59%	36.94%	23	23
8	臺中市新社區	2018-11-24T22:43:44+08:00	7705	2101	9806	956	10762	20860	51.59%	36.94%	23	23
8	臺中市新社區	2018-11-25T00:03:26+08:00	7705	2101	9806	956	10762	20860	51.59%	36.94%	23	23
8	臺中市新社區	2018-11-25T01:10:59+08:00	7705	2101	9806	956	10762	20860	51.59%	36.94%	23	23
8	臺中市新社區	2018-11-25T06:22:39+08:00	7705	2101	9806	956	10762	20860	51.59%	36.94%	23	23
8	臺中市新社區	2018-11-25T03:30:51+08:00	7705	2101	9806	956	10762	20860	51.59%	36.94%	23	23
8	臺中市新社區	2018-11-24T22:25:17+08:00	7705	2101	9806	956	10762	20860	51.59%	36.94%	23	23
8	臺中市新社區	2018-11-24T23:29:40+08:00	7705	2101	9806	956	10762	20860	51.59%	36.94%	23	23
8	臺中市新社區	2018-11-25T01:16:15+08:00	7705	2101	9806	956	10762	20860	51.59%	36.94%	23	23
8	臺中市新社區	2018-11-25T01:05:52+08:00	7705	2101	9806	956	10762	20860	51.59%	36.94%	23	23
8	臺中市新社區	2018-11-24T23:54:18+08:00	7705	2101	9806	956	10762	20860	51.59%	36.94%	23	23
8	臺中市新社區	2018-11-25T00:07:57+08:00	7705	2101	9806	956	10762	20860	51.59%	36.94%	23	23
8	臺中市新社區	2018-11-24T22:14:42+08:00	7705	2101	9806	956	10762	20860	51.59%	36.94%	23	23
8	臺中市新社區	2018-11-24T22:28:34+08:00	7705	2101	9806	956	10762	20860	51.59%	36.94%	23	23
8	臺中市新社區	2018-11-24T22:18:13+08:00	7705	2101	9806	956	10762	20860	51.59%	36.94%	23	23
8	臺中市新社區	2018-11-24T23:50:08+08:00	7705	2101	9806	956	10762	20860	51.59%	36.94%	23	23
8	臺中市新社區	2018-11-24T23:07:12+08:00	7705	2101	9806	956	10762	20860	51.59%	36.94%	23	23
8	臺中市新社區	2018-11-24T22:39:02+08:00	7705	2101	9806	956	10762	20860	51.59%	36.94%	23	23
8	臺中市新社區	2018-11-25T01:24:17+08:00	7705	2101	9806	956	10762	20860	51.59%	36.94%	23	23
8	臺中市新社區	2018-11-24T22:35:39+08:00	7705	2101	9806	956	10762	20860	51.59%	36.94%	23	23
8	臺中市新社區	2018-11-24T23:58:35+08:00	7705	2101	9806	956	10762	20860	51.59%	36.94%	23	23
8	臺中市新社區	2018-11-25T06:27:49+08:00	7705	2101	9806	956	10762	20860	51.59%	36.94%	23	23
8	臺中市新社區	2018-11-24T23:03:41+08:00	7705	2101	9806	956	10762	20860	51.59%	36.94%	23	23
8	臺中市新社區	2018-11-25T01:00:53+08:00	7705	2101	9806	956	10762	20860	51.59%	36.94%	23	23
8	臺中市新社區	2018-11-24T23:00:08+08:00	7705	2101	9806	956	10762	20860	51.59%	36.94%	23	23
8	臺中市新社區	2018-11-25T03:48:22+08:00	7705	2101	9806	956	10762	20860	51.59%	36.94%	23	23
8	臺中市新社區	2018-11-25T00:21:37+08:00	7705	2101	9806	956	10762	20860	51.59%	36.94%	23	23
8	臺中市新社區	2018-11-25T03:42:41+08:00	7705	2101	9806	956	10762	20860	51.59%	36.94%	23	23
8	臺中市新社區	2018-11-24T22:21:39+08:00	7705	2101	9806	956	10762	20860	51.59%	36.94%	23	23
8	臺中市新社區	2018-11-24T22:32:12+08:00	7705	2101	9806	956	10762	20860	51.59%	36.94%	23	23
8	臺中市新社區	2018-11-25T04:01:22+08:00	7705	2101	9806	956	10762	20860	51.59%	36.94%	23	23
8	臺中市新社區	2018-11-24T22:11:57+08:00	7705	2101	9806	956	10762	20860	51.59%	36.94%	23	23
8	臺中市新社區	2018-11-25T00:17:01+08:00	7705	2101	9806	956	10762	20860	51.59%	36.94%	23	23
8	臺中市新社區	2018-11-24T22:40:13+08:00	7705	2101	9806	956	10762	20860	51.59%	36.94%	23	23
8	臺中市新社區	2018-11-24T22:53:07+08:00	7705	2101	9806	956	10762	20860	51.59%	36.94%	23	23
8	臺中市新社區	2018-11-25T06:12:31+08:00	7705	2101	9806	956	10762	20860	51.59%	36.94%	23	23
8	臺中市新社區	2018-11-25T06:07:16+08:00	7705	2101	9806	956	10762	20860	51.59%	36.94%	23	23
8	臺中市新社區	2018-11-24T23:33:44+08:00	7705	2101	9806	956	10762	20860	51.59%	36.94%	23	23
8	臺中市新社區	2018-11-25T03:54:33+08:00	7705	2101	9806	956	10762	20860	51.59%	36.94%	23	23
8	臺中市新社區	2018-11-24T23:26:01+08:00	7705	2101	9806	956	10762	20860	51.59%	36.94%	23	23
8	臺中市新社區	2018-11-25T06:17:29+08:00	7705	2101	9806	956	10762	20860	51.59%	36.94%	23	23
8	臺中市新社區	2018-11-24T23:41:56+08:00	7705	2101	9806	956	10762	20860	51.59%	36.94%	23	23
8	臺中市新社區	2018-11-24T23:37:43+08:00	7705	2101	9806	956	10762	20860	51.59%	36.94%	23	23
8	臺中市新社區	2018-11-24T23:18:21+08:00	7705	2101	9806	956	10762	20860	51.59%	36.94%	23	23
8	臺中市新社區	2018-11-24T23:45:57+08:00	7705	2101	9806	956	10762	20860	51.59%	36.94%	23	23
8	澎湖縣湖西鄉	2018-11-24T23:26:10+08:00	3825	1035	4860	485	5345	12741	41.95%	30.02%	23	23
8	澎湖縣湖西鄉	2018-11-24T23:10:59+08:00	3825	1035	4860	485	5345	12741	41.95%	30.02%	23	23
8	澎湖縣湖西鄉	2018-11-24T22:49:27+08:00	3551	949	4500	407	4907	11895	41.25%	29.85%	22	23
8	澎湖縣湖西鄉	2018-11-24T23:33:53+08:00	3825	1035	4860	485	5345	12741	41.95%	30.02%	23	23
8	澎湖縣湖西鄉	2018-11-24T22:56:39+08:00	3551	949	4500	407	4907	11895	41.25%	29.85%	22	23
8	澎湖縣湖西鄉	2018-11-24T23:22:26+08:00	3825	1035	4860	485	5345	12741	41.95%	30.02%	23	23
8	澎湖縣湖西鄉	2018-11-24T22:28:43+08:00	3551	949	4500	407	4907	11895	41.25%	29.85%	22	23
8	澎湖縣湖西鄉	2018-11-24T23:18:30+08:00	3825	1035	4860	485	5345	12741	41.95%	30.02%	23	23
8	澎湖縣湖西鄉	2018-11-25T00:17:11+08:00	3825	1035	4860	485	5345	12741	41.95%	30.02%	23	23
8	澎湖縣湖西鄉	2018-11-24T22:32:21+08:00	3551	949	4500	407	4907	11895	41.25%	29.85%	22	23
8	澎湖縣湖西鄉	2018-11-24T23:46:06+08:00	3825	1035	4860	485	5345	12741	41.95%	30.02%	23	23
8	澎湖縣湖西鄉	2018-11-24T22:53:18+08:00	3551	949	4500	407	4907	11895	41.25%	29.85%	22	23
8	澎湖縣湖西鄉	2018-11-25T00:08:08+08:00	3825	1035	4860	485	5345	12741	41.95%	30.02%	23	23
8	澎湖縣湖西鄉	2018-11-25T04:01:32+08:00	3825	1035	4860	485	5345	12741	41.95%	30.02%	23	23
8	澎湖縣湖西鄉	2018-11-25T03:48:34+08:00	3825	1035	4860	485	5345	12741	41.95%	30.02%	23	23
8	澎湖縣湖西鄉	2018-11-24T23:00:19+08:00	3551	949	4500	407	4907	11895	41.25%	29.85%	22	23
8	澎湖縣湖西鄉	2018-11-24T22:25:28+08:00	3551	949	4500	407	4907	11895	41.25%	29.85%	22	23
8	澎湖縣湖西鄉	2018-11-25T06:22:47+08:00	3825	1035	4860	485	5345	12741	41.95%	30.02%	23	23
8	澎湖縣湖西鄉	2018-11-24T22:40:21+08:00	3551	949	4500	407	4907	11895	41.25%	29.85%	22	23
8	澎湖縣湖西鄉	2018-11-24T23:14:44+08:00	3825	1035	4860	485	5345	12741	41.95%	30.02%	23	23
8	澎湖縣湖西鄉	2018-11-25T03:37:33+08:00	3825	1035	4860	485	5345	12741	41.95%	30.02%	23	23
8	澎湖縣湖西鄉	2018-11-24T22:18:23+08:00	3551	949	4500	407	4907	11895	41.25%	29.85%	22	23
8	澎湖縣湖西鄉	2018-11-24T23:50:18+08:00	3825	1035	4860	485	5345	12741	41.95%	30.02%	23	23
8	澎湖縣湖西鄉	2018-11-25T01:16:25+08:00	3825	1035	4860	485	5345	12741	41.95%	30.02%	23	23
8	澎湖縣湖西鄉	2018-11-24T23:58:46+08:00	3825	1035	4860	485	5345	12741	41.95%	30.02%	23	23
8	澎湖縣湖西鄉	2018-11-25T00:12:48+08:00	3825	1035	4860	485	5345	12741	41.95%	30.02%	23	23
8	澎湖縣湖西鄉	2018-11-24T23:03:50+08:00	3825	1035	4860	485	5345	12741	41.95%	30.02%	23	23
8	澎湖縣湖西鄉	2018-11-24T22:39:12+08:00	3551	949	4500	407	4907	11895	41.25%	29.85%	22	23
8	澎湖縣湖西鄉	2018-11-25T06:27:58+08:00	3825	1035	4860	485	5345	12741	41.95%	30.02%	23	23
8	澎湖縣湖西鄉	2018-11-25T06:17:40+08:00	3825	1035	4860	485	5345	12741	41.95%	30.02%	23	23
8	澎湖縣湖西鄉	2018-11-25T03:54:44+08:00	3825	1035	4860	485	5345	12741	41.95%	30.02%	23	23
8	澎湖縣湖西鄉	2018-11-24T22:14:52+08:00	3551	949	4500	407	4907	11895	41.25%	29.85%	22	23
8	澎湖縣湖西鄉	2018-11-25T01:24:28+08:00	3825	1035	4860	485	5345	12741	41.95%	30.02%	23	23
8	澎湖縣湖西鄉	2018-11-24T23:37:51+08:00	3825	1035	4860	485	5345	12741	41.95%	30.02%	23	23
8	澎湖縣湖西鄉	2018-11-24T23:07:22+08:00	3825	1035	4860	485	5345	12741	41.95%	30.02%	23	23
8	澎湖縣湖西鄉	2018-11-24T22:12:05+08:00	3551	949	4500	407	4907	11895	41.25%	29.85%	22	23
8	澎湖縣湖西鄉	2018-11-24T23:54:30+08:00	3825	1035	4860	485	5345	12741	41.95%	30.02%	23	23
8	澎湖縣湖西鄉	2018-11-25T06:12:40+08:00	3825	1035	4860	485	5345	12741	41.95%	30.02%	23	23
8	澎湖縣湖西鄉	2018-11-24T23:29:50+08:00	3825	1035	4860	485	5345	12741	41.95%	30.02%	23	23
8	澎湖縣湖西鄉	2018-11-24T23:42:05+08:00	3825	1035	4860	485	5345	12741	41.95%	30.02%	23	23
8	澎湖縣湖西鄉	2018-11-25T01:06:03+08:00	3825	1035	4860	485	5345	12741	41.95%	30.02%	23	23
8	澎湖縣湖西鄉	2018-11-25T01:11:11+08:00	3825	1035	4860	485	5345	12741	41.95%	30.02%	23	23
8	澎湖縣湖西鄉	2018-11-25T00:21:47+08:00	3825	1035	4860	485	5345	12741	41.95%	30.02%	23	23
8	澎湖縣湖西鄉	2018-11-25T03:42:52+08:00	3825	1035	4860	485	5345	12741	41.95%	30.02%	23	23
8	澎湖縣湖西鄉	2018-11-25T06:07:26+08:00	3825	1035	4860	485	5345	12741	41.95%	30.02%	23	23
8	澎湖縣湖西鄉	2018-11-24T22:21:49+08:00	3551	949	4500	407	4907	11895	41.25%	29.85%	22	23
8	澎湖縣湖西鄉	2018-11-24T22:43:53+08:00	3551	949	4500	407	4907	11895	41.25%	29.85%	22	23
8	澎湖縣湖西鄉	2018-11-25T03:31:03+08:00	3825	1035	4860	485	5345	12741	41.95%	30.02%	23	23
8	澎湖縣湖西鄉	2018-11-24T22:35:47+08:00	3551	949	4500	407	4907	11895	41.25%	29.85%	22	23
8	澎湖縣湖西鄉	2018-11-25T01:01:05+08:00	3825	1035	4860	485	5345	12741	41.95%	30.02%	23	23
8	澎湖縣湖西鄉	2018-11-25T00:56:16+08:00	3825	1035	4860	485	5345	12741	41.95%	30.02%	23	23
8	澎湖縣湖西鄉	2018-11-25T00:03:39+08:00	3825	1035	4860	485	5345	12741	41.95%	30.02%	23	23
8	高雄市鳳山區	2018-11-24T22:49:20+08:00	74120	22940	97060	7914	104974	179253	58.56%	41.35%	147	228
8	高雄市鳳山區	2018-11-25T03:37:21+08:00	124404	37861	162265	12320	174585	298465	58.49%	41.68%	227	228
8	高雄市鳳山區	2018-11-24T23:03:43+08:00	80433	25039	105472	8585	114057	194227	58.72%	41.41%	159	228
8	高雄市鳳山區	2018-11-24T23:58:37+08:00	99881	30976	130857	10334	141191	240964	58.59%	41.45%	192	228
8	高雄市鳳山區	2018-11-25T06:17:31+08:00	125228	38044	163272	12418	175690	300510	58.46%	41.67%	228	228
8	高雄市鳳山區	2018-11-24T23:22:18+08:00	87521	27272	114793	9271	124064	211745	58.59%	41.33%	172	228
8	高雄市鳳山區	2018-11-25T00:03:29+08:00	103276	31957	135233	10564	145797	248959	58.56%	41.48%	197	228
8	高雄市鳳山區	2018-11-24T23:14:35+08:00	83383	26029	109412	8839	118251	201606	58.65%	41.36%	165	228
8	高雄市鳳山區	2018-11-25T00:56:09+08:00	117202	35872	153074	11689	164763	281439	58.54%	41.64%	218	228
8	高雄市鳳山區	2018-11-25T03:42:43+08:00	124404	37861	162265	12320	174585	298465	58.49%	41.68%	227	228
8	高雄市鳳山區	2018-11-24T22:53:10+08:00	74579	23096	97675	7958	105633	180365	58.57%	41.35%	148	228
8	高雄市鳳山區	2018-11-25T00:08:00+08:00	104441	32313	136754	10636	147390	251754	58.55%	41.49%	199	228
8	高雄市鳳山區	2018-11-24T23:46:00+08:00	97514	30341	127855	10102	137957	235324	58.62%	41.44%	188	228
8	高雄市鳳山區	2018-11-25T01:00:56+08:00	118740	36309	155049	11800	166849	285291	58.48%	41.62%	220	228
8	高雄市鳳山區	2018-11-24T22:25:19+08:00	55971	17581	73552	6132	79684	135788	58.68%	41.22%	116	228
8	高雄市鳳山區	2018-11-25T06:12:33+08:00	125228	38044	163272	12418	175690	300510	58.46%	41.67%	228	228
8	高雄市鳳山區	2018-11-25T00:17:03+08:00	108130	33236	141366	10932	152298	260234	58.52%	41.55%	205	228
8	高雄市鳳山區	2018-11-25T06:22:41+08:00	125228	38044	163272	12418	175690	300510	58.46%	41.67%	228	228
8	高雄市鳳山區	2018-11-24T23:18:23+08:00	84520	26361	110881	8960	119841	204356	58.64%	41.36%	167	228
8	高雄市鳳山區	2018-11-24T23:50:10+08:00	98621	30674	129295	10220	139515	237968	58.63%	41.44%	190	228
8	高雄市鳳山區	2018-11-24T22:18:15+08:00	52091	16345	68436	5729	74165	126574	58.59%	41.15%	109	228
8	高雄市鳳山區	2018-11-24T22:14:44+08:00	49972	15614	65586	5476	71062	120945	58.76%	41.32%	105	228
8	高雄市鳳山區	2018-11-25T01:05:54+08:00	118740	36309	155049	11800	166849	285291	58.48%	41.62%	220	228
8	高雄市鳳山區	2018-11-24T23:54:21+08:00	98621	30674	129295	10220	139515	237968	58.63%	41.44%	190	228
8	高雄市鳳山區	2018-11-24T23:33:46+08:00	93727	29185	122912	9780	132692	226459	58.59%	41.39%	182	228
8	高雄市鳳山區	2018-11-25T06:27:51+08:00	125228	38044	163272	12418	175690	300510	58.46%	41.67%	228	228
8	高雄市鳳山區	2018-11-24T23:26:03+08:00	88127	27446	115573	9302	124875	213270	58.55%	41.32%	173	228
8	高雄市鳳山區	2018-11-25T03:54:36+08:00	125228	38044	163272	12418	175690	300510	58.46%	41.67%	228	228
8	高雄市鳳山區	2018-11-25T00:12:41+08:00	108130	33236	141366	10932	152298	260234	58.52%	41.55%	205	228
8	高雄市鳳山區	2018-11-25T01:24:20+08:00	122349	37191	159540	12106	171646	293528	58.48%	41.68%	224	228
8	高雄市鳳山區	2018-11-24T22:56:32+08:00	75621	23413	99034	8072	107106	182721	58.62%	41.39%	150	228
8	高雄市鳳山區	2018-11-24T22:43:46+08:00	68894	21332	90226	7354	97580	166542	58.59%	41.37%	138	228
8	高雄市鳳山區	2018-11-24T22:39:05+08:00	64422	20087	84509	6967	91476	156199	58.56%	41.24%	131	228
8	高雄市鳳山區	2018-11-24T23:10:52+08:00	81818	25539	107357	8714	116071	197571	58.75%	41.41%	162	228
8	高雄市鳳山區	2018-11-24T23:07:14+08:00	81465	25382	106847	8658	115505	196603	58.75%	41.44%	161	228
8	高雄市鳳山區	2018-11-24T22:32:14+08:00	60230	18694	78924	6581	85505	145893	58.61%	41.28%	123	228
8	高雄市鳳山區	2018-11-25T03:30:54+08:00	124404	37861	162265	12320	174585	298465	58.49%	41.68%	227	228
8	高雄市鳳山區	2018-11-25T03:48:24+08:00	125228	38044	163272	12418	175690	300510	58.46%	41.67%	228	228
8	高雄市鳳山區	2018-11-24T22:40:15+08:00	66899	20744	87643	7174	94817	161908	58.56%	41.32%	135	228
8	高雄市鳳山區	2018-11-25T00:21:40+08:00	110154	33861	144015	11151	155166	265129	58.52%	41.55%	208	228
8	高雄市鳳山區	2018-11-24T23:29:42+08:00	88660	27592	116252	9330	125582	214469	58.55%	41.34%	174	228
8	高雄市鳳山區	2018-11-25T01:11:02+08:00	120687	36729	157416	11966	169382	289719	58.46%	41.66%	222	228
8	高雄市鳳山區	2018-11-24T23:00:13+08:00	76645	23792	100437	8169	108606	185185	58.65%	41.39%	152	228
8	高雄市鳳山區	2018-11-24T22:21:41+08:00	53719	16882	70601	5932	76533	130594	58.6%	41.13%	112	228
8	高雄市鳳山區	2018-11-25T06:07:18+08:00	125228	38044	163272	12418	175690	300510	58.46%	41.67%	228	228
8	高雄市鳳山區	2018-11-24T22:11:58+08:00	47598	14913	62511	5250	67761	115540	58.65%	41.2%	101	228
8	高雄市鳳山區	2018-11-25T04:01:24+08:00	125228	38044	163272	12418	175690	300510	58.46%	41.67%	228	228
8	高雄市鳳山區	2018-11-24T22:28:36+08:00	57791	18167	75958	6358	82316	140503	58.59%	41.13%	119	228
8	高雄市鳳山區	2018-11-24T22:35:41+08:00	62396	19380	81776	6761	88537	151363	58.49%	41.22%	127	228
8	高雄市鳳山區	2018-11-24T23:37:45+08:00	93727	29185	122912	9780	132692	226459	58.59%	41.39%	182	228
8	高雄市鳳山區	2018-11-24T23:41:58+08:00	94509	29412	123921	9830	133751	228210	58.61%	41.41%	183	228
8	高雄市鳳山區	2018-11-25T01:16:17+08:00	121403	36919	158322	12020	170342	291431	58.45%	41.66%	223	228
8	高雄市鼓山區	2018-11-25T00:56:08+08:00	43289	13567	56856	3836	60692	104618	58.01%	41.38%	71	77
8	高雄市鼓山區	2018-11-24T23:03:43+08:00	25727	7878	33605	2692	36297	63304	57.34%	40.64%	49	77
8	高雄市鼓山區	2018-11-24T23:58:37+08:00	35601	11112	46713	3282	49995	85876	58.22%	41.46%	61	77
8	高雄市鼓山區	2018-11-25T06:17:31+08:00	47801	14884	62685	4110	66795	114979	58.09%	41.57%	77	77
8	高雄市鼓山區	2018-11-24T23:22:18+08:00	30633	9410	40043	2988	43031	74324	57.9%	41.22%	55	77
8	高雄市鼓山區	2018-11-24T22:43:45+08:00	19576	6237	25813	2186	27999	49409	56.67%	39.62%	40	77
8	高雄市鼓山區	2018-11-24T23:14:35+08:00	26803	8178	34981	2739	37720	65666	57.44%	40.82%	50	77
8	高雄市鼓山區	2018-11-25T03:37:20+08:00	47801	14884	62685	4110	66795	114979	58.09%	41.57%	77	77
8	高雄市鼓山區	2018-11-24T22:49:19+08:00	20021	6409	26430	2253	28683	50615	56.67%	39.56%	41	77
8	高雄市鼓山區	2018-11-25T00:03:28+08:00	37033	11566	48599	3382	51981	89426	58.13%	41.41%	63	77
8	高雄市鼓山區	2018-11-25T03:42:43+08:00	47801	14884	62685	4110	66795	114979	58.09%	41.57%	77	77
8	高雄市鼓山區	2018-11-24T22:53:10+08:00	21093	6476	27569	2288	29857	52543	56.82%	40.14%	42	77
8	高雄市鼓山區	2018-11-25T00:08:00+08:00	37858	11751	49609	3408	53017	91313	58.06%	41.46%	64	77
8	高雄市鼓山區	2018-11-25T01:00:56+08:00	43779	13730	57509	3887	61396	106102	57.87%	41.26%	72	77
8	高雄市鼓山區	2018-11-24T22:25:19+08:00	16689	5427	22116	1942	24058	42405	56.73%	39.36%	35	77
8	高雄市鼓山區	2018-11-25T00:17:03+08:00	37858	11751	49609	3408	53017	91313	58.06%	41.46%	64	77
8	高雄市鼓山區	2018-11-25T01:11:01+08:00	45494	14247	59741	3958	63699	109881	57.97%	41.4%	74	77
8	高雄市鼓山區	2018-11-25T06:22:41+08:00	47801	14884	62685	4110	66795	114979	58.09%	41.57%	77	77
8	高雄市鼓山區	2018-11-25T06:12:32+08:00	47801	14884	62685	4110	66795	114979	58.09%	41.57%	77	77
8	高雄市鼓山區	2018-11-24T23:50:10+08:00	34768	10782	45550	3233	48783	83878	58.16%	41.45%	60	77
8	高雄市鼓山區	2018-11-24T22:18:15+08:00	13521	4470	17991	1653	19644	34688	56.63%	38.98%	30	77
8	高雄市鼓山區	2018-11-24T22:28:35+08:00	17460	5630	23090	1990	25080	44265	56.66%	39.44%	36	77
8	高雄市鼓山區	2018-11-24T23:54:20+08:00	35601	11112	46713	3282	49995	85876	58.22%	41.46%	61	77
8	高雄市鼓山區	2018-11-24T22:14:44+08:00	12671	4210	16881	1586	18467	32776	56.34%	38.66%	29	77
8	高雄市鼓山區	2018-11-25T06:27:50+08:00	47801	14884	62685	4110	66795	114979	58.09%	41.57%	77	77
8	高雄市鼓山區	2018-11-24T23:18:22+08:00	28043	8588	36631	2867	39498	68651	57.53%	40.85%	52	77
8	高雄市鼓山區	2018-11-25T01:05:54+08:00	45494	14247	59741	3958	63699	109881	57.97%	41.4%	74	77
8	高雄市鼓山區	2018-11-24T23:26:03+08:00	31429	9688	41117	3052	44169	76191	57.97%	41.25%	56	77
8	高雄市鼓山區	2018-11-25T00:12:41+08:00	37858	11751	49609	3408	53017	91313	58.06%	41.46%	64	77
8	高雄市鼓山區	2018-11-24T22:56:32+08:00	22545	6858	29403	2396	31799	55750	57.04%	40.44%	44	77
8	高雄市鼓山區	2018-11-25T01:24:19+08:00	45494	14247	59741	3958	63699	109881	57.97%	41.4%	74	77
8	高雄市鼓山區	2018-11-24T22:39:04+08:00	18479	5939	24418	2115	26533	46775	56.72%	39.51%	38	77
8	高雄市鼓山區	2018-11-24T23:10:52+08:00	26803	8178	34981	2739	37720	65666	57.44%	40.82%	50	77
8	高雄市鼓山區	2018-11-24T23:07:14+08:00	26803	8178	34981	2739	37720	65666	57.44%	40.82%	50	77
8	高雄市鼓山區	2018-11-25T00:21:39+08:00	38624	11988	50612	3477	54089	93122	58.08%	41.48%	65	77
8	高雄市鼓山區	2018-11-24T22:32:14+08:00	17460	5630	23090	1990	25080	44265	56.66%	39.44%	36	77
8	高雄市鼓山區	2018-11-25T03:30:53+08:00	47801	14884	62685	4110	66795	114979	58.09%	41.57%	77	77
8	高雄市鼓山區	2018-11-25T03:48:24+08:00	47801	14884	62685	4110	66795	114979	58.09%	41.57%	77	77
8	高雄市鼓山區	2018-11-24T23:29:42+08:00	31429	9688	41117	3052	44169	76191	57.97%	41.25%	56	77
8	高雄市鼓山區	2018-11-24T23:00:13+08:00	23476	7173	30649	2452	33101	57897	57.17%	40.55%	45	77
8	高雄市鼓山區	2018-11-24T22:21:41+08:00	15372	5014	20386	1801	22187	39206	56.59%	39.21%	33	77
8	高雄市鼓山區	2018-11-24T22:40:14+08:00	18955	6078	25033	2155	27188	48016	56.62%	39.48%	39	77
8	高雄市鼓山區	2018-11-25T06:07:18+08:00	47801	14884	62685	4110	66795	114979	58.09%	41.57%	77	77
8	高雄市鼓山區	2018-11-24T22:11:58+08:00	12671	4210	16881	1586	18467	32776	56.34%	38.66%	29	77
8	高雄市鼓山區	2018-11-25T04:01:24+08:00	47801	14884	62685	4110	66795	114979	58.09%	41.57%	77	77
8	高雄市鼓山區	2018-11-24T23:41:57+08:00	34768	10782	45550	3233	48783	83878	58.16%	41.45%	60	77
8	高雄市鼓山區	2018-11-24T22:35:40+08:00	18040	5786	23826	2035	25861	45417	56.94%	39.72%	37	77
8	高雄市鼓山區	2018-11-25T03:54:35+08:00	47801	14884	62685	4110	66795	114979	58.09%	41.57%	77	77
8	高雄市鼓山區	2018-11-24T23:33:45+08:00	33047	10257	43304	3121	46425	80093	57.96%	41.26%	58	77
8	高雄市鼓山區	2018-11-24T23:37:44+08:00	33047	10257	43304	3121	46425	80093	57.96%	41.26%	58	77
8	高雄市鼓山區	2018-11-24T23:45:59+08:00	34768	10782	45550	3233	48783	83878	58.16%	41.45%	60	77
8	高雄市鼓山區	2018-11-25T01:16:17+08:00	45494	14247	59741	3958	63699	109881	57.97%	41.4%	74	77
8	苗栗縣苗栗市	2018-11-24T23:07:16+08:00	29820	7409	37229	2322	39551	68511	57.73%	43.53%	62	67
8	苗栗縣苗栗市	2018-11-24T22:12:00+08:00	18407	4600	23007	1481	24488	42686	57.37%	43.12%	40	67
8	苗栗縣苗栗市	2018-11-24T22:39:06+08:00	23339	5875	29214	1861	31075	53682	57.89%	43.48%	50	67
8	苗栗縣苗栗市	2018-11-24T23:22:20+08:00	32286	8001	40287	2503	42790	74249	57.63%	43.48%	67	67
8	苗栗縣苗栗市	2018-11-24T23:58:39+08:00	32286	8001	40287	2503	42790	74249	57.63%	43.48%	67	67
8	苗栗縣苗栗市	2018-11-24T23:03:45+08:00	28741	7096	35837	2245	38082	65949	57.74%	43.58%	60	67
8	苗栗縣苗栗市	2018-11-24T22:49:21+08:00	25390	6348	31738	2009	33747	58406	57.78%	43.47%	54	67
8	苗栗縣苗栗市	2018-11-24T23:46:01+08:00	32286	8001	40287	2503	42790	74249	57.63%	43.48%	67	67
8	苗栗縣苗栗市	2018-11-25T03:48:26+08:00	32286	8001	40287	2503	42790	74249	57.63%	43.48%	67	67
8	苗栗縣苗栗市	2018-11-25T03:30:56+08:00	32286	8001	40287	2503	42790	74249	57.63%	43.48%	67	67
8	苗栗縣苗栗市	2018-11-25T03:42:45+08:00	32286	8001	40287	2503	42790	74249	57.63%	43.48%	67	67
8	苗栗縣苗栗市	2018-11-24T22:32:16+08:00	21988	5529	27517	1763	29280	50553	57.92%	43.49%	47	67
8	苗栗縣苗栗市	2018-11-25T01:00:58+08:00	32286	8001	40287	2503	42790	74249	57.63%	43.48%	67	67
8	苗栗縣苗栗市	2018-11-25T00:08:01+08:00	32286	8001	40287	2503	42790	74249	57.63%	43.48%	67	67
8	苗栗縣苗栗市	2018-11-25T04:01:26+08:00	32286	8001	40287	2503	42790	74249	57.63%	43.48%	67	67
8	苗栗縣苗栗市	2018-11-24T22:25:21+08:00	20854	5212	26066	1654	27720	48052	57.69%	43.4%	45	67
8	苗栗縣苗栗市	2018-11-25T06:12:34+08:00	32286	8001	40287	2503	42790	74249	57.63%	43.48%	67	67
8	苗栗縣苗栗市	2018-11-24T22:40:16+08:00	23765	5978	29743	1886	31629	54647	57.88%	43.49%	51	67
8	苗栗縣苗栗市	2018-11-24T22:21:43+08:00	20434	5097	25531	1625	27156	47042	57.73%	43.44%	44	67
8	苗栗縣苗栗市	2018-11-25T00:17:05+08:00	32286	8001	40287	2503	42790	74249	57.63%	43.48%	67	67
8	苗栗縣苗栗市	2018-11-24T23:18:24+08:00	32286	8001	40287	2503	42790	74249	57.63%	43.48%	67	67
8	苗栗縣苗栗市	2018-11-24T23:37:46+08:00	32286	8001	40287	2503	42790	74249	57.63%	43.48%	67	67
8	苗栗縣苗栗市	2018-11-24T22:35:42+08:00	22876	5777	28653	1832	30485	52635	57.92%	43.46%	49	67
8	苗栗縣苗栗市	2018-11-25T03:54:37+08:00	32286	8001	40287	2503	42790	74249	57.63%	43.48%	67	67
8	苗栗縣苗栗市	2018-11-24T23:33:47+08:00	32286	8001	40287	2503	42790	74249	57.63%	43.48%	67	67
8	苗栗縣苗栗市	2018-11-24T23:26:04+08:00	32286	8001	40287	2503	42790	74249	57.63%	43.48%	67	67
8	苗栗縣苗栗市	2018-11-24T23:14:37+08:00	31756	7873	39629	2468	42097	72757	57.86%	43.65%	66	67
8	苗栗縣苗栗市	2018-11-24T23:10:53+08:00	30788	7625	38413	2385	40798	70701	57.7%	43.55%	64	67
8	苗栗縣苗栗市	2018-11-25T06:17:33+08:00	32286	8001	40287	2503	42790	74249	57.63%	43.48%	67	67
8	苗栗縣苗栗市	2018-11-24T22:43:47+08:00	24312	6105	30417	1921	32338	55989	57.76%	43.42%	52	67
8	苗栗縣苗栗市	2018-11-25T01:24:21+08:00	32286	8001	40287	2503	42790	74249	57.63%	43.48%	67	67
8	苗栗縣苗栗市	2018-11-24T22:56:34+08:00	27027	6719	33746	2138	35884	62056	57.83%	43.55%	57	67
8	苗栗縣苗栗市	2018-11-25T03:37:24+08:00	32286	8001	40287	2503	42790	74249	57.63%	43.48%	67	67
8	苗栗縣苗栗市	2018-11-24T22:53:12+08:00	26427	6595	33022	2085	35107	60750	57.79%	43.5%	56	67
8	苗栗縣苗栗市	2018-11-24T23:00:14+08:00	27027	6719	33746	2138	35884	62056	57.83%	43.55%	57	67
8	苗栗縣苗栗市	2018-11-25T01:11:03+08:00	32286	8001	40287	2503	42790	74249	57.63%	43.48%	67	67
8	苗栗縣苗栗市	2018-11-24T23:29:43+08:00	32286	8001	40287	2503	42790	74249	57.63%	43.48%	67	67
8	苗栗縣苗栗市	2018-11-25T00:21:41+08:00	32286	8001	40287	2503	42790	74249	57.63%	43.48%	67	67
8	苗栗縣苗栗市	2018-11-25T06:22:42+08:00	32286	8001	40287	2503	42790	74249	57.63%	43.48%	67	67
8	苗栗縣苗栗市	2018-11-25T06:07:20+08:00	32286	8001	40287	2503	42790	74249	57.63%	43.48%	67	67
8	苗栗縣苗栗市	2018-11-25T01:05:56+08:00	32286	8001	40287	2503	42790	74249	57.63%	43.48%	67	67
8	苗栗縣苗栗市	2018-11-24T23:54:24+08:00	32286	8001	40287	2503	42790	74249	57.63%	43.48%	67	67
8	苗栗縣苗栗市	2018-11-24T23:41:59+08:00	32286	8001	40287	2503	42790	74249	57.63%	43.48%	67	67
8	苗栗縣苗栗市	2018-11-25T01:16:18+08:00	32286	8001	40287	2503	42790	74249	57.63%	43.48%	67	67
8	苗栗縣苗栗市	2018-11-25T00:03:31+08:00	32286	8001	40287	2503	42790	74249	57.63%	43.48%	67	67
8	苗栗縣苗栗市	2018-11-24T22:14:46+08:00	18407	4600	23007	1481	24488	42686	57.37%	43.12%	40	67
8	苗栗縣苗栗市	2018-11-25T06:27:52+08:00	32286	8001	40287	2503	42790	74249	57.63%	43.48%	67	67
8	苗栗縣苗栗市	2018-11-25T00:56:11+08:00	32286	8001	40287	2503	42790	74249	57.63%	43.48%	67	67
8	苗栗縣苗栗市	2018-11-24T22:18:17+08:00	18901	4717	23618	1512	25130	43738	57.46%	43.21%	41	67
8	苗栗縣苗栗市	2018-11-25T00:12:42+08:00	32286	8001	40287	2503	42790	74249	57.63%	43.48%	67	67
8	苗栗縣苗栗市	2018-11-24T22:28:37+08:00	21469	5396	26865	1724	28589	49428	57.84%	43.43%	46	67
8	苗栗縣苗栗市	2018-11-24T23:50:12+08:00	32286	8001	40287	2503	42790	74249	57.63%	43.48%	67	67
8	苗栗縣南庄鄉	2018-11-24T23:07:16+08:00	3033	885	3918	386	4304	8784	49%	34.53%	9	9
8	苗栗縣南庄鄉	2018-11-24T22:12:00+08:00	2547	732	3279	325	3604	7431	48.5%	34.28%	8	9
8	苗栗縣南庄鄉	2018-11-24T22:39:06+08:00	3033	885	3918	386	4304	8784	49%	34.53%	9	9
8	苗栗縣南庄鄉	2018-11-24T23:58:39+08:00	3033	885	3918	386	4304	8784	49%	34.53%	9	9
8	苗栗縣南庄鄉	2018-11-24T23:03:45+08:00	3033	885	3918	386	4304	8784	49%	34.53%	9	9
8	苗栗縣南庄鄉	2018-11-24T22:49:21+08:00	3033	885	3918	386	4304	8784	49%	34.53%	9	9
8	苗栗縣南庄鄉	2018-11-24T23:22:21+08:00	3033	885	3918	386	4304	8784	49%	34.53%	9	9
8	苗栗縣南庄鄉	2018-11-25T01:24:22+08:00	3033	885	3918	386	4304	8784	49%	34.53%	9	9
8	苗栗縣南庄鄉	2018-11-24T23:46:01+08:00	3033	885	3918	386	4304	8784	49%	34.53%	9	9
8	苗栗縣南庄鄉	2018-11-24T23:42:00+08:00	3033	885	3918	386	4304	8784	49%	34.53%	9	9
8	苗栗縣南庄鄉	2018-11-25T03:30:56+08:00	3033	885	3918	386	4304	8784	49%	34.53%	9	9
8	苗栗縣南庄鄉	2018-11-25T03:42:45+08:00	3033	885	3918	386	4304	8784	49%	34.53%	9	9
8	苗栗縣南庄鄉	2018-11-24T22:32:16+08:00	2547	732	3279	325	3604	7431	48.5%	34.28%	8	9
8	苗栗縣南庄鄉	2018-11-25T03:48:27+08:00	3033	885	3918	386	4304	8784	49%	34.53%	9	9
8	苗栗縣南庄鄉	2018-11-25T01:00:58+08:00	3033	885	3918	386	4304	8784	49%	34.53%	9	9
8	苗栗縣南庄鄉	2018-11-24T22:25:21+08:00	2547	732	3279	325	3604	7431	48.5%	34.28%	8	9
8	苗栗縣南庄鄉	2018-11-25T06:12:34+08:00	3033	885	3918	386	4304	8784	49%	34.53%	9	9
8	苗栗縣南庄鄉	2018-11-24T22:40:16+08:00	3033	885	3918	386	4304	8784	49%	34.53%	9	9
8	苗栗縣南庄鄉	2018-11-25T04:01:27+08:00	3033	885	3918	386	4304	8784	49%	34.53%	9	9
8	苗栗縣南庄鄉	2018-11-24T22:21:43+08:00	2547	732	3279	325	3604	7431	48.5%	34.28%	8	9
8	苗栗縣南庄鄉	2018-11-25T00:17:05+08:00	3033	885	3918	386	4304	8784	49%	34.53%	9	9
8	苗栗縣南庄鄉	2018-11-25T00:21:42+08:00	3033	885	3918	386	4304	8784	49%	34.53%	9	9
8	苗栗縣南庄鄉	2018-11-24T23:37:46+08:00	3033	885	3918	386	4304	8784	49%	34.53%	9	9
8	苗栗縣南庄鄉	2018-11-24T22:35:42+08:00	2547	732	3279	325	3604	7431	48.5%	34.28%	8	9
8	苗栗縣南庄鄉	2018-11-24T23:26:05+08:00	3033	885	3918	386	4304	8784	49%	34.53%	9	9
8	苗栗縣南庄鄉	2018-11-24T23:18:25+08:00	3033	885	3918	386	4304	8784	49%	34.53%	9	9
8	苗栗縣南庄鄉	2018-11-24T23:33:48+08:00	3033	885	3918	386	4304	8784	49%	34.53%	9	9
8	苗栗縣南庄鄉	2018-11-25T03:54:38+08:00	3033	885	3918	386	4304	8784	49%	34.53%	9	9
8	苗栗縣南庄鄉	2018-11-25T03:37:25+08:00	3033	885	3918	386	4304	8784	49%	34.53%	9	9
8	苗栗縣南庄鄉	2018-11-24T23:10:54+08:00	3033	885	3918	386	4304	8784	49%	34.53%	9	9
8	苗栗縣南庄鄉	2018-11-24T23:14:37+08:00	3033	885	3918	386	4304	8784	49%	34.53%	9	9
8	苗栗縣南庄鄉	2018-11-25T06:17:33+08:00	3033	885	3918	386	4304	8784	49%	34.53%	9	9
8	苗栗縣南庄鄉	2018-11-24T22:43:47+08:00	3033	885	3918	386	4304	8784	49%	34.53%	9	9
8	苗栗縣南庄鄉	2018-11-24T22:56:34+08:00	3033	885	3918	386	4304	8784	49%	34.53%	9	9
8	苗栗縣南庄鄉	2018-11-25T00:08:02+08:00	3033	885	3918	386	4304	8784	49%	34.53%	9	9
8	苗栗縣南庄鄉	2018-11-24T22:53:12+08:00	3033	885	3918	386	4304	8784	49%	34.53%	9	9
8	苗栗縣南庄鄉	2018-11-25T06:22:43+08:00	3033	885	3918	386	4304	8784	49%	34.53%	9	9
8	苗栗縣南庄鄉	2018-11-24T23:29:44+08:00	3033	885	3918	386	4304	8784	49%	34.53%	9	9
8	苗栗縣南庄鄉	2018-11-25T01:11:04+08:00	3033	885	3918	386	4304	8784	49%	34.53%	9	9
8	苗栗縣南庄鄉	2018-11-25T06:07:20+08:00	3033	885	3918	386	4304	8784	49%	34.53%	9	9
8	苗栗縣南庄鄉	2018-11-24T23:00:15+08:00	3033	885	3918	386	4304	8784	49%	34.53%	9	9
8	苗栗縣南庄鄉	2018-11-25T01:05:56+08:00	3033	885	3918	386	4304	8784	49%	34.53%	9	9
8	苗栗縣南庄鄉	2018-11-25T06:27:53+08:00	3033	885	3918	386	4304	8784	49%	34.53%	9	9
8	苗栗縣南庄鄉	2018-11-25T00:03:31+08:00	3033	885	3918	386	4304	8784	49%	34.53%	9	9
8	苗栗縣南庄鄉	2018-11-24T23:54:25+08:00	3033	885	3918	386	4304	8784	49%	34.53%	9	9
8	苗栗縣南庄鄉	2018-11-24T22:14:46+08:00	2547	732	3279	325	3604	7431	48.5%	34.28%	8	9
8	苗栗縣南庄鄉	2018-11-25T00:56:11+08:00	3033	885	3918	386	4304	8784	49%	34.53%	9	9
8	苗栗縣南庄鄉	2018-11-24T22:18:17+08:00	2547	732	3279	325	3604	7431	48.5%	34.28%	8	9
8	苗栗縣南庄鄉	2018-11-25T00:12:42+08:00	3033	885	3918	386	4304	8784	49%	34.53%	9	9
8	苗栗縣南庄鄉	2018-11-24T22:28:37+08:00	2547	732	3279	325	3604	7431	48.5%	34.28%	8	9
8	苗栗縣南庄鄉	2018-11-25T01:16:19+08:00	3033	885	3918	386	4304	8784	49%	34.53%	9	9
8	苗栗縣南庄鄉	2018-11-24T23:50:12+08:00	3033	885	3918	386	4304	8784	49%	34.53%	9	9
8	南投縣名間鄉	2018-11-25T01:24:23+08:00	14224	3820	18044	1911	19955	33408	59.73%	42.58%	37	37
8	南投縣名間鄉	2018-11-24T22:39:07+08:00	12046	3237	15283	1594	16877	28169	59.91%	42.76%	32	37
8	南投縣名間鄉	2018-11-24T23:07:17+08:00	13198	3552	16750	1780	18530	31007	59.76%	42.56%	35	37
8	南投縣名間鄉	2018-11-24T22:12:01+08:00	9649	2607	12256	1299	13555	22722	59.66%	42.47%	27	37
8	南投縣名間鄉	2018-11-25T03:37:27+08:00	14224	3820	18044	1911	19955	33408	59.73%	42.58%	37	37
8	南投縣名間鄉	2018-11-24T22:32:17+08:00	11019	2977	13996	1460	15456	25724	60.08%	42.84%	30	37
8	南投縣名間鄉	2018-11-25T03:30:57+08:00	14224	3820	18044	1911	19955	33408	59.73%	42.58%	37	37
8	南投縣名間鄉	2018-11-25T03:48:28+08:00	14224	3820	18044	1911	19955	33408	59.73%	42.58%	37	37
8	南投縣名間鄉	2018-11-24T23:42:01+08:00	14224	3820	18044	1911	19955	33408	59.73%	42.58%	37	37
8	南投縣名間鄉	2018-11-25T04:01:28+08:00	14224	3820	18044	1911	19955	33408	59.73%	42.58%	37	37
8	南投縣名間鄉	2018-11-25T00:21:43+08:00	14224	3820	18044	1911	19955	33408	59.73%	42.58%	37	37
8	南投縣名間鄉	2018-11-24T22:21:44+08:00	10115	2735	12850	1356	14206	23777	59.75%	42.54%	28	37
8	南投縣名間鄉	2018-11-24T23:00:16+08:00	12815	3439	16254	1711	17965	30077	59.73%	42.61%	34	37
8	南投縣名間鄉	2018-11-24T22:40:17+08:00	12046	3237	15283	1594	16877	28169	59.91%	42.76%	32	37
8	南投縣名間鄉	2018-11-25T06:12:35+08:00	14224	3820	18044	1911	19955	33408	59.73%	42.58%	37	37
8	南投縣名間鄉	2018-11-25T00:03:32+08:00	14224	3820	18044	1911	19955	33408	59.73%	42.58%	37	37
8	南投縣名間鄉	2018-11-25T03:54:39+08:00	14224	3820	18044	1911	19955	33408	59.73%	42.58%	37	37
8	南投縣名間鄉	2018-11-25T01:01:00+08:00	14224	3820	18044	1911	19955	33408	59.73%	42.58%	37	37
8	南投縣名間鄉	2018-11-24T23:33:49+08:00	14224	3820	18044	1911	19955	33408	59.73%	42.58%	37	37
8	南投縣名間鄉	2018-11-24T23:26:05+08:00	13683	3683	17366	1838	19204	32134	59.76%	42.58%	36	37
8	南投縣名間鄉	2018-11-24T23:37:47+08:00	14224	3820	18044	1911	19955	33408	59.73%	42.58%	37	37
8	南投縣名間鄉	2018-11-24T22:35:43+08:00	11536	3090	14626	1526	16152	26908	60.03%	42.87%	31	37
8	南投縣名間鄉	2018-11-24T23:54:26+08:00	14224	3820	18044	1911	19955	33408	59.73%	42.58%	37	37
8	南投縣名間鄉	2018-11-24T23:58:41+08:00	14224	3820	18044	1911	19955	33408	59.73%	42.58%	37	37
8	南投縣名間鄉	2018-11-25T00:56:12+08:00	14224	3820	18044	1911	19955	33408	59.73%	42.58%	37	37
8	南投縣名間鄉	2018-11-24T22:56:35+08:00	12815	3439	16254	1711	17965	30077	59.73%	42.61%	34	37
8	南投縣名間鄉	2018-11-24T23:14:39+08:00	13683	3683	17366	1838	19204	32134	59.76%	42.58%	36	37
8	南投縣名間鄉	2018-11-24T23:22:22+08:00	13683	3683	17366	1838	19204	32134	59.76%	42.58%	36	37
8	南投縣名間鄉	2018-11-25T06:17:34+08:00	14224	3820	18044	1911	19955	33408	59.73%	42.58%	37	37
8	南投縣名間鄉	2018-11-24T22:43:49+08:00	12046	3237	15283	1594	16877	28169	59.91%	42.76%	32	37
8	南投縣名間鄉	2018-11-24T23:03:46+08:00	12815	3439	16254	1711	17965	30077	59.73%	42.61%	34	37
8	南投縣名間鄉	2018-11-24T23:10:55+08:00	13683	3683	17366	1838	19204	32134	59.76%	42.58%	36	37
8	南投縣名間鄉	2018-11-24T22:49:22+08:00	12046	3237	15283	1594	16877	28169	59.91%	42.76%	32	37
8	南投縣名間鄉	2018-11-25T00:08:03+08:00	14224	3820	18044	1911	19955	33408	59.73%	42.58%	37	37
8	南投縣名間鄉	2018-11-25T03:42:47+08:00	14224	3820	18044	1911	19955	33408	59.73%	42.58%	37	37
8	南投縣名間鄉	2018-11-24T22:53:13+08:00	12046	3237	15283	1594	16877	28169	59.91%	42.76%	32	37
8	南投縣名間鄉	2018-11-24T23:46:02+08:00	14224	3820	18044	1911	19955	33408	59.73%	42.58%	37	37
8	南投縣名間鄉	2018-11-25T01:11:05+08:00	14224	3820	18044	1911	19955	33408	59.73%	42.58%	37	37
8	南投縣名間鄉	2018-11-24T23:29:45+08:00	13683	3683	17366	1838	19204	32134	59.76%	42.58%	36	37
8	南投縣名間鄉	2018-11-25T06:07:21+08:00	14224	3820	18044	1911	19955	33408	59.73%	42.58%	37	37
8	南投縣名間鄉	2018-11-25T06:22:43+08:00	14224	3820	18044	1911	19955	33408	59.73%	42.58%	37	37
8	南投縣名間鄉	2018-11-25T00:17:06+08:00	14224	3820	18044	1911	19955	33408	59.73%	42.58%	37	37
8	南投縣名間鄉	2018-11-24T22:25:23+08:00	10115	2735	12850	1356	14206	23777	59.75%	42.54%	28	37
8	南投縣名間鄉	2018-11-25T00:12:43+08:00	14224	3820	18044	1911	19955	33408	59.73%	42.58%	37	37
8	南投縣名間鄉	2018-11-24T22:14:47+08:00	9649	2607	12256	1299	13555	22722	59.66%	42.47%	27	37
8	南投縣名間鄉	2018-11-24T22:18:18+08:00	9649	2607	12256	1299	13555	22722	59.66%	42.47%	27	37
8	南投縣名間鄉	2018-11-25T06:27:54+08:00	14224	3820	18044	1911	19955	33408	59.73%	42.58%	37	37
8	南投縣名間鄉	2018-11-24T23:50:13+08:00	14224	3820	18044	1911	19955	33408	59.73%	42.58%	37	37
8	南投縣名間鄉	2018-11-25T01:16:20+08:00	14224	3820	18044	1911	19955	33408	59.73%	42.58%	37	37
8	南投縣名間鄉	2018-11-25T01:05:57+08:00	14224	3820	18044	1911	19955	33408	59.73%	42.58%	37	37
8	南投縣名間鄉	2018-11-24T22:28:39+08:00	10115	2735	12850	1356	14206	23777	59.75%	42.54%	28	37
8	南投縣名間鄉	2018-11-24T23:18:26+08:00	13683	3683	17366	1838	19204	32134	59.76%	42.58%	36	37
8	雲林縣口湖鄉	2018-11-24T22:39:08+08:00	5993	1989	7982	1268	9250	20147	45.91%	29.75%	22	25
8	雲林縣口湖鄉	2018-11-24T23:07:18+08:00	7192	2367	9559	1578	11137	24193	46.03%	29.73%	25	25
8	雲林縣口湖鄉	2018-11-24T22:56:36+08:00	6710	2208	8918	1389	10307	22685	45.44%	29.58%	24	25
8	雲林縣口湖鄉	2018-11-25T01:24:24+08:00	7192	2367	9559	1578	11137	24193	46.03%	29.73%	25	25
8	雲林縣口湖鄉	2018-11-25T03:54:40+08:00	7192	2367	9559	1578	11137	24193	46.03%	29.73%	25	25
8	雲林縣口湖鄉	2018-11-25T03:37:29+08:00	7192	2367	9559	1578	11137	24193	46.03%	29.73%	25	25
8	雲林縣口湖鄉	2018-11-24T22:32:18+08:00	5993	1989	7982	1268	9250	20147	45.91%	29.75%	22	25
8	雲林縣口湖鄉	2018-11-25T03:30:58+08:00	7192	2367	9559	1578	11137	24193	46.03%	29.73%	25	25
8	雲林縣口湖鄉	2018-11-24T23:42:01+08:00	7192	2367	9559	1578	11137	24193	46.03%	29.73%	25	25
8	雲林縣口湖鄉	2018-11-25T03:48:29+08:00	7192	2367	9559	1578	11137	24193	46.03%	29.73%	25	25
8	雲林縣口湖鄉	2018-11-24T22:21:45+08:00	5993	1989	7982	1268	9250	20147	45.91%	29.75%	22	25
8	雲林縣口湖鄉	2018-11-25T06:07:22+08:00	7192	2367	9559	1578	11137	24193	46.03%	29.73%	25	25
8	雲林縣口湖鄉	2018-11-25T00:21:44+08:00	7192	2367	9559	1578	11137	24193	46.03%	29.73%	25	25
8	雲林縣口湖鄉	2018-11-24T23:29:46+08:00	7192	2367	9559	1578	11137	24193	46.03%	29.73%	25	25
8	雲林縣口湖鄉	2018-11-24T22:40:18+08:00	5993	1989	7982	1268	9250	20147	45.91%	29.75%	22	25
8	雲林縣口湖鄉	2018-11-25T04:01:29+08:00	7192	2367	9559	1578	11137	24193	46.03%	29.73%	25	25
8	雲林縣口湖鄉	2018-11-24T23:00:16+08:00	6710	2208	8918	1389	10307	22685	45.44%	29.58%	24	25
8	雲林縣口湖鄉	2018-11-25T01:11:07+08:00	7192	2367	9559	1578	11137	24193	46.03%	29.73%	25	25
8	雲林縣口湖鄉	2018-11-24T23:37:48+08:00	7192	2367	9559	1578	11137	24193	46.03%	29.73%	25	25
8	雲林縣口湖鄉	2018-11-24T22:43:50+08:00	5993	1989	7982	1268	9250	20147	45.91%	29.75%	22	25
8	雲林縣口湖鄉	2018-11-25T00:56:13+08:00	7192	2367	9559	1578	11137	24193	46.03%	29.73%	25	25
8	雲林縣口湖鄉	2018-11-24T23:54:27+08:00	7192	2367	9559	1578	11137	24193	46.03%	29.73%	25	25
8	雲林縣口湖鄉	2018-11-25T00:03:34+08:00	7192	2367	9559	1578	11137	24193	46.03%	29.73%	25	25
8	雲林縣口湖鄉	2018-11-24T22:35:44+08:00	5993	1989	7982	1268	9250	20147	45.91%	29.75%	22	25
8	雲林縣口湖鄉	2018-11-25T01:01:01+08:00	7192	2367	9559	1578	11137	24193	46.03%	29.73%	25	25
8	雲林縣口湖鄉	2018-11-24T23:22:23+08:00	7192	2367	9559	1578	11137	24193	46.03%	29.73%	25	25
8	雲林縣口湖鄉	2018-11-25T06:17:35+08:00	7192	2367	9559	1578	11137	24193	46.03%	29.73%	25	25
8	雲林縣口湖鄉	2018-11-24T22:49:23+08:00	6710	2208	8918	1389	10307	22685	45.44%	29.58%	24	25
8	雲林縣口湖鄉	2018-11-24T23:03:47+08:00	7192	2367	9559	1578	11137	24193	46.03%	29.73%	25	25
8	雲林縣口湖鄉	2018-11-24T23:10:55+08:00	7192	2367	9559	1578	11137	24193	46.03%	29.73%	25	25
8	雲林縣口湖鄉	2018-11-24T23:33:50+08:00	7192	2367	9559	1578	11137	24193	46.03%	29.73%	25	25
8	雲林縣口湖鄉	2018-11-24T22:12:02+08:00	5266	1783	7049	1094	8143	17497	46.54%	30.1%	20	25
8	雲林縣口湖鄉	2018-11-25T00:08:04+08:00	7192	2367	9559	1578	11137	24193	46.03%	29.73%	25	25
8	雲林縣口湖鄉	2018-11-24T22:53:14+08:00	6710	2208	8918	1389	10307	22685	45.44%	29.58%	24	25
8	雲林縣口湖鄉	2018-11-25T03:42:48+08:00	7192	2367	9559	1578	11137	24193	46.03%	29.73%	25	25
8	雲林縣口湖鄉	2018-11-24T23:46:03+08:00	7192	2367	9559	1578	11137	24193	46.03%	29.73%	25	25
8	雲林縣口湖鄉	2018-11-25T00:17:07+08:00	7192	2367	9559	1578	11137	24193	46.03%	29.73%	25	25
8	雲林縣口湖鄉	2018-11-24T22:25:25+08:00	5993	1989	7982	1268	9250	20147	45.91%	29.75%	22	25
8	雲林縣口湖鄉	2018-11-25T06:22:44+08:00	7192	2367	9559	1578	11137	24193	46.03%	29.73%	25	25
8	雲林縣口湖鄉	2018-11-25T06:12:36+08:00	7192	2367	9559	1578	11137	24193	46.03%	29.73%	25	25
8	雲林縣口湖鄉	2018-11-25T01:05:58+08:00	7192	2367	9559	1578	11137	24193	46.03%	29.73%	25	25
8	雲林縣口湖鄉	2018-11-25T00:12:44+08:00	7192	2367	9559	1578	11137	24193	46.03%	29.73%	25	25
8	雲林縣口湖鄉	2018-11-24T23:26:06+08:00	7192	2367	9559	1578	11137	24193	46.03%	29.73%	25	25
8	雲林縣口湖鄉	2018-11-24T23:18:27+08:00	7192	2367	9559	1578	11137	24193	46.03%	29.73%	25	25
8	雲林縣口湖鄉	2018-11-24T23:50:14+08:00	7192	2367	9559	1578	11137	24193	46.03%	29.73%	25	25
8	雲林縣口湖鄉	2018-11-24T23:14:40+08:00	7192	2367	9559	1578	11137	24193	46.03%	29.73%	25	25
8	雲林縣口湖鄉	2018-11-24T22:18:19+08:00	5647	1890	7537	1128	8665	18934	45.76%	29.82%	21	25
8	雲林縣口湖鄉	2018-11-24T23:58:42+08:00	7192	2367	9559	1578	11137	24193	46.03%	29.73%	25	25
8	雲林縣口湖鄉	2018-11-25T06:27:55+08:00	7192	2367	9559	1578	11137	24193	46.03%	29.73%	25	25
8	雲林縣口湖鄉	2018-11-24T22:28:39+08:00	5993	1989	7982	1268	9250	20147	45.91%	29.75%	22	25
8	雲林縣口湖鄉	2018-11-24T22:14:48+08:00	5266	1783	7049	1094	8143	17497	46.54%	30.1%	20	25
8	雲林縣口湖鄉	2018-11-25T01:16:21+08:00	7192	2367	9559	1578	11137	24193	46.03%	29.73%	25	25
8	雲林縣莿桐鄉	2018-11-24T22:39:08+08:00	8258	2862	11120	1524	12644	23298	54.27%	35.45%	21	22
8	雲林縣莿桐鄉	2018-11-25T03:37:28+08:00	8735	3012	11747	1614	13361	24570	54.38%	35.55%	22	22
8	雲林縣莿桐鄉	2018-11-25T01:24:23+08:00	8735	3012	11747	1614	13361	24570	54.38%	35.55%	22	22
8	雲林縣莿桐鄉	2018-11-24T23:07:17+08:00	8735	3012	11747	1614	13361	24570	54.38%	35.55%	22	22
8	雲林縣莿桐鄉	2018-11-24T22:12:01+08:00	6030	2129	8159	1139	9298	16884	55.07%	35.71%	16	22
8	雲林縣莿桐鄉	2018-11-24T22:32:17+08:00	7767	2707	10474	1446	11920	21809	54.66%	35.61%	20	22
8	雲林縣莿桐鄉	2018-11-25T03:30:58+08:00	8735	3012	11747	1614	13361	24570	54.38%	35.55%	22	22
8	雲林縣莿桐鄉	2018-11-24T23:42:01+08:00	8735	3012	11747	1614	13361	24570	54.38%	35.55%	22	22
8	雲林縣莿桐鄉	2018-11-25T03:48:29+08:00	8735	3012	11747	1614	13361	24570	54.38%	35.55%	22	22
8	雲林縣莿桐鄉	2018-11-24T22:21:45+08:00	6381	2256	8637	1215	9852	17869	55.13%	35.71%	17	22
8	雲林縣莿桐鄉	2018-11-25T06:07:22+08:00	8735	3012	11747	1614	13361	24570	54.38%	35.55%	22	22
8	雲林縣莿桐鄉	2018-11-25T04:01:28+08:00	8735	3012	11747	1614	13361	24570	54.38%	35.55%	22	22
8	雲林縣莿桐鄉	2018-11-25T00:21:43+08:00	8735	3012	11747	1614	13361	24570	54.38%	35.55%	22	22
8	雲林縣莿桐鄉	2018-11-25T01:11:06+08:00	8735	3012	11747	1614	13361	24570	54.38%	35.55%	22	22
8	雲林縣莿桐鄉	2018-11-24T22:40:18+08:00	8258	2862	11120	1524	12644	23298	54.27%	35.45%	21	22
8	雲林縣莿桐鄉	2018-11-24T23:00:16+08:00	8735	3012	11747	1614	13361	24570	54.38%	35.55%	22	22
8	雲林縣莿桐鄉	2018-11-24T23:37:48+08:00	8735	3012	11747	1614	13361	24570	54.38%	35.55%	22	22
8	雲林縣莿桐鄉	2018-11-25T03:54:39+08:00	8735	3012	11747	1614	13361	24570	54.38%	35.55%	22	22
8	雲林縣莿桐鄉	2018-11-25T01:01:00+08:00	8735	3012	11747	1614	13361	24570	54.38%	35.55%	22	22
8	雲林縣莿桐鄉	2018-11-24T23:33:49+08:00	8735	3012	11747	1614	13361	24570	54.38%	35.55%	22	22
8	雲林縣莿桐鄉	2018-11-25T00:03:33+08:00	8735	3012	11747	1614	13361	24570	54.38%	35.55%	22	22
8	雲林縣莿桐鄉	2018-11-24T22:35:44+08:00	7767	2707	10474	1446	11920	21809	54.66%	35.61%	20	22
8	雲林縣莿桐鄉	2018-11-24T23:54:26+08:00	8735	3012	11747	1614	13361	24570	54.38%	35.55%	22	22
8	雲林縣莿桐鄉	2018-11-24T23:58:41+08:00	8735	3012	11747	1614	13361	24570	54.38%	35.55%	22	22
8	雲林縣莿桐鄉	2018-11-25T00:56:12+08:00	8735	3012	11747	1614	13361	24570	54.38%	35.55%	22	22
8	雲林縣莿桐鄉	2018-11-24T22:56:35+08:00	8735	3012	11747	1614	13361	24570	54.38%	35.55%	22	22
8	雲林縣莿桐鄉	2018-11-25T06:17:35+08:00	8735	3012	11747	1614	13361	24570	54.38%	35.55%	22	22
8	雲林縣莿桐鄉	2018-11-24T22:49:23+08:00	8735	3012	11747	1614	13361	24570	54.38%	35.55%	22	22
8	雲林縣莿桐鄉	2018-11-24T23:22:22+08:00	8735	3012	11747	1614	13361	24570	54.38%	35.55%	22	22
8	雲林縣莿桐鄉	2018-11-24T22:43:49+08:00	8258	2862	11120	1524	12644	23298	54.27%	35.45%	21	22
8	雲林縣莿桐鄉	2018-11-24T23:03:46+08:00	8735	3012	11747	1614	13361	24570	54.38%	35.55%	22	22
8	雲林縣莿桐鄉	2018-11-24T23:10:55+08:00	8735	3012	11747	1614	13361	24570	54.38%	35.55%	22	22
8	雲林縣莿桐鄉	2018-11-25T00:08:04+08:00	8735	3012	11747	1614	13361	24570	54.38%	35.55%	22	22
8	雲林縣莿桐鄉	2018-11-25T03:42:47+08:00	8735	3012	11747	1614	13361	24570	54.38%	35.55%	22	22
8	雲林縣莿桐鄉	2018-11-24T22:53:14+08:00	8735	3012	11747	1614	13361	24570	54.38%	35.55%	22	22
8	雲林縣莿桐鄉	2018-11-24T23:46:03+08:00	8735	3012	11747	1614	13361	24570	54.38%	35.55%	22	22
8	雲林縣莿桐鄉	2018-11-25T00:17:07+08:00	8735	3012	11747	1614	13361	24570	54.38%	35.55%	22	22
8	雲林縣莿桐鄉	2018-11-24T23:29:45+08:00	8735	3012	11747	1614	13361	24570	54.38%	35.55%	22	22
8	雲林縣莿桐鄉	2018-11-25T06:22:44+08:00	8735	3012	11747	1614	13361	24570	54.38%	35.55%	22	22
8	雲林縣莿桐鄉	2018-11-25T06:12:36+08:00	8735	3012	11747	1614	13361	24570	54.38%	35.55%	22	22
8	雲林縣莿桐鄉	2018-11-24T22:25:24+08:00	6897	2388	9285	1263	10548	19169	55.03%	35.98%	18	22
8	雲林縣莿桐鄉	2018-11-25T01:05:58+08:00	8735	3012	11747	1614	13361	24570	54.38%	35.55%	22	22
8	雲林縣莿桐鄉	2018-11-25T00:12:44+08:00	8735	3012	11747	1614	13361	24570	54.38%	35.55%	22	22
8	雲林縣莿桐鄉	2018-11-24T23:26:06+08:00	8735	3012	11747	1614	13361	24570	54.38%	35.55%	22	22
8	雲林縣莿桐鄉	2018-11-25T06:27:54+08:00	8735	3012	11747	1614	13361	24570	54.38%	35.55%	22	22
8	雲林縣莿桐鄉	2018-11-24T23:50:14+08:00	8735	3012	11747	1614	13361	24570	54.38%	35.55%	22	22
8	雲林縣莿桐鄉	2018-11-24T23:14:40+08:00	8735	3012	11747	1614	13361	24570	54.38%	35.55%	22	22
8	雲林縣莿桐鄉	2018-11-24T22:18:19+08:00	6030	2129	8159	1139	9298	16884	55.07%	35.71%	16	22
8	雲林縣莿桐鄉	2018-11-24T22:28:39+08:00	7767	2707	10474	1446	11920	21809	54.66%	35.61%	20	22
8	雲林縣莿桐鄉	2018-11-24T22:14:48+08:00	6030	2129	8159	1139	9298	16884	55.07%	35.71%	16	22
8	雲林縣莿桐鄉	2018-11-25T01:16:21+08:00	8735	3012	11747	1614	13361	24570	54.38%	35.55%	22	22
8	雲林縣莿桐鄉	2018-11-24T23:18:26+08:00	8735	3012	11747	1614	13361	24570	54.38%	35.55%	22	22
8	花蓮縣瑞穗鄉	2018-11-24T22:14:51+08:00	1726	496	2222	300	2522	5212	48.39%	33.12%	7	13
8	花蓮縣瑞穗鄉	2018-11-24T23:33:52+08:00	2219	653	2872	372	3244	7055	45.98%	31.45%	9	13
8	花蓮縣瑞穗鄉	2018-11-24T22:28:42+08:00	2103	615	2718	361	3079	6187	49.77%	33.99%	8	13
8	花蓮縣瑞穗鄉	2018-11-24T22:56:38+08:00	2103	615	2718	361	3079	6187	49.77%	33.99%	8	13
8	花蓮縣瑞穗鄉	2018-11-24T23:07:21+08:00	2219	653	2872	372	3244	7055	45.98%	31.45%	9	13
8	花蓮縣瑞穗鄉	2018-11-24T22:49:26+08:00	2103	615	2718	361	3079	6187	49.77%	33.99%	8	13
8	花蓮縣瑞穗鄉	2018-11-24T23:10:58+08:00	2219	653	2872	372	3244	7055	45.98%	31.45%	9	13
8	花蓮縣瑞穗鄉	2018-11-25T06:17:39+08:00	3429	1006	4435	576	5011	10279	48.75%	33.36%	13	13
8	花蓮縣瑞穗鄉	2018-11-24T22:53:17+08:00	2103	615	2718	361	3079	6187	49.77%	33.99%	8	13
8	花蓮縣瑞穗鄉	2018-11-24T23:46:06+08:00	2388	714	3102	396	3498	7601	46.02%	31.42%	10	13
8	花蓮縣瑞穗鄉	2018-11-25T00:08:07+08:00	2733	790	3523	444	3967	8414	47.15%	32.48%	11	13
8	花蓮縣瑞穗鄉	2018-11-24T22:32:20+08:00	2103	615	2718	361	3079	6187	49.77%	33.99%	8	13
8	花蓮縣瑞穗鄉	2018-11-25T00:17:10+08:00	2733	790	3523	444	3967	8414	47.15%	32.48%	11	13
8	花蓮縣瑞穗鄉	2018-11-25T03:48:33+08:00	3429	1006	4435	576	5011	10279	48.75%	33.36%	13	13
8	花蓮縣瑞穗鄉	2018-11-24T23:00:19+08:00	2103	615	2718	361	3079	6187	49.77%	33.99%	8	13
8	花蓮縣瑞穗鄉	2018-11-25T06:07:25+08:00	3429	1006	4435	576	5011	10279	48.75%	33.36%	13	13
8	花蓮縣瑞穗鄉	2018-11-25T06:22:47+08:00	3429	1006	4435	576	5011	10279	48.75%	33.36%	13	13
8	花蓮縣瑞穗鄉	2018-11-25T03:42:51+08:00	3429	1006	4435	576	5011	10279	48.75%	33.36%	13	13
8	花蓮縣瑞穗鄉	2018-11-24T22:25:27+08:00	2103	615	2718	361	3079	6187	49.77%	33.99%	8	13
8	花蓮縣瑞穗鄉	2018-11-24T22:40:21+08:00	2103	615	2718	361	3079	6187	49.77%	33.99%	8	13
8	花蓮縣瑞穗鄉	2018-11-24T23:29:49+08:00	2219	653	2872	372	3244	7055	45.98%	31.45%	9	13
8	花蓮縣瑞穗鄉	2018-11-24T23:50:17+08:00	2388	714	3102	396	3498	7601	46.02%	31.42%	10	13
8	花蓮縣瑞穗鄉	2018-11-24T23:14:43+08:00	2219	653	2872	372	3244	7055	45.98%	31.45%	9	13
8	花蓮縣瑞穗鄉	2018-11-25T01:16:24+08:00	3124	906	4030	506	4536	9416	48.17%	33.18%	12	13
8	花蓮縣瑞穗鄉	2018-11-25T00:12:47+08:00	2733	790	3523	444	3967	8414	47.15%	32.48%	11	13
8	花蓮縣瑞穗鄉	2018-11-24T23:54:29+08:00	2733	790	3523	444	3967	8414	47.15%	32.48%	11	13
8	花蓮縣瑞穗鄉	2018-11-25T06:27:57+08:00	3429	1006	4435	576	5011	10279	48.75%	33.36%	13	13
8	花蓮縣瑞穗鄉	2018-11-24T22:18:22+08:00	1726	496	2222	300	2522	5212	48.39%	33.12%	7	13
8	花蓮縣瑞穗鄉	2018-11-25T03:37:32+08:00	3429	1006	4435	576	5011	10279	48.75%	33.36%	13	13
8	花蓮縣瑞穗鄉	2018-11-25T00:56:15+08:00	2733	790	3523	444	3967	8414	47.15%	32.48%	11	13
8	花蓮縣瑞穗鄉	2018-11-25T01:24:27+08:00	3124	906	4030	506	4536	9416	48.17%	33.18%	12	13
8	花蓮縣瑞穗鄉	2018-11-25T03:54:44+08:00	3429	1006	4435	576	5011	10279	48.75%	33.36%	13	13
8	花蓮縣瑞穗鄉	2018-11-24T23:03:49+08:00	2103	615	2718	361	3079	6187	49.77%	33.99%	8	13
8	花蓮縣瑞穗鄉	2018-11-24T23:22:25+08:00	2219	653	2872	372	3244	7055	45.98%	31.45%	9	13
8	花蓮縣瑞穗鄉	2018-11-24T23:37:51+08:00	2219	653	2872	372	3244	7055	45.98%	31.45%	9	13
8	花蓮縣瑞穗鄉	2018-11-24T22:12:05+08:00	1726	496	2222	300	2522	5212	48.39%	33.12%	7	13
8	花蓮縣瑞穗鄉	2018-11-25T01:06:02+08:00	2733	790	3523	444	3967	8414	47.15%	32.48%	11	13
8	花蓮縣瑞穗鄉	2018-11-24T23:42:04+08:00	2219	653	2872	372	3244	7055	45.98%	31.45%	9	13
8	花蓮縣瑞穗鄉	2018-11-25T01:11:10+08:00	3124	906	4030	506	4536	9416	48.17%	33.18%	12	13
8	花蓮縣瑞穗鄉	2018-11-25T04:01:31+08:00	3429	1006	4435	576	5011	10279	48.75%	33.36%	13	13
8	花蓮縣瑞穗鄉	2018-11-25T06:12:39+08:00	3429	1006	4435	576	5011	10279	48.75%	33.36%	13	13
8	花蓮縣瑞穗鄉	2018-11-24T22:21:48+08:00	2103	615	2718	361	3079	6187	49.77%	33.99%	8	13
8	花蓮縣瑞穗鄉	2018-11-25T00:21:46+08:00	2733	790	3523	444	3967	8414	47.15%	32.48%	11	13
8	花蓮縣瑞穗鄉	2018-11-25T01:01:04+08:00	2733	790	3523	444	3967	8414	47.15%	32.48%	11	13
8	花蓮縣瑞穗鄉	2018-11-24T22:35:46+08:00	2103	615	2718	361	3079	6187	49.77%	33.99%	8	13
8	花蓮縣瑞穗鄉	2018-11-24T22:43:53+08:00	2103	615	2718	361	3079	6187	49.77%	33.99%	8	13
8	花蓮縣瑞穗鄉	2018-11-24T23:18:29+08:00	2219	653	2872	372	3244	7055	45.98%	31.45%	9	13
8	花蓮縣瑞穗鄉	2018-11-24T23:58:45+08:00	2733	790	3523	444	3967	8414	47.15%	32.48%	11	13
8	花蓮縣瑞穗鄉	2018-11-24T22:39:11+08:00	2103	615	2718	361	3079	6187	49.77%	33.99%	8	13
8	花蓮縣瑞穗鄉	2018-11-24T23:26:09+08:00	2219	653	2872	372	3244	7055	45.98%	31.45%	9	13
8	花蓮縣瑞穗鄉	2018-11-25T03:31:02+08:00	3429	1006	4435	576	5011	10279	48.75%	33.36%	13	13
8	花蓮縣瑞穗鄉	2018-11-25T00:03:37+08:00	2733	790	3523	444	3967	8414	47.15%	32.48%	11	13
8	臺中市霧峰區	2018-11-24T22:49:18+08:00	22313	6322	28635	2919	31554	52385	60.23%	42.59%	41	43
8	臺中市霧峰區	2018-11-24T23:14:33+08:00	22820	6472	29292	2985	32277	53652	60.16%	42.53%	42	43
8	臺中市霧峰區	2018-11-24T22:56:31+08:00	22313	6322	28635	2919	31554	52385	60.23%	42.59%	41	43
8	臺中市霧峰區	2018-11-25T00:12:39+08:00	23502	6672	30174	3067	33241	55225	60.19%	42.56%	43	43
8	臺中市霧峰區	2018-11-25T00:03:27+08:00	23502	6672	30174	3067	33241	55225	60.19%	42.56%	43	43
8	臺中市霧峰區	2018-11-25T00:56:07+08:00	23502	6672	30174	3067	33241	55225	60.19%	42.56%	43	43
8	臺中市霧峰區	2018-11-24T23:03:42+08:00	22820	6472	29292	2985	32277	53652	60.16%	42.53%	42	43
8	臺中市霧峰區	2018-11-24T23:10:51+08:00	22820	6472	29292	2985	32277	53652	60.16%	42.53%	42	43
8	臺中市霧峰區	2018-11-25T03:37:18+08:00	23502	6672	30174	3067	33241	55225	60.19%	42.56%	43	43
8	臺中市霧峰區	2018-11-24T22:43:44+08:00	22313	6322	28635	2919	31554	52385	60.23%	42.59%	41	43
8	臺中市霧峰區	2018-11-25T01:10:59+08:00	23502	6672	30174	3067	33241	55225	60.19%	42.56%	43	43
8	臺中市霧峰區	2018-11-24T23:22:17+08:00	23502	6672	30174	3067	33241	55225	60.19%	42.56%	43	43
8	臺中市霧峰區	2018-11-25T06:22:39+08:00	23502	6672	30174	3067	33241	55225	60.19%	42.56%	43	43
8	臺中市霧峰區	2018-11-24T22:25:18+08:00	18595	5272	23867	2496	26363	43931	60.01%	42.33%	35	43
8	臺中市霧峰區	2018-11-24T23:29:40+08:00	23502	6672	30174	3067	33241	55225	60.19%	42.56%	43	43
8	臺中市霧峰區	2018-11-25T00:17:02+08:00	23502	6672	30174	3067	33241	55225	60.19%	42.56%	43	43
8	臺中市霧峰區	2018-11-25T00:07:58+08:00	23502	6672	30174	3067	33241	55225	60.19%	42.56%	43	43
8	臺中市霧峰區	2018-11-25T01:16:15+08:00	23502	6672	30174	3067	33241	55225	60.19%	42.56%	43	43
8	臺中市霧峰區	2018-11-25T01:05:52+08:00	23502	6672	30174	3067	33241	55225	60.19%	42.56%	43	43
8	臺中市霧峰區	2018-11-24T22:14:42+08:00	17909	5080	22989	2423	25412	42271	60.12%	42.37%	34	43
8	臺中市霧峰區	2018-11-24T23:54:19+08:00	23502	6672	30174	3067	33241	55225	60.19%	42.56%	43	43
8	臺中市霧峰區	2018-11-24T22:28:34+08:00	20002	5652	25654	2636	28290	47092	60.07%	42.47%	37	43
8	臺中市霧峰區	2018-11-24T22:18:13+08:00	17909	5080	22989	2423	25412	42271	60.12%	42.37%	34	43
8	臺中市霧峰區	2018-11-25T01:24:17+08:00	23502	6672	30174	3067	33241	55225	60.19%	42.56%	43	43
8	臺中市霧峰區	2018-11-24T22:35:39+08:00	21301	5997	27298	2790	30088	50025	60.15%	42.58%	39	43
8	臺中市霧峰區	2018-11-24T23:50:09+08:00	23502	6672	30174	3067	33241	55225	60.19%	42.56%	43	43
8	臺中市霧峰區	2018-11-24T23:58:35+08:00	23502	6672	30174	3067	33241	55225	60.19%	42.56%	43	43
8	臺中市霧峰區	2018-11-25T06:27:49+08:00	23502	6672	30174	3067	33241	55225	60.19%	42.56%	43	43
8	臺中市霧峰區	2018-11-24T22:39:03+08:00	21847	6169	28016	2850	30866	51391	60.06%	42.51%	40	43
8	臺中市霧峰區	2018-11-24T23:07:13+08:00	22820	6472	29292	2985	32277	53652	60.16%	42.53%	42	43
8	臺中市霧峰區	2018-11-25T01:00:54+08:00	23502	6672	30174	3067	33241	55225	60.19%	42.56%	43	43
8	臺中市霧峰區	2018-11-24T23:00:08+08:00	22313	6322	28635	2919	31554	52385	60.23%	42.59%	41	43
8	臺中市霧峰區	2018-11-25T03:48:22+08:00	23502	6672	30174	3067	33241	55225	60.19%	42.56%	43	43
8	臺中市霧峰區	2018-11-25T00:21:37+08:00	23502	6672	30174	3067	33241	55225	60.19%	42.56%	43	43
8	臺中市霧峰區	2018-11-25T03:30:52+08:00	23502	6672	30174	3067	33241	55225	60.19%	42.56%	43	43
8	臺中市霧峰區	2018-11-25T03:42:41+08:00	23502	6672	30174	3067	33241	55225	60.19%	42.56%	43	43
8	臺中市霧峰區	2018-11-24T22:21:39+08:00	17909	5080	22989	2423	25412	42271	60.12%	42.37%	34	43
8	臺中市霧峰區	2018-11-24T22:32:12+08:00	20594	5834	26428	2722	29150	48434	60.18%	42.52%	38	43
8	臺中市霧峰區	2018-11-24T22:53:08+08:00	22313	6322	28635	2919	31554	52385	60.23%	42.59%	41	43
8	臺中市霧峰區	2018-11-25T04:01:22+08:00	23502	6672	30174	3067	33241	55225	60.19%	42.56%	43	43
8	臺中市霧峰區	2018-11-24T22:11:57+08:00	17909	5080	22989	2423	25412	42271	60.12%	42.37%	34	43
8	臺中市霧峰區	2018-11-24T22:40:13+08:00	22313	6322	28635	2919	31554	52385	60.23%	42.59%	41	43
8	臺中市霧峰區	2018-11-25T06:12:31+08:00	23502	6672	30174	3067	33241	55225	60.19%	42.56%	43	43
8	臺中市霧峰區	2018-11-25T06:07:16+08:00	23502	6672	30174	3067	33241	55225	60.19%	42.56%	43	43
8	臺中市霧峰區	2018-11-24T23:33:44+08:00	23502	6672	30174	3067	33241	55225	60.19%	42.56%	43	43
8	臺中市霧峰區	2018-11-24T23:26:01+08:00	23502	6672	30174	3067	33241	55225	60.19%	42.56%	43	43
8	臺中市霧峰區	2018-11-25T03:54:34+08:00	23502	6672	30174	3067	33241	55225	60.19%	42.56%	43	43
8	臺中市霧峰區	2018-11-24T23:45:58+08:00	23502	6672	30174	3067	33241	55225	60.19%	42.56%	43	43
8	臺中市霧峰區	2018-11-25T06:17:29+08:00	23502	6672	30174	3067	33241	55225	60.19%	42.56%	43	43
8	臺中市霧峰區	2018-11-24T23:41:56+08:00	23502	6672	30174	3067	33241	55225	60.19%	42.56%	43	43
8	臺中市霧峰區	2018-11-24T23:37:43+08:00	23502	6672	30174	3067	33241	55225	60.19%	42.56%	43	43
8	臺中市霧峰區	2018-11-24T23:18:21+08:00	22820	6472	29292	2985	32277	53652	60.16%	42.53%	42	43
8	臺東縣池上鄉	2018-11-24T22:56:38+08:00	2209	673	2882	362	3244	7162	45.29%	30.84%	12	12
8	臺東縣池上鄉	2018-11-24T23:07:21+08:00	2209	673	2882	362	3244	7162	45.29%	30.84%	12	12
8	臺東縣池上鄉	2018-11-24T22:49:26+08:00	1928	591	2519	310	2829	6306	44.86%	30.57%	11	12
8	臺東縣池上鄉	2018-11-24T23:10:58+08:00	2209	673	2882	362	3244	7162	45.29%	30.84%	12	12
8	臺東縣池上鄉	2018-11-24T23:33:53+08:00	2209	673	2882	362	3244	7162	45.29%	30.84%	12	12
8	臺東縣池上鄉	2018-11-24T23:22:26+08:00	2209	673	2882	362	3244	7162	45.29%	30.84%	12	12
8	臺東縣池上鄉	2018-11-24T22:28:43+08:00	1928	591	2519	310	2829	6306	44.86%	30.57%	11	12
8	臺東縣池上鄉	2018-11-24T23:18:30+08:00	2209	673	2882	362	3244	7162	45.29%	30.84%	12	12
8	臺東縣池上鄉	2018-11-25T00:17:11+08:00	2209	673	2882	362	3244	7162	45.29%	30.84%	12	12
8	臺東縣池上鄉	2018-11-24T22:32:21+08:00	1928	591	2519	310	2829	6306	44.86%	30.57%	11	12
8	臺東縣池上鄉	2018-11-24T23:46:06+08:00	2209	673	2882	362	3244	7162	45.29%	30.84%	12	12
8	臺東縣池上鄉	2018-11-25T00:08:07+08:00	2209	673	2882	362	3244	7162	45.29%	30.84%	12	12
8	臺東縣池上鄉	2018-11-24T22:53:18+08:00	1928	591	2519	310	2829	6306	44.86%	30.57%	11	12
8	臺東縣池上鄉	2018-11-25T04:01:32+08:00	2209	673	2882	362	3244	7162	45.29%	30.84%	12	12
8	臺東縣池上鄉	2018-11-25T03:48:34+08:00	2209	673	2882	362	3244	7162	45.29%	30.84%	12	12
8	臺東縣池上鄉	2018-11-24T23:00:19+08:00	2209	673	2882	362	3244	7162	45.29%	30.84%	12	12
8	臺東縣池上鄉	2018-11-25T06:07:25+08:00	2209	673	2882	362	3244	7162	45.29%	30.84%	12	12
8	臺東縣池上鄉	2018-11-24T22:25:28+08:00	1928	591	2519	310	2829	6306	44.86%	30.57%	11	12
8	臺東縣池上鄉	2018-11-25T06:22:47+08:00	2209	673	2882	362	3244	7162	45.29%	30.84%	12	12
8	臺東縣池上鄉	2018-11-25T03:42:51+08:00	2209	673	2882	362	3244	7162	45.29%	30.84%	12	12
8	臺東縣池上鄉	2018-11-24T22:40:21+08:00	1928	591	2519	310	2829	6306	44.86%	30.57%	11	12
8	臺東縣池上鄉	2018-11-24T23:29:49+08:00	2209	673	2882	362	3244	7162	45.29%	30.84%	12	12
8	臺東縣池上鄉	2018-11-24T23:14:44+08:00	2209	673	2882	362	3244	7162	45.29%	30.84%	12	12
8	臺東縣池上鄉	2018-11-24T23:50:17+08:00	2209	673	2882	362	3244	7162	45.29%	30.84%	12	12
8	臺東縣池上鄉	2018-11-25T00:12:47+08:00	2209	673	2882	362	3244	7162	45.29%	30.84%	12	12
8	臺東縣池上鄉	2018-11-25T01:16:25+08:00	2209	673	2882	362	3244	7162	45.29%	30.84%	12	12
8	臺東縣池上鄉	2018-11-24T22:18:22+08:00	1928	591	2519	310	2829	6306	44.86%	30.57%	11	12
8	臺東縣池上鄉	2018-11-25T03:37:32+08:00	2209	673	2882	362	3244	7162	45.29%	30.84%	12	12
8	臺東縣池上鄉	2018-11-25T06:27:58+08:00	2209	673	2882	362	3244	7162	45.29%	30.84%	12	12
8	臺東縣池上鄉	2018-11-25T06:17:40+08:00	2209	673	2882	362	3244	7162	45.29%	30.84%	12	12
8	臺東縣池上鄉	2018-11-25T01:24:27+08:00	2209	673	2882	362	3244	7162	45.29%	30.84%	12	12
8	臺東縣池上鄉	2018-11-25T03:54:44+08:00	2209	673	2882	362	3244	7162	45.29%	30.84%	12	12
8	臺東縣池上鄉	2018-11-24T23:03:49+08:00	2209	673	2882	362	3244	7162	45.29%	30.84%	12	12
8	臺東縣池上鄉	2018-11-24T22:14:52+08:00	1928	591	2519	310	2829	6306	44.86%	30.57%	11	12
8	臺東縣池上鄉	2018-11-24T23:37:51+08:00	2209	673	2882	362	3244	7162	45.29%	30.84%	12	12
8	臺東縣池上鄉	2018-11-24T22:12:05+08:00	1928	591	2519	310	2829	6306	44.86%	30.57%	11	12
8	臺東縣池上鄉	2018-11-24T23:54:30+08:00	2209	673	2882	362	3244	7162	45.29%	30.84%	12	12
8	臺東縣池上鄉	2018-11-25T01:06:02+08:00	2209	673	2882	362	3244	7162	45.29%	30.84%	12	12
8	臺東縣池上鄉	2018-11-24T23:42:04+08:00	2209	673	2882	362	3244	7162	45.29%	30.84%	12	12
8	臺東縣池上鄉	2018-11-25T01:11:10+08:00	2209	673	2882	362	3244	7162	45.29%	30.84%	12	12
8	臺東縣池上鄉	2018-11-25T00:21:47+08:00	2209	673	2882	362	3244	7162	45.29%	30.84%	12	12
8	臺東縣池上鄉	2018-11-25T06:12:39+08:00	2209	673	2882	362	3244	7162	45.29%	30.84%	12	12
8	臺東縣池上鄉	2018-11-24T22:21:49+08:00	1928	591	2519	310	2829	6306	44.86%	30.57%	11	12
8	臺東縣池上鄉	2018-11-25T01:01:04+08:00	2209	673	2882	362	3244	7162	45.29%	30.84%	12	12
8	臺東縣池上鄉	2018-11-25T00:03:38+08:00	2209	673	2882	362	3244	7162	45.29%	30.84%	12	12
8	臺東縣池上鄉	2018-11-24T22:43:53+08:00	1928	591	2519	310	2829	6306	44.86%	30.57%	11	12
8	臺東縣池上鄉	2018-11-24T22:35:47+08:00	1928	591	2519	310	2829	6306	44.86%	30.57%	11	12
8	臺東縣池上鄉	2018-11-24T23:58:45+08:00	2209	673	2882	362	3244	7162	45.29%	30.84%	12	12
8	臺東縣池上鄉	2018-11-25T00:56:16+08:00	2209	673	2882	362	3244	7162	45.29%	30.84%	12	12
8	臺東縣池上鄉	2018-11-24T22:39:11+08:00	1928	591	2519	310	2829	6306	44.86%	30.57%	11	12
8	臺東縣池上鄉	2018-11-24T23:26:09+08:00	2209	673	2882	362	3244	7162	45.29%	30.84%	12	12
8	臺東縣池上鄉	2018-11-25T03:31:02+08:00	2209	673	2882	362	3244	7162	45.29%	30.84%	12	12
8	臺東縣蘭嶼鄉	2018-11-24T23:26:10+08:00	237	102	339	28	367	943	38.92%	25.13%	1	4
8	臺東縣蘭嶼鄉	2018-11-24T22:49:27+08:00	237	102	339	28	367	943	38.92%	25.13%	1	4
8	臺東縣蘭嶼鄉	2018-11-24T23:10:58+08:00	237	102	339	28	367	943	38.92%	25.13%	1	4
8	臺東縣蘭嶼鄉	2018-11-24T23:33:53+08:00	237	102	339	28	367	943	38.92%	25.13%	1	4
8	臺東縣蘭嶼鄉	2018-11-24T22:56:39+08:00	237	102	339	28	367	943	38.92%	25.13%	1	4
8	臺東縣蘭嶼鄉	2018-11-24T23:22:26+08:00	237	102	339	28	367	943	38.92%	25.13%	1	4
8	臺東縣蘭嶼鄉	2018-11-24T22:28:43+08:00	237	102	339	28	367	943	38.92%	25.13%	1	4
8	臺東縣蘭嶼鄉	2018-11-24T23:18:30+08:00	237	102	339	28	367	943	38.92%	25.13%	1	4
8	臺東縣蘭嶼鄉	2018-11-25T00:17:11+08:00	638	277	915	93	1008	2943	34.25%	21.68%	3	4
8	臺東縣蘭嶼鄉	2018-11-24T22:32:21+08:00	237	102	339	28	367	943	38.92%	25.13%	1	4
8	臺東縣蘭嶼鄉	2018-11-24T23:46:06+08:00	237	102	339	28	367	943	38.92%	25.13%	1	4
8	臺東縣蘭嶼鄉	2018-11-25T00:08:07+08:00	638	277	915	93	1008	2943	34.25%	21.68%	3	4
8	臺東縣蘭嶼鄉	2018-11-24T22:53:18+08:00	237	102	339	28	367	943	38.92%	25.13%	1	4
8	臺東縣蘭嶼鄉	2018-11-25T04:01:32+08:00	991	401	1392	140	1532	4181	36.64%	23.7%	4	4
8	臺東縣蘭嶼鄉	2018-11-25T03:48:34+08:00	991	401	1392	140	1532	4181	36.64%	23.7%	4	4
8	臺東縣蘭嶼鄉	2018-11-24T23:00:19+08:00	237	102	339	28	367	943	38.92%	25.13%	1	4
8	臺東縣蘭嶼鄉	2018-11-24T22:25:28+08:00	237	102	339	28	367	943	38.92%	25.13%	1	4
8	臺東縣蘭嶼鄉	2018-11-25T06:22:47+08:00	991	401	1392	140	1532	4181	36.64%	23.7%	4	4
8	臺東縣蘭嶼鄉	2018-11-25T03:42:51+08:00	991	401	1392	140	1532	4181	36.64%	23.7%	4	4
8	臺東縣蘭嶼鄉	2018-11-24T22:40:21+08:00	237	102	339	28	367	943	38.92%	25.13%	1	4
8	臺東縣蘭嶼鄉	2018-11-24T23:29:49+08:00	237	102	339	28	367	943	38.92%	25.13%	1	4
8	臺東縣蘭嶼鄉	2018-11-24T23:14:44+08:00	237	102	339	28	367	943	38.92%	25.13%	1	4
8	臺東縣蘭嶼鄉	2018-11-24T23:50:17+08:00	237	102	339	28	367	943	38.92%	25.13%	1	4
8	臺東縣蘭嶼鄉	2018-11-25T00:12:47+08:00	638	277	915	93	1008	2943	34.25%	21.68%	3	4
8	臺東縣蘭嶼鄉	2018-11-25T03:37:33+08:00	991	401	1392	140	1532	4181	36.64%	23.7%	4	4
8	臺東縣蘭嶼鄉	2018-11-25T01:16:25+08:00	991	401	1392	140	1532	4181	36.64%	23.7%	4	4
8	臺東縣蘭嶼鄉	2018-11-24T23:58:46+08:00	638	277	915	93	1008	2943	34.25%	21.68%	3	4
8	臺東縣蘭嶼鄉	2018-11-24T22:18:22+08:00	237	102	339	28	367	943	38.92%	25.13%	1	4
8	臺東縣蘭嶼鄉	2018-11-24T23:03:50+08:00	237	102	339	28	367	943	38.92%	25.13%	1	4
8	臺東縣蘭嶼鄉	2018-11-24T22:39:12+08:00	237	102	339	28	367	943	38.92%	25.13%	1	4
8	臺東縣蘭嶼鄉	2018-11-25T06:27:58+08:00	991	401	1392	140	1532	4181	36.64%	23.7%	4	4
8	臺東縣蘭嶼鄉	2018-11-25T06:17:40+08:00	991	401	1392	140	1532	4181	36.64%	23.7%	4	4
8	臺東縣蘭嶼鄉	2018-11-25T03:54:44+08:00	991	401	1392	140	1532	4181	36.64%	23.7%	4	4
8	臺東縣蘭嶼鄉	2018-11-24T22:14:52+08:00	237	102	339	28	367	943	38.92%	25.13%	1	4
8	臺東縣蘭嶼鄉	2018-11-25T01:24:28+08:00	991	401	1392	140	1532	4181	36.64%	23.7%	4	4
8	臺東縣蘭嶼鄉	2018-11-24T23:37:51+08:00	237	102	339	28	367	943	38.92%	25.13%	1	4
8	臺東縣蘭嶼鄉	2018-11-24T23:07:22+08:00	237	102	339	28	367	943	38.92%	25.13%	1	4
8	臺東縣蘭嶼鄉	2018-11-24T22:12:05+08:00	237	102	339	28	367	943	38.92%	25.13%	1	4
8	臺東縣蘭嶼鄉	2018-11-24T23:54:30+08:00	465	210	675	54	729	2183	33.39%	21.3%	2	4
8	臺東縣蘭嶼鄉	2018-11-25T06:12:40+08:00	991	401	1392	140	1532	4181	36.64%	23.7%	4	4
8	臺東縣蘭嶼鄉	2018-11-24T23:42:04+08:00	237	102	339	28	367	943	38.92%	25.13%	1	4
8	臺東縣蘭嶼鄉	2018-11-25T01:06:03+08:00	991	401	1392	140	1532	4181	36.64%	23.7%	4	4
8	臺東縣蘭嶼鄉	2018-11-25T01:11:11+08:00	991	401	1392	140	1532	4181	36.64%	23.7%	4	4
8	臺東縣蘭嶼鄉	2018-11-25T00:21:47+08:00	991	401	1392	140	1532	4181	36.64%	23.7%	4	4
8	臺東縣蘭嶼鄉	2018-11-25T06:07:26+08:00	991	401	1392	140	1532	4181	36.64%	23.7%	4	4
8	臺東縣蘭嶼鄉	2018-11-24T22:21:49+08:00	237	102	339	28	367	943	38.92%	25.13%	1	4
8	臺東縣蘭嶼鄉	2018-11-25T00:03:38+08:00	638	277	915	93	1008	2943	34.25%	21.68%	3	4
8	臺東縣蘭嶼鄉	2018-11-24T22:43:53+08:00	237	102	339	28	367	943	38.92%	25.13%	1	4
8	臺東縣蘭嶼鄉	2018-11-24T22:35:47+08:00	237	102	339	28	367	943	38.92%	25.13%	1	4
8	臺東縣蘭嶼鄉	2018-11-25T01:01:05+08:00	991	401	1392	140	1532	4181	36.64%	23.7%	4	4
8	臺東縣蘭嶼鄉	2018-11-25T00:56:16+08:00	991	401	1392	140	1532	4181	36.64%	23.7%	4	4
8	臺東縣蘭嶼鄉	2018-11-25T03:31:02+08:00	991	401	1392	140	1532	4181	36.64%	23.7%	4	4
8	臺南市新化區	2018-11-25T03:37:19+08:00	13258	4349	17607	2058	19665	37296	52.73%	35.55%	37	37
8	臺南市新化區	2018-11-25T00:56:08+08:00	13258	4349	17607	2058	19665	37296	52.73%	35.55%	37	37
8	臺南市新化區	2018-11-24T22:49:18+08:00	13258	4349	17607	2058	19665	37296	52.73%	35.55%	37	37
8	臺南市新化區	2018-11-24T23:14:34+08:00	13258	4349	17607	2058	19665	37296	52.73%	35.55%	37	37
8	臺南市新化區	2018-11-24T22:56:31+08:00	13258	4349	17607	2058	19665	37296	52.73%	35.55%	37	37
8	臺南市新化區	2018-11-25T00:03:27+08:00	13258	4349	17607	2058	19665	37296	52.73%	35.55%	37	37
8	臺南市新化區	2018-11-24T22:43:45+08:00	13258	4349	17607	2058	19665	37296	52.73%	35.55%	37	37
8	臺南市新化區	2018-11-24T23:03:42+08:00	13258	4349	17607	2058	19665	37296	52.73%	35.55%	37	37
8	臺南市新化區	2018-11-24T23:10:51+08:00	13258	4349	17607	2058	19665	37296	52.73%	35.55%	37	37
8	臺南市新化區	2018-11-25T06:17:30+08:00	13258	4349	17607	2058	19665	37296	52.73%	35.55%	37	37
8	臺南市新化區	2018-11-24T23:58:36+08:00	13258	4349	17607	2058	19665	37296	52.73%	35.55%	37	37
8	臺南市新化區	2018-11-24T23:22:17+08:00	13258	4349	17607	2058	19665	37296	52.73%	35.55%	37	37
8	臺南市新化區	2018-11-25T03:42:42+08:00	13258	4349	17607	2058	19665	37296	52.73%	35.55%	37	37
8	臺南市新化區	2018-11-25T06:22:40+08:00	13258	4349	17607	2058	19665	37296	52.73%	35.55%	37	37
8	臺南市新化區	2018-11-24T23:29:41+08:00	13258	4349	17607	2058	19665	37296	52.73%	35.55%	37	37
8	臺南市新化區	2018-11-24T22:25:18+08:00	13258	4349	17607	2058	19665	37296	52.73%	35.55%	37	37
8	臺南市新化區	2018-11-25T01:11:00+08:00	13258	4349	17607	2058	19665	37296	52.73%	35.55%	37	37
8	臺南市新化區	2018-11-25T00:17:02+08:00	13258	4349	17607	2058	19665	37296	52.73%	35.55%	37	37
8	臺南市新化區	2018-11-25T06:12:32+08:00	13258	4349	17607	2058	19665	37296	52.73%	35.55%	37	37
8	臺南市新化區	2018-11-25T00:12:40+08:00	13258	4349	17607	2058	19665	37296	52.73%	35.55%	37	37
8	臺南市新化區	2018-11-24T22:28:35+08:00	13258	4349	17607	2058	19665	37296	52.73%	35.55%	37	37
8	臺南市新化區	2018-11-24T22:14:43+08:00	12623	4135	16758	1992	18750	35734	52.47%	35.32%	36	37
8	臺南市新化區	2018-11-24T23:26:02+08:00	13258	4349	17607	2058	19665	37296	52.73%	35.55%	37	37
8	臺南市新化區	2018-11-24T23:54:20+08:00	13258	4349	17607	2058	19665	37296	52.73%	35.55%	37	37
8	臺南市新化區	2018-11-25T06:27:50+08:00	13258	4349	17607	2058	19665	37296	52.73%	35.55%	37	37
8	臺南市新化區	2018-11-25T00:07:59+08:00	13258	4349	17607	2058	19665	37296	52.73%	35.55%	37	37
8	臺南市新化區	2018-11-24T23:18:22+08:00	13258	4349	17607	2058	19665	37296	52.73%	35.55%	37	37
8	臺南市新化區	2018-11-25T01:05:53+08:00	13258	4349	17607	2058	19665	37296	52.73%	35.55%	37	37
8	臺南市新化區	2018-11-24T22:18:14+08:00	13258	4349	17607	2058	19665	37296	52.73%	35.55%	37	37
8	臺南市新化區	2018-11-25T01:24:18+08:00	13258	4349	17607	2058	19665	37296	52.73%	35.55%	37	37
8	臺南市新化區	2018-11-24T23:50:09+08:00	13258	4349	17607	2058	19665	37296	52.73%	35.55%	37	37
8	臺南市新化區	2018-11-24T22:39:03+08:00	13258	4349	17607	2058	19665	37296	52.73%	35.55%	37	37
8	臺南市新化區	2018-11-24T23:07:13+08:00	13258	4349	17607	2058	19665	37296	52.73%	35.55%	37	37
8	臺南市新化區	2018-11-24T22:32:13+08:00	13258	4349	17607	2058	19665	37296	52.73%	35.55%	37	37
8	臺南市新化區	2018-11-25T03:30:53+08:00	13258	4349	17607	2058	19665	37296	52.73%	35.55%	37	37
8	臺南市新化區	2018-11-25T03:48:23+08:00	13258	4349	17607	2058	19665	37296	52.73%	35.55%	37	37
8	臺南市新化區	2018-11-25T01:00:55+08:00	13258	4349	17607	2058	19665	37296	52.73%	35.55%	37	37
8	臺南市新化區	2018-11-24T23:00:09+08:00	13258	4349	17607	2058	19665	37296	52.73%	35.55%	37	37
8	臺南市新化區	2018-11-25T00:21:38+08:00	13258	4349	17607	2058	19665	37296	52.73%	35.55%	37	37
8	臺南市新化區	2018-11-25T06:07:17+08:00	13258	4349	17607	2058	19665	37296	52.73%	35.55%	37	37
8	臺南市新化區	2018-11-24T22:11:57+08:00	12623	4135	16758	1992	18750	35734	52.47%	35.32%	36	37
8	臺南市新化區	2018-11-24T22:53:09+08:00	13258	4349	17607	2058	19665	37296	52.73%	35.55%	37	37
8	臺南市新化區	2018-11-24T22:40:14+08:00	13258	4349	17607	2058	19665	37296	52.73%	35.55%	37	37
8	臺南市新化區	2018-11-25T04:01:23+08:00	13258	4349	17607	2058	19665	37296	52.73%	35.55%	37	37
8	臺南市新化區	2018-11-24T22:21:40+08:00	13258	4349	17607	2058	19665	37296	52.73%	35.55%	37	37
8	臺南市新化區	2018-11-24T23:41:57+08:00	13258	4349	17607	2058	19665	37296	52.73%	35.55%	37	37
8	臺南市新化區	2018-11-25T01:16:16+08:00	13258	4349	17607	2058	19665	37296	52.73%	35.55%	37	37
8	臺南市新化區	2018-11-24T23:45:58+08:00	13258	4349	17607	2058	19665	37296	52.73%	35.55%	37	37
8	臺南市新化區	2018-11-24T22:35:40+08:00	13258	4349	17607	2058	19665	37296	52.73%	35.55%	37	37
8	臺南市新化區	2018-11-25T03:54:35+08:00	13258	4349	17607	2058	19665	37296	52.73%	35.55%	37	37
8	臺南市新化區	2018-11-24T23:33:45+08:00	13258	4349	17607	2058	19665	37296	52.73%	35.55%	37	37
8	臺南市新化區	2018-11-24T23:37:44+08:00	13258	4349	17607	2058	19665	37296	52.73%	35.55%	37	37
8	臺南市下營區	2018-11-25T03:37:19+08:00	6324	2082	8406	1044	9450	20947	45.11%	30.19%	19	19
8	臺南市下營區	2018-11-24T22:49:18+08:00	6324	2082	8406	1044	9450	20947	45.11%	30.19%	19	19
8	臺南市下營區	2018-11-24T23:14:33+08:00	6324	2082	8406	1044	9450	20947	45.11%	30.19%	19	19
8	臺南市下營區	2018-11-24T22:56:31+08:00	6324	2082	8406	1044	9450	20947	45.11%	30.19%	19	19
8	臺南市下營區	2018-11-25T00:12:39+08:00	6324	2082	8406	1044	9450	20947	45.11%	30.19%	19	19
8	臺南市下營區	2018-11-25T00:03:27+08:00	6324	2082	8406	1044	9450	20947	45.11%	30.19%	19	19
8	臺南市下營區	2018-11-25T00:56:07+08:00	6324	2082	8406	1044	9450	20947	45.11%	30.19%	19	19
8	臺南市下營區	2018-11-24T23:03:42+08:00	6324	2082	8406	1044	9450	20947	45.11%	30.19%	19	19
8	臺南市下營區	2018-11-24T23:10:51+08:00	6324	2082	8406	1044	9450	20947	45.11%	30.19%	19	19
8	臺南市下營區	2018-11-24T22:43:44+08:00	6324	2082	8406	1044	9450	20947	45.11%	30.19%	19	19
8	臺南市下營區	2018-11-25T06:17:30+08:00	6324	2082	8406	1044	9450	20947	45.11%	30.19%	19	19
8	臺南市下營區	2018-11-24T23:58:36+08:00	6324	2082	8406	1044	9450	20947	45.11%	30.19%	19	19
8	臺南市下營區	2018-11-24T23:22:17+08:00	6324	2082	8406	1044	9450	20947	45.11%	30.19%	19	19
8	臺南市下營區	2018-11-25T06:22:40+08:00	6324	2082	8406	1044	9450	20947	45.11%	30.19%	19	19
8	臺南市下營區	2018-11-24T23:29:41+08:00	6324	2082	8406	1044	9450	20947	45.11%	30.19%	19	19
8	臺南市下營區	2018-11-24T22:25:18+08:00	6324	2082	8406	1044	9450	20947	45.11%	30.19%	19	19
8	臺南市下營區	2018-11-25T01:11:00+08:00	6324	2082	8406	1044	9450	20947	45.11%	30.19%	19	19
8	臺南市下營區	2018-11-25T00:17:02+08:00	6324	2082	8406	1044	9450	20947	45.11%	30.19%	19	19
8	臺南市下營區	2018-11-25T00:07:58+08:00	6324	2082	8406	1044	9450	20947	45.11%	30.19%	19	19
8	臺南市下營區	2018-11-25T01:16:15+08:00	6324	2082	8406	1044	9450	20947	45.11%	30.19%	19	19
8	臺南市下營區	2018-11-24T23:26:02+08:00	6324	2082	8406	1044	9450	20947	45.11%	30.19%	19	19
8	臺南市下營區	2018-11-25T01:05:52+08:00	6324	2082	8406	1044	9450	20947	45.11%	30.19%	19	19
8	臺南市下營區	2018-11-24T22:14:42+08:00	6324	2082	8406	1044	9450	20947	45.11%	30.19%	19	19
8	臺南市下營區	2018-11-24T23:54:19+08:00	6324	2082	8406	1044	9450	20947	45.11%	30.19%	19	19
8	臺南市下營區	2018-11-24T22:28:34+08:00	6324	2082	8406	1044	9450	20947	45.11%	30.19%	19	19
8	臺南市下營區	2018-11-24T22:18:14+08:00	6324	2082	8406	1044	9450	20947	45.11%	30.19%	19	19
8	臺南市下營區	2018-11-25T01:24:18+08:00	6324	2082	8406	1044	9450	20947	45.11%	30.19%	19	19
8	臺南市下營區	2018-11-24T22:35:39+08:00	6324	2082	8406	1044	9450	20947	45.11%	30.19%	19	19
8	臺南市下營區	2018-11-24T23:50:09+08:00	6324	2082	8406	1044	9450	20947	45.11%	30.19%	19	19
8	臺南市下營區	2018-11-25T06:27:49+08:00	6324	2082	8406	1044	9450	20947	45.11%	30.19%	19	19
8	臺南市下營區	2018-11-24T22:39:03+08:00	6324	2082	8406	1044	9450	20947	45.11%	30.19%	19	19
8	臺南市下營區	2018-11-24T23:07:13+08:00	6324	2082	8406	1044	9450	20947	45.11%	30.19%	19	19
8	臺南市下營區	2018-11-25T01:00:54+08:00	6324	2082	8406	1044	9450	20947	45.11%	30.19%	19	19
8	臺南市下營區	2018-11-24T22:32:13+08:00	6324	2082	8406	1044	9450	20947	45.11%	30.19%	19	19
8	臺南市下營區	2018-11-25T03:48:23+08:00	6324	2082	8406	1044	9450	20947	45.11%	30.19%	19	19
8	臺南市下營區	2018-11-24T23:00:09+08:00	6324	2082	8406	1044	9450	20947	45.11%	30.19%	19	19
8	臺南市下營區	2018-11-25T00:21:38+08:00	6324	2082	8406	1044	9450	20947	45.11%	30.19%	19	19
8	臺南市下營區	2018-11-25T03:30:52+08:00	6324	2082	8406	1044	9450	20947	45.11%	30.19%	19	19
8	臺南市下營區	2018-11-25T03:42:41+08:00	6324	2082	8406	1044	9450	20947	45.11%	30.19%	19	19
8	臺南市下營區	2018-11-24T22:53:08+08:00	6324	2082	8406	1044	9450	20947	45.11%	30.19%	19	19
8	臺南市下營區	2018-11-25T06:07:17+08:00	6324	2082	8406	1044	9450	20947	45.11%	30.19%	19	19
8	臺南市下營區	2018-11-24T22:11:57+08:00	6324	2082	8406	1044	9450	20947	45.11%	30.19%	19	19
8	臺南市下營區	2018-11-24T22:40:13+08:00	6324	2082	8406	1044	9450	20947	45.11%	30.19%	19	19
8	臺南市下營區	2018-11-25T06:12:31+08:00	6324	2082	8406	1044	9450	20947	45.11%	30.19%	19	19
8	臺南市下營區	2018-11-25T04:01:23+08:00	6324	2082	8406	1044	9450	20947	45.11%	30.19%	19	19
8	臺南市下營區	2018-11-24T22:21:40+08:00	6324	2082	8406	1044	9450	20947	45.11%	30.19%	19	19
8	臺南市下營區	2018-11-24T23:33:44+08:00	6324	2082	8406	1044	9450	20947	45.11%	30.19%	19	19
8	臺南市下營區	2018-11-25T03:54:34+08:00	6324	2082	8406	1044	9450	20947	45.11%	30.19%	19	19
8	臺南市下營區	2018-11-24T23:45:58+08:00	6324	2082	8406	1044	9450	20947	45.11%	30.19%	19	19
8	臺南市下營區	2018-11-24T23:41:56+08:00	6324	2082	8406	1044	9450	20947	45.11%	30.19%	19	19
8	臺南市下營區	2018-11-24T23:37:43+08:00	6324	2082	8406	1044	9450	20947	45.11%	30.19%	19	19
8	臺南市下營區	2018-11-24T23:18:21+08:00	6324	2082	8406	1044	9450	20947	45.11%	30.19%	19	19
8	嘉義縣六腳鄉	2018-11-24T23:07:18+08:00	5473	1859	7332	1019	8351	20821	40.11%	26.29%	30	30
8	嘉義縣六腳鄉	2018-11-24T22:56:36+08:00	5473	1859	7332	1019	8351	20821	40.11%	26.29%	30	30
8	嘉義縣六腳鄉	2018-11-25T01:24:24+08:00	5473	1859	7332	1019	8351	20821	40.11%	26.29%	30	30
8	嘉義縣六腳鄉	2018-11-25T03:54:40+08:00	5473	1859	7332	1019	8351	20821	40.11%	26.29%	30	30
8	嘉義縣六腳鄉	2018-11-25T06:17:36+08:00	5473	1859	7332	1019	8351	20821	40.11%	26.29%	30	30
8	嘉義縣六腳鄉	2018-11-24T23:10:56+08:00	5473	1859	7332	1019	8351	20821	40.11%	26.29%	30	30
8	嘉義縣六腳鄉	2018-11-25T03:37:29+08:00	5473	1859	7332	1019	8351	20821	40.11%	26.29%	30	30
8	嘉義縣六腳鄉	2018-11-24T22:39:09+08:00	5170	1779	6949	967	7916	19621	40.34%	26.35%	29	30
8	嘉義縣六腳鄉	2018-11-25T03:30:59+08:00	5473	1859	7332	1019	8351	20821	40.11%	26.29%	30	30
8	嘉義縣六腳鄉	2018-11-24T22:32:18+08:00	5170	1779	6949	967	7916	19621	40.34%	26.35%	29	30
8	嘉義縣六腳鄉	2018-11-25T03:48:29+08:00	5473	1859	7332	1019	8351	20821	40.11%	26.29%	30	30
8	嘉義縣六腳鄉	2018-11-24T23:00:17+08:00	5473	1859	7332	1019	8351	20821	40.11%	26.29%	30	30
8	嘉義縣六腳鄉	2018-11-25T00:21:44+08:00	5473	1859	7332	1019	8351	20821	40.11%	26.29%	30	30
8	嘉義縣六腳鄉	2018-11-24T23:29:46+08:00	5473	1859	7332	1019	8351	20821	40.11%	26.29%	30	30
8	嘉義縣六腳鄉	2018-11-24T22:40:18+08:00	5170	1779	6949	967	7916	19621	40.34%	26.35%	29	30
8	嘉義縣六腳鄉	2018-11-25T06:07:23+08:00	5473	1859	7332	1019	8351	20821	40.11%	26.29%	30	30
8	嘉義縣六腳鄉	2018-11-25T04:01:29+08:00	5473	1859	7332	1019	8351	20821	40.11%	26.29%	30	30
8	嘉義縣六腳鄉	2018-11-25T01:11:07+08:00	5473	1859	7332	1019	8351	20821	40.11%	26.29%	30	30
8	嘉義縣六腳鄉	2018-11-24T23:37:48+08:00	5473	1859	7332	1019	8351	20821	40.11%	26.29%	30	30
8	嘉義縣六腳鄉	2018-11-24T22:43:50+08:00	5170	1779	6949	967	7916	19621	40.34%	26.35%	29	30
8	嘉義縣六腳鄉	2018-11-25T00:56:13+08:00	5473	1859	7332	1019	8351	20821	40.11%	26.29%	30	30
8	嘉義縣六腳鄉	2018-11-24T23:54:27+08:00	5473	1859	7332	1019	8351	20821	40.11%	26.29%	30	30
8	嘉義縣六腳鄉	2018-11-25T01:16:22+08:00	5473	1859	7332	1019	8351	20821	40.11%	26.29%	30	30
8	嘉義縣六腳鄉	2018-11-25T00:03:34+08:00	5473	1859	7332	1019	8351	20821	40.11%	26.29%	30	30
8	嘉義縣六腳鄉	2018-11-24T22:35:44+08:00	5170	1779	6949	967	7916	19621	40.34%	26.35%	29	30
8	嘉義縣六腳鄉	2018-11-25T01:01:01+08:00	5473	1859	7332	1019	8351	20821	40.11%	26.29%	30	30
8	嘉義縣六腳鄉	2018-11-24T23:22:23+08:00	5473	1859	7332	1019	8351	20821	40.11%	26.29%	30	30
8	嘉義縣六腳鄉	2018-11-24T22:49:24+08:00	5170	1779	6949	967	7916	19621	40.34%	26.35%	29	30
8	嘉義縣六腳鄉	2018-11-24T23:03:47+08:00	5473	1859	7332	1019	8351	20821	40.11%	26.29%	30	30
8	嘉義縣六腳鄉	2018-11-24T22:28:40+08:00	5170	1779	6949	967	7916	19621	40.34%	26.35%	29	30
8	嘉義縣六腳鄉	2018-11-24T23:33:50+08:00	5473	1859	7332	1019	8351	20821	40.11%	26.29%	30	30
8	嘉義縣六腳鄉	2018-11-24T22:12:02+08:00	5170	1779	6949	967	7916	19621	40.34%	26.35%	29	30
8	嘉義縣六腳鄉	2018-11-25T00:08:04+08:00	5473	1859	7332	1019	8351	20821	40.11%	26.29%	30	30
8	嘉義縣六腳鄉	2018-11-24T23:42:02+08:00	5473	1859	7332	1019	8351	20821	40.11%	26.29%	30	30
8	嘉義縣六腳鄉	2018-11-25T03:42:48+08:00	5473	1859	7332	1019	8351	20821	40.11%	26.29%	30	30
8	嘉義縣六腳鄉	2018-11-24T22:53:15+08:00	5170	1779	6949	967	7916	19621	40.34%	26.35%	29	30
8	嘉義縣六腳鄉	2018-11-24T23:46:03+08:00	5473	1859	7332	1019	8351	20821	40.11%	26.29%	30	30
8	嘉義縣六腳鄉	2018-11-25T00:17:07+08:00	5473	1859	7332	1019	8351	20821	40.11%	26.29%	30	30
8	嘉義縣六腳鄉	2018-11-24T22:21:46+08:00	5170	1779	6949	967	7916	19621	40.34%	26.35%	29	30
8	嘉義縣六腳鄉	2018-11-24T22:25:25+08:00	5170	1779	6949	967	7916	19621	40.34%	26.35%	29	30
8	嘉義縣六腳鄉	2018-11-25T06:22:44+08:00	5473	1859	7332	1019	8351	20821	40.11%	26.29%	30	30
8	嘉義縣六腳鄉	2018-11-25T06:12:36+08:00	5473	1859	7332	1019	8351	20821	40.11%	26.29%	30	30
8	嘉義縣六腳鄉	2018-11-24T22:14:49+08:00	5170	1779	6949	967	7916	19621	40.34%	26.35%	29	30
8	嘉義縣六腳鄉	2018-11-24T23:18:27+08:00	5473	1859	7332	1019	8351	20821	40.11%	26.29%	30	30
8	嘉義縣六腳鄉	2018-11-24T22:18:19+08:00	5170	1779	6949	967	7916	19621	40.34%	26.35%	29	30
8	嘉義縣六腳鄉	2018-11-24T23:58:42+08:00	5473	1859	7332	1019	8351	20821	40.11%	26.29%	30	30
8	嘉義縣六腳鄉	2018-11-25T06:27:55+08:00	5473	1859	7332	1019	8351	20821	40.11%	26.29%	30	30
8	嘉義縣六腳鄉	2018-11-24T23:26:07+08:00	5473	1859	7332	1019	8351	20821	40.11%	26.29%	30	30
8	嘉義縣六腳鄉	2018-11-25T00:12:45+08:00	5473	1859	7332	1019	8351	20821	40.11%	26.29%	30	30
8	嘉義縣六腳鄉	2018-11-25T01:05:59+08:00	5473	1859	7332	1019	8351	20821	40.11%	26.29%	30	30
8	嘉義縣六腳鄉	2018-11-24T23:14:41+08:00	5473	1859	7332	1019	8351	20821	40.11%	26.29%	30	30
8	嘉義縣六腳鄉	2018-11-24T23:50:15+08:00	5473	1859	7332	1019	8351	20821	40.11%	26.29%	30	30
8	宜蘭縣頭城鎮	2018-11-24T23:33:52+08:00	9390	2823	12213	1535	13748	25135	54.7%	37.36%	32	32
8	宜蘭縣頭城鎮	2018-11-24T23:10:57+08:00	9390	2823	12213	1535	13748	25135	54.7%	37.36%	32	32
8	宜蘭縣頭城鎮	2018-11-25T06:17:38+08:00	9390	2823	12213	1535	13748	25135	54.7%	37.36%	32	32
8	宜蘭縣頭城鎮	2018-11-24T22:28:42+08:00	9390	2823	12213	1535	13748	25135	54.7%	37.36%	32	32
8	宜蘭縣頭城鎮	2018-11-24T23:07:21+08:00	9390	2823	12213	1535	13748	25135	54.7%	37.36%	32	32
8	宜蘭縣頭城鎮	2018-11-24T22:14:50+08:00	9390	2823	12213	1535	13748	25135	54.7%	37.36%	32	32
8	宜蘭縣頭城鎮	2018-11-24T22:56:37+08:00	9390	2823	12213	1535	13748	25135	54.7%	37.36%	32	32
8	宜蘭縣頭城鎮	2018-11-24T22:53:17+08:00	9390	2823	12213	1535	13748	25135	54.7%	37.36%	32	32
8	宜蘭縣頭城鎮	2018-11-25T01:06:01+08:00	9390	2823	12213	1535	13748	25135	54.7%	37.36%	32	32
8	宜蘭縣頭城鎮	2018-11-24T22:32:20+08:00	9390	2823	12213	1535	13748	25135	54.7%	37.36%	32	32
8	宜蘭縣頭城鎮	2018-11-25T00:17:10+08:00	9390	2823	12213	1535	13748	25135	54.7%	37.36%	32	32
8	宜蘭縣頭城鎮	2018-11-25T00:08:06+08:00	9390	2823	12213	1535	13748	25135	54.7%	37.36%	32	32
8	宜蘭縣頭城鎮	2018-11-25T03:48:33+08:00	9390	2823	12213	1535	13748	25135	54.7%	37.36%	32	32
8	宜蘭縣頭城鎮	2018-11-24T23:29:48+08:00	9390	2823	12213	1535	13748	25135	54.7%	37.36%	32	32
8	宜蘭縣頭城鎮	2018-11-24T22:40:20+08:00	9390	2823	12213	1535	13748	25135	54.7%	37.36%	32	32
8	宜蘭縣頭城鎮	2018-11-25T06:22:46+08:00	9390	2823	12213	1535	13748	25135	54.7%	37.36%	32	32
8	宜蘭縣頭城鎮	2018-11-25T06:07:24+08:00	9390	2823	12213	1535	13748	25135	54.7%	37.36%	32	32
8	宜蘭縣頭城鎮	2018-11-24T23:00:18+08:00	9390	2823	12213	1535	13748	25135	54.7%	37.36%	32	32
8	宜蘭縣頭城鎮	2018-11-24T22:25:27+08:00	9390	2823	12213	1535	13748	25135	54.7%	37.36%	32	32
8	宜蘭縣頭城鎮	2018-11-25T03:42:50+08:00	9390	2823	12213	1535	13748	25135	54.7%	37.36%	32	32
8	宜蘭縣頭城鎮	2018-11-25T01:11:09+08:00	9390	2823	12213	1535	13748	25135	54.7%	37.36%	32	32
8	宜蘭縣頭城鎮	2018-11-25T01:16:24+08:00	9390	2823	12213	1535	13748	25135	54.7%	37.36%	32	32
8	宜蘭縣頭城鎮	2018-11-25T06:27:57+08:00	9390	2823	12213	1535	13748	25135	54.7%	37.36%	32	32
8	宜蘭縣頭城鎮	2018-11-25T03:31:01+08:00	9390	2823	12213	1535	13748	25135	54.7%	37.36%	32	32
8	宜蘭縣頭城鎮	2018-11-24T23:14:42+08:00	9390	2823	12213	1535	13748	25135	54.7%	37.36%	32	32
8	宜蘭縣頭城鎮	2018-11-24T23:50:16+08:00	9390	2823	12213	1535	13748	25135	54.7%	37.36%	32	32
8	宜蘭縣頭城鎮	2018-11-25T00:56:15+08:00	9390	2823	12213	1535	13748	25135	54.7%	37.36%	32	32
8	宜蘭縣頭城鎮	2018-11-25T00:12:46+08:00	9390	2823	12213	1535	13748	25135	54.7%	37.36%	32	32
8	宜蘭縣頭城鎮	2018-11-24T23:54:28+08:00	9390	2823	12213	1535	13748	25135	54.7%	37.36%	32	32
8	宜蘭縣頭城鎮	2018-11-24T23:37:50+08:00	9390	2823	12213	1535	13748	25135	54.7%	37.36%	32	32
8	宜蘭縣頭城鎮	2018-11-25T03:54:43+08:00	9390	2823	12213	1535	13748	25135	54.7%	37.36%	32	32
8	宜蘭縣頭城鎮	2018-11-24T22:12:04+08:00	9390	2823	12213	1535	13748	25135	54.7%	37.36%	32	32
8	宜蘭縣頭城鎮	2018-11-24T23:22:25+08:00	9390	2823	12213	1535	13748	25135	54.7%	37.36%	32	32
8	宜蘭縣頭城鎮	2018-11-25T01:24:26+08:00	9390	2823	12213	1535	13748	25135	54.7%	37.36%	32	32
8	宜蘭縣頭城鎮	2018-11-24T23:03:48+08:00	9390	2823	12213	1535	13748	25135	54.7%	37.36%	32	32
8	宜蘭縣頭城鎮	2018-11-24T22:49:25+08:00	9390	2823	12213	1535	13748	25135	54.7%	37.36%	32	32
8	宜蘭縣頭城鎮	2018-11-24T23:42:03+08:00	9390	2823	12213	1535	13748	25135	54.7%	37.36%	32	32
8	宜蘭縣頭城鎮	2018-11-24T23:46:05+08:00	9390	2823	12213	1535	13748	25135	54.7%	37.36%	32	32
8	宜蘭縣頭城鎮	2018-11-25T04:01:31+08:00	9390	2823	12213	1535	13748	25135	54.7%	37.36%	32	32
8	宜蘭縣頭城鎮	2018-11-24T22:21:48+08:00	9390	2823	12213	1535	13748	25135	54.7%	37.36%	32	32
8	宜蘭縣頭城鎮	2018-11-25T06:12:38+08:00	9390	2823	12213	1535	13748	25135	54.7%	37.36%	32	32
8	宜蘭縣頭城鎮	2018-11-25T00:21:46+08:00	9390	2823	12213	1535	13748	25135	54.7%	37.36%	32	32
8	宜蘭縣頭城鎮	2018-11-25T01:01:03+08:00	9390	2823	12213	1535	13748	25135	54.7%	37.36%	32	32
8	宜蘭縣頭城鎮	2018-11-24T22:39:10+08:00	9390	2823	12213	1535	13748	25135	54.7%	37.36%	32	32
8	宜蘭縣頭城鎮	2018-11-24T23:26:08+08:00	9390	2823	12213	1535	13748	25135	54.7%	37.36%	32	32
8	宜蘭縣頭城鎮	2018-11-24T22:35:46+08:00	9390	2823	12213	1535	13748	25135	54.7%	37.36%	32	32
8	宜蘭縣頭城鎮	2018-11-24T23:58:44+08:00	9390	2823	12213	1535	13748	25135	54.7%	37.36%	32	32
8	宜蘭縣頭城鎮	2018-11-24T23:18:29+08:00	9390	2823	12213	1535	13748	25135	54.7%	37.36%	32	32
8	宜蘭縣頭城鎮	2018-11-25T03:37:31+08:00	9390	2823	12213	1535	13748	25135	54.7%	37.36%	32	32
8	宜蘭縣頭城鎮	2018-11-24T22:18:21+08:00	9390	2823	12213	1535	13748	25135	54.7%	37.36%	32	32
8	宜蘭縣頭城鎮	2018-11-25T00:03:37+08:00	9390	2823	12213	1535	13748	25135	54.7%	37.36%	32	32
8	宜蘭縣頭城鎮	2018-11-24T22:43:52+08:00	9390	2823	12213	1535	13748	25135	54.7%	37.36%	32	32
8	嘉義縣阿里山鄉	2018-11-24T23:07:18+08:00	1539	369	1908	133	2041	4691	43.51%	32.81%	13	13
8	嘉義縣阿里山鄉	2018-11-24T22:56:36+08:00	1539	369	1908	133	2041	4691	43.51%	32.81%	13	13
8	嘉義縣阿里山鄉	2018-11-25T06:17:36+08:00	1539	369	1908	133	2041	4691	43.51%	32.81%	13	13
8	嘉義縣阿里山鄉	2018-11-24T23:10:56+08:00	1539	369	1908	133	2041	4691	43.51%	32.81%	13	13
8	嘉義縣阿里山鄉	2018-11-25T03:37:29+08:00	1539	369	1908	133	2041	4691	43.51%	32.81%	13	13
8	嘉義縣阿里山鄉	2018-11-24T22:39:09+08:00	1539	369	1908	133	2041	4691	43.51%	32.81%	13	13
8	嘉義縣阿里山鄉	2018-11-25T01:24:25+08:00	1539	369	1908	133	2041	4691	43.51%	32.81%	13	13
8	嘉義縣阿里山鄉	2018-11-25T03:54:41+08:00	1539	369	1908	133	2041	4691	43.51%	32.81%	13	13
8	嘉義縣阿里山鄉	2018-11-25T03:30:59+08:00	1539	369	1908	133	2041	4691	43.51%	32.81%	13	13
8	嘉義縣阿里山鄉	2018-11-24T22:32:18+08:00	1151	271	1422	114	1536	3430	44.78%	33.56%	11	13
8	嘉義縣阿里山鄉	2018-11-24T23:00:17+08:00	1539	369	1908	133	2041	4691	43.51%	32.81%	13	13
8	嘉義縣阿里山鄉	2018-11-25T00:21:44+08:00	1539	369	1908	133	2041	4691	43.51%	32.81%	13	13
8	嘉義縣阿里山鄉	2018-11-24T23:29:46+08:00	1539	369	1908	133	2041	4691	43.51%	32.81%	13	13
8	嘉義縣阿里山鄉	2018-11-25T06:07:23+08:00	1539	369	1908	133	2041	4691	43.51%	32.81%	13	13
8	嘉義縣阿里山鄉	2018-11-25T04:01:29+08:00	1539	369	1908	133	2041	4691	43.51%	32.81%	13	13
8	嘉義縣阿里山鄉	2018-11-25T01:11:07+08:00	1539	369	1908	133	2041	4691	43.51%	32.81%	13	13
8	嘉義縣阿里山鄉	2018-11-24T22:40:19+08:00	1539	369	1908	133	2041	4691	43.51%	32.81%	13	13
8	嘉義縣阿里山鄉	2018-11-24T22:43:50+08:00	1539	369	1908	133	2041	4691	43.51%	32.81%	13	13
8	嘉義縣阿里山鄉	2018-11-25T00:03:35+08:00	1539	369	1908	133	2041	4691	43.51%	32.81%	13	13
8	嘉義縣阿里山鄉	2018-11-25T00:56:13+08:00	1539	369	1908	133	2041	4691	43.51%	32.81%	13	13
8	嘉義縣阿里山鄉	2018-11-24T23:54:27+08:00	1539	369	1908	133	2041	4691	43.51%	32.81%	13	13
8	嘉義縣阿里山鄉	2018-11-24T22:35:45+08:00	1218	291	1509	121	1630	3721	43.81%	32.73%	12	13
8	嘉義縣阿里山鄉	2018-11-25T01:16:22+08:00	1539	369	1908	133	2041	4691	43.51%	32.81%	13	13
8	嘉義縣阿里山鄉	2018-11-24T23:37:49+08:00	1539	369	1908	133	2041	4691	43.51%	32.81%	13	13
8	嘉義縣阿里山鄉	2018-11-24T23:22:23+08:00	1539	369	1908	133	2041	4691	43.51%	32.81%	13	13
8	嘉義縣阿里山鄉	2018-11-24T22:49:24+08:00	1539	369	1908	133	2041	4691	43.51%	32.81%	13	13
8	嘉義縣阿里山鄉	2018-11-24T22:12:03+08:00	1044	243	1287	92	1379	3184	43.31%	32.79%	10	13
8	嘉義縣阿里山鄉	2018-11-24T23:03:47+08:00	1539	369	1908	133	2041	4691	43.51%	32.81%	13	13
8	嘉義縣阿里山鄉	2018-11-24T22:28:40+08:00	1151	271	1422	114	1536	3430	44.78%	33.56%	11	13
8	嘉義縣阿里山鄉	2018-11-24T23:33:50+08:00	1539	369	1908	133	2041	4691	43.51%	32.81%	13	13
8	嘉義縣阿里山鄉	2018-11-24T23:42:02+08:00	1539	369	1908	133	2041	4691	43.51%	32.81%	13	13
8	嘉義縣阿里山鄉	2018-11-25T00:08:05+08:00	1539	369	1908	133	2041	4691	43.51%	32.81%	13	13
8	嘉義縣阿里山鄉	2018-11-25T03:42:48+08:00	1539	369	1908	133	2041	4691	43.51%	32.81%	13	13
8	嘉義縣阿里山鄉	2018-11-24T22:53:15+08:00	1539	369	1908	133	2041	4691	43.51%	32.81%	13	13
8	嘉義縣阿里山鄉	2018-11-24T23:46:04+08:00	1539	369	1908	133	2041	4691	43.51%	32.81%	13	13
8	嘉義縣阿里山鄉	2018-11-25T06:12:37+08:00	1539	369	1908	133	2041	4691	43.51%	32.81%	13	13
8	嘉義縣阿里山鄉	2018-11-24T22:21:46+08:00	1044	243	1287	92	1379	3184	43.31%	32.79%	10	13
8	嘉義縣阿里山鄉	2018-11-24T22:25:25+08:00	1044	243	1287	92	1379	3184	43.31%	32.79%	10	13
8	嘉義縣阿里山鄉	2018-11-25T00:17:08+08:00	1539	369	1908	133	2041	4691	43.51%	32.81%	13	13
8	嘉義縣阿里山鄉	2018-11-25T06:22:45+08:00	1539	369	1908	133	2041	4691	43.51%	32.81%	13	13
8	嘉義縣阿里山鄉	2018-11-25T03:48:31+08:00	1539	369	1908	133	2041	4691	43.51%	32.81%	13	13
8	嘉義縣阿里山鄉	2018-11-24T22:14:49+08:00	1044	243	1287	92	1379	3184	43.31%	32.79%	10	13
8	嘉義縣阿里山鄉	2018-11-24T22:18:20+08:00	1044	243	1287	92	1379	3184	43.31%	32.79%	10	13
8	嘉義縣阿里山鄉	2018-11-24T23:18:27+08:00	1539	369	1908	133	2041	4691	43.51%	32.81%	13	13
8	嘉義縣阿里山鄉	2018-11-24T23:58:42+08:00	1539	369	1908	133	2041	4691	43.51%	32.81%	13	13
8	嘉義縣阿里山鄉	2018-11-25T06:27:55+08:00	1539	369	1908	133	2041	4691	43.51%	32.81%	13	13
8	嘉義縣阿里山鄉	2018-11-24T23:26:07+08:00	1539	369	1908	133	2041	4691	43.51%	32.81%	13	13
8	嘉義縣阿里山鄉	2018-11-25T00:12:45+08:00	1539	369	1908	133	2041	4691	43.51%	32.81%	13	13
8	嘉義縣阿里山鄉	2018-11-25T01:01:02+08:00	1539	369	1908	133	2041	4691	43.51%	32.81%	13	13
8	嘉義縣阿里山鄉	2018-11-25T01:05:59+08:00	1539	369	1908	133	2041	4691	43.51%	32.81%	13	13
8	嘉義縣阿里山鄉	2018-11-24T23:14:41+08:00	1539	369	1908	133	2041	4691	43.51%	32.81%	13	13
8	嘉義縣阿里山鄉	2018-11-24T23:50:15+08:00	1539	369	1908	133	2041	4691	43.51%	32.81%	13	13
8	新竹縣芎林鄉	2018-11-24T22:39:06+08:00	5128	1450	6578	517	7095	11921	59.52%	43.02%	14	19
8	新竹縣芎林鄉	2018-11-24T23:03:44+08:00	5840	1686	7526	595	8121	13533	60.01%	43.15%	16	19
8	新竹縣芎林鄉	2018-11-24T23:22:20+08:00	5840	1686	7526	595	8121	13533	60.01%	43.15%	16	19
8	新竹縣芎林鄉	2018-11-24T23:58:39+08:00	6815	1946	8761	677	9438	15939	59.21%	42.76%	18	19
8	新竹縣芎林鄉	2018-11-24T22:49:21+08:00	5583	1603	7186	566	7752	12999	59.64%	42.95%	15	19
8	新竹縣芎林鄉	2018-11-24T23:46:01+08:00	6815	1946	8761	677	9438	15939	59.21%	42.76%	18	19
8	新竹縣芎林鄉	2018-11-25T01:00:57+08:00	7308	2084	9392	721	10113	17293	58.48%	42.26%	19	19
8	新竹縣芎林鄉	2018-11-25T03:48:26+08:00	7308	2084	9392	721	10113	17293	58.48%	42.26%	19	19
8	新竹縣芎林鄉	2018-11-24T22:53:11+08:00	5583	1603	7186	566	7752	12999	59.64%	42.95%	15	19
8	新竹縣芎林鄉	2018-11-25T03:42:45+08:00	7308	2084	9392	721	10113	17293	58.48%	42.26%	19	19
8	新竹縣芎林鄉	2018-11-25T00:08:01+08:00	6815	1946	8761	677	9438	15939	59.21%	42.76%	18	19
8	新竹縣芎林鄉	2018-11-25T04:01:26+08:00	7308	2084	9392	721	10113	17293	58.48%	42.26%	19	19
8	新竹縣芎林鄉	2018-11-24T22:25:21+08:00	4459	1258	5717	463	6180	10375	59.57%	42.98%	12	19
8	新竹縣芎林鄉	2018-11-25T06:12:34+08:00	7308	2084	9392	721	10113	17293	58.48%	42.26%	19	19
8	新竹縣芎林鄉	2018-11-24T22:40:16+08:00	5128	1450	6578	517	7095	11921	59.52%	43.02%	14	19
8	新竹縣芎林鄉	2018-11-24T22:21:43+08:00	4459	1258	5717	463	6180	10375	59.57%	42.98%	12	19
8	新竹縣芎林鄉	2018-11-25T00:17:05+08:00	7308	2084	9392	721	10113	17293	58.48%	42.26%	19	19
8	新竹縣芎林鄉	2018-11-24T23:18:24+08:00	5840	1686	7526	595	8121	13533	60.01%	43.15%	16	19
8	新竹縣芎林鄉	2018-11-24T23:37:46+08:00	6815	1946	8761	677	9438	15939	59.21%	42.76%	18	19
8	新竹縣芎林鄉	2018-11-24T22:35:42+08:00	4965	1387	6352	500	6852	11504	59.56%	43.16%	13	19
8	新竹縣芎林鄉	2018-11-25T03:54:37+08:00	7308	2084	9392	721	10113	17293	58.48%	42.26%	19	19
8	新竹縣芎林鄉	2018-11-24T23:33:47+08:00	6815	1946	8761	677	9438	15939	59.21%	42.76%	18	19
8	新竹縣芎林鄉	2018-11-25T01:05:55+08:00	7308	2084	9392	721	10113	17293	58.48%	42.26%	19	19
8	新竹縣芎林鄉	2018-11-24T23:26:04+08:00	6371	1818	8189	652	8841	14845	59.56%	42.92%	17	19
8	新竹縣芎林鄉	2018-11-24T22:14:45+08:00	4459	1258	5717	463	6180	10375	59.57%	42.98%	12	19
8	新竹縣芎林鄉	2018-11-24T23:07:15+08:00	5840	1686	7526	595	8121	13533	60.01%	43.15%	16	19
8	新竹縣芎林鄉	2018-11-24T23:14:37+08:00	5840	1686	7526	595	8121	13533	60.01%	43.15%	16	19
8	新竹縣芎林鄉	2018-11-24T23:10:53+08:00	5840	1686	7526	595	8121	13533	60.01%	43.15%	16	19
8	新竹縣芎林鄉	2018-11-25T06:17:33+08:00	7308	2084	9392	721	10113	17293	58.48%	42.26%	19	19
8	新竹縣芎林鄉	2018-11-24T22:43:47+08:00	5128	1450	6578	517	7095	11921	59.52%	43.02%	14	19
8	新竹縣芎林鄉	2018-11-24T22:56:33+08:00	5583	1603	7186	566	7752	12999	59.64%	42.95%	15	19
8	新竹縣芎林鄉	2018-11-25T01:24:21+08:00	7308	2084	9392	721	10113	17293	58.48%	42.26%	19	19
8	新竹縣芎林鄉	2018-11-25T03:37:23+08:00	7308	2084	9392	721	10113	17293	58.48%	42.26%	19	19
8	新竹縣芎林鄉	2018-11-25T03:30:55+08:00	7308	2084	9392	721	10113	17293	58.48%	42.26%	19	19
8	新竹縣芎林鄉	2018-11-24T22:32:15+08:00	4965	1387	6352	500	6852	11504	59.56%	43.16%	13	19
8	新竹縣芎林鄉	2018-11-24T22:11:59+08:00	4016	1143	5159	443	5602	9394	59.63%	42.75%	11	19
8	新竹縣芎林鄉	2018-11-24T23:00:14+08:00	5583	1603	7186	566	7752	12999	59.64%	42.95%	15	19
8	新竹縣芎林鄉	2018-11-25T06:07:19+08:00	7308	2084	9392	721	10113	17293	58.48%	42.26%	19	19
8	新竹縣芎林鄉	2018-11-25T01:11:03+08:00	7308	2084	9392	721	10113	17293	58.48%	42.26%	19	19
8	新竹縣芎林鄉	2018-11-24T23:29:43+08:00	6371	1818	8189	652	8841	14845	59.56%	42.92%	17	19
8	新竹縣芎林鄉	2018-11-25T00:21:41+08:00	7308	2084	9392	721	10113	17293	58.48%	42.26%	19	19
8	新竹縣芎林鄉	2018-11-25T06:22:42+08:00	7308	2084	9392	721	10113	17293	58.48%	42.26%	19	19
8	新竹縣芎林鄉	2018-11-25T00:56:10+08:00	7308	2084	9392	721	10113	17293	58.48%	42.26%	19	19
8	新竹縣芎林鄉	2018-11-24T22:18:16+08:00	4459	1258	5717	463	6180	10375	59.57%	42.98%	12	19
8	新竹縣芎林鄉	2018-11-24T23:54:24+08:00	6815	1946	8761	677	9438	15939	59.21%	42.76%	18	19
8	新竹縣芎林鄉	2018-11-24T23:41:59+08:00	6815	1946	8761	677	9438	15939	59.21%	42.76%	18	19
8	新竹縣芎林鄉	2018-11-25T01:16:18+08:00	7308	2084	9392	721	10113	17293	58.48%	42.26%	19	19
8	新竹縣芎林鄉	2018-11-25T06:27:52+08:00	7308	2084	9392	721	10113	17293	58.48%	42.26%	19	19
8	新竹縣芎林鄉	2018-11-25T00:12:42+08:00	7308	2084	9392	721	10113	17293	58.48%	42.26%	19	19
8	新竹縣芎林鄉	2018-11-24T22:28:37+08:00	4459	1258	5717	463	6180	10375	59.57%	42.98%	12	19
8	新竹縣芎林鄉	2018-11-25T00:03:30+08:00	6815	1946	8761	677	9438	15939	59.21%	42.76%	18	19
8	新竹縣芎林鄉	2018-11-24T23:50:12+08:00	6815	1946	8761	677	9438	15939	59.21%	42.76%	18	19
8	苗栗縣泰安鄉	2018-11-25T03:37:26+08:00	2425	688	3113	254	3367	5180	65%	46.81%	10	10
8	苗栗縣泰安鄉	2018-11-24T23:07:16+08:00	2425	688	3113	254	3367	5180	65%	46.81%	10	10
8	苗栗縣泰安鄉	2018-11-24T22:12:00+08:00	2065	607	2672	249	2921	4591	63.62%	44.98%	9	10
8	苗栗縣泰安鄉	2018-11-24T22:39:07+08:00	2065	607	2672	249	2921	4591	63.62%	44.98%	9	10
8	苗栗縣泰安鄉	2018-11-24T23:03:45+08:00	2425	688	3113	254	3367	5180	65%	46.81%	10	10
8	苗栗縣泰安鄉	2018-11-24T23:22:21+08:00	2425	688	3113	254	3367	5180	65%	46.81%	10	10
8	苗栗縣泰安鄉	2018-11-25T01:24:22+08:00	2425	688	3113	254	3367	5180	65%	46.81%	10	10
8	苗栗縣泰安鄉	2018-11-24T23:46:01+08:00	2425	688	3113	254	3367	5180	65%	46.81%	10	10
8	苗栗縣泰安鄉	2018-11-24T23:42:00+08:00	2425	688	3113	254	3367	5180	65%	46.81%	10	10
8	苗栗縣泰安鄉	2018-11-25T03:30:56+08:00	2425	688	3113	254	3367	5180	65%	46.81%	10	10
8	苗栗縣泰安鄉	2018-11-25T03:42:45+08:00	2425	688	3113	254	3367	5180	65%	46.81%	10	10
8	苗栗縣泰安鄉	2018-11-24T22:32:16+08:00	2065	607	2672	249	2921	4591	63.62%	44.98%	9	10
8	苗栗縣泰安鄉	2018-11-25T03:48:27+08:00	2425	688	3113	254	3367	5180	65%	46.81%	10	10
8	苗栗縣泰安鄉	2018-11-25T01:00:58+08:00	2425	688	3113	254	3367	5180	65%	46.81%	10	10
8	苗栗縣泰安鄉	2018-11-24T22:25:21+08:00	2065	607	2672	249	2921	4591	63.62%	44.98%	9	10
8	苗栗縣泰安鄉	2018-11-25T04:01:27+08:00	2425	688	3113	254	3367	5180	65%	46.81%	10	10
8	苗栗縣泰安鄉	2018-11-24T22:21:43+08:00	2065	607	2672	249	2921	4591	63.62%	44.98%	9	10
8	苗栗縣泰安鄉	2018-11-24T22:40:17+08:00	2065	607	2672	249	2921	4591	63.62%	44.98%	9	10
8	苗栗縣泰安鄉	2018-11-25T00:21:42+08:00	2425	688	3113	254	3367	5180	65%	46.81%	10	10
8	苗栗縣泰安鄉	2018-11-25T06:12:35+08:00	2425	688	3113	254	3367	5180	65%	46.81%	10	10
8	苗栗縣泰安鄉	2018-11-24T22:35:42+08:00	2065	607	2672	249	2921	4591	63.62%	44.98%	9	10
8	苗栗縣泰安鄉	2018-11-24T23:58:40+08:00	2425	688	3113	254	3367	5180	65%	46.81%	10	10
8	苗栗縣泰安鄉	2018-11-24T23:26:05+08:00	2425	688	3113	254	3367	5180	65%	46.81%	10	10
8	苗栗縣泰安鄉	2018-11-24T23:37:47+08:00	2425	688	3113	254	3367	5180	65%	46.81%	10	10
8	苗栗縣泰安鄉	2018-11-24T23:18:25+08:00	2425	688	3113	254	3367	5180	65%	46.81%	10	10
8	苗栗縣泰安鄉	2018-11-24T23:33:48+08:00	2425	688	3113	254	3367	5180	65%	46.81%	10	10
8	苗栗縣泰安鄉	2018-11-25T03:54:38+08:00	2425	688	3113	254	3367	5180	65%	46.81%	10	10
8	苗栗縣泰安鄉	2018-11-24T22:43:48+08:00	2065	607	2672	249	2921	4591	63.62%	44.98%	9	10
8	苗栗縣泰安鄉	2018-11-24T23:10:54+08:00	2425	688	3113	254	3367	5180	65%	46.81%	10	10
8	苗栗縣泰安鄉	2018-11-25T06:17:34+08:00	2425	688	3113	254	3367	5180	65%	46.81%	10	10
8	苗栗縣泰安鄉	2018-11-24T22:56:34+08:00	2065	607	2672	249	2921	4591	63.62%	44.98%	9	10
8	苗栗縣泰安鄉	2018-11-24T23:14:38+08:00	2425	688	3113	254	3367	5180	65%	46.81%	10	10
8	苗栗縣泰安鄉	2018-11-24T22:49:22+08:00	2065	607	2672	249	2921	4591	63.62%	44.98%	9	10
8	苗栗縣泰安鄉	2018-11-25T00:08:02+08:00	2425	688	3113	254	3367	5180	65%	46.81%	10	10
8	苗栗縣泰安鄉	2018-11-24T22:53:12+08:00	2065	607	2672	249	2921	4591	63.62%	44.98%	9	10
8	苗栗縣泰安鄉	2018-11-25T06:22:43+08:00	2425	688	3113	254	3367	5180	65%	46.81%	10	10
8	苗栗縣泰安鄉	2018-11-24T23:29:44+08:00	2425	688	3113	254	3367	5180	65%	46.81%	10	10
8	苗栗縣泰安鄉	2018-11-25T00:17:06+08:00	2425	688	3113	254	3367	5180	65%	46.81%	10	10
8	苗栗縣泰安鄉	2018-11-25T01:11:04+08:00	2425	688	3113	254	3367	5180	65%	46.81%	10	10
8	苗栗縣泰安鄉	2018-11-25T06:07:20+08:00	2425	688	3113	254	3367	5180	65%	46.81%	10	10
8	苗栗縣泰安鄉	2018-11-24T23:00:15+08:00	2425	688	3113	254	3367	5180	65%	46.81%	10	10
8	苗栗縣泰安鄉	2018-11-25T00:12:43+08:00	2425	688	3113	254	3367	5180	65%	46.81%	10	10
8	苗栗縣泰安鄉	2018-11-24T22:28:38+08:00	2065	607	2672	249	2921	4591	63.62%	44.98%	9	10
8	苗栗縣泰安鄉	2018-11-25T06:27:53+08:00	2425	688	3113	254	3367	5180	65%	46.81%	10	10
8	苗栗縣泰安鄉	2018-11-24T23:50:13+08:00	2425	688	3113	254	3367	5180	65%	46.81%	10	10
8	苗栗縣泰安鄉	2018-11-25T00:03:31+08:00	2425	688	3113	254	3367	5180	65%	46.81%	10	10
8	苗栗縣泰安鄉	2018-11-24T23:54:25+08:00	2425	688	3113	254	3367	5180	65%	46.81%	10	10
8	苗栗縣泰安鄉	2018-11-25T01:05:57+08:00	2425	688	3113	254	3367	5180	65%	46.81%	10	10
8	苗栗縣泰安鄉	2018-11-24T22:14:46+08:00	2065	607	2672	249	2921	4591	63.62%	44.98%	9	10
8	苗栗縣泰安鄉	2018-11-25T00:56:11+08:00	2425	688	3113	254	3367	5180	65%	46.81%	10	10
8	苗栗縣泰安鄉	2018-11-24T22:18:17+08:00	2065	607	2672	249	2921	4591	63.62%	44.98%	9	10
8	苗栗縣泰安鄉	2018-11-25T01:16:19+08:00	2425	688	3113	254	3367	5180	65%	46.81%	10	10
8	基隆市仁愛區	2018-11-24T23:10:59+08:00	13573	4225	17798	1682	19480	36738	53.02%	36.95%	35	35
8	基隆市仁愛區	2018-11-24T23:22:27+08:00	13573	4225	17798	1682	19480	36738	53.02%	36.95%	35	35
8	基隆市仁愛區	2018-11-24T23:18:31+08:00	13573	4225	17798	1682	19480	36738	53.02%	36.95%	35	35
8	基隆市仁愛區	2018-11-24T22:49:28+08:00	13573	4225	17798	1682	19480	36738	53.02%	36.95%	35	35
8	基隆市仁愛區	2018-11-24T23:33:54+08:00	13573	4225	17798	1682	19480	36738	53.02%	36.95%	35	35
8	基隆市仁愛區	2018-11-24T22:12:06+08:00	11932	3686	15618	1459	17077	32212	53.01%	37.04%	31	35
8	基隆市仁愛區	2018-11-24T23:26:11+08:00	13573	4225	17798	1682	19480	36738	53.02%	36.95%	35	35
8	基隆市仁愛區	2018-11-24T22:28:44+08:00	13573	4225	17798	1682	19480	36738	53.02%	36.95%	35	35
8	基隆市仁愛區	2018-11-24T23:37:52+08:00	13573	4225	17798	1682	19480	36738	53.02%	36.95%	35	35
8	基隆市仁愛區	2018-11-24T22:53:19+08:00	13573	4225	17798	1682	19480	36738	53.02%	36.95%	35	35
8	基隆市仁愛區	2018-11-24T22:21:50+08:00	13573	4225	17798	1682	19480	36738	53.02%	36.95%	35	35
8	基隆市仁愛區	2018-11-25T04:01:33+08:00	13573	4225	17798	1682	19480	36738	53.02%	36.95%	35	35
8	基隆市仁愛區	2018-11-25T00:08:09+08:00	13573	4225	17798	1682	19480	36738	53.02%	36.95%	35	35
8	基隆市仁愛區	2018-11-24T23:46:07+08:00	13573	4225	17798	1682	19480	36738	53.02%	36.95%	35	35
8	基隆市仁愛區	2018-11-25T01:11:12+08:00	13573	4225	17798	1682	19480	36738	53.02%	36.95%	35	35
8	基隆市仁愛區	2018-11-24T23:00:20+08:00	13573	4225	17798	1682	19480	36738	53.02%	36.95%	35	35
8	基隆市仁愛區	2018-11-24T22:25:29+08:00	13573	4225	17798	1682	19480	36738	53.02%	36.95%	35	35
8	基隆市仁愛區	2018-11-25T06:22:48+08:00	13573	4225	17798	1682	19480	36738	53.02%	36.95%	35	35
8	基隆市仁愛區	2018-11-25T03:48:35+08:00	13573	4225	17798	1682	19480	36738	53.02%	36.95%	35	35
8	基隆市仁愛區	2018-11-25T06:27:59+08:00	13573	4225	17798	1682	19480	36738	53.02%	36.95%	35	35
8	基隆市仁愛區	2018-11-25T06:17:41+08:00	13573	4225	17798	1682	19480	36738	53.02%	36.95%	35	35
8	基隆市仁愛區	2018-11-24T22:39:13+08:00	13573	4225	17798	1682	19480	36738	53.02%	36.95%	35	35
8	基隆市仁愛區	2018-11-25T03:37:34+08:00	13573	4225	17798	1682	19480	36738	53.02%	36.95%	35	35
8	基隆市仁愛區	2018-11-25T00:12:49+08:00	13573	4225	17798	1682	19480	36738	53.02%	36.95%	35	35
8	基隆市仁愛區	2018-11-24T22:18:23+08:00	13573	4225	17798	1682	19480	36738	53.02%	36.95%	35	35
8	基隆市仁愛區	2018-11-24T23:50:18+08:00	13573	4225	17798	1682	19480	36738	53.02%	36.95%	35	35
8	基隆市仁愛區	2018-11-24T23:14:45+08:00	13573	4225	17798	1682	19480	36738	53.02%	36.95%	35	35
8	基隆市仁愛區	2018-11-24T23:58:46+08:00	13573	4225	17798	1682	19480	36738	53.02%	36.95%	35	35
8	基隆市仁愛區	2018-11-24T22:56:40+08:00	13573	4225	17798	1682	19480	36738	53.02%	36.95%	35	35
8	基隆市仁愛區	2018-11-24T23:03:50+08:00	13573	4225	17798	1682	19480	36738	53.02%	36.95%	35	35
8	基隆市仁愛區	2018-11-25T01:01:06+08:00	13573	4225	17798	1682	19480	36738	53.02%	36.95%	35	35
8	基隆市仁愛區	2018-11-25T01:24:29+08:00	13573	4225	17798	1682	19480	36738	53.02%	36.95%	35	35
8	基隆市仁愛區	2018-11-24T23:54:31+08:00	13573	4225	17798	1682	19480	36738	53.02%	36.95%	35	35
8	基隆市仁愛區	2018-11-24T23:07:23+08:00	13573	4225	17798	1682	19480	36738	53.02%	36.95%	35	35
8	基隆市仁愛區	2018-11-25T03:54:45+08:00	13573	4225	17798	1682	19480	36738	53.02%	36.95%	35	35
8	基隆市仁愛區	2018-11-25T00:03:40+08:00	13573	4225	17798	1682	19480	36738	53.02%	36.95%	35	35
8	基隆市仁愛區	2018-11-24T22:14:53+08:00	12794	3982	16776	1583	18359	34584	53.09%	36.99%	33	35
8	基隆市仁愛區	2018-11-25T06:12:40+08:00	13573	4225	17798	1682	19480	36738	53.02%	36.95%	35	35
8	基隆市仁愛區	2018-11-24T23:29:50+08:00	13573	4225	17798	1682	19480	36738	53.02%	36.95%	35	35
8	基隆市仁愛區	2018-11-25T00:17:12+08:00	13573	4225	17798	1682	19480	36738	53.02%	36.95%	35	35
8	基隆市仁愛區	2018-11-24T22:32:22+08:00	13573	4225	17798	1682	19480	36738	53.02%	36.95%	35	35
8	基隆市仁愛區	2018-11-24T23:42:05+08:00	13573	4225	17798	1682	19480	36738	53.02%	36.95%	35	35
8	基隆市仁愛區	2018-11-25T01:06:04+08:00	13573	4225	17798	1682	19480	36738	53.02%	36.95%	35	35
8	基隆市仁愛區	2018-11-25T03:42:52+08:00	13573	4225	17798	1682	19480	36738	53.02%	36.95%	35	35
8	基隆市仁愛區	2018-11-24T22:40:22+08:00	13573	4225	17798	1682	19480	36738	53.02%	36.95%	35	35
8	基隆市仁愛區	2018-11-25T00:21:48+08:00	13573	4225	17798	1682	19480	36738	53.02%	36.95%	35	35
8	基隆市仁愛區	2018-11-25T06:07:27+08:00	13573	4225	17798	1682	19480	36738	53.02%	36.95%	35	35
8	基隆市仁愛區	2018-11-25T00:56:17+08:00	13573	4225	17798	1682	19480	36738	53.02%	36.95%	35	35
8	基隆市仁愛區	2018-11-24T22:35:48+08:00	13573	4225	17798	1682	19480	36738	53.02%	36.95%	35	35
8	基隆市仁愛區	2018-11-24T22:43:54+08:00	13573	4225	17798	1682	19480	36738	53.02%	36.95%	35	35
8	基隆市仁愛區	2018-11-25T03:31:03+08:00	13573	4225	17798	1682	19480	36738	53.02%	36.95%	35	35
8	基隆市仁愛區	2018-11-25T01:16:26+08:00	13573	4225	17798	1682	19480	36738	53.02%	36.95%	35	35
8	苗栗縣大湖鄉	2018-11-24T23:07:16+08:00	4829	1347	6176	566	6742	12653	53.28%	38.16%	15	15
8	苗栗縣大湖鄉	2018-11-24T22:12:00+08:00	4829	1347	6176	566	6742	12653	53.28%	38.16%	15	15
8	苗栗縣大湖鄉	2018-11-24T22:39:06+08:00	4829	1347	6176	566	6742	12653	53.28%	38.16%	15	15
8	苗栗縣大湖鄉	2018-11-24T23:58:39+08:00	4829	1347	6176	566	6742	12653	53.28%	38.16%	15	15
8	苗栗縣大湖鄉	2018-11-24T23:03:45+08:00	4829	1347	6176	566	6742	12653	53.28%	38.16%	15	15
8	苗栗縣大湖鄉	2018-11-24T22:49:21+08:00	4829	1347	6176	566	6742	12653	53.28%	38.16%	15	15
8	苗栗縣大湖鄉	2018-11-24T23:22:21+08:00	4829	1347	6176	566	6742	12653	53.28%	38.16%	15	15
8	苗栗縣大湖鄉	2018-11-25T01:24:22+08:00	4829	1347	6176	566	6742	12653	53.28%	38.16%	15	15
8	苗栗縣大湖鄉	2018-11-24T23:46:01+08:00	4829	1347	6176	566	6742	12653	53.28%	38.16%	15	15
8	苗栗縣大湖鄉	2018-11-25T03:48:26+08:00	4829	1347	6176	566	6742	12653	53.28%	38.16%	15	15
8	苗栗縣大湖鄉	2018-11-25T03:30:56+08:00	4829	1347	6176	566	6742	12653	53.28%	38.16%	15	15
8	苗栗縣大湖鄉	2018-11-25T03:42:45+08:00	4829	1347	6176	566	6742	12653	53.28%	38.16%	15	15
8	苗栗縣大湖鄉	2018-11-24T22:32:16+08:00	4829	1347	6176	566	6742	12653	53.28%	38.16%	15	15
8	苗栗縣大湖鄉	2018-11-25T01:00:58+08:00	4829	1347	6176	566	6742	12653	53.28%	38.16%	15	15
8	苗栗縣大湖鄉	2018-11-24T22:25:21+08:00	4829	1347	6176	566	6742	12653	53.28%	38.16%	15	15
8	苗栗縣大湖鄉	2018-11-25T06:12:34+08:00	4829	1347	6176	566	6742	12653	53.28%	38.16%	15	15
8	苗栗縣大湖鄉	2018-11-24T22:40:16+08:00	4829	1347	6176	566	6742	12653	53.28%	38.16%	15	15
8	苗栗縣大湖鄉	2018-11-25T04:01:27+08:00	4829	1347	6176	566	6742	12653	53.28%	38.16%	15	15
8	苗栗縣大湖鄉	2018-11-24T22:21:43+08:00	4829	1347	6176	566	6742	12653	53.28%	38.16%	15	15
8	苗栗縣大湖鄉	2018-11-25T00:17:05+08:00	4829	1347	6176	566	6742	12653	53.28%	38.16%	15	15
8	苗栗縣大湖鄉	2018-11-25T00:21:42+08:00	4829	1347	6176	566	6742	12653	53.28%	38.16%	15	15
8	苗栗縣大湖鄉	2018-11-24T23:37:46+08:00	4829	1347	6176	566	6742	12653	53.28%	38.16%	15	15
8	苗栗縣大湖鄉	2018-11-24T22:35:42+08:00	4829	1347	6176	566	6742	12653	53.28%	38.16%	15	15
8	苗栗縣大湖鄉	2018-11-24T23:33:47+08:00	4829	1347	6176	566	6742	12653	53.28%	38.16%	15	15
8	苗栗縣大湖鄉	2018-11-24T23:18:25+08:00	4829	1347	6176	566	6742	12653	53.28%	38.16%	15	15
8	苗栗縣大湖鄉	2018-11-24T23:26:04+08:00	4829	1347	6176	566	6742	12653	53.28%	38.16%	15	15
8	苗栗縣大湖鄉	2018-11-25T03:54:38+08:00	4829	1347	6176	566	6742	12653	53.28%	38.16%	15	15
8	苗栗縣大湖鄉	2018-11-25T03:37:25+08:00	4829	1347	6176	566	6742	12653	53.28%	38.16%	15	15
8	苗栗縣大湖鄉	2018-11-24T23:10:54+08:00	4829	1347	6176	566	6742	12653	53.28%	38.16%	15	15
8	苗栗縣大湖鄉	2018-11-24T23:14:37+08:00	4829	1347	6176	566	6742	12653	53.28%	38.16%	15	15
8	苗栗縣大湖鄉	2018-11-25T06:17:33+08:00	4829	1347	6176	566	6742	12653	53.28%	38.16%	15	15
8	苗栗縣大湖鄉	2018-11-24T22:43:47+08:00	4829	1347	6176	566	6742	12653	53.28%	38.16%	15	15
8	苗栗縣大湖鄉	2018-11-24T22:56:34+08:00	4829	1347	6176	566	6742	12653	53.28%	38.16%	15	15
8	苗栗縣大湖鄉	2018-11-25T00:08:02+08:00	4829	1347	6176	566	6742	12653	53.28%	38.16%	15	15
8	苗栗縣大湖鄉	2018-11-24T22:53:12+08:00	4829	1347	6176	566	6742	12653	53.28%	38.16%	15	15
8	苗栗縣大湖鄉	2018-11-25T01:11:04+08:00	4829	1347	6176	566	6742	12653	53.28%	38.16%	15	15
8	苗栗縣大湖鄉	2018-11-24T23:29:43+08:00	4829	1347	6176	566	6742	12653	53.28%	38.16%	15	15
8	苗栗縣大湖鄉	2018-11-25T06:22:42+08:00	4829	1347	6176	566	6742	12653	53.28%	38.16%	15	15
8	苗栗縣大湖鄉	2018-11-25T06:07:20+08:00	4829	1347	6176	566	6742	12653	53.28%	38.16%	15	15
8	苗栗縣大湖鄉	2018-11-24T23:00:15+08:00	4829	1347	6176	566	6742	12653	53.28%	38.16%	15	15
8	苗栗縣大湖鄉	2018-11-25T01:05:56+08:00	4829	1347	6176	566	6742	12653	53.28%	38.16%	15	15
8	苗栗縣大湖鄉	2018-11-24T23:41:59+08:00	4829	1347	6176	566	6742	12653	53.28%	38.16%	15	15
8	苗栗縣大湖鄉	2018-11-25T00:03:31+08:00	4829	1347	6176	566	6742	12653	53.28%	38.16%	15	15
8	苗栗縣大湖鄉	2018-11-24T23:54:25+08:00	4829	1347	6176	566	6742	12653	53.28%	38.16%	15	15
8	苗栗縣大湖鄉	2018-11-24T22:14:46+08:00	4829	1347	6176	566	6742	12653	53.28%	38.16%	15	15
8	苗栗縣大湖鄉	2018-11-25T06:27:52+08:00	4829	1347	6176	566	6742	12653	53.28%	38.16%	15	15
8	苗栗縣大湖鄉	2018-11-25T00:56:11+08:00	4829	1347	6176	566	6742	12653	53.28%	38.16%	15	15
8	苗栗縣大湖鄉	2018-11-24T22:18:17+08:00	4829	1347	6176	566	6742	12653	53.28%	38.16%	15	15
8	苗栗縣大湖鄉	2018-11-25T00:12:42+08:00	4829	1347	6176	566	6742	12653	53.28%	38.16%	15	15
8	苗栗縣大湖鄉	2018-11-24T22:28:37+08:00	4829	1347	6176	566	6742	12653	53.28%	38.16%	15	15
8	苗栗縣大湖鄉	2018-11-25T01:16:19+08:00	4829	1347	6176	566	6742	12653	53.28%	38.16%	15	15
8	苗栗縣大湖鄉	2018-11-24T23:50:12+08:00	4829	1347	6176	566	6742	12653	53.28%	38.16%	15	15
8	雲林縣	2018-11-24T22:39:08+08:00	154162	50521	204683	24452	229135	459069	49.91%	33.58%	466	557
8	雲林縣	2018-11-25T03:37:28+08:00	201784	65207	266991	30111	297102	584480	50.83%	34.52%	557	557
8	雲林縣	2018-11-25T01:24:23+08:00	201784	65207	266991	30111	297102	584480	50.83%	34.52%	557	557
8	雲林縣	2018-11-24T23:07:17+08:00	173021	56311	229332	27052	256384	509599	50.31%	33.95%	504	557
8	雲林縣	2018-11-24T22:12:01+08:00	129986	42797	172783	20806	193589	390056	49.63%	33.32%	410	557
8	雲林縣	2018-11-24T22:32:17+08:00	147298	48249	195547	23543	219090	439872	49.81%	33.49%	452	557
8	雲林縣	2018-11-25T03:48:28+08:00	201784	65207	266991	30111	297102	584480	50.83%	34.52%	557	557
8	雲林縣	2018-11-25T03:30:58+08:00	201784	65207	266991	30111	297102	584480	50.83%	34.52%	557	557
8	雲林縣	2018-11-24T23:42:01+08:00	189135	61407	250542	28921	279463	551522	50.67%	34.29%	533	557
8	雲林縣	2018-11-24T22:21:45+08:00	141278	46240	187518	22619	210137	422182	49.77%	33.46%	437	557
8	雲林縣	2018-11-25T04:01:28+08:00	201784	65207	266991	30111	297102	584480	50.83%	34.52%	557	557
8	雲林縣	2018-11-25T00:21:43+08:00	198574	64243	262817	29899	292716	576380	50.79%	34.45%	552	557
8	雲林縣	2018-11-25T01:11:06+08:00	201784	65207	266991	30111	297102	584480	50.83%	34.52%	557	557
8	雲林縣	2018-11-24T22:40:18+08:00	156372	51223	207595	24821	232416	465569	49.92%	33.59%	471	557
8	雲林縣	2018-11-24T23:00:16+08:00	169069	55235	224304	26523	250827	499556	50.21%	33.84%	497	557
8	雲林縣	2018-11-25T03:54:39+08:00	201784	65207	266991	30111	297102	584480	50.83%	34.52%	557	557
8	雲林縣	2018-11-25T01:01:00+08:00	201784	65207	266991	30111	297102	584480	50.83%	34.52%	557	557
8	雲林縣	2018-11-24T23:33:49+08:00	186330	60549	246879	28591	275470	544262	50.61%	34.24%	528	557
8	雲林縣	2018-11-25T00:03:33+08:00	194067	62844	256911	29400	286311	564521	50.72%	34.38%	544	557
8	雲林縣	2018-11-24T23:37:47+08:00	187486	60905	248391	28678	277069	547238	50.63%	34.26%	530	557
8	雲林縣	2018-11-24T22:35:43+08:00	151216	49595	200811	24102	224913	450633	49.91%	33.56%	460	557
8	雲林縣	2018-11-24T23:54:26+08:00	191255	61987	253242	29144	282386	556994	50.7%	34.34%	537	557
8	雲林縣	2018-11-24T23:58:41+08:00	191924	62211	254135	29223	283358	559007	50.69%	34.33%	539	557
8	雲林縣	2018-11-25T00:56:12+08:00	201784	65207	266991	30111	297102	584480	50.83%	34.52%	557	557
8	雲林縣	2018-11-24T22:56:35+08:00	167319	54693	222012	26319	248331	495251	50.14%	33.78%	494	557
8	雲林縣	2018-11-25T06:17:35+08:00	201784	65207	266991	30111	297102	584480	50.83%	34.52%	557	557
8	雲林縣	2018-11-24T22:49:23+08:00	162604	53152	215756	25621	241377	482314	50.05%	33.71%	485	557
8	雲林縣	2018-11-24T23:14:39+08:00	174475	56749	231224	27188	258412	513229	50.35%	34%	506	557
8	雲林縣	2018-11-24T23:22:22+08:00	180651	58695	239346	27986	267332	529577	50.48%	34.11%	518	557
8	雲林縣	2018-11-24T22:43:49+08:00	157770	51666	209436	24994	234430	469494	49.93%	33.6%	474	557
8	雲林縣	2018-11-24T23:03:46+08:00	171653	56001	227654	26971	254625	506755	50.25%	33.87%	502	557
8	雲林縣	2018-11-24T23:10:55+08:00	173021	56311	229332	27052	256384	509599	50.31%	33.95%	504	557
8	雲林縣	2018-11-25T00:08:03+08:00	194429	62943	257372	29444	286816	565368	50.73%	34.39%	545	557
8	雲林縣	2018-11-25T03:42:47+08:00	201784	65207	266991	30111	297102	584480	50.83%	34.52%	557	557
8	雲林縣	2018-11-24T22:53:14+08:00	165155	53999	219154	26029	245183	489659	50.07%	33.73%	490	557
8	雲林縣	2018-11-24T23:46:02+08:00	190392	61752	252144	29021	281165	554601	50.7%	34.33%	535	557
8	雲林縣	2018-11-25T00:17:07+08:00	197424	63913	261337	29804	291141	573414	50.77%	34.43%	550	557
8	雲林縣	2018-11-24T23:29:45+08:00	183178	59506	242684	28294	270978	536045	50.55%	34.17%	523	557
8	雲林縣	2018-11-25T06:22:44+08:00	201784	65207	266991	30111	297102	584480	50.83%	34.52%	557	557
8	雲林縣	2018-11-25T06:07:21+08:00	201784	65207	266991	30111	297102	584480	50.83%	34.52%	557	557
8	雲林縣	2018-11-25T06:12:36+08:00	201784	65207	266991	30111	297102	584480	50.83%	34.52%	557	557
8	雲林縣	2018-11-24T22:25:23+08:00	143672	47036	190708	22916	213624	429326	49.76%	33.46%	443	557
8	雲林縣	2018-11-25T01:05:58+08:00	201784	65207	266991	30111	297102	584480	50.83%	34.52%	557	557
8	雲林縣	2018-11-25T00:12:44+08:00	195434	63292	258726	29589	288315	568154	50.75%	34.4%	547	557
8	雲林縣	2018-11-24T23:26:06+08:00	181541	58968	240509	28084	268593	531855	50.5%	34.13%	520	557
8	雲林縣	2018-11-24T22:18:18+08:00	135738	44539	180277	21649	201926	406529	49.67%	33.39%	425	557
8	雲林縣	2018-11-25T06:27:54+08:00	201784	65207	266991	30111	297102	584480	50.83%	34.52%	557	557
8	雲林縣	2018-11-24T23:50:14+08:00	190392	61752	252144	29021	281165	554601	50.7%	34.33%	535	557
8	雲林縣	2018-11-24T22:28:39+08:00	145630	47705	193335	23304	216639	435478	49.75%	33.44%	448	557
8	雲林縣	2018-11-24T22:14:48+08:00	133111	43763	176874	21267	198141	398441	49.73%	33.41%	418	557
8	雲林縣	2018-11-25T01:16:21+08:00	201784	65207	266991	30111	297102	584480	50.83%	34.52%	557	557
8	雲林縣	2018-11-24T23:18:26+08:00	178062	57872	235934	27653	263587	522650	50.43%	34.07%	513	557
8	雲林縣林內鄉	2018-11-24T22:39:08+08:00	5852	1805	7657	1072	8729	15551	56.13%	37.63%	15	15
8	雲林縣林內鄉	2018-11-25T03:37:28+08:00	5852	1805	7657	1072	8729	15551	56.13%	37.63%	15	15
8	雲林縣林內鄉	2018-11-24T23:07:18+08:00	5852	1805	7657	1072	8729	15551	56.13%	37.63%	15	15
8	雲林縣林內鄉	2018-11-25T01:24:23+08:00	5852	1805	7657	1072	8729	15551	56.13%	37.63%	15	15
8	雲林縣林內鄉	2018-11-25T03:54:40+08:00	5852	1805	7657	1072	8729	15551	56.13%	37.63%	15	15
8	雲林縣林內鄉	2018-11-24T22:32:17+08:00	5852	1805	7657	1072	8729	15551	56.13%	37.63%	15	15
8	雲林縣林內鄉	2018-11-25T03:30:58+08:00	5852	1805	7657	1072	8729	15551	56.13%	37.63%	15	15
8	雲林縣林內鄉	2018-11-24T23:42:01+08:00	5852	1805	7657	1072	8729	15551	56.13%	37.63%	15	15
8	雲林縣林內鄉	2018-11-25T03:48:29+08:00	5852	1805	7657	1072	8729	15551	56.13%	37.63%	15	15
8	雲林縣林內鄉	2018-11-24T22:21:45+08:00	5852	1805	7657	1072	8729	15551	56.13%	37.63%	15	15
8	雲林縣林內鄉	2018-11-25T06:07:22+08:00	5852	1805	7657	1072	8729	15551	56.13%	37.63%	15	15
8	雲林縣林內鄉	2018-11-25T04:01:28+08:00	5852	1805	7657	1072	8729	15551	56.13%	37.63%	15	15
8	雲林縣林內鄉	2018-11-25T00:21:43+08:00	5852	1805	7657	1072	8729	15551	56.13%	37.63%	15	15
8	雲林縣林內鄉	2018-11-25T01:11:06+08:00	5852	1805	7657	1072	8729	15551	56.13%	37.63%	15	15
8	雲林縣林內鄉	2018-11-24T22:40:18+08:00	5852	1805	7657	1072	8729	15551	56.13%	37.63%	15	15
8	雲林縣林內鄉	2018-11-24T23:00:16+08:00	5852	1805	7657	1072	8729	15551	56.13%	37.63%	15	15
8	雲林縣林內鄉	2018-11-24T23:37:48+08:00	5852	1805	7657	1072	8729	15551	56.13%	37.63%	15	15
8	雲林縣林內鄉	2018-11-25T00:56:13+08:00	5852	1805	7657	1072	8729	15551	56.13%	37.63%	15	15
8	雲林縣林內鄉	2018-11-25T01:01:00+08:00	5852	1805	7657	1072	8729	15551	56.13%	37.63%	15	15
8	雲林縣林內鄉	2018-11-24T23:33:49+08:00	5852	1805	7657	1072	8729	15551	56.13%	37.63%	15	15
8	雲林縣林內鄉	2018-11-25T00:03:33+08:00	5852	1805	7657	1072	8729	15551	56.13%	37.63%	15	15
8	雲林縣林內鄉	2018-11-24T22:35:44+08:00	5852	1805	7657	1072	8729	15551	56.13%	37.63%	15	15
8	雲林縣林內鄉	2018-11-24T23:54:26+08:00	5852	1805	7657	1072	8729	15551	56.13%	37.63%	15	15
8	雲林縣林內鄉	2018-11-24T23:58:41+08:00	5852	1805	7657	1072	8729	15551	56.13%	37.63%	15	15
8	雲林縣林內鄉	2018-11-24T22:56:35+08:00	5852	1805	7657	1072	8729	15551	56.13%	37.63%	15	15
8	雲林縣林內鄉	2018-11-25T06:17:35+08:00	5852	1805	7657	1072	8729	15551	56.13%	37.63%	15	15
8	雲林縣林內鄉	2018-11-24T22:49:23+08:00	5852	1805	7657	1072	8729	15551	56.13%	37.63%	15	15
8	雲林縣林內鄉	2018-11-24T23:22:22+08:00	5852	1805	7657	1072	8729	15551	56.13%	37.63%	15	15
8	雲林縣林內鄉	2018-11-24T22:43:49+08:00	5852	1805	7657	1072	8729	15551	56.13%	37.63%	15	15
8	雲林縣林內鄉	2018-11-24T23:03:46+08:00	5852	1805	7657	1072	8729	15551	56.13%	37.63%	15	15
8	雲林縣林內鄉	2018-11-24T23:10:55+08:00	5852	1805	7657	1072	8729	15551	56.13%	37.63%	15	15
8	雲林縣林內鄉	2018-11-24T22:12:02+08:00	5309	1640	6949	985	7934	14060	56.43%	37.76%	14	15
8	雲林縣林內鄉	2018-11-25T00:08:04+08:00	5852	1805	7657	1072	8729	15551	56.13%	37.63%	15	15
8	雲林縣林內鄉	2018-11-25T03:42:47+08:00	5852	1805	7657	1072	8729	15551	56.13%	37.63%	15	15
8	雲林縣林內鄉	2018-11-24T22:53:14+08:00	5852	1805	7657	1072	8729	15551	56.13%	37.63%	15	15
8	雲林縣林內鄉	2018-11-24T23:46:03+08:00	5852	1805	7657	1072	8729	15551	56.13%	37.63%	15	15
8	雲林縣林內鄉	2018-11-25T00:17:07+08:00	5852	1805	7657	1072	8729	15551	56.13%	37.63%	15	15
8	雲林縣林內鄉	2018-11-24T23:29:45+08:00	5852	1805	7657	1072	8729	15551	56.13%	37.63%	15	15
8	雲林縣林內鄉	2018-11-25T06:22:44+08:00	5852	1805	7657	1072	8729	15551	56.13%	37.63%	15	15
8	雲林縣林內鄉	2018-11-25T06:12:36+08:00	5852	1805	7657	1072	8729	15551	56.13%	37.63%	15	15
8	雲林縣林內鄉	2018-11-24T22:25:24+08:00	5852	1805	7657	1072	8729	15551	56.13%	37.63%	15	15
8	雲林縣林內鄉	2018-11-25T01:05:58+08:00	5852	1805	7657	1072	8729	15551	56.13%	37.63%	15	15
8	雲林縣林內鄉	2018-11-25T00:12:44+08:00	5852	1805	7657	1072	8729	15551	56.13%	37.63%	15	15
8	雲林縣林內鄉	2018-11-24T23:26:06+08:00	5852	1805	7657	1072	8729	15551	56.13%	37.63%	15	15
8	雲林縣林內鄉	2018-11-25T06:27:54+08:00	5852	1805	7657	1072	8729	15551	56.13%	37.63%	15	15
8	雲林縣林內鄉	2018-11-24T23:50:14+08:00	5852	1805	7657	1072	8729	15551	56.13%	37.63%	15	15
8	雲林縣林內鄉	2018-11-24T23:14:40+08:00	5852	1805	7657	1072	8729	15551	56.13%	37.63%	15	15
8	雲林縣林內鄉	2018-11-24T22:18:19+08:00	5309	1640	6949	985	7934	14060	56.43%	37.76%	14	15
8	雲林縣林內鄉	2018-11-24T22:28:39+08:00	5852	1805	7657	1072	8729	15551	56.13%	37.63%	15	15
8	雲林縣林內鄉	2018-11-24T22:14:48+08:00	5309	1640	6949	985	7934	14060	56.43%	37.76%	14	15
8	雲林縣林內鄉	2018-11-25T01:16:21+08:00	5852	1805	7657	1072	8729	15551	56.13%	37.63%	15	15
8	雲林縣林內鄉	2018-11-24T23:18:26+08:00	5852	1805	7657	1072	8729	15551	56.13%	37.63%	15	15
8	臺北市信義區	2018-11-24T23:07:11+08:00	54710	17119	71829	4834	76663	132485	57.87%	41.3%	102	142
8	臺北市信義區	2018-11-25T01:05:49+08:00	76799	24060	100859	6830	107689	187741	57.36%	40.91%	140	142
8	臺北市信義區	2018-11-24T22:49:16+08:00	48519	15195	63714	4219	67933	116892	58.12%	41.51%	91	142
8	臺北市信義區	2018-11-24T22:43:42+08:00	45805	14337	60142	3966	64108	110232	58.16%	41.55%	86	142
8	臺北市信義區	2018-11-25T01:10:56+08:00	77362	24245	101607	6884	108491	189041	57.39%	40.92%	141	142
8	臺北市信義區	2018-11-24T22:39:00+08:00	45307	14175	59482	3918	63400	108921	58.21%	41.6%	85	142
8	臺北市信義區	2018-11-25T03:37:16+08:00	77960	24430	102390	6933	109323	190444	57.4%	40.94%	142	142
8	臺北市信義區	2018-11-25T01:10:57+08:00	77362	24245	101607	6884	108491	189041	57.39%	40.92%	141	142
8	臺北市信義區	2018-11-24T23:50:04+08:00	65821	20751	86572	5854	92426	160805	57.48%	40.93%	121	142
8	臺北市信義區	2018-11-25T01:24:14+08:00	77960	24430	102390	6933	109323	190444	57.4%	40.94%	142	142
8	臺北市信義區	2018-11-25T00:12:36+08:00	71457	22467	93924	6324	100248	174683	57.39%	40.91%	131	142
8	臺北市信義區	2018-11-24T22:32:10+08:00	43159	13481	56640	3702	60342	103703	58.19%	41.62%	81	142
8	臺北市信義區	2018-11-25T01:00:50+08:00	76799	24060	100859	6830	107689	187741	57.36%	40.91%	140	142
8	臺北市信義區	2018-11-24T23:29:38+08:00	61328	19203	80531	5428	85959	149825	57.37%	40.93%	113	142
8	臺北市信義區	2018-11-25T03:48:19+08:00	77960	24430	102390	6933	109323	190444	57.4%	40.94%	142	142
8	臺北市信義區	2018-11-25T06:22:36+08:00	77960	24430	102390	6933	109323	190444	57.4%	40.94%	142	142
8	臺北市信義區	2018-11-25T06:12:29+08:00	77960	24430	102390	6933	109323	190444	57.4%	40.94%	142	142
8	臺北市信義區	2018-11-25T00:21:35+08:00	72128	22725	94853	6395	101248	176414	57.39%	40.89%	132	142
8	臺北市信義區	2018-11-24T23:00:03+08:00	51716	16172	67888	4546	72434	124829	58.03%	41.43%	96	142
8	臺北市信義區	2018-11-25T03:48:20+08:00	77960	24430	102390	6933	109323	190444	57.4%	40.94%	142	142
8	臺北市信義區	2018-11-24T23:25:59+08:00	60057	18799	78856	5333	84189	146789	57.35%	40.91%	111	142
8	臺北市信義區	2018-11-24T23:00:04+08:00	51716	16172	67888	4546	72434	124829	58.03%	41.43%	96	142
8	臺北市信義區	2018-11-25T01:00:51+08:00	76799	24060	100859	6830	107689	187741	57.36%	40.91%	140	142
8	臺北市信義區	2018-11-25T06:07:14+08:00	77960	24430	102390	6933	109323	190444	57.4%	40.94%	142	142
8	臺北市信義區	2018-11-25T06:07:13+08:00	77960	24430	102390	6933	109323	190444	57.4%	40.94%	142	142
8	臺北市信義區	2018-11-24T22:53:05+08:00	48519	15195	63714	4219	67933	116892	58.12%	41.51%	91	142
8	臺北市信義區	2018-11-24T22:40:11+08:00	45307	14175	59482	3918	63400	108921	58.21%	41.6%	85	142
8	臺北市信義區	2018-11-24T22:25:16+08:00	40016	12469	52485	3352	55837	95778	58.3%	41.78%	75	142
8	臺北市信義區	2018-11-24T22:11:55+08:00	35280	11066	46346	2981	49327	84368	58.47%	41.82%	67	142
8	臺北市信義區	2018-11-25T04:01:20+08:00	77960	24430	102390	6933	109323	190444	57.4%	40.94%	142	142
8	臺北市信義區	2018-11-24T22:53:04+08:00	48519	15195	63714	4219	67933	116892	58.12%	41.51%	91	142
8	臺北市信義區	2018-11-25T01:16:12+08:00	77960	24430	102390	6933	109323	190444	57.4%	40.94%	142	142
8	臺北市信義區	2018-11-24T23:45:55+08:00	65821	20751	86572	5854	92426	160805	57.48%	40.93%	121	142
8	臺北市信義區	2018-11-24T23:37:41+08:00	63132	19790	82922	5636	88558	154004	57.5%	40.99%	116	142
8	臺北市信義區	2018-11-24T23:41:54+08:00	63552	19917	83469	5676	89145	155072	57.49%	40.98%	117	142
8	臺北市信義區	2018-11-24T23:54:16+08:00	66889	21064	87953	5949	93902	163471	57.44%	40.92%	123	142
8	臺北市信義區	2018-11-24T22:28:32+08:00	41676	13000	54676	3538	58214	99957	58.24%	41.69%	78	142
8	臺北市信義區	2018-11-24T23:41:53+08:00	63552	19917	83469	5676	89145	155072	57.49%	40.98%	117	142
8	臺北市信義區	2018-11-25T01:16:13+08:00	77960	24430	102390	6933	109323	190444	57.4%	40.94%	142	142
8	臺北市信義區	2018-11-25T03:54:31+08:00	77960	24430	102390	6933	109323	190444	57.4%	40.94%	142	142
8	臺北市信義區	2018-11-24T23:33:41+08:00	61914	19380	81294	5510	86804	151232	57.4%	40.94%	114	142
8	臺北市信義區	2018-11-24T23:54:17+08:00	66889	21064	87953	5949	93902	163471	57.44%	40.92%	123	142
8	臺北市信義區	2018-11-25T00:03:24+08:00	69071	21716	90787	6162	96949	168732	57.46%	40.94%	127	142
8	臺北市信義區	2018-11-24T22:35:36+08:00	44164	13808	57972	3795	61767	106152	58.19%	41.6%	83	142
8	臺北市信義區	2018-11-25T00:16:59+08:00	72128	22725	94853	6395	101248	176414	57.39%	40.89%	132	142
8	臺北市信義區	2018-11-25T00:03:23+08:00	69071	21716	90787	6162	96949	168732	57.46%	40.94%	127	142
8	臺北市信義區	2018-11-24T23:58:33+08:00	67925	21334	89259	6036	95295	165975	57.42%	40.92%	125	142
8	臺北市信義區	2018-11-24T22:14:39+08:00	36546	11418	47964	3083	51047	87259	58.5%	41.88%	69	142
8	臺北市信義區	2018-11-24T22:43:41+08:00	45805	14337	60142	3966	64108	110232	58.16%	41.55%	86	142
8	臺北市信義區	2018-11-25T06:27:46+08:00	77960	24430	102390	6933	109323	190444	57.4%	40.94%	142	142
8	臺北市信義區	2018-11-24T22:49:15+08:00	48519	15195	63714	4219	67933	116892	58.12%	41.51%	91	142
8	臺北市信義區	2018-11-24T23:03:40+08:00	53861	16824	70685	4745	75430	130208	57.93%	41.37%	100	142
8	臺北市信義區	2018-11-24T23:14:30+08:00	55247	17318	72565	4878	77443	133845	57.86%	41.28%	103	142
8	臺北市信義區	2018-11-24T23:22:14+08:00	58881	18442	77323	5223	82546	143652	57.46%	40.99%	109	142
8	臺北市信義區	2018-11-24T23:58:32+08:00	67925	21334	89259	6036	95295	165975	57.42%	40.92%	125	142
8	臺北市信義區	2018-11-25T03:37:15+08:00	77960	24430	102390	6933	109323	190444	57.4%	40.94%	142	142
8	臺北市信義區	2018-11-25T00:56:03+08:00	76156	23860	100016	6756	106772	186210	57.34%	40.9%	139	142
8	臺北市信義區	2018-11-25T00:56:04+08:00	76156	23860	100016	6756	106772	186210	57.34%	40.9%	139	142
8	臺北市信義區	2018-11-24T23:14:31+08:00	55247	17318	72565	4878	77443	133845	57.86%	41.28%	103	142
8	臺北市信義區	2018-11-25T06:27:47+08:00	77960	24430	102390	6933	109323	190444	57.4%	40.94%	142	142
8	臺北市信義區	2018-11-24T22:21:36+08:00	38665	12137	50802	3282	54084	92856	58.25%	41.64%	73	142
8	臺北市信義區	2018-11-25T00:17:00+08:00	72128	22725	94853	6395	101248	176414	57.39%	40.89%	132	142
8	臺北市信義區	2018-11-25T03:42:37+08:00	77960	24430	102390	6933	109323	190444	57.4%	40.94%	142	142
8	臺北市信義區	2018-11-25T03:30:49+08:00	77960	24430	102390	6933	109323	190444	57.4%	40.94%	142	142
8	臺北市信義區	2018-11-25T03:42:36+08:00	77960	24430	102390	6933	109323	190444	57.4%	40.94%	142	142
8	臺北市信義區	2018-11-24T22:25:15+08:00	40016	12469	52485	3352	55837	95778	58.3%	41.78%	75	142
8	臺北市信義區	2018-11-24T22:18:11+08:00	37160	11589	48749	3133	51882	88709	58.49%	41.89%	70	142
8	臺北市信義區	2018-11-24T22:28:31+08:00	41676	13000	54676	3538	58214	99957	58.24%	41.69%	78	142
8	臺北市信義區	2018-11-24T23:10:48+08:00	55247	17318	72565	4878	77443	133845	57.86%	41.28%	103	142
8	臺北市信義區	2018-11-24T22:14:40+08:00	36546	11418	47964	3083	51047	87259	58.5%	41.88%	69	142
8	臺北市信義區	2018-11-25T06:17:27+08:00	77960	24430	102390	6933	109323	190444	57.4%	40.94%	142	142
8	臺北市信義區	2018-11-24T22:56:29+08:00	49744	15578	65322	4366	69688	119900	58.12%	41.49%	93	142
8	臺北市信義區	2018-11-24T23:18:18+08:00	55949	17528	73477	4930	78407	135466	57.88%	41.3%	104	142
8	臺北市信義區	2018-11-24T23:45:56+08:00	65821	20751	86572	5854	92426	160805	57.48%	40.93%	121	142
8	臺北市信義區	2018-11-24T23:03:39+08:00	53861	16824	70685	4745	75430	130208	57.93%	41.37%	100	142
8	臺北市信義區	2018-11-25T00:07:55+08:00	69071	21716	90787	6162	96949	168732	57.46%	40.94%	127	142
8	臺北市信義區	2018-11-24T23:33:42+08:00	61914	19380	81294	5510	86804	151232	57.4%	40.94%	114	142
8	臺北市信義區	2018-11-24T23:10:49+08:00	55247	17318	72565	4878	77443	133845	57.86%	41.28%	103	142
8	臺北市信義區	2018-11-24T22:18:10+08:00	37160	11589	48749	3133	51882	88709	58.49%	41.89%	70	142
8	臺北市信義區	2018-11-24T23:18:19+08:00	55949	17528	73477	4930	78407	135466	57.88%	41.3%	104	142
8	桃園市八德區	2018-11-25T03:37:17+08:00	59933	17095	77028	5780	82808	165065	50.17%	36.31%	101	101
8	桃園市八德區	2018-11-25T01:10:58+08:00	59933	17095	77028	5780	82808	165065	50.17%	36.31%	101	101
8	桃園市八德區	2018-11-25T00:12:37+08:00	59933	17095	77028	5780	82808	165065	50.17%	36.31%	101	101
8	桃園市八德區	2018-11-24T22:49:17+08:00	48653	13866	62519	4705	67224	133992	50.17%	36.31%	84	101
8	桃園市八德區	2018-11-24T23:14:32+08:00	54765	15628	70393	5258	75651	151012	50.1%	36.27%	93	101
8	桃園市八德區	2018-11-24T22:43:43+08:00	47640	13540	61180	4597	65777	130699	50.33%	36.45%	82	101
8	桃園市八德區	2018-11-24T22:56:30+08:00	49781	14191	63972	4821	68793	137158	50.16%	36.29%	86	101
8	桃園市八德區	2018-11-25T06:22:37+08:00	59933	17095	77028	5780	82808	165065	50.17%	36.31%	101	101
8	桃園市八德區	2018-11-25T03:30:50+08:00	59933	17095	77028	5780	82808	165065	50.17%	36.31%	101	101
8	桃園市八德區	2018-11-25T03:48:21+08:00	59933	17095	77028	5780	82808	165065	50.17%	36.31%	101	101
8	桃園市八德區	2018-11-24T22:32:11+08:00	42783	12291	55074	4255	59329	117502	50.49%	36.41%	75	101
8	桃園市八德區	2018-11-24T23:29:39+08:00	56719	16153	72872	5453	78325	156280	50.12%	36.29%	96	101
8	桃園市八德區	2018-11-25T04:01:21+08:00	59933	17095	77028	5780	82808	165065	50.17%	36.31%	101	101
8	桃園市八德區	2018-11-24T22:25:17+08:00	40858	11707	52565	4047	56612	111836	50.62%	36.53%	72	101
8	桃園市八德區	2018-11-25T06:07:15+08:00	59933	17095	77028	5780	82808	165065	50.17%	36.31%	101	101
8	桃園市八德區	2018-11-24T22:18:12+08:00	37231	10844	48075	3732	51807	102118	50.73%	36.46%	67	101
8	桃園市八德區	2018-11-24T23:54:18+08:00	58000	16486	74486	5580	80066	159622	50.16%	36.34%	98	101
8	桃園市八德區	2018-11-25T00:07:57+08:00	59933	17095	77028	5780	82808	165065	50.17%	36.31%	101	101
8	桃園市八德區	2018-11-25T01:16:14+08:00	59933	17095	77028	5780	82808	165065	50.17%	36.31%	101	101
8	桃園市八德區	2018-11-24T23:41:55+08:00	57343	16320	73663	5521	79184	157887	50.15%	36.32%	97	101
8	桃園市八德區	2018-11-24T22:28:33+08:00	42128	12119	54247	4162	58409	115685	50.49%	36.42%	74	101
8	桃園市八德區	2018-11-24T23:58:34+08:00	58000	16486	74486	5580	80066	159622	50.16%	36.34%	98	101
8	桃園市八德區	2018-11-24T23:22:15+08:00	55524	15786	71310	5314	76624	152876	50.12%	36.32%	94	101
8	桃園市八德區	2018-11-25T01:24:16+08:00	59933	17095	77028	5780	82808	165065	50.17%	36.31%	101	101
8	桃園市八德區	2018-11-24T22:35:38+08:00	44786	12801	57587	4366	61953	123084	50.33%	36.39%	78	101
8	桃園市八德區	2018-11-24T23:07:12+08:00	54038	15419	69457	5176	74633	149171	50.03%	36.23%	92	101
8	桃園市八德區	2018-11-24T22:39:02+08:00	45404	12951	58355	4436	62791	124589	50.4%	36.44%	79	101
8	桃園市八德區	2018-11-25T00:56:05+08:00	59933	17095	77028	5780	82808	165065	50.17%	36.31%	101	101
8	桃園市八德區	2018-11-25T06:27:48+08:00	59933	17095	77028	5780	82808	165065	50.17%	36.31%	101	101
8	桃園市八德區	2018-11-24T23:50:07+08:00	58000	16486	74486	5580	80066	159622	50.16%	36.34%	98	101
8	桃園市八德區	2018-11-25T00:03:25+08:00	58000	16486	74486	5580	80066	159622	50.16%	36.34%	98	101
8	桃園市八德區	2018-11-24T23:03:41+08:00	54038	15419	69457	5176	74633	149171	50.03%	36.23%	92	101
8	桃園市八德區	2018-11-24T23:00:06+08:00	52010	14809	66819	4995	71814	143202	50.15%	36.32%	89	101
8	桃園市八德區	2018-11-24T22:21:38+08:00	39245	11417	50662	3942	54604	107776	50.66%	36.41%	70	101
8	桃園市八德區	2018-11-25T03:42:40+08:00	59933	17095	77028	5780	82808	165065	50.17%	36.31%	101	101
8	桃園市八德區	2018-11-25T00:21:36+08:00	59933	17095	77028	5780	82808	165065	50.17%	36.31%	101	101
8	桃園市八德區	2018-11-25T01:00:52+08:00	59933	17095	77028	5780	82808	165065	50.17%	36.31%	101	101
8	桃園市八德區	2018-11-25T06:12:30+08:00	59933	17095	77028	5780	82808	165065	50.17%	36.31%	101	101
8	桃園市八德區	2018-11-24T22:40:12+08:00	46898	13335	60233	4544	64777	128438	50.43%	36.51%	81	101
8	桃園市八德區	2018-11-25T00:17:01+08:00	59933	17095	77028	5780	82808	165065	50.17%	36.31%	101	101
8	桃園市八德區	2018-11-24T22:53:07+08:00	49781	14191	63972	4821	68793	137158	50.16%	36.29%	86	101
8	桃園市八德區	2018-11-24T22:11:56+08:00	35901	10493	46394	3593	49987	98563	50.72%	36.42%	65	101
8	桃園市八德區	2018-11-25T03:54:33+08:00	59933	17095	77028	5780	82808	165065	50.17%	36.31%	101	101
8	桃園市八德區	2018-11-25T01:05:51+08:00	59933	17095	77028	5780	82808	165065	50.17%	36.31%	101	101
8	桃園市八德區	2018-11-24T23:33:43+08:00	56719	16153	72872	5453	78325	156280	50.12%	36.29%	96	101
8	桃園市八德區	2018-11-24T23:18:20+08:00	55524	15786	71310	5314	76624	152876	50.12%	36.32%	94	101
8	桃園市八德區	2018-11-24T23:37:42+08:00	57343	16320	73663	5521	79184	157887	50.15%	36.32%	97	101
8	桃園市八德區	2018-11-24T22:14:41+08:00	36607	10661	47268	3647	50915	100506	50.66%	36.42%	66	101
8	桃園市八德區	2018-11-24T23:26:00+08:00	56719	16153	72872	5453	78325	156280	50.12%	36.29%	96	101
8	桃園市八德區	2018-11-24T23:10:49+08:00	54765	15628	70393	5258	75651	151012	50.1%	36.27%	93	101
8	桃園市八德區	2018-11-25T06:17:28+08:00	59933	17095	77028	5780	82808	165065	50.17%	36.31%	101	101
8	桃園市八德區	2018-11-24T23:45:57+08:00	58000	16486	74486	5580	80066	159622	50.16%	36.34%	98	101
8	臺北市北投區	2018-11-24T23:07:11+08:00	31847	10518	42365	3257	45622	82141	55.54%	38.77%	58	141
8	臺北市北投區	2018-11-25T01:05:49+08:00	67598	22641	90239	6967	97206	174335	55.76%	38.77%	117	141
8	臺北市北投區	2018-11-24T22:49:16+08:00	23615	7965	31580	2461	34041	61309	55.52%	38.52%	44	141
8	臺北市北投區	2018-11-24T22:39:01+08:00	20665	6947	27612	2153	29765	54056	55.06%	38.23%	39	141
8	臺北市北投區	2018-11-24T22:43:42+08:00	22504	7576	30080	2338	32418	58554	55.36%	38.43%	42	141
8	臺北市北投區	2018-11-25T01:24:15+08:00	70575	23746	94321	7243	101564	182327	55.7%	38.71%	122	141
8	臺北市北投區	2018-11-24T23:50:05+08:00	42356	14148	56504	4281	60785	109719	55.4%	38.6%	76	141
8	臺北市北投區	2018-11-24T22:39:00+08:00	20665	6947	27612	2153	29765	54056	55.06%	38.23%	39	141
8	臺北市北投區	2018-11-25T03:37:16+08:00	82553	27879	110432	8451	118883	213250	55.75%	38.71%	141	141
8	臺北市北投區	2018-11-25T01:10:57+08:00	68714	23050	91764	7078	98842	177171	55.79%	38.78%	119	141
8	臺北市北投區	2018-11-24T23:50:04+08:00	42356	14148	56504	4281	60785	109719	55.4%	38.6%	76	141
8	臺北市北投區	2018-11-25T01:24:14+08:00	70575	23746	94321	7243	101564	182327	55.7%	38.71%	122	141
8	臺北市北投區	2018-11-25T00:12:36+08:00	51586	17314	68900	5348	74248	133892	55.45%	38.53%	91	141
8	臺北市北投區	2018-11-25T06:22:37+08:00	82553	27879	110432	8451	118883	213250	55.75%	38.71%	141	141
8	臺北市北投區	2018-11-24T22:32:10+08:00	18871	6317	25188	2007	27195	49287	55.18%	38.29%	36	141
8	臺北市北投區	2018-11-24T23:29:38+08:00	39069	12962	52031	3969	56000	100962	55.47%	38.7%	70	141
8	臺北市北投區	2018-11-25T06:22:36+08:00	82553	27879	110432	8451	118883	213250	55.75%	38.71%	141	141
8	臺北市北投區	2018-11-24T22:32:11+08:00	18871	6317	25188	2007	27195	49287	55.18%	38.29%	36	141
8	臺北市北投區	2018-11-25T06:12:29+08:00	82553	27879	110432	8451	118883	213250	55.75%	38.71%	141	141
8	臺北市北投區	2018-11-25T00:21:35+08:00	56393	18779	75172	5802	80974	145622	55.61%	38.73%	99	141
8	臺北市北投區	2018-11-25T03:48:20+08:00	82553	27879	110432	8451	118883	213250	55.75%	38.71%	141	141
8	臺北市北投區	2018-11-24T23:25:59+08:00	37174	12316	49490	3794	53284	96104	55.44%	38.68%	67	141
8	臺北市北投區	2018-11-24T23:29:39+08:00	39069	12962	52031	3969	56000	100962	55.47%	38.7%	70	141
8	臺北市北投區	2018-11-24T23:00:04+08:00	26617	8902	35519	2698	38217	68826	55.53%	38.67%	49	141
8	臺北市北投區	2018-11-25T01:00:51+08:00	66251	22158	88409	6828	95237	171038	55.68%	38.73%	115	141
8	臺北市北投區	2018-11-25T06:07:14+08:00	82553	27879	110432	8451	118883	213250	55.75%	38.71%	141	141
8	臺北市北投區	2018-11-24T22:53:05+08:00	24278	8129	32407	2511	34918	62806	55.6%	38.66%	45	141
8	臺北市北投區	2018-11-24T22:40:11+08:00	21348	7176	28524	2219	30743	55653	55.24%	38.36%	40	141
8	臺北市北投區	2018-11-24T22:25:16+08:00	18226	6118	24344	1939	26283	47810	54.97%	38.12%	35	141
8	臺北市北投區	2018-11-24T22:11:55+08:00	12343	4080	16423	1378	17801	32615	54.58%	37.84%	25	141
8	臺北市北投區	2018-11-25T04:01:20+08:00	82553	27879	110432	8451	118883	213250	55.75%	38.71%	141	141
8	臺北市北投區	2018-11-25T01:16:12+08:00	70575	23746	94321	7243	101564	182327	55.7%	38.71%	122	141
8	臺北市北投區	2018-11-25T00:07:56+08:00	49577	16612	66189	5104	71293	128718	55.39%	38.52%	88	141
8	臺北市北投區	2018-11-24T23:37:41+08:00	40686	13549	54235	4151	58386	105380	55.41%	38.61%	73	141
8	臺北市北投區	2018-11-24T23:41:54+08:00	40686	13549	54235	4151	58386	105380	55.41%	38.61%	73	141
8	臺北市北投區	2018-11-24T22:28:32+08:00	18226	6118	24344	1939	26283	47810	54.97%	38.12%	35	141
8	臺北市北投區	2018-11-25T01:16:13+08:00	70575	23746	94321	7243	101564	182327	55.7%	38.71%	122	141
8	臺北市北投區	2018-11-25T03:54:31+08:00	82553	27879	110432	8451	118883	213250	55.75%	38.71%	141	141
8	臺北市北投區	2018-11-24T23:54:17+08:00	42956	14325	57281	4354	61635	111150	55.45%	38.65%	77	141
8	臺北市北投區	2018-11-25T00:03:24+08:00	46416	15566	61982	4753	66735	120780	55.25%	38.43%	83	141
8	臺北市北投區	2018-11-24T22:35:36+08:00	20110	6716	26826	2096	28922	52556	55.03%	38.26%	38	141
8	臺北市北投區	2018-11-24T23:22:15+08:00	36055	11860	47915	3627	51542	92599	55.66%	38.94%	65	141
8	臺北市北投區	2018-11-24T23:58:33+08:00	45249	15171	60420	4634	65054	117576	55.33%	38.48%	81	141
8	臺北市北投區	2018-11-24T23:03:40+08:00	29378	9723	39101	3014	42115	75758	55.59%	38.78%	54	141
8	臺北市北投區	2018-11-24T23:22:14+08:00	36055	11860	47915	3627	51542	92599	55.66%	38.94%	65	141
8	臺北市北投區	2018-11-24T23:58:32+08:00	45249	15171	60420	4634	65054	117576	55.33%	38.48%	81	141
8	臺北市北投區	2018-11-24T22:35:37+08:00	20110	6716	26826	2096	28922	52556	55.03%	38.26%	38	141
8	臺北市北投區	2018-11-25T03:37:15+08:00	82553	27879	110432	8451	118883	213250	55.75%	38.71%	141	141
8	臺北市北投區	2018-11-25T00:56:04+08:00	64488	21573	86061	6692	92753	166761	55.62%	38.67%	112	141
8	臺北市北投區	2018-11-24T23:14:31+08:00	33560	11097	44657	3451	48108	86571	55.57%	38.77%	61	141
8	臺北市北投區	2018-11-25T06:27:47+08:00	82553	27879	110432	8451	118883	213250	55.75%	38.71%	141	141
8	臺北市北投區	2018-11-24T22:21:36+08:00	17159	5754	22913	1800	24713	45162	54.72%	37.99%	33	141
8	臺北市北投區	2018-11-24T22:21:37+08:00	17159	5754	22913	1800	24713	45162	54.72%	37.99%	33	141
8	臺北市北投區	2018-11-24T22:53:06+08:00	24278	8129	32407	2511	34918	62806	55.6%	38.66%	45	141
8	臺北市北投區	2018-11-25T00:17:00+08:00	53888	17981	71869	5556	77425	139440	55.53%	38.65%	95	141
8	臺北市北投區	2018-11-25T03:42:37+08:00	82553	27879	110432	8451	118883	213250	55.75%	38.71%	141	141
8	臺北市北投區	2018-11-25T03:30:49+08:00	82553	27879	110432	8451	118883	213250	55.75%	38.71%	141	141
8	臺北市北投區	2018-11-24T22:25:15+08:00	18226	6118	24344	1939	26283	47810	54.97%	38.12%	35	141
8	臺北市北投區	2018-11-25T03:42:38+08:00	82553	27879	110432	8451	118883	213250	55.75%	38.71%	141	141
8	臺北市北投區	2018-11-24T22:18:11+08:00	14069	4638	18707	1564	20271	37108	54.63%	37.91%	28	141
8	臺北市北投區	2018-11-24T22:14:40+08:00	14069	4638	18707	1564	20271	37108	54.63%	37.91%	28	141
8	臺北市北投區	2018-11-25T06:17:27+08:00	82553	27879	110432	8451	118883	213250	55.75%	38.71%	141	141
8	臺北市北投區	2018-11-24T22:56:29+08:00	24805	8326	33131	2562	35693	64194	55.6%	38.64%	46	141
8	臺北市北投區	2018-11-24T23:45:56+08:00	41869	13967	55836	4223	60059	108510	55.35%	38.59%	75	141
8	臺北市北投區	2018-11-25T00:07:55+08:00	49577	16612	66189	5104	71293	128718	55.39%	38.52%	88	141
8	臺北市北投區	2018-11-24T23:33:42+08:00	40686	13549	54235	4151	58386	105380	55.41%	38.61%	73	141
8	臺北市北投區	2018-11-24T23:10:49+08:00	33065	10894	43959	3387	47346	85308	55.5%	38.76%	60	141
8	臺北市北投區	2018-11-25T03:54:32+08:00	82553	27879	110432	8451	118883	213250	55.75%	38.71%	141	141
8	臺北市北投區	2018-11-24T23:18:19+08:00	34213	11302	45515	3512	49027	88040	55.69%	38.86%	62	141
8	臺中市東勢區	2018-11-24T23:10:50+08:00	16947	4790	21737	2191	23928	41553	57.58%	40.78%	38	39
8	臺中市東勢區	2018-11-25T00:56:06+08:00	17561	4978	22539	2316	24855	43181	57.56%	40.67%	39	39
8	臺中市東勢區	2018-11-24T23:22:16+08:00	16947	4790	21737	2191	23928	41553	57.58%	40.78%	38	39
8	臺中市東勢區	2018-11-24T22:49:17+08:00	16947	4790	21737	2191	23928	41553	57.58%	40.78%	38	39
8	臺中市東勢區	2018-11-24T23:14:32+08:00	16947	4790	21737	2191	23928	41553	57.58%	40.78%	38	39
8	臺中市東勢區	2018-11-25T03:37:18+08:00	17561	4978	22539	2316	24855	43181	57.56%	40.67%	39	39
8	臺中市東勢區	2018-11-24T22:43:43+08:00	16947	4790	21737	2191	23928	41553	57.58%	40.78%	38	39
8	臺中市東勢區	2018-11-25T00:03:26+08:00	16947	4790	21737	2191	23928	41553	57.58%	40.78%	38	39
8	臺中市東勢區	2018-11-25T01:10:59+08:00	17561	4978	22539	2316	24855	43181	57.56%	40.67%	39	39
8	臺中市東勢區	2018-11-24T22:56:30+08:00	16947	4790	21737	2191	23928	41553	57.58%	40.78%	38	39
8	臺中市東勢區	2018-11-25T00:12:38+08:00	17561	4978	22539	2316	24855	43181	57.56%	40.67%	39	39
8	臺中市東勢區	2018-11-25T06:22:38+08:00	17561	4978	22539	2316	24855	43181	57.56%	40.67%	39	39
8	臺中市東勢區	2018-11-25T03:30:51+08:00	17561	4978	22539	2316	24855	43181	57.56%	40.67%	39	39
8	臺中市東勢區	2018-11-24T22:25:17+08:00	16563	4618	21181	2127	23308	40339	57.78%	41.06%	37	39
8	臺中市東勢區	2018-11-24T23:29:40+08:00	16947	4790	21737	2191	23928	41553	57.58%	40.78%	38	39
8	臺中市東勢區	2018-11-24T23:54:18+08:00	16947	4790	21737	2191	23928	41553	57.58%	40.78%	38	39
8	臺中市東勢區	2018-11-25T00:07:57+08:00	17561	4978	22539	2316	24855	43181	57.56%	40.67%	39	39
8	臺中市東勢區	2018-11-25T01:16:14+08:00	17561	4978	22539	2316	24855	43181	57.56%	40.67%	39	39
8	臺中市東勢區	2018-11-24T22:18:13+08:00	15950	4477	20427	2061	22488	38908	57.8%	40.99%	36	39
8	臺中市東勢區	2018-11-24T23:41:55+08:00	16947	4790	21737	2191	23928	41553	57.58%	40.78%	38	39
8	臺中市東勢區	2018-11-24T22:28:33+08:00	16563	4618	21181	2127	23308	40339	57.78%	41.06%	37	39
8	臺中市東勢區	2018-11-24T23:58:34+08:00	16947	4790	21737	2191	23928	41553	57.58%	40.78%	38	39
8	臺中市東勢區	2018-11-24T23:50:08+08:00	16947	4790	21737	2191	23928	41553	57.58%	40.78%	38	39
8	臺中市東勢區	2018-11-25T01:24:16+08:00	17561	4978	22539	2316	24855	43181	57.56%	40.67%	39	39
8	臺中市東勢區	2018-11-24T23:07:12+08:00	16947	4790	21737	2191	23928	41553	57.58%	40.78%	38	39
8	臺中市東勢區	2018-11-24T22:39:02+08:00	16947	4790	21737	2191	23928	41553	57.58%	40.78%	38	39
8	臺中市東勢區	2018-11-25T06:27:48+08:00	17561	4978	22539	2316	24855	43181	57.56%	40.67%	39	39
8	臺中市東勢區	2018-11-24T22:35:39+08:00	16563	4618	21181	2127	23308	40339	57.78%	41.06%	37	39
8	臺中市東勢區	2018-11-24T23:03:41+08:00	16947	4790	21737	2191	23928	41553	57.58%	40.78%	38	39
8	臺中市東勢區	2018-11-25T01:00:53+08:00	17561	4978	22539	2316	24855	43181	57.56%	40.67%	39	39
8	臺中市東勢區	2018-11-25T03:48:22+08:00	17561	4978	22539	2316	24855	43181	57.56%	40.67%	39	39
8	臺中市東勢區	2018-11-25T00:21:37+08:00	17561	4978	22539	2316	24855	43181	57.56%	40.67%	39	39
8	臺中市東勢區	2018-11-24T22:21:38+08:00	16563	4618	21181	2127	23308	40339	57.78%	41.06%	37	39
8	臺中市東勢區	2018-11-25T03:42:40+08:00	17561	4978	22539	2316	24855	43181	57.56%	40.67%	39	39
8	臺中市東勢區	2018-11-24T23:00:07+08:00	16947	4790	21737	2191	23928	41553	57.58%	40.78%	38	39
8	臺中市東勢區	2018-11-24T22:32:12+08:00	16563	4618	21181	2127	23308	40339	57.78%	41.06%	37	39
8	臺中市東勢區	2018-11-25T06:12:30+08:00	17561	4978	22539	2316	24855	43181	57.56%	40.67%	39	39
8	臺中市東勢區	2018-11-25T04:01:22+08:00	17561	4978	22539	2316	24855	43181	57.56%	40.67%	39	39
8	臺中市東勢區	2018-11-25T00:17:01+08:00	17561	4978	22539	2316	24855	43181	57.56%	40.67%	39	39
8	臺中市東勢區	2018-11-24T22:40:13+08:00	16947	4790	21737	2191	23928	41553	57.58%	40.78%	38	39
8	臺中市東勢區	2018-11-24T22:53:07+08:00	16947	4790	21737	2191	23928	41553	57.58%	40.78%	38	39
8	臺中市東勢區	2018-11-24T22:11:56+08:00	15950	4477	20427	2061	22488	38908	57.8%	40.99%	36	39
8	臺中市東勢區	2018-11-25T06:07:16+08:00	17561	4978	22539	2316	24855	43181	57.56%	40.67%	39	39
8	臺中市東勢區	2018-11-25T03:54:33+08:00	17561	4978	22539	2316	24855	43181	57.56%	40.67%	39	39
8	臺中市東勢區	2018-11-25T01:05:51+08:00	17561	4978	22539	2316	24855	43181	57.56%	40.67%	39	39
8	臺中市東勢區	2018-11-24T23:26:01+08:00	16947	4790	21737	2191	23928	41553	57.58%	40.78%	38	39
8	臺中市東勢區	2018-11-24T23:33:43+08:00	16947	4790	21737	2191	23928	41553	57.58%	40.78%	38	39
8	臺中市東勢區	2018-11-24T23:18:20+08:00	16947	4790	21737	2191	23928	41553	57.58%	40.78%	38	39
8	臺中市東勢區	2018-11-25T06:17:29+08:00	17561	4978	22539	2316	24855	43181	57.56%	40.67%	39	39
8	臺中市東勢區	2018-11-24T23:37:42+08:00	16947	4790	21737	2191	23928	41553	57.58%	40.78%	38	39
8	臺中市東勢區	2018-11-24T22:14:41+08:00	15950	4477	20427	2061	22488	38908	57.8%	40.99%	36	39
8	臺中市東勢區	2018-11-24T23:45:57+08:00	16947	4790	21737	2191	23928	41553	57.58%	40.78%	38	39
8	臺中市	2018-11-25T03:37:17+08:00	950822	273963	1224785	93034	1317819	2295642	57.41%	41.42%	601	1
8	臺中市	2018-11-24T23:10:50+08:00	828057	239658	1067715	82132	1149847	1996328	57.6%	41.48%	425	1
8	臺中市	2018-11-25T00:56:06+08:00	945068	272391	1217459	92580	1310039	2281141	57.43%	41.43%	593	1
8	臺中市	2018-11-24T23:22:16+08:00	857607	248058	1105665	85024	1190689	2068711	57.56%	41.46%	467	1
8	臺中市	2018-11-25T01:10:58+08:00	945661	272559	1218220	92634	1310854	2282657	57.43%	41.43%	594	1
8	臺中市	2018-11-25T00:12:37+08:00	925764	266886	1192650	90960	1283610	2233119	57.48%	41.46%	565	1
8	臺中市	2018-11-24T22:49:17+08:00	771294	223421	994715	76820	1071535	1857403	57.69%	41.53%	338	1
8	臺中市	2018-11-24T23:14:32+08:00	833833	241287	1075120	82647	1157767	2010523	57.59%	41.47%	433	1
8	臺中市	2018-11-24T22:43:43+08:00	745620	216437	962057	74476	1036533	1797032	57.68%	41.49%	300	1
8	臺中市	2018-11-25T00:03:26+08:00	912690	263476	1176166	89934	1266100	2202200	57.49%	41.44%	547	1
8	臺中市	2018-11-24T22:56:30+08:00	786373	227734	1014107	78227	1092334	1893594	57.69%	41.53%	361	1
8	臺中市	2018-11-25T06:22:37+08:00	950822	273963	1224785	93034	1317819	2295642	57.41%	41.42%	601	1
8	臺中市	2018-11-25T03:48:21+08:00	950822	273963	1224785	93034	1317819	2295642	57.41%	41.42%	601	1
8	臺中市	2018-11-25T03:30:51+08:00	950822	273963	1224785	93034	1317819	2295642	57.41%	41.42%	601	1
8	臺中市	2018-11-24T22:32:11+08:00	691557	201008	892565	69454	962019	1668635	57.65%	41.44%	216	1
8	臺中市	2018-11-25T04:01:21+08:00	950822	273963	1224785	93034	1317819	2295642	57.41%	41.42%	601	1
8	臺中市	2018-11-24T22:25:17+08:00	661814	192647	854461	66959	921420	1597980	57.66%	41.42%	171	1
8	臺中市	2018-11-25T06:07:15+08:00	950822	273963	1224785	93034	1317819	2295642	57.41%	41.42%	601	1
8	臺中市	2018-11-24T23:29:40+08:00	869962	251598	1121560	86205	1207765	2098996	57.54%	41.45%	485	1
8	臺中市	2018-11-24T22:18:12+08:00	611295	178296	789591	62372	851963	1477411	57.67%	41.38%	095	1
8	臺中市	2018-11-24T23:54:18+08:00	903338	260991	1164329	89119	1253448	2178980	57.52%	41.46%	534	1
8	臺中市	2018-11-25T00:07:57+08:00	917796	264840	1182636	90292	1272928	2214492	57.48%	41.44%	554	1
8	臺中市	2018-11-25T01:16:14+08:00	946505	272787	1219292	92718	1312010	2284808	57.42%	41.43%	595	1
8	臺中市	2018-11-24T23:41:55+08:00	894415	258373	1152788	88360	1241148	2157209	57.53%	41.46%	521	1
8	臺中市	2018-11-24T22:28:33+08:00	681142	197997	879139	68465	947604	1644024	57.64%	41.43%	200	1
8	臺中市	2018-11-24T23:58:34+08:00	908180	262298	1170478	89563	1260041	2191228	57.5%	41.45%	541	1
8	臺中市	2018-11-24T23:50:08+08:00	900867	260260	1161127	88915	1250042	2173313	57.52%	41.45%	531	1
8	臺中市	2018-11-25T01:24:16+08:00	947153	272951	1220104	92762	1312866	2286569	57.42%	41.42%	596	1
8	臺中市	2018-11-24T22:35:38+08:00	708590	205910	914500	71086	985586	1708711	57.68%	41.47%	242	1
8	臺中市	2018-11-24T23:07:12+08:00	822373	238059	1060432	81495	1141927	1982567	57.6%	41.48%	416	1
8	臺中市	2018-11-24T22:39:02+08:00	721171	209666	930837	72311	1003148	1739675	57.66%	41.45%	262	1
8	臺中市	2018-11-25T06:27:48+08:00	950822	273963	1224785	93034	1317819	2295642	57.41%	41.42%	601	1
8	臺中市	2018-11-24T23:03:41+08:00	813131	235302	1048433	80622	1129055	1959309	57.63%	41.5%	401	1
8	臺中市	2018-11-24T22:21:38+08:00	644590	187879	832469	65497	897966	1557107	57.67%	41.4%	145	1
8	臺中市	2018-11-25T03:42:40+08:00	950822	273963	1224785	93034	1317819	2295642	57.41%	41.42%	601	1
8	臺中市	2018-11-24T23:00:07+08:00	795274	230264	1025538	78978	1104516	1914787	57.68%	41.53%	374	1
8	臺中市	2018-11-25T00:21:36+08:00	933440	269015	1202455	91637	1294092	2252020	57.46%	41.45%	576	1
8	臺中市	2018-11-25T01:00:52+08:00	945661	272559	1218220	92634	1310854	2282657	57.43%	41.43%	594	1
8	臺中市	2018-11-25T06:12:30+08:00	950822	273963	1224785	93034	1317819	2295642	57.41%	41.42%	601	1
8	臺中市	2018-11-24T22:40:12+08:00	733146	213037	946183	73416	1019599	1767367	57.69%	41.48%	281	1
8	臺中市	2018-11-25T00:17:01+08:00	927979	267484	1195463	91181	1286644	2238579	57.48%	41.45%	568	1
8	臺中市	2018-11-24T22:53:07+08:00	779382	225762	1005144	77552	1082696	1877091	57.68%	41.52%	351	1
8	臺中市	2018-11-24T22:11:56+08:00	581085	169515	750600	59693	810293	1404727	57.68%	41.37%	050	1
8	臺中市	2018-11-25T03:54:33+08:00	950822	273963	1224785	93034	1317819	2295642	57.41%	41.42%	601	1
8	臺中市	2018-11-25T01:05:51+08:00	945661	272559	1218220	92634	1310854	2282657	57.43%	41.43%	594	1
8	臺中市	2018-11-24T23:33:43+08:00	875330	253046	1128376	86682	1215058	2111889	57.53%	41.45%	492	1
8	臺中市	2018-11-24T23:18:20+08:00	840946	243330	1084276	83345	1167621	2027229	57.6%	41.48%	443	1
8	臺中市	2018-11-25T06:17:29+08:00	950822	273963	1224785	93034	1317819	2295642	57.41%	41.42%	601	1
8	臺中市	2018-11-24T23:37:42+08:00	889977	257107	1147084	88034	1235118	2146679	57.54%	41.46%	514	1
8	臺中市	2018-11-24T22:14:41+08:00	597495	174349	771844	61125	832969	1443933	57.69%	41.38%	074	1
8	臺中市	2018-11-24T23:26:00+08:00	862428	249397	1111825	85433	1197258	2080193	57.56%	41.46%	474	1
8	臺中市	2018-11-24T23:45:57+08:00	899470	259972	1159442	88856	1248298	2170160	57.52%	41.45%	529	1
8	金門縣烏坵鄉	2018-11-24T23:26:10+08:00	135	20	155	10	165	567	29.1%	23.81%	2	2
8	金門縣烏坵鄉	2018-11-24T23:10:59+08:00	135	20	155	10	165	567	29.1%	23.81%	2	2
8	金門縣烏坵鄉	2018-11-24T22:49:27+08:00	135	20	155	10	165	567	29.1%	23.81%	2	2
8	金門縣烏坵鄉	2018-11-24T23:22:27+08:00	135	20	155	10	165	567	29.1%	23.81%	2	2
8	金門縣烏坵鄉	2018-11-24T23:33:54+08:00	135	20	155	10	165	567	29.1%	23.81%	2	2
8	金門縣烏坵鄉	2018-11-24T22:12:06+08:00	135	20	155	10	165	567	29.1%	23.81%	2	2
8	金門縣烏坵鄉	2018-11-24T22:56:39+08:00	135	20	155	10	165	567	29.1%	23.81%	2	2
8	金門縣烏坵鄉	2018-11-24T22:28:43+08:00	135	20	155	10	165	567	29.1%	23.81%	2	2
8	金門縣烏坵鄉	2018-11-24T23:18:30+08:00	135	20	155	10	165	567	29.1%	23.81%	2	2
8	金門縣烏坵鄉	2018-11-24T23:37:52+08:00	135	20	155	10	165	567	29.1%	23.81%	2	2
8	金門縣烏坵鄉	2018-11-24T22:53:19+08:00	135	20	155	10	165	567	29.1%	23.81%	2	2
8	金門縣烏坵鄉	2018-11-25T00:17:11+08:00	135	20	155	10	165	567	29.1%	23.81%	2	2
8	金門縣烏坵鄉	2018-11-24T22:32:21+08:00	135	20	155	10	165	567	29.1%	23.81%	2	2
8	金門縣烏坵鄉	2018-11-24T22:21:50+08:00	135	20	155	10	165	567	29.1%	23.81%	2	2
8	金門縣烏坵鄉	2018-11-25T04:01:33+08:00	135	20	155	10	165	567	29.1%	23.81%	2	2
8	金門縣烏坵鄉	2018-11-24T23:46:07+08:00	135	20	155	10	165	567	29.1%	23.81%	2	2
8	金門縣烏坵鄉	2018-11-25T00:08:08+08:00	135	20	155	10	165	567	29.1%	23.81%	2	2
8	金門縣烏坵鄉	2018-11-24T23:00:20+08:00	135	20	155	10	165	567	29.1%	23.81%	2	2
8	金門縣烏坵鄉	2018-11-24T22:25:29+08:00	135	20	155	10	165	567	29.1%	23.81%	2	2
8	金門縣烏坵鄉	2018-11-25T06:22:48+08:00	135	20	155	10	165	567	29.1%	23.81%	2	2
8	金門縣烏坵鄉	2018-11-25T03:48:35+08:00	135	20	155	10	165	567	29.1%	23.81%	2	2
8	金門縣烏坵鄉	2018-11-24T23:14:44+08:00	135	20	155	10	165	567	29.1%	23.81%	2	2
8	金門縣烏坵鄉	2018-11-25T00:12:49+08:00	135	20	155	10	165	567	29.1%	23.81%	2	2
8	金門縣烏坵鄉	2018-11-25T03:37:33+08:00	135	20	155	10	165	567	29.1%	23.81%	2	2
8	金門縣烏坵鄉	2018-11-24T22:18:23+08:00	135	20	155	10	165	567	29.1%	23.81%	2	2
8	金門縣烏坵鄉	2018-11-24T23:50:18+08:00	135	20	155	10	165	567	29.1%	23.81%	2	2
8	金門縣烏坵鄉	2018-11-24T23:58:46+08:00	135	20	155	10	165	567	29.1%	23.81%	2	2
8	金門縣烏坵鄉	2018-11-24T23:03:50+08:00	135	20	155	10	165	567	29.1%	23.81%	2	2
8	金門縣烏坵鄉	2018-11-24T22:39:12+08:00	135	20	155	10	165	567	29.1%	23.81%	2	2
8	金門縣烏坵鄉	2018-11-25T06:27:58+08:00	135	20	155	10	165	567	29.1%	23.81%	2	2
8	金門縣烏坵鄉	2018-11-25T06:17:40+08:00	135	20	155	10	165	567	29.1%	23.81%	2	2
8	金門縣烏坵鄉	2018-11-24T23:54:31+08:00	135	20	155	10	165	567	29.1%	23.81%	2	2
8	金門縣烏坵鄉	2018-11-24T22:14:52+08:00	135	20	155	10	165	567	29.1%	23.81%	2	2
8	金門縣烏坵鄉	2018-11-25T01:24:28+08:00	135	20	155	10	165	567	29.1%	23.81%	2	2
8	金門縣烏坵鄉	2018-11-25T03:54:45+08:00	135	20	155	10	165	567	29.1%	23.81%	2	2
8	金門縣烏坵鄉	2018-11-24T23:07:22+08:00	135	20	155	10	165	567	29.1%	23.81%	2	2
8	金門縣烏坵鄉	2018-11-25T06:12:40+08:00	135	20	155	10	165	567	29.1%	23.81%	2	2
8	金門縣烏坵鄉	2018-11-24T23:29:50+08:00	135	20	155	10	165	567	29.1%	23.81%	2	2
8	金門縣烏坵鄉	2018-11-24T23:42:05+08:00	135	20	155	10	165	567	29.1%	23.81%	2	2
8	金門縣烏坵鄉	2018-11-25T01:06:03+08:00	135	20	155	10	165	567	29.1%	23.81%	2	2
8	金門縣烏坵鄉	2018-11-25T01:11:11+08:00	135	20	155	10	165	567	29.1%	23.81%	2	2
8	金門縣烏坵鄉	2018-11-25T00:21:47+08:00	135	20	155	10	165	567	29.1%	23.81%	2	2
8	金門縣烏坵鄉	2018-11-25T03:42:52+08:00	135	20	155	10	165	567	29.1%	23.81%	2	2
8	金門縣烏坵鄉	2018-11-25T06:07:26+08:00	135	20	155	10	165	567	29.1%	23.81%	2	2
8	金門縣烏坵鄉	2018-11-24T22:40:22+08:00	135	20	155	10	165	567	29.1%	23.81%	2	2
8	金門縣烏坵鄉	2018-11-25T00:56:17+08:00	135	20	155	10	165	567	29.1%	23.81%	2	2
8	金門縣烏坵鄉	2018-11-24T22:35:48+08:00	135	20	155	10	165	567	29.1%	23.81%	2	2
8	金門縣烏坵鄉	2018-11-24T22:43:54+08:00	135	20	155	10	165	567	29.1%	23.81%	2	2
8	金門縣烏坵鄉	2018-11-25T03:31:03+08:00	135	20	155	10	165	567	29.1%	23.81%	2	2
8	金門縣烏坵鄉	2018-11-25T01:01:05+08:00	135	20	155	10	165	567	29.1%	23.81%	2	2
8	金門縣烏坵鄉	2018-11-25T01:16:26+08:00	135	20	155	10	165	567	29.1%	23.81%	2	2
8	金門縣烏坵鄉	2018-11-25T00:03:39+08:00	135	20	155	10	165	567	29.1%	23.81%	2	2
8	嘉義縣鹿草鄉	2018-11-24T23:07:18+08:00	3674	1190	4864	968	5832	12625	46.19%	29.1%	19	20
8	嘉義縣鹿草鄉	2018-11-24T22:56:36+08:00	3674	1190	4864	968	5832	12625	46.19%	29.1%	19	20
8	嘉義縣鹿草鄉	2018-11-25T01:24:24+08:00	4098	1349	5447	1042	6489	13937	46.56%	29.4%	20	20
8	嘉義縣鹿草鄉	2018-11-25T06:17:36+08:00	4098	1349	5447	1042	6489	13937	46.56%	29.4%	20	20
8	嘉義縣鹿草鄉	2018-11-24T23:10:56+08:00	3674	1190	4864	968	5832	12625	46.19%	29.1%	19	20
8	嘉義縣鹿草鄉	2018-11-25T03:37:29+08:00	4098	1349	5447	1042	6489	13937	46.56%	29.4%	20	20
8	嘉義縣鹿草鄉	2018-11-24T22:39:09+08:00	3674	1190	4864	968	5832	12625	46.19%	29.1%	19	20
8	嘉義縣鹿草鄉	2018-11-25T03:54:41+08:00	4098	1349	5447	1042	6489	13937	46.56%	29.4%	20	20
8	嘉義縣鹿草鄉	2018-11-25T03:30:59+08:00	4098	1349	5447	1042	6489	13937	46.56%	29.4%	20	20
8	嘉義縣鹿草鄉	2018-11-24T22:32:18+08:00	3674	1190	4864	968	5832	12625	46.19%	29.1%	19	20
8	嘉義縣鹿草鄉	2018-11-25T03:48:29+08:00	4098	1349	5447	1042	6489	13937	46.56%	29.4%	20	20
8	嘉義縣鹿草鄉	2018-11-24T23:00:17+08:00	3674	1190	4864	968	5832	12625	46.19%	29.1%	19	20
8	嘉義縣鹿草鄉	2018-11-25T00:21:44+08:00	4098	1349	5447	1042	6489	13937	46.56%	29.4%	20	20
8	嘉義縣鹿草鄉	2018-11-24T23:29:46+08:00	4098	1349	5447	1042	6489	13937	46.56%	29.4%	20	20
8	嘉義縣鹿草鄉	2018-11-25T06:07:23+08:00	4098	1349	5447	1042	6489	13937	46.56%	29.4%	20	20
8	嘉義縣鹿草鄉	2018-11-25T04:01:29+08:00	4098	1349	5447	1042	6489	13937	46.56%	29.4%	20	20
8	嘉義縣鹿草鄉	2018-11-25T01:11:07+08:00	4098	1349	5447	1042	6489	13937	46.56%	29.4%	20	20
8	嘉義縣鹿草鄉	2018-11-24T22:40:19+08:00	3674	1190	4864	968	5832	12625	46.19%	29.1%	19	20
8	嘉義縣鹿草鄉	2018-11-24T23:37:48+08:00	4098	1349	5447	1042	6489	13937	46.56%	29.4%	20	20
8	嘉義縣鹿草鄉	2018-11-24T22:43:50+08:00	3674	1190	4864	968	5832	12625	46.19%	29.1%	19	20
8	嘉義縣鹿草鄉	2018-11-25T00:56:13+08:00	4098	1349	5447	1042	6489	13937	46.56%	29.4%	20	20
8	嘉義縣鹿草鄉	2018-11-24T23:54:27+08:00	4098	1349	5447	1042	6489	13937	46.56%	29.4%	20	20
8	嘉義縣鹿草鄉	2018-11-25T01:16:22+08:00	4098	1349	5447	1042	6489	13937	46.56%	29.4%	20	20
8	嘉義縣鹿草鄉	2018-11-25T00:03:34+08:00	4098	1349	5447	1042	6489	13937	46.56%	29.4%	20	20
8	嘉義縣鹿草鄉	2018-11-24T22:35:44+08:00	3674	1190	4864	968	5832	12625	46.19%	29.1%	19	20
8	嘉義縣鹿草鄉	2018-11-25T01:01:01+08:00	4098	1349	5447	1042	6489	13937	46.56%	29.4%	20	20
8	嘉義縣鹿草鄉	2018-11-24T23:22:23+08:00	4098	1349	5447	1042	6489	13937	46.56%	29.4%	20	20
8	嘉義縣鹿草鄉	2018-11-24T22:49:24+08:00	3674	1190	4864	968	5832	12625	46.19%	29.1%	19	20
8	嘉義縣鹿草鄉	2018-11-24T23:03:47+08:00	3674	1190	4864	968	5832	12625	46.19%	29.1%	19	20
8	嘉義縣鹿草鄉	2018-11-24T22:28:40+08:00	3674	1190	4864	968	5832	12625	46.19%	29.1%	19	20
8	嘉義縣鹿草鄉	2018-11-24T23:33:50+08:00	4098	1349	5447	1042	6489	13937	46.56%	29.4%	20	20
8	嘉義縣鹿草鄉	2018-11-24T22:12:02+08:00	3416	1115	4531	858	5389	11795	45.69%	28.96%	18	20
8	嘉義縣鹿草鄉	2018-11-25T00:08:04+08:00	4098	1349	5447	1042	6489	13937	46.56%	29.4%	20	20
8	嘉義縣鹿草鄉	2018-11-24T23:42:02+08:00	4098	1349	5447	1042	6489	13937	46.56%	29.4%	20	20
8	嘉義縣鹿草鄉	2018-11-25T03:42:48+08:00	4098	1349	5447	1042	6489	13937	46.56%	29.4%	20	20
8	嘉義縣鹿草鄉	2018-11-24T22:53:15+08:00	3674	1190	4864	968	5832	12625	46.19%	29.1%	19	20
8	嘉義縣鹿草鄉	2018-11-24T23:46:03+08:00	4098	1349	5447	1042	6489	13937	46.56%	29.4%	20	20
8	嘉義縣鹿草鄉	2018-11-25T06:12:37+08:00	4098	1349	5447	1042	6489	13937	46.56%	29.4%	20	20
8	嘉義縣鹿草鄉	2018-11-24T22:21:46+08:00	3674	1190	4864	968	5832	12625	46.19%	29.1%	19	20
8	嘉義縣鹿草鄉	2018-11-24T22:25:25+08:00	3674	1190	4864	968	5832	12625	46.19%	29.1%	19	20
8	嘉義縣鹿草鄉	2018-11-25T00:17:08+08:00	4098	1349	5447	1042	6489	13937	46.56%	29.4%	20	20
8	嘉義縣鹿草鄉	2018-11-25T06:22:45+08:00	4098	1349	5447	1042	6489	13937	46.56%	29.4%	20	20
8	嘉義縣鹿草鄉	2018-11-24T22:14:49+08:00	3416	1115	4531	858	5389	11795	45.69%	28.96%	18	20
8	嘉義縣鹿草鄉	2018-11-24T23:18:27+08:00	4098	1349	5447	1042	6489	13937	46.56%	29.4%	20	20
8	嘉義縣鹿草鄉	2018-11-24T22:18:19+08:00	3416	1115	4531	858	5389	11795	45.69%	28.96%	18	20
8	嘉義縣鹿草鄉	2018-11-24T23:58:42+08:00	4098	1349	5447	1042	6489	13937	46.56%	29.4%	20	20
8	嘉義縣鹿草鄉	2018-11-25T06:27:55+08:00	4098	1349	5447	1042	6489	13937	46.56%	29.4%	20	20
8	嘉義縣鹿草鄉	2018-11-24T23:26:07+08:00	4098	1349	5447	1042	6489	13937	46.56%	29.4%	20	20
8	嘉義縣鹿草鄉	2018-11-25T00:12:45+08:00	4098	1349	5447	1042	6489	13937	46.56%	29.4%	20	20
8	嘉義縣鹿草鄉	2018-11-25T01:05:59+08:00	4098	1349	5447	1042	6489	13937	46.56%	29.4%	20	20
8	嘉義縣鹿草鄉	2018-11-24T23:14:41+08:00	3674	1190	4864	968	5832	12625	46.19%	29.1%	19	20
8	嘉義縣鹿草鄉	2018-11-24T23:50:15+08:00	4098	1349	5447	1042	6489	13937	46.56%	29.4%	20	20
8	嘉義縣太保市	2018-11-24T22:39:08+08:00	8919	3072	11991	1248	13239	25677	51.56%	34.74%	29	33
8	嘉義縣太保市	2018-11-24T23:07:18+08:00	9457	3259	12716	1289	14005	27250	51.39%	34.7%	30	33
8	嘉義縣太保市	2018-11-24T22:56:36+08:00	9457	3259	12716	1289	14005	27250	51.39%	34.7%	30	33
8	嘉義縣太保市	2018-11-25T01:24:24+08:00	10962	3836	14798	1601	16399	31568	51.95%	34.73%	33	33
8	嘉義縣太保市	2018-11-25T03:54:40+08:00	10962	3836	14798	1601	16399	31568	51.95%	34.73%	33	33
8	嘉義縣太保市	2018-11-25T03:37:29+08:00	10962	3836	14798	1601	16399	31568	51.95%	34.73%	33	33
8	嘉義縣太保市	2018-11-25T03:30:59+08:00	10962	3836	14798	1601	16399	31568	51.95%	34.73%	33	33
8	嘉義縣太保市	2018-11-24T22:32:18+08:00	8919	3072	11991	1248	13239	25677	51.56%	34.74%	29	33
8	嘉義縣太保市	2018-11-24T23:42:01+08:00	9981	3484	13465	1385	14850	28761	51.63%	34.7%	31	33
8	嘉義縣太保市	2018-11-25T03:48:29+08:00	10962	3836	14798	1601	16399	31568	51.95%	34.73%	33	33
8	嘉義縣太保市	2018-11-25T06:07:22+08:00	10962	3836	14798	1601	16399	31568	51.95%	34.73%	33	33
8	嘉義縣太保市	2018-11-25T00:21:44+08:00	10547	3661	14208	1488	15696	30290	51.82%	34.82%	32	33
8	嘉義縣太保市	2018-11-24T23:29:46+08:00	9981	3484	13465	1385	14850	28761	51.63%	34.7%	31	33
8	嘉義縣太保市	2018-11-24T22:40:18+08:00	8919	3072	11991	1248	13239	25677	51.56%	34.74%	29	33
8	嘉義縣太保市	2018-11-25T04:01:29+08:00	10962	3836	14798	1601	16399	31568	51.95%	34.73%	33	33
8	嘉義縣太保市	2018-11-24T23:00:16+08:00	9457	3259	12716	1289	14005	27250	51.39%	34.7%	30	33
8	嘉義縣太保市	2018-11-25T01:11:07+08:00	10962	3836	14798	1601	16399	31568	51.95%	34.73%	33	33
8	嘉義縣太保市	2018-11-24T23:37:48+08:00	9981	3484	13465	1385	14850	28761	51.63%	34.7%	31	33
8	嘉義縣太保市	2018-11-24T22:43:50+08:00	8919	3072	11991	1248	13239	25677	51.56%	34.74%	29	33
8	嘉義縣太保市	2018-11-25T00:56:13+08:00	10962	3836	14798	1601	16399	31568	51.95%	34.73%	33	33
8	嘉義縣太保市	2018-11-24T23:54:27+08:00	10547	3661	14208	1488	15696	30290	51.82%	34.82%	32	33
8	嘉義縣太保市	2018-11-25T01:16:22+08:00	10962	3836	14798	1601	16399	31568	51.95%	34.73%	33	33
8	嘉義縣太保市	2018-11-25T00:03:34+08:00	10547	3661	14208	1488	15696	30290	51.82%	34.82%	32	33
8	嘉義縣太保市	2018-11-24T22:35:44+08:00	8919	3072	11991	1248	13239	25677	51.56%	34.74%	29	33
8	嘉義縣太保市	2018-11-25T01:01:01+08:00	10962	3836	14798	1601	16399	31568	51.95%	34.73%	33	33
8	嘉義縣太保市	2018-11-24T23:22:23+08:00	9457	3259	12716	1289	14005	27250	51.39%	34.7%	30	33
8	嘉義縣太保市	2018-11-25T06:17:35+08:00	10962	3836	14798	1601	16399	31568	51.95%	34.73%	33	33
8	嘉義縣太保市	2018-11-24T22:49:23+08:00	9457	3259	12716	1289	14005	27250	51.39%	34.7%	30	33
8	嘉義縣太保市	2018-11-24T23:03:47+08:00	9457	3259	12716	1289	14005	27250	51.39%	34.7%	30	33
8	嘉義縣太保市	2018-11-24T22:28:40+08:00	8919	3072	11991	1248	13239	25677	51.56%	34.74%	29	33
8	嘉義縣太保市	2018-11-24T23:10:55+08:00	9457	3259	12716	1289	14005	27250	51.39%	34.7%	30	33
8	嘉義縣太保市	2018-11-24T23:33:50+08:00	9981	3484	13465	1385	14850	28761	51.63%	34.7%	31	33
8	嘉義縣太保市	2018-11-24T22:12:02+08:00	8551	2946	11497	1189	12686	24541	51.69%	34.84%	27	33
8	嘉義縣太保市	2018-11-25T00:08:04+08:00	10547	3661	14208	1488	15696	30290	51.82%	34.82%	32	33
8	嘉義縣太保市	2018-11-24T22:53:14+08:00	9457	3259	12716	1289	14005	27250	51.39%	34.7%	30	33
8	嘉義縣太保市	2018-11-25T03:42:48+08:00	10962	3836	14798	1601	16399	31568	51.95%	34.73%	33	33
8	嘉義縣太保市	2018-11-24T23:46:03+08:00	9981	3484	13465	1385	14850	28761	51.63%	34.7%	31	33
8	嘉義縣太保市	2018-11-25T00:17:07+08:00	10547	3661	14208	1488	15696	30290	51.82%	34.82%	32	33
8	嘉義縣太保市	2018-11-24T22:21:46+08:00	8919	3072	11991	1248	13239	25677	51.56%	34.74%	29	33
8	嘉義縣太保市	2018-11-24T22:25:25+08:00	8919	3072	11991	1248	13239	25677	51.56%	34.74%	29	33
8	嘉義縣太保市	2018-11-25T06:22:44+08:00	10962	3836	14798	1601	16399	31568	51.95%	34.73%	33	33
8	嘉義縣太保市	2018-11-25T06:12:36+08:00	10962	3836	14798	1601	16399	31568	51.95%	34.73%	33	33
8	嘉義縣太保市	2018-11-25T00:12:44+08:00	10547	3661	14208	1488	15696	30290	51.82%	34.82%	32	33
8	嘉義縣太保市	2018-11-24T23:26:06+08:00	9981	3484	13465	1385	14850	28761	51.63%	34.7%	31	33
8	嘉義縣太保市	2018-11-24T23:18:27+08:00	9457	3259	12716	1289	14005	27250	51.39%	34.7%	30	33
8	嘉義縣太保市	2018-11-24T23:50:14+08:00	9981	3484	13465	1385	14850	28761	51.63%	34.7%	31	33
8	嘉義縣太保市	2018-11-24T23:14:40+08:00	9457	3259	12716	1289	14005	27250	51.39%	34.7%	30	33
8	嘉義縣太保市	2018-11-24T22:18:19+08:00	8919	3072	11991	1248	13239	25677	51.56%	34.74%	29	33
8	嘉義縣太保市	2018-11-24T23:58:42+08:00	10547	3661	14208	1488	15696	30290	51.82%	34.82%	32	33
8	嘉義縣太保市	2018-11-25T06:27:55+08:00	10962	3836	14798	1601	16399	31568	51.95%	34.73%	33	33
8	嘉義縣太保市	2018-11-24T22:14:48+08:00	8919	3072	11991	1248	13239	25677	51.56%	34.74%	29	33
8	嘉義縣太保市	2018-11-25T01:05:59+08:00	10962	3836	14798	1601	16399	31568	51.95%	34.73%	33	33
8	高雄市杉林區	2018-11-24T22:49:20+08:00	3178	1039	4217	508	4725	10607	44.55%	29.96%	10	10
8	高雄市杉林區	2018-11-24T23:03:44+08:00	3178	1039	4217	508	4725	10607	44.55%	29.96%	10	10
8	高雄市杉林區	2018-11-24T23:22:20+08:00	3178	1039	4217	508	4725	10607	44.55%	29.96%	10	10
8	高雄市杉林區	2018-11-24T23:58:38+08:00	3178	1039	4217	508	4725	10607	44.55%	29.96%	10	10
8	高雄市杉林區	2018-11-25T03:42:44+08:00	3178	1039	4217	508	4725	10607	44.55%	29.96%	10	10
8	高雄市杉林區	2018-11-25T01:00:57+08:00	3178	1039	4217	508	4725	10607	44.55%	29.96%	10	10
8	高雄市杉林區	2018-11-24T22:53:11+08:00	3178	1039	4217	508	4725	10607	44.55%	29.96%	10	10
8	高雄市杉林區	2018-11-24T23:46:00+08:00	3178	1039	4217	508	4725	10607	44.55%	29.96%	10	10
8	高雄市杉林區	2018-11-25T00:08:01+08:00	3178	1039	4217	508	4725	10607	44.55%	29.96%	10	10
8	高雄市杉林區	2018-11-24T22:21:42+08:00	3178	1039	4217	508	4725	10607	44.55%	29.96%	10	10
8	高雄市杉林區	2018-11-25T06:12:33+08:00	3178	1039	4217	508	4725	10607	44.55%	29.96%	10	10
8	高雄市杉林區	2018-11-25T00:17:04+08:00	3178	1039	4217	508	4725	10607	44.55%	29.96%	10	10
8	高雄市杉林區	2018-11-24T22:25:20+08:00	3178	1039	4217	508	4725	10607	44.55%	29.96%	10	10
8	高雄市杉林區	2018-11-24T23:18:24+08:00	3178	1039	4217	508	4725	10607	44.55%	29.96%	10	10
8	高雄市杉林區	2018-11-25T03:54:37+08:00	3178	1039	4217	508	4725	10607	44.55%	29.96%	10	10
8	高雄市杉林區	2018-11-24T23:33:47+08:00	3178	1039	4217	508	4725	10607	44.55%	29.96%	10	10
8	高雄市杉林區	2018-11-25T01:05:55+08:00	3178	1039	4217	508	4725	10607	44.55%	29.96%	10	10
8	高雄市杉林區	2018-11-24T23:50:11+08:00	3178	1039	4217	508	4725	10607	44.55%	29.96%	10	10
8	高雄市杉林區	2018-11-24T23:26:04+08:00	3178	1039	4217	508	4725	10607	44.55%	29.96%	10	10
8	高雄市杉林區	2018-11-24T22:14:45+08:00	3178	1039	4217	508	4725	10607	44.55%	29.96%	10	10
8	高雄市杉林區	2018-11-25T01:24:20+08:00	3178	1039	4217	508	4725	10607	44.55%	29.96%	10	10
8	高雄市杉林區	2018-11-24T22:43:46+08:00	3178	1039	4217	508	4725	10607	44.55%	29.96%	10	10
8	高雄市杉林區	2018-11-25T06:17:32+08:00	3178	1039	4217	508	4725	10607	44.55%	29.96%	10	10
8	高雄市杉林區	2018-11-25T03:37:22+08:00	3178	1039	4217	508	4725	10607	44.55%	29.96%	10	10
8	高雄市杉林區	2018-11-24T23:07:15+08:00	3178	1039	4217	508	4725	10607	44.55%	29.96%	10	10
8	高雄市杉林區	2018-11-24T22:39:05+08:00	3178	1039	4217	508	4725	10607	44.55%	29.96%	10	10
8	高雄市杉林區	2018-11-24T23:10:53+08:00	3178	1039	4217	508	4725	10607	44.55%	29.96%	10	10
8	高雄市杉林區	2018-11-24T22:56:33+08:00	3178	1039	4217	508	4725	10607	44.55%	29.96%	10	10
8	高雄市杉林區	2018-11-24T23:14:36+08:00	3178	1039	4217	508	4725	10607	44.55%	29.96%	10	10
8	高雄市杉林區	2018-11-25T03:48:25+08:00	3178	1039	4217	508	4725	10607	44.55%	29.96%	10	10
8	高雄市杉林區	2018-11-25T03:30:55+08:00	3178	1039	4217	508	4725	10607	44.55%	29.96%	10	10
8	高雄市杉林區	2018-11-24T22:32:15+08:00	3178	1039	4217	508	4725	10607	44.55%	29.96%	10	10
8	高雄市杉林區	2018-11-24T22:40:15+08:00	3178	1039	4217	508	4725	10607	44.55%	29.96%	10	10
8	高雄市杉林區	2018-11-25T04:01:25+08:00	3178	1039	4217	508	4725	10607	44.55%	29.96%	10	10
8	高雄市杉林區	2018-11-24T22:11:59+08:00	3178	1039	4217	508	4725	10607	44.55%	29.96%	10	10
8	高雄市杉林區	2018-11-24T23:00:14+08:00	3178	1039	4217	508	4725	10607	44.55%	29.96%	10	10
8	高雄市杉林區	2018-11-25T06:07:19+08:00	3178	1039	4217	508	4725	10607	44.55%	29.96%	10	10
8	高雄市杉林區	2018-11-25T01:11:03+08:00	3178	1039	4217	508	4725	10607	44.55%	29.96%	10	10
8	高雄市杉林區	2018-11-24T23:29:43+08:00	3178	1039	4217	508	4725	10607	44.55%	29.96%	10	10
8	高雄市杉林區	2018-11-25T00:21:41+08:00	3178	1039	4217	508	4725	10607	44.55%	29.96%	10	10
8	高雄市杉林區	2018-11-25T06:22:42+08:00	3178	1039	4217	508	4725	10607	44.55%	29.96%	10	10
8	高雄市杉林區	2018-11-24T22:28:36+08:00	3178	1039	4217	508	4725	10607	44.55%	29.96%	10	10
8	高雄市杉林區	2018-11-25T00:56:10+08:00	3178	1039	4217	508	4725	10607	44.55%	29.96%	10	10
8	高雄市杉林區	2018-11-24T22:18:16+08:00	3178	1039	4217	508	4725	10607	44.55%	29.96%	10	10
8	高雄市杉林區	2018-11-24T23:54:24+08:00	3178	1039	4217	508	4725	10607	44.55%	29.96%	10	10
8	高雄市杉林區	2018-11-24T22:35:41+08:00	3178	1039	4217	508	4725	10607	44.55%	29.96%	10	10
8	高雄市杉林區	2018-11-25T01:16:18+08:00	3178	1039	4217	508	4725	10607	44.55%	29.96%	10	10
8	高雄市杉林區	2018-11-24T23:37:45+08:00	3178	1039	4217	508	4725	10607	44.55%	29.96%	10	10
8	高雄市杉林區	2018-11-24T23:41:58+08:00	3178	1039	4217	508	4725	10607	44.55%	29.96%	10	10
8	高雄市杉林區	2018-11-25T06:27:52+08:00	3178	1039	4217	508	4725	10607	44.55%	29.96%	10	10
8	高雄市杉林區	2018-11-25T00:12:42+08:00	3178	1039	4217	508	4725	10607	44.55%	29.96%	10	10
8	高雄市杉林區	2018-11-25T00:03:30+08:00	3178	1039	4217	508	4725	10607	44.55%	29.96%	10	10
8	高雄市路竹區	2018-11-24T22:49:20+08:00	17563	5709	23272	2274	25546	43850	58.26%	40.05%	41	41
8	高雄市路竹區	2018-11-25T03:37:21+08:00	17563	5709	23272	2274	25546	43850	58.26%	40.05%	41	41
8	高雄市路竹區	2018-11-24T23:03:44+08:00	17563	5709	23272	2274	25546	43850	58.26%	40.05%	41	41
8	高雄市路竹區	2018-11-25T00:03:29+08:00	17563	5709	23272	2274	25546	43850	58.26%	40.05%	41	41
8	高雄市路竹區	2018-11-25T00:56:09+08:00	17563	5709	23272	2274	25546	43850	58.26%	40.05%	41	41
8	高雄市路竹區	2018-11-24T23:58:38+08:00	17563	5709	23272	2274	25546	43850	58.26%	40.05%	41	41
8	高雄市路竹區	2018-11-24T23:22:19+08:00	17563	5709	23272	2274	25546	43850	58.26%	40.05%	41	41
8	高雄市路竹區	2018-11-25T03:42:44+08:00	17563	5709	23272	2274	25546	43850	58.26%	40.05%	41	41
8	高雄市路竹區	2018-11-24T22:53:10+08:00	17563	5709	23272	2274	25546	43850	58.26%	40.05%	41	41
8	高雄市路竹區	2018-11-25T01:00:57+08:00	17563	5709	23272	2274	25546	43850	58.26%	40.05%	41	41
8	高雄市路竹區	2018-11-25T00:08:00+08:00	17563	5709	23272	2274	25546	43850	58.26%	40.05%	41	41
8	高雄市路竹區	2018-11-24T23:46:00+08:00	17563	5709	23272	2274	25546	43850	58.26%	40.05%	41	41
8	高雄市路竹區	2018-11-24T22:21:42+08:00	16016	5157	21173	2068	23241	39854	58.32%	40.19%	38	41
8	高雄市路竹區	2018-11-25T06:12:33+08:00	17563	5709	23272	2274	25546	43850	58.26%	40.05%	41	41
8	高雄市路竹區	2018-11-25T00:17:04+08:00	17563	5709	23272	2274	25546	43850	58.26%	40.05%	41	41
8	高雄市路竹區	2018-11-25T06:22:41+08:00	17563	5709	23272	2274	25546	43850	58.26%	40.05%	41	41
8	高雄市路竹區	2018-11-24T22:25:20+08:00	16016	5157	21173	2068	23241	39854	58.32%	40.19%	38	41
8	高雄市路竹區	2018-11-24T23:18:23+08:00	17563	5709	23272	2274	25546	43850	58.26%	40.05%	41	41
8	高雄市路竹區	2018-11-24T23:50:11+08:00	17563	5709	23272	2274	25546	43850	58.26%	40.05%	41	41
8	高雄市路竹區	2018-11-25T01:05:54+08:00	17563	5709	23272	2274	25546	43850	58.26%	40.05%	41	41
8	高雄市路竹區	2018-11-24T22:14:45+08:00	15293	4973	20266	1995	22261	38317	58.1%	39.91%	37	41
8	高雄市路竹區	2018-11-24T23:33:46+08:00	17563	5709	23272	2274	25546	43850	58.26%	40.05%	41	41
8	高雄市路竹區	2018-11-25T06:27:51+08:00	17563	5709	23272	2274	25546	43850	58.26%	40.05%	41	41
8	高雄市路竹區	2018-11-24T23:26:03+08:00	17563	5709	23272	2274	25546	43850	58.26%	40.05%	41	41
8	高雄市路竹區	2018-11-25T03:54:36+08:00	17563	5709	23272	2274	25546	43850	58.26%	40.05%	41	41
8	高雄市路竹區	2018-11-25T00:12:41+08:00	17563	5709	23272	2274	25546	43850	58.26%	40.05%	41	41
8	高雄市路竹區	2018-11-25T01:24:20+08:00	17563	5709	23272	2274	25546	43850	58.26%	40.05%	41	41
8	高雄市路竹區	2018-11-24T22:43:46+08:00	17563	5709	23272	2274	25546	43850	58.26%	40.05%	41	41
8	高雄市路竹區	2018-11-25T06:17:32+08:00	17563	5709	23272	2274	25546	43850	58.26%	40.05%	41	41
8	高雄市路竹區	2018-11-24T23:07:15+08:00	17563	5709	23272	2274	25546	43850	58.26%	40.05%	41	41
8	高雄市路竹區	2018-11-24T22:39:05+08:00	16947	5486	22433	2209	24642	42213	58.38%	40.15%	40	41
8	高雄市路竹區	2018-11-24T22:56:33+08:00	17563	5709	23272	2274	25546	43850	58.26%	40.05%	41	41
8	高雄市路竹區	2018-11-24T23:14:36+08:00	17563	5709	23272	2274	25546	43850	58.26%	40.05%	41	41
8	高雄市路竹區	2018-11-24T23:10:52+08:00	17563	5709	23272	2274	25546	43850	58.26%	40.05%	41	41
8	高雄市路竹區	2018-11-25T03:48:25+08:00	17563	5709	23272	2274	25546	43850	58.26%	40.05%	41	41
8	高雄市路竹區	2018-11-24T22:32:14+08:00	16477	5327	21804	2145	23949	41031	58.37%	40.16%	39	41
8	高雄市路竹區	2018-11-25T03:30:54+08:00	17563	5709	23272	2274	25546	43850	58.26%	40.05%	41	41
8	高雄市路竹區	2018-11-24T22:40:15+08:00	17563	5709	23272	2274	25546	43850	58.26%	40.05%	41	41
8	高雄市路竹區	2018-11-25T00:21:40+08:00	17563	5709	23272	2274	25546	43850	58.26%	40.05%	41	41
8	高雄市路竹區	2018-11-24T23:29:42+08:00	17563	5709	23272	2274	25546	43850	58.26%	40.05%	41	41
8	高雄市路竹區	2018-11-25T01:11:02+08:00	17563	5709	23272	2274	25546	43850	58.26%	40.05%	41	41
8	高雄市路竹區	2018-11-25T04:01:25+08:00	17563	5709	23272	2274	25546	43850	58.26%	40.05%	41	41
8	高雄市路竹區	2018-11-24T22:11:59+08:00	15293	4973	20266	1995	22261	38317	58.1%	39.91%	37	41
8	高雄市路竹區	2018-11-24T23:00:14+08:00	17563	5709	23272	2274	25546	43850	58.26%	40.05%	41	41
8	高雄市路竹區	2018-11-25T06:07:19+08:00	17563	5709	23272	2274	25546	43850	58.26%	40.05%	41	41
8	高雄市路竹區	2018-11-24T22:28:36+08:00	16477	5327	21804	2145	23949	41031	58.37%	40.16%	39	41
8	高雄市路竹區	2018-11-24T22:18:16+08:00	15293	4973	20266	1995	22261	38317	58.1%	39.91%	37	41
8	高雄市路竹區	2018-11-24T23:54:23+08:00	17563	5709	23272	2274	25546	43850	58.26%	40.05%	41	41
8	高雄市路竹區	2018-11-24T22:35:41+08:00	16477	5327	21804	2145	23949	41031	58.37%	40.16%	39	41
8	高雄市路竹區	2018-11-24T23:37:45+08:00	17563	5709	23272	2274	25546	43850	58.26%	40.05%	41	41
8	高雄市路竹區	2018-11-24T23:41:58+08:00	17563	5709	23272	2274	25546	43850	58.26%	40.05%	41	41
8	高雄市路竹區	2018-11-25T01:16:17+08:00	17563	5709	23272	2274	25546	43850	58.26%	40.05%	41	41
8	花蓮縣	2018-11-24T22:14:51+08:00	36506	9797	46303	4687	50990	99500	51.25%	36.69%	138	299
8	花蓮縣	2018-11-24T23:33:52+08:00	69718	18849	88567	8517	97084	186648	52.01%	37.35%	222	299
8	花蓮縣	2018-11-25T06:17:38+08:00	104153	28095	132248	12163	144411	278059	51.94%	37.46%	299	299
8	花蓮縣	2018-11-24T22:28:42+08:00	40269	10827	51096	5115	56211	109191	51.48%	36.88%	149	299
8	花蓮縣	2018-11-24T22:56:38+08:00	51869	13923	65792	6531	72323	139340	51.9%	37.22%	177	299
8	花蓮縣	2018-11-24T23:07:21+08:00	56818	15258	72076	7032	79108	152160	51.99%	37.34%	190	299
8	花蓮縣	2018-11-24T22:49:26+08:00	49943	13398	63341	6271	69612	134579	51.73%	37.11%	173	299
8	花蓮縣	2018-11-24T23:10:58+08:00	57914	15552	73466	7154	80620	155327	51.9%	37.29%	193	299
8	花蓮縣	2018-11-24T22:53:17+08:00	51230	13769	64999	6483	71482	137908	51.83%	37.15%	176	299
8	花蓮縣	2018-11-24T22:32:20+08:00	41603	11197	52800	5258	58058	112454	51.63%	37%	152	299
8	花蓮縣	2018-11-25T00:17:10+08:00	84436	22784	107220	10086	117306	225394	52.04%	37.46%	256	299
8	花蓮縣	2018-11-25T00:08:06+08:00	80617	21755	102372	9660	112032	215341	52.03%	37.44%	248	299
8	花蓮縣	2018-11-25T03:48:33+08:00	104153	28095	132248	12163	144411	278059	51.94%	37.46%	299	299
8	花蓮縣	2018-11-25T06:07:25+08:00	104153	28095	132248	12163	144411	278059	51.94%	37.46%	299	299
8	花蓮縣	2018-11-24T23:29:48+08:00	66059	17758	83817	8159	91976	176583	52.09%	37.41%	213	299
8	花蓮縣	2018-11-24T22:40:20+08:00	42899	11543	54442	5422	59864	115575	51.8%	37.12%	156	299
8	花蓮縣	2018-11-25T06:22:46+08:00	104153	28095	132248	12163	144411	278059	51.94%	37.46%	299	299
8	花蓮縣	2018-11-24T23:00:18+08:00	52466	14067	66533	6587	73120	140807	51.93%	37.26%	178	299
8	花蓮縣	2018-11-24T22:25:27+08:00	39716	10628	50344	4968	55312	107624	51.39%	36.9%	147	299
8	花蓮縣	2018-11-25T03:42:50+08:00	104153	28095	132248	12163	144411	278059	51.94%	37.46%	299	299
8	花蓮縣	2018-11-25T01:11:09+08:00	98010	26286	124296	11400	135696	260456	52.1%	37.63%	284	299
8	花蓮縣	2018-11-24T23:14:43+08:00	58296	15687	73983	7220	81203	156398	51.92%	37.27%	194	299
8	花蓮縣	2018-11-25T01:16:24+08:00	98010	26286	124296	11400	135696	260456	52.1%	37.63%	284	299
8	花蓮縣	2018-11-25T00:12:47+08:00	82887	22390	105277	9882	115159	221344	52.03%	37.45%	253	299
8	花蓮縣	2018-11-24T23:54:29+08:00	78144	21081	99225	9389	108614	208150	52.18%	37.54%	242	299
8	花蓮縣	2018-11-25T06:27:57+08:00	104153	28095	132248	12163	144411	278059	51.94%	37.46%	299	299
8	花蓮縣	2018-11-25T03:31:01+08:00	104153	28095	132248	12163	144411	278059	51.94%	37.46%	299	299
8	花蓮縣	2018-11-24T23:50:16+08:00	77208	20847	98055	9306	107361	205822	52.16%	37.51%	240	299
8	花蓮縣	2018-11-25T00:56:15+08:00	96157	25752	121909	11188	133097	255657	52.06%	37.61%	280	299
8	花蓮縣	2018-11-24T23:37:50+08:00	70528	19073	89601	8587	98188	188942	51.97%	37.33%	224	299
8	花蓮縣	2018-11-25T01:24:27+08:00	99444	26665	126109	11502	137611	264340	52.06%	37.62%	287	299
8	花蓮縣	2018-11-25T03:54:43+08:00	104153	28095	132248	12163	144411	278059	51.94%	37.46%	299	299
8	花蓮縣	2018-11-24T23:03:49+08:00	55748	14888	70636	6926	77562	148838	52.11%	37.46%	186	299
8	花蓮縣	2018-11-24T22:12:04+08:00	36041	9701	45742	4626	50368	98312	51.23%	36.66%	137	299
8	花蓮縣	2018-11-24T23:22:25+08:00	63488	17080	80568	7879	88447	170158	51.98%	37.31%	207	299
8	花蓮縣	2018-11-25T01:06:02+08:00	97701	26163	123864	11306	135170	259635	52.06%	37.63%	283	299
8	花蓮縣	2018-11-24T23:42:03+08:00	72804	19713	92517	8854	101371	194621	52.09%	37.41%	229	299
8	花蓮縣	2018-11-24T23:46:05+08:00	76095	20558	96653	9195	105848	202805	52.19%	37.52%	237	299
8	花蓮縣	2018-11-25T04:01:31+08:00	104153	28095	132248	12163	144411	278059	51.94%	37.46%	299	299
8	花蓮縣	2018-11-25T06:12:39+08:00	104153	28095	132248	12163	144411	278059	51.94%	37.46%	299	299
8	花蓮縣	2018-11-24T22:21:48+08:00	39391	10531	49922	4932	54854	106851	51.34%	36.87%	146	299
8	花蓮縣	2018-11-25T00:21:46+08:00	87049	23477	110526	10354	120880	232557	51.98%	37.43%	262	299
8	花蓮縣	2018-11-25T01:01:03+08:00	96706	25904	122610	11236	133846	256988	52.08%	37.63%	281	299
8	花蓮縣	2018-11-24T22:35:46+08:00	42615	11474	54089	5375	59464	114974	51.72%	37.06%	155	299
8	花蓮縣	2018-11-24T23:58:44+08:00	79359	21423	100782	9552	110334	212071	52.03%	37.42%	245	299
8	花蓮縣	2018-11-24T23:18:29+08:00	59312	15966	75278	7370	82648	159121	51.94%	37.27%	198	299
8	花蓮縣	2018-11-25T03:37:31+08:00	104153	28095	132248	12163	144411	278059	51.94%	37.46%	299	299
8	花蓮縣	2018-11-24T22:18:21+08:00	36506	9797	46303	4687	50990	99500	51.25%	36.69%	138	299
8	花蓮縣	2018-11-24T22:39:11+08:00	42615	11474	54089	5375	59464	114974	51.72%	37.06%	155	299
8	花蓮縣	2018-11-24T23:26:09+08:00	64512	17347	81859	7973	89832	172574	52.05%	37.38%	209	299
8	花蓮縣	2018-11-25T00:03:37+08:00	80326	21664	101990	9611	111601	214490	52.03%	37.45%	247	299
8	花蓮縣	2018-11-24T22:43:52+08:00	44392	11876	56268	5560	61828	119299	51.83%	37.21%	159	299
8	花蓮縣富里鄉	2018-11-24T22:14:51+08:00	2782	822	3604	509	4113	9065	45.37%	30.69%	13	13
8	花蓮縣富里鄉	2018-11-24T23:33:52+08:00	2782	822	3604	509	4113	9065	45.37%	30.69%	13	13
8	花蓮縣富里鄉	2018-11-24T22:28:42+08:00	2782	822	3604	509	4113	9065	45.37%	30.69%	13	13
8	花蓮縣富里鄉	2018-11-24T22:56:38+08:00	2782	822	3604	509	4113	9065	45.37%	30.69%	13	13
8	花蓮縣富里鄉	2018-11-24T23:07:21+08:00	2782	822	3604	509	4113	9065	45.37%	30.69%	13	13
8	花蓮縣富里鄉	2018-11-24T22:49:26+08:00	2782	822	3604	509	4113	9065	45.37%	30.69%	13	13
8	花蓮縣富里鄉	2018-11-24T23:10:58+08:00	2782	822	3604	509	4113	9065	45.37%	30.69%	13	13
8	花蓮縣富里鄉	2018-11-25T06:17:39+08:00	2782	822	3604	509	4113	9065	45.37%	30.69%	13	13
8	花蓮縣富里鄉	2018-11-24T22:53:17+08:00	2782	822	3604	509	4113	9065	45.37%	30.69%	13	13
8	花蓮縣富里鄉	2018-11-24T23:46:06+08:00	2782	822	3604	509	4113	9065	45.37%	30.69%	13	13
8	花蓮縣富里鄉	2018-11-25T00:08:07+08:00	2782	822	3604	509	4113	9065	45.37%	30.69%	13	13
8	花蓮縣富里鄉	2018-11-24T22:32:20+08:00	2782	822	3604	509	4113	9065	45.37%	30.69%	13	13
8	花蓮縣富里鄉	2018-11-25T00:17:10+08:00	2782	822	3604	509	4113	9065	45.37%	30.69%	13	13
8	花蓮縣富里鄉	2018-11-25T03:48:33+08:00	2782	822	3604	509	4113	9065	45.37%	30.69%	13	13
8	花蓮縣富里鄉	2018-11-24T23:00:19+08:00	2782	822	3604	509	4113	9065	45.37%	30.69%	13	13
8	花蓮縣富里鄉	2018-11-25T06:07:25+08:00	2782	822	3604	509	4113	9065	45.37%	30.69%	13	13
8	花蓮縣富里鄉	2018-11-25T06:22:47+08:00	2782	822	3604	509	4113	9065	45.37%	30.69%	13	13
8	花蓮縣富里鄉	2018-11-25T03:42:51+08:00	2782	822	3604	509	4113	9065	45.37%	30.69%	13	13
8	花蓮縣富里鄉	2018-11-24T22:25:27+08:00	2782	822	3604	509	4113	9065	45.37%	30.69%	13	13
8	花蓮縣富里鄉	2018-11-24T22:40:21+08:00	2782	822	3604	509	4113	9065	45.37%	30.69%	13	13
8	花蓮縣富里鄉	2018-11-24T23:29:49+08:00	2782	822	3604	509	4113	9065	45.37%	30.69%	13	13
8	花蓮縣富里鄉	2018-11-24T23:50:17+08:00	2782	822	3604	509	4113	9065	45.37%	30.69%	13	13
8	花蓮縣富里鄉	2018-11-24T23:14:43+08:00	2782	822	3604	509	4113	9065	45.37%	30.69%	13	13
8	花蓮縣富里鄉	2018-11-25T00:12:47+08:00	2782	822	3604	509	4113	9065	45.37%	30.69%	13	13
8	花蓮縣富里鄉	2018-11-24T23:54:29+08:00	2782	822	3604	509	4113	9065	45.37%	30.69%	13	13
8	花蓮縣富里鄉	2018-11-25T06:27:57+08:00	2782	822	3604	509	4113	9065	45.37%	30.69%	13	13
8	花蓮縣富里鄉	2018-11-25T01:16:25+08:00	2782	822	3604	509	4113	9065	45.37%	30.69%	13	13
8	花蓮縣富里鄉	2018-11-24T22:18:22+08:00	2782	822	3604	509	4113	9065	45.37%	30.69%	13	13
8	花蓮縣富里鄉	2018-11-25T03:37:32+08:00	2782	822	3604	509	4113	9065	45.37%	30.69%	13	13
8	花蓮縣富里鄉	2018-11-25T01:24:27+08:00	2782	822	3604	509	4113	9065	45.37%	30.69%	13	13
8	花蓮縣富里鄉	2018-11-25T03:54:44+08:00	2782	822	3604	509	4113	9065	45.37%	30.69%	13	13
8	花蓮縣富里鄉	2018-11-24T23:03:49+08:00	2782	822	3604	509	4113	9065	45.37%	30.69%	13	13
8	花蓮縣富里鄉	2018-11-24T23:22:25+08:00	2782	822	3604	509	4113	9065	45.37%	30.69%	13	13
8	花蓮縣富里鄉	2018-11-24T23:37:51+08:00	2782	822	3604	509	4113	9065	45.37%	30.69%	13	13
8	花蓮縣富里鄉	2018-11-24T22:12:05+08:00	2782	822	3604	509	4113	9065	45.37%	30.69%	13	13
8	花蓮縣富里鄉	2018-11-25T01:06:02+08:00	2782	822	3604	509	4113	9065	45.37%	30.69%	13	13
8	花蓮縣富里鄉	2018-11-24T23:42:04+08:00	2782	822	3604	509	4113	9065	45.37%	30.69%	13	13
8	花蓮縣富里鄉	2018-11-25T01:11:10+08:00	2782	822	3604	509	4113	9065	45.37%	30.69%	13	13
8	花蓮縣富里鄉	2018-11-25T04:01:31+08:00	2782	822	3604	509	4113	9065	45.37%	30.69%	13	13
8	花蓮縣富里鄉	2018-11-25T06:12:39+08:00	2782	822	3604	509	4113	9065	45.37%	30.69%	13	13
8	花蓮縣富里鄉	2018-11-24T22:21:48+08:00	2782	822	3604	509	4113	9065	45.37%	30.69%	13	13
8	花蓮縣富里鄉	2018-11-25T00:21:46+08:00	2782	822	3604	509	4113	9065	45.37%	30.69%	13	13
8	花蓮縣富里鄉	2018-11-25T01:01:04+08:00	2782	822	3604	509	4113	9065	45.37%	30.69%	13	13
8	花蓮縣富里鄉	2018-11-24T22:35:46+08:00	2782	822	3604	509	4113	9065	45.37%	30.69%	13	13
8	花蓮縣富里鄉	2018-11-24T22:43:53+08:00	2782	822	3604	509	4113	9065	45.37%	30.69%	13	13
8	花蓮縣富里鄉	2018-11-24T23:18:29+08:00	2782	822	3604	509	4113	9065	45.37%	30.69%	13	13
8	花蓮縣富里鄉	2018-11-24T23:58:45+08:00	2782	822	3604	509	4113	9065	45.37%	30.69%	13	13
8	花蓮縣富里鄉	2018-11-25T00:56:16+08:00	2782	822	3604	509	4113	9065	45.37%	30.69%	13	13
8	花蓮縣富里鄉	2018-11-24T22:39:11+08:00	2782	822	3604	509	4113	9065	45.37%	30.69%	13	13
8	花蓮縣富里鄉	2018-11-24T23:26:09+08:00	2782	822	3604	509	4113	9065	45.37%	30.69%	13	13
8	花蓮縣富里鄉	2018-11-25T03:31:02+08:00	2782	822	3604	509	4113	9065	45.37%	30.69%	13	13
8	花蓮縣富里鄉	2018-11-25T00:03:37+08:00	2782	822	3604	509	4113	9065	45.37%	30.69%	13	13
8	臺南市新營區	2018-11-24T22:49:18+08:00	21245	6562	27807	2035	29842	61762	48.32%	34.4%	47	49
8	臺南市新營區	2018-11-24T23:14:33+08:00	22398	6951	29349	2136	31485	64949	48.48%	34.49%	49	49
8	臺南市新營區	2018-11-24T22:56:31+08:00	21245	6562	27807	2035	29842	61762	48.32%	34.4%	47	49
8	臺南市新營區	2018-11-25T00:12:39+08:00	22398	6951	29349	2136	31485	64949	48.48%	34.49%	49	49
8	臺南市新營區	2018-11-25T00:03:27+08:00	22398	6951	29349	2136	31485	64949	48.48%	34.49%	49	49
8	臺南市新營區	2018-11-25T00:56:07+08:00	22398	6951	29349	2136	31485	64949	48.48%	34.49%	49	49
8	臺南市新營區	2018-11-24T23:03:42+08:00	21830	6727	28557	2088	30645	63200	48.49%	34.54%	48	49
8	臺南市新營區	2018-11-24T23:10:51+08:00	22398	6951	29349	2136	31485	64949	48.48%	34.49%	49	49
8	臺南市新營區	2018-11-25T03:37:18+08:00	22398	6951	29349	2136	31485	64949	48.48%	34.49%	49	49
8	臺南市新營區	2018-11-24T22:43:44+08:00	20656	6369	27025	1973	28998	59917	48.4%	34.47%	46	49
8	臺南市新營區	2018-11-25T06:17:30+08:00	22398	6951	29349	2136	31485	64949	48.48%	34.49%	49	49
8	臺南市新營區	2018-11-24T23:22:17+08:00	22398	6951	29349	2136	31485	64949	48.48%	34.49%	49	49
8	臺南市新營區	2018-11-25T06:22:40+08:00	22398	6951	29349	2136	31485	64949	48.48%	34.49%	49	49
8	臺南市新營區	2018-11-24T23:29:41+08:00	22398	6951	29349	2136	31485	64949	48.48%	34.49%	49	49
8	臺南市新營區	2018-11-24T22:25:18+08:00	19006	5845	24851	1829	26680	55027	48.49%	34.54%	43	49
8	臺南市新營區	2018-11-25T01:11:00+08:00	22398	6951	29349	2136	31485	64949	48.48%	34.49%	49	49
8	臺南市新營區	2018-11-25T00:17:02+08:00	22398	6951	29349	2136	31485	64949	48.48%	34.49%	49	49
8	臺南市新營區	2018-11-25T00:07:58+08:00	22398	6951	29349	2136	31485	64949	48.48%	34.49%	49	49
8	臺南市新營區	2018-11-25T01:16:15+08:00	22398	6951	29349	2136	31485	64949	48.48%	34.49%	49	49
8	臺南市新營區	2018-11-25T01:05:52+08:00	22398	6951	29349	2136	31485	64949	48.48%	34.49%	49	49
8	臺南市新營區	2018-11-24T22:14:42+08:00	16860	5200	22060	1611	23671	48333	48.97%	34.88%	39	49
8	臺南市新營區	2018-11-24T23:54:19+08:00	22398	6951	29349	2136	31485	64949	48.48%	34.49%	49	49
8	臺南市新營區	2018-11-24T22:28:34+08:00	19601	6022	25623	1878	27501	56889	48.34%	34.45%	44	49
8	臺南市新營區	2018-11-24T22:18:13+08:00	17281	5336	22617	1667	24284	49706	48.86%	34.77%	40	49
8	臺南市新營區	2018-11-25T01:24:18+08:00	22398	6951	29349	2136	31485	64949	48.48%	34.49%	49	49
8	臺南市新營區	2018-11-24T22:35:39+08:00	20168	6214	26382	1946	28328	58484	48.44%	34.48%	45	49
8	臺南市新營區	2018-11-24T23:50:09+08:00	22398	6951	29349	2136	31485	64949	48.48%	34.49%	49	49
8	臺南市新營區	2018-11-24T23:58:35+08:00	22398	6951	29349	2136	31485	64949	48.48%	34.49%	49	49
8	臺南市新營區	2018-11-25T06:27:49+08:00	22398	6951	29349	2136	31485	64949	48.48%	34.49%	49	49
8	臺南市新營區	2018-11-24T22:39:03+08:00	20168	6214	26382	1946	28328	58484	48.44%	34.48%	45	49
8	臺南市新營區	2018-11-24T23:07:13+08:00	21830	6727	28557	2088	30645	63200	48.49%	34.54%	48	49
8	臺南市新營區	2018-11-25T01:00:54+08:00	22398	6951	29349	2136	31485	64949	48.48%	34.49%	49	49
8	臺南市新營區	2018-11-24T23:00:08+08:00	21245	6562	27807	2035	29842	61762	48.32%	34.4%	47	49
8	臺南市新營區	2018-11-25T03:48:22+08:00	22398	6951	29349	2136	31485	64949	48.48%	34.49%	49	49
8	臺南市新營區	2018-11-25T00:21:37+08:00	22398	6951	29349	2136	31485	64949	48.48%	34.49%	49	49
8	臺南市新營區	2018-11-25T03:30:52+08:00	22398	6951	29349	2136	31485	64949	48.48%	34.49%	49	49
8	臺南市新營區	2018-11-25T03:42:41+08:00	22398	6951	29349	2136	31485	64949	48.48%	34.49%	49	49
8	臺南市新營區	2018-11-24T22:21:39+08:00	18451	5670	24121	1799	25920	53097	48.82%	34.75%	42	49
8	臺南市新營區	2018-11-24T22:32:12+08:00	20168	6214	26382	1946	28328	58484	48.44%	34.48%	45	49
8	臺南市新營區	2018-11-24T22:53:08+08:00	21245	6562	27807	2035	29842	61762	48.32%	34.4%	47	49
8	臺南市新營區	2018-11-25T04:01:22+08:00	22398	6951	29349	2136	31485	64949	48.48%	34.49%	49	49
8	臺南市新營區	2018-11-24T22:11:57+08:00	16860	5200	22060	1611	23671	48333	48.97%	34.88%	39	49
8	臺南市新營區	2018-11-24T22:40:13+08:00	20168	6214	26382	1946	28328	58484	48.44%	34.48%	45	49
8	臺南市新營區	2018-11-25T06:12:31+08:00	22398	6951	29349	2136	31485	64949	48.48%	34.49%	49	49
8	臺南市新營區	2018-11-25T06:07:16+08:00	22398	6951	29349	2136	31485	64949	48.48%	34.49%	49	49
8	臺南市新營區	2018-11-24T23:33:44+08:00	22398	6951	29349	2136	31485	64949	48.48%	34.49%	49	49
8	臺南市新營區	2018-11-24T23:26:01+08:00	22398	6951	29349	2136	31485	64949	48.48%	34.49%	49	49
8	臺南市新營區	2018-11-25T03:54:34+08:00	22398	6951	29349	2136	31485	64949	48.48%	34.49%	49	49
8	臺南市新營區	2018-11-24T23:45:58+08:00	22398	6951	29349	2136	31485	64949	48.48%	34.49%	49	49
8	臺南市新營區	2018-11-24T23:41:56+08:00	22398	6951	29349	2136	31485	64949	48.48%	34.49%	49	49
8	臺南市新營區	2018-11-24T23:37:43+08:00	22398	6951	29349	2136	31485	64949	48.48%	34.49%	49	49
8	臺南市新營區	2018-11-24T23:18:21+08:00	22398	6951	29349	2136	31485	64949	48.48%	34.49%	49	49
8	屏東縣枋山鄉	2018-11-24T23:10:57+08:00	1293	418	1711	232	1943	3884	50.03%	33.29%	5	6
8	屏東縣枋山鄉	2018-11-24T23:07:19+08:00	1293	418	1711	232	1943	3884	50.03%	33.29%	5	6
8	屏東縣枋山鄉	2018-11-24T22:14:50+08:00	904	305	1209	157	1366	2956	46.21%	30.58%	4	6
8	屏東縣枋山鄉	2018-11-25T06:17:37+08:00	1616	530	2146	256	2402	4856	49.46%	33.28%	6	6
8	屏東縣枋山鄉	2018-11-24T22:56:37+08:00	1293	418	1711	232	1943	3884	50.03%	33.29%	5	6
8	屏東縣枋山鄉	2018-11-24T22:32:19+08:00	904	305	1209	157	1366	2956	46.21%	30.58%	4	6
8	屏東縣枋山鄉	2018-11-25T01:06:01+08:00	1616	530	2146	256	2402	4856	49.46%	33.28%	6	6
8	屏東縣枋山鄉	2018-11-24T22:53:16+08:00	1293	418	1711	232	1943	3884	50.03%	33.29%	5	6
8	屏東縣枋山鄉	2018-11-25T00:08:06+08:00	1616	530	2146	256	2402	4856	49.46%	33.28%	6	6
8	屏東縣枋山鄉	2018-11-24T22:25:26+08:00	904	305	1209	157	1366	2956	46.21%	30.58%	4	6
8	屏東縣枋山鄉	2018-11-25T01:11:08+08:00	1616	530	2146	256	2402	4856	49.46%	33.28%	6	6
8	屏東縣枋山鄉	2018-11-24T22:40:20+08:00	904	305	1209	157	1366	2956	46.21%	30.58%	4	6
8	屏東縣枋山鄉	2018-11-25T06:22:46+08:00	1616	530	2146	256	2402	4856	49.46%	33.28%	6	6
8	屏東縣枋山鄉	2018-11-25T06:07:24+08:00	1616	530	2146	256	2402	4856	49.46%	33.28%	6	6
8	屏東縣枋山鄉	2018-11-24T23:00:18+08:00	1293	418	1711	232	1943	3884	50.03%	33.29%	5	6
8	屏東縣枋山鄉	2018-11-25T03:48:32+08:00	1616	530	2146	256	2402	4856	49.46%	33.28%	6	6
8	屏東縣枋山鄉	2018-11-24T23:29:47+08:00	1293	418	1711	232	1943	3884	50.03%	33.29%	5	6
8	屏東縣枋山鄉	2018-11-25T00:21:45+08:00	1616	530	2146	256	2402	4856	49.46%	33.28%	6	6
8	屏東縣枋山鄉	2018-11-25T03:31:00+08:00	1616	530	2146	256	2402	4856	49.46%	33.28%	6	6
8	屏東縣枋山鄉	2018-11-25T01:16:23+08:00	1616	530	2146	256	2402	4856	49.46%	33.28%	6	6
8	屏東縣枋山鄉	2018-11-25T00:56:14+08:00	1616	530	2146	256	2402	4856	49.46%	33.28%	6	6
8	屏東縣枋山鄉	2018-11-24T22:35:45+08:00	904	305	1209	157	1366	2956	46.21%	30.58%	4	6
8	屏東縣枋山鄉	2018-11-24T23:14:42+08:00	1293	418	1711	232	1943	3884	50.03%	33.29%	5	6
8	屏東縣枋山鄉	2018-11-24T23:50:16+08:00	1616	530	2146	256	2402	4856	49.46%	33.28%	6	6
8	屏東縣枋山鄉	2018-11-24T23:37:49+08:00	1293	418	1711	232	1943	3884	50.03%	33.29%	5	6
8	屏東縣枋山鄉	2018-11-24T22:43:51+08:00	904	305	1209	157	1366	2956	46.21%	30.58%	4	6
8	屏東縣枋山鄉	2018-11-25T06:27:56+08:00	1616	530	2146	256	2402	4856	49.46%	33.28%	6	6
8	屏東縣枋山鄉	2018-11-25T00:12:46+08:00	1616	530	2146	256	2402	4856	49.46%	33.28%	6	6
8	屏東縣枋山鄉	2018-11-24T23:54:28+08:00	1616	530	2146	256	2402	4856	49.46%	33.28%	6	6
8	屏東縣枋山鄉	2018-11-24T23:22:24+08:00	1293	418	1711	232	1943	3884	50.03%	33.29%	5	6
8	屏東縣枋山鄉	2018-11-24T22:28:41+08:00	904	305	1209	157	1366	2956	46.21%	30.58%	4	6
8	屏東縣枋山鄉	2018-11-24T22:12:03+08:00	904	305	1209	157	1366	2956	46.21%	30.58%	4	6
8	屏東縣枋山鄉	2018-11-24T23:33:51+08:00	1293	418	1711	232	1943	3884	50.03%	33.29%	5	6
8	屏東縣枋山鄉	2018-11-25T01:24:26+08:00	1616	530	2146	256	2402	4856	49.46%	33.28%	6	6
8	屏東縣枋山鄉	2018-11-25T03:54:42+08:00	1616	530	2146	256	2402	4856	49.46%	33.28%	6	6
8	屏東縣枋山鄉	2018-11-24T23:03:48+08:00	1293	418	1711	232	1943	3884	50.03%	33.29%	5	6
8	屏東縣枋山鄉	2018-11-24T22:49:25+08:00	1293	418	1711	232	1943	3884	50.03%	33.29%	5	6
8	屏東縣枋山鄉	2018-11-24T23:42:03+08:00	1293	418	1711	232	1943	3884	50.03%	33.29%	5	6
8	屏東縣枋山鄉	2018-11-25T04:01:30+08:00	1616	530	2146	256	2402	4856	49.46%	33.28%	6	6
8	屏東縣枋山鄉	2018-11-24T23:46:05+08:00	1616	530	2146	256	2402	4856	49.46%	33.28%	6	6
8	屏東縣枋山鄉	2018-11-25T03:42:49+08:00	1616	530	2146	256	2402	4856	49.46%	33.28%	6	6
8	屏東縣枋山鄉	2018-11-25T00:17:09+08:00	1616	530	2146	256	2402	4856	49.46%	33.28%	6	6
8	屏東縣枋山鄉	2018-11-25T06:12:38+08:00	1616	530	2146	256	2402	4856	49.46%	33.28%	6	6
8	屏東縣枋山鄉	2018-11-24T22:21:47+08:00	904	305	1209	157	1366	2956	46.21%	30.58%	4	6
8	屏東縣枋山鄉	2018-11-25T01:01:03+08:00	1616	530	2146	256	2402	4856	49.46%	33.28%	6	6
8	屏東縣枋山鄉	2018-11-24T22:39:10+08:00	904	305	1209	157	1366	2956	46.21%	30.58%	4	6
8	屏東縣枋山鄉	2018-11-24T23:26:08+08:00	1293	418	1711	232	1943	3884	50.03%	33.29%	5	6
8	屏東縣枋山鄉	2018-11-25T03:37:30+08:00	1616	530	2146	256	2402	4856	49.46%	33.28%	6	6
8	屏東縣枋山鄉	2018-11-24T23:58:43+08:00	1616	530	2146	256	2402	4856	49.46%	33.28%	6	6
8	屏東縣枋山鄉	2018-11-25T00:03:36+08:00	1616	530	2146	256	2402	4856	49.46%	33.28%	6	6
8	屏東縣枋山鄉	2018-11-24T22:18:21+08:00	904	305	1209	157	1366	2956	46.21%	30.58%	4	6
8	屏東縣枋山鄉	2018-11-24T23:18:28+08:00	1293	418	1711	232	1943	3884	50.03%	33.29%	5	6
8	臺南市大內區	2018-11-25T03:37:19+08:00	2664	835	3499	517	4016	8654	46.41%	30.78%	11	11
8	臺南市大內區	2018-11-24T22:49:18+08:00	2664	835	3499	517	4016	8654	46.41%	30.78%	11	11
8	臺南市大內區	2018-11-24T23:14:34+08:00	2664	835	3499	517	4016	8654	46.41%	30.78%	11	11
8	臺南市大內區	2018-11-24T22:56:31+08:00	2664	835	3499	517	4016	8654	46.41%	30.78%	11	11
8	臺南市大內區	2018-11-25T00:03:27+08:00	2664	835	3499	517	4016	8654	46.41%	30.78%	11	11
8	臺南市大內區	2018-11-25T00:56:07+08:00	2664	835	3499	517	4016	8654	46.41%	30.78%	11	11
8	臺南市大內區	2018-11-24T23:03:42+08:00	2664	835	3499	517	4016	8654	46.41%	30.78%	11	11
8	臺南市大內區	2018-11-24T23:10:51+08:00	2664	835	3499	517	4016	8654	46.41%	30.78%	11	11
8	臺南市大內區	2018-11-24T22:43:44+08:00	2664	835	3499	517	4016	8654	46.41%	30.78%	11	11
8	臺南市大內區	2018-11-25T06:17:30+08:00	2664	835	3499	517	4016	8654	46.41%	30.78%	11	11
8	臺南市大內區	2018-11-24T23:58:36+08:00	2664	835	3499	517	4016	8654	46.41%	30.78%	11	11
8	臺南市大內區	2018-11-24T23:22:17+08:00	2664	835	3499	517	4016	8654	46.41%	30.78%	11	11
8	臺南市大內區	2018-11-25T06:22:40+08:00	2664	835	3499	517	4016	8654	46.41%	30.78%	11	11
8	臺南市大內區	2018-11-24T23:29:41+08:00	2664	835	3499	517	4016	8654	46.41%	30.78%	11	11
8	臺南市大內區	2018-11-24T22:25:18+08:00	2664	835	3499	517	4016	8654	46.41%	30.78%	11	11
8	臺南市大內區	2018-11-25T01:11:00+08:00	2664	835	3499	517	4016	8654	46.41%	30.78%	11	11
8	臺南市大內區	2018-11-25T00:17:02+08:00	2664	835	3499	517	4016	8654	46.41%	30.78%	11	11
8	臺南市大內區	2018-11-25T00:07:58+08:00	2664	835	3499	517	4016	8654	46.41%	30.78%	11	11
8	臺南市大內區	2018-11-25T01:16:15+08:00	2664	835	3499	517	4016	8654	46.41%	30.78%	11	11
8	臺南市大內區	2018-11-25T00:12:40+08:00	2664	835	3499	517	4016	8654	46.41%	30.78%	11	11
8	臺南市大內區	2018-11-24T22:14:43+08:00	2664	835	3499	517	4016	8654	46.41%	30.78%	11	11
8	臺南市大內區	2018-11-24T23:26:02+08:00	2664	835	3499	517	4016	8654	46.41%	30.78%	11	11
8	臺南市大內區	2018-11-25T01:05:52+08:00	2664	835	3499	517	4016	8654	46.41%	30.78%	11	11
8	臺南市大內區	2018-11-24T23:54:19+08:00	2664	835	3499	517	4016	8654	46.41%	30.78%	11	11
8	臺南市大內區	2018-11-24T22:28:34+08:00	2664	835	3499	517	4016	8654	46.41%	30.78%	11	11
8	臺南市大內區	2018-11-24T22:18:14+08:00	2664	835	3499	517	4016	8654	46.41%	30.78%	11	11
8	臺南市大內區	2018-11-25T01:24:18+08:00	2664	835	3499	517	4016	8654	46.41%	30.78%	11	11
8	臺南市大內區	2018-11-24T22:35:39+08:00	2664	835	3499	517	4016	8654	46.41%	30.78%	11	11
8	臺南市大內區	2018-11-24T23:50:09+08:00	2664	835	3499	517	4016	8654	46.41%	30.78%	11	11
8	臺南市大內區	2018-11-25T06:27:49+08:00	2664	835	3499	517	4016	8654	46.41%	30.78%	11	11
8	臺南市大內區	2018-11-24T22:39:03+08:00	2664	835	3499	517	4016	8654	46.41%	30.78%	11	11
8	臺南市大內區	2018-11-24T23:07:13+08:00	2664	835	3499	517	4016	8654	46.41%	30.78%	11	11
8	臺南市大內區	2018-11-25T01:00:54+08:00	2664	835	3499	517	4016	8654	46.41%	30.78%	11	11
8	臺南市大內區	2018-11-24T22:32:13+08:00	2664	835	3499	517	4016	8654	46.41%	30.78%	11	11
8	臺南市大內區	2018-11-25T03:48:23+08:00	2664	835	3499	517	4016	8654	46.41%	30.78%	11	11
8	臺南市大內區	2018-11-24T23:00:09+08:00	2664	835	3499	517	4016	8654	46.41%	30.78%	11	11
8	臺南市大內區	2018-11-25T00:21:38+08:00	2664	835	3499	517	4016	8654	46.41%	30.78%	11	11
8	臺南市大內區	2018-11-25T03:30:52+08:00	2664	835	3499	517	4016	8654	46.41%	30.78%	11	11
8	臺南市大內區	2018-11-25T03:42:41+08:00	2664	835	3499	517	4016	8654	46.41%	30.78%	11	11
8	臺南市大內區	2018-11-24T22:53:08+08:00	2664	835	3499	517	4016	8654	46.41%	30.78%	11	11
8	臺南市大內區	2018-11-25T06:07:17+08:00	2664	835	3499	517	4016	8654	46.41%	30.78%	11	11
8	臺南市大內區	2018-11-24T22:11:57+08:00	2664	835	3499	517	4016	8654	46.41%	30.78%	11	11
8	臺南市大內區	2018-11-24T22:40:14+08:00	2664	835	3499	517	4016	8654	46.41%	30.78%	11	11
8	臺南市大內區	2018-11-25T06:12:31+08:00	2664	835	3499	517	4016	8654	46.41%	30.78%	11	11
8	臺南市大內區	2018-11-25T04:01:23+08:00	2664	835	3499	517	4016	8654	46.41%	30.78%	11	11
8	臺南市大內區	2018-11-24T22:21:40+08:00	2664	835	3499	517	4016	8654	46.41%	30.78%	11	11
8	臺南市大內區	2018-11-24T23:33:44+08:00	2664	835	3499	517	4016	8654	46.41%	30.78%	11	11
8	臺南市大內區	2018-11-25T03:54:34+08:00	2664	835	3499	517	4016	8654	46.41%	30.78%	11	11
8	臺南市大內區	2018-11-24T23:45:58+08:00	2664	835	3499	517	4016	8654	46.41%	30.78%	11	11
8	臺南市大內區	2018-11-24T23:41:56+08:00	2664	835	3499	517	4016	8654	46.41%	30.78%	11	11
8	臺南市大內區	2018-11-24T23:37:43+08:00	2664	835	3499	517	4016	8654	46.41%	30.78%	11	11
8	臺南市大內區	2018-11-24T23:18:21+08:00	2664	835	3499	517	4016	8654	46.41%	30.78%	11	11
