案	區	時間	同意票數	不同意票數	有效票數	無效票數	投票數	投票權人數	投票率(%)	有效同意票數對投票權人數百分比(%)	已送	應送
15	桃園市觀音區	2018-11-25T03:56:17+08:00	8475	17670	26145	1647	27792	55149	50.39%	15.37%	41	41
15	桃園市觀音區	2018-11-24T23:16:06+08:00	8288	17280	25568	1598	27166	54037	50.27%	15.34%	40	41
15	桃園市觀音區	2018-11-25T06:29:21+08:00	8475	17670	26145	1647	27792	55149	50.39%	15.37%	41	41
15	桃園市觀音區	2018-11-25T06:19:01+08:00	8475	17670	26145	1647	27792	55149	50.39%	15.37%	41	41
15	桃園市觀音區	2018-11-24T23:43:20+08:00	8475	17670	26145	1647	27792	55149	50.39%	15.37%	41	41
15	桃園市觀音區	2018-11-25T03:49:54+08:00	8475	17670	26145	1647	27792	55149	50.39%	15.37%	41	41
15	桃園市觀音區	2018-11-24T22:45:12+08:00	6624	13899	20523	1359	21882	43262	50.58%	15.31%	32	41
15	桃園市觀音區	2018-11-24T22:30:13+08:00	5862	12362	18224	1251	19475	38598	50.46%	15.19%	29	41
15	桃園市觀音區	2018-11-25T06:24:04+08:00	8475	17670	26145	1647	27792	55149	50.39%	15.37%	41	41
15	桃園市觀音區	2018-11-25T03:32:38+08:00	8475	17670	26145	1647	27792	55149	50.39%	15.37%	41	41
15	桃園市觀音區	2018-11-25T01:25:56+08:00	8475	17670	26145	1647	27792	55149	50.39%	15.37%	41	41
15	桃園市觀音區	2018-11-25T00:23:07+08:00	8475	17670	26145	1647	27792	55149	50.39%	15.37%	41	41
15	桃園市觀音區	2018-11-24T23:51:39+08:00	8475	17670	26145	1647	27792	55149	50.39%	15.37%	41	41
15	桃園市觀音區	2018-11-24T23:27:22+08:00	8475	17670	26145	1647	27792	55149	50.39%	15.37%	41	41
15	桃園市觀音區	2018-11-24T22:13:32+08:00	4458	9367	13825	968	14793	29513	50.12%	15.11%	23	41
15	桃園市觀音區	2018-11-25T01:17:57+08:00	8475	17670	26145	1647	27792	55149	50.39%	15.37%	41	41
15	桃園市觀音區	2018-11-24T23:08:40+08:00	7787	16358	24145	1548	25693	50851	50.53%	15.31%	38	41
15	桃園市觀音區	2018-11-24T22:57:58+08:00	7434	15510	22944	1486	24430	48221	50.66%	15.42%	36	41
15	桃園市觀音區	2018-11-25T06:08:57+08:00	8475	17670	26145	1647	27792	55149	50.39%	15.37%	41	41
15	桃園市觀音區	2018-11-24T22:54:29+08:00	7434	15510	22944	1486	24430	48221	50.66%	15.42%	36	41
15	桃園市觀音區	2018-11-25T01:12:47+08:00	8475	17670	26145	1647	27792	55149	50.39%	15.37%	41	41
15	桃園市觀音區	2018-11-24T22:16:14+08:00	4703	9992	14695	1002	15697	31382	50.02%	14.99%	24	41
15	桃園市觀音區	2018-11-25T04:02:56+08:00	8475	17670	26145	1647	27792	55149	50.39%	15.37%	41	41
15	桃園市觀音區	2018-11-24T22:33:41+08:00	5862	12362	18224	1251	19475	38598	50.46%	15.19%	29	41
15	桃園市觀音區	2018-11-24T23:05:08+08:00	7613	15965	23578	1518	25096	49500	50.7%	15.38%	37	41
15	桃園市觀音區	2018-11-24T23:47:32+08:00	8475	17670	26145	1647	27792	55149	50.39%	15.37%	41	41
15	桃園市觀音區	2018-11-24T22:41:39+08:00	6373	13416	19789	1329	21118	41745	50.59%	15.27%	31	41
15	桃園市觀音區	2018-11-25T00:05:09+08:00	8475	17670	26145	1647	27792	55149	50.39%	15.37%	41	41
15	桃園市觀音區	2018-11-24T22:37:04+08:00	6373	13416	19789	1329	21118	41745	50.59%	15.27%	31	41
15	桃園市觀音區	2018-11-24T22:50:52+08:00	6876	14368	21244	1410	22654	44723	50.65%	15.37%	33	41
15	桃園市觀音區	2018-11-25T06:13:56+08:00	8475	17670	26145	1647	27792	55149	50.39%	15.37%	41	41
15	桃園市觀音區	2018-11-24T22:26:40+08:00	5862	12362	18224	1251	19475	38598	50.46%	15.19%	29	41
15	桃園市觀音區	2018-11-25T00:18:35+08:00	8475	17670	26145	1647	27792	55149	50.39%	15.37%	41	41
15	桃園市觀音區	2018-11-24T22:40:31+08:00	6373	13416	19789	1329	21118	41745	50.59%	15.27%	31	41
15	桃園市觀音區	2018-11-25T03:44:27+08:00	8475	17670	26145	1647	27792	55149	50.39%	15.37%	41	41
15	桃園市觀音區	2018-11-25T00:57:41+08:00	8475	17670	26145	1647	27792	55149	50.39%	15.37%	41	41
15	桃園市觀音區	2018-11-24T22:19:40+08:00	4977	10509	15486	1047	16533	33073	49.99%	15.05%	25	41
15	桃園市觀音區	2018-11-25T01:02:34+08:00	8475	17670	26145	1647	27792	55149	50.39%	15.37%	41	41
15	桃園市觀音區	2018-11-25T03:38:58+08:00	8475	17670	26145	1647	27792	55149	50.39%	15.37%	41	41
15	桃園市觀音區	2018-11-24T23:23:42+08:00	8475	17670	26145	1647	27792	55149	50.39%	15.37%	41	41
15	桃園市觀音區	2018-11-24T23:55:50+08:00	8475	17670	26145	1647	27792	55149	50.39%	15.37%	41	41
15	桃園市觀音區	2018-11-24T22:23:17+08:00	5427	11449	16876	1114	17990	35813	50.23%	15.15%	27	41
15	桃園市觀音區	2018-11-24T23:19:55+08:00	8475	17670	26145	1647	27792	55149	50.39%	15.37%	41	41
15	桃園市觀音區	2018-11-25T00:00:14+08:00	8475	17670	26145	1647	27792	55149	50.39%	15.37%	41	41
15	桃園市觀音區	2018-11-25T01:07:30+08:00	8475	17670	26145	1647	27792	55149	50.39%	15.37%	41	41
15	桃園市觀音區	2018-11-25T00:09:38+08:00	8475	17670	26145	1647	27792	55149	50.39%	15.37%	41	41
15	桃園市觀音區	2018-11-24T23:35:14+08:00	8475	17670	26145	1647	27792	55149	50.39%	15.37%	41	41
15	桃園市觀音區	2018-11-25T00:14:13+08:00	8475	17670	26145	1647	27792	55149	50.39%	15.37%	41	41
15	桃園市觀音區	2018-11-24T23:01:35+08:00	7613	15965	23578	1518	25096	49500	50.7%	15.38%	37	41
15	桃園市觀音區	2018-11-24T23:12:19+08:00	7787	16358	24145	1548	25693	50851	50.53%	15.31%	38	41
15	桃園市觀音區	2018-11-24T23:31:15+08:00	8475	17670	26145	1647	27792	55149	50.39%	15.37%	41	41
15	桃園市觀音區	2018-11-24T23:39:20+08:00	8475	17670	26145	1647	27792	55149	50.39%	15.37%	41	41
15	臺北市文山區	2018-11-25T06:29:19+08:00	49133	81140	130273	5773	136046	227211	59.88%	21.62%	162	162
15	臺北市文山區	2018-11-25T01:07:28+08:00	45499	74786	120285	5287	125572	208397	60.26%	21.83%	150	162
15	臺北市文山區	2018-11-25T06:13:55+08:00	49133	81140	130273	5773	136046	227211	59.88%	21.62%	162	162
15	臺北市文山區	2018-11-24T22:50:51+08:00	20142	33079	53221	2471	55692	92291	60.34%	21.82%	70	162
15	臺北市文山區	2018-11-25T06:19:00+08:00	49133	81140	130273	5773	136046	227211	59.88%	21.62%	162	162
15	臺北市文山區	2018-11-25T03:49:53+08:00	49133	81140	130273	5773	136046	227211	59.88%	21.62%	162	162
15	臺北市文山區	2018-11-25T06:29:20+08:00	49133	81140	130273	5773	136046	227211	59.88%	21.62%	162	162
15	臺北市文山區	2018-11-25T03:49:54+08:00	49133	81140	130273	5773	136046	227211	59.88%	21.62%	162	162
15	臺北市文山區	2018-11-24T22:50:50+08:00	20142	33079	53221	2471	55692	92291	60.34%	21.82%	70	162
15	臺北市文山區	2018-11-25T06:13:54+08:00	49133	81140	130273	5773	136046	227211	59.88%	21.62%	162	162
15	臺北市文山區	2018-11-25T01:07:29+08:00	45499	74786	120285	5287	125572	208397	60.26%	21.83%	150	162
15	臺北市文山區	2018-11-24T23:43:19+08:00	30893	50865	81758	3711	85469	141526	60.39%	21.83%	105	162
15	臺北市文山區	2018-11-24T22:13:29+08:00	14562	23447	38009	1765	39774	65689	60.55%	22.17%	51	162
15	臺北市文山區	2018-11-25T06:24:03+08:00	49133	81140	130273	5773	136046	227211	59.88%	21.62%	162	162
15	臺北市文山區	2018-11-24T23:08:39+08:00	24989	41050	66039	3031	69070	114518	60.31%	21.82%	86	162
15	臺北市文山區	2018-11-25T00:23:06+08:00	38991	64056	103047	4550	107597	178359	60.33%	21.86%	130	162
15	臺北市文山區	2018-11-24T22:30:12+08:00	17217	28193	45410	2131	47541	78688	60.42%	21.88%	60	162
15	臺北市文山區	2018-11-24T23:55:49+08:00	34012	56243	90255	4037	94292	156326	60.32%	21.76%	115	162
15	臺北市文山區	2018-11-25T03:32:37+08:00	49133	81140	130273	5773	136046	227211	59.88%	21.62%	162	162
15	臺北市文山區	2018-11-25T06:24:02+08:00	49133	81140	130273	5773	136046	227211	59.88%	21.62%	162	162
15	臺北市文山區	2018-11-24T23:51:37+08:00	33030	54404	87434	3935	91369	151489	60.31%	21.8%	112	162
15	臺北市文山區	2018-11-24T23:23:41+08:00	26807	44083	70890	3228	74118	122936	60.29%	21.81%	92	162
15	臺北市文山區	2018-11-24T22:57:57+08:00	21942	35925	57867	2674	60541	100475	60.25%	21.84%	76	162
15	臺北市文山區	2018-11-24T23:51:38+08:00	33030	54404	87434	3935	91369	151489	60.31%	21.8%	112	162
15	臺北市文山區	2018-11-25T06:18:59+08:00	49133	81140	130273	5773	136046	227211	59.88%	21.62%	162	162
15	臺北市文山區	2018-11-25T01:17:56+08:00	46100	75943	122043	5369	127412	211563	60.22%	21.79%	152	162
15	臺北市文山區	2018-11-24T23:23:40+08:00	26807	44083	70890	3228	74118	122936	60.29%	21.81%	92	162
15	臺北市文山區	2018-11-24T22:33:40+08:00	17217	28193	45410	2131	47541	78688	60.42%	21.88%	60	162
15	臺北市文山區	2018-11-24T22:16:13+08:00	14831	23883	38714	1795	40509	66960	60.5%	22.15%	52	162
15	臺北市文山區	2018-11-24T23:05:07+08:00	24409	40082	64491	2967	67458	111870	60.3%	21.82%	84	162
15	臺北市文山區	2018-11-24T22:41:38+08:00	18564	30341	48905	2296	51201	84742	60.42%	21.91%	64	162
15	臺北市文山區	2018-11-24T22:54:28+08:00	20142	33079	53221	2471	55692	92291	60.34%	21.82%	70	162
15	臺北市文山區	2018-11-25T01:12:46+08:00	46100	75943	122043	5369	127412	211563	60.22%	21.79%	152	162
15	臺北市文山區	2018-11-25T06:08:56+08:00	49133	81140	130273	5773	136046	227211	59.88%	21.62%	162	162
15	臺北市文山區	2018-11-24T22:41:37+08:00	18564	30341	48905	2296	51201	84742	60.42%	21.91%	64	162
15	臺北市文山區	2018-11-25T00:05:07+08:00	35579	58775	94354	4217	98571	163504	60.29%	21.76%	120	162
15	臺北市文山區	2018-11-24T23:05:06+08:00	24409	40082	64491	2967	67458	111870	60.3%	21.82%	84	162
15	臺北市文山區	2018-11-25T00:18:33+08:00	38685	63532	102217	4517	106734	176966	60.31%	21.86%	129	162
15	臺北市文山區	2018-11-24T22:37:03+08:00	17547	28676	46223	2172	48395	80104	60.42%	21.91%	61	162
15	臺北市文山區	2018-11-24T22:45:10+08:00	18564	30341	48905	2296	51201	84742	60.42%	21.91%	64	162
15	臺北市文山區	2018-11-24T23:16:05+08:00	25807	42491	68298	3124	71422	118561	60.24%	21.77%	89	162
15	臺北市文山區	2018-11-24T22:45:11+08:00	18564	30341	48905	2296	51201	84742	60.42%	21.91%	64	162
15	臺北市文山區	2018-11-25T03:56:15+08:00	49133	81140	130273	5773	136046	227211	59.88%	21.62%	162	162
15	臺北市文山區	2018-11-25T03:38:57+08:00	49133	81140	130273	5773	136046	227211	59.88%	21.62%	162	162
15	臺北市文山區	2018-11-25T03:44:26+08:00	49133	81140	130273	5773	136046	227211	59.88%	21.62%	162	162
15	臺北市文山區	2018-11-25T01:02:33+08:00	45146	74165	119311	5246	124557	206781	60.24%	21.83%	149	162
15	臺北市文山區	2018-11-24T22:40:30+08:00	18564	30341	48905	2296	51201	84742	60.42%	21.91%	64	162
15	臺北市文山區	2018-11-25T01:25:55+08:00	46983	77516	124499	5469	129968	215677	60.26%	21.78%	155	162
15	臺北市文山區	2018-11-24T22:23:16+08:00	16969	27626	44595	2083	46678	77244	60.43%	21.97%	59	162
15	臺北市文山區	2018-11-24T23:19:54+08:00	26807	44083	70890	3228	74118	122936	60.29%	21.81%	92	162
15	臺北市文山區	2018-11-25T00:57:39+08:00	45146	74165	119311	5246	124557	206781	60.24%	21.83%	149	162
15	臺北市文山區	2018-11-24T23:27:21+08:00	27076	44511	71587	3250	74837	124055	60.33%	21.83%	93	162
15	臺北市文山區	2018-11-25T01:17:55+08:00	46100	75943	122043	5369	127412	211563	60.22%	21.79%	152	162
15	臺北市文山區	2018-11-24T22:19:39+08:00	15450	25021	40471	1884	42355	69961	60.54%	22.08%	54	162
15	臺北市文山區	2018-11-24T23:27:20+08:00	27076	44511	71587	3250	74837	124055	60.33%	21.83%	93	162
15	臺北市文山區	2018-11-24T22:13:30+08:00	14562	23447	38009	1765	39774	65689	60.55%	22.17%	51	162
15	臺北市文山區	2018-11-25T00:00:13+08:00	34596	57219	91815	4120	95935	158960	60.35%	21.76%	117	162
15	臺北市文山區	2018-11-25T00:14:12+08:00	37362	61433	98795	4354	103149	171048	60.3%	21.84%	125	162
15	臺北市文山區	2018-11-25T04:02:55+08:00	49133	81140	130273	5773	136046	227211	59.88%	21.62%	162	162
15	臺北市文山區	2018-11-24T23:39:19+08:00	28957	47601	76558	3451	80009	132692	60.3%	21.82%	99	162
15	臺北市文山區	2018-11-24T22:26:39+08:00	17217	28193	45410	2131	47541	78688	60.42%	21.88%	60	162
15	臺北市文山區	2018-11-24T23:12:18+08:00	24989	41050	66039	3031	69070	114518	60.31%	21.82%	86	162
15	臺北市文山區	2018-11-24T23:31:14+08:00	28054	46092	74146	3324	77470	128357	60.36%	21.86%	96	162
15	臺北市文山區	2018-11-24T23:01:33+08:00	23088	37991	61079	2830	63909	105960	60.31%	21.79%	80	162
15	臺北市文山區	2018-11-24T23:01:34+08:00	23088	37991	61079	2830	63909	105960	60.31%	21.79%	80	162
15	臺北市文山區	2018-11-24T23:47:31+08:00	31576	51894	83470	3782	87252	144522	60.37%	21.85%	107	162
15	臺北市文山區	2018-11-24T23:35:13+08:00	28338	46571	74909	3369	78278	129822	60.3%	21.83%	97	162
15	臺北市文山區	2018-11-25T04:02:54+08:00	49133	81140	130273	5773	136046	227211	59.88%	21.62%	162	162
15	臺北市文山區	2018-11-25T00:09:37+08:00	36571	60355	96926	4292	101218	167859	60.3%	21.79%	123	162
15	桃園市中壢區	2018-11-24T23:16:06+08:00	30113	60990	91103	4054	95157	178876	53.2%	16.83%	120	210
15	桃園市中壢區	2018-11-24T23:43:20+08:00	35938	73124	109062	4792	113854	213972	53.21%	16.8%	141	210
15	桃園市中壢區	2018-11-25T06:13:55+08:00	55628	113277	168905	7506	176411	334402	52.75%	16.64%	210	210
15	桃園市中壢區	2018-11-25T06:19:00+08:00	55628	113277	168905	7506	176411	334402	52.75%	16.64%	210	210
15	桃園市中壢區	2018-11-25T06:29:20+08:00	55628	113277	168905	7506	176411	334402	52.75%	16.64%	210	210
15	桃園市中壢區	2018-11-25T03:49:54+08:00	55628	113277	168905	7506	176411	334402	52.75%	16.64%	210	210
15	桃園市中壢區	2018-11-25T03:56:16+08:00	55628	113277	168905	7506	176411	334402	52.75%	16.64%	210	210
15	桃園市中壢區	2018-11-25T01:07:29+08:00	48735	99201	147936	6523	154459	291574	52.97%	16.71%	186	210
15	桃園市中壢區	2018-11-24T22:30:13+08:00	17032	34156	51188	2385	53573	100474	53.32%	16.95%	70	210
15	桃園市中壢區	2018-11-25T06:24:03+08:00	55628	113277	168905	7506	176411	334402	52.75%	16.64%	210	210
15	桃園市中壢區	2018-11-25T03:32:38+08:00	55628	113277	168905	7506	176411	334402	52.75%	16.64%	210	210
15	桃園市中壢區	2018-11-25T01:25:56+08:00	50978	103717	154695	6824	161519	304771	53%	16.73%	194	210
15	桃園市中壢區	2018-11-25T00:23:07+08:00	43770	89138	132908	5779	138687	261367	53.06%	16.75%	168	210
15	桃園市中壢區	2018-11-24T23:51:39+08:00	38229	77819	116048	5099	121147	227467	53.26%	16.81%	149	210
15	桃園市中壢區	2018-11-24T23:23:41+08:00	31162	63396	94558	4209	98767	185661	53.2%	16.78%	124	210
15	桃園市中壢區	2018-11-25T01:17:57+08:00	49935	101634	151569	6662	158231	298565	53%	16.73%	190	210
15	桃園市中壢區	2018-11-24T23:08:40+08:00	27257	55075	82332	3705	86037	161051	53.42%	16.92%	109	210
15	桃園市中壢區	2018-11-24T22:57:58+08:00	24894	50240	75134	3348	78482	146877	53.43%	16.95%	100	210
15	桃園市中壢區	2018-11-25T06:08:57+08:00	55628	113277	168905	7506	176411	334402	52.75%	16.64%	210	210
15	桃園市中壢區	2018-11-25T01:12:47+08:00	49935	101634	151569	6662	158231	298565	53%	16.73%	190	210
15	桃園市中壢區	2018-11-24T22:16:14+08:00	13551	27088	40639	1934	42573	79582	53.5%	17.03%	57	210
15	桃園市中壢區	2018-11-25T00:05:08+08:00	40881	83019	123900	5386	129286	243505	53.09%	16.79%	158	210
15	桃園市中壢區	2018-11-24T23:05:07+08:00	26736	53882	80618	3633	84251	157868	53.37%	16.94%	107	210
15	桃園市中壢區	2018-11-24T22:54:28+08:00	23537	47635	71172	3204	74376	139686	53.25%	16.85%	95	210
15	桃園市中壢區	2018-11-24T22:33:41+08:00	18240	36614	54854	2547	57401	107608	53.34%	16.95%	75	210
15	桃園市中壢區	2018-11-24T23:47:32+08:00	37023	75441	112464	4975	117439	220717	53.21%	16.77%	145	210
15	桃園市中壢區	2018-11-24T22:41:39+08:00	19824	40168	59992	2761	62753	118018	53.17%	16.8%	82	210
15	桃園市中壢區	2018-11-24T22:37:04+08:00	19153	38668	57821	2689	60510	113524	53.3%	16.87%	79	210
15	桃園市中壢區	2018-11-25T00:18:34+08:00	42239	85939	128178	5560	133738	251631	53.15%	16.79%	163	210
15	桃園市中壢區	2018-11-24T22:50:52+08:00	21709	44357	66066	2997	69063	129908	53.16%	16.71%	89	210
15	桃園市中壢區	2018-11-24T22:26:40+08:00	16433	32952	49385	2314	51699	96997	53.3%	16.94%	68	210
15	桃園市中壢區	2018-11-24T22:45:11+08:00	20321	41468	61789	2817	64606	121650	53.11%	16.7%	84	210
15	桃園市中壢區	2018-11-25T00:57:40+08:00	47942	97361	145303	6374	151677	286152	53.01%	16.75%	183	210
15	桃園市中壢區	2018-11-25T03:44:27+08:00	55628	113277	168905	7506	176411	334402	52.75%	16.64%	210	210
15	桃園市中壢區	2018-11-24T22:19:40+08:00	14284	28646	42930	2025	44955	84012	53.51%	17%	60	210
15	桃園市中壢區	2018-11-25T01:02:34+08:00	47942	97361	145303	6374	151677	286152	53.01%	16.75%	183	210
15	桃園市中壢區	2018-11-24T22:40:30+08:00	19824	40168	59992	2761	62753	118018	53.17%	16.8%	82	210
15	桃園市中壢區	2018-11-25T03:38:58+08:00	55628	113277	168905	7506	176411	334402	52.75%	16.64%	210	210
15	桃園市中壢區	2018-11-24T22:13:31+08:00	13099	26111	39210	1857	41067	76622	53.6%	17.1%	55	210
15	桃園市中壢區	2018-11-24T23:27:21+08:00	31774	64521	96295	4283	100578	188996	53.22%	16.81%	126	210
15	桃園市中壢區	2018-11-24T23:55:50+08:00	38836	78906	117742	5150	122892	230790	53.25%	16.83%	151	210
15	桃園市中壢區	2018-11-24T22:23:17+08:00	15145	30134	45279	2112	47391	89287	53.08%	16.96%	63	210
15	桃園市中壢區	2018-11-24T23:19:55+08:00	30862	62767	93629	4177	97806	183993	53.16%	16.77%	123	210
15	桃園市中壢區	2018-11-25T00:00:14+08:00	39736	80814	120550	5274	125824	236734	53.15%	16.79%	154	210
15	桃園市中壢區	2018-11-25T04:02:55+08:00	55628	113277	168905	7506	176411	334402	52.75%	16.64%	210	210
15	桃園市中壢區	2018-11-25T00:09:38+08:00	40881	83019	123900	5386	129286	243505	53.09%	16.79%	158	210
15	桃園市中壢區	2018-11-24T23:01:34+08:00	25467	51371	76838	3451	80289	150132	53.48%	16.96%	102	210
15	桃園市中壢區	2018-11-24T23:35:14+08:00	33712	68655	102367	4532	106899	200895	53.21%	16.78%	133	210
15	桃園市中壢區	2018-11-25T00:14:13+08:00	41635	84735	126370	5490	131860	248285	53.11%	16.77%	161	210
15	桃園市中壢區	2018-11-24T23:12:19+08:00	28262	57191	85453	3812	89265	167379	53.33%	16.89%	113	210
15	桃園市中壢區	2018-11-24T23:31:15+08:00	32632	66314	98946	4365	103311	194098	53.23%	16.81%	129	210
15	桃園市中壢區	2018-11-24T23:39:20+08:00	34455	70284	104739	4635	109374	205558	53.21%	16.76%	136	210
15	臺南市楠西區	2018-11-24T23:16:08+08:00	995	2544	3539	319	3858	8528	45.24%	11.67%	9	9
15	臺南市楠西區	2018-11-25T03:56:19+08:00	995	2544	3539	319	3858	8528	45.24%	11.67%	9	9
15	臺南市楠西區	2018-11-25T00:18:37+08:00	995	2544	3539	319	3858	8528	45.24%	11.67%	9	9
15	臺南市楠西區	2018-11-24T22:45:13+08:00	995	2544	3539	319	3858	8528	45.24%	11.67%	9	9
15	臺南市楠西區	2018-11-24T22:58:00+08:00	995	2544	3539	319	3858	8528	45.24%	11.67%	9	9
15	臺南市楠西區	2018-11-24T22:37:06+08:00	995	2544	3539	319	3858	8528	45.24%	11.67%	9	9
15	臺南市楠西區	2018-11-25T06:09:00+08:00	995	2544	3539	319	3858	8528	45.24%	11.67%	9	9
15	臺南市楠西區	2018-11-24T22:40:32+08:00	995	2544	3539	319	3858	8528	45.24%	11.67%	9	9
15	臺南市楠西區	2018-11-25T01:02:36+08:00	995	2544	3539	319	3858	8528	45.24%	11.67%	9	9
15	臺南市楠西區	2018-11-24T22:19:42+08:00	995	2544	3539	319	3858	8528	45.24%	11.67%	9	9
15	臺南市楠西區	2018-11-25T01:25:58+08:00	995	2544	3539	319	3858	8528	45.24%	11.67%	9	9
15	臺南市楠西區	2018-11-24T22:30:15+08:00	995	2544	3539	319	3858	8528	45.24%	11.67%	9	9
15	臺南市楠西區	2018-11-24T23:51:41+08:00	995	2544	3539	319	3858	8528	45.24%	11.67%	9	9
15	臺南市楠西區	2018-11-25T00:23:09+08:00	995	2544	3539	319	3858	8528	45.24%	11.67%	9	9
15	臺南市楠西區	2018-11-25T00:57:42+08:00	995	2544	3539	319	3858	8528	45.24%	11.67%	9	9
15	臺南市楠西區	2018-11-25T06:24:05+08:00	995	2544	3539	319	3858	8528	45.24%	11.67%	9	9
15	臺南市楠西區	2018-11-25T00:00:16+08:00	995	2544	3539	319	3858	8528	45.24%	11.67%	9	9
15	臺南市楠西區	2018-11-25T01:17:59+08:00	995	2544	3539	319	3858	8528	45.24%	11.67%	9	9
15	臺南市楠西區	2018-11-24T23:19:57+08:00	995	2544	3539	319	3858	8528	45.24%	11.67%	9	9
15	臺南市楠西區	2018-11-24T23:55:52+08:00	995	2544	3539	319	3858	8528	45.24%	11.67%	9	9
15	臺南市楠西區	2018-11-24T22:13:34+08:00	995	2544	3539	319	3858	8528	45.24%	11.67%	9	9
15	臺南市楠西區	2018-11-24T23:27:23+08:00	995	2544	3539	319	3858	8528	45.24%	11.67%	9	9
15	臺南市楠西區	2018-11-25T03:44:30+08:00	995	2544	3539	319	3858	8528	45.24%	11.67%	9	9
15	臺南市楠西區	2018-11-24T23:39:22+08:00	995	2544	3539	319	3858	8528	45.24%	11.67%	9	9
15	臺南市楠西區	2018-11-25T04:02:58+08:00	995	2544	3539	319	3858	8528	45.24%	11.67%	9	9
15	臺南市楠西區	2018-11-24T23:47:34+08:00	995	2544	3539	319	3858	8528	45.24%	11.67%	9	9
15	臺南市楠西區	2018-11-24T23:05:09+08:00	995	2544	3539	319	3858	8528	45.24%	11.67%	9	9
15	臺南市楠西區	2018-11-24T23:01:36+08:00	995	2544	3539	319	3858	8528	45.24%	11.67%	9	9
15	臺南市楠西區	2018-11-24T23:31:18+08:00	995	2544	3539	319	3858	8528	45.24%	11.67%	9	9
15	臺南市楠西區	2018-11-25T01:07:32+08:00	995	2544	3539	319	3858	8528	45.24%	11.67%	9	9
15	臺南市楠西區	2018-11-24T22:41:42+08:00	995	2544	3539	319	3858	8528	45.24%	11.67%	9	9
15	臺南市楠西區	2018-11-25T06:13:58+08:00	995	2544	3539	319	3858	8528	45.24%	11.67%	9	9
15	臺南市楠西區	2018-11-25T00:05:10+08:00	995	2544	3539	319	3858	8528	45.24%	11.67%	9	9
15	臺南市楠西區	2018-11-25T06:19:02+08:00	995	2544	3539	319	3858	8528	45.24%	11.67%	9	9
15	臺南市楠西區	2018-11-25T03:49:56+08:00	995	2544	3539	319	3858	8528	45.24%	11.67%	9	9
15	臺南市楠西區	2018-11-24T22:54:30+08:00	995	2544	3539	319	3858	8528	45.24%	11.67%	9	9
15	臺南市楠西區	2018-11-24T22:50:54+08:00	995	2544	3539	319	3858	8528	45.24%	11.67%	9	9
15	臺南市楠西區	2018-11-25T01:12:50+08:00	995	2544	3539	319	3858	8528	45.24%	11.67%	9	9
15	臺南市楠西區	2018-11-24T23:43:22+08:00	995	2544	3539	319	3858	8528	45.24%	11.67%	9	9
15	臺南市楠西區	2018-11-25T00:09:40+08:00	995	2544	3539	319	3858	8528	45.24%	11.67%	9	9
15	臺南市楠西區	2018-11-25T06:29:23+08:00	995	2544	3539	319	3858	8528	45.24%	11.67%	9	9
15	臺南市楠西區	2018-11-24T22:26:41+08:00	995	2544	3539	319	3858	8528	45.24%	11.67%	9	9
15	臺南市楠西區	2018-11-25T03:32:42+08:00	995	2544	3539	319	3858	8528	45.24%	11.67%	9	9
15	臺南市楠西區	2018-11-24T23:08:42+08:00	995	2544	3539	319	3858	8528	45.24%	11.67%	9	9
15	臺南市楠西區	2018-11-24T22:23:19+08:00	995	2544	3539	319	3858	8528	45.24%	11.67%	9	9
15	臺南市楠西區	2018-11-24T23:23:43+08:00	995	2544	3539	319	3858	8528	45.24%	11.67%	9	9
15	臺南市楠西區	2018-11-25T00:14:15+08:00	995	2544	3539	319	3858	8528	45.24%	11.67%	9	9
15	臺南市楠西區	2018-11-24T23:35:15+08:00	995	2544	3539	319	3858	8528	45.24%	11.67%	9	9
15	臺南市楠西區	2018-11-24T22:33:43+08:00	995	2544	3539	319	3858	8528	45.24%	11.67%	9	9
15	臺南市楠西區	2018-11-25T03:39:00+08:00	995	2544	3539	319	3858	8528	45.24%	11.67%	9	9
15	臺南市楠西區	2018-11-24T23:12:21+08:00	995	2544	3539	319	3858	8528	45.24%	11.67%	9	9
15	臺南市楠西區	2018-11-24T22:16:16+08:00	995	2544	3539	319	3858	8528	45.24%	11.67%	9	9
15	屏東縣	2018-11-24T22:58:06+08:00	98317	198610	296927	25440	322367	616838	52.26%	15.94%	616	689
15	屏東縣	2018-11-25T06:19:08+08:00	113331	229686	343017	28411	371428	711720	52.19%	15.92%	689	689
15	屏東縣	2018-11-25T06:29:28+08:00	113331	229686	343017	28411	371428	711720	52.19%	15.92%	689	689
15	屏東縣	2018-11-24T23:43:27+08:00	108064	219482	327546	27492	355038	680046	52.21%	15.89%	666	689
15	屏東縣	2018-11-24T22:54:35+08:00	97423	196718	294141	25242	319383	611261	52.25%	15.94%	611	689
15	屏東縣	2018-11-24T23:05:14+08:00	99534	201470	301004	25692	326696	625419	52.24%	15.91%	623	689
15	屏東縣	2018-11-25T01:18:07+08:00	113331	229686	343017	28411	371428	711720	52.19%	15.92%	689	689
15	屏東縣	2018-11-25T00:05:15+08:00	110275	224428	334703	27907	362610	694578	52.21%	15.88%	677	689
15	屏東縣	2018-11-24T22:41:47+08:00	91381	184585	275966	23946	299912	574326	52.22%	15.91%	581	689
15	屏東縣	2018-11-24T22:13:42+08:00	74963	151483	226446	20428	246874	472960	52.2%	15.85%	497	689
15	屏東縣	2018-11-24T23:51:46+08:00	109286	222095	331381	27701	359082	687876	52.2%	15.89%	672	689
15	屏東縣	2018-11-25T06:09:06+08:00	113331	229686	343017	28411	371428	711720	52.19%	15.92%	689	689
15	屏東縣	2018-11-25T01:02:41+08:00	113331	229686	343017	28411	371428	711720	52.19%	15.92%	689	689
15	屏東縣	2018-11-25T00:23:14+08:00	111117	226089	337206	28094	365300	699908	52.19%	15.88%	681	689
15	屏東縣	2018-11-25T06:24:11+08:00	113331	229686	343017	28411	371428	711720	52.19%	15.92%	689	689
15	屏東縣	2018-11-24T23:23:48+08:00	104437	211665	316102	26727	342829	655936	52.27%	15.92%	648	689
15	屏東縣	2018-11-25T00:00:21+08:00	109286	222095	331381	27701	359082	687876	52.2%	15.89%	672	689
15	屏東縣	2018-11-24T22:23:25+08:00	81569	164833	246402	22006	268408	513816	52.24%	15.88%	531	689
15	屏東縣	2018-11-24T22:51:00+08:00	95989	193623	289612	24978	314590	602382	52.22%	15.93%	604	689
15	屏東縣	2018-11-25T03:32:49+08:00	113331	229686	343017	28411	371428	711720	52.19%	15.92%	689	689
15	屏東縣	2018-11-25T03:44:37+08:00	113331	229686	343017	28411	371428	711720	52.19%	15.92%	689	689
15	屏東縣	2018-11-24T23:08:48+08:00	100339	203445	303784	25874	329658	631028	52.24%	15.9%	628	689
15	屏東縣	2018-11-24T22:16:22+08:00	77257	155808	233065	20925	253990	486619	52.19%	15.88%	508	689
15	屏東縣	2018-11-25T01:26:04+08:00	113331	229686	343017	28411	371428	711720	52.19%	15.92%	689	689
15	屏東縣	2018-11-24T23:16:13+08:00	102743	208088	310831	26404	337235	645314	52.26%	15.92%	640	689
15	屏東縣	2018-11-24T23:35:20+08:00	107350	217506	324856	27266	352122	674368	52.22%	15.92%	661	689
15	屏東縣	2018-11-25T00:14:20+08:00	110961	225863	336824	28051	364875	699240	52.18%	15.87%	680	689
15	屏東縣	2018-11-25T03:39:05+08:00	113331	229686	343017	28411	371428	711720	52.19%	15.92%	689	689
15	屏東縣	2018-11-24T22:33:48+08:00	87427	176706	264133	23251	287384	550421	52.21%	15.88%	562	689
15	屏東縣	2018-11-25T03:50:01+08:00	113331	229686	343017	28411	371428	711720	52.19%	15.92%	689	689
15	屏東縣	2018-11-25T01:12:56+08:00	113331	229686	343017	28411	371428	711720	52.19%	15.92%	689	689
15	屏東縣	2018-11-24T23:47:40+08:00	109096	221594	330690	27665	358355	686506	52.2%	15.89%	671	689
15	屏東縣	2018-11-24T23:01:43+08:00	98849	199798	298647	25588	324235	620475	52.26%	15.93%	619	689
15	屏東縣	2018-11-25T00:09:46+08:00	110764	225490	336254	28001	364255	697755	52.2%	15.87%	679	689
15	屏東縣	2018-11-25T03:56:25+08:00	113331	229686	343017	28411	371428	711720	52.19%	15.92%	689	689
15	屏東縣	2018-11-24T22:45:18+08:00	93406	189176	282582	24392	306974	588099	52.2%	15.88%	592	689
15	屏東縣	2018-11-24T22:26:46+08:00	82278	166331	248609	22164	270773	518774	52.19%	15.86%	535	689
15	屏東縣	2018-11-24T22:40:38+08:00	91381	184585	275966	23946	299912	574326	52.22%	15.91%	581	689
15	屏東縣	2018-11-25T04:03:03+08:00	113331	229686	343017	28411	371428	711720	52.19%	15.92%	689	689
15	屏東縣	2018-11-25T00:57:48+08:00	113102	229246	342348	28341	370689	710201	52.19%	15.93%	688	689
15	屏東縣	2018-11-24T22:19:47+08:00	79192	159671	238863	21476	260339	498665	52.21%	15.88%	519	689
15	屏東縣	2018-11-24T22:30:20+08:00	83358	168612	251970	22336	274306	525587	52.19%	15.86%	540	689
15	屏東縣	2018-11-24T23:27:28+08:00	105905	214561	320466	26917	347383	665121	52.23%	15.92%	654	689
15	屏東縣	2018-11-25T06:14:03+08:00	113331	229686	343017	28411	371428	711720	52.19%	15.92%	689	689
15	屏東縣	2018-11-24T23:55:58+08:00	109286	222095	331381	27701	359082	687876	52.2%	15.89%	672	689
15	屏東縣	2018-11-25T00:18:44+08:00	110961	225863	336824	28051	364875	699240	52.18%	15.87%	680	689
15	屏東縣	2018-11-24T23:20:03+08:00	103428	209607	313035	26502	339537	649744	52.26%	15.92%	643	689
15	屏東縣	2018-11-25T01:07:37+08:00	113331	229686	343017	28411	371428	711720	52.19%	15.92%	689	689
15	屏東縣	2018-11-24T23:12:27+08:00	100761	204345	305106	25986	331092	633828	52.24%	15.9%	630	689
15	屏東縣	2018-11-24T22:37:11+08:00	89824	181210	271034	23649	294683	564344	52.22%	15.92%	572	689
15	屏東縣	2018-11-24T23:39:29+08:00	107930	219148	327078	27472	354550	679074	52.21%	15.89%	665	689
15	屏東縣	2018-11-24T23:31:24+08:00	106729	216280	323009	27144	350153	670644	52.21%	15.91%	658	689
15	臺南市北區	2018-11-24T23:16:08+08:00	18942	33451	52393	2322	54715	101108	54.12%	18.73%	75	81
15	臺南市北區	2018-11-25T03:56:19+08:00	20680	36676	57356	2527	59883	110906	53.99%	18.65%	81	81
15	臺南市北區	2018-11-25T00:18:37+08:00	20360	36135	56495	2494	58989	109322	53.96%	18.62%	80	81
15	臺南市北區	2018-11-24T22:45:14+08:00	16499	29592	46091	2023	48114	88870	54.14%	18.57%	67	81
15	臺南市北區	2018-11-24T22:58:00+08:00	17115	30740	47855	2108	49963	92082	54.26%	18.59%	69	81
15	臺南市北區	2018-11-24T22:26:42+08:00	14652	26246	40898	1800	42698	79092	53.99%	18.53%	60	81
15	臺南市北區	2018-11-25T01:18:00+08:00	20680	36676	57356	2527	59883	110906	53.99%	18.65%	81	81
15	臺南市北區	2018-11-24T22:37:06+08:00	15727	28083	43810	1910	45720	84429	54.15%	18.63%	64	81
15	臺南市北區	2018-11-25T06:09:00+08:00	20680	36676	57356	2527	59883	110906	53.99%	18.65%	81	81
15	臺南市北區	2018-11-25T00:57:43+08:00	20680	36676	57356	2527	59883	110906	53.99%	18.65%	81	81
15	臺南市北區	2018-11-24T22:19:42+08:00	14003	24890	38893	1718	40611	75222	53.99%	18.62%	57	81
15	臺南市北區	2018-11-25T01:25:58+08:00	20680	36676	57356	2527	59883	110906	53.99%	18.65%	81	81
15	臺南市北區	2018-11-24T22:30:15+08:00	15127	27089	42216	1848	44064	81505	54.06%	18.56%	62	81
15	臺南市北區	2018-11-25T01:02:37+08:00	20680	36676	57356	2527	59883	110906	53.99%	18.65%	81	81
15	臺南市北區	2018-11-24T22:40:33+08:00	16024	28654	44678	1934	46612	86024	54.18%	18.63%	65	81
15	臺南市北區	2018-11-24T23:51:41+08:00	20360	36135	56495	2494	58989	109322	53.96%	18.62%	80	81
15	臺南市北區	2018-11-25T00:00:16+08:00	20360	36135	56495	2494	58989	109322	53.96%	18.62%	80	81
15	臺南市北區	2018-11-24T22:13:35+08:00	13006	23045	36051	1566	37617	69726	53.95%	18.65%	53	81
15	臺南市北區	2018-11-24T23:55:52+08:00	20360	36135	56495	2494	58989	109322	53.96%	18.62%	80	81
15	臺南市北區	2018-11-24T23:19:58+08:00	19487	34454	53941	2391	56332	104338	53.99%	18.68%	77	81
15	臺南市北區	2018-11-24T23:27:23+08:00	19817	35014	54831	2404	57235	106058	53.97%	18.69%	78	81
15	臺南市北區	2018-11-25T03:44:30+08:00	20680	36676	57356	2527	59883	110906	53.99%	18.65%	81	81
15	臺南市北區	2018-11-24T23:01:37+08:00	17309	31150	48459	2137	50596	93271	54.25%	18.56%	70	81
15	臺南市北區	2018-11-25T04:02:58+08:00	20680	36676	57356	2527	59883	110906	53.99%	18.65%	81	81
15	臺南市北區	2018-11-25T00:14:16+08:00	20360	36135	56495	2494	58989	109322	53.96%	18.62%	80	81
15	臺南市北區	2018-11-24T23:35:16+08:00	20161	35630	55791	2461	58252	107932	53.97%	18.68%	79	81
15	臺南市北區	2018-11-24T23:12:22+08:00	18723	33112	51835	2285	54120	99541	54.37%	18.81%	74	81
15	臺南市北區	2018-11-24T23:31:18+08:00	19817	35014	54831	2404	57235	106058	53.97%	18.69%	78	81
15	臺南市北區	2018-11-24T23:39:23+08:00	20161	35630	55791	2461	58252	107932	53.97%	18.68%	79	81
15	臺南市北區	2018-11-25T01:07:32+08:00	20680	36676	57356	2527	59883	110906	53.99%	18.65%	81	81
15	臺南市北區	2018-11-24T23:47:35+08:00	20360	36135	56495	2494	58989	109322	53.96%	18.62%	80	81
15	臺南市北區	2018-11-24T22:41:42+08:00	16024	28654	44678	1934	46612	86024	54.18%	18.63%	65	81
15	臺南市北區	2018-11-25T06:13:58+08:00	20680	36676	57356	2527	59883	110906	53.99%	18.65%	81	81
15	臺南市北區	2018-11-24T22:54:31+08:00	17115	30740	47855	2108	49963	92082	54.26%	18.59%	69	81
15	臺南市北區	2018-11-25T00:09:41+08:00	20360	36135	56495	2494	58989	109322	53.96%	18.62%	80	81
15	臺南市北區	2018-11-24T22:50:54+08:00	16751	30083	46834	2074	48908	90210	54.22%	18.57%	68	81
15	臺南市北區	2018-11-25T01:12:50+08:00	20680	36676	57356	2527	59883	110906	53.99%	18.65%	81	81
15	臺南市北區	2018-11-24T23:43:22+08:00	20360	36135	56495	2494	58989	109322	53.96%	18.62%	80	81
15	臺南市北區	2018-11-25T06:29:23+08:00	20680	36676	57356	2527	59883	110906	53.99%	18.65%	81	81
15	臺南市北區	2018-11-25T03:49:57+08:00	20680	36676	57356	2527	59883	110906	53.99%	18.65%	81	81
15	臺南市北區	2018-11-24T23:05:10+08:00	17309	31150	48459	2137	50596	93271	54.25%	18.56%	70	81
15	臺南市北區	2018-11-25T06:19:03+08:00	20680	36676	57356	2527	59883	110906	53.99%	18.65%	81	81
15	臺南市北區	2018-11-25T00:05:11+08:00	20360	36135	56495	2494	58989	109322	53.96%	18.62%	80	81
15	臺南市北區	2018-11-25T06:24:06+08:00	20680	36676	57356	2527	59883	110906	53.99%	18.65%	81	81
15	臺南市北區	2018-11-24T23:08:43+08:00	17967	32186	50153	2204	52357	96390	54.32%	18.64%	72	81
15	臺南市北區	2018-11-24T22:23:20+08:00	14212	25390	39602	1752	41354	76540	54.03%	18.57%	58	81
15	臺南市北區	2018-11-25T00:23:10+08:00	20360	36135	56495	2494	58989	109322	53.96%	18.62%	80	81
15	臺南市北區	2018-11-25T03:32:43+08:00	20680	36676	57356	2527	59883	110906	53.99%	18.65%	81	81
15	臺南市北區	2018-11-24T23:23:44+08:00	19817	35014	54831	2404	57235	106058	53.97%	18.69%	78	81
15	臺南市北區	2018-11-24T22:33:44+08:00	15452	27617	43069	1882	44951	83167	54.05%	18.58%	63	81
15	臺南市北區	2018-11-24T22:16:17+08:00	13481	24013	37494	1669	39163	72626	53.92%	18.56%	55	81
15	臺南市北區	2018-11-25T03:39:00+08:00	20680	36676	57356	2527	59883	110906	53.99%	18.65%	81	81
15	屏東縣鹽埔鄉	2018-11-24T22:58:06+08:00	3430	7284	10714	908	11622	22402	51.88%	15.31%	20	20
15	屏東縣鹽埔鄉	2018-11-25T06:19:08+08:00	3430	7284	10714	908	11622	22402	51.88%	15.31%	20	20
15	屏東縣鹽埔鄉	2018-11-24T23:43:27+08:00	3430	7284	10714	908	11622	22402	51.88%	15.31%	20	20
15	屏東縣鹽埔鄉	2018-11-24T22:54:35+08:00	3430	7284	10714	908	11622	22402	51.88%	15.31%	20	20
15	屏東縣鹽埔鄉	2018-11-24T22:41:48+08:00	3311	6880	10191	839	11030	21418	51.5%	15.46%	19	20
15	屏東縣鹽埔鄉	2018-11-24T23:05:14+08:00	3430	7284	10714	908	11622	22402	51.88%	15.31%	20	20
15	屏東縣鹽埔鄉	2018-11-25T06:29:29+08:00	3430	7284	10714	908	11622	22402	51.88%	15.31%	20	20
15	屏東縣鹽埔鄉	2018-11-25T01:18:07+08:00	3430	7284	10714	908	11622	22402	51.88%	15.31%	20	20
15	屏東縣鹽埔鄉	2018-11-24T22:13:42+08:00	2791	5916	8707	738	9445	18432	51.24%	15.14%	17	20
15	屏東縣鹽埔鄉	2018-11-24T23:51:46+08:00	3430	7284	10714	908	11622	22402	51.88%	15.31%	20	20
15	屏東縣鹽埔鄉	2018-11-25T06:09:06+08:00	3430	7284	10714	908	11622	22402	51.88%	15.31%	20	20
15	屏東縣鹽埔鄉	2018-11-25T06:24:11+08:00	3430	7284	10714	908	11622	22402	51.88%	15.31%	20	20
15	屏東縣鹽埔鄉	2018-11-24T23:08:49+08:00	3430	7284	10714	908	11622	22402	51.88%	15.31%	20	20
15	屏東縣鹽埔鄉	2018-11-24T23:23:48+08:00	3430	7284	10714	908	11622	22402	51.88%	15.31%	20	20
15	屏東縣鹽埔鄉	2018-11-25T03:44:38+08:00	3430	7284	10714	908	11622	22402	51.88%	15.31%	20	20
15	屏東縣鹽埔鄉	2018-11-25T00:23:15+08:00	3430	7284	10714	908	11622	22402	51.88%	15.31%	20	20
15	屏東縣鹽埔鄉	2018-11-25T00:00:21+08:00	3430	7284	10714	908	11622	22402	51.88%	15.31%	20	20
15	屏東縣鹽埔鄉	2018-11-24T22:51:00+08:00	3430	7284	10714	908	11622	22402	51.88%	15.31%	20	20
15	屏東縣鹽埔鄉	2018-11-25T03:32:49+08:00	3430	7284	10714	908	11622	22402	51.88%	15.31%	20	20
15	屏東縣鹽埔鄉	2018-11-24T22:37:12+08:00	3311	6880	10191	839	11030	21418	51.5%	15.46%	19	20
15	屏東縣鹽埔鄉	2018-11-24T23:16:14+08:00	3430	7284	10714	908	11622	22402	51.88%	15.31%	20	20
15	屏東縣鹽埔鄉	2018-11-24T23:35:20+08:00	3430	7284	10714	908	11622	22402	51.88%	15.31%	20	20
15	屏東縣鹽埔鄉	2018-11-25T01:26:05+08:00	3430	7284	10714	908	11622	22402	51.88%	15.31%	20	20
15	屏東縣鹽埔鄉	2018-11-25T03:39:05+08:00	3430	7284	10714	908	11622	22402	51.88%	15.31%	20	20
15	屏東縣鹽埔鄉	2018-11-24T22:33:48+08:00	3311	6880	10191	839	11030	21418	51.5%	15.46%	19	20
15	屏東縣鹽埔鄉	2018-11-25T03:50:01+08:00	3430	7284	10714	908	11622	22402	51.88%	15.31%	20	20
15	屏東縣鹽埔鄉	2018-11-24T22:16:23+08:00	2791	5916	8707	738	9445	18432	51.24%	15.14%	17	20
15	屏東縣鹽埔鄉	2018-11-25T00:14:21+08:00	3430	7284	10714	908	11622	22402	51.88%	15.31%	20	20
15	屏東縣鹽埔鄉	2018-11-25T01:12:56+08:00	3430	7284	10714	908	11622	22402	51.88%	15.31%	20	20
15	屏東縣鹽埔鄉	2018-11-24T23:01:43+08:00	3430	7284	10714	908	11622	22402	51.88%	15.31%	20	20
15	屏東縣鹽埔鄉	2018-11-25T03:56:25+08:00	3430	7284	10714	908	11622	22402	51.88%	15.31%	20	20
15	屏東縣鹽埔鄉	2018-11-24T23:47:41+08:00	3430	7284	10714	908	11622	22402	51.88%	15.31%	20	20
15	屏東縣鹽埔鄉	2018-11-24T22:45:18+08:00	3430	7284	10714	908	11622	22402	51.88%	15.31%	20	20
15	屏東縣鹽埔鄉	2018-11-25T00:09:47+08:00	3430	7284	10714	908	11622	22402	51.88%	15.31%	20	20
15	屏東縣鹽埔鄉	2018-11-24T22:26:46+08:00	3311	6880	10191	839	11030	21418	51.5%	15.46%	19	20
15	屏東縣鹽埔鄉	2018-11-25T00:05:16+08:00	3430	7284	10714	908	11622	22402	51.88%	15.31%	20	20
15	屏東縣鹽埔鄉	2018-11-24T22:30:21+08:00	3311	6880	10191	839	11030	21418	51.5%	15.46%	19	20
15	屏東縣鹽埔鄉	2018-11-24T22:40:38+08:00	3311	6880	10191	839	11030	21418	51.5%	15.46%	19	20
15	屏東縣鹽埔鄉	2018-11-25T04:03:03+08:00	3430	7284	10714	908	11622	22402	51.88%	15.31%	20	20
15	屏東縣鹽埔鄉	2018-11-25T00:57:48+08:00	3430	7284	10714	908	11622	22402	51.88%	15.31%	20	20
15	屏東縣鹽埔鄉	2018-11-24T22:19:47+08:00	3022	6330	9352	800	10152	19799	51.28%	15.26%	18	20
15	屏東縣鹽埔鄉	2018-11-24T23:27:28+08:00	3430	7284	10714	908	11622	22402	51.88%	15.31%	20	20
15	屏東縣鹽埔鄉	2018-11-25T01:02:42+08:00	3430	7284	10714	908	11622	22402	51.88%	15.31%	20	20
15	屏東縣鹽埔鄉	2018-11-25T06:14:03+08:00	3430	7284	10714	908	11622	22402	51.88%	15.31%	20	20
15	屏東縣鹽埔鄉	2018-11-24T22:23:26+08:00	3311	6880	10191	839	11030	21418	51.5%	15.46%	19	20
15	屏東縣鹽埔鄉	2018-11-24T23:55:58+08:00	3430	7284	10714	908	11622	22402	51.88%	15.31%	20	20
15	屏東縣鹽埔鄉	2018-11-25T00:18:44+08:00	3430	7284	10714	908	11622	22402	51.88%	15.31%	20	20
15	屏東縣鹽埔鄉	2018-11-24T23:20:03+08:00	3430	7284	10714	908	11622	22402	51.88%	15.31%	20	20
15	屏東縣鹽埔鄉	2018-11-25T01:07:37+08:00	3430	7284	10714	908	11622	22402	51.88%	15.31%	20	20
15	屏東縣鹽埔鄉	2018-11-24T23:39:29+08:00	3430	7284	10714	908	11622	22402	51.88%	15.31%	20	20
15	屏東縣鹽埔鄉	2018-11-24T23:12:28+08:00	3430	7284	10714	908	11622	22402	51.88%	15.31%	20	20
15	屏東縣鹽埔鄉	2018-11-24T23:31:24+08:00	3430	7284	10714	908	11622	22402	51.88%	15.31%	20	20
15	南投縣集集鎮	2018-11-25T00:05:14+08:00	1562	3642	5204	378	5582	9611	58.08%	16.25%	13	13
15	南投縣集集鎮	2018-11-24T23:01:40+08:00	1369	3160	4529	339	4868	8417	57.84%	16.26%	12	13
15	南投縣集集鎮	2018-11-25T06:19:06+08:00	1562	3642	5204	378	5582	9611	58.08%	16.25%	13	13
15	南投縣集集鎮	2018-11-24T23:05:12+08:00	1369	3160	4529	339	4868	8417	57.84%	16.26%	12	13
15	南投縣集集鎮	2018-11-25T00:09:45+08:00	1562	3642	5204	378	5582	9611	58.08%	16.25%	13	13
15	南投縣集集鎮	2018-11-25T06:29:26+08:00	1562	3642	5204	378	5582	9611	58.08%	16.25%	13	13
15	南投縣集集鎮	2018-11-24T22:50:58+08:00	1369	3160	4529	339	4868	8417	57.84%	16.26%	12	13
15	南投縣集集鎮	2018-11-24T22:41:46+08:00	1369	3160	4529	339	4868	8417	57.84%	16.26%	12	13
15	南投縣集集鎮	2018-11-24T22:37:09+08:00	1369	3160	4529	339	4868	8417	57.84%	16.26%	12	13
15	南投縣集集鎮	2018-11-24T22:26:45+08:00	1238	2910	4148	318	4466	7708	57.94%	16.06%	11	13
15	南投縣集集鎮	2018-11-24T22:54:33+08:00	1369	3160	4529	339	4868	8417	57.84%	16.26%	12	13
15	南投縣集集鎮	2018-11-25T01:12:54+08:00	1562	3642	5204	378	5582	9611	58.08%	16.25%	13	13
15	南投縣集集鎮	2018-11-24T22:19:45+08:00	1238	2910	4148	318	4466	7708	57.94%	16.06%	11	13
15	南投縣集集鎮	2018-11-25T04:03:01+08:00	1562	3642	5204	378	5582	9611	58.08%	16.25%	13	13
15	南投縣集集鎮	2018-11-25T00:00:20+08:00	1562	3642	5204	378	5582	9611	58.08%	16.25%	13	13
15	南投縣集集鎮	2018-11-25T00:23:13+08:00	1562	3642	5204	378	5582	9611	58.08%	16.25%	13	13
15	南投縣集集鎮	2018-11-24T22:23:24+08:00	1238	2910	4148	318	4466	7708	57.94%	16.06%	11	13
15	南投縣集集鎮	2018-11-25T01:02:40+08:00	1562	3642	5204	378	5582	9611	58.08%	16.25%	13	13
15	南投縣集集鎮	2018-11-25T06:14:01+08:00	1562	3642	5204	378	5582	9611	58.08%	16.25%	13	13
15	南投縣集集鎮	2018-11-25T03:32:47+08:00	1562	3642	5204	378	5582	9611	58.08%	16.25%	13	13
15	南投縣集集鎮	2018-11-24T23:08:46+08:00	1369	3160	4529	339	4868	8417	57.84%	16.26%	12	13
15	南投縣集集鎮	2018-11-24T23:23:47+08:00	1369	3160	4529	339	4868	8417	57.84%	16.26%	12	13
15	南投縣集集鎮	2018-11-25T03:50:00+08:00	1562	3642	5204	378	5582	9611	58.08%	16.25%	13	13
15	南投縣集集鎮	2018-11-25T03:39:03+08:00	1562	3642	5204	378	5582	9611	58.08%	16.25%	13	13
15	南投縣集集鎮	2018-11-25T01:26:02+08:00	1562	3642	5204	378	5582	9611	58.08%	16.25%	13	13
15	南投縣集集鎮	2018-11-24T23:20:01+08:00	1369	3160	4529	339	4868	8417	57.84%	16.26%	12	13
15	南投縣集集鎮	2018-11-25T01:07:35+08:00	1562	3642	5204	378	5582	9611	58.08%	16.25%	13	13
15	南投縣集集鎮	2018-11-24T22:33:46+08:00	1238	2910	4148	318	4466	7708	57.94%	16.06%	11	13
15	南投縣集集鎮	2018-11-25T00:14:19+08:00	1562	3642	5204	378	5582	9611	58.08%	16.25%	13	13
15	南投縣集集鎮	2018-11-24T23:16:12+08:00	1369	3160	4529	339	4868	8417	57.84%	16.26%	12	13
15	南投縣集集鎮	2018-11-24T23:35:19+08:00	1369	3160	4529	339	4868	8417	57.84%	16.26%	12	13
15	南投縣集集鎮	2018-11-24T22:45:16+08:00	1369	3160	4529	339	4868	8417	57.84%	16.26%	12	13
15	南投縣集集鎮	2018-11-24T23:43:25+08:00	1369	3160	4529	339	4868	8417	57.84%	16.26%	12	13
15	南投縣集集鎮	2018-11-25T03:56:23+08:00	1562	3642	5204	378	5582	9611	58.08%	16.25%	13	13
15	南投縣集集鎮	2018-11-24T22:58:04+08:00	1369	3160	4529	339	4868	8417	57.84%	16.26%	12	13
15	南投縣集集鎮	2018-11-25T01:18:04+08:00	1562	3642	5204	378	5582	9611	58.08%	16.25%	13	13
15	南投縣集集鎮	2018-11-25T06:24:09+08:00	1562	3642	5204	378	5582	9611	58.08%	16.25%	13	13
15	南投縣集集鎮	2018-11-25T06:09:04+08:00	1562	3642	5204	378	5582	9611	58.08%	16.25%	13	13
15	南投縣集集鎮	2018-11-24T23:51:44+08:00	1562	3642	5204	378	5582	9611	58.08%	16.25%	13	13
15	南投縣集集鎮	2018-11-24T22:40:36+08:00	1369	3160	4529	339	4868	8417	57.84%	16.26%	12	13
15	南投縣集集鎮	2018-11-24T22:30:19+08:00	1238	2910	4148	318	4466	7708	57.94%	16.06%	11	13
15	南投縣集集鎮	2018-11-24T22:13:40+08:00	1110	2588	3698	284	3982	6935	57.42%	16.01%	10	13
15	南投縣集集鎮	2018-11-25T00:57:46+08:00	1562	3642	5204	378	5582	9611	58.08%	16.25%	13	13
15	南投縣集集鎮	2018-11-24T23:27:26+08:00	1369	3160	4529	339	4868	8417	57.84%	16.26%	12	13
15	南投縣集集鎮	2018-11-25T03:44:35+08:00	1562	3642	5204	378	5582	9611	58.08%	16.25%	13	13
15	南投縣集集鎮	2018-11-24T23:55:56+08:00	1562	3642	5204	378	5582	9611	58.08%	16.25%	13	13
15	南投縣集集鎮	2018-11-24T23:31:22+08:00	1369	3160	4529	339	4868	8417	57.84%	16.26%	12	13
15	南投縣集集鎮	2018-11-24T22:16:21+08:00	1238	2910	4148	318	4466	7708	57.94%	16.06%	11	13
15	南投縣集集鎮	2018-11-25T00:18:42+08:00	1562	3642	5204	378	5582	9611	58.08%	16.25%	13	13
15	南投縣集集鎮	2018-11-24T23:47:38+08:00	1369	3160	4529	339	4868	8417	57.84%	16.26%	12	13
15	南投縣集集鎮	2018-11-24T23:12:26+08:00	1369	3160	4529	339	4868	8417	57.84%	16.26%	12	13
15	南投縣集集鎮	2018-11-24T23:39:27+08:00	1369	3160	4529	339	4868	8417	57.84%	16.26%	12	13
15	苗栗縣苑裡鎮	2018-11-24T22:26:43+08:00	4083	9443	13526	1040	14566	25097	58.04%	16.27%	28	40
15	苗栗縣苑裡鎮	2018-11-25T03:56:21+08:00	6245	14548	20793	1583	22376	38890	57.54%	16.06%	40	40
15	苗栗縣苑裡鎮	2018-11-25T01:12:52+08:00	6245	14548	20793	1583	22376	38890	57.54%	16.06%	40	40
15	苗栗縣苑裡鎮	2018-11-24T22:54:32+08:00	5517	12830	18347	1362	19709	34168	57.68%	16.15%	36	40
15	苗栗縣苑裡鎮	2018-11-25T00:09:43+08:00	6245	14548	20793	1583	22376	38890	57.54%	16.06%	40	40
15	苗栗縣苑裡鎮	2018-11-25T00:05:12+08:00	6245	14548	20793	1583	22376	38890	57.54%	16.06%	40	40
15	苗栗縣苑裡鎮	2018-11-24T22:37:08+08:00	4760	11042	15802	1183	16985	29453	57.67%	16.16%	32	40
15	苗栗縣苑裡鎮	2018-11-24T22:45:15+08:00	5055	11746	16801	1257	18058	31355	57.59%	16.12%	34	40
15	苗栗縣苑裡鎮	2018-11-24T22:50:57+08:00	5258	12233	17491	1315	18806	32589	57.71%	16.13%	35	40
15	苗栗縣苑裡鎮	2018-11-25T01:02:38+08:00	6245	14548	20793	1583	22376	38890	57.54%	16.06%	40	40
15	苗栗縣苑裡鎮	2018-11-24T22:40:35+08:00	4878	11328	16206	1213	17419	30241	57.6%	16.13%	33	40
15	苗栗縣苑裡鎮	2018-11-25T04:03:00+08:00	6245	14548	20793	1583	22376	38890	57.54%	16.06%	40	40
15	苗栗縣苑裡鎮	2018-11-25T00:57:45+08:00	6245	14548	20793	1583	22376	38890	57.54%	16.06%	40	40
15	苗栗縣苑裡鎮	2018-11-24T22:19:44+08:00	3850	8934	12784	990	13774	23751	57.99%	16.21%	27	40
15	苗栗縣苑裡鎮	2018-11-25T06:14:00+08:00	6245	14548	20793	1583	22376	38890	57.54%	16.06%	40	40
15	苗栗縣苑裡鎮	2018-11-25T00:00:18+08:00	6245	14548	20793	1583	22376	38890	57.54%	16.06%	40	40
15	苗栗縣苑裡鎮	2018-11-24T23:27:25+08:00	6245	14548	20793	1583	22376	38890	57.54%	16.06%	40	40
15	苗栗縣苑裡鎮	2018-11-24T23:55:55+08:00	6245	14548	20793	1583	22376	38890	57.54%	16.06%	40	40
15	苗栗縣苑裡鎮	2018-11-24T22:23:22+08:00	3850	8934	12784	990	13774	23751	57.99%	16.21%	27	40
15	苗栗縣苑裡鎮	2018-11-24T23:01:39+08:00	5517	12830	18347	1362	19709	34168	57.68%	16.15%	36	40
15	苗栗縣苑裡鎮	2018-11-24T23:39:25+08:00	6245	14548	20793	1583	22376	38890	57.54%	16.06%	40	40
15	苗栗縣苑裡鎮	2018-11-24T23:20:00+08:00	6245	14548	20793	1583	22376	38890	57.54%	16.06%	40	40
15	苗栗縣苑裡鎮	2018-11-25T01:07:34+08:00	6245	14548	20793	1583	22376	38890	57.54%	16.06%	40	40
15	苗栗縣苑裡鎮	2018-11-24T23:12:24+08:00	6054	14096	20150	1526	21676	37620	57.62%	16.09%	39	40
15	苗栗縣苑裡鎮	2018-11-25T00:18:40+08:00	6245	14548	20793	1583	22376	38890	57.54%	16.06%	40	40
15	苗栗縣苑裡鎮	2018-11-25T03:39:02+08:00	6245	14548	20793	1583	22376	38890	57.54%	16.06%	40	40
15	苗栗縣苑裡鎮	2018-11-24T23:31:20+08:00	6245	14548	20793	1583	22376	38890	57.54%	16.06%	40	40
15	苗栗縣苑裡鎮	2018-11-24T23:35:17+08:00	6245	14548	20793	1583	22376	38890	57.54%	16.06%	40	40
15	苗栗縣苑裡鎮	2018-11-25T00:14:17+08:00	6245	14548	20793	1583	22376	38890	57.54%	16.06%	40	40
15	苗栗縣苑裡鎮	2018-11-24T23:43:24+08:00	6245	14548	20793	1583	22376	38890	57.54%	16.06%	40	40
15	苗栗縣苑裡鎮	2018-11-24T22:58:02+08:00	5517	12830	18347	1362	19709	34168	57.68%	16.15%	36	40
15	苗栗縣苑裡鎮	2018-11-25T03:49:58+08:00	6245	14548	20793	1583	22376	38890	57.54%	16.06%	40	40
15	苗栗縣苑裡鎮	2018-11-25T01:18:02+08:00	6245	14548	20793	1583	22376	38890	57.54%	16.06%	40	40
15	苗栗縣苑裡鎮	2018-11-25T06:29:25+08:00	6245	14548	20793	1583	22376	38890	57.54%	16.06%	40	40
15	苗栗縣苑裡鎮	2018-11-25T06:19:05+08:00	6245	14548	20793	1583	22376	38890	57.54%	16.06%	40	40
15	苗栗縣苑裡鎮	2018-11-24T23:05:11+08:00	5724	13338	19062	1431	20493	35516	57.7%	16.12%	37	40
15	苗栗縣苑裡鎮	2018-11-24T22:41:44+08:00	4878	11328	16206	1213	17419	30241	57.6%	16.13%	33	40
15	苗栗縣苑裡鎮	2018-11-24T23:51:43+08:00	6245	14548	20793	1583	22376	38890	57.54%	16.06%	40	40
15	苗栗縣苑裡鎮	2018-11-24T22:30:17+08:00	4361	10141	14502	1094	15596	27110	57.53%	16.09%	30	40
15	苗栗縣苑裡鎮	2018-11-25T06:24:08+08:00	6245	14548	20793	1583	22376	38890	57.54%	16.06%	40	40
15	苗栗縣苑裡鎮	2018-11-25T06:09:02+08:00	6245	14548	20793	1583	22376	38890	57.54%	16.06%	40	40
15	苗栗縣苑裡鎮	2018-11-24T23:23:45+08:00	6245	14548	20793	1583	22376	38890	57.54%	16.06%	40	40
15	苗栗縣苑裡鎮	2018-11-25T03:44:32+08:00	6245	14548	20793	1583	22376	38890	57.54%	16.06%	40	40
15	苗栗縣苑裡鎮	2018-11-25T03:32:45+08:00	6245	14548	20793	1583	22376	38890	57.54%	16.06%	40	40
15	苗栗縣苑裡鎮	2018-11-24T22:13:38+08:00	3508	8129	11637	911	12548	21617	58.05%	16.23%	25	40
15	苗栗縣苑裡鎮	2018-11-24T23:08:45+08:00	5911	13753	19664	1488	21152	36747	57.56%	16.09%	38	40
15	苗栗縣苑裡鎮	2018-11-25T00:23:11+08:00	6245	14548	20793	1583	22376	38890	57.54%	16.06%	40	40
15	苗栗縣苑裡鎮	2018-11-24T23:16:10+08:00	6245	14548	20793	1583	22376	38890	57.54%	16.06%	40	40
15	苗栗縣苑裡鎮	2018-11-24T23:47:37+08:00	6245	14548	20793	1583	22376	38890	57.54%	16.06%	40	40
15	苗栗縣苑裡鎮	2018-11-24T22:16:19+08:00	3668	8589	12257	936	13193	22699	58.12%	16.16%	26	40
15	苗栗縣苑裡鎮	2018-11-25T01:26:01+08:00	6245	14548	20793	1583	22376	38890	57.54%	16.06%	40	40
15	苗栗縣苑裡鎮	2018-11-24T22:33:45+08:00	4580	10584	15164	1144	16308	28259	57.71%	16.21%	31	40
15	苗栗縣頭屋鄉	2018-11-24T22:26:44+08:00	1691	4087	5778	346	6124	9390	65.22%	18.01%	12	12
15	苗栗縣頭屋鄉	2018-11-25T00:05:13+08:00	1691	4087	5778	346	6124	9390	65.22%	18.01%	12	12
15	苗栗縣頭屋鄉	2018-11-24T23:05:12+08:00	1691	4087	5778	346	6124	9390	65.22%	18.01%	12	12
15	苗栗縣頭屋鄉	2018-11-25T00:09:43+08:00	1691	4087	5778	346	6124	9390	65.22%	18.01%	12	12
15	苗栗縣頭屋鄉	2018-11-24T22:37:08+08:00	1691	4087	5778	346	6124	9390	65.22%	18.01%	12	12
15	苗栗縣頭屋鄉	2018-11-24T22:54:33+08:00	1691	4087	5778	346	6124	9390	65.22%	18.01%	12	12
15	苗栗縣頭屋鄉	2018-11-24T22:50:57+08:00	1691	4087	5778	346	6124	9390	65.22%	18.01%	12	12
15	苗栗縣頭屋鄉	2018-11-25T01:12:53+08:00	1691	4087	5778	346	6124	9390	65.22%	18.01%	12	12
15	苗栗縣頭屋鄉	2018-11-24T22:40:35+08:00	1691	4087	5778	346	6124	9390	65.22%	18.01%	12	12
15	苗栗縣頭屋鄉	2018-11-25T01:02:39+08:00	1691	4087	5778	346	6124	9390	65.22%	18.01%	12	12
15	苗栗縣頭屋鄉	2018-11-25T04:03:00+08:00	1691	4087	5778	346	6124	9390	65.22%	18.01%	12	12
15	苗栗縣頭屋鄉	2018-11-25T00:57:45+08:00	1691	4087	5778	346	6124	9390	65.22%	18.01%	12	12
15	苗栗縣頭屋鄉	2018-11-24T22:19:44+08:00	1691	4087	5778	346	6124	9390	65.22%	18.01%	12	12
15	苗栗縣頭屋鄉	2018-11-25T06:14:00+08:00	1691	4087	5778	346	6124	9390	65.22%	18.01%	12	12
15	苗栗縣頭屋鄉	2018-11-24T23:23:46+08:00	1691	4087	5778	346	6124	9390	65.22%	18.01%	12	12
15	苗栗縣頭屋鄉	2018-11-25T03:32:46+08:00	1691	4087	5778	346	6124	9390	65.22%	18.01%	12	12
15	苗栗縣頭屋鄉	2018-11-24T23:55:55+08:00	1691	4087	5778	346	6124	9390	65.22%	18.01%	12	12
15	苗栗縣頭屋鄉	2018-11-25T00:00:19+08:00	1691	4087	5778	346	6124	9390	65.22%	18.01%	12	12
15	苗栗縣頭屋鄉	2018-11-25T00:23:12+08:00	1691	4087	5778	346	6124	9390	65.22%	18.01%	12	12
15	苗栗縣頭屋鄉	2018-11-24T22:23:22+08:00	1691	4087	5778	346	6124	9390	65.22%	18.01%	12	12
15	苗栗縣頭屋鄉	2018-11-24T23:01:39+08:00	1691	4087	5778	346	6124	9390	65.22%	18.01%	12	12
15	苗栗縣頭屋鄉	2018-11-24T23:31:21+08:00	1691	4087	5778	346	6124	9390	65.22%	18.01%	12	12
15	苗栗縣頭屋鄉	2018-11-24T23:20:00+08:00	1691	4087	5778	346	6124	9390	65.22%	18.01%	12	12
15	苗栗縣頭屋鄉	2018-11-25T01:07:34+08:00	1691	4087	5778	346	6124	9390	65.22%	18.01%	12	12
15	苗栗縣頭屋鄉	2018-11-24T23:35:18+08:00	1691	4087	5778	346	6124	9390	65.22%	18.01%	12	12
15	苗栗縣頭屋鄉	2018-11-25T00:14:18+08:00	1691	4087	5778	346	6124	9390	65.22%	18.01%	12	12
15	苗栗縣頭屋鄉	2018-11-24T23:12:25+08:00	1691	4087	5778	346	6124	9390	65.22%	18.01%	12	12
15	苗栗縣頭屋鄉	2018-11-25T03:39:02+08:00	1691	4087	5778	346	6124	9390	65.22%	18.01%	12	12
15	苗栗縣頭屋鄉	2018-11-24T22:33:46+08:00	1691	4087	5778	346	6124	9390	65.22%	18.01%	12	12
15	苗栗縣頭屋鄉	2018-11-25T00:18:41+08:00	1691	4087	5778	346	6124	9390	65.22%	18.01%	12	12
15	苗栗縣頭屋鄉	2018-11-24T22:41:45+08:00	1691	4087	5778	346	6124	9390	65.22%	18.01%	12	12
15	苗栗縣頭屋鄉	2018-11-24T23:43:24+08:00	1691	4087	5778	346	6124	9390	65.22%	18.01%	12	12
15	苗栗縣頭屋鄉	2018-11-25T03:56:22+08:00	1691	4087	5778	346	6124	9390	65.22%	18.01%	12	12
15	苗栗縣頭屋鄉	2018-11-25T06:29:25+08:00	1691	4087	5778	346	6124	9390	65.22%	18.01%	12	12
15	苗栗縣頭屋鄉	2018-11-25T06:19:05+08:00	1691	4087	5778	346	6124	9390	65.22%	18.01%	12	12
15	苗栗縣頭屋鄉	2018-11-24T22:45:16+08:00	1691	4087	5778	346	6124	9390	65.22%	18.01%	12	12
15	苗栗縣頭屋鄉	2018-11-25T01:18:03+08:00	1691	4087	5778	346	6124	9390	65.22%	18.01%	12	12
15	苗栗縣頭屋鄉	2018-11-25T03:49:59+08:00	1691	4087	5778	346	6124	9390	65.22%	18.01%	12	12
15	苗栗縣頭屋鄉	2018-11-24T22:58:03+08:00	1691	4087	5778	346	6124	9390	65.22%	18.01%	12	12
15	苗栗縣頭屋鄉	2018-11-25T06:09:03+08:00	1691	4087	5778	346	6124	9390	65.22%	18.01%	12	12
15	苗栗縣頭屋鄉	2018-11-24T23:51:43+08:00	1691	4087	5778	346	6124	9390	65.22%	18.01%	12	12
15	苗栗縣頭屋鄉	2018-11-25T06:24:08+08:00	1691	4087	5778	346	6124	9390	65.22%	18.01%	12	12
15	苗栗縣頭屋鄉	2018-11-24T22:30:18+08:00	1691	4087	5778	346	6124	9390	65.22%	18.01%	12	12
15	苗栗縣頭屋鄉	2018-11-24T23:27:26+08:00	1691	4087	5778	346	6124	9390	65.22%	18.01%	12	12
15	苗栗縣頭屋鄉	2018-11-24T23:08:45+08:00	1691	4087	5778	346	6124	9390	65.22%	18.01%	12	12
15	苗栗縣頭屋鄉	2018-11-24T22:13:39+08:00	1691	4087	5778	346	6124	9390	65.22%	18.01%	12	12
15	苗栗縣頭屋鄉	2018-11-25T03:44:33+08:00	1691	4087	5778	346	6124	9390	65.22%	18.01%	12	12
15	苗栗縣頭屋鄉	2018-11-24T23:16:10+08:00	1691	4087	5778	346	6124	9390	65.22%	18.01%	12	12
15	苗栗縣頭屋鄉	2018-11-24T23:47:37+08:00	1691	4087	5778	346	6124	9390	65.22%	18.01%	12	12
15	苗栗縣頭屋鄉	2018-11-24T22:16:19+08:00	1691	4087	5778	346	6124	9390	65.22%	18.01%	12	12
15	苗栗縣頭屋鄉	2018-11-24T23:39:26+08:00	1691	4087	5778	346	6124	9390	65.22%	18.01%	12	12
15	苗栗縣頭屋鄉	2018-11-25T01:26:01+08:00	1691	4087	5778	346	6124	9390	65.22%	18.01%	12	12
15	高雄市小港區	2018-11-24T22:58:01+08:00	19844	37963	57807	3201	61008	103701	58.83%	19.14%	71	89
15	高雄市小港區	2018-11-24T22:45:14+08:00	17827	34872	52699	2930	55629	94158	59.08%	18.93%	65	89
15	高雄市小港區	2018-11-25T03:56:20+08:00	25181	48504	73685	4154	77839	132733	58.64%	18.97%	89	89
15	高雄市小港區	2018-11-24T22:26:42+08:00	15299	29784	45083	2598	47681	80033	59.58%	19.12%	56	89
15	高雄市小港區	2018-11-25T01:18:00+08:00	24807	47845	72652	4093	76745	130750	58.7%	18.97%	88	89
15	高雄市小港區	2018-11-24T23:16:09+08:00	21171	40707	61878	3459	65337	111045	58.84%	19.07%	76	89
15	高雄市小港區	2018-11-25T00:18:38+08:00	24117	46537	70654	3954	74608	126706	58.88%	19.03%	86	89
15	高雄市小港區	2018-11-24T22:37:06+08:00	17260	33765	51025	2834	53859	91307	58.99%	18.9%	63	89
15	高雄市小港區	2018-11-25T01:25:59+08:00	24807	47845	72652	4093	76745	130750	58.7%	18.97%	88	89
15	高雄市小港區	2018-11-25T00:57:43+08:00	24488	47226	71714	4040	75754	129106	58.68%	18.97%	87	89
15	高雄市小港區	2018-11-25T01:02:37+08:00	24488	47226	71714	4040	75754	129106	58.68%	18.97%	87	89
15	高雄市小港區	2018-11-24T22:40:33+08:00	17540	34326	51866	2881	54747	92650	59.09%	18.93%	64	89
15	高雄市小港區	2018-11-24T23:51:41+08:00	23800	45793	69593	3858	73451	124849	58.83%	19.06%	85	89
15	高雄市小港區	2018-11-25T06:09:01+08:00	25181	48504	73685	4154	77839	132733	58.64%	18.97%	89	89
15	高雄市小港區	2018-11-24T22:19:43+08:00	14246	27425	41671	2380	44051	73850	59.65%	19.29%	52	89
15	高雄市小港區	2018-11-24T23:55:53+08:00	23800	45793	69593	3858	73451	124849	58.83%	19.06%	85	89
15	高雄市小港區	2018-11-25T03:44:31+08:00	25181	48504	73685	4154	77839	132733	58.64%	18.97%	89	89
15	高雄市小港區	2018-11-25T00:00:17+08:00	23800	45793	69593	3858	73451	124849	58.83%	19.06%	85	89
15	高雄市小港區	2018-11-24T23:19:58+08:00	21822	41806	63628	3513	67141	114137	58.82%	19.12%	78	89
15	高雄市小港區	2018-11-24T23:27:24+08:00	22111	42359	64470	3546	68016	115621	58.83%	19.12%	79	89
15	高雄市小港區	2018-11-24T23:01:37+08:00	20468	38960	59428	3321	62749	106566	58.88%	19.21%	73	89
15	高雄市小港區	2018-11-24T23:12:23+08:00	20628	39611	60239	3364	63603	108079	58.85%	19.09%	74	89
15	高雄市小港區	2018-11-25T04:02:58+08:00	25181	48504	73685	4154	77839	132733	58.64%	18.97%	89	89
15	高雄市小港區	2018-11-25T00:14:16+08:00	24117	46537	70654	3954	74608	126706	58.88%	19.03%	86	89
15	高雄市小港區	2018-11-24T23:35:16+08:00	22403	42880	65283	3571	68854	117054	58.82%	19.14%	80	89
15	高雄市小港區	2018-11-24T23:39:24+08:00	22625	43358	65983	3599	69582	118293	58.82%	19.13%	81	89
15	高雄市小港區	2018-11-24T23:31:18+08:00	22403	42880	65283	3571	68854	117054	58.82%	19.14%	80	89
15	高雄市小港區	2018-11-25T01:07:32+08:00	24488	47226	71714	4040	75754	129106	58.68%	18.97%	87	89
15	高雄市小港區	2018-11-24T23:47:35+08:00	23800	45793	69593	3858	73451	124849	58.83%	19.06%	85	89
15	高雄市小港區	2018-11-24T23:43:23+08:00	23443	45061	68504	3726	72230	122634	58.9%	19.12%	84	89
15	高雄市小港區	2018-11-24T22:41:42+08:00	17540	34326	51866	2881	54747	92650	59.09%	18.93%	64	89
15	高雄市小港區	2018-11-25T01:12:51+08:00	24807	47845	72652	4093	76745	130750	58.7%	18.97%	88	89
15	高雄市小港區	2018-11-25T06:13:58+08:00	25181	48504	73685	4154	77839	132733	58.64%	18.97%	89	89
15	高雄市小港區	2018-11-24T22:54:31+08:00	19223	36723	55946	3092	59038	100454	58.77%	19.14%	69	89
15	高雄市小港區	2018-11-24T22:50:55+08:00	18596	36423	55019	3055	58074	98891	58.73%	18.8%	68	89
15	高雄市小港區	2018-11-25T00:09:41+08:00	23800	45793	69593	3858	73451	124849	58.83%	19.06%	85	89
15	高雄市小港區	2018-11-25T06:29:23+08:00	25181	48504	73685	4154	77839	132733	58.64%	18.97%	89	89
15	高雄市小港區	2018-11-25T03:49:57+08:00	25181	48504	73685	4154	77839	132733	58.64%	18.97%	89	89
15	高雄市小港區	2018-11-24T23:05:10+08:00	20628	39611	60239	3364	63603	108079	58.85%	19.09%	74	89
15	高雄市小港區	2018-11-25T06:19:03+08:00	25181	48504	73685	4154	77839	132733	58.64%	18.97%	89	89
15	高雄市小港區	2018-11-25T00:05:11+08:00	23800	45793	69593	3858	73451	124849	58.83%	19.06%	85	89
15	高雄市小港區	2018-11-25T06:24:06+08:00	25181	48504	73685	4154	77839	132733	58.64%	18.97%	89	89
15	高雄市小港區	2018-11-24T22:30:16+08:00	15299	29784	45083	2598	47681	80033	59.58%	19.12%	56	89
15	高雄市小港區	2018-11-24T22:13:36+08:00	12999	25864	38863	2254	41117	68740	59.82%	18.91%	49	89
15	高雄市小港區	2018-11-24T23:08:43+08:00	20628	39611	60239	3364	63603	108079	58.85%	19.09%	74	89
15	高雄市小港區	2018-11-24T22:23:20+08:00	14809	28526	43335	2511	45846	76933	59.59%	19.25%	54	89
15	高雄市小港區	2018-11-25T00:23:10+08:00	24117	46537	70654	3954	74608	126706	58.88%	19.03%	86	89
15	高雄市小港區	2018-11-25T03:32:43+08:00	25181	48504	73685	4154	77839	132733	58.64%	18.97%	89	89
15	高雄市小港區	2018-11-24T23:23:44+08:00	22111	42359	64470	3546	68016	115621	58.83%	19.12%	79	89
15	高雄市小港區	2018-11-24T22:33:44+08:00	16324	31986	48310	2735	51045	86295	59.15%	18.92%	60	89
15	高雄市小港區	2018-11-24T22:16:17+08:00	12999	25864	38863	2254	41117	68740	59.82%	18.91%	49	89
15	高雄市小港區	2018-11-25T03:39:01+08:00	25181	48504	73685	4154	77839	132733	58.64%	18.97%	89	89
15	高雄市鹽埕區	2018-11-24T23:16:08+08:00	4613	7277	11890	575	12465	21617	57.66%	21.34%	24	24
15	高雄市鹽埕區	2018-11-25T03:56:19+08:00	4613	7277	11890	575	12465	21617	57.66%	21.34%	24	24
15	高雄市鹽埕區	2018-11-24T22:45:14+08:00	4411	6869	11280	544	11824	20487	57.71%	21.53%	23	24
15	高雄市鹽埕區	2018-11-24T22:58:00+08:00	4613	7277	11890	575	12465	21617	57.66%	21.34%	24	24
15	高雄市鹽埕區	2018-11-24T22:26:42+08:00	4411	6869	11280	544	11824	20487	57.71%	21.53%	23	24
15	高雄市鹽埕區	2018-11-25T01:18:00+08:00	4613	7277	11890	575	12465	21617	57.66%	21.34%	24	24
15	高雄市鹽埕區	2018-11-25T00:18:38+08:00	4613	7277	11890	575	12465	21617	57.66%	21.34%	24	24
15	高雄市鹽埕區	2018-11-24T22:37:06+08:00	4411	6869	11280	544	11824	20487	57.71%	21.53%	23	24
15	高雄市鹽埕區	2018-11-25T06:09:00+08:00	4613	7277	11890	575	12465	21617	57.66%	21.34%	24	24
15	高雄市鹽埕區	2018-11-25T01:25:59+08:00	4613	7277	11890	575	12465	21617	57.66%	21.34%	24	24
15	高雄市鹽埕區	2018-11-25T00:57:43+08:00	4613	7277	11890	575	12465	21617	57.66%	21.34%	24	24
15	高雄市鹽埕區	2018-11-24T22:19:42+08:00	4411	6869	11280	544	11824	20487	57.71%	21.53%	23	24
15	高雄市鹽埕區	2018-11-25T01:02:37+08:00	4613	7277	11890	575	12465	21617	57.66%	21.34%	24	24
15	高雄市鹽埕區	2018-11-24T22:40:33+08:00	4411	6869	11280	544	11824	20487	57.71%	21.53%	23	24
15	高雄市鹽埕區	2018-11-24T23:51:41+08:00	4613	7277	11890	575	12465	21617	57.66%	21.34%	24	24
15	高雄市鹽埕區	2018-11-24T22:13:35+08:00	4117	6459	10576	508	11084	19090	58.06%	21.57%	22	24
15	高雄市鹽埕區	2018-11-24T23:55:52+08:00	4613	7277	11890	575	12465	21617	57.66%	21.34%	24	24
15	高雄市鹽埕區	2018-11-25T00:00:17+08:00	4613	7277	11890	575	12465	21617	57.66%	21.34%	24	24
15	高雄市鹽埕區	2018-11-24T23:19:58+08:00	4613	7277	11890	575	12465	21617	57.66%	21.34%	24	24
15	高雄市鹽埕區	2018-11-24T23:27:24+08:00	4613	7277	11890	575	12465	21617	57.66%	21.34%	24	24
15	高雄市鹽埕區	2018-11-25T03:44:30+08:00	4613	7277	11890	575	12465	21617	57.66%	21.34%	24	24
15	高雄市鹽埕區	2018-11-24T23:01:37+08:00	4613	7277	11890	575	12465	21617	57.66%	21.34%	24	24
15	高雄市鹽埕區	2018-11-25T04:02:58+08:00	4613	7277	11890	575	12465	21617	57.66%	21.34%	24	24
15	高雄市鹽埕區	2018-11-25T00:14:16+08:00	4613	7277	11890	575	12465	21617	57.66%	21.34%	24	24
15	高雄市鹽埕區	2018-11-24T23:35:16+08:00	4613	7277	11890	575	12465	21617	57.66%	21.34%	24	24
15	高雄市鹽埕區	2018-11-24T23:12:22+08:00	4613	7277	11890	575	12465	21617	57.66%	21.34%	24	24
15	高雄市鹽埕區	2018-11-24T23:31:18+08:00	4613	7277	11890	575	12465	21617	57.66%	21.34%	24	24
15	高雄市鹽埕區	2018-11-24T23:39:23+08:00	4613	7277	11890	575	12465	21617	57.66%	21.34%	24	24
15	高雄市鹽埕區	2018-11-25T01:07:32+08:00	4613	7277	11890	575	12465	21617	57.66%	21.34%	24	24
15	高雄市鹽埕區	2018-11-24T23:47:35+08:00	4613	7277	11890	575	12465	21617	57.66%	21.34%	24	24
15	高雄市鹽埕區	2018-11-24T22:41:42+08:00	4411	6869	11280	544	11824	20487	57.71%	21.53%	23	24
15	高雄市鹽埕區	2018-11-25T06:13:58+08:00	4613	7277	11890	575	12465	21617	57.66%	21.34%	24	24
15	高雄市鹽埕區	2018-11-24T22:54:31+08:00	4411	6869	11280	544	11824	20487	57.71%	21.53%	23	24
15	高雄市鹽埕區	2018-11-24T22:50:55+08:00	4411	6869	11280	544	11824	20487	57.71%	21.53%	23	24
15	高雄市鹽埕區	2018-11-25T00:09:41+08:00	4613	7277	11890	575	12465	21617	57.66%	21.34%	24	24
15	高雄市鹽埕區	2018-11-25T01:12:50+08:00	4613	7277	11890	575	12465	21617	57.66%	21.34%	24	24
15	高雄市鹽埕區	2018-11-24T23:43:22+08:00	4613	7277	11890	575	12465	21617	57.66%	21.34%	24	24
15	高雄市鹽埕區	2018-11-25T06:29:23+08:00	4613	7277	11890	575	12465	21617	57.66%	21.34%	24	24
15	高雄市鹽埕區	2018-11-25T03:49:57+08:00	4613	7277	11890	575	12465	21617	57.66%	21.34%	24	24
15	高雄市鹽埕區	2018-11-24T23:05:10+08:00	4613	7277	11890	575	12465	21617	57.66%	21.34%	24	24
15	高雄市鹽埕區	2018-11-25T06:19:03+08:00	4613	7277	11890	575	12465	21617	57.66%	21.34%	24	24
15	高雄市鹽埕區	2018-11-25T00:05:11+08:00	4613	7277	11890	575	12465	21617	57.66%	21.34%	24	24
15	高雄市鹽埕區	2018-11-25T06:24:06+08:00	4613	7277	11890	575	12465	21617	57.66%	21.34%	24	24
15	高雄市鹽埕區	2018-11-24T22:30:16+08:00	4411	6869	11280	544	11824	20487	57.71%	21.53%	23	24
15	高雄市鹽埕區	2018-11-24T23:08:43+08:00	4613	7277	11890	575	12465	21617	57.66%	21.34%	24	24
15	高雄市鹽埕區	2018-11-24T22:23:20+08:00	4411	6869	11280	544	11824	20487	57.71%	21.53%	23	24
15	高雄市鹽埕區	2018-11-25T00:23:10+08:00	4613	7277	11890	575	12465	21617	57.66%	21.34%	24	24
15	高雄市鹽埕區	2018-11-25T03:32:43+08:00	4613	7277	11890	575	12465	21617	57.66%	21.34%	24	24
15	高雄市鹽埕區	2018-11-24T23:23:44+08:00	4613	7277	11890	575	12465	21617	57.66%	21.34%	24	24
15	高雄市鹽埕區	2018-11-24T22:33:44+08:00	4411	6869	11280	544	11824	20487	57.71%	21.53%	23	24
15	高雄市鹽埕區	2018-11-24T22:16:17+08:00	4117	6459	10576	508	11084	19090	58.06%	21.57%	22	24
15	高雄市鹽埕區	2018-11-25T03:39:00+08:00	4613	7277	11890	575	12465	21617	57.66%	21.34%	24	24
15	澎湖縣馬公市	2018-11-25T03:56:28+08:00	7572	17018	24590	1571	26161	53655	48.76%	14.11%	50	50
15	澎湖縣馬公市	2018-11-24T22:58:08+08:00	4172	10096	14268	1013	15281	31307	48.81%	13.33%	33	50
15	澎湖縣馬公市	2018-11-24T23:47:43+08:00	5646	13755	19401	1308	20709	42622	48.59%	13.25%	42	50
15	澎湖縣馬公市	2018-11-24T22:58:09+08:00	4172	10096	14268	1013	15281	31307	48.81%	13.33%	33	50
15	澎湖縣馬公市	2018-11-24T23:56:01+08:00	5646	13755	19401	1308	20709	42622	48.59%	13.25%	42	50
15	澎湖縣馬公市	2018-11-24T23:01:46+08:00	4172	10096	14268	1013	15281	31307	48.81%	13.33%	33	50
15	澎湖縣馬公市	2018-11-24T23:12:30+08:00	4563	11108	15671	1080	16751	34338	48.78%	13.29%	35	50
15	澎湖縣馬公市	2018-11-24T23:27:30+08:00	5444	13253	18697	1265	19962	41122	48.54%	13.24%	41	50
15	澎湖縣馬公市	2018-11-25T06:09:09+08:00	7572	17018	24590	1571	26161	53655	48.76%	14.11%	50	50
15	澎湖縣馬公市	2018-11-24T22:13:45+08:00	2649	6265	8914	676	9590	19949	48.07%	13.28%	24	50
15	澎湖縣馬公市	2018-11-25T04:03:06+08:00	7572	17018	24590	1571	26161	53655	48.76%	14.11%	50	50
15	澎湖縣馬公市	2018-11-24T23:51:48+08:00	5646	13755	19401	1308	20709	42622	48.59%	13.25%	42	50
15	澎湖縣馬公市	2018-11-24T22:30:23+08:00	3567	8444	12011	889	12900	26436	48.8%	13.49%	29	50
15	澎湖縣馬公市	2018-11-25T03:32:52+08:00	7572	17018	24590	1571	26161	53655	48.76%	14.11%	50	50
15	澎湖縣馬公市	2018-11-25T03:44:40+08:00	7572	17018	24590	1571	26161	53655	48.76%	14.11%	50	50
15	澎湖縣馬公市	2018-11-25T00:57:51+08:00	7572	17018	24590	1571	26161	53655	48.76%	14.11%	50	50
15	澎湖縣馬公市	2018-11-24T22:19:50+08:00	3073	7356	10429	766	11195	22942	48.8%	13.39%	26	50
15	澎湖縣馬公市	2018-11-24T22:16:25+08:00	2877	6864	9741	708	10449	21430	48.76%	13.43%	25	50
15	澎湖縣馬公市	2018-11-25T00:09:50+08:00	6369	15452	21821	1417	23238	47497	48.93%	13.41%	46	50
15	澎湖縣馬公市	2018-11-25T00:18:47+08:00	7381	16571	23952	1530	25482	52307	48.72%	14.11%	49	50
15	澎湖縣馬公市	2018-11-24T22:37:14+08:00	3958	9543	13501	970	14471	29753	48.64%	13.3%	32	50
15	澎湖縣馬公市	2018-11-24T23:20:08+08:00	4950	12115	17065	1195	18260	37343	48.9%	13.26%	38	50
15	澎湖縣馬公市	2018-11-24T23:31:27+08:00	5646	13755	19401	1308	20709	42622	48.59%	13.25%	42	50
15	澎湖縣馬公市	2018-11-24T22:45:21+08:00	4172	10096	14268	1013	15281	31307	48.81%	13.33%	33	50
15	澎湖縣馬公市	2018-11-25T01:12:58+08:00	7572	17018	24590	1571	26161	53655	48.76%	14.11%	50	50
15	澎湖縣馬公市	2018-11-24T23:39:33+08:00	5646	13755	19401	1308	20709	42622	48.59%	13.25%	42	50
15	澎湖縣馬公市	2018-11-24T23:05:16+08:00	4352	10548	14900	1053	15953	32700	48.79%	13.31%	34	50
15	澎湖縣馬公市	2018-11-24T22:26:49+08:00	3394	8068	11462	842	12304	25221	48.78%	13.46%	28	50
15	澎湖縣馬公市	2018-11-25T01:07:40+08:00	7572	17018	24590	1571	26161	53655	48.76%	14.11%	50	50
15	澎湖縣馬公市	2018-11-24T23:39:32+08:00	5646	13755	19401	1308	20709	42622	48.59%	13.25%	42	50
15	澎湖縣馬公市	2018-11-24T22:54:37+08:00	4172	10096	14268	1013	15281	31307	48.81%	13.33%	33	50
15	澎湖縣馬公市	2018-11-24T22:33:50+08:00	3792	9151	12943	927	13870	28559	48.57%	13.28%	31	50
15	澎湖縣馬公市	2018-11-25T01:12:59+08:00	7572	17018	24590	1571	26161	53655	48.76%	14.11%	50	50
15	澎湖縣馬公市	2018-11-25T00:05:18+08:00	6369	15452	21821	1417	23238	47497	48.93%	13.41%	46	50
15	澎湖縣馬公市	2018-11-24T23:08:51+08:00	4352	10548	14900	1053	15953	32700	48.79%	13.31%	34	50
15	澎湖縣馬公市	2018-11-24T23:23:51+08:00	4950	12115	17065	1195	18260	37343	48.9%	13.26%	38	50
15	澎湖縣馬公市	2018-11-25T00:23:17+08:00	7381	16571	23952	1530	25482	52307	48.72%	14.11%	49	50
15	澎湖縣馬公市	2018-11-25T00:00:24+08:00	5881	14249	20130	1333	21463	44062	48.71%	13.35%	43	50
15	澎湖縣馬公市	2018-11-24T22:51:03+08:00	4172	10096	14268	1013	15281	31307	48.81%	13.33%	33	50
15	澎湖縣馬公市	2018-11-24T22:23:28+08:00	3204	7655	10859	789	11648	23834	48.87%	13.44%	27	50
15	澎湖縣馬公市	2018-11-24T22:40:40+08:00	4172	10096	14268	1013	15281	31307	48.81%	13.33%	33	50
15	澎湖縣馬公市	2018-11-25T06:24:13+08:00	7572	17018	24590	1571	26161	53655	48.76%	14.11%	50	50
15	澎湖縣馬公市	2018-11-25T01:02:44+08:00	7572	17018	24590	1571	26161	53655	48.76%	14.11%	50	50
15	澎湖縣馬公市	2018-11-25T06:14:05+08:00	7572	17018	24590	1571	26161	53655	48.76%	14.11%	50	50
15	澎湖縣馬公市	2018-11-25T06:19:10+08:00	7572	17018	24590	1571	26161	53655	48.76%	14.11%	50	50
15	澎湖縣馬公市	2018-11-25T00:14:23+08:00	7220	16148	23368	1482	24850	51023	48.7%	14.15%	48	50
15	澎湖縣馬公市	2018-11-25T01:18:10+08:00	7572	17018	24590	1571	26161	53655	48.76%	14.11%	50	50
15	澎湖縣馬公市	2018-11-25T03:50:04+08:00	7572	17018	24590	1571	26161	53655	48.76%	14.11%	50	50
15	澎湖縣馬公市	2018-11-25T03:39:07+08:00	7572	17018	24590	1571	26161	53655	48.76%	14.11%	50	50
15	澎湖縣馬公市	2018-11-24T22:41:50+08:00	4172	10096	14268	1013	15281	31307	48.81%	13.33%	33	50
15	澎湖縣馬公市	2018-11-25T06:29:31+08:00	7572	17018	24590	1571	26161	53655	48.76%	14.11%	50	50
15	澎湖縣馬公市	2018-11-24T23:16:16+08:00	4649	11384	16033	1118	17151	35135	48.81%	13.23%	36	50
15	澎湖縣馬公市	2018-11-24T23:35:22+08:00	5646	13755	19401	1308	20709	42622	48.59%	13.25%	42	50
15	澎湖縣馬公市	2018-11-24T23:43:30+08:00	5646	13755	19401	1308	20709	42622	48.59%	13.25%	42	50
15	澎湖縣馬公市	2018-11-25T01:26:08+08:00	7572	17018	24590	1571	26161	53655	48.76%	14.11%	50	50
15	臺東縣鹿野鄉	2018-11-24T23:56:00+08:00	896	1965	2861	259	3120	6936	44.98%	12.92%	10	10
15	臺東縣鹿野鄉	2018-11-24T22:58:08+08:00	896	1965	2861	259	3120	6936	44.98%	12.92%	10	10
15	臺東縣鹿野鄉	2018-11-24T23:47:43+08:00	896	1965	2861	259	3120	6936	44.98%	12.92%	10	10
15	臺東縣鹿野鄉	2018-11-25T01:18:09+08:00	896	1965	2861	259	3120	6936	44.98%	12.92%	10	10
15	臺東縣鹿野鄉	2018-11-25T03:56:27+08:00	896	1965	2861	259	3120	6936	44.98%	12.92%	10	10
15	臺東縣鹿野鄉	2018-11-24T23:12:30+08:00	896	1965	2861	259	3120	6936	44.98%	12.92%	10	10
15	臺東縣鹿野鄉	2018-11-24T23:27:30+08:00	896	1965	2861	259	3120	6936	44.98%	12.92%	10	10
15	臺東縣鹿野鄉	2018-11-25T06:09:09+08:00	896	1965	2861	259	3120	6936	44.98%	12.92%	10	10
15	臺東縣鹿野鄉	2018-11-24T23:51:48+08:00	896	1965	2861	259	3120	6936	44.98%	12.92%	10	10
15	臺東縣鹿野鄉	2018-11-24T22:30:23+08:00	741	1645	2386	221	2607	5832	44.7%	12.71%	9	10
15	臺東縣鹿野鄉	2018-11-25T03:32:52+08:00	896	1965	2861	259	3120	6936	44.98%	12.92%	10	10
15	臺東縣鹿野鄉	2018-11-24T22:13:44+08:00	741	1645	2386	221	2607	5832	44.7%	12.71%	9	10
15	臺東縣鹿野鄉	2018-11-25T03:44:40+08:00	896	1965	2861	259	3120	6936	44.98%	12.92%	10	10
15	臺東縣鹿野鄉	2018-11-25T00:57:51+08:00	896	1965	2861	259	3120	6936	44.98%	12.92%	10	10
15	臺東縣鹿野鄉	2018-11-24T22:16:25+08:00	741	1645	2386	221	2607	5832	44.7%	12.71%	9	10
15	臺東縣鹿野鄉	2018-11-24T23:31:26+08:00	896	1965	2861	259	3120	6936	44.98%	12.92%	10	10
15	臺東縣鹿野鄉	2018-11-25T00:09:50+08:00	896	1965	2861	259	3120	6936	44.98%	12.92%	10	10
15	臺東縣鹿野鄉	2018-11-25T00:18:47+08:00	896	1965	2861	259	3120	6936	44.98%	12.92%	10	10
15	臺東縣鹿野鄉	2018-11-24T23:20:08+08:00	896	1965	2861	259	3120	6936	44.98%	12.92%	10	10
15	臺東縣鹿野鄉	2018-11-24T22:37:13+08:00	896	1965	2861	259	3120	6936	44.98%	12.92%	10	10
15	臺東縣鹿野鄉	2018-11-24T23:16:15+08:00	896	1965	2861	259	3120	6936	44.98%	12.92%	10	10
15	臺東縣鹿野鄉	2018-11-25T01:12:58+08:00	896	1965	2861	259	3120	6936	44.98%	12.92%	10	10
15	臺東縣鹿野鄉	2018-11-25T00:05:17+08:00	896	1965	2861	259	3120	6936	44.98%	12.92%	10	10
15	臺東縣鹿野鄉	2018-11-24T23:05:16+08:00	896	1965	2861	259	3120	6936	44.98%	12.92%	10	10
15	臺東縣鹿野鄉	2018-11-24T23:39:32+08:00	896	1965	2861	259	3120	6936	44.98%	12.92%	10	10
15	臺東縣鹿野鄉	2018-11-24T22:54:37+08:00	896	1965	2861	259	3120	6936	44.98%	12.92%	10	10
15	臺東縣鹿野鄉	2018-11-24T22:33:50+08:00	741	1645	2386	221	2607	5832	44.7%	12.71%	9	10
15	臺東縣鹿野鄉	2018-11-24T22:45:20+08:00	896	1965	2861	259	3120	6936	44.98%	12.92%	10	10
15	臺東縣鹿野鄉	2018-11-24T22:26:48+08:00	741	1645	2386	221	2607	5832	44.7%	12.71%	9	10
15	臺東縣鹿野鄉	2018-11-24T23:01:45+08:00	896	1965	2861	259	3120	6936	44.98%	12.92%	10	10
15	臺東縣鹿野鄉	2018-11-25T04:03:05+08:00	896	1965	2861	259	3120	6936	44.98%	12.92%	10	10
15	臺東縣鹿野鄉	2018-11-24T23:08:51+08:00	896	1965	2861	259	3120	6936	44.98%	12.92%	10	10
15	臺東縣鹿野鄉	2018-11-24T23:23:50+08:00	896	1965	2861	259	3120	6936	44.98%	12.92%	10	10
15	臺東縣鹿野鄉	2018-11-24T22:19:49+08:00	741	1645	2386	221	2607	5832	44.7%	12.71%	9	10
15	臺東縣鹿野鄉	2018-11-25T00:23:17+08:00	896	1965	2861	259	3120	6936	44.98%	12.92%	10	10
15	臺東縣鹿野鄉	2018-11-25T00:00:23+08:00	896	1965	2861	259	3120	6936	44.98%	12.92%	10	10
15	臺東縣鹿野鄉	2018-11-24T22:51:03+08:00	896	1965	2861	259	3120	6936	44.98%	12.92%	10	10
15	臺東縣鹿野鄉	2018-11-24T22:23:28+08:00	741	1645	2386	221	2607	5832	44.7%	12.71%	9	10
15	臺東縣鹿野鄉	2018-11-24T22:40:40+08:00	896	1965	2861	259	3120	6936	44.98%	12.92%	10	10
15	臺東縣鹿野鄉	2018-11-25T06:24:13+08:00	896	1965	2861	259	3120	6936	44.98%	12.92%	10	10
15	臺東縣鹿野鄉	2018-11-25T01:02:44+08:00	896	1965	2861	259	3120	6936	44.98%	12.92%	10	10
15	臺東縣鹿野鄉	2018-11-25T06:14:05+08:00	896	1965	2861	259	3120	6936	44.98%	12.92%	10	10
15	臺東縣鹿野鄉	2018-11-25T06:19:10+08:00	896	1965	2861	259	3120	6936	44.98%	12.92%	10	10
15	臺東縣鹿野鄉	2018-11-25T03:50:03+08:00	896	1965	2861	259	3120	6936	44.98%	12.92%	10	10
15	臺東縣鹿野鄉	2018-11-25T01:07:39+08:00	896	1965	2861	259	3120	6936	44.98%	12.92%	10	10
15	臺東縣鹿野鄉	2018-11-25T01:26:07+08:00	896	1965	2861	259	3120	6936	44.98%	12.92%	10	10
15	臺東縣鹿野鄉	2018-11-25T03:39:07+08:00	896	1965	2861	259	3120	6936	44.98%	12.92%	10	10
15	臺東縣鹿野鄉	2018-11-24T22:41:50+08:00	896	1965	2861	259	3120	6936	44.98%	12.92%	10	10
15	臺東縣鹿野鄉	2018-11-25T00:14:22+08:00	896	1965	2861	259	3120	6936	44.98%	12.92%	10	10
15	臺東縣鹿野鄉	2018-11-25T06:29:31+08:00	896	1965	2861	259	3120	6936	44.98%	12.92%	10	10
15	臺東縣鹿野鄉	2018-11-24T23:35:22+08:00	896	1965	2861	259	3120	6936	44.98%	12.92%	10	10
15	臺東縣鹿野鄉	2018-11-24T23:43:30+08:00	896	1965	2861	259	3120	6936	44.98%	12.92%	10	10
15	臺東縣達仁鄉	2018-11-25T03:56:28+08:00	382	1261	1643	188	1831	3137	58.37%	12.18%	7	7
15	臺東縣達仁鄉	2018-11-24T22:58:08+08:00	262	967	1229	119	1348	2270	59.38%	11.54%	6	7
15	臺東縣達仁鄉	2018-11-24T23:47:43+08:00	382	1261	1643	188	1831	3137	58.37%	12.18%	7	7
15	臺東縣達仁鄉	2018-11-24T23:56:01+08:00	382	1261	1643	188	1831	3137	58.37%	12.18%	7	7
15	臺東縣達仁鄉	2018-11-24T23:01:46+08:00	262	967	1229	119	1348	2270	59.38%	11.54%	6	7
15	臺東縣達仁鄉	2018-11-24T23:12:30+08:00	262	967	1229	119	1348	2270	59.38%	11.54%	6	7
15	臺東縣達仁鄉	2018-11-24T23:27:30+08:00	382	1261	1643	188	1831	3137	58.37%	12.18%	7	7
15	臺東縣達仁鄉	2018-11-25T06:09:09+08:00	382	1261	1643	188	1831	3137	58.37%	12.18%	7	7
15	臺東縣達仁鄉	2018-11-24T22:13:45+08:00	262	967	1229	119	1348	2270	59.38%	11.54%	6	7
15	臺東縣達仁鄉	2018-11-25T04:03:06+08:00	382	1261	1643	188	1831	3137	58.37%	12.18%	7	7
15	臺東縣達仁鄉	2018-11-24T23:51:48+08:00	382	1261	1643	188	1831	3137	58.37%	12.18%	7	7
15	臺東縣達仁鄉	2018-11-24T22:30:23+08:00	262	967	1229	119	1348	2270	59.38%	11.54%	6	7
15	臺東縣達仁鄉	2018-11-25T03:32:52+08:00	382	1261	1643	188	1831	3137	58.37%	12.18%	7	7
15	臺東縣達仁鄉	2018-11-25T03:44:40+08:00	382	1261	1643	188	1831	3137	58.37%	12.18%	7	7
15	臺東縣達仁鄉	2018-11-25T00:57:51+08:00	382	1261	1643	188	1831	3137	58.37%	12.18%	7	7
15	臺東縣達仁鄉	2018-11-24T22:19:50+08:00	262	967	1229	119	1348	2270	59.38%	11.54%	6	7
15	臺東縣達仁鄉	2018-11-24T22:16:25+08:00	262	967	1229	119	1348	2270	59.38%	11.54%	6	7
15	臺東縣達仁鄉	2018-11-25T00:09:50+08:00	382	1261	1643	188	1831	3137	58.37%	12.18%	7	7
15	臺東縣達仁鄉	2018-11-25T00:18:47+08:00	382	1261	1643	188	1831	3137	58.37%	12.18%	7	7
15	臺東縣達仁鄉	2018-11-24T22:37:14+08:00	262	967	1229	119	1348	2270	59.38%	11.54%	6	7
15	臺東縣達仁鄉	2018-11-24T23:20:08+08:00	382	1261	1643	188	1831	3137	58.37%	12.18%	7	7
15	臺東縣達仁鄉	2018-11-24T23:31:27+08:00	382	1261	1643	188	1831	3137	58.37%	12.18%	7	7
15	臺東縣達仁鄉	2018-11-24T22:45:21+08:00	262	967	1229	119	1348	2270	59.38%	11.54%	6	7
15	臺東縣達仁鄉	2018-11-25T01:12:58+08:00	382	1261	1643	188	1831	3137	58.37%	12.18%	7	7
15	臺東縣達仁鄉	2018-11-24T23:05:16+08:00	262	967	1229	119	1348	2270	59.38%	11.54%	6	7
15	臺東縣達仁鄉	2018-11-24T22:26:49+08:00	262	967	1229	119	1348	2270	59.38%	11.54%	6	7
15	臺東縣達仁鄉	2018-11-25T01:07:40+08:00	382	1261	1643	188	1831	3137	58.37%	12.18%	7	7
15	臺東縣達仁鄉	2018-11-24T23:39:32+08:00	382	1261	1643	188	1831	3137	58.37%	12.18%	7	7
15	臺東縣達仁鄉	2018-11-24T22:54:37+08:00	262	967	1229	119	1348	2270	59.38%	11.54%	6	7
15	臺東縣達仁鄉	2018-11-24T22:33:50+08:00	262	967	1229	119	1348	2270	59.38%	11.54%	6	7
15	臺東縣達仁鄉	2018-11-25T00:05:18+08:00	382	1261	1643	188	1831	3137	58.37%	12.18%	7	7
15	臺東縣達仁鄉	2018-11-24T23:08:51+08:00	262	967	1229	119	1348	2270	59.38%	11.54%	6	7
15	臺東縣達仁鄉	2018-11-24T23:23:51+08:00	382	1261	1643	188	1831	3137	58.37%	12.18%	7	7
15	臺東縣達仁鄉	2018-11-25T00:23:17+08:00	382	1261	1643	188	1831	3137	58.37%	12.18%	7	7
15	臺東縣達仁鄉	2018-11-25T00:00:24+08:00	382	1261	1643	188	1831	3137	58.37%	12.18%	7	7
15	臺東縣達仁鄉	2018-11-24T22:51:03+08:00	262	967	1229	119	1348	2270	59.38%	11.54%	6	7
15	臺東縣達仁鄉	2018-11-24T22:23:28+08:00	262	967	1229	119	1348	2270	59.38%	11.54%	6	7
15	臺東縣達仁鄉	2018-11-24T22:40:40+08:00	262	967	1229	119	1348	2270	59.38%	11.54%	6	7
15	臺東縣達仁鄉	2018-11-25T06:24:13+08:00	382	1261	1643	188	1831	3137	58.37%	12.18%	7	7
15	臺東縣達仁鄉	2018-11-25T01:02:44+08:00	382	1261	1643	188	1831	3137	58.37%	12.18%	7	7
15	臺東縣達仁鄉	2018-11-25T06:14:05+08:00	382	1261	1643	188	1831	3137	58.37%	12.18%	7	7
15	臺東縣達仁鄉	2018-11-25T06:19:10+08:00	382	1261	1643	188	1831	3137	58.37%	12.18%	7	7
15	臺東縣達仁鄉	2018-11-25T00:14:23+08:00	382	1261	1643	188	1831	3137	58.37%	12.18%	7	7
15	臺東縣達仁鄉	2018-11-25T01:18:10+08:00	382	1261	1643	188	1831	3137	58.37%	12.18%	7	7
15	臺東縣達仁鄉	2018-11-25T03:50:04+08:00	382	1261	1643	188	1831	3137	58.37%	12.18%	7	7
15	臺東縣達仁鄉	2018-11-25T03:39:07+08:00	382	1261	1643	188	1831	3137	58.37%	12.18%	7	7
15	臺東縣達仁鄉	2018-11-24T22:41:50+08:00	262	967	1229	119	1348	2270	59.38%	11.54%	6	7
15	臺東縣達仁鄉	2018-11-25T06:29:31+08:00	382	1261	1643	188	1831	3137	58.37%	12.18%	7	7
15	臺東縣達仁鄉	2018-11-24T23:16:16+08:00	382	1261	1643	188	1831	3137	58.37%	12.18%	7	7
15	臺東縣達仁鄉	2018-11-24T23:35:22+08:00	382	1261	1643	188	1831	3137	58.37%	12.18%	7	7
15	臺東縣達仁鄉	2018-11-24T23:43:30+08:00	382	1261	1643	188	1831	3137	58.37%	12.18%	7	7
15	臺東縣達仁鄉	2018-11-25T01:26:08+08:00	382	1261	1643	188	1831	3137	58.37%	12.18%	7	7
15	臺中市龍井區	2018-11-25T03:49:55+08:00	10744	23229	33973	2116	36089	63584	56.76%	16.9%	45	45
15	臺中市龍井區	2018-11-25T06:19:01+08:00	10744	23229	33973	2116	36089	63584	56.76%	16.9%	45	45
15	臺中市龍井區	2018-11-24T23:16:07+08:00	10744	23229	33973	2116	36089	63584	56.76%	16.9%	45	45
15	臺中市龍井區	2018-11-25T03:56:18+08:00	10744	23229	33973	2116	36089	63584	56.76%	16.9%	45	45
15	臺中市龍井區	2018-11-24T22:45:12+08:00	8654	19190	27844	1714	29558	52392	56.42%	16.52%	38	45
15	臺中市龍井區	2018-11-24T23:43:21+08:00	10744	23229	33973	2116	36089	63584	56.76%	16.9%	45	45
15	臺中市龍井區	2018-11-24T22:41:40+08:00	8331	18619	26950	1708	28658	50768	56.45%	16.41%	37	45
15	臺中市龍井區	2018-11-25T00:18:36+08:00	10744	23229	33973	2116	36089	63584	56.76%	16.9%	45	45
15	臺中市龍井區	2018-11-24T23:51:40+08:00	10744	23229	33973	2116	36089	63584	56.76%	16.9%	45	45
15	臺中市龍井區	2018-11-24T22:40:32+08:00	8331	18619	26950	1708	28658	50768	56.45%	16.41%	37	45
15	臺中市龍井區	2018-11-25T01:25:57+08:00	10744	23229	33973	2116	36089	63584	56.76%	16.9%	45	45
15	臺中市龍井區	2018-11-24T22:30:14+08:00	8069	18034	26103	1666	27769	49105	56.55%	16.43%	36	45
15	臺中市龍井區	2018-11-25T06:24:04+08:00	10744	23229	33973	2116	36089	63584	56.76%	16.9%	45	45
15	臺中市龍井區	2018-11-25T00:23:08+08:00	10744	23229	33973	2116	36089	63584	56.76%	16.9%	45	45
15	臺中市龍井區	2018-11-25T00:57:42+08:00	10744	23229	33973	2116	36089	63584	56.76%	16.9%	45	45
15	臺中市龍井區	2018-11-24T23:27:22+08:00	10744	23229	33973	2116	36089	63584	56.76%	16.9%	45	45
15	臺中市龍井區	2018-11-24T22:57:59+08:00	10195	22098	32293	1980	34273	60477	56.67%	16.86%	43	45
15	臺中市龍井區	2018-11-25T03:32:41+08:00	10744	23229	33973	2116	36089	63584	56.76%	16.9%	45	45
15	臺中市龍井區	2018-11-24T23:08:41+08:00	10510	22702	33212	2059	35271	62256	56.65%	16.88%	44	45
15	臺中市龍井區	2018-11-24T22:13:33+08:00	6968	15667	22635	1453	24088	42547	56.62%	16.38%	32	45
15	臺中市龍井區	2018-11-24T23:19:56+08:00	10744	23229	33973	2116	36089	63584	56.76%	16.9%	45	45
15	臺中市龍井區	2018-11-25T01:17:58+08:00	10744	23229	33973	2116	36089	63584	56.76%	16.9%	45	45
15	臺中市龍井區	2018-11-24T22:54:29+08:00	10195	22098	32293	1980	34273	60477	56.67%	16.86%	43	45
15	臺中市龍井區	2018-11-24T23:47:33+08:00	10744	23229	33973	2116	36089	63584	56.76%	16.9%	45	45
15	臺中市龍井區	2018-11-25T06:08:58+08:00	10744	23229	33973	2116	36089	63584	56.76%	16.9%	45	45
15	臺中市龍井區	2018-11-24T22:16:15+08:00	7225	16263	23488	1510	24998	44160	56.61%	16.36%	33	45
15	臺中市龍井區	2018-11-24T23:31:16+08:00	10744	23229	33973	2116	36089	63584	56.76%	16.9%	45	45
15	臺中市龍井區	2018-11-25T01:12:48+08:00	10744	23229	33973	2116	36089	63584	56.76%	16.9%	45	45
15	臺中市龍井區	2018-11-24T23:05:08+08:00	10510	22702	33212	2059	35271	62256	56.65%	16.88%	44	45
15	臺中市龍井區	2018-11-25T04:02:57+08:00	10744	23229	33973	2116	36089	63584	56.76%	16.9%	45	45
15	臺中市龍井區	2018-11-25T00:05:09+08:00	10744	23229	33973	2116	36089	63584	56.76%	16.9%	45	45
15	臺中市龍井區	2018-11-25T06:29:22+08:00	10744	23229	33973	2116	36089	63584	56.76%	16.9%	45	45
15	臺中市龍井區	2018-11-25T06:13:57+08:00	10744	23229	33973	2116	36089	63584	56.76%	16.9%	45	45
15	臺中市龍井區	2018-11-24T22:50:53+08:00	9510	20911	30421	1854	32275	57167	56.46%	16.64%	41	45
15	臺中市龍井區	2018-11-24T22:37:05+08:00	8069	18034	26103	1666	27769	49105	56.55%	16.43%	36	45
15	臺中市龍井區	2018-11-24T22:26:41+08:00	8069	18034	26103	1666	27769	49105	56.55%	16.43%	36	45
15	臺中市龍井區	2018-11-24T22:19:41+08:00	7225	16263	23488	1510	24998	44160	56.61%	16.36%	33	45
15	臺中市龍井區	2018-11-25T03:38:59+08:00	10744	23229	33973	2116	36089	63584	56.76%	16.9%	45	45
15	臺中市龍井區	2018-11-25T03:44:29+08:00	10744	23229	33973	2116	36089	63584	56.76%	16.9%	45	45
15	臺中市龍井區	2018-11-25T01:02:35+08:00	10744	23229	33973	2116	36089	63584	56.76%	16.9%	45	45
15	臺中市龍井區	2018-11-24T23:23:42+08:00	10744	23229	33973	2116	36089	63584	56.76%	16.9%	45	45
15	臺中市龍井區	2018-11-24T22:23:18+08:00	7795	17485	25280	1614	26894	47596	56.5%	16.38%	35	45
15	臺中市龍井區	2018-11-25T00:00:15+08:00	10744	23229	33973	2116	36089	63584	56.76%	16.9%	45	45
15	臺中市龍井區	2018-11-24T23:55:51+08:00	10744	23229	33973	2116	36089	63584	56.76%	16.9%	45	45
15	臺中市龍井區	2018-11-24T23:35:15+08:00	10744	23229	33973	2116	36089	63584	56.76%	16.9%	45	45
15	臺中市龍井區	2018-11-24T23:39:21+08:00	10744	23229	33973	2116	36089	63584	56.76%	16.9%	45	45
15	臺中市龍井區	2018-11-24T23:12:20+08:00	10744	23229	33973	2116	36089	63584	56.76%	16.9%	45	45
15	臺中市龍井區	2018-11-25T00:14:14+08:00	10744	23229	33973	2116	36089	63584	56.76%	16.9%	45	45
15	臺中市龍井區	2018-11-24T23:01:35+08:00	10510	22702	33212	2059	35271	62256	56.65%	16.88%	44	45
15	臺中市龍井區	2018-11-25T00:09:39+08:00	10744	23229	33973	2116	36089	63584	56.76%	16.9%	45	45
15	臺中市龍井區	2018-11-25T01:07:31+08:00	10744	23229	33973	2116	36089	63584	56.76%	16.9%	45	45
15	臺中市龍井區	2018-11-24T22:33:42+08:00	8069	18034	26103	1666	27769	49105	56.55%	16.43%	36	45
15	宜蘭縣員山鄉	2018-11-25T03:56:26+08:00	4651	9182	13833	1333	15166	28131	53.91%	16.53%	31	31
15	宜蘭縣員山鄉	2018-11-24T23:05:15+08:00	4251	8336	12587	1206	13793	25693	53.68%	16.55%	29	31
15	宜蘭縣員山鄉	2018-11-25T01:18:08+08:00	4651	9182	13833	1333	15166	28131	53.91%	16.53%	31	31
15	宜蘭縣員山鄉	2018-11-24T23:43:29+08:00	4651	9182	13833	1333	15166	28131	53.91%	16.53%	31	31
15	宜蘭縣員山鄉	2018-11-25T06:19:09+08:00	4651	9182	13833	1333	15166	28131	53.91%	16.53%	31	31
15	宜蘭縣員山鄉	2018-11-24T22:58:07+08:00	3858	7458	11316	1116	12432	23212	53.56%	16.62%	27	31
15	宜蘭縣員山鄉	2018-11-24T22:41:49+08:00	3611	7025	10636	1080	11716	21819	53.7%	16.55%	26	31
15	宜蘭縣員山鄉	2018-11-24T23:39:31+08:00	4651	9182	13833	1333	15166	28131	53.91%	16.53%	31	31
15	宜蘭縣員山鄉	2018-11-24T23:47:42+08:00	4651	9182	13833	1333	15166	28131	53.91%	16.53%	31	31
15	宜蘭縣員山鄉	2018-11-24T22:30:22+08:00	3278	6423	9701	965	10666	20003	53.32%	16.39%	24	31
15	宜蘭縣員山鄉	2018-11-24T23:51:47+08:00	4651	9182	13833	1333	15166	28131	53.91%	16.53%	31	31
15	宜蘭縣員山鄉	2018-11-25T06:09:08+08:00	4651	9182	13833	1333	15166	28131	53.91%	16.53%	31	31
15	宜蘭縣員山鄉	2018-11-24T22:13:43+08:00	3278	6423	9701	965	10666	20003	53.32%	16.39%	24	31
15	宜蘭縣員山鄉	2018-11-25T00:57:50+08:00	4651	9182	13833	1333	15166	28131	53.91%	16.53%	31	31
15	宜蘭縣員山鄉	2018-11-25T03:44:39+08:00	4651	9182	13833	1333	15166	28131	53.91%	16.53%	31	31
15	宜蘭縣員山鄉	2018-11-24T23:23:49+08:00	4251	8336	12587	1206	13793	25693	53.68%	16.55%	29	31
15	宜蘭縣員山鄉	2018-11-24T22:33:49+08:00	3611	7025	10636	1080	11716	21819	53.7%	16.55%	26	31
15	宜蘭縣員山鄉	2018-11-24T22:37:13+08:00	3611	7025	10636	1080	11716	21819	53.7%	16.55%	26	31
15	宜蘭縣員山鄉	2018-11-24T22:16:24+08:00	3278	6423	9701	965	10666	20003	53.32%	16.39%	24	31
15	宜蘭縣員山鄉	2018-11-25T00:18:46+08:00	4651	9182	13833	1333	15166	28131	53.91%	16.53%	31	31
15	宜蘭縣員山鄉	2018-11-24T23:35:21+08:00	4651	9182	13833	1333	15166	28131	53.91%	16.53%	31	31
15	宜蘭縣員山鄉	2018-11-24T23:16:15+08:00	4251	8336	12587	1206	13793	25693	53.68%	16.55%	29	31
15	宜蘭縣員山鄉	2018-11-24T22:45:19+08:00	3611	7025	10636	1080	11716	21819	53.7%	16.55%	26	31
15	宜蘭縣員山鄉	2018-11-24T22:54:36+08:00	3858	7458	11316	1116	12432	23212	53.56%	16.62%	27	31
15	宜蘭縣員山鄉	2018-11-24T23:01:44+08:00	4051	7754	11805	1142	12947	24228	53.44%	16.72%	28	31
15	宜蘭縣員山鄉	2018-11-24T22:26:47+08:00	3278	6423	9701	965	10666	20003	53.32%	16.39%	24	31
15	宜蘭縣員山鄉	2018-11-25T00:05:17+08:00	4651	9182	13833	1333	15166	28131	53.91%	16.53%	31	31
15	宜蘭縣員山鄉	2018-11-25T01:12:57+08:00	4651	9182	13833	1333	15166	28131	53.91%	16.53%	31	31
15	宜蘭縣員山鄉	2018-11-25T00:09:49+08:00	4651	9182	13833	1333	15166	28131	53.91%	16.53%	31	31
15	宜蘭縣員山鄉	2018-11-24T22:19:48+08:00	3278	6423	9701	965	10666	20003	53.32%	16.39%	24	31
15	宜蘭縣員山鄉	2018-11-25T04:03:04+08:00	4651	9182	13833	1333	15166	28131	53.91%	16.53%	31	31
15	宜蘭縣員山鄉	2018-11-24T22:40:39+08:00	3611	7025	10636	1080	11716	21819	53.7%	16.55%	26	31
15	宜蘭縣員山鄉	2018-11-25T03:32:51+08:00	4651	9182	13833	1333	15166	28131	53.91%	16.53%	31	31
15	宜蘭縣員山鄉	2018-11-24T23:08:50+08:00	4251	8336	12587	1206	13793	25693	53.68%	16.55%	29	31
15	宜蘭縣員山鄉	2018-11-24T22:23:27+08:00	3278	6423	9701	965	10666	20003	53.32%	16.39%	24	31
15	宜蘭縣員山鄉	2018-11-24T22:51:02+08:00	3858	7458	11316	1116	12432	23212	53.56%	16.62%	27	31
15	宜蘭縣員山鄉	2018-11-25T06:14:04+08:00	4651	9182	13833	1333	15166	28131	53.91%	16.53%	31	31
15	宜蘭縣員山鄉	2018-11-24T23:55:59+08:00	4651	9182	13833	1333	15166	28131	53.91%	16.53%	31	31
15	宜蘭縣員山鄉	2018-11-25T06:24:12+08:00	4651	9182	13833	1333	15166	28131	53.91%	16.53%	31	31
15	宜蘭縣員山鄉	2018-11-24T23:27:29+08:00	4651	9182	13833	1333	15166	28131	53.91%	16.53%	31	31
15	宜蘭縣員山鄉	2018-11-25T00:00:22+08:00	4651	9182	13833	1333	15166	28131	53.91%	16.53%	31	31
15	宜蘭縣員山鄉	2018-11-25T00:23:16+08:00	4651	9182	13833	1333	15166	28131	53.91%	16.53%	31	31
15	宜蘭縣員山鄉	2018-11-25T01:02:43+08:00	4651	9182	13833	1333	15166	28131	53.91%	16.53%	31	31
15	宜蘭縣員山鄉	2018-11-25T06:29:30+08:00	4651	9182	13833	1333	15166	28131	53.91%	16.53%	31	31
15	宜蘭縣員山鄉	2018-11-24T23:12:29+08:00	4251	8336	12587	1206	13793	25693	53.68%	16.55%	29	31
15	宜蘭縣員山鄉	2018-11-24T23:31:25+08:00	4651	9182	13833	1333	15166	28131	53.91%	16.53%	31	31
15	宜蘭縣員山鄉	2018-11-25T03:50:03+08:00	4651	9182	13833	1333	15166	28131	53.91%	16.53%	31	31
15	宜蘭縣員山鄉	2018-11-24T23:20:04+08:00	4251	8336	12587	1206	13793	25693	53.68%	16.55%	29	31
15	宜蘭縣員山鄉	2018-11-25T00:14:22+08:00	4651	9182	13833	1333	15166	28131	53.91%	16.53%	31	31
15	宜蘭縣員山鄉	2018-11-25T01:07:38+08:00	4651	9182	13833	1333	15166	28131	53.91%	16.53%	31	31
15	宜蘭縣員山鄉	2018-11-25T03:39:06+08:00	4651	9182	13833	1333	15166	28131	53.91%	16.53%	31	31
15	宜蘭縣員山鄉	2018-11-25T01:26:06+08:00	4651	9182	13833	1333	15166	28131	53.91%	16.53%	31	31
15	雲林縣虎尾鎮	2018-11-25T00:05:14+08:00	9239	18982	28221	1689	29910	55805	53.6%	16.56%	44	46
15	雲林縣虎尾鎮	2018-11-25T06:19:06+08:00	9596	19755	29351	1753	31104	58167	53.47%	16.5%	46	46
15	雲林縣虎尾鎮	2018-11-25T00:09:45+08:00	9408	19335	28743	1720	30463	56883	53.55%	16.54%	45	46
15	雲林縣虎尾鎮	2018-11-24T22:41:46+08:00	4572	9683	14255	947	15202	28744	52.89%	15.91%	24	46
15	雲林縣虎尾鎮	2018-11-24T22:37:09+08:00	4572	9683	14255	947	15202	28744	52.89%	15.91%	24	46
15	雲林縣虎尾鎮	2018-11-25T06:29:27+08:00	9596	19755	29351	1753	31104	58167	53.47%	16.5%	46	46
15	雲林縣虎尾鎮	2018-11-24T23:05:13+08:00	5347	11087	16434	1112	17546	33031	53.12%	16.19%	27	46
15	雲林縣虎尾鎮	2018-11-24T23:01:41+08:00	5125	10655	15780	1046	16826	31482	53.45%	16.28%	26	46
15	雲林縣虎尾鎮	2018-11-24T22:26:45+08:00	3967	8233	12200	828	13028	24576	53.01%	16.14%	21	46
15	雲林縣虎尾鎮	2018-11-24T22:54:34+08:00	5125	10655	15780	1046	16826	31482	53.45%	16.28%	26	46
15	雲林縣虎尾鎮	2018-11-25T01:12:54+08:00	9596	19755	29351	1753	31104	58167	53.47%	16.5%	46	46
15	雲林縣虎尾鎮	2018-11-24T23:43:26+08:00	7833	16254	24087	1464	25551	47797	53.46%	16.39%	37	46
15	雲林縣虎尾鎮	2018-11-24T22:50:59+08:00	4900	10183	15083	983	16066	30188	53.22%	16.23%	25	46
15	雲林縣虎尾鎮	2018-11-25T00:00:20+08:00	8489	17357	25846	1559	27405	51218	53.51%	16.57%	40	46
15	雲林縣虎尾鎮	2018-11-25T00:23:13+08:00	9596	19755	29351	1753	31104	58167	53.47%	16.5%	46	46
15	雲林縣虎尾鎮	2018-11-25T03:44:36+08:00	9596	19755	29351	1753	31104	58167	53.47%	16.5%	46	46
15	雲林縣虎尾鎮	2018-11-24T23:08:47+08:00	5636	11705	17341	1138	18479	34521	53.53%	16.33%	28	46
15	雲林縣虎尾鎮	2018-11-24T22:23:24+08:00	3967	8233	12200	828	13028	24576	53.01%	16.14%	21	46
15	雲林縣虎尾鎮	2018-11-25T01:02:40+08:00	9596	19755	29351	1753	31104	58167	53.47%	16.5%	46	46
15	雲林縣虎尾鎮	2018-11-25T06:14:01+08:00	9596	19755	29351	1753	31104	58167	53.47%	16.5%	46	46
15	雲林縣虎尾鎮	2018-11-25T03:32:47+08:00	9596	19755	29351	1753	31104	58167	53.47%	16.5%	46	46
15	雲林縣虎尾鎮	2018-11-24T23:23:47+08:00	6581	13647	20228	1306	21534	40110	53.69%	16.41%	32	46
15	雲林縣虎尾鎮	2018-11-25T03:50:00+08:00	9596	19755	29351	1753	31104	58167	53.47%	16.5%	46	46
15	雲林縣虎尾鎮	2018-11-24T22:33:47+08:00	4401	9224	13625	914	14539	27461	52.94%	16.03%	23	46
15	雲林縣虎尾鎮	2018-11-25T03:39:03+08:00	9596	19755	29351	1753	31104	58167	53.47%	16.5%	46	46
15	雲林縣虎尾鎮	2018-11-25T01:26:02+08:00	9596	19755	29351	1753	31104	58167	53.47%	16.5%	46	46
15	雲林縣虎尾鎮	2018-11-25T00:14:19+08:00	9408	19335	28743	1720	30463	56883	53.55%	16.54%	45	46
15	雲林縣虎尾鎮	2018-11-24T23:16:12+08:00	5876	12164	18040	1195	19235	35941	53.52%	16.35%	29	46
15	雲林縣虎尾鎮	2018-11-24T23:35:19+08:00	7340	15208	22548	1407	23955	44812	53.46%	16.38%	35	46
15	雲林縣虎尾鎮	2018-11-24T22:45:17+08:00	4572	9683	14255	947	15202	28744	52.89%	15.91%	24	46
15	雲林縣虎尾鎮	2018-11-25T01:18:05+08:00	9596	19755	29351	1753	31104	58167	53.47%	16.5%	46	46
15	雲林縣虎尾鎮	2018-11-25T03:56:23+08:00	9596	19755	29351	1753	31104	58167	53.47%	16.5%	46	46
15	雲林縣虎尾鎮	2018-11-24T22:58:04+08:00	5125	10655	15780	1046	16826	31482	53.45%	16.28%	26	46
15	雲林縣虎尾鎮	2018-11-25T00:57:47+08:00	9596	19755	29351	1753	31104	58167	53.47%	16.5%	46	46
15	雲林縣虎尾鎮	2018-11-24T22:19:46+08:00	3476	7132	10608	765	11373	21784	52.21%	15.96%	19	46
15	雲林縣虎尾鎮	2018-11-25T06:24:09+08:00	9596	19755	29351	1753	31104	58167	53.47%	16.5%	46	46
15	雲林縣虎尾鎮	2018-11-25T04:03:02+08:00	9596	19755	29351	1753	31104	58167	53.47%	16.5%	46	46
15	雲林縣虎尾鎮	2018-11-24T22:30:19+08:00	3967	8233	12200	828	13028	24576	53.01%	16.14%	21	46
15	雲林縣虎尾鎮	2018-11-24T22:13:40+08:00	3088	6279	9367	667	10034	18962	52.92%	16.29%	17	46
15	雲林縣虎尾鎮	2018-11-24T22:40:37+08:00	4572	9683	14255	947	15202	28744	52.89%	15.91%	24	46
15	雲林縣虎尾鎮	2018-11-24T23:51:45+08:00	8359	17080	25439	1528	26967	50328	53.58%	16.61%	39	46
15	雲林縣虎尾鎮	2018-11-25T06:09:05+08:00	9596	19755	29351	1753	31104	58167	53.47%	16.5%	46	46
15	雲林縣虎尾鎮	2018-11-24T23:27:27+08:00	6851	14172	21023	1350	22373	41523	53.88%	16.5%	33	46
15	雲林縣虎尾鎮	2018-11-24T23:55:56+08:00	8359	17080	25439	1528	26967	50328	53.58%	16.61%	39	46
15	雲林縣虎尾鎮	2018-11-24T23:47:39+08:00	8178	16699	24877	1501	26378	49104	53.72%	16.65%	38	46
15	雲林縣虎尾鎮	2018-11-24T23:31:22+08:00	7340	15208	22548	1407	23955	44812	53.46%	16.38%	35	46
15	雲林縣虎尾鎮	2018-11-24T22:16:21+08:00	3271	6681	9952	712	10664	20275	52.6%	16.13%	18	46
15	雲林縣虎尾鎮	2018-11-25T00:18:42+08:00	9596	19755	29351	1753	31104	58167	53.47%	16.5%	46	46
15	雲林縣虎尾鎮	2018-11-24T23:12:26+08:00	5636	11705	17341	1138	18479	34521	53.53%	16.33%	28	46
15	雲林縣虎尾鎮	2018-11-24T23:39:27+08:00	7833	16254	24087	1464	25551	47797	53.46%	16.39%	37	46
15	雲林縣虎尾鎮	2018-11-24T23:20:02+08:00	6107	12695	18802	1248	20050	37445	53.55%	16.31%	30	46
15	雲林縣虎尾鎮	2018-11-25T01:07:36+08:00	9596	19755	29351	1753	31104	58167	53.47%	16.5%	46	46
15	雲林縣麥寮鄉	2018-11-25T00:05:14+08:00	4927	11731	16658	1443	18101	37119	48.76%	13.27%	28	28
15	雲林縣麥寮鄉	2018-11-25T00:09:45+08:00	4927	11731	16658	1443	18101	37119	48.76%	13.27%	28	28
15	雲林縣麥寮鄉	2018-11-25T01:12:55+08:00	4927	11731	16658	1443	18101	37119	48.76%	13.27%	28	28
15	雲林縣麥寮鄉	2018-11-24T22:41:46+08:00	4282	10281	14563	1263	15826	32771	48.29%	13.07%	25	28
15	雲林縣麥寮鄉	2018-11-25T06:29:27+08:00	4927	11731	16658	1443	18101	37119	48.76%	13.27%	28	28
15	雲林縣麥寮鄉	2018-11-24T23:05:13+08:00	4711	11237	15948	1349	17297	35648	48.52%	13.22%	27	28
15	雲林縣麥寮鄉	2018-11-25T06:19:07+08:00	4927	11731	16658	1443	18101	37119	48.76%	13.27%	28	28
15	雲林縣麥寮鄉	2018-11-24T22:26:45+08:00	4102	9905	14007	1208	15215	31431	48.41%	13.05%	24	28
15	雲林縣麥寮鄉	2018-11-24T22:54:34+08:00	4711	11237	15948	1349	17297	35648	48.52%	13.22%	27	28
15	雲林縣麥寮鄉	2018-11-24T23:43:26+08:00	4927	11731	16658	1443	18101	37119	48.76%	13.27%	28	28
15	雲林縣麥寮鄉	2018-11-24T22:50:59+08:00	4437	10604	15041	1299	16340	33727	48.45%	13.16%	26	28
15	雲林縣麥寮鄉	2018-11-25T00:00:20+08:00	4927	11731	16658	1443	18101	37119	48.76%	13.27%	28	28
15	雲林縣麥寮鄉	2018-11-25T00:23:13+08:00	4927	11731	16658	1443	18101	37119	48.76%	13.27%	28	28
15	雲林縣麥寮鄉	2018-11-25T03:32:48+08:00	4927	11731	16658	1443	18101	37119	48.76%	13.27%	28	28
15	雲林縣麥寮鄉	2018-11-25T03:44:36+08:00	4927	11731	16658	1443	18101	37119	48.76%	13.27%	28	28
15	雲林縣麥寮鄉	2018-11-24T23:08:47+08:00	4711	11237	15948	1349	17297	35648	48.52%	13.22%	27	28
15	雲林縣麥寮鄉	2018-11-24T22:23:24+08:00	4102	9905	14007	1208	15215	31431	48.41%	13.05%	24	28
15	雲林縣麥寮鄉	2018-11-25T06:24:10+08:00	4927	11731	16658	1443	18101	37119	48.76%	13.27%	28	28
15	雲林縣麥寮鄉	2018-11-25T01:02:40+08:00	4927	11731	16658	1443	18101	37119	48.76%	13.27%	28	28
15	雲林縣麥寮鄉	2018-11-24T23:23:47+08:00	4927	11731	16658	1443	18101	37119	48.76%	13.27%	28	28
15	雲林縣麥寮鄉	2018-11-25T03:50:00+08:00	4927	11731	16658	1443	18101	37119	48.76%	13.27%	28	28
15	雲林縣麥寮鄉	2018-11-24T22:33:47+08:00	4102	9905	14007	1208	15215	31431	48.41%	13.05%	24	28
15	雲林縣麥寮鄉	2018-11-25T01:26:03+08:00	4927	11731	16658	1443	18101	37119	48.76%	13.27%	28	28
15	雲林縣麥寮鄉	2018-11-25T03:39:04+08:00	4927	11731	16658	1443	18101	37119	48.76%	13.27%	28	28
15	雲林縣麥寮鄉	2018-11-25T00:14:19+08:00	4927	11731	16658	1443	18101	37119	48.76%	13.27%	28	28
15	雲林縣麥寮鄉	2018-11-24T23:16:12+08:00	4711	11237	15948	1349	17297	35648	48.52%	13.22%	27	28
15	雲林縣麥寮鄉	2018-11-24T23:35:19+08:00	4927	11731	16658	1443	18101	37119	48.76%	13.27%	28	28
15	雲林縣麥寮鄉	2018-11-24T22:45:17+08:00	4282	10281	14563	1263	15826	32771	48.29%	13.07%	25	28
15	雲林縣麥寮鄉	2018-11-25T01:18:05+08:00	4927	11731	16658	1443	18101	37119	48.76%	13.27%	28	28
15	雲林縣麥寮鄉	2018-11-25T03:56:24+08:00	4927	11731	16658	1443	18101	37119	48.76%	13.27%	28	28
15	雲林縣麥寮鄉	2018-11-24T22:58:04+08:00	4711	11237	15948	1349	17297	35648	48.52%	13.22%	27	28
15	雲林縣麥寮鄉	2018-11-24T23:01:42+08:00	4711	11237	15948	1349	17297	35648	48.52%	13.22%	27	28
15	雲林縣麥寮鄉	2018-11-25T00:57:47+08:00	4927	11731	16658	1443	18101	37119	48.76%	13.27%	28	28
15	雲林縣麥寮鄉	2018-11-24T22:19:46+08:00	4102	9905	14007	1208	15215	31431	48.41%	13.05%	24	28
15	雲林縣麥寮鄉	2018-11-24T22:13:41+08:00	4102	9905	14007	1208	15215	31431	48.41%	13.05%	24	28
15	雲林縣麥寮鄉	2018-11-25T04:03:02+08:00	4927	11731	16658	1443	18101	37119	48.76%	13.27%	28	28
15	雲林縣麥寮鄉	2018-11-24T22:40:37+08:00	4282	10281	14563	1263	15826	32771	48.29%	13.07%	25	28
15	雲林縣麥寮鄉	2018-11-24T23:51:45+08:00	4927	11731	16658	1443	18101	37119	48.76%	13.27%	28	28
15	雲林縣麥寮鄉	2018-11-24T22:30:20+08:00	4102	9905	14007	1208	15215	31431	48.41%	13.05%	24	28
15	雲林縣麥寮鄉	2018-11-25T06:09:05+08:00	4927	11731	16658	1443	18101	37119	48.76%	13.27%	28	28
15	雲林縣麥寮鄉	2018-11-24T23:55:57+08:00	4927	11731	16658	1443	18101	37119	48.76%	13.27%	28	28
15	雲林縣麥寮鄉	2018-11-24T23:27:27+08:00	4927	11731	16658	1443	18101	37119	48.76%	13.27%	28	28
15	雲林縣麥寮鄉	2018-11-25T06:14:02+08:00	4927	11731	16658	1443	18101	37119	48.76%	13.27%	28	28
15	雲林縣麥寮鄉	2018-11-24T23:47:39+08:00	4927	11731	16658	1443	18101	37119	48.76%	13.27%	28	28
15	雲林縣麥寮鄉	2018-11-25T00:18:43+08:00	4927	11731	16658	1443	18101	37119	48.76%	13.27%	28	28
15	雲林縣麥寮鄉	2018-11-24T22:16:21+08:00	4102	9905	14007	1208	15215	31431	48.41%	13.05%	24	28
15	雲林縣麥寮鄉	2018-11-24T23:12:27+08:00	4711	11237	15948	1349	17297	35648	48.52%	13.22%	27	28
15	雲林縣麥寮鄉	2018-11-24T23:39:28+08:00	4927	11731	16658	1443	18101	37119	48.76%	13.27%	28	28
15	雲林縣麥寮鄉	2018-11-24T22:37:10+08:00	4102	9905	14007	1208	15215	31431	48.41%	13.05%	24	28
15	雲林縣麥寮鄉	2018-11-24T23:31:23+08:00	4927	11731	16658	1443	18101	37119	48.76%	13.27%	28	28
15	雲林縣麥寮鄉	2018-11-24T23:20:02+08:00	4711	11237	15948	1349	17297	35648	48.52%	13.22%	27	28
15	雲林縣麥寮鄉	2018-11-25T01:07:36+08:00	4927	11731	16658	1443	18101	37119	48.76%	13.27%	28	28
15	基隆市信義區	2018-11-24T23:01:47+08:00	5903	11323	17226	760	17986	34025	52.86%	17.35%	28	36
15	基隆市信義區	2018-11-24T23:47:44+08:00	7073	13544	20617	914	21531	40984	52.54%	17.26%	33	36
15	基隆市信義區	2018-11-24T22:58:09+08:00	5714	10899	16613	708	17321	32892	52.66%	17.37%	27	36
15	基隆市信義區	2018-11-25T03:56:29+08:00	7869	15251	23120	1012	24132	46014	52.44%	17.1%	36	36
15	基隆市信義區	2018-11-25T03:32:53+08:00	7869	15251	23120	1012	24132	46014	52.44%	17.1%	36	36
15	基隆市信義區	2018-11-24T23:08:52+08:00	6374	12217	18591	803	19394	36973	52.45%	17.24%	30	36
15	基隆市信義區	2018-11-24T23:51:49+08:00	7073	13544	20617	914	21531	40984	52.54%	17.26%	33	36
15	基隆市信義區	2018-11-25T03:44:41+08:00	7869	15251	23120	1012	24132	46014	52.44%	17.1%	36	36
15	基隆市信義區	2018-11-24T23:27:31+08:00	7073	13544	20617	914	21531	40984	52.54%	17.26%	33	36
15	基隆市信義區	2018-11-24T22:30:24+08:00	4465	8427	12892	542	13434	25167	53.38%	17.74%	21	36
15	基隆市信義區	2018-11-25T04:03:07+08:00	7869	15251	23120	1012	24132	46014	52.44%	17.1%	36	36
15	基隆市信義區	2018-11-24T22:19:51+08:00	4296	8095	12391	520	12911	24168	53.42%	17.78%	20	36
15	基隆市信義區	2018-11-25T06:14:06+08:00	7869	15251	23120	1012	24132	46014	52.44%	17.1%	36	36
15	基隆市信義區	2018-11-24T23:20:09+08:00	6833	13078	19911	870	20781	39429	52.7%	17.33%	32	36
15	基隆市信義區	2018-11-24T23:31:28+08:00	7073	13544	20617	914	21531	40984	52.54%	17.26%	33	36
15	基隆市信義區	2018-11-24T22:37:15+08:00	4465	8427	12892	542	13434	25167	53.38%	17.74%	21	36
15	基隆市信義區	2018-11-25T00:18:48+08:00	7869	15251	23120	1012	24132	46014	52.44%	17.1%	36	36
15	基隆市信義區	2018-11-25T06:29:32+08:00	7869	15251	23120	1012	24132	46014	52.44%	17.1%	36	36
15	基隆市信義區	2018-11-24T22:45:21+08:00	4659	8760	13419	565	13984	26096	53.59%	17.85%	22	36
15	基隆市信義區	2018-11-24T22:54:38+08:00	5452	10332	15784	665	16449	30876	53.27%	17.66%	26	36
15	基隆市信義區	2018-11-24T23:12:32+08:00	6833	13078	19911	870	20781	39429	52.7%	17.33%	32	36
15	基隆市信義區	2018-11-24T22:33:51+08:00	4465	8427	12892	542	13434	25167	53.38%	17.74%	21	36
15	基隆市信義區	2018-11-24T23:39:34+08:00	7073	13544	20617	914	21531	40984	52.54%	17.26%	33	36
15	基隆市信義區	2018-11-25T00:05:19+08:00	7335	14076	21411	954	22365	42553	52.56%	17.24%	34	36
15	基隆市信義區	2018-11-24T22:26:49+08:00	4296	8095	12391	520	12911	24168	53.42%	17.78%	20	36
15	基隆市信義區	2018-11-25T01:07:41+08:00	7869	15251	23120	1012	24132	46014	52.44%	17.1%	36	36
15	基隆市信義區	2018-11-24T23:05:17+08:00	6147	11717	17864	780	18644	35209	52.95%	17.46%	29	36
15	基隆市信義區	2018-11-24T23:56:02+08:00	7073	13544	20617	914	21531	40984	52.54%	17.26%	33	36
15	基隆市信義區	2018-11-24T22:13:46+08:00	3669	6934	10603	440	11043	20541	53.76%	17.86%	17	36
15	基隆市信義區	2018-11-24T23:23:51+08:00	6833	13078	19911	870	20781	39429	52.7%	17.33%	32	36
15	基隆市信義區	2018-11-24T22:23:29+08:00	4296	8095	12391	520	12911	24168	53.42%	17.78%	20	36
15	基隆市信義區	2018-11-25T01:02:45+08:00	7869	15251	23120	1012	24132	46014	52.44%	17.1%	36	36
15	基隆市信義區	2018-11-24T22:40:41+08:00	4465	8427	12892	542	13434	25167	53.38%	17.74%	21	36
15	基隆市信義區	2018-11-25T00:57:52+08:00	7869	15251	23120	1012	24132	46014	52.44%	17.1%	36	36
15	基隆市信義區	2018-11-24T22:51:04+08:00	5106	9532	14638	604	15242	28382	53.7%	17.99%	24	36
15	基隆市信義區	2018-11-25T06:09:10+08:00	7869	15251	23120	1012	24132	46014	52.44%	17.1%	36	36
15	基隆市信義區	2018-11-25T01:13:00+08:00	7869	15251	23120	1012	24132	46014	52.44%	17.1%	36	36
15	基隆市信義區	2018-11-25T06:24:14+08:00	7869	15251	23120	1012	24132	46014	52.44%	17.1%	36	36
15	基隆市信義區	2018-11-25T00:23:18+08:00	7869	15251	23120	1012	24132	46014	52.44%	17.1%	36	36
15	基隆市信義區	2018-11-25T00:00:25+08:00	7335	14076	21411	954	22365	42553	52.56%	17.24%	34	36
15	基隆市信義區	2018-11-24T23:35:23+08:00	7073	13544	20617	914	21531	40984	52.54%	17.26%	33	36
15	基隆市信義區	2018-11-25T00:14:24+08:00	7548	14655	22203	975	23178	44029	52.64%	17.14%	35	36
15	基隆市信義區	2018-11-25T01:26:09+08:00	7869	15251	23120	1012	24132	46014	52.44%	17.1%	36	36
15	基隆市信義區	2018-11-25T03:50:04+08:00	7869	15251	23120	1012	24132	46014	52.44%	17.1%	36	36
15	基隆市信義區	2018-11-24T22:16:26+08:00	4015	7657	11672	488	12160	22829	53.27%	17.59%	19	36
15	基隆市信義區	2018-11-24T23:43:31+08:00	7073	13544	20617	914	21531	40984	52.54%	17.26%	33	36
15	基隆市信義區	2018-11-25T01:18:11+08:00	7869	15251	23120	1012	24132	46014	52.44%	17.1%	36	36
15	基隆市信義區	2018-11-24T23:16:16+08:00	6833	13078	19911	870	20781	39429	52.7%	17.33%	32	36
15	基隆市信義區	2018-11-25T00:09:52+08:00	7548	14655	22203	975	23178	44029	52.64%	17.14%	35	36
15	基隆市信義區	2018-11-25T06:19:11+08:00	7869	15251	23120	1012	24132	46014	52.44%	17.1%	36	36
15	基隆市信義區	2018-11-24T22:41:51+08:00	4465	8427	12892	542	13434	25167	53.38%	17.74%	21	36
15	基隆市信義區	2018-11-25T03:39:08+08:00	7869	15251	23120	1012	24132	46014	52.44%	17.1%	36	36
15	高雄市苓雅區	2018-11-24T22:58:01+08:00	22254	42051	64305	2984	67289	109731	61.32%	20.28%	91	116
15	高雄市苓雅區	2018-11-24T22:45:14+08:00	20944	39659	60603	2823	63426	103411	61.33%	20.25%	86	116
15	高雄市苓雅區	2018-11-25T03:56:20+08:00	29700	55824	85524	4183	89707	146786	61.11%	20.23%	116	116
15	高雄市苓雅區	2018-11-24T22:26:42+08:00	19473	36712	56185	2612	58797	95911	61.3%	20.3%	80	116
15	高雄市苓雅區	2018-11-25T01:18:00+08:00	28872	54315	83187	4089	87276	143020	61.02%	20.19%	114	116
15	高雄市苓雅區	2018-11-24T23:16:09+08:00	24079	45545	69624	3253	72877	119338	61.07%	20.18%	97	116
15	高雄市苓雅區	2018-11-25T00:18:38+08:00	28021	52696	80717	3952	84669	138626	61.08%	20.21%	111	116
15	高雄市苓雅區	2018-11-24T22:37:06+08:00	20681	39251	59932	2785	62717	102127	61.41%	20.25%	85	116
15	高雄市苓雅區	2018-11-25T06:09:00+08:00	29700	55824	85524	4183	89707	146786	61.11%	20.23%	116	116
15	高雄市苓雅區	2018-11-25T01:25:59+08:00	28872	54315	83187	4089	87276	143020	61.02%	20.19%	114	116
15	高雄市苓雅區	2018-11-25T00:57:43+08:00	28872	54315	83187	4089	87276	143020	61.02%	20.19%	114	116
15	高雄市苓雅區	2018-11-25T01:02:37+08:00	28872	54315	83187	4089	87276	143020	61.02%	20.19%	114	116
15	高雄市苓雅區	2018-11-24T22:40:33+08:00	20944	39659	60603	2823	63426	103411	61.33%	20.25%	86	116
15	高雄市苓雅區	2018-11-24T23:51:41+08:00	26428	49677	76105	3613	79718	130470	61.1%	20.26%	105	116
15	高雄市苓雅區	2018-11-24T22:19:43+08:00	18011	33869	51880	2409	54289	88676	61.22%	20.31%	75	116
15	高雄市苓雅區	2018-11-24T23:55:53+08:00	26624	50097	76721	3678	80399	131572	61.11%	20.24%	106	116
15	高雄市苓雅區	2018-11-25T00:00:17+08:00	26947	50646	77593	3721	81314	133068	61.11%	20.25%	107	116
15	高雄市苓雅區	2018-11-24T23:19:58+08:00	24300	46013	70313	3284	73597	120656	61%	20.14%	98	116
15	高雄市苓雅區	2018-11-24T23:27:24+08:00	24630	46712	71342	3334	74676	122374	61.02%	20.13%	99	116
15	高雄市苓雅區	2018-11-25T03:44:30+08:00	29700	55824	85524	4183	89707	146786	61.11%	20.23%	116	116
15	高雄市苓雅區	2018-11-24T23:01:37+08:00	22829	43091	65920	3062	68982	112411	61.37%	20.31%	93	116
15	高雄市苓雅區	2018-11-24T23:12:23+08:00	23702	44842	68544	3213	71757	117293	61.18%	20.21%	96	116
15	高雄市苓雅區	2018-11-25T04:02:58+08:00	29700	55824	85524	4183	89707	146786	61.11%	20.23%	116	116
15	高雄市苓雅區	2018-11-25T00:14:16+08:00	27659	52071	79730	3893	83623	136822	61.12%	20.22%	110	116
15	高雄市苓雅區	2018-11-24T23:35:16+08:00	25174	47763	72937	3410	76347	124991	61.08%	20.14%	101	116
15	高雄市苓雅區	2018-11-24T23:31:18+08:00	25174	47763	72937	3410	76347	124991	61.08%	20.14%	101	116
15	高雄市苓雅區	2018-11-24T23:39:23+08:00	25860	48758	74618	3489	78107	127774	61.13%	20.24%	103	116
15	高雄市苓雅區	2018-11-25T01:07:32+08:00	28872	54315	83187	4089	87276	143020	61.02%	20.19%	114	116
15	高雄市苓雅區	2018-11-24T23:47:35+08:00	26428	49677	76105	3613	79718	130470	61.1%	20.26%	105	116
15	高雄市苓雅區	2018-11-24T23:43:23+08:00	26428	49677	76105	3613	79718	130470	61.1%	20.26%	105	116
15	高雄市苓雅區	2018-11-24T22:41:42+08:00	20944	39659	60603	2823	63426	103411	61.33%	20.25%	86	116
15	高雄市苓雅區	2018-11-25T01:12:51+08:00	28872	54315	83187	4089	87276	143020	61.02%	20.19%	114	116
15	高雄市苓雅區	2018-11-25T06:13:58+08:00	29700	55824	85524	4183	89707	146786	61.11%	20.23%	116	116
15	高雄市苓雅區	2018-11-24T22:54:31+08:00	21951	41454	63405	2957	66362	108300	61.28%	20.27%	90	116
15	高雄市苓雅區	2018-11-24T22:50:55+08:00	21755	41122	62877	2911	65788	107450	61.23%	20.25%	89	116
15	高雄市苓雅區	2018-11-25T00:09:41+08:00	27659	52071	79730	3893	83623	136822	61.12%	20.22%	110	116
15	高雄市苓雅區	2018-11-25T06:29:23+08:00	29700	55824	85524	4183	89707	146786	61.11%	20.23%	116	116
15	高雄市苓雅區	2018-11-25T03:49:57+08:00	29700	55824	85524	4183	89707	146786	61.11%	20.23%	116	116
15	高雄市苓雅區	2018-11-24T23:05:10+08:00	23437	44362	67799	3178	70977	115849	61.27%	20.23%	95	116
15	高雄市苓雅區	2018-11-25T06:19:03+08:00	29700	55824	85524	4183	89707	146786	61.11%	20.23%	116	116
15	高雄市苓雅區	2018-11-25T00:05:11+08:00	27659	52071	79730	3893	83623	136822	61.12%	20.22%	110	116
15	高雄市苓雅區	2018-11-25T06:24:06+08:00	29700	55824	85524	4183	89707	146786	61.11%	20.23%	116	116
15	高雄市苓雅區	2018-11-24T22:30:16+08:00	19905	37697	57602	2650	60252	98231	61.34%	20.26%	82	116
15	高雄市苓雅區	2018-11-24T22:13:36+08:00	17139	32306	49445	2298	51743	84506	61.23%	20.28%	72	116
15	高雄市苓雅區	2018-11-24T23:08:43+08:00	23437	44362	67799	3178	70977	115849	61.27%	20.23%	95	116
15	高雄市苓雅區	2018-11-24T22:23:20+08:00	18884	35551	54435	2520	56955	93074	61.19%	20.29%	78	116
15	高雄市苓雅區	2018-11-25T00:23:10+08:00	28257	53118	81375	3992	85367	139898	61.02%	20.2%	112	116
15	高雄市苓雅區	2018-11-25T03:32:43+08:00	29700	55824	85524	4183	89707	146786	61.11%	20.23%	116	116
15	高雄市苓雅區	2018-11-24T23:23:44+08:00	24630	46712	71342	3334	74676	122374	61.02%	20.13%	99	116
15	高雄市苓雅區	2018-11-24T22:33:44+08:00	20147	38226	58373	2692	61065	99467	61.39%	20.25%	83	116
15	高雄市苓雅區	2018-11-24T22:16:17+08:00	17376	32727	50103	2317	52420	85627	61.22%	20.29%	73	116
15	高雄市苓雅區	2018-11-25T03:39:00+08:00	29700	55824	85524	4183	89707	146786	61.11%	20.23%	116	116
15	高雄市鳥松區	2018-11-25T01:18:01+08:00	7877	14661	22538	1305	23843	39191	60.84%	20.1%	28	28
15	高雄市鳥松區	2018-11-24T22:58:01+08:00	5613	10266	15879	926	16805	27752	60.55%	20.23%	21	28
15	高雄市鳥松區	2018-11-25T00:09:42+08:00	7393	13531	20924	1193	22117	36383	60.79%	20.32%	26	28
15	高雄市鳥松區	2018-11-24T22:37:07+08:00	4724	8597	13321	785	14106	23118	61.02%	20.43%	18	28
15	高雄市鳥松區	2018-11-25T00:18:39+08:00	7877	14661	22538	1305	23843	39191	60.84%	20.1%	28	28
15	高雄市鳥松區	2018-11-24T22:45:14+08:00	5268	9668	14936	891	15827	26118	60.6%	20.17%	20	28
15	高雄市鳥松區	2018-11-25T03:56:20+08:00	7877	14661	22538	1305	23843	39191	60.84%	20.1%	28	28
15	高雄市鳥松區	2018-11-24T22:26:42+08:00	4476	8125	12601	738	13339	21893	60.93%	20.44%	17	28
15	高雄市鳥松區	2018-11-24T23:16:09+08:00	6301	11536	17837	1011	18848	31219	60.37%	20.18%	23	28
15	高雄市鳥松區	2018-11-25T01:25:59+08:00	7877	14661	22538	1305	23843	39191	60.84%	20.1%	28	28
15	高雄市鳥松區	2018-11-25T00:57:44+08:00	7877	14661	22538	1305	23843	39191	60.84%	20.1%	28	28
15	高雄市鳥松區	2018-11-25T01:02:37+08:00	7877	14661	22538	1305	23843	39191	60.84%	20.1%	28	28
15	高雄市鳥松區	2018-11-24T22:40:33+08:00	5032	9219	14251	842	15093	24796	60.87%	20.29%	19	28
15	高雄市鳥松區	2018-11-25T06:09:01+08:00	7877	14661	22538	1305	23843	39191	60.84%	20.1%	28	28
15	高雄市鳥松區	2018-11-24T22:19:43+08:00	3436	5976	9412	537	9949	16259	61.19%	21.13%	13	28
15	高雄市鳥松區	2018-11-24T23:55:53+08:00	7393	13531	20924	1193	22117	36383	60.79%	20.32%	26	28
15	高雄市鳥松區	2018-11-25T03:44:31+08:00	7877	14661	22538	1305	23843	39191	60.84%	20.1%	28	28
15	高雄市鳥松區	2018-11-24T23:19:59+08:00	6301	11536	17837	1011	18848	31219	60.37%	20.18%	23	28
15	高雄市鳥松區	2018-11-25T00:00:17+08:00	7393	13531	20924	1193	22117	36383	60.79%	20.32%	26	28
15	高雄市鳥松區	2018-11-24T23:27:24+08:00	6536	12005	18541	1081	19622	32420	60.52%	20.16%	24	28
15	高雄市鳥松區	2018-11-25T01:07:33+08:00	7877	14661	22538	1305	23843	39191	60.84%	20.1%	28	28
15	高雄市鳥松區	2018-11-24T23:31:19+08:00	6909	12696	19605	1145	20750	34164	60.74%	20.22%	25	28
15	高雄市鳥松區	2018-11-24T23:01:37+08:00	5926	10881	16807	973	17780	29531	60.21%	20.07%	22	28
15	高雄市鳥松區	2018-11-24T23:12:23+08:00	5926	10881	16807	973	17780	29531	60.21%	20.07%	22	28
15	高雄市鳥松區	2018-11-25T00:14:16+08:00	7573	14030	21603	1253	22856	37638	60.73%	20.12%	27	28
15	高雄市鳥松區	2018-11-24T23:35:16+08:00	6909	12696	19605	1145	20750	34164	60.74%	20.22%	25	28
15	高雄市鳥松區	2018-11-24T23:39:24+08:00	6909	12696	19605	1145	20750	34164	60.74%	20.22%	25	28
15	高雄市鳥松區	2018-11-25T04:02:59+08:00	7877	14661	22538	1305	23843	39191	60.84%	20.1%	28	28
15	高雄市鳥松區	2018-11-24T23:43:23+08:00	6909	12696	19605	1145	20750	34164	60.74%	20.22%	25	28
15	高雄市鳥松區	2018-11-25T01:12:51+08:00	7877	14661	22538	1305	23843	39191	60.84%	20.1%	28	28
15	高雄市鳥松區	2018-11-24T22:54:31+08:00	5613	10266	15879	926	16805	27752	60.55%	20.23%	21	28
15	高雄市鳥松區	2018-11-24T22:50:55+08:00	5613	10266	15879	926	16805	27752	60.55%	20.23%	21	28
15	高雄市鳥松區	2018-11-25T06:13:59+08:00	7877	14661	22538	1305	23843	39191	60.84%	20.1%	28	28
15	高雄市鳥松區	2018-11-24T22:41:43+08:00	5032	9219	14251	842	15093	24796	60.87%	20.29%	19	28
15	高雄市鳥松區	2018-11-25T03:49:57+08:00	7877	14661	22538	1305	23843	39191	60.84%	20.1%	28	28
15	高雄市鳥松區	2018-11-24T23:05:10+08:00	5926	10881	16807	973	17780	29531	60.21%	20.07%	22	28
15	高雄市鳥松區	2018-11-25T06:19:03+08:00	7877	14661	22538	1305	23843	39191	60.84%	20.1%	28	28
15	高雄市鳥松區	2018-11-25T06:29:24+08:00	7877	14661	22538	1305	23843	39191	60.84%	20.1%	28	28
15	高雄市鳥松區	2018-11-25T00:05:11+08:00	7393	13531	20924	1193	22117	36383	60.79%	20.32%	26	28
15	高雄市鳥松區	2018-11-25T06:24:06+08:00	7877	14661	22538	1305	23843	39191	60.84%	20.1%	28	28
15	高雄市鳥松區	2018-11-24T22:30:16+08:00	4476	8125	12601	738	13339	21893	60.93%	20.44%	17	28
15	高雄市鳥松區	2018-11-24T23:51:42+08:00	7393	13531	20924	1193	22117	36383	60.79%	20.32%	26	28
15	高雄市鳥松區	2018-11-24T22:13:36+08:00	2936	5778	8714	506	9220	14889	61.92%	19.72%	12	28
15	高雄市鳥松區	2018-11-24T23:08:44+08:00	5926	10881	16807	973	17780	29531	60.21%	20.07%	22	28
15	高雄市鳥松區	2018-11-25T00:23:10+08:00	7877	14661	22538	1305	23843	39191	60.84%	20.1%	28	28
15	高雄市鳥松區	2018-11-24T22:23:21+08:00	4027	7058	11085	628	11713	19097	61.33%	21.09%	15	28
15	高雄市鳥松區	2018-11-25T03:32:44+08:00	7877	14661	22538	1305	23843	39191	60.84%	20.1%	28	28
15	高雄市鳥松區	2018-11-24T23:23:44+08:00	6301	11536	17837	1011	18848	31219	60.37%	20.18%	23	28
15	高雄市鳥松區	2018-11-24T22:33:44+08:00	4724	8597	13321	785	14106	23118	61.02%	20.43%	18	28
15	高雄市鳥松區	2018-11-24T23:47:36+08:00	6909	12696	19605	1145	20750	34164	60.74%	20.22%	25	28
15	高雄市鳥松區	2018-11-25T03:39:01+08:00	7877	14661	22538	1305	23843	39191	60.84%	20.1%	28	28
15	高雄市鳥松區	2018-11-24T22:16:18+08:00	2936	5778	8714	506	9220	14889	61.92%	19.72%	12	28
15	新竹縣關西鎮	2018-11-24T22:26:43+08:00	2680	6717	9397	595	9992	17714	56.41%	15.13%	20	27
15	新竹縣關西鎮	2018-11-25T00:09:42+08:00	3759	9450	13209	834	14043	24712	56.83%	15.21%	27	27
15	新竹縣關西鎮	2018-11-25T03:56:21+08:00	3759	9450	13209	834	14043	24712	56.83%	15.21%	27	27
15	新竹縣關西鎮	2018-11-25T01:12:52+08:00	3759	9450	13209	834	14043	24712	56.83%	15.21%	27	27
15	新竹縣關西鎮	2018-11-24T22:37:07+08:00	3175	7821	10996	693	11689	20576	56.81%	15.43%	23	27
15	新竹縣關西鎮	2018-11-24T22:54:32+08:00	3630	9054	12684	793	13477	23735	56.78%	15.29%	26	27
15	新竹縣關西鎮	2018-11-24T22:50:56+08:00	3531	8672	12203	768	12971	22792	56.91%	15.49%	25	27
15	新竹縣關西鎮	2018-11-25T00:05:12+08:00	3759	9450	13209	834	14043	24712	56.83%	15.21%	27	27
15	新竹縣關西鎮	2018-11-24T22:45:15+08:00	3330	8172	11502	721	12223	21430	57.04%	15.54%	24	27
15	新竹縣關西鎮	2018-11-25T01:02:38+08:00	3759	9450	13209	834	14043	24712	56.83%	15.21%	27	27
15	新竹縣關西鎮	2018-11-25T00:57:44+08:00	3759	9450	13209	834	14043	24712	56.83%	15.21%	27	27
15	新竹縣關西鎮	2018-11-24T22:40:34+08:00	3175	7821	10996	693	11689	20576	56.81%	15.43%	23	27
15	新竹縣關西鎮	2018-11-24T22:19:44+08:00	2610	6497	9107	576	9683	17234	56.19%	15.14%	19	27
15	新竹縣關西鎮	2018-11-25T00:00:18+08:00	3759	9450	13209	834	14043	24712	56.83%	15.21%	27	27
15	新竹縣關西鎮	2018-11-24T23:55:54+08:00	3759	9450	13209	834	14043	24712	56.83%	15.21%	27	27
15	新竹縣關西鎮	2018-11-24T23:27:25+08:00	3759	9450	13209	834	14043	24712	56.83%	15.21%	27	27
15	新竹縣關西鎮	2018-11-24T23:19:59+08:00	3759	9450	13209	834	14043	24712	56.83%	15.21%	27	27
15	新竹縣關西鎮	2018-11-24T22:23:22+08:00	2680	6717	9397	595	9992	17714	56.41%	15.13%	20	27
15	新竹縣關西鎮	2018-11-24T23:01:39+08:00	3630	9054	12684	793	13477	23735	56.78%	15.29%	26	27
15	新竹縣關西鎮	2018-11-25T01:07:33+08:00	3759	9450	13209	834	14043	24712	56.83%	15.21%	27	27
15	新竹縣關西鎮	2018-11-24T23:39:25+08:00	3759	9450	13209	834	14043	24712	56.83%	15.21%	27	27
15	新竹縣關西鎮	2018-11-24T23:12:24+08:00	3759	9450	13209	834	14043	24712	56.83%	15.21%	27	27
15	新竹縣關西鎮	2018-11-25T00:18:40+08:00	3759	9450	13209	834	14043	24712	56.83%	15.21%	27	27
15	新竹縣關西鎮	2018-11-25T03:39:02+08:00	3759	9450	13209	834	14043	24712	56.83%	15.21%	27	27
15	新竹縣關西鎮	2018-11-24T23:31:20+08:00	3759	9450	13209	834	14043	24712	56.83%	15.21%	27	27
15	新竹縣關西鎮	2018-11-24T23:35:17+08:00	3759	9450	13209	834	14043	24712	56.83%	15.21%	27	27
15	新竹縣關西鎮	2018-11-25T04:02:59+08:00	3759	9450	13209	834	14043	24712	56.83%	15.21%	27	27
15	新竹縣關西鎮	2018-11-25T00:14:17+08:00	3759	9450	13209	834	14043	24712	56.83%	15.21%	27	27
15	新竹縣關西鎮	2018-11-24T23:43:24+08:00	3759	9450	13209	834	14043	24712	56.83%	15.21%	27	27
15	新竹縣關西鎮	2018-11-24T22:58:02+08:00	3630	9054	12684	793	13477	23735	56.78%	15.29%	26	27
15	新竹縣關西鎮	2018-11-25T03:49:58+08:00	3759	9450	13209	834	14043	24712	56.83%	15.21%	27	27
15	新竹縣關西鎮	2018-11-25T01:18:02+08:00	3759	9450	13209	834	14043	24712	56.83%	15.21%	27	27
15	新竹縣關西鎮	2018-11-25T06:29:25+08:00	3759	9450	13209	834	14043	24712	56.83%	15.21%	27	27
15	新竹縣關西鎮	2018-11-24T23:05:11+08:00	3630	9054	12684	793	13477	23735	56.78%	15.29%	26	27
15	新竹縣關西鎮	2018-11-25T06:13:59+08:00	3759	9450	13209	834	14043	24712	56.83%	15.21%	27	27
15	新竹縣關西鎮	2018-11-24T22:41:44+08:00	3175	7821	10996	693	11689	20576	56.81%	15.43%	23	27
15	新竹縣關西鎮	2018-11-25T06:19:04+08:00	3759	9450	13209	834	14043	24712	56.83%	15.21%	27	27
15	新竹縣關西鎮	2018-11-25T06:24:07+08:00	3759	9450	13209	834	14043	24712	56.83%	15.21%	27	27
15	新竹縣關西鎮	2018-11-24T22:30:17+08:00	2888	7168	10056	626	10682	18922	56.45%	15.26%	21	27
15	新竹縣關西鎮	2018-11-24T23:51:42+08:00	3759	9450	13209	834	14043	24712	56.83%	15.21%	27	27
15	新竹縣關西鎮	2018-11-25T06:09:02+08:00	3759	9450	13209	834	14043	24712	56.83%	15.21%	27	27
15	新竹縣關西鎮	2018-11-24T23:23:45+08:00	3759	9450	13209	834	14043	24712	56.83%	15.21%	27	27
15	新竹縣關西鎮	2018-11-25T03:44:32+08:00	3759	9450	13209	834	14043	24712	56.83%	15.21%	27	27
15	新竹縣關西鎮	2018-11-25T03:32:45+08:00	3759	9450	13209	834	14043	24712	56.83%	15.21%	27	27
15	新竹縣關西鎮	2018-11-24T23:08:44+08:00	3759	9450	13209	834	14043	24712	56.83%	15.21%	27	27
15	新竹縣關西鎮	2018-11-24T22:13:37+08:00	2459	6098	8557	546	9103	16178	56.27%	15.2%	18	27
15	新竹縣關西鎮	2018-11-25T00:23:11+08:00	3759	9450	13209	834	14043	24712	56.83%	15.21%	27	27
15	新竹縣關西鎮	2018-11-24T23:16:10+08:00	3759	9450	13209	834	14043	24712	56.83%	15.21%	27	27
15	新竹縣關西鎮	2018-11-24T23:47:37+08:00	3759	9450	13209	834	14043	24712	56.83%	15.21%	27	27
15	新竹縣關西鎮	2018-11-24T22:16:19+08:00	2610	6497	9107	576	9683	17234	56.19%	15.14%	19	27
15	新竹縣關西鎮	2018-11-25T01:26:00+08:00	3759	9450	13209	834	14043	24712	56.83%	15.21%	27	27
15	新竹縣關西鎮	2018-11-24T22:33:45+08:00	3040	7527	10567	651	11218	19768	56.75%	15.38%	22	27
15	臺中市沙鹿區	2018-11-25T03:56:17+08:00	12711	27332	40043	2280	42323	74207	57.03%	17.13%	53	53
15	臺中市沙鹿區	2018-11-25T06:29:21+08:00	12711	27332	40043	2280	42323	74207	57.03%	17.13%	53	53
15	臺中市沙鹿區	2018-11-25T03:49:55+08:00	12711	27332	40043	2280	42323	74207	57.03%	17.13%	53	53
15	臺中市沙鹿區	2018-11-25T06:19:01+08:00	12711	27332	40043	2280	42323	74207	57.03%	17.13%	53	53
15	臺中市沙鹿區	2018-11-24T23:16:07+08:00	10491	22661	33152	1879	35031	60938	57.49%	17.22%	45	53
15	臺中市沙鹿區	2018-11-24T22:45:12+08:00	8341	17894	26235	1516	27751	48041	57.77%	17.36%	37	53
15	臺中市沙鹿區	2018-11-24T23:43:21+08:00	12711	27332	40043	2280	42323	74207	57.03%	17.13%	53	53
15	臺中市沙鹿區	2018-11-24T22:41:40+08:00	8341	17894	26235	1516	27751	48041	57.77%	17.36%	37	53
15	臺中市沙鹿區	2018-11-25T01:25:57+08:00	12711	27332	40043	2280	42323	74207	57.03%	17.13%	53	53
15	臺中市沙鹿區	2018-11-24T22:30:14+08:00	7665	16452	24117	1385	25502	43773	58.26%	17.51%	34	53
15	臺中市沙鹿區	2018-11-25T06:24:04+08:00	12711	27332	40043	2280	42323	74207	57.03%	17.13%	53	53
15	臺中市沙鹿區	2018-11-25T00:23:08+08:00	12711	27332	40043	2280	42323	74207	57.03%	17.13%	53	53
15	臺中市沙鹿區	2018-11-25T03:32:39+08:00	12711	27332	40043	2280	42323	74207	57.03%	17.13%	53	53
15	臺中市沙鹿區	2018-11-24T23:51:39+08:00	12711	27332	40043	2280	42323	74207	57.03%	17.13%	53	53
15	臺中市沙鹿區	2018-11-24T23:27:22+08:00	11537	25060	36597	2082	38679	67774	57.07%	17.02%	49	53
15	臺中市沙鹿區	2018-11-24T22:13:32+08:00	6374	13734	20108	1198	21306	36732	58%	17.35%	29	53
15	臺中市沙鹿區	2018-11-24T23:08:41+08:00	10491	22661	33152	1879	35031	60938	57.49%	17.22%	45	53
15	臺中市沙鹿區	2018-11-24T22:57:58+08:00	9169	19780	28949	1654	30603	52996	57.75%	17.3%	40	53
15	臺中市沙鹿區	2018-11-24T23:19:56+08:00	11006	23834	34840	1961	36801	64490	57.06%	17.07%	47	53
15	臺中市沙鹿區	2018-11-25T01:17:58+08:00	12711	27332	40043	2280	42323	74207	57.03%	17.13%	53	53
15	臺中市沙鹿區	2018-11-24T22:54:29+08:00	8918	19162	28080	1624	29704	51302	57.9%	17.38%	39	53
15	臺中市沙鹿區	2018-11-24T23:47:33+08:00	12711	27332	40043	2280	42323	74207	57.03%	17.13%	53	53
15	臺中市沙鹿區	2018-11-25T04:02:56+08:00	12711	27332	40043	2280	42323	74207	57.03%	17.13%	53	53
15	臺中市沙鹿區	2018-11-25T06:08:58+08:00	12711	27332	40043	2280	42323	74207	57.03%	17.13%	53	53
15	臺中市沙鹿區	2018-11-24T22:16:15+08:00	6374	13734	20108	1198	21306	36732	58%	17.35%	29	53
15	臺中市沙鹿區	2018-11-24T23:31:16+08:00	12475	26880	39355	2231	41586	72922	57.03%	17.11%	52	53
15	臺中市沙鹿區	2018-11-25T01:12:48+08:00	12711	27332	40043	2280	42323	74207	57.03%	17.13%	53	53
15	臺中市沙鹿區	2018-11-24T23:05:08+08:00	9898	21371	31269	1812	33081	57432	57.6%	17.23%	43	53
15	臺中市沙鹿區	2018-11-25T00:05:09+08:00	12711	27332	40043	2280	42323	74207	57.03%	17.13%	53	53
15	臺中市沙鹿區	2018-11-24T22:37:04+08:00	8341	17894	26235	1516	27751	48041	57.77%	17.36%	37	53
15	臺中市沙鹿區	2018-11-25T06:13:56+08:00	12711	27332	40043	2280	42323	74207	57.03%	17.13%	53	53
15	臺中市沙鹿區	2018-11-24T22:26:40+08:00	7097	15340	22437	1315	23752	40905	58.07%	17.35%	32	53
15	臺中市沙鹿區	2018-11-24T22:50:53+08:00	8611	18533	27144	1561	28705	49674	57.79%	17.34%	38	53
15	臺中市沙鹿區	2018-11-25T00:18:35+08:00	12711	27332	40043	2280	42323	74207	57.03%	17.13%	53	53
15	臺中市沙鹿區	2018-11-24T22:19:41+08:00	6632	14278	20910	1261	22171	38201	58.04%	17.36%	30	53
15	臺中市沙鹿區	2018-11-25T03:38:59+08:00	12711	27332	40043	2280	42323	74207	57.03%	17.13%	53	53
15	臺中市沙鹿區	2018-11-24T22:40:31+08:00	8341	17894	26235	1516	27751	48041	57.77%	17.36%	37	53
15	臺中市沙鹿區	2018-11-25T01:02:35+08:00	12711	27332	40043	2280	42323	74207	57.03%	17.13%	53	53
15	臺中市沙鹿區	2018-11-25T00:57:41+08:00	12711	27332	40043	2280	42323	74207	57.03%	17.13%	53	53
15	臺中市沙鹿區	2018-11-25T03:44:28+08:00	12711	27332	40043	2280	42323	74207	57.03%	17.13%	53	53
15	臺中市沙鹿區	2018-11-24T23:23:42+08:00	11317	24473	35790	2027	37817	66330	57.01%	17.06%	48	53
15	臺中市沙鹿區	2018-11-24T22:23:18+08:00	6949	14914	21863	1286	23149	39866	58.07%	17.43%	31	53
15	臺中市沙鹿區	2018-11-25T00:00:15+08:00	12711	27332	40043	2280	42323	74207	57.03%	17.13%	53	53
15	臺中市沙鹿區	2018-11-24T23:55:51+08:00	12711	27332	40043	2280	42323	74207	57.03%	17.13%	53	53
15	臺中市沙鹿區	2018-11-24T23:39:21+08:00	12711	27332	40043	2280	42323	74207	57.03%	17.13%	53	53
15	臺中市沙鹿區	2018-11-25T01:07:30+08:00	12711	27332	40043	2280	42323	74207	57.03%	17.13%	53	53
15	臺中市沙鹿區	2018-11-24T23:12:20+08:00	10491	22661	33152	1879	35031	60938	57.49%	17.22%	45	53
15	臺中市沙鹿區	2018-11-24T23:35:14+08:00	12711	27332	40043	2280	42323	74207	57.03%	17.13%	53	53
15	臺中市沙鹿區	2018-11-25T00:14:14+08:00	12711	27332	40043	2280	42323	74207	57.03%	17.13%	53	53
15	臺中市沙鹿區	2018-11-24T23:01:35+08:00	9355	20252	29607	1696	31303	54138	57.82%	17.28%	41	53
15	臺中市沙鹿區	2018-11-25T00:09:39+08:00	12711	27332	40043	2280	42323	74207	57.03%	17.13%	53	53
15	臺中市沙鹿區	2018-11-24T22:33:42+08:00	8066	17342	25408	1466	26874	46413	57.9%	17.38%	36	53
15	臺中市南區	2018-11-25T03:56:17+08:00	20975	39392	60367	3321	63688	103643	61.45%	20.24%	74	74
15	臺中市南區	2018-11-24T23:16:06+08:00	19017	35865	54882	2967	57849	94235	61.39%	20.18%	68	74
15	臺中市南區	2018-11-25T06:29:21+08:00	20975	39392	60367	3321	63688	103643	61.45%	20.24%	74	74
15	臺中市南區	2018-11-25T03:49:55+08:00	20975	39392	60367	3321	63688	103643	61.45%	20.24%	74	74
15	臺中市南區	2018-11-25T06:19:01+08:00	20975	39392	60367	3321	63688	103643	61.45%	20.24%	74	74
15	臺中市南區	2018-11-24T22:45:12+08:00	18349	34485	52834	2790	55624	90506	61.46%	20.27%	65	74
15	臺中市南區	2018-11-24T23:43:21+08:00	19289	36397	55686	3045	58731	95539	61.47%	20.19%	69	74
15	臺中市南區	2018-11-25T01:25:57+08:00	20975	39392	60367	3321	63688	103643	61.45%	20.24%	74	74
15	臺中市南區	2018-11-24T22:30:13+08:00	16791	31562	48353	2575	50928	83418	61.05%	20.13%	60	74
15	臺中市南區	2018-11-25T06:24:04+08:00	20975	39392	60367	3321	63688	103643	61.45%	20.24%	74	74
15	臺中市南區	2018-11-25T03:32:38+08:00	20975	39392	60367	3321	63688	103643	61.45%	20.24%	74	74
15	臺中市南區	2018-11-25T00:23:07+08:00	19971	37716	57687	3102	60789	98987	61.41%	20.18%	71	74
15	臺中市南區	2018-11-24T23:51:39+08:00	19289	36397	55686	3045	58731	95539	61.47%	20.19%	69	74
15	臺中市南區	2018-11-24T23:27:22+08:00	19017	35865	54882	2967	57849	94235	61.39%	20.18%	68	74
15	臺中市南區	2018-11-24T22:13:32+08:00	15037	28359	43396	2346	45742	74880	61.09%	20.08%	54	74
15	臺中市南區	2018-11-25T01:17:57+08:00	20975	39392	60367	3321	63688	103643	61.45%	20.24%	74	74
15	臺中市南區	2018-11-24T23:08:40+08:00	19017	35865	54882	2967	57849	94235	61.39%	20.18%	68	74
15	臺中市南區	2018-11-24T22:57:58+08:00	18805	35408	54213	2903	57116	93028	61.4%	20.21%	67	74
15	臺中市南區	2018-11-24T23:19:56+08:00	19017	35865	54882	2967	57849	94235	61.39%	20.18%	68	74
15	臺中市南區	2018-11-25T06:08:57+08:00	20975	39392	60367	3321	63688	103643	61.45%	20.24%	74	74
15	臺中市南區	2018-11-24T22:54:29+08:00	18805	35408	54213	2903	57116	93028	61.4%	20.21%	67	74
15	臺中市南區	2018-11-25T04:02:56+08:00	20975	39392	60367	3321	63688	103643	61.45%	20.24%	74	74
15	臺中市南區	2018-11-24T22:16:15+08:00	15306	28808	44114	2370	46484	76164	61.03%	20.1%	55	74
15	臺中市南區	2018-11-24T23:31:16+08:00	19017	35865	54882	2967	57849	94235	61.39%	20.18%	68	74
15	臺中市南區	2018-11-25T01:12:48+08:00	20975	39392	60367	3321	63688	103643	61.45%	20.24%	74	74
15	臺中市南區	2018-11-24T22:33:41+08:00	17609	33097	50706	2695	53401	87057	61.34%	20.23%	63	74
15	臺中市南區	2018-11-24T23:05:08+08:00	19017	35865	54882	2967	57849	94235	61.39%	20.18%	68	74
15	臺中市南區	2018-11-24T23:47:32+08:00	19289	36397	55686	3045	58731	95539	61.47%	20.19%	69	74
15	臺中市南區	2018-11-24T22:41:39+08:00	17961	33771	51732	2743	54475	88780	61.36%	20.23%	64	74
15	臺中市南區	2018-11-25T00:05:09+08:00	19289	36397	55686	3045	58731	95539	61.47%	20.19%	69	74
15	臺中市南區	2018-11-24T22:37:04+08:00	17609	33097	50706	2695	53401	87057	61.34%	20.23%	63	74
15	臺中市南區	2018-11-24T22:50:52+08:00	18586	34903	53489	2857	56346	91636	61.49%	20.28%	66	74
15	臺中市南區	2018-11-25T06:13:56+08:00	20975	39392	60367	3321	63688	103643	61.45%	20.24%	74	74
15	臺中市南區	2018-11-24T22:26:40+08:00	16505	31038	47543	2550	50093	82024	61.07%	20.12%	59	74
15	臺中市南區	2018-11-25T00:18:35+08:00	19971	37716	57687	3102	60789	98987	61.41%	20.18%	71	74
15	臺中市南區	2018-11-24T22:40:31+08:00	17961	33771	51732	2743	54475	88780	61.36%	20.23%	64	74
15	臺中市南區	2018-11-25T01:02:35+08:00	20975	39392	60367	3321	63688	103643	61.45%	20.24%	74	74
15	臺中市南區	2018-11-25T00:57:41+08:00	20975	39392	60367	3321	63688	103643	61.45%	20.24%	74	74
15	臺中市南區	2018-11-24T22:19:40+08:00	15895	29928	45823	2467	48290	79040	61.1%	20.11%	57	74
15	臺中市南區	2018-11-25T03:38:58+08:00	20975	39392	60367	3321	63688	103643	61.45%	20.24%	74	74
15	臺中市南區	2018-11-25T03:44:28+08:00	20975	39392	60367	3321	63688	103643	61.45%	20.24%	74	74
15	臺中市南區	2018-11-24T23:23:42+08:00	19017	35865	54882	2967	57849	94235	61.39%	20.18%	68	74
15	臺中市南區	2018-11-24T22:23:17+08:00	15895	29928	45823	2467	48290	79040	61.1%	20.11%	57	74
15	臺中市南區	2018-11-24T23:55:51+08:00	19289	36397	55686	3045	58731	95539	61.47%	20.19%	69	74
15	臺中市南區	2018-11-25T00:00:14+08:00	19289	36397	55686	3045	58731	95539	61.47%	20.19%	69	74
15	臺中市南區	2018-11-24T23:39:21+08:00	19289	36397	55686	3045	58731	95539	61.47%	20.19%	69	74
15	臺中市南區	2018-11-25T01:07:30+08:00	20975	39392	60367	3321	63688	103643	61.45%	20.24%	74	74
15	臺中市南區	2018-11-25T00:09:38+08:00	19337	36514	55851	3025	58876	95795	61.46%	20.19%	69	74
15	臺中市南區	2018-11-24T23:35:14+08:00	19017	35865	54882	2967	57849	94235	61.39%	20.18%	68	74
15	臺中市南區	2018-11-25T00:14:14+08:00	19675	37158	56833	3051	59884	97600	61.36%	20.16%	70	74
15	臺中市南區	2018-11-24T23:01:35+08:00	18805	35408	54213	2903	57116	93028	61.4%	20.21%	67	74
15	臺中市南區	2018-11-24T23:12:19+08:00	19017	35865	54882	2967	57849	94235	61.39%	20.18%	68	74
15	臺北市松山區	2018-11-25T06:29:19+08:00	37298	58829	96127	4313	100440	169278	59.33%	22.03%	117	117
15	臺北市松山區	2018-11-25T01:07:28+08:00	32551	51154	83705	3766	87471	147365	59.36%	22.09%	103	117
15	臺北市松山區	2018-11-25T03:49:53+08:00	37298	58829	96127	4313	100440	169278	59.33%	22.03%	117	117
15	臺北市松山區	2018-11-24T22:50:50+08:00	15192	23670	38862	1738	40600	67787	59.89%	22.41%	49	117
15	臺北市松山區	2018-11-25T06:13:54+08:00	37298	58829	96127	4313	100440	169278	59.33%	22.03%	117	117
15	臺北市松山區	2018-11-24T23:43:19+08:00	23040	36505	59545	2657	62202	104536	59.5%	22.04%	74	117
15	臺北市松山區	2018-11-24T22:13:29+08:00	7740	12041	19781	852	20633	34667	59.52%	22.33%	25	117
15	臺北市松山區	2018-11-25T03:32:36+08:00	37298	58829	96127	4313	100440	169278	59.33%	22.03%	117	117
15	臺北市松山區	2018-11-25T00:23:06+08:00	28720	45308	74028	3320	77348	130566	59.24%	22%	91	117
15	臺北市松山區	2018-11-24T23:08:38+08:00	18373	28835	47208	2111	49319	83057	59.38%	22.12%	59	117
15	臺北市松山區	2018-11-24T23:55:49+08:00	23326	36933	60259	2690	62949	105750	59.53%	22.06%	75	117
15	臺北市松山區	2018-11-25T06:24:02+08:00	37298	58829	96127	4313	100440	169278	59.33%	22.03%	117	117
15	臺北市松山區	2018-11-24T23:51:37+08:00	23326	36933	60259	2690	62949	105750	59.53%	22.06%	75	117
15	臺北市松山區	2018-11-24T22:23:15+08:00	10541	16486	27027	1196	28223	47354	59.6%	22.26%	34	117
15	臺北市松山區	2018-11-24T22:40:29+08:00	13714	21278	34992	1565	36557	61228	59.71%	22.4%	44	117
15	臺北市松山區	2018-11-25T06:18:59+08:00	37298	58829	96127	4313	100440	169278	59.33%	22.03%	117	117
15	臺北市松山區	2018-11-24T22:57:56+08:00	17057	26725	43782	1957	45739	76905	59.47%	22.18%	55	117
15	臺北市松山區	2018-11-24T23:23:40+08:00	20066	31229	51295	2307	53602	90236	59.4%	22.24%	64	117
15	臺北市松山區	2018-11-24T22:33:40+08:00	13383	20749	34132	1540	35672	59732	59.72%	22.41%	43	117
15	臺北市松山區	2018-11-24T22:54:27+08:00	15458	24246	39704	1772	41476	69277	59.87%	22.31%	50	117
15	臺北市松山區	2018-11-24T22:16:13+08:00	8277	12924	21201	903	22104	37142	59.51%	22.28%	27	117
15	臺北市松山區	2018-11-25T00:14:11+08:00	25830	40946	66776	2977	69753	117339	59.45%	22.01%	83	117
15	臺北市松山區	2018-11-25T01:12:46+08:00	33481	52779	86260	3890	90150	151882	59.36%	22.04%	106	117
15	臺北市松山區	2018-11-24T22:41:37+08:00	13714	21278	34992	1565	36557	61228	59.71%	22.4%	44	117
15	臺北市松山區	2018-11-25T00:05:07+08:00	24894	39411	64305	2874	67179	112986	59.46%	22.03%	80	117
15	臺北市松山區	2018-11-24T23:05:06+08:00	17735	27812	45547	2030	47577	80134	59.37%	22.13%	57	117
15	臺北市松山區	2018-11-25T00:18:33+08:00	28034	44265	72299	3221	75520	127535	59.22%	21.98%	89	117
15	臺北市松山區	2018-11-24T22:45:10+08:00	13990	21772	35762	1601	37363	62504	59.78%	22.38%	45	117
15	臺北市松山區	2018-11-24T23:16:05+08:00	19262	30297	49559	2221	51780	87084	59.46%	22.12%	62	117
15	臺北市松山區	2018-11-24T22:37:02+08:00	13714	21278	34992	1565	36557	61228	59.71%	22.4%	44	117
15	臺北市松山區	2018-11-25T03:56:15+08:00	37298	58829	96127	4313	100440	169278	59.33%	22.03%	117	117
15	臺北市松山區	2018-11-25T03:38:57+08:00	37298	58829	96127	4313	100440	169278	59.33%	22.03%	117	117
15	臺北市松山區	2018-11-25T03:44:26+08:00	37298	58829	96127	4313	100440	169278	59.33%	22.03%	117	117
15	臺北市松山區	2018-11-24T22:30:11+08:00	12751	19818	32569	1483	34052	57019	59.72%	22.36%	41	117
15	臺北市松山區	2018-11-25T01:02:33+08:00	31949	50265	82214	3703	85917	144854	59.31%	22.06%	101	117
15	臺北市松山區	2018-11-25T01:25:55+08:00	33481	52779	86260	3890	90150	151882	59.36%	22.04%	106	117
15	臺北市松山區	2018-11-24T23:19:54+08:00	19717	30764	50481	2284	52765	88784	59.43%	22.21%	63	117
15	臺北市松山區	2018-11-25T00:57:39+08:00	31655	49748	81403	3665	85068	143380	59.33%	22.08%	100	117
15	臺北市松山區	2018-11-25T01:17:55+08:00	33481	52779	86260	3890	90150	151882	59.36%	22.04%	106	117
15	臺北市松山區	2018-11-24T22:19:39+08:00	9527	14923	24450	1074	25524	42883	59.52%	22.22%	31	117
15	臺北市松山區	2018-11-24T23:27:20+08:00	20929	32893	53822	2392	56214	94545	59.46%	22.14%	67	117
15	臺北市松山區	2018-11-25T00:00:13+08:00	23969	37932	61901	2769	64670	108587	59.56%	22.07%	77	117
15	臺北市松山區	2018-11-24T23:35:12+08:00	21487	33999	55486	2434	57920	97507	59.4%	22.04%	69	117
15	臺北市松山區	2018-11-25T00:09:36+08:00	24894	39411	64305	2874	67179	112986	59.46%	22.03%	80	117
15	臺北市松山區	2018-11-24T23:12:18+08:00	18690	29367	48057	2138	50195	84520	59.39%	22.11%	60	117
15	臺北市松山區	2018-11-24T23:31:14+08:00	21285	33477	54762	2419	57181	96199	59.44%	22.13%	68	117
15	臺北市松山區	2018-11-24T23:01:33+08:00	17390	27183	44573	1994	46567	78408	59.39%	22.18%	56	117
15	臺北市松山區	2018-11-24T23:47:31+08:00	23326	36933	60259	2690	62949	105750	59.53%	22.06%	75	117
15	臺北市松山區	2018-11-25T04:02:54+08:00	37298	58829	96127	4313	100440	169278	59.33%	22.03%	117	117
15	臺北市松山區	2018-11-24T22:26:38+08:00	11809	18442	30251	1371	31622	52982	59.68%	22.29%	38	117
15	臺北市松山區	2018-11-24T23:39:18+08:00	22039	34943	56982	2513	59495	100153	59.4%	22.01%	71	117
15	臺北市松山區	2018-11-25T06:08:55+08:00	37298	58829	96127	4313	100440	169278	59.33%	22.03%	117	117
15	臺北市士林區	2018-11-25T06:29:19+08:00	51855	79244	131099	7642	138741	241854	57.37%	21.44%	163	163
15	臺北市士林區	2018-11-25T01:07:28+08:00	39582	60584	100166	5842	106008	183816	57.67%	21.53%	127	163
15	臺北市士林區	2018-11-25T06:13:55+08:00	51855	79244	131099	7642	138741	241854	57.37%	21.44%	163	163
15	臺北市士林區	2018-11-24T22:50:51+08:00	15096	22824	37920	2570	40490	70522	57.41%	21.41%	52	163
15	臺北市士林區	2018-11-25T06:19:00+08:00	51855	79244	131099	7642	138741	241854	57.37%	21.44%	163	163
15	臺北市士林區	2018-11-25T03:49:53+08:00	51855	79244	131099	7642	138741	241854	57.37%	21.44%	163	163
15	臺北市士林區	2018-11-25T06:29:20+08:00	51855	79244	131099	7642	138741	241854	57.37%	21.44%	163	163
15	臺北市士林區	2018-11-25T03:49:54+08:00	51855	79244	131099	7642	138741	241854	57.37%	21.44%	163	163
15	臺北市士林區	2018-11-25T01:07:29+08:00	39582	60584	100166	5842	106008	183816	57.67%	21.53%	127	163
15	臺北市士林區	2018-11-24T23:43:19+08:00	26800	41221	68021	4107	72128	124915	57.74%	21.45%	89	163
15	臺北市士林區	2018-11-25T06:24:03+08:00	51855	79244	131099	7642	138741	241854	57.37%	21.44%	163	163
15	臺北市士林區	2018-11-24T23:08:39+08:00	19558	29970	49528	3195	52723	91678	57.51%	21.33%	66	163
15	臺北市士林區	2018-11-25T00:23:06+08:00	33512	51142	84654	5017	89671	155286	57.75%	21.58%	109	163
15	臺北市士林區	2018-11-24T22:30:12+08:00	12772	19129	31901	2150	34051	59271	57.45%	21.55%	45	163
15	臺北市士林區	2018-11-24T23:55:49+08:00	30573	46666	77239	4568	81807	141488	57.82%	21.61%	100	163
15	臺北市士林區	2018-11-25T03:32:37+08:00	51855	79244	131099	7642	138741	241854	57.37%	21.44%	163	163
15	臺北市士林區	2018-11-25T06:24:02+08:00	51855	79244	131099	7642	138741	241854	57.37%	21.44%	163	163
15	臺北市士林區	2018-11-24T23:51:37+08:00	29629	45257	74886	4453	79339	137200	57.83%	21.6%	97	163
15	臺北市士林區	2018-11-24T23:23:41+08:00	22528	34498	57026	3618	60644	105015	57.75%	21.45%	76	163
15	臺北市士林區	2018-11-24T22:57:57+08:00	17333	26300	43633	2893	46526	81078	57.38%	21.38%	59	163
15	臺北市士林區	2018-11-24T23:51:38+08:00	29629	45257	74886	4453	79339	137200	57.83%	21.6%	97	163
15	臺北市士林區	2018-11-25T06:18:59+08:00	51855	79244	131099	7642	138741	241854	57.37%	21.44%	163	163
15	臺北市士林區	2018-11-25T01:17:56+08:00	40602	62157	102759	5995	108754	188497	57.7%	21.54%	130	163
15	臺北市士林區	2018-11-24T23:23:40+08:00	22528	34498	57026	3618	60644	105015	57.75%	21.45%	76	163
15	臺北市士林區	2018-11-24T22:33:40+08:00	13453	20145	33598	2288	35886	62563	57.36%	21.5%	47	163
15	臺北市士林區	2018-11-24T22:16:13+08:00	12033	18243	30276	2045	32321	56331	57.38%	21.36%	43	163
15	臺北市士林區	2018-11-24T23:05:07+08:00	19023	28925	47948	3135	51083	88788	57.53%	21.43%	64	163
15	臺北市士林區	2018-11-24T22:41:38+08:00	14441	21768	36209	2456	38665	67402	57.36%	21.43%	50	163
15	臺北市士林區	2018-11-24T22:54:28+08:00	16374	24670	41044	2739	43783	76261	57.41%	21.47%	56	163
15	臺北市士林區	2018-11-25T01:12:46+08:00	39582	60584	100166	5842	106008	183816	57.67%	21.53%	127	163
15	臺北市士林區	2018-11-25T06:08:56+08:00	51855	79244	131099	7642	138741	241854	57.37%	21.44%	163	163
15	臺北市士林區	2018-11-25T00:05:07+08:00	31956	48752	80708	4793	85501	147789	57.85%	21.62%	104	163
15	臺北市士林區	2018-11-24T23:05:06+08:00	19023	28925	47948	3135	51083	88788	57.53%	21.43%	64	163
15	臺北市士林區	2018-11-25T00:18:33+08:00	33512	51142	84654	5017	89671	155286	57.75%	21.58%	109	163
15	臺北市士林區	2018-11-24T22:37:03+08:00	13740	20650	34390	2352	36742	64093	57.33%	21.44%	48	163
15	臺北市士林區	2018-11-25T00:18:34+08:00	33512	51142	84654	5017	89671	155286	57.75%	21.58%	109	163
15	臺北市士林區	2018-11-24T23:16:05+08:00	21423	32686	54109	3480	57589	99688	57.77%	21.49%	72	163
15	臺北市士林區	2018-11-24T22:45:11+08:00	14771	22240	37011	2507	39518	68854	57.39%	21.45%	51	163
15	臺北市士林區	2018-11-25T03:56:15+08:00	51855	79244	131099	7642	138741	241854	57.37%	21.44%	163	163
15	臺北市士林區	2018-11-25T00:57:40+08:00	37747	57878	95625	5633	101258	175815	57.59%	21.47%	122	163
15	臺北市士林區	2018-11-25T03:38:57+08:00	51855	79244	131099	7642	138741	241854	57.37%	21.44%	163	163
15	臺北市士林區	2018-11-25T03:44:26+08:00	51855	79244	131099	7642	138741	241854	57.37%	21.44%	163	163
15	臺北市士林區	2018-11-25T01:02:33+08:00	38865	59505	98370	5752	104122	180748	57.61%	21.5%	125	163
15	臺北市士林區	2018-11-24T22:40:30+08:00	14441	21768	36209	2456	38665	67402	57.36%	21.43%	50	163
15	臺北市士林區	2018-11-25T01:25:55+08:00	41943	64268	106211	6202	112413	195258	57.57%	21.48%	134	163
15	臺北市士林區	2018-11-24T22:23:16+08:00	12452	18685	31137	2095	33232	57852	57.44%	21.52%	44	163
15	臺北市士林區	2018-11-24T23:19:54+08:00	22022	33598	55620	3546	59166	102394	57.78%	21.51%	74	163
15	臺北市士林區	2018-11-25T00:57:39+08:00	37747	57878	95625	5633	101258	175815	57.59%	21.47%	122	163
15	臺北市士林區	2018-11-24T23:27:21+08:00	23150	35418	58568	3661	62229	107998	57.62%	21.44%	78	163
15	臺北市士林區	2018-11-25T01:17:55+08:00	40602	62157	102759	5995	108754	188497	57.7%	21.54%	130	163
15	臺北市士林區	2018-11-24T22:19:39+08:00	12033	18243	30276	2045	32321	56331	57.38%	21.36%	43	163
15	臺北市士林區	2018-11-24T23:27:20+08:00	23150	35418	58568	3661	62229	107998	57.62%	21.44%	78	163
15	臺北市士林區	2018-11-24T22:13:30+08:00	11679	17698	29377	1980	31357	54672	57.35%	21.36%	42	163
15	臺北市士林區	2018-11-25T00:00:13+08:00	30978	47217	78195	4624	82819	143153	57.85%	21.64%	101	163
15	臺北市士林區	2018-11-25T00:14:12+08:00	32854	50098	82952	4932	87884	152269	57.72%	21.58%	107	163
15	臺北市士林區	2018-11-25T04:02:55+08:00	51855	79244	131099	7642	138741	241854	57.37%	21.44%	163	163
15	臺北市士林區	2018-11-24T23:39:19+08:00	25124	38704	63828	3944	67772	117407	57.72%	21.4%	84	163
15	臺北市士林區	2018-11-24T22:26:39+08:00	12452	18685	31137	2095	33232	57852	57.44%	21.52%	44	163
15	臺北市士林區	2018-11-24T23:12:18+08:00	19918	30495	50413	3219	53632	93316	57.47%	21.34%	67	163
15	臺北市士林區	2018-11-24T23:31:14+08:00	23807	36547	60354	3736	64090	111206	57.63%	21.41%	80	163
15	臺北市士林區	2018-11-24T23:01:33+08:00	18428	27959	46387	3053	49440	86015	57.48%	21.42%	62	163
15	臺北市士林區	2018-11-24T23:01:34+08:00	18428	27959	46387	3053	49440	86015	57.48%	21.42%	62	163
15	臺北市士林區	2018-11-24T23:47:31+08:00	28214	43392	71606	4294	75900	131304	57.8%	21.49%	93	163
15	臺北市士林區	2018-11-24T23:35:13+08:00	24414	37620	62034	3830	65864	114319	57.61%	21.36%	82	163
15	臺北市士林區	2018-11-25T04:02:54+08:00	51855	79244	131099	7642	138741	241854	57.37%	21.44%	163	163
15	臺北市士林區	2018-11-25T00:09:37+08:00	32232	49179	81411	4830	86241	148971	57.89%	21.64%	105	163
15	屏東縣林邊鄉	2018-11-24T22:58:06+08:00	2763	5109	7872	849	8721	15691	55.58%	17.61%	16	16
15	屏東縣林邊鄉	2018-11-25T06:19:08+08:00	2763	5109	7872	849	8721	15691	55.58%	17.61%	16	16
15	屏東縣林邊鄉	2018-11-25T03:56:26+08:00	2763	5109	7872	849	8721	15691	55.58%	17.61%	16	16
15	屏東縣林邊鄉	2018-11-24T23:39:30+08:00	2763	5109	7872	849	8721	15691	55.58%	17.61%	16	16
15	屏東縣林邊鄉	2018-11-24T22:41:48+08:00	2606	4774	7380	801	8181	14688	55.7%	17.74%	15	16
15	屏東縣林邊鄉	2018-11-24T23:05:14+08:00	2763	5109	7872	849	8721	15691	55.58%	17.61%	16	16
15	屏東縣林邊鄉	2018-11-25T06:29:29+08:00	2763	5109	7872	849	8721	15691	55.58%	17.61%	16	16
15	屏東縣林邊鄉	2018-11-25T01:18:07+08:00	2763	5109	7872	849	8721	15691	55.58%	17.61%	16	16
15	屏東縣林邊鄉	2018-11-24T23:43:28+08:00	2763	5109	7872	849	8721	15691	55.58%	17.61%	16	16
15	屏東縣林邊鄉	2018-11-25T06:09:07+08:00	2763	5109	7872	849	8721	15691	55.58%	17.61%	16	16
15	屏東縣林邊鄉	2018-11-24T23:51:47+08:00	2763	5109	7872	849	8721	15691	55.58%	17.61%	16	16
15	屏東縣林邊鄉	2018-11-24T22:13:42+08:00	2070	3631	5701	631	6332	11383	55.63%	18.19%	12	16
15	屏東縣林邊鄉	2018-11-25T06:24:11+08:00	2763	5109	7872	849	8721	15691	55.58%	17.61%	16	16
15	屏東縣林邊鄉	2018-11-24T23:08:49+08:00	2763	5109	7872	849	8721	15691	55.58%	17.61%	16	16
15	屏東縣林邊鄉	2018-11-24T22:51:01+08:00	2763	5109	7872	849	8721	15691	55.58%	17.61%	16	16
15	屏東縣林邊鄉	2018-11-25T03:44:38+08:00	2763	5109	7872	849	8721	15691	55.58%	17.61%	16	16
15	屏東縣林邊鄉	2018-11-25T00:23:15+08:00	2763	5109	7872	849	8721	15691	55.58%	17.61%	16	16
15	屏東縣林邊鄉	2018-11-24T23:23:49+08:00	2763	5109	7872	849	8721	15691	55.58%	17.61%	16	16
15	屏東縣林邊鄉	2018-11-24T22:33:49+08:00	2375	4235	6610	713	7323	13230	55.35%	17.95%	14	16
15	屏東縣林邊鄉	2018-11-24T22:37:12+08:00	2606	4774	7380	801	8181	14688	55.7%	17.74%	15	16
15	屏東縣林邊鄉	2018-11-24T23:16:14+08:00	2763	5109	7872	849	8721	15691	55.58%	17.61%	16	16
15	屏東縣林邊鄉	2018-11-25T01:26:05+08:00	2763	5109	7872	849	8721	15691	55.58%	17.61%	16	16
15	屏東縣林邊鄉	2018-11-25T03:39:05+08:00	2763	5109	7872	849	8721	15691	55.58%	17.61%	16	16
15	屏東縣林邊鄉	2018-11-24T22:16:23+08:00	2070	3631	5701	631	6332	11383	55.63%	18.19%	12	16
15	屏東縣林邊鄉	2018-11-25T00:14:21+08:00	2763	5109	7872	849	8721	15691	55.58%	17.61%	16	16
15	屏東縣林邊鄉	2018-11-24T23:35:21+08:00	2763	5109	7872	849	8721	15691	55.58%	17.61%	16	16
15	屏東縣林邊鄉	2018-11-24T22:45:19+08:00	2763	5109	7872	849	8721	15691	55.58%	17.61%	16	16
15	屏東縣林邊鄉	2018-11-24T22:54:36+08:00	2763	5109	7872	849	8721	15691	55.58%	17.61%	16	16
15	屏東縣林邊鄉	2018-11-25T00:09:48+08:00	2763	5109	7872	849	8721	15691	55.58%	17.61%	16	16
15	屏東縣林邊鄉	2018-11-24T23:01:44+08:00	2763	5109	7872	849	8721	15691	55.58%	17.61%	16	16
15	屏東縣林邊鄉	2018-11-24T22:26:47+08:00	2218	3970	6188	675	6863	12505	54.88%	17.74%	13	16
15	屏東縣林邊鄉	2018-11-24T23:47:41+08:00	2763	5109	7872	849	8721	15691	55.58%	17.61%	16	16
15	屏東縣林邊鄉	2018-11-25T01:12:57+08:00	2763	5109	7872	849	8721	15691	55.58%	17.61%	16	16
15	屏東縣林邊鄉	2018-11-25T00:05:16+08:00	2763	5109	7872	849	8721	15691	55.58%	17.61%	16	16
15	屏東縣林邊鄉	2018-11-25T00:57:49+08:00	2763	5109	7872	849	8721	15691	55.58%	17.61%	16	16
15	屏東縣林邊鄉	2018-11-24T22:19:48+08:00	2218	3970	6188	675	6863	12505	54.88%	17.74%	13	16
15	屏東縣林邊鄉	2018-11-24T22:30:21+08:00	2218	3970	6188	675	6863	12505	54.88%	17.74%	13	16
15	屏東縣林邊鄉	2018-11-25T03:32:50+08:00	2763	5109	7872	849	8721	15691	55.58%	17.61%	16	16
15	屏東縣林邊鄉	2018-11-24T22:40:38+08:00	2606	4774	7380	801	8181	14688	55.7%	17.74%	15	16
15	屏東縣林邊鄉	2018-11-25T04:03:04+08:00	2763	5109	7872	849	8721	15691	55.58%	17.61%	16	16
15	屏東縣林邊鄉	2018-11-25T01:02:42+08:00	2763	5109	7872	849	8721	15691	55.58%	17.61%	16	16
15	屏東縣林邊鄉	2018-11-25T06:14:03+08:00	2763	5109	7872	849	8721	15691	55.58%	17.61%	16	16
15	屏東縣林邊鄉	2018-11-24T23:55:59+08:00	2763	5109	7872	849	8721	15691	55.58%	17.61%	16	16
15	屏東縣林邊鄉	2018-11-24T22:23:26+08:00	2218	3970	6188	675	6863	12505	54.88%	17.74%	13	16
15	屏東縣林邊鄉	2018-11-24T23:27:29+08:00	2763	5109	7872	849	8721	15691	55.58%	17.61%	16	16
15	屏東縣林邊鄉	2018-11-25T00:00:22+08:00	2763	5109	7872	849	8721	15691	55.58%	17.61%	16	16
15	屏東縣林邊鄉	2018-11-24T23:20:03+08:00	2763	5109	7872	849	8721	15691	55.58%	17.61%	16	16
15	屏東縣林邊鄉	2018-11-24T23:31:25+08:00	2763	5109	7872	849	8721	15691	55.58%	17.61%	16	16
15	屏東縣林邊鄉	2018-11-25T00:18:45+08:00	2763	5109	7872	849	8721	15691	55.58%	17.61%	16	16
15	屏東縣林邊鄉	2018-11-25T01:07:38+08:00	2763	5109	7872	849	8721	15691	55.58%	17.61%	16	16
15	屏東縣林邊鄉	2018-11-25T03:50:02+08:00	2763	5109	7872	849	8721	15691	55.58%	17.61%	16	16
15	屏東縣林邊鄉	2018-11-24T23:12:28+08:00	2763	5109	7872	849	8721	15691	55.58%	17.61%	16	16
15	屏東縣里港鄉	2018-11-24T22:58:06+08:00	3407	6798	10205	1164	11369	20594	55.21%	16.54%	19	20
15	屏東縣里港鄉	2018-11-25T06:19:08+08:00	3616	7226	10842	1218	12060	22128	54.5%	16.34%	20	20
15	屏東縣里港鄉	2018-11-24T23:43:27+08:00	3616	7226	10842	1218	12060	22128	54.5%	16.34%	20	20
15	屏東縣里港鄉	2018-11-24T22:54:35+08:00	3134	6302	9436	1078	10514	19016	55.29%	16.48%	18	20
15	屏東縣里港鄉	2018-11-24T22:41:48+08:00	2865	5737	8602	997	9599	17464	54.96%	16.41%	17	20
15	屏東縣里港鄉	2018-11-24T23:05:14+08:00	3407	6798	10205	1164	11369	20594	55.21%	16.54%	19	20
15	屏東縣里港鄉	2018-11-25T06:29:29+08:00	3616	7226	10842	1218	12060	22128	54.5%	16.34%	20	20
15	屏東縣里港鄉	2018-11-25T01:18:07+08:00	3616	7226	10842	1218	12060	22128	54.5%	16.34%	20	20
15	屏東縣里港鄉	2018-11-24T22:13:42+08:00	2865	5737	8602	997	9599	17464	54.96%	16.41%	17	20
15	屏東縣里港鄉	2018-11-24T23:51:46+08:00	3616	7226	10842	1218	12060	22128	54.5%	16.34%	20	20
15	屏東縣里港鄉	2018-11-25T06:09:06+08:00	3616	7226	10842	1218	12060	22128	54.5%	16.34%	20	20
15	屏東縣里港鄉	2018-11-25T06:24:11+08:00	3616	7226	10842	1218	12060	22128	54.5%	16.34%	20	20
15	屏東縣里港鄉	2018-11-24T23:08:49+08:00	3407	6798	10205	1164	11369	20594	55.21%	16.54%	19	20
15	屏東縣里港鄉	2018-11-24T23:23:48+08:00	3407	6798	10205	1164	11369	20594	55.21%	16.54%	19	20
15	屏東縣里港鄉	2018-11-25T03:44:38+08:00	3616	7226	10842	1218	12060	22128	54.5%	16.34%	20	20
15	屏東縣里港鄉	2018-11-25T00:23:15+08:00	3616	7226	10842	1218	12060	22128	54.5%	16.34%	20	20
15	屏東縣里港鄉	2018-11-25T00:00:21+08:00	3616	7226	10842	1218	12060	22128	54.5%	16.34%	20	20
15	屏東縣里港鄉	2018-11-24T22:51:00+08:00	2865	5737	8602	997	9599	17464	54.96%	16.41%	17	20
15	屏東縣里港鄉	2018-11-25T03:32:49+08:00	3616	7226	10842	1218	12060	22128	54.5%	16.34%	20	20
15	屏東縣里港鄉	2018-11-24T22:37:12+08:00	2865	5737	8602	997	9599	17464	54.96%	16.41%	17	20
15	屏東縣里港鄉	2018-11-24T23:16:13+08:00	3407	6798	10205	1164	11369	20594	55.21%	16.54%	19	20
15	屏東縣里港鄉	2018-11-24T23:35:20+08:00	3616	7226	10842	1218	12060	22128	54.5%	16.34%	20	20
15	屏東縣里港鄉	2018-11-25T01:26:05+08:00	3616	7226	10842	1218	12060	22128	54.5%	16.34%	20	20
15	屏東縣里港鄉	2018-11-25T03:39:05+08:00	3616	7226	10842	1218	12060	22128	54.5%	16.34%	20	20
15	屏東縣里港鄉	2018-11-24T22:33:48+08:00	2865	5737	8602	997	9599	17464	54.96%	16.41%	17	20
15	屏東縣里港鄉	2018-11-25T03:50:01+08:00	3616	7226	10842	1218	12060	22128	54.5%	16.34%	20	20
15	屏東縣里港鄉	2018-11-24T22:16:23+08:00	2865	5737	8602	997	9599	17464	54.96%	16.41%	17	20
15	屏東縣里港鄉	2018-11-25T00:14:21+08:00	3616	7226	10842	1218	12060	22128	54.5%	16.34%	20	20
15	屏東縣里港鄉	2018-11-25T01:12:56+08:00	3616	7226	10842	1218	12060	22128	54.5%	16.34%	20	20
15	屏東縣里港鄉	2018-11-24T23:01:43+08:00	3407	6798	10205	1164	11369	20594	55.21%	16.54%	19	20
15	屏東縣里港鄉	2018-11-25T03:56:25+08:00	3616	7226	10842	1218	12060	22128	54.5%	16.34%	20	20
15	屏東縣里港鄉	2018-11-24T23:47:41+08:00	3616	7226	10842	1218	12060	22128	54.5%	16.34%	20	20
15	屏東縣里港鄉	2018-11-24T22:45:18+08:00	2865	5737	8602	997	9599	17464	54.96%	16.41%	17	20
15	屏東縣里港鄉	2018-11-25T00:09:47+08:00	3616	7226	10842	1218	12060	22128	54.5%	16.34%	20	20
15	屏東縣里港鄉	2018-11-24T22:26:46+08:00	2865	5737	8602	997	9599	17464	54.96%	16.41%	17	20
15	屏東縣里港鄉	2018-11-25T00:05:16+08:00	3616	7226	10842	1218	12060	22128	54.5%	16.34%	20	20
15	屏東縣里港鄉	2018-11-24T22:30:21+08:00	2865	5737	8602	997	9599	17464	54.96%	16.41%	17	20
15	屏東縣里港鄉	2018-11-24T22:40:38+08:00	2865	5737	8602	997	9599	17464	54.96%	16.41%	17	20
15	屏東縣里港鄉	2018-11-25T04:03:03+08:00	3616	7226	10842	1218	12060	22128	54.5%	16.34%	20	20
15	屏東縣里港鄉	2018-11-25T00:57:48+08:00	3616	7226	10842	1218	12060	22128	54.5%	16.34%	20	20
15	屏東縣里港鄉	2018-11-24T22:19:47+08:00	2865	5737	8602	997	9599	17464	54.96%	16.41%	17	20
15	屏東縣里港鄉	2018-11-24T23:27:28+08:00	3616	7226	10842	1218	12060	22128	54.5%	16.34%	20	20
15	屏東縣里港鄉	2018-11-25T01:02:42+08:00	3616	7226	10842	1218	12060	22128	54.5%	16.34%	20	20
15	屏東縣里港鄉	2018-11-25T06:14:03+08:00	3616	7226	10842	1218	12060	22128	54.5%	16.34%	20	20
15	屏東縣里港鄉	2018-11-24T22:23:26+08:00	2865	5737	8602	997	9599	17464	54.96%	16.41%	17	20
15	屏東縣里港鄉	2018-11-24T23:55:58+08:00	3616	7226	10842	1218	12060	22128	54.5%	16.34%	20	20
15	屏東縣里港鄉	2018-11-25T00:18:44+08:00	3616	7226	10842	1218	12060	22128	54.5%	16.34%	20	20
15	屏東縣里港鄉	2018-11-24T23:20:03+08:00	3407	6798	10205	1164	11369	20594	55.21%	16.54%	19	20
15	屏東縣里港鄉	2018-11-25T01:07:37+08:00	3616	7226	10842	1218	12060	22128	54.5%	16.34%	20	20
15	屏東縣里港鄉	2018-11-24T23:39:29+08:00	3616	7226	10842	1218	12060	22128	54.5%	16.34%	20	20
15	屏東縣里港鄉	2018-11-24T23:12:28+08:00	3407	6798	10205	1164	11369	20594	55.21%	16.54%	19	20
15	屏東縣里港鄉	2018-11-24T23:31:24+08:00	3616	7226	10842	1218	12060	22128	54.5%	16.34%	20	20
15	高雄市桃源區	2018-11-24T22:26:43+08:00	321	1232	1553	93	1646	2866	57.43%	11.2%	7	8
15	高雄市桃源區	2018-11-25T00:09:42+08:00	385	1450	1835	100	1935	3498	55.32%	11.01%	8	8
15	高雄市桃源區	2018-11-25T03:56:21+08:00	385	1450	1835	100	1935	3498	55.32%	11.01%	8	8
15	高雄市桃源區	2018-11-25T01:12:52+08:00	385	1450	1835	100	1935	3498	55.32%	11.01%	8	8
15	高雄市桃源區	2018-11-24T22:37:07+08:00	385	1450	1835	100	1935	3498	55.32%	11.01%	8	8
15	高雄市桃源區	2018-11-24T22:54:32+08:00	385	1450	1835	100	1935	3498	55.32%	11.01%	8	8
15	高雄市桃源區	2018-11-24T22:50:56+08:00	385	1450	1835	100	1935	3498	55.32%	11.01%	8	8
15	高雄市桃源區	2018-11-25T00:18:39+08:00	385	1450	1835	100	1935	3498	55.32%	11.01%	8	8
15	高雄市桃源區	2018-11-25T00:05:12+08:00	385	1450	1835	100	1935	3498	55.32%	11.01%	8	8
15	高雄市桃源區	2018-11-24T22:45:15+08:00	385	1450	1835	100	1935	3498	55.32%	11.01%	8	8
15	高雄市桃源區	2018-11-25T01:02:38+08:00	385	1450	1835	100	1935	3498	55.32%	11.01%	8	8
15	高雄市桃源區	2018-11-25T00:57:44+08:00	385	1450	1835	100	1935	3498	55.32%	11.01%	8	8
15	高雄市桃源區	2018-11-24T22:40:34+08:00	385	1450	1835	100	1935	3498	55.32%	11.01%	8	8
15	高雄市桃源區	2018-11-24T22:19:44+08:00	280	1159	1439	91	1530	2602	58.8%	10.76%	6	8
15	高雄市桃源區	2018-11-25T00:00:18+08:00	385	1450	1835	100	1935	3498	55.32%	11.01%	8	8
15	高雄市桃源區	2018-11-24T23:55:54+08:00	385	1450	1835	100	1935	3498	55.32%	11.01%	8	8
15	高雄市桃源區	2018-11-24T23:27:25+08:00	385	1450	1835	100	1935	3498	55.32%	11.01%	8	8
15	高雄市桃源區	2018-11-24T23:19:59+08:00	385	1450	1835	100	1935	3498	55.32%	11.01%	8	8
15	高雄市桃源區	2018-11-25T01:07:33+08:00	385	1450	1835	100	1935	3498	55.32%	11.01%	8	8
15	高雄市桃源區	2018-11-24T23:39:25+08:00	385	1450	1835	100	1935	3498	55.32%	11.01%	8	8
15	高雄市桃源區	2018-11-24T23:12:24+08:00	385	1450	1835	100	1935	3498	55.32%	11.01%	8	8
15	高雄市桃源區	2018-11-24T23:01:38+08:00	385	1450	1835	100	1935	3498	55.32%	11.01%	8	8
15	高雄市桃源區	2018-11-24T23:31:20+08:00	385	1450	1835	100	1935	3498	55.32%	11.01%	8	8
15	高雄市桃源區	2018-11-24T23:35:17+08:00	385	1450	1835	100	1935	3498	55.32%	11.01%	8	8
15	高雄市桃源區	2018-11-25T04:02:59+08:00	385	1450	1835	100	1935	3498	55.32%	11.01%	8	8
15	高雄市桃源區	2018-11-25T00:14:17+08:00	385	1450	1835	100	1935	3498	55.32%	11.01%	8	8
15	高雄市桃源區	2018-11-24T23:43:24+08:00	385	1450	1835	100	1935	3498	55.32%	11.01%	8	8
15	高雄市桃源區	2018-11-24T22:58:02+08:00	385	1450	1835	100	1935	3498	55.32%	11.01%	8	8
15	高雄市桃源區	2018-11-25T03:49:58+08:00	385	1450	1835	100	1935	3498	55.32%	11.01%	8	8
15	高雄市桃源區	2018-11-25T01:18:02+08:00	385	1450	1835	100	1935	3498	55.32%	11.01%	8	8
15	高雄市桃源區	2018-11-24T23:05:11+08:00	385	1450	1835	100	1935	3498	55.32%	11.01%	8	8
15	高雄市桃源區	2018-11-25T06:13:59+08:00	385	1450	1835	100	1935	3498	55.32%	11.01%	8	8
15	高雄市桃源區	2018-11-24T22:41:43+08:00	385	1450	1835	100	1935	3498	55.32%	11.01%	8	8
15	高雄市桃源區	2018-11-25T06:19:04+08:00	385	1450	1835	100	1935	3498	55.32%	11.01%	8	8
15	高雄市桃源區	2018-11-25T06:29:24+08:00	385	1450	1835	100	1935	3498	55.32%	11.01%	8	8
15	高雄市桃源區	2018-11-25T06:24:07+08:00	385	1450	1835	100	1935	3498	55.32%	11.01%	8	8
15	高雄市桃源區	2018-11-24T22:30:17+08:00	385	1450	1835	100	1935	3498	55.32%	11.01%	8	8
15	高雄市桃源區	2018-11-24T23:51:42+08:00	385	1450	1835	100	1935	3498	55.32%	11.01%	8	8
15	高雄市桃源區	2018-11-25T06:09:02+08:00	385	1450	1835	100	1935	3498	55.32%	11.01%	8	8
15	高雄市桃源區	2018-11-24T23:23:45+08:00	385	1450	1835	100	1935	3498	55.32%	11.01%	8	8
15	高雄市桃源區	2018-11-25T03:44:32+08:00	385	1450	1835	100	1935	3498	55.32%	11.01%	8	8
15	高雄市桃源區	2018-11-24T23:08:44+08:00	385	1450	1835	100	1935	3498	55.32%	11.01%	8	8
15	高雄市桃源區	2018-11-24T22:23:21+08:00	280	1159	1439	91	1530	2602	58.8%	10.76%	6	8
15	高雄市桃源區	2018-11-25T03:32:44+08:00	385	1450	1835	100	1935	3498	55.32%	11.01%	8	8
15	高雄市桃源區	2018-11-24T22:13:37+08:00	204	874	1078	78	1156	1819	63.55%	11.21%	5	8
15	高雄市桃源區	2018-11-25T00:23:11+08:00	385	1450	1835	100	1935	3498	55.32%	11.01%	8	8
15	高雄市桃源區	2018-11-24T23:16:10+08:00	385	1450	1835	100	1935	3498	55.32%	11.01%	8	8
15	高雄市桃源區	2018-11-25T01:26:00+08:00	385	1450	1835	100	1935	3498	55.32%	11.01%	8	8
15	高雄市桃源區	2018-11-24T23:47:36+08:00	385	1450	1835	100	1935	3498	55.32%	11.01%	8	8
15	高雄市桃源區	2018-11-25T03:39:01+08:00	385	1450	1835	100	1935	3498	55.32%	11.01%	8	8
15	高雄市桃源區	2018-11-24T22:33:45+08:00	385	1450	1835	100	1935	3498	55.32%	11.01%	8	8
15	高雄市桃源區	2018-11-24T22:16:18+08:00	204	874	1078	78	1156	1819	63.55%	11.21%	5	8
15	高雄市永安區	2018-11-25T01:18:01+08:00	2323	4723	7046	527	7573	12001	63.1%	19.36%	12	12
15	高雄市永安區	2018-11-24T22:58:01+08:00	1690	3390	5080	418	5498	8692	63.25%	19.44%	10	12
15	高雄市永安區	2018-11-24T22:26:43+08:00	1690	3390	5080	418	5498	8692	63.25%	19.44%	10	12
15	高雄市永安區	2018-11-25T00:09:42+08:00	2323	4723	7046	527	7573	12001	63.1%	19.36%	12	12
15	高雄市永安區	2018-11-24T22:37:07+08:00	1690	3390	5080	418	5498	8692	63.25%	19.44%	10	12
15	高雄市永安區	2018-11-24T22:54:32+08:00	1690	3390	5080	418	5498	8692	63.25%	19.44%	10	12
15	高雄市永安區	2018-11-24T22:50:56+08:00	1690	3390	5080	418	5498	8692	63.25%	19.44%	10	12
15	高雄市永安區	2018-11-25T00:18:39+08:00	2323	4723	7046	527	7573	12001	63.1%	19.36%	12	12
15	高雄市永安區	2018-11-24T22:45:14+08:00	1690	3390	5080	418	5498	8692	63.25%	19.44%	10	12
15	高雄市永安區	2018-11-25T03:56:20+08:00	2323	4723	7046	527	7573	12001	63.1%	19.36%	12	12
15	高雄市永安區	2018-11-25T00:05:12+08:00	2323	4723	7046	527	7573	12001	63.1%	19.36%	12	12
15	高雄市永安區	2018-11-24T23:16:09+08:00	2068	4135	6203	487	6690	10583	63.21%	19.54%	11	12
15	高雄市永安區	2018-11-25T01:02:38+08:00	2323	4723	7046	527	7573	12001	63.1%	19.36%	12	12
15	高雄市永安區	2018-11-25T00:57:44+08:00	2323	4723	7046	527	7573	12001	63.1%	19.36%	12	12
15	高雄市永安區	2018-11-24T22:40:34+08:00	1690	3390	5080	418	5498	8692	63.25%	19.44%	10	12
15	高雄市永安區	2018-11-25T06:09:01+08:00	2323	4723	7046	527	7573	12001	63.1%	19.36%	12	12
15	高雄市永安區	2018-11-24T22:19:43+08:00	1690	3390	5080	418	5498	8692	63.25%	19.44%	10	12
15	高雄市永安區	2018-11-24T23:55:53+08:00	2323	4723	7046	527	7573	12001	63.1%	19.36%	12	12
15	高雄市永安區	2018-11-25T03:44:31+08:00	2323	4723	7046	527	7573	12001	63.1%	19.36%	12	12
15	高雄市永安區	2018-11-24T23:19:59+08:00	2068	4135	6203	487	6690	10583	63.21%	19.54%	11	12
15	高雄市永安區	2018-11-25T00:00:17+08:00	2323	4723	7046	527	7573	12001	63.1%	19.36%	12	12
15	高雄市永安區	2018-11-24T23:27:24+08:00	2068	4135	6203	487	6690	10583	63.21%	19.54%	11	12
15	高雄市永安區	2018-11-25T01:07:33+08:00	2323	4723	7046	527	7573	12001	63.1%	19.36%	12	12
15	高雄市永安區	2018-11-24T23:31:19+08:00	2068	4135	6203	487	6690	10583	63.21%	19.54%	11	12
15	高雄市永安區	2018-11-24T23:12:23+08:00	1690	3390	5080	418	5498	8692	63.25%	19.44%	10	12
15	高雄市永安區	2018-11-24T23:39:24+08:00	2068	4135	6203	487	6690	10583	63.21%	19.54%	11	12
15	高雄市永安區	2018-11-24T23:01:38+08:00	1690	3390	5080	418	5498	8692	63.25%	19.44%	10	12
15	高雄市永安區	2018-11-24T23:35:17+08:00	2068	4135	6203	487	6690	10583	63.21%	19.54%	11	12
15	高雄市永安區	2018-11-25T04:02:59+08:00	2323	4723	7046	527	7573	12001	63.1%	19.36%	12	12
15	高雄市永安區	2018-11-25T00:14:17+08:00	2323	4723	7046	527	7573	12001	63.1%	19.36%	12	12
15	高雄市永安區	2018-11-24T23:43:23+08:00	2068	4135	6203	487	6690	10583	63.21%	19.54%	11	12
15	高雄市永安區	2018-11-25T01:12:51+08:00	2323	4723	7046	527	7573	12001	63.1%	19.36%	12	12
15	高雄市永安區	2018-11-25T06:13:59+08:00	2323	4723	7046	527	7573	12001	63.1%	19.36%	12	12
15	高雄市永安區	2018-11-24T22:41:43+08:00	1690	3390	5080	418	5498	8692	63.25%	19.44%	10	12
15	高雄市永安區	2018-11-25T03:49:57+08:00	2323	4723	7046	527	7573	12001	63.1%	19.36%	12	12
15	高雄市永安區	2018-11-24T23:05:10+08:00	1690	3390	5080	418	5498	8692	63.25%	19.44%	10	12
15	高雄市永安區	2018-11-25T06:19:04+08:00	2323	4723	7046	527	7573	12001	63.1%	19.36%	12	12
15	高雄市永安區	2018-11-25T06:29:24+08:00	2323	4723	7046	527	7573	12001	63.1%	19.36%	12	12
15	高雄市永安區	2018-11-25T06:24:07+08:00	2323	4723	7046	527	7573	12001	63.1%	19.36%	12	12
15	高雄市永安區	2018-11-24T22:30:16+08:00	1690	3390	5080	418	5498	8692	63.25%	19.44%	10	12
15	高雄市永安區	2018-11-24T23:51:42+08:00	2068	4135	6203	487	6690	10583	63.21%	19.54%	11	12
15	高雄市永安區	2018-11-24T22:13:36+08:00	1414	2790	4204	339	4543	7215	62.97%	19.6%	9	12
15	高雄市永安區	2018-11-24T23:08:44+08:00	1690	3390	5080	418	5498	8692	63.25%	19.44%	10	12
15	高雄市永安區	2018-11-24T22:23:21+08:00	1690	3390	5080	418	5498	8692	63.25%	19.44%	10	12
15	高雄市永安區	2018-11-25T03:32:44+08:00	2323	4723	7046	527	7573	12001	63.1%	19.36%	12	12
15	高雄市永安區	2018-11-24T23:23:44+08:00	2068	4135	6203	487	6690	10583	63.21%	19.54%	11	12
15	高雄市永安區	2018-11-25T00:23:11+08:00	2323	4723	7046	527	7573	12001	63.1%	19.36%	12	12
15	高雄市永安區	2018-11-25T01:26:00+08:00	2323	4723	7046	527	7573	12001	63.1%	19.36%	12	12
15	高雄市永安區	2018-11-24T23:47:36+08:00	2068	4135	6203	487	6690	10583	63.21%	19.54%	11	12
15	高雄市永安區	2018-11-25T03:39:01+08:00	2323	4723	7046	527	7573	12001	63.1%	19.36%	12	12
15	高雄市永安區	2018-11-24T22:33:45+08:00	1690	3390	5080	418	5498	8692	63.25%	19.44%	10	12
15	高雄市永安區	2018-11-24T22:16:18+08:00	1414	2790	4204	339	4543	7215	62.97%	19.6%	9	12
15	金門縣烈嶼鄉	2018-11-25T03:56:28+08:00	869	3202	4071	186	4257	11676	36.46%	7.44%	8	8
15	金門縣烈嶼鄉	2018-11-24T23:12:31+08:00	869	3202	4071	186	4257	11676	36.46%	7.44%	8	8
15	金門縣烈嶼鄉	2018-11-24T23:47:44+08:00	869	3202	4071	186	4257	11676	36.46%	7.44%	8	8
15	金門縣烈嶼鄉	2018-11-24T22:58:09+08:00	869	3202	4071	186	4257	11676	36.46%	7.44%	8	8
15	金門縣烈嶼鄉	2018-11-24T23:56:01+08:00	869	3202	4071	186	4257	11676	36.46%	7.44%	8	8
15	金門縣烈嶼鄉	2018-11-24T23:01:46+08:00	869	3202	4071	186	4257	11676	36.46%	7.44%	8	8
15	金門縣烈嶼鄉	2018-11-25T03:32:53+08:00	869	3202	4071	186	4257	11676	36.46%	7.44%	8	8
15	金門縣烈嶼鄉	2018-11-24T23:08:52+08:00	869	3202	4071	186	4257	11676	36.46%	7.44%	8	8
15	金門縣烈嶼鄉	2018-11-24T23:51:49+08:00	869	3202	4071	186	4257	11676	36.46%	7.44%	8	8
15	金門縣烈嶼鄉	2018-11-24T22:13:45+08:00	869	3202	4071	186	4257	11676	36.46%	7.44%	8	8
15	金門縣烈嶼鄉	2018-11-25T03:44:41+08:00	869	3202	4071	186	4257	11676	36.46%	7.44%	8	8
15	金門縣烈嶼鄉	2018-11-25T04:03:06+08:00	869	3202	4071	186	4257	11676	36.46%	7.44%	8	8
15	金門縣烈嶼鄉	2018-11-24T23:27:31+08:00	869	3202	4071	186	4257	11676	36.46%	7.44%	8	8
15	金門縣烈嶼鄉	2018-11-24T22:30:24+08:00	869	3202	4071	186	4257	11676	36.46%	7.44%	8	8
15	金門縣烈嶼鄉	2018-11-25T00:57:51+08:00	869	3202	4071	186	4257	11676	36.46%	7.44%	8	8
15	金門縣烈嶼鄉	2018-11-24T22:19:50+08:00	869	3202	4071	186	4257	11676	36.46%	7.44%	8	8
15	金門縣烈嶼鄉	2018-11-24T22:37:14+08:00	869	3202	4071	186	4257	11676	36.46%	7.44%	8	8
15	金門縣烈嶼鄉	2018-11-24T23:20:08+08:00	869	3202	4071	186	4257	11676	36.46%	7.44%	8	8
15	金門縣烈嶼鄉	2018-11-24T23:31:27+08:00	869	3202	4071	186	4257	11676	36.46%	7.44%	8	8
15	金門縣烈嶼鄉	2018-11-25T00:18:48+08:00	869	3202	4071	186	4257	11676	36.46%	7.44%	8	8
15	金門縣烈嶼鄉	2018-11-25T06:29:32+08:00	869	3202	4071	186	4257	11676	36.46%	7.44%	8	8
15	金門縣烈嶼鄉	2018-11-25T00:09:51+08:00	869	3202	4071	186	4257	11676	36.46%	7.44%	8	8
15	金門縣烈嶼鄉	2018-11-24T22:45:21+08:00	869	3202	4071	186	4257	11676	36.46%	7.44%	8	8
15	金門縣烈嶼鄉	2018-11-24T22:54:38+08:00	869	3202	4071	186	4257	11676	36.46%	7.44%	8	8
15	金門縣烈嶼鄉	2018-11-24T22:33:51+08:00	869	3202	4071	186	4257	11676	36.46%	7.44%	8	8
15	金門縣烈嶼鄉	2018-11-24T23:39:33+08:00	869	3202	4071	186	4257	11676	36.46%	7.44%	8	8
15	金門縣烈嶼鄉	2018-11-24T22:26:49+08:00	869	3202	4071	186	4257	11676	36.46%	7.44%	8	8
15	金門縣烈嶼鄉	2018-11-25T01:07:40+08:00	869	3202	4071	186	4257	11676	36.46%	7.44%	8	8
15	金門縣烈嶼鄉	2018-11-25T01:12:59+08:00	869	3202	4071	186	4257	11676	36.46%	7.44%	8	8
15	金門縣烈嶼鄉	2018-11-25T00:05:18+08:00	869	3202	4071	186	4257	11676	36.46%	7.44%	8	8
15	金門縣烈嶼鄉	2018-11-24T23:05:17+08:00	869	3202	4071	186	4257	11676	36.46%	7.44%	8	8
15	金門縣烈嶼鄉	2018-11-24T23:23:51+08:00	869	3202	4071	186	4257	11676	36.46%	7.44%	8	8
15	金門縣烈嶼鄉	2018-11-24T22:23:29+08:00	869	3202	4071	186	4257	11676	36.46%	7.44%	8	8
15	金門縣烈嶼鄉	2018-11-25T00:23:17+08:00	869	3202	4071	186	4257	11676	36.46%	7.44%	8	8
15	金門縣烈嶼鄉	2018-11-25T00:00:24+08:00	869	3202	4071	186	4257	11676	36.46%	7.44%	8	8
15	金門縣烈嶼鄉	2018-11-25T01:02:45+08:00	869	3202	4071	186	4257	11676	36.46%	7.44%	8	8
15	金門縣烈嶼鄉	2018-11-24T22:40:41+08:00	869	3202	4071	186	4257	11676	36.46%	7.44%	8	8
15	金門縣烈嶼鄉	2018-11-24T22:51:04+08:00	869	3202	4071	186	4257	11676	36.46%	7.44%	8	8
15	金門縣烈嶼鄉	2018-11-25T06:09:10+08:00	869	3202	4071	186	4257	11676	36.46%	7.44%	8	8
15	金門縣烈嶼鄉	2018-11-25T06:24:14+08:00	869	3202	4071	186	4257	11676	36.46%	7.44%	8	8
15	金門縣烈嶼鄉	2018-11-25T06:14:05+08:00	869	3202	4071	186	4257	11676	36.46%	7.44%	8	8
15	金門縣烈嶼鄉	2018-11-24T23:35:23+08:00	869	3202	4071	186	4257	11676	36.46%	7.44%	8	8
15	金門縣烈嶼鄉	2018-11-25T00:14:24+08:00	869	3202	4071	186	4257	11676	36.46%	7.44%	8	8
15	金門縣烈嶼鄉	2018-11-25T03:50:04+08:00	869	3202	4071	186	4257	11676	36.46%	7.44%	8	8
15	金門縣烈嶼鄉	2018-11-24T22:16:26+08:00	869	3202	4071	186	4257	11676	36.46%	7.44%	8	8
15	金門縣烈嶼鄉	2018-11-24T23:43:31+08:00	869	3202	4071	186	4257	11676	36.46%	7.44%	8	8
15	金門縣烈嶼鄉	2018-11-25T01:18:11+08:00	869	3202	4071	186	4257	11676	36.46%	7.44%	8	8
15	金門縣烈嶼鄉	2018-11-24T23:16:16+08:00	869	3202	4071	186	4257	11676	36.46%	7.44%	8	8
15	金門縣烈嶼鄉	2018-11-25T06:19:11+08:00	869	3202	4071	186	4257	11676	36.46%	7.44%	8	8
15	金門縣烈嶼鄉	2018-11-24T22:41:51+08:00	869	3202	4071	186	4257	11676	36.46%	7.44%	8	8
15	金門縣烈嶼鄉	2018-11-25T03:39:08+08:00	869	3202	4071	186	4257	11676	36.46%	7.44%	8	8
15	金門縣烈嶼鄉	2018-11-25T01:26:08+08:00	869	3202	4071	186	4257	11676	36.46%	7.44%	8	8
15	嘉義縣水上鄉	2018-11-25T01:18:06+08:00	6712	14609	21321	1928	23249	43857	53.01%	15.3%	39	39
15	嘉義縣水上鄉	2018-11-25T06:29:28+08:00	6712	14609	21321	1928	23249	43857	53.01%	15.3%	39	39
15	嘉義縣水上鄉	2018-11-24T23:43:27+08:00	5822	12563	18385	1700	20085	37360	53.76%	15.58%	35	39
15	嘉義縣水上鄉	2018-11-24T22:54:35+08:00	4151	8877	13028	1241	14269	26303	54.25%	15.78%	29	39
15	嘉義縣水上鄉	2018-11-24T23:05:14+08:00	4151	8877	13028	1241	14269	26303	54.25%	15.78%	29	39
15	嘉義縣水上鄉	2018-11-25T06:19:07+08:00	6712	14609	21321	1928	23249	43857	53.01%	15.3%	39	39
15	嘉義縣水上鄉	2018-11-25T00:05:15+08:00	6269	13576	19845	1801	21646	40616	53.29%	15.43%	37	39
15	嘉義縣水上鄉	2018-11-24T22:41:47+08:00	3401	7304	10705	997	11702	21409	54.66%	15.89%	25	39
15	嘉義縣水上鄉	2018-11-24T23:51:46+08:00	5822	12563	18385	1700	20085	37360	53.76%	15.58%	35	39
15	嘉義縣水上鄉	2018-11-25T06:09:06+08:00	6712	14609	21321	1928	23249	43857	53.01%	15.3%	39	39
15	嘉義縣水上鄉	2018-11-25T01:02:41+08:00	6712	14609	21321	1928	23249	43857	53.01%	15.3%	39	39
15	嘉義縣水上鄉	2018-11-25T00:23:14+08:00	6712	14609	21321	1928	23249	43857	53.01%	15.3%	39	39
15	嘉義縣水上鄉	2018-11-24T23:23:48+08:00	4561	9972	14533	1402	15935	29471	54.07%	15.48%	31	39
15	嘉義縣水上鄉	2018-11-25T06:24:10+08:00	6712	14609	21321	1928	23249	43857	53.01%	15.3%	39	39
15	嘉義縣水上鄉	2018-11-25T00:00:21+08:00	5822	12563	18385	1700	20085	37360	53.76%	15.58%	35	39
15	嘉義縣水上鄉	2018-11-24T22:23:25+08:00	3283	7114	10397	966	11363	20839	54.53%	15.75%	24	39
15	嘉義縣水上鄉	2018-11-24T22:51:00+08:00	3722	7956	11678	1118	12796	23466	54.53%	15.86%	27	39
15	嘉義縣水上鄉	2018-11-25T03:32:49+08:00	6712	14609	21321	1928	23249	43857	53.01%	15.3%	39	39
15	嘉義縣水上鄉	2018-11-25T03:44:37+08:00	6712	14609	21321	1928	23249	43857	53.01%	15.3%	39	39
15	嘉義縣水上鄉	2018-11-24T23:08:48+08:00	4151	8877	13028	1241	14269	26303	54.25%	15.78%	29	39
15	嘉義縣水上鄉	2018-11-24T22:16:22+08:00	3283	7114	10397	966	11363	20839	54.53%	15.75%	24	39
15	嘉義縣水上鄉	2018-11-25T01:26:04+08:00	6712	14609	21321	1928	23249	43857	53.01%	15.3%	39	39
15	嘉義縣水上鄉	2018-11-24T23:16:13+08:00	4561	9972	14533	1402	15935	29471	54.07%	15.48%	31	39
15	嘉義縣水上鄉	2018-11-24T23:35:20+08:00	5508	11908	17416	1610	19026	35373	53.79%	15.57%	34	39
15	嘉義縣水上鄉	2018-11-25T00:14:20+08:00	6269	13576	19845	1801	21646	40616	53.29%	15.43%	37	39
15	嘉義縣水上鄉	2018-11-25T03:39:05+08:00	6712	14609	21321	1928	23249	43857	53.01%	15.3%	39	39
15	嘉義縣水上鄉	2018-11-24T22:33:48+08:00	3401	7304	10705	997	11702	21409	54.66%	15.89%	25	39
15	嘉義縣水上鄉	2018-11-25T03:50:01+08:00	6712	14609	21321	1928	23249	43857	53.01%	15.3%	39	39
15	嘉義縣水上鄉	2018-11-25T01:12:56+08:00	6712	14609	21321	1928	23249	43857	53.01%	15.3%	39	39
15	嘉義縣水上鄉	2018-11-24T23:47:40+08:00	5822	12563	18385	1700	20085	37360	53.76%	15.58%	35	39
15	嘉義縣水上鄉	2018-11-24T22:58:05+08:00	4151	8877	13028	1241	14269	26303	54.25%	15.78%	29	39
15	嘉義縣水上鄉	2018-11-25T00:09:46+08:00	6269	13576	19845	1801	21646	40616	53.29%	15.43%	37	39
15	嘉義縣水上鄉	2018-11-25T03:56:25+08:00	6712	14609	21321	1928	23249	43857	53.01%	15.3%	39	39
15	嘉義縣水上鄉	2018-11-24T22:45:18+08:00	3401	7304	10705	997	11702	21409	54.66%	15.89%	25	39
15	嘉義縣水上鄉	2018-11-24T22:26:46+08:00	3401	7304	10705	997	11702	21409	54.66%	15.89%	25	39
15	嘉義縣水上鄉	2018-11-24T23:01:42+08:00	4151	8877	13028	1241	14269	26303	54.25%	15.78%	29	39
15	嘉義縣水上鄉	2018-11-24T22:13:41+08:00	3283	7114	10397	966	11363	20839	54.53%	15.75%	24	39
15	嘉義縣水上鄉	2018-11-25T04:03:03+08:00	6712	14609	21321	1928	23249	43857	53.01%	15.3%	39	39
15	嘉義縣水上鄉	2018-11-25T00:57:48+08:00	6712	14609	21321	1928	23249	43857	53.01%	15.3%	39	39
15	嘉義縣水上鄉	2018-11-24T22:19:47+08:00	3283	7114	10397	966	11363	20839	54.53%	15.75%	24	39
15	嘉義縣水上鄉	2018-11-24T22:40:37+08:00	3401	7304	10705	997	11702	21409	54.66%	15.89%	25	39
15	嘉義縣水上鄉	2018-11-24T22:30:20+08:00	3401	7304	10705	997	11702	21409	54.66%	15.89%	25	39
15	嘉義縣水上鄉	2018-11-24T23:27:28+08:00	5176	11313	16489	1564	18053	33425	54.01%	15.49%	33	39
15	嘉義縣水上鄉	2018-11-24T23:55:57+08:00	5822	12563	18385	1700	20085	37360	53.76%	15.58%	35	39
15	嘉義縣水上鄉	2018-11-25T06:14:02+08:00	6712	14609	21321	1928	23249	43857	53.01%	15.3%	39	39
15	嘉義縣水上鄉	2018-11-25T00:18:44+08:00	6432	14013	20445	1858	22303	41925	53.2%	15.34%	38	39
15	嘉義縣水上鄉	2018-11-24T23:20:03+08:00	4561	9972	14533	1402	15935	29471	54.07%	15.48%	31	39
15	嘉義縣水上鄉	2018-11-25T01:07:37+08:00	6712	14609	21321	1928	23249	43857	53.01%	15.3%	39	39
15	嘉義縣水上鄉	2018-11-24T23:12:27+08:00	4281	9220	13501	1321	14822	27263	54.37%	15.7%	30	39
15	嘉義縣水上鄉	2018-11-24T22:37:11+08:00	3401	7304	10705	997	11702	21409	54.66%	15.89%	25	39
15	嘉義縣水上鄉	2018-11-24T23:39:29+08:00	5822	12563	18385	1700	20085	37360	53.76%	15.58%	35	39
15	嘉義縣水上鄉	2018-11-24T23:31:23+08:00	5176	11313	16489	1564	18053	33425	54.01%	15.49%	33	39
15	嘉義縣朴子市	2018-11-25T01:18:06+08:00	5426	11329	16755	1428	18183	35191	51.67%	15.42%	35	35
15	嘉義縣朴子市	2018-11-25T06:29:28+08:00	5426	11329	16755	1428	18183	35191	51.67%	15.42%	35	35
15	嘉義縣朴子市	2018-11-25T01:12:55+08:00	5426	11329	16755	1428	18183	35191	51.67%	15.42%	35	35
15	嘉義縣朴子市	2018-11-24T23:05:13+08:00	4289	9061	13350	1172	14522	28252	51.4%	15.18%	29	35
15	嘉義縣朴子市	2018-11-25T06:19:07+08:00	5426	11329	16755	1428	18183	35191	51.67%	15.42%	35	35
15	嘉義縣朴子市	2018-11-25T00:05:15+08:00	5138	10806	15944	1390	17334	33712	51.42%	15.24%	34	35
15	嘉義縣朴子市	2018-11-24T22:54:34+08:00	4289	9061	13350	1172	14522	28252	51.4%	15.18%	29	35
15	嘉義縣朴子市	2018-11-24T22:41:47+08:00	4063	8533	12596	1133	13729	26581	51.65%	15.29%	28	35
15	嘉義縣朴子市	2018-11-24T23:43:26+08:00	4911	10291	15202	1318	16520	31914	51.76%	15.39%	32	35
15	嘉義縣朴子市	2018-11-24T22:50:59+08:00	4289	9061	13350	1172	14522	28252	51.4%	15.18%	29	35
15	嘉義縣朴子市	2018-11-25T01:02:41+08:00	5426	11329	16755	1428	18183	35191	51.67%	15.42%	35	35
15	嘉義縣朴子市	2018-11-25T00:23:14+08:00	5426	11329	16755	1428	18183	35191	51.67%	15.42%	35	35
15	嘉義縣朴子市	2018-11-25T03:32:48+08:00	5426	11329	16755	1428	18183	35191	51.67%	15.42%	35	35
15	嘉義縣朴子市	2018-11-24T23:23:48+08:00	4766	9930	14696	1273	15969	30974	51.56%	15.39%	31	35
15	嘉義縣朴子市	2018-11-25T06:24:10+08:00	5426	11329	16755	1428	18183	35191	51.67%	15.42%	35	35
15	嘉義縣朴子市	2018-11-25T00:00:21+08:00	5138	10806	15944	1390	17334	33712	51.42%	15.24%	34	35
15	嘉義縣朴子市	2018-11-24T22:23:25+08:00	3559	7433	10992	984	11976	22819	52.48%	15.6%	25	35
15	嘉義縣朴子市	2018-11-25T03:44:37+08:00	5426	11329	16755	1428	18183	35191	51.67%	15.42%	35	35
15	嘉義縣朴子市	2018-11-24T23:08:48+08:00	4289	9061	13350	1172	14522	28252	51.4%	15.18%	29	35
15	嘉義縣朴子市	2018-11-24T22:33:47+08:00	3686	7730	11416	1049	12465	23857	52.25%	15.45%	26	35
15	嘉義縣朴子市	2018-11-24T22:16:22+08:00	3559	7433	10992	984	11976	22819	52.48%	15.6%	25	35
15	嘉義縣朴子市	2018-11-25T01:26:03+08:00	5426	11329	16755	1428	18183	35191	51.67%	15.42%	35	35
15	嘉義縣朴子市	2018-11-25T03:39:04+08:00	5426	11329	16755	1428	18183	35191	51.67%	15.42%	35	35
15	嘉義縣朴子市	2018-11-24T23:16:13+08:00	4766	9930	14696	1273	15969	30974	51.56%	15.39%	31	35
15	嘉義縣朴子市	2018-11-25T00:14:20+08:00	5138	10806	15944	1390	17334	33712	51.42%	15.24%	34	35
15	嘉義縣朴子市	2018-11-25T03:50:01+08:00	5426	11329	16755	1428	18183	35191	51.67%	15.42%	35	35
15	嘉義縣朴子市	2018-11-24T23:35:19+08:00	4766	9930	14696	1273	15969	30974	51.56%	15.39%	31	35
15	嘉義縣朴子市	2018-11-24T23:47:40+08:00	4911	10291	15202	1318	16520	31914	51.76%	15.39%	32	35
15	嘉義縣朴子市	2018-11-24T22:45:17+08:00	4063	8533	12596	1133	13729	26581	51.65%	15.29%	28	35
15	嘉義縣朴子市	2018-11-24T22:58:05+08:00	4289	9061	13350	1172	14522	28252	51.4%	15.18%	29	35
15	嘉義縣朴子市	2018-11-25T00:09:46+08:00	5138	10806	15944	1390	17334	33712	51.42%	15.24%	34	35
15	嘉義縣朴子市	2018-11-25T03:56:24+08:00	5426	11329	16755	1428	18183	35191	51.67%	15.42%	35	35
15	嘉義縣朴子市	2018-11-24T22:26:46+08:00	3559	7433	10992	984	11976	22819	52.48%	15.6%	25	35
15	嘉義縣朴子市	2018-11-24T23:01:42+08:00	4289	9061	13350	1172	14522	28252	51.4%	15.18%	29	35
15	嘉義縣朴子市	2018-11-25T00:57:47+08:00	5426	11329	16755	1428	18183	35191	51.67%	15.42%	35	35
15	嘉義縣朴子市	2018-11-24T22:19:46+08:00	3559	7433	10992	984	11976	22819	52.48%	15.6%	25	35
15	嘉義縣朴子市	2018-11-24T22:13:41+08:00	3414	7171	10585	945	11530	22009	52.39%	15.51%	24	35
15	嘉義縣朴子市	2018-11-25T04:03:02+08:00	5426	11329	16755	1428	18183	35191	51.67%	15.42%	35	35
15	嘉義縣朴子市	2018-11-24T22:40:37+08:00	4063	8533	12596	1133	13729	26581	51.65%	15.29%	28	35
15	嘉義縣朴子市	2018-11-24T23:51:45+08:00	5138	10806	15944	1390	17334	33712	51.42%	15.24%	34	35
15	嘉義縣朴子市	2018-11-24T22:30:20+08:00	3686	7730	11416	1049	12465	23857	52.25%	15.45%	26	35
15	嘉義縣朴子市	2018-11-25T06:09:05+08:00	5426	11329	16755	1428	18183	35191	51.67%	15.42%	35	35
15	嘉義縣朴子市	2018-11-24T23:55:57+08:00	5138	10806	15944	1390	17334	33712	51.42%	15.24%	34	35
15	嘉義縣朴子市	2018-11-24T23:27:27+08:00	4766	9930	14696	1273	15969	30974	51.56%	15.39%	31	35
15	嘉義縣朴子市	2018-11-25T06:14:02+08:00	5426	11329	16755	1428	18183	35191	51.67%	15.42%	35	35
15	嘉義縣朴子市	2018-11-25T00:18:43+08:00	5426	11329	16755	1428	18183	35191	51.67%	15.42%	35	35
15	嘉義縣朴子市	2018-11-24T23:12:27+08:00	4766	9930	14696	1273	15969	30974	51.56%	15.39%	31	35
15	嘉義縣朴子市	2018-11-24T23:39:28+08:00	4911	10291	15202	1318	16520	31914	51.76%	15.39%	32	35
15	嘉義縣朴子市	2018-11-24T22:37:11+08:00	3936	8279	12215	1105	13320	25353	52.54%	15.52%	27	35
15	嘉義縣朴子市	2018-11-24T23:31:23+08:00	4766	9930	14696	1273	15969	30974	51.56%	15.39%	31	35
15	嘉義縣朴子市	2018-11-24T23:20:02+08:00	4766	9930	14696	1273	15969	30974	51.56%	15.39%	31	35
15	嘉義縣朴子市	2018-11-25T01:07:36+08:00	5426	11329	16755	1428	18183	35191	51.67%	15.42%	35	35
15	臺南市鹽水區	2018-11-25T03:49:55+08:00	3508	6307	9815	774	10589	22121	47.87%	15.86%	31	31
15	臺南市鹽水區	2018-11-24T22:41:41+08:00	3298	5880	9178	753	9931	20748	47.86%	15.9%	30	31
15	臺南市鹽水區	2018-11-24T23:16:07+08:00	3508	6307	9815	774	10589	22121	47.87%	15.86%	31	31
15	臺南市鹽水區	2018-11-25T03:56:18+08:00	3508	6307	9815	774	10589	22121	47.87%	15.86%	31	31
15	臺南市鹽水區	2018-11-24T22:45:12+08:00	3298	5880	9178	753	9931	20748	47.86%	15.9%	30	31
15	臺南市鹽水區	2018-11-24T23:43:21+08:00	3508	6307	9815	774	10589	22121	47.87%	15.86%	31	31
15	臺南市鹽水區	2018-11-25T00:18:36+08:00	3508	6307	9815	774	10589	22121	47.87%	15.86%	31	31
15	臺南市鹽水區	2018-11-24T23:51:40+08:00	3508	6307	9815	774	10589	22121	47.87%	15.86%	31	31
15	臺南市鹽水區	2018-11-24T22:40:32+08:00	3298	5880	9178	753	9931	20748	47.86%	15.9%	30	31
15	臺南市鹽水區	2018-11-25T01:25:57+08:00	3508	6307	9815	774	10589	22121	47.87%	15.86%	31	31
15	臺南市鹽水區	2018-11-25T01:02:36+08:00	3508	6307	9815	774	10589	22121	47.87%	15.86%	31	31
15	臺南市鹽水區	2018-11-24T22:30:14+08:00	3298	5880	9178	753	9931	20748	47.86%	15.9%	30	31
15	臺南市鹽水區	2018-11-25T00:23:08+08:00	3508	6307	9815	774	10589	22121	47.87%	15.86%	31	31
15	臺南市鹽水區	2018-11-25T00:57:42+08:00	3508	6307	9815	774	10589	22121	47.87%	15.86%	31	31
15	臺南市鹽水區	2018-11-25T06:24:05+08:00	3508	6307	9815	774	10589	22121	47.87%	15.86%	31	31
15	臺南市鹽水區	2018-11-24T23:27:22+08:00	3508	6307	9815	774	10589	22121	47.87%	15.86%	31	31
15	臺南市鹽水區	2018-11-24T22:57:59+08:00	3508	6307	9815	774	10589	22121	47.87%	15.86%	31	31
15	臺南市鹽水區	2018-11-24T23:19:57+08:00	3508	6307	9815	774	10589	22121	47.87%	15.86%	31	31
15	臺南市鹽水區	2018-11-25T03:32:41+08:00	3508	6307	9815	774	10589	22121	47.87%	15.86%	31	31
15	臺南市鹽水區	2018-11-24T23:08:41+08:00	3508	6307	9815	774	10589	22121	47.87%	15.86%	31	31
15	臺南市鹽水區	2018-11-24T22:13:33+08:00	3107	5532	8639	713	9352	19504	47.95%	15.93%	29	31
15	臺南市鹽水區	2018-11-25T01:17:58+08:00	3508	6307	9815	774	10589	22121	47.87%	15.86%	31	31
15	臺南市鹽水區	2018-11-24T23:39:22+08:00	3508	6307	9815	774	10589	22121	47.87%	15.86%	31	31
15	臺南市鹽水區	2018-11-25T01:12:49+08:00	3508	6307	9815	774	10589	22121	47.87%	15.86%	31	31
15	臺南市鹽水區	2018-11-25T06:08:59+08:00	3508	6307	9815	774	10589	22121	47.87%	15.86%	31	31
15	臺南市鹽水區	2018-11-24T23:31:17+08:00	3508	6307	9815	774	10589	22121	47.87%	15.86%	31	31
15	臺南市鹽水區	2018-11-24T23:47:33+08:00	3508	6307	9815	774	10589	22121	47.87%	15.86%	31	31
15	臺南市鹽水區	2018-11-24T23:05:09+08:00	3508	6307	9815	774	10589	22121	47.87%	15.86%	31	31
15	臺南市鹽水區	2018-11-24T23:01:36+08:00	3508	6307	9815	774	10589	22121	47.87%	15.86%	31	31
15	臺南市鹽水區	2018-11-25T04:02:57+08:00	3508	6307	9815	774	10589	22121	47.87%	15.86%	31	31
15	臺南市鹽水區	2018-11-25T00:05:10+08:00	3508	6307	9815	774	10589	22121	47.87%	15.86%	31	31
15	臺南市鹽水區	2018-11-25T06:19:02+08:00	3508	6307	9815	774	10589	22121	47.87%	15.86%	31	31
15	臺南市鹽水區	2018-11-25T06:29:22+08:00	3508	6307	9815	774	10589	22121	47.87%	15.86%	31	31
15	臺南市鹽水區	2018-11-24T22:54:30+08:00	3508	6307	9815	774	10589	22121	47.87%	15.86%	31	31
15	臺南市鹽水區	2018-11-25T06:13:57+08:00	3508	6307	9815	774	10589	22121	47.87%	15.86%	31	31
15	臺南市鹽水區	2018-11-24T22:50:53+08:00	3298	5880	9178	753	9931	20748	47.86%	15.9%	30	31
15	臺南市鹽水區	2018-11-24T22:37:05+08:00	3298	5880	9178	753	9931	20748	47.86%	15.9%	30	31
15	臺南市鹽水區	2018-11-24T22:26:41+08:00	3298	5880	9178	753	9931	20748	47.86%	15.9%	30	31
15	臺南市鹽水區	2018-11-24T22:19:41+08:00	3107	5532	8639	713	9352	19504	47.95%	15.93%	29	31
15	臺南市鹽水區	2018-11-25T03:38:59+08:00	3508	6307	9815	774	10589	22121	47.87%	15.86%	31	31
15	臺南市鹽水區	2018-11-25T03:44:29+08:00	3508	6307	9815	774	10589	22121	47.87%	15.86%	31	31
15	臺南市鹽水區	2018-11-24T22:23:18+08:00	3298	5880	9178	753	9931	20748	47.86%	15.9%	30	31
15	臺南市鹽水區	2018-11-25T00:00:15+08:00	3508	6307	9815	774	10589	22121	47.87%	15.86%	31	31
15	臺南市鹽水區	2018-11-24T23:23:43+08:00	3508	6307	9815	774	10589	22121	47.87%	15.86%	31	31
15	臺南市鹽水區	2018-11-24T23:55:51+08:00	3508	6307	9815	774	10589	22121	47.87%	15.86%	31	31
15	臺南市鹽水區	2018-11-24T23:35:15+08:00	3508	6307	9815	774	10589	22121	47.87%	15.86%	31	31
15	臺南市鹽水區	2018-11-24T23:12:20+08:00	3508	6307	9815	774	10589	22121	47.87%	15.86%	31	31
15	臺南市鹽水區	2018-11-25T00:14:14+08:00	3508	6307	9815	774	10589	22121	47.87%	15.86%	31	31
15	臺南市鹽水區	2018-11-24T22:16:16+08:00	3107	5532	8639	713	9352	19504	47.95%	15.93%	29	31
15	臺南市鹽水區	2018-11-25T00:09:39+08:00	3508	6307	9815	774	10589	22121	47.87%	15.86%	31	31
15	臺南市鹽水區	2018-11-25T01:07:31+08:00	3508	6307	9815	774	10589	22121	47.87%	15.86%	31	31
15	臺南市鹽水區	2018-11-24T22:33:42+08:00	3298	5880	9178	753	9931	20748	47.86%	15.9%	30	31
15	屏東縣三地門鄉	2018-11-24T22:58:06+08:00	647	1649	2296	192	2488	4467	55.7%	14.48%	8	10
15	屏東縣三地門鄉	2018-11-25T03:56:26+08:00	985	2381	3366	249	3615	6373	56.72%	15.46%	10	10
15	屏東縣三地門鄉	2018-11-24T23:05:15+08:00	647	1649	2296	192	2488	4467	55.7%	14.48%	8	10
15	屏東縣三地門鄉	2018-11-25T01:18:08+08:00	985	2381	3366	249	3615	6373	56.72%	15.46%	10	10
15	屏東縣三地門鄉	2018-11-24T23:39:30+08:00	703	1827	2530	196	2726	4925	55.35%	14.27%	9	10
15	屏東縣三地門鄉	2018-11-24T22:41:48+08:00	460	1100	1560	148	1708	3213	53.16%	14.32%	6	10
15	屏東縣三地門鄉	2018-11-25T06:29:29+08:00	985	2381	3366	249	3615	6373	56.72%	15.46%	10	10
15	屏東縣三地門鄉	2018-11-25T06:19:09+08:00	985	2381	3366	249	3615	6373	56.72%	15.46%	10	10
15	屏東縣三地門鄉	2018-11-24T23:43:28+08:00	703	1827	2530	196	2726	4925	55.35%	14.27%	9	10
15	屏東縣三地門鄉	2018-11-25T06:09:07+08:00	985	2381	3366	249	3615	6373	56.72%	15.46%	10	10
15	屏東縣三地門鄉	2018-11-24T23:51:47+08:00	703	1827	2530	196	2726	4925	55.35%	14.27%	9	10
15	屏東縣三地門鄉	2018-11-24T22:13:43+08:00	382	894	1276	78	1354	2641	51.27%	14.46%	5	10
15	屏東縣三地門鄉	2018-11-24T23:08:49+08:00	647	1649	2296	192	2488	4467	55.7%	14.48%	8	10
15	屏東縣三地門鄉	2018-11-24T22:51:01+08:00	460	1100	1560	148	1708	3213	53.16%	14.32%	6	10
15	屏東縣三地門鄉	2018-11-25T03:44:38+08:00	985	2381	3366	249	3615	6373	56.72%	15.46%	10	10
15	屏東縣三地門鄉	2018-11-25T00:23:15+08:00	703	1827	2530	196	2726	4925	55.35%	14.27%	9	10
15	屏東縣三地門鄉	2018-11-24T23:23:49+08:00	647	1649	2296	192	2488	4467	55.7%	14.48%	8	10
15	屏東縣三地門鄉	2018-11-24T22:33:49+08:00	460	1100	1560	148	1708	3213	53.16%	14.32%	6	10
15	屏東縣三地門鄉	2018-11-24T22:37:12+08:00	460	1100	1560	148	1708	3213	53.16%	14.32%	6	10
15	屏東縣三地門鄉	2018-11-24T23:16:14+08:00	647	1649	2296	192	2488	4467	55.7%	14.48%	8	10
15	屏東縣三地門鄉	2018-11-25T01:26:05+08:00	985	2381	3366	249	3615	6373	56.72%	15.46%	10	10
15	屏東縣三地門鄉	2018-11-24T22:16:23+08:00	382	894	1276	78	1354	2641	51.27%	14.46%	5	10
15	屏東縣三地門鄉	2018-11-25T00:14:21+08:00	703	1827	2530	196	2726	4925	55.35%	14.27%	9	10
15	屏東縣三地門鄉	2018-11-24T23:35:21+08:00	647	1649	2296	192	2488	4467	55.7%	14.48%	8	10
15	屏東縣三地門鄉	2018-11-24T22:45:19+08:00	460	1100	1560	148	1708	3213	53.16%	14.32%	6	10
15	屏東縣三地門鄉	2018-11-24T22:54:36+08:00	519	1332	1851	165	2016	3829	52.65%	13.55%	7	10
15	屏東縣三地門鄉	2018-11-25T00:09:48+08:00	703	1827	2530	196	2726	4925	55.35%	14.27%	9	10
15	屏東縣三地門鄉	2018-11-24T23:01:44+08:00	647	1649	2296	192	2488	4467	55.7%	14.48%	8	10
15	屏東縣三地門鄉	2018-11-24T22:26:47+08:00	460	1100	1560	148	1708	3213	53.16%	14.32%	6	10
15	屏東縣三地門鄉	2018-11-24T23:47:41+08:00	703	1827	2530	196	2726	4925	55.35%	14.27%	9	10
15	屏東縣三地門鄉	2018-11-25T01:12:57+08:00	985	2381	3366	249	3615	6373	56.72%	15.46%	10	10
15	屏東縣三地門鄉	2018-11-25T00:05:16+08:00	703	1827	2530	196	2726	4925	55.35%	14.27%	9	10
15	屏東縣三地門鄉	2018-11-25T00:57:49+08:00	985	2381	3366	249	3615	6373	56.72%	15.46%	10	10
15	屏東縣三地門鄉	2018-11-24T22:19:48+08:00	460	1100	1560	148	1708	3213	53.16%	14.32%	6	10
15	屏東縣三地門鄉	2018-11-24T22:30:21+08:00	460	1100	1560	148	1708	3213	53.16%	14.32%	6	10
15	屏東縣三地門鄉	2018-11-25T03:32:50+08:00	985	2381	3366	249	3615	6373	56.72%	15.46%	10	10
15	屏東縣三地門鄉	2018-11-25T04:03:04+08:00	985	2381	3366	249	3615	6373	56.72%	15.46%	10	10
15	屏東縣三地門鄉	2018-11-24T22:40:39+08:00	460	1100	1560	148	1708	3213	53.16%	14.32%	6	10
15	屏東縣三地門鄉	2018-11-25T01:02:42+08:00	985	2381	3366	249	3615	6373	56.72%	15.46%	10	10
15	屏東縣三地門鄉	2018-11-25T06:14:03+08:00	985	2381	3366	249	3615	6373	56.72%	15.46%	10	10
15	屏東縣三地門鄉	2018-11-24T23:55:59+08:00	703	1827	2530	196	2726	4925	55.35%	14.27%	9	10
15	屏東縣三地門鄉	2018-11-25T06:24:12+08:00	985	2381	3366	249	3615	6373	56.72%	15.46%	10	10
15	屏東縣三地門鄉	2018-11-24T22:23:26+08:00	460	1100	1560	148	1708	3213	53.16%	14.32%	6	10
15	屏東縣三地門鄉	2018-11-24T23:27:29+08:00	647	1649	2296	192	2488	4467	55.7%	14.48%	8	10
15	屏東縣三地門鄉	2018-11-25T00:00:22+08:00	703	1827	2530	196	2726	4925	55.35%	14.27%	9	10
15	屏東縣三地門鄉	2018-11-24T23:31:25+08:00	647	1649	2296	192	2488	4467	55.7%	14.48%	8	10
15	屏東縣三地門鄉	2018-11-24T23:20:04+08:00	647	1649	2296	192	2488	4467	55.7%	14.48%	8	10
15	屏東縣三地門鄉	2018-11-25T00:18:45+08:00	703	1827	2530	196	2726	4925	55.35%	14.27%	9	10
15	屏東縣三地門鄉	2018-11-25T01:07:38+08:00	985	2381	3366	249	3615	6373	56.72%	15.46%	10	10
15	屏東縣三地門鄉	2018-11-25T03:39:06+08:00	985	2381	3366	249	3615	6373	56.72%	15.46%	10	10
15	屏東縣三地門鄉	2018-11-25T03:50:02+08:00	985	2381	3366	249	3615	6373	56.72%	15.46%	10	10
15	屏東縣三地門鄉	2018-11-24T23:12:28+08:00	647	1649	2296	192	2488	4467	55.7%	14.48%	8	10
15	臺南市佳里區	2018-11-24T22:41:41+08:00	8520	16286	24806	1494	26300	50407	52.18%	16.9%	41	41
15	臺南市佳里區	2018-11-25T00:18:37+08:00	8520	16286	24806	1494	26300	50407	52.18%	16.9%	41	41
15	臺南市佳里區	2018-11-24T22:45:13+08:00	8520	16286	24806	1494	26300	50407	52.18%	16.9%	41	41
15	臺南市佳里區	2018-11-24T23:16:07+08:00	8520	16286	24806	1494	26300	50407	52.18%	16.9%	41	41
15	臺南市佳里區	2018-11-25T03:56:18+08:00	8520	16286	24806	1494	26300	50407	52.18%	16.9%	41	41
15	臺南市佳里區	2018-11-24T23:51:40+08:00	8520	16286	24806	1494	26300	50407	52.18%	16.9%	41	41
15	臺南市佳里區	2018-11-24T22:40:32+08:00	8520	16286	24806	1494	26300	50407	52.18%	16.9%	41	41
15	臺南市佳里區	2018-11-25T01:02:36+08:00	8520	16286	24806	1494	26300	50407	52.18%	16.9%	41	41
15	臺南市佳里區	2018-11-24T22:19:42+08:00	8520	16286	24806	1494	26300	50407	52.18%	16.9%	41	41
15	臺南市佳里區	2018-11-25T01:25:58+08:00	8520	16286	24806	1494	26300	50407	52.18%	16.9%	41	41
15	臺南市佳里區	2018-11-24T22:30:15+08:00	8520	16286	24806	1494	26300	50407	52.18%	16.9%	41	41
15	臺南市佳里區	2018-11-25T00:23:09+08:00	8520	16286	24806	1494	26300	50407	52.18%	16.9%	41	41
15	臺南市佳里區	2018-11-25T00:57:42+08:00	8520	16286	24806	1494	26300	50407	52.18%	16.9%	41	41
15	臺南市佳里區	2018-11-25T06:24:05+08:00	8520	16286	24806	1494	26300	50407	52.18%	16.9%	41	41
15	臺南市佳里區	2018-11-25T00:00:16+08:00	8520	16286	24806	1494	26300	50407	52.18%	16.9%	41	41
15	臺南市佳里區	2018-11-25T01:17:59+08:00	8520	16286	24806	1494	26300	50407	52.18%	16.9%	41	41
15	臺南市佳里區	2018-11-24T22:57:59+08:00	8520	16286	24806	1494	26300	50407	52.18%	16.9%	41	41
15	臺南市佳里區	2018-11-24T23:19:57+08:00	8520	16286	24806	1494	26300	50407	52.18%	16.9%	41	41
15	臺南市佳里區	2018-11-24T23:55:52+08:00	8520	16286	24806	1494	26300	50407	52.18%	16.9%	41	41
15	臺南市佳里區	2018-11-24T22:13:33+08:00	8520	16286	24806	1494	26300	50407	52.18%	16.9%	41	41
15	臺南市佳里區	2018-11-24T23:27:23+08:00	8520	16286	24806	1494	26300	50407	52.18%	16.9%	41	41
15	臺南市佳里區	2018-11-24T23:39:22+08:00	8520	16286	24806	1494	26300	50407	52.18%	16.9%	41	41
15	臺南市佳里區	2018-11-25T01:12:49+08:00	8520	16286	24806	1494	26300	50407	52.18%	16.9%	41	41
15	臺南市佳里區	2018-11-25T06:08:59+08:00	8520	16286	24806	1494	26300	50407	52.18%	16.9%	41	41
15	臺南市佳里區	2018-11-24T23:31:17+08:00	8520	16286	24806	1494	26300	50407	52.18%	16.9%	41	41
15	臺南市佳里區	2018-11-24T23:47:34+08:00	8520	16286	24806	1494	26300	50407	52.18%	16.9%	41	41
15	臺南市佳里區	2018-11-24T23:05:09+08:00	8520	16286	24806	1494	26300	50407	52.18%	16.9%	41	41
15	臺南市佳里區	2018-11-24T23:01:36+08:00	8520	16286	24806	1494	26300	50407	52.18%	16.9%	41	41
15	臺南市佳里區	2018-11-25T04:02:57+08:00	8520	16286	24806	1494	26300	50407	52.18%	16.9%	41	41
15	臺南市佳里區	2018-11-25T00:05:10+08:00	8520	16286	24806	1494	26300	50407	52.18%	16.9%	41	41
15	臺南市佳里區	2018-11-25T06:19:02+08:00	8520	16286	24806	1494	26300	50407	52.18%	16.9%	41	41
15	臺南市佳里區	2018-11-25T06:29:22+08:00	8520	16286	24806	1494	26300	50407	52.18%	16.9%	41	41
15	臺南市佳里區	2018-11-25T03:49:56+08:00	8520	16286	24806	1494	26300	50407	52.18%	16.9%	41	41
15	臺南市佳里區	2018-11-24T22:54:30+08:00	8520	16286	24806	1494	26300	50407	52.18%	16.9%	41	41
15	臺南市佳里區	2018-11-24T22:50:54+08:00	8520	16286	24806	1494	26300	50407	52.18%	16.9%	41	41
15	臺南市佳里區	2018-11-25T06:13:57+08:00	8520	16286	24806	1494	26300	50407	52.18%	16.9%	41	41
15	臺南市佳里區	2018-11-24T22:37:05+08:00	8520	16286	24806	1494	26300	50407	52.18%	16.9%	41	41
15	臺南市佳里區	2018-11-24T23:43:22+08:00	8520	16286	24806	1494	26300	50407	52.18%	16.9%	41	41
15	臺南市佳里區	2018-11-25T00:09:40+08:00	8520	16286	24806	1494	26300	50407	52.18%	16.9%	41	41
15	臺南市佳里區	2018-11-24T22:26:41+08:00	8520	16286	24806	1494	26300	50407	52.18%	16.9%	41	41
15	臺南市佳里區	2018-11-25T03:38:59+08:00	8520	16286	24806	1494	26300	50407	52.18%	16.9%	41	41
15	臺南市佳里區	2018-11-25T03:44:29+08:00	8520	16286	24806	1494	26300	50407	52.18%	16.9%	41	41
15	臺南市佳里區	2018-11-25T03:32:42+08:00	8520	16286	24806	1494	26300	50407	52.18%	16.9%	41	41
15	臺南市佳里區	2018-11-24T23:08:42+08:00	8520	16286	24806	1494	26300	50407	52.18%	16.9%	41	41
15	臺南市佳里區	2018-11-24T22:23:19+08:00	8520	16286	24806	1494	26300	50407	52.18%	16.9%	41	41
15	臺南市佳里區	2018-11-24T23:23:43+08:00	8520	16286	24806	1494	26300	50407	52.18%	16.9%	41	41
15	臺南市佳里區	2018-11-25T00:14:15+08:00	8520	16286	24806	1494	26300	50407	52.18%	16.9%	41	41
15	臺南市佳里區	2018-11-24T23:35:15+08:00	8520	16286	24806	1494	26300	50407	52.18%	16.9%	41	41
15	臺南市佳里區	2018-11-24T22:33:43+08:00	8520	16286	24806	1494	26300	50407	52.18%	16.9%	41	41
15	臺南市佳里區	2018-11-24T23:12:21+08:00	8520	16286	24806	1494	26300	50407	52.18%	16.9%	41	41
15	臺南市佳里區	2018-11-24T22:16:16+08:00	8520	16286	24806	1494	26300	50407	52.18%	16.9%	41	41
15	臺南市佳里區	2018-11-25T01:07:31+08:00	8520	16286	24806	1494	26300	50407	52.18%	16.9%	41	41
15	花蓮縣玉里鎮	2018-11-24T23:56:00+08:00	1948	5170	7118	786	7904	16053	49.24%	12.13%	19	23
15	花蓮縣玉里鎮	2018-11-24T23:05:15+08:00	1414	3536	4950	606	5556	11184	49.68%	12.64%	14	23
15	花蓮縣玉里鎮	2018-11-24T23:43:29+08:00	1825	4952	6777	755	7532	15184	49.6%	12.02%	18	23
15	花蓮縣玉里鎮	2018-11-25T01:18:09+08:00	2402	6382	8784	997	9781	20650	47.37%	11.63%	23	23
15	花蓮縣玉里鎮	2018-11-25T03:56:27+08:00	2402	6382	8784	997	9781	20650	47.37%	11.63%	23	23
15	花蓮縣玉里鎮	2018-11-25T06:19:09+08:00	2402	6382	8784	997	9781	20650	47.37%	11.63%	23	23
15	花蓮縣玉里鎮	2018-11-24T22:58:07+08:00	1274	3174	4448	574	5022	10205	49.21%	12.48%	13	23
15	花蓮縣玉里鎮	2018-11-24T22:41:49+08:00	1088	2801	3889	535	4424	8959	49.38%	12.14%	12	23
15	花蓮縣玉里鎮	2018-11-24T23:39:31+08:00	1825	4952	6777	755	7532	15184	49.6%	12.02%	18	23
15	花蓮縣玉里鎮	2018-11-24T23:47:42+08:00	1825	4952	6777	755	7532	15184	49.6%	12.02%	18	23
15	花蓮縣玉里鎮	2018-11-24T22:30:22+08:00	1088	2801	3889	535	4424	8959	49.38%	12.14%	12	23
15	花蓮縣玉里鎮	2018-11-24T23:51:47+08:00	1948	5170	7118	786	7904	16053	49.24%	12.13%	19	23
15	花蓮縣玉里鎮	2018-11-24T23:27:30+08:00	1637	4107	5744	688	6432	12961	49.63%	12.63%	16	23
15	花蓮縣玉里鎮	2018-11-25T06:09:08+08:00	2402	6382	8784	997	9781	20650	47.37%	11.63%	23	23
15	花蓮縣玉里鎮	2018-11-24T22:13:44+08:00	989	2520	3509	445	3954	8093	48.86%	12.22%	11	23
15	花蓮縣玉里鎮	2018-11-25T00:57:50+08:00	2402	6382	8784	997	9781	20650	47.37%	11.63%	23	23
15	花蓮縣玉里鎮	2018-11-25T03:44:39+08:00	2402	6382	8784	997	9781	20650	47.37%	11.63%	23	23
15	花蓮縣玉里鎮	2018-11-24T23:31:26+08:00	1637	4107	5744	688	6432	12961	49.63%	12.63%	16	23
15	花蓮縣玉里鎮	2018-11-24T22:37:13+08:00	1088	2801	3889	535	4424	8959	49.38%	12.14%	12	23
15	花蓮縣玉里鎮	2018-11-24T22:16:24+08:00	989	2520	3509	445	3954	8093	48.86%	12.22%	11	23
15	花蓮縣玉里鎮	2018-11-25T00:18:46+08:00	2047	5380	7427	858	8285	17118	48.4%	11.96%	20	23
15	花蓮縣玉里鎮	2018-11-24T23:16:15+08:00	1491	3742	5233	658	5891	11953	49.28%	12.47%	15	23
15	花蓮縣玉里鎮	2018-11-24T22:54:36+08:00	1274	3174	4448	574	5022	10205	49.21%	12.48%	13	23
15	花蓮縣玉里鎮	2018-11-25T01:12:58+08:00	2402	6382	8784	997	9781	20650	47.37%	11.63%	23	23
15	花蓮縣玉里鎮	2018-11-25T00:05:17+08:00	2047	5380	7427	858	8285	17118	48.4%	11.96%	20	23
15	花蓮縣玉里鎮	2018-11-24T22:33:50+08:00	1088	2801	3889	535	4424	8959	49.38%	12.14%	12	23
15	花蓮縣玉里鎮	2018-11-24T22:45:20+08:00	1088	2801	3889	535	4424	8959	49.38%	12.14%	12	23
15	花蓮縣玉里鎮	2018-11-24T22:26:48+08:00	989	2520	3509	445	3954	8093	48.86%	12.22%	11	23
15	花蓮縣玉里鎮	2018-11-24T23:01:45+08:00	1414	3536	4950	606	5556	11184	49.68%	12.64%	14	23
15	花蓮縣玉里鎮	2018-11-25T00:09:49+08:00	2047	5380	7427	858	8285	17118	48.4%	11.96%	20	23
15	花蓮縣玉里鎮	2018-11-25T04:03:05+08:00	2402	6382	8784	997	9781	20650	47.37%	11.63%	23	23
15	花蓮縣玉里鎮	2018-11-24T23:23:50+08:00	1491	3742	5233	658	5891	11953	49.28%	12.47%	15	23
15	花蓮縣玉里鎮	2018-11-24T22:19:49+08:00	989	2520	3509	445	3954	8093	48.86%	12.22%	11	23
15	花蓮縣玉里鎮	2018-11-24T22:40:39+08:00	1088	2801	3889	535	4424	8959	49.38%	12.14%	12	23
15	花蓮縣玉里鎮	2018-11-25T03:32:51+08:00	2402	6382	8784	997	9781	20650	47.37%	11.63%	23	23
15	花蓮縣玉里鎮	2018-11-24T23:08:50+08:00	1414	3536	4950	606	5556	11184	49.68%	12.64%	14	23
15	花蓮縣玉里鎮	2018-11-24T22:23:27+08:00	989	2520	3509	445	3954	8093	48.86%	12.22%	11	23
15	花蓮縣玉里鎮	2018-11-24T22:51:02+08:00	1274	3174	4448	574	5022	10205	49.21%	12.48%	13	23
15	花蓮縣玉里鎮	2018-11-25T06:14:04+08:00	2402	6382	8784	997	9781	20650	47.37%	11.63%	23	23
15	花蓮縣玉里鎮	2018-11-25T00:00:23+08:00	2047	5380	7427	858	8285	17118	48.4%	11.96%	20	23
15	花蓮縣玉里鎮	2018-11-25T06:24:12+08:00	2402	6382	8784	997	9781	20650	47.37%	11.63%	23	23
15	花蓮縣玉里鎮	2018-11-25T00:23:16+08:00	2112	5543	7655	872	8527	18108	47.09%	11.66%	21	23
15	花蓮縣玉里鎮	2018-11-25T01:02:43+08:00	2402	6382	8784	997	9781	20650	47.37%	11.63%	23	23
15	花蓮縣玉里鎮	2018-11-25T06:29:30+08:00	2402	6382	8784	997	9781	20650	47.37%	11.63%	23	23
15	花蓮縣玉里鎮	2018-11-24T23:12:29+08:00	1491	3742	5233	658	5891	11953	49.28%	12.47%	15	23
15	花蓮縣玉里鎮	2018-11-25T03:50:03+08:00	2402	6382	8784	997	9781	20650	47.37%	11.63%	23	23
15	花蓮縣玉里鎮	2018-11-25T01:07:39+08:00	2402	6382	8784	997	9781	20650	47.37%	11.63%	23	23
15	花蓮縣玉里鎮	2018-11-25T01:26:07+08:00	2402	6382	8784	997	9781	20650	47.37%	11.63%	23	23
15	花蓮縣玉里鎮	2018-11-25T03:39:07+08:00	2402	6382	8784	997	9781	20650	47.37%	11.63%	23	23
15	花蓮縣玉里鎮	2018-11-25T00:14:22+08:00	2047	5380	7427	858	8285	17118	48.4%	11.96%	20	23
15	花蓮縣玉里鎮	2018-11-24T23:35:22+08:00	1727	4351	6078	724	6802	13940	48.79%	12.39%	17	23
15	花蓮縣玉里鎮	2018-11-24T23:20:05+08:00	1491	3742	5233	658	5891	11953	49.28%	12.47%	15	23
15	花蓮縣卓溪鄉	2018-11-24T23:56:00+08:00	585	2002	2587	258	2845	4947	57.51%	11.83%	10	10
15	花蓮縣卓溪鄉	2018-11-24T22:58:08+08:00	477	1614	2091	221	2312	3986	58%	11.97%	8	10
15	花蓮縣卓溪鄉	2018-11-25T01:18:09+08:00	585	2002	2587	258	2845	4947	57.51%	11.83%	10	10
15	花蓮縣卓溪鄉	2018-11-25T03:56:27+08:00	585	2002	2587	258	2845	4947	57.51%	11.83%	10	10
15	花蓮縣卓溪鄉	2018-11-24T23:47:42+08:00	585	2002	2587	258	2845	4947	57.51%	11.83%	10	10
15	花蓮縣卓溪鄉	2018-11-24T23:12:30+08:00	543	1828	2371	244	2615	4519	57.87%	12.02%	9	10
15	花蓮縣卓溪鄉	2018-11-24T23:27:30+08:00	585	2002	2587	258	2845	4947	57.51%	11.83%	10	10
15	花蓮縣卓溪鄉	2018-11-25T06:09:09+08:00	585	2002	2587	258	2845	4947	57.51%	11.83%	10	10
15	花蓮縣卓溪鄉	2018-11-24T23:51:48+08:00	585	2002	2587	258	2845	4947	57.51%	11.83%	10	10
15	花蓮縣卓溪鄉	2018-11-24T22:30:23+08:00	477	1614	2091	221	2312	3986	58%	11.97%	8	10
15	花蓮縣卓溪鄉	2018-11-24T22:13:44+08:00	409	1287	1696	175	1871	3285	56.96%	12.45%	7	10
15	花蓮縣卓溪鄉	2018-11-25T03:44:40+08:00	585	2002	2587	258	2845	4947	57.51%	11.83%	10	10
15	花蓮縣卓溪鄉	2018-11-25T00:57:50+08:00	585	2002	2587	258	2845	4947	57.51%	11.83%	10	10
15	花蓮縣卓溪鄉	2018-11-24T23:20:07+08:00	585	2002	2587	258	2845	4947	57.51%	11.83%	10	10
15	花蓮縣卓溪鄉	2018-11-24T22:16:25+08:00	409	1287	1696	175	1871	3285	56.96%	12.45%	7	10
15	花蓮縣卓溪鄉	2018-11-24T23:31:26+08:00	585	2002	2587	258	2845	4947	57.51%	11.83%	10	10
15	花蓮縣卓溪鄉	2018-11-24T22:37:13+08:00	477	1614	2091	221	2312	3986	58%	11.97%	8	10
15	花蓮縣卓溪鄉	2018-11-25T00:18:46+08:00	585	2002	2587	258	2845	4947	57.51%	11.83%	10	10
15	花蓮縣卓溪鄉	2018-11-24T23:16:15+08:00	585	2002	2587	258	2845	4947	57.51%	11.83%	10	10
15	花蓮縣卓溪鄉	2018-11-25T01:12:58+08:00	585	2002	2587	258	2845	4947	57.51%	11.83%	10	10
15	花蓮縣卓溪鄉	2018-11-25T00:05:17+08:00	585	2002	2587	258	2845	4947	57.51%	11.83%	10	10
15	花蓮縣卓溪鄉	2018-11-24T23:05:16+08:00	477	1614	2091	221	2312	3986	58%	11.97%	8	10
15	花蓮縣卓溪鄉	2018-11-24T23:39:32+08:00	585	2002	2587	258	2845	4947	57.51%	11.83%	10	10
15	花蓮縣卓溪鄉	2018-11-24T22:54:37+08:00	477	1614	2091	221	2312	3986	58%	11.97%	8	10
15	花蓮縣卓溪鄉	2018-11-24T22:33:50+08:00	477	1614	2091	221	2312	3986	58%	11.97%	8	10
15	花蓮縣卓溪鄉	2018-11-24T22:45:20+08:00	477	1614	2091	221	2312	3986	58%	11.97%	8	10
15	花蓮縣卓溪鄉	2018-11-24T22:26:48+08:00	409	1287	1696	175	1871	3285	56.96%	12.45%	7	10
15	花蓮縣卓溪鄉	2018-11-24T23:01:45+08:00	477	1614	2091	221	2312	3986	58%	11.97%	8	10
15	花蓮縣卓溪鄉	2018-11-25T00:09:49+08:00	585	2002	2587	258	2845	4947	57.51%	11.83%	10	10
15	花蓮縣卓溪鄉	2018-11-25T04:03:05+08:00	585	2002	2587	258	2845	4947	57.51%	11.83%	10	10
15	花蓮縣卓溪鄉	2018-11-24T23:23:50+08:00	585	2002	2587	258	2845	4947	57.51%	11.83%	10	10
15	花蓮縣卓溪鄉	2018-11-24T22:19:49+08:00	409	1287	1696	175	1871	3285	56.96%	12.45%	7	10
15	花蓮縣卓溪鄉	2018-11-25T03:32:51+08:00	585	2002	2587	258	2845	4947	57.51%	11.83%	10	10
15	花蓮縣卓溪鄉	2018-11-24T23:08:50+08:00	543	1828	2371	244	2615	4519	57.87%	12.02%	9	10
15	花蓮縣卓溪鄉	2018-11-25T00:00:23+08:00	585	2002	2587	258	2845	4947	57.51%	11.83%	10	10
15	花蓮縣卓溪鄉	2018-11-24T22:51:03+08:00	477	1614	2091	221	2312	3986	58%	11.97%	8	10
15	花蓮縣卓溪鄉	2018-11-24T22:23:28+08:00	409	1287	1696	175	1871	3285	56.96%	12.45%	7	10
15	花蓮縣卓溪鄉	2018-11-24T22:40:40+08:00	477	1614	2091	221	2312	3986	58%	11.97%	8	10
15	花蓮縣卓溪鄉	2018-11-25T06:24:13+08:00	585	2002	2587	258	2845	4947	57.51%	11.83%	10	10
15	花蓮縣卓溪鄉	2018-11-25T01:02:44+08:00	585	2002	2587	258	2845	4947	57.51%	11.83%	10	10
15	花蓮縣卓溪鄉	2018-11-25T06:14:05+08:00	585	2002	2587	258	2845	4947	57.51%	11.83%	10	10
15	花蓮縣卓溪鄉	2018-11-25T00:23:16+08:00	585	2002	2587	258	2845	4947	57.51%	11.83%	10	10
15	花蓮縣卓溪鄉	2018-11-25T06:19:10+08:00	585	2002	2587	258	2845	4947	57.51%	11.83%	10	10
15	花蓮縣卓溪鄉	2018-11-25T06:29:30+08:00	585	2002	2587	258	2845	4947	57.51%	11.83%	10	10
15	花蓮縣卓溪鄉	2018-11-25T03:50:03+08:00	585	2002	2587	258	2845	4947	57.51%	11.83%	10	10
15	花蓮縣卓溪鄉	2018-11-25T01:07:39+08:00	585	2002	2587	258	2845	4947	57.51%	11.83%	10	10
15	花蓮縣卓溪鄉	2018-11-25T01:26:07+08:00	585	2002	2587	258	2845	4947	57.51%	11.83%	10	10
15	花蓮縣卓溪鄉	2018-11-25T03:39:07+08:00	585	2002	2587	258	2845	4947	57.51%	11.83%	10	10
15	花蓮縣卓溪鄉	2018-11-24T22:41:50+08:00	477	1614	2091	221	2312	3986	58%	11.97%	8	10
15	花蓮縣卓溪鄉	2018-11-25T00:14:22+08:00	585	2002	2587	258	2845	4947	57.51%	11.83%	10	10
15	花蓮縣卓溪鄉	2018-11-24T23:35:22+08:00	585	2002	2587	258	2845	4947	57.51%	11.83%	10	10
15	花蓮縣卓溪鄉	2018-11-24T23:43:30+08:00	585	2002	2587	258	2845	4947	57.51%	11.83%	10	10
15	高雄市岡山區	2018-11-25T01:18:01+08:00	14680	32567	47247	2620	49867	81244	61.38%	18.07%	72	72
15	高雄市岡山區	2018-11-24T22:58:01+08:00	10095	21393	31488	1827	33315	54146	61.53%	18.64%	51	72
15	高雄市岡山區	2018-11-25T00:09:42+08:00	13530	29761	43291	2476	45767	74724	61.25%	18.11%	67	72
15	高雄市岡山區	2018-11-24T22:37:07+08:00	8459	17897	26356	1593	27949	45293	61.71%	18.68%	44	72
15	高雄市岡山區	2018-11-25T00:18:39+08:00	13784	30318	44102	2511	46613	76149	61.21%	18.1%	68	72
15	高雄市岡山區	2018-11-24T22:45:14+08:00	8821	18921	27742	1639	29381	47488	61.87%	18.58%	46	72
15	高雄市岡山區	2018-11-25T03:56:20+08:00	14680	32567	47247	2620	49867	81244	61.38%	18.07%	72	72
15	高雄市岡山區	2018-11-24T22:26:42+08:00	7524	15922	23446	1429	24875	40365	61.63%	18.64%	40	72
15	高雄市岡山區	2018-11-24T23:16:09+08:00	11259	23848	35107	2005	37112	60301	61.54%	18.67%	56	72
15	高雄市岡山區	2018-11-25T01:25:59+08:00	14680	32567	47247	2620	49867	81244	61.38%	18.07%	72	72
15	高雄市岡山區	2018-11-25T00:57:44+08:00	14680	32567	47247	2620	49867	81244	61.38%	18.07%	72	72
15	高雄市岡山區	2018-11-25T01:02:37+08:00	14680	32567	47247	2620	49867	81244	61.38%	18.07%	72	72
15	高雄市岡山區	2018-11-24T22:40:33+08:00	8459	17897	26356	1593	27949	45293	61.71%	18.68%	44	72
15	高雄市岡山區	2018-11-25T06:09:01+08:00	14680	32567	47247	2620	49867	81244	61.38%	18.07%	72	72
15	高雄市岡山區	2018-11-24T22:19:43+08:00	7276	15404	22680	1389	24069	39070	61.6%	18.62%	39	72
15	高雄市岡山區	2018-11-24T23:55:53+08:00	13263	29131	42394	2411	44805	73131	61.27%	18.14%	66	72
15	高雄市岡山區	2018-11-25T03:44:31+08:00	14680	32567	47247	2620	49867	81244	61.38%	18.07%	72	72
15	高雄市岡山區	2018-11-24T23:19:59+08:00	11507	24316	35823	2065	37888	61583	61.52%	18.69%	57	72
15	高雄市岡山區	2018-11-25T00:00:17+08:00	13263	29131	42394	2411	44805	73131	61.27%	18.14%	66	72
15	高雄市岡山區	2018-11-24T23:27:24+08:00	11837	25513	37350	2130	39480	64580	61.13%	18.33%	59	72
15	高雄市岡山區	2018-11-25T01:07:33+08:00	14680	32567	47247	2620	49867	81244	61.38%	18.07%	72	72
15	高雄市岡山區	2018-11-24T23:31:19+08:00	12197	26520	38717	2209	40926	66854	61.22%	18.24%	61	72
15	高雄市岡山區	2018-11-24T23:01:37+08:00	10334	21916	32250	1866	34116	55473	61.5%	18.63%	52	72
15	高雄市岡山區	2018-11-24T23:12:23+08:00	10564	22435	32999	1909	34908	56710	61.56%	18.63%	53	72
15	高雄市岡山區	2018-11-25T00:14:16+08:00	13530	29761	43291	2476	45767	74724	61.25%	18.11%	67	72
15	高雄市岡山區	2018-11-24T23:35:16+08:00	12197	26520	38717	2209	40926	66854	61.22%	18.24%	61	72
15	高雄市岡山區	2018-11-24T23:39:24+08:00	12436	27035	39471	2241	41712	68267	61.1%	18.22%	62	72
15	高雄市岡山區	2018-11-25T04:02:59+08:00	14680	32567	47247	2620	49867	81244	61.38%	18.07%	72	72
15	高雄市岡山區	2018-11-24T23:43:23+08:00	12436	27035	39471	2241	41712	68267	61.1%	18.22%	62	72
15	高雄市岡山區	2018-11-25T01:12:51+08:00	14680	32567	47247	2620	49867	81244	61.38%	18.07%	72	72
15	高雄市岡山區	2018-11-24T22:54:31+08:00	10095	21393	31488	1827	33315	54146	61.53%	18.64%	51	72
15	高雄市岡山區	2018-11-24T22:50:55+08:00	9352	19817	29169	1716	30885	49858	61.95%	18.76%	48	72
15	高雄市岡山區	2018-11-25T06:13:59+08:00	14680	32567	47247	2620	49867	81244	61.38%	18.07%	72	72
15	高雄市岡山區	2018-11-24T22:41:43+08:00	8459	17897	26356	1593	27949	45293	61.71%	18.68%	44	72
15	高雄市岡山區	2018-11-25T03:49:57+08:00	14680	32567	47247	2620	49867	81244	61.38%	18.07%	72	72
15	高雄市岡山區	2018-11-24T23:05:10+08:00	10334	21916	32250	1866	34116	55473	61.5%	18.63%	52	72
15	高雄市岡山區	2018-11-25T06:19:03+08:00	14680	32567	47247	2620	49867	81244	61.38%	18.07%	72	72
15	高雄市岡山區	2018-11-25T06:29:24+08:00	14680	32567	47247	2620	49867	81244	61.38%	18.07%	72	72
15	高雄市岡山區	2018-11-25T00:05:11+08:00	13530	29761	43291	2476	45767	74724	61.25%	18.11%	67	72
15	高雄市岡山區	2018-11-25T06:24:06+08:00	14680	32567	47247	2620	49867	81244	61.38%	18.07%	72	72
15	高雄市岡山區	2018-11-24T22:30:16+08:00	7748	16428	24176	1473	25649	41524	61.77%	18.66%	41	72
15	高雄市岡山區	2018-11-24T23:51:42+08:00	13263	29131	42394	2411	44805	73131	61.27%	18.14%	66	72
15	高雄市岡山區	2018-11-24T22:13:36+08:00	6783	14240	21023	1325	22348	36297	61.57%	18.69%	37	72
15	高雄市岡山區	2018-11-24T23:08:44+08:00	10334	21916	32250	1866	34116	55473	61.5%	18.63%	52	72
15	高雄市岡山區	2018-11-25T00:23:10+08:00	13784	30318	44102	2511	46613	76149	61.21%	18.1%	68	72
15	高雄市岡山區	2018-11-24T22:23:21+08:00	7524	15922	23446	1429	24875	40365	61.63%	18.64%	40	72
15	高雄市岡山區	2018-11-25T03:32:44+08:00	14680	32567	47247	2620	49867	81244	61.38%	18.07%	72	72
15	高雄市岡山區	2018-11-24T23:23:44+08:00	11837	25513	37350	2130	39480	64580	61.13%	18.33%	59	72
15	高雄市岡山區	2018-11-24T22:33:44+08:00	8459	17897	26356	1593	27949	45293	61.71%	18.68%	44	72
15	高雄市岡山區	2018-11-24T23:47:36+08:00	12880	28062	40942	2342	43284	70670	61.25%	18.23%	64	72
15	高雄市岡山區	2018-11-25T03:39:01+08:00	14680	32567	47247	2620	49867	81244	61.38%	18.07%	72	72
15	高雄市岡山區	2018-11-24T22:16:18+08:00	7276	15404	22680	1389	24069	39070	61.6%	18.62%	39	72
15	高雄市前鎮區	2018-11-24T22:58:01+08:00	16537	31370	47907	3328	51235	86888	58.97%	19.03%	68	119
15	高雄市前鎮區	2018-11-24T22:45:14+08:00	14317	27050	41367	2901	44268	75055	58.98%	19.08%	60	119
15	高雄市前鎮區	2018-11-25T03:56:20+08:00	30275	58765	89040	5948	94988	161797	58.71%	18.71%	119	119
15	高雄市前鎮區	2018-11-24T22:26:42+08:00	12356	23077	35433	2599	38032	64238	59.2%	19.23%	53	119
15	高雄市前鎮區	2018-11-25T01:18:00+08:00	29728	57594	87322	5851	93173	158629	58.74%	18.74%	116	119
15	高雄市前鎮區	2018-11-24T23:16:09+08:00	20306	39202	59508	4042	63550	107842	58.93%	18.83%	83	119
15	高雄市前鎮區	2018-11-25T00:18:38+08:00	28548	55380	83928	5596	89524	152333	58.77%	18.74%	112	119
15	高雄市前鎮區	2018-11-24T22:37:06+08:00	14317	27050	41367	2901	44268	75055	58.98%	19.08%	60	119
15	高雄市前鎮區	2018-11-25T06:09:00+08:00	30275	58765	89040	5948	94988	161797	58.71%	18.71%	119	119
15	高雄市前鎮區	2018-11-25T01:25:59+08:00	29911	57983	87894	5877	93771	159711	58.71%	18.73%	117	119
15	高雄市前鎮區	2018-11-25T00:57:43+08:00	29728	57594	87322	5851	93173	158629	58.74%	18.74%	116	119
15	高雄市前鎮區	2018-11-25T01:02:37+08:00	29728	57594	87322	5851	93173	158629	58.74%	18.74%	116	119
15	高雄市前鎮區	2018-11-24T22:40:33+08:00	14317	27050	41367	2901	44268	75055	58.98%	19.08%	60	119
15	高雄市前鎮區	2018-11-24T23:51:41+08:00	26723	51887	78610	5195	83805	142519	58.8%	18.75%	106	119
15	高雄市前鎮區	2018-11-24T22:19:43+08:00	11497	21497	32994	2404	35398	59883	59.11%	19.2%	50	119
15	高雄市前鎮區	2018-11-24T23:55:53+08:00	26723	51887	78610	5195	83805	142519	58.8%	18.75%	106	119
15	高雄市前鎮區	2018-11-25T03:44:31+08:00	30275	58765	89040	5948	94988	161797	58.71%	18.71%	119	119
15	高雄市前鎮區	2018-11-25T00:00:17+08:00	26979	52345	79324	5235	84559	143903	58.76%	18.75%	107	119
15	高雄市前鎮區	2018-11-24T23:19:58+08:00	20631	39826	60457	4077	64534	109355	59.01%	18.87%	84	119
15	高雄市前鎮區	2018-11-24T23:27:24+08:00	21878	42088	63966	4304	68270	116217	58.74%	18.83%	88	119
15	高雄市前鎮區	2018-11-24T23:01:37+08:00	16964	32343	49307	3441	52748	89500	58.94%	18.95%	70	119
15	高雄市前鎮區	2018-11-24T23:12:23+08:00	19422	37010	56432	3829	60261	102121	59.01%	19.02%	79	119
15	高雄市前鎮區	2018-11-25T04:02:58+08:00	30275	58765	89040	5948	94988	161797	58.71%	18.71%	119	119
15	高雄市前鎮區	2018-11-25T00:14:16+08:00	28250	54754	83004	5517	88521	150498	58.82%	18.77%	111	119
15	高雄市前鎮區	2018-11-24T23:35:16+08:00	23017	44278	67295	4532	71827	122421	58.67%	18.8%	92	119
15	高雄市前鎮區	2018-11-24T23:39:24+08:00	24069	46478	70547	4704	75251	128086	58.75%	18.79%	96	119
15	高雄市前鎮區	2018-11-24T23:31:18+08:00	22544	43353	65897	4428	70325	119877	58.66%	18.81%	90	119
15	高雄市前鎮區	2018-11-25T01:07:32+08:00	29728	57594	87322	5851	93173	158629	58.74%	18.74%	116	119
15	高雄市前鎮區	2018-11-24T23:47:35+08:00	25823	50220	76043	5004	81047	137010	59.15%	18.85%	103	119
15	高雄市前鎮區	2018-11-24T23:43:23+08:00	25319	49018	74337	4909	79246	134173	59.06%	18.87%	101	119
15	高雄市前鎮區	2018-11-24T22:41:42+08:00	14317	27050	41367	2901	44268	75055	58.98%	19.08%	60	119
15	高雄市前鎮區	2018-11-25T01:12:51+08:00	29728	57594	87322	5851	93173	158629	58.74%	18.74%	116	119
15	高雄市前鎮區	2018-11-25T06:13:58+08:00	30275	58765	89040	5948	94988	161797	58.71%	18.71%	119	119
15	高雄市前鎮區	2018-11-24T22:54:31+08:00	16537	31370	47907	3328	51235	86888	58.97%	19.03%	68	119
15	高雄市前鎮區	2018-11-24T22:50:55+08:00	15753	29837	45590	3124	48714	82521	59.03%	19.09%	65	119
15	高雄市前鎮區	2018-11-25T00:09:41+08:00	27863	54049	81912	5441	87353	148628	58.77%	18.75%	110	119
15	高雄市前鎮區	2018-11-25T06:29:23+08:00	30275	58765	89040	5948	94988	161797	58.71%	18.71%	119	119
15	高雄市前鎮區	2018-11-25T03:49:57+08:00	30275	58765	89040	5948	94988	161797	58.71%	18.71%	119	119
15	高雄市前鎮區	2018-11-24T23:05:10+08:00	17900	34056	51956	3534	55490	93896	59.1%	19.06%	73	119
15	高雄市前鎮區	2018-11-25T06:19:03+08:00	30275	58765	89040	5948	94988	161797	58.71%	18.71%	119	119
15	高雄市前鎮區	2018-11-25T00:05:11+08:00	26979	52345	79324	5235	84559	143903	58.76%	18.75%	107	119
15	高雄市前鎮區	2018-11-25T06:24:06+08:00	30275	58765	89040	5948	94988	161797	58.71%	18.71%	119	119
15	高雄市前鎮區	2018-11-24T22:30:16+08:00	12593	23589	36182	2615	38797	65545	59.19%	19.21%	54	119
15	高雄市前鎮區	2018-11-24T22:13:36+08:00	10606	19902	30508	2243	32751	55499	59.01%	19.11%	47	119
15	高雄市前鎮區	2018-11-24T23:08:43+08:00	18625	35482	54107	3690	57797	97752	59.13%	19.05%	76	119
15	高雄市前鎮區	2018-11-24T22:23:20+08:00	11994	22511	34505	2554	37059	62643	59.16%	19.15%	52	119
15	高雄市前鎮區	2018-11-25T00:23:10+08:00	28548	55380	83928	5596	89524	152333	58.77%	18.74%	112	119
15	高雄市前鎮區	2018-11-25T03:32:43+08:00	30275	58765	89040	5948	94988	161797	58.71%	18.71%	119	119
15	高雄市前鎮區	2018-11-24T23:23:44+08:00	21198	40828	62026	4169	66195	112841	58.66%	18.79%	86	119
15	高雄市前鎮區	2018-11-24T22:33:44+08:00	13735	25813	39548	2840	42388	71901	58.95%	19.1%	58	119
15	高雄市前鎮區	2018-11-24T22:16:17+08:00	11497	21497	32994	2404	35398	59883	59.11%	19.2%	50	119
15	高雄市前鎮區	2018-11-25T03:39:01+08:00	30275	58765	89040	5948	94988	161797	58.71%	18.71%	119	119
15	基隆市安樂區	2018-11-24T23:47:44+08:00	9987	18344	28331	1296	29627	57496	51.53%	17.37%	41	49
15	基隆市安樂區	2018-11-24T22:58:09+08:00	6106	11544	17650	881	18531	35059	52.86%	17.42%	28	49
15	基隆市安樂區	2018-11-25T03:56:29+08:00	12312	22626	34938	1633	36571	70396	51.95%	17.49%	49	49
15	基隆市安樂區	2018-11-24T23:01:46+08:00	6106	11544	17650	881	18531	35059	52.86%	17.42%	28	49
15	基隆市安樂區	2018-11-25T03:32:53+08:00	12312	22626	34938	1633	36571	70396	51.95%	17.49%	49	49
15	基隆市安樂區	2018-11-24T23:08:52+08:00	6764	12827	19591	979	20570	39337	52.29%	17.2%	31	49
15	基隆市安樂區	2018-11-24T23:51:49+08:00	10409	19173	29582	1420	31002	59885	51.77%	17.38%	43	49
15	基隆市安樂區	2018-11-25T03:44:41+08:00	12312	22626	34938	1633	36571	70396	51.95%	17.49%	49	49
15	基隆市安樂區	2018-11-24T23:27:31+08:00	7948	15055	23003	1091	24094	46237	52.11%	17.19%	35	49
15	基隆市安樂區	2018-11-24T22:30:24+08:00	4806	9056	13862	727	14589	27794	52.49%	17.29%	23	49
15	基隆市安樂區	2018-11-25T04:03:07+08:00	12312	22626	34938	1633	36571	70396	51.95%	17.49%	49	49
15	基隆市安樂區	2018-11-24T22:19:51+08:00	4529	8595	13124	701	13825	26395	52.38%	17.16%	22	49
15	基隆市安樂區	2018-11-25T06:14:06+08:00	12312	22626	34938	1633	36571	70396	51.95%	17.49%	49	49
15	基隆市安樂區	2018-11-24T23:20:09+08:00	7636	14487	22123	1045	23168	44336	52.26%	17.22%	34	49
15	基隆市安樂區	2018-11-24T23:31:28+08:00	8624	15639	24263	1120	25383	48750	52.07%	17.69%	36	49
15	基隆市安樂區	2018-11-24T22:37:15+08:00	4806	9056	13862	727	14589	27794	52.49%	17.29%	23	49
15	基隆市安樂區	2018-11-25T00:18:48+08:00	11375	20867	32242	1517	33759	64996	51.94%	17.5%	46	49
15	基隆市安樂區	2018-11-25T06:29:32+08:00	12312	22626	34938	1633	36571	70396	51.95%	17.49%	49	49
15	基隆市安樂區	2018-11-24T22:45:21+08:00	5011	9480	14491	736	15227	28934	52.63%	17.32%	24	49
15	基隆市安樂區	2018-11-24T22:54:38+08:00	6106	11544	17650	881	18531	35059	52.86%	17.42%	28	49
15	基隆市安樂區	2018-11-24T23:12:32+08:00	7318	13923	21241	1020	22261	42735	52.09%	17.12%	33	49
15	基隆市安樂區	2018-11-24T22:33:51+08:00	4806	9056	13862	727	14589	27794	52.49%	17.29%	23	49
15	基隆市安樂區	2018-11-24T23:39:34+08:00	9381	17137	26518	1222	27740	53848	51.52%	17.42%	39	49
15	基隆市安樂區	2018-11-25T00:05:19+08:00	10409	19173	29582	1420	31002	59885	51.77%	17.38%	43	49
15	基隆市安樂區	2018-11-24T22:26:49+08:00	4529	8595	13124	701	13825	26395	52.38%	17.16%	22	49
15	基隆市安樂區	2018-11-25T01:07:41+08:00	12069	22177	34246	1602	35848	68996	51.96%	17.49%	48	49
15	基隆市安樂區	2018-11-24T23:05:17+08:00	6543	12397	18940	954	19894	37780	52.66%	17.32%	30	49
15	基隆市安樂區	2018-11-24T23:56:02+08:00	10409	19173	29582	1420	31002	59885	51.77%	17.38%	43	49
15	基隆市安樂區	2018-11-24T22:13:46+08:00	3923	7449	11372	621	11993	22830	52.53%	17.18%	20	49
15	基隆市安樂區	2018-11-24T23:23:51+08:00	7948	15055	23003	1091	24094	46237	52.11%	17.19%	35	49
15	基隆市安樂區	2018-11-24T22:23:29+08:00	4529	8595	13124	701	13825	26395	52.38%	17.16%	22	49
15	基隆市安樂區	2018-11-25T01:02:45+08:00	12069	22177	34246	1602	35848	68996	51.96%	17.49%	48	49
15	基隆市安樂區	2018-11-24T22:40:41+08:00	4806	9056	13862	727	14589	27794	52.49%	17.29%	23	49
15	基隆市安樂區	2018-11-25T00:57:52+08:00	12069	22177	34246	1602	35848	68996	51.96%	17.49%	48	49
15	基隆市安樂區	2018-11-24T22:51:04+08:00	5849	11002	16851	858	17709	33386	53.04%	17.52%	27	49
15	基隆市安樂區	2018-11-25T06:09:10+08:00	12312	22626	34938	1633	36571	70396	51.95%	17.49%	49	49
15	基隆市安樂區	2018-11-25T01:13:00+08:00	12069	22177	34246	1602	35848	68996	51.96%	17.49%	48	49
15	基隆市安樂區	2018-11-25T06:24:14+08:00	12312	22626	34938	1633	36571	70396	51.95%	17.49%	49	49
15	基隆市安樂區	2018-11-25T00:23:18+08:00	11736	21508	33244	1553	34797	67036	51.91%	17.51%	47	49
15	基隆市安樂區	2018-11-25T00:00:25+08:00	10409	19173	29582	1420	31002	59885	51.77%	17.38%	43	49
15	基隆市安樂區	2018-11-24T23:35:23+08:00	8922	16246	25168	1163	26331	50712	51.92%	17.59%	37	49
15	基隆市安樂區	2018-11-25T00:14:24+08:00	11015	20246	31261	1475	32736	63094	51.88%	17.46%	45	49
15	基隆市安樂區	2018-11-25T01:26:09+08:00	12312	22626	34938	1633	36571	70396	51.95%	17.49%	49	49
15	基隆市安樂區	2018-11-25T03:50:04+08:00	12312	22626	34938	1633	36571	70396	51.95%	17.49%	49	49
15	基隆市安樂區	2018-11-24T22:16:26+08:00	4529	8595	13124	701	13825	26395	52.38%	17.16%	22	49
15	基隆市安樂區	2018-11-24T23:43:31+08:00	9638	17656	27294	1234	28528	55379	51.51%	17.4%	40	49
15	基隆市安樂區	2018-11-25T01:18:11+08:00	12312	22626	34938	1633	36571	70396	51.95%	17.49%	49	49
15	基隆市安樂區	2018-11-24T23:16:16+08:00	7636	14487	22123	1045	23168	44336	52.26%	17.22%	34	49
15	基隆市安樂區	2018-11-25T00:09:52+08:00	11015	20246	31261	1475	32736	63094	51.88%	17.46%	45	49
15	基隆市安樂區	2018-11-25T06:19:11+08:00	12312	22626	34938	1633	36571	70396	51.95%	17.49%	49	49
15	基隆市安樂區	2018-11-24T22:41:51+08:00	4806	9056	13862	727	14589	27794	52.49%	17.29%	23	49
15	基隆市安樂區	2018-11-25T03:39:08+08:00	12312	22626	34938	1633	36571	70396	51.95%	17.49%	49	49
15	新竹縣湖口鄉	2018-11-24T22:26:43+08:00	3478	7840	11318	612	11930	21251	56.14%	16.37%	17	47
15	新竹縣湖口鄉	2018-11-25T00:09:42+08:00	8867	19840	28707	1429	30136	53446	56.39%	16.59%	40	47
15	新竹縣湖口鄉	2018-11-25T03:56:21+08:00	10422	23740	34162	1657	35819	63511	56.4%	16.41%	47	47
15	新竹縣湖口鄉	2018-11-25T01:12:52+08:00	10422	23740	34162	1657	35819	63511	56.4%	16.41%	47	47
15	新竹縣湖口鄉	2018-11-24T22:37:07+08:00	4479	10430	14909	817	15726	27506	57.17%	16.28%	22	47
15	新竹縣湖口鄉	2018-11-24T22:54:32+08:00	5855	12583	18438	969	19407	33958	57.15%	17.24%	27	47
15	新竹縣湖口鄉	2018-11-24T22:50:56+08:00	5615	12090	17705	932	18637	32686	57.02%	17.18%	26	47
15	新竹縣湖口鄉	2018-11-25T00:05:12+08:00	8643	19265	27908	1384	29292	52099	56.22%	16.59%	39	47
15	新竹縣湖口鄉	2018-11-24T22:45:15+08:00	5221	11133	16354	872	17226	30342	56.77%	17.21%	24	47
15	新竹縣湖口鄉	2018-11-25T01:02:38+08:00	10422	23740	34162	1657	35819	63511	56.4%	16.41%	47	47
15	新竹縣湖口鄉	2018-11-25T00:57:44+08:00	10422	23740	34162	1657	35819	63511	56.4%	16.41%	47	47
15	新竹縣湖口鄉	2018-11-24T22:40:34+08:00	4681	10918	15599	843	16442	28708	57.27%	16.31%	23	47
15	新竹縣湖口鄉	2018-11-25T04:03:00+08:00	10422	23740	34162	1657	35819	63511	56.4%	16.41%	47	47
15	新竹縣湖口鄉	2018-11-24T22:19:44+08:00	3273	7359	10632	586	11218	19745	56.81%	16.58%	16	47
15	新竹縣湖口鄉	2018-11-25T00:00:18+08:00	8643	19265	27908	1384	29292	52099	56.22%	16.59%	39	47
15	新竹縣湖口鄉	2018-11-24T23:55:54+08:00	8643	19265	27908	1384	29292	52099	56.22%	16.59%	39	47
15	新竹縣湖口鄉	2018-11-24T23:27:25+08:00	6961	15201	22162	1161	23323	40961	56.94%	16.99%	32	47
15	新竹縣湖口鄉	2018-11-24T23:19:59+08:00	6712	14617	21329	1120	22449	39456	56.9%	17.01%	31	47
15	新竹縣湖口鄉	2018-11-24T22:23:22+08:00	3478	7840	11318	612	11930	21251	56.14%	16.37%	17	47
15	新竹縣湖口鄉	2018-11-24T23:01:39+08:00	6053	13100	19153	1020	20173	35419	56.96%	17.09%	28	47
15	新竹縣湖口鄉	2018-11-25T01:07:33+08:00	10422	23740	34162	1657	35819	63511	56.4%	16.41%	47	47
15	新竹縣湖口鄉	2018-11-24T23:39:25+08:00	7992	17730	25722	1282	27004	48062	56.19%	16.63%	36	47
15	新竹縣湖口鄉	2018-11-24T23:12:24+08:00	6466	14141	20607	1091	21698	38123	56.92%	16.96%	30	47
15	新竹縣湖口鄉	2018-11-25T00:18:40+08:00	9322	20896	30218	1492	31710	56233	56.39%	16.58%	42	47
15	新竹縣湖口鄉	2018-11-25T03:39:02+08:00	10422	23740	34162	1657	35819	63511	56.4%	16.41%	47	47
15	新竹縣湖口鄉	2018-11-24T23:31:20+08:00	7485	16339	23824	1198	25022	44282	56.51%	16.9%	34	47
15	新竹縣湖口鄉	2018-11-24T23:35:17+08:00	7485	16339	23824	1198	25022	44282	56.51%	16.9%	34	47
15	新竹縣湖口鄉	2018-11-25T00:14:17+08:00	8867	19840	28707	1429	30136	53446	56.39%	16.59%	40	47
15	新竹縣湖口鄉	2018-11-24T23:43:24+08:00	8149	18146	26295	1320	27615	49112	56.23%	16.59%	37	47
15	新竹縣湖口鄉	2018-11-24T22:58:02+08:00	6053	13100	19153	1020	20173	35419	56.96%	17.09%	28	47
15	新竹縣湖口鄉	2018-11-25T03:49:58+08:00	10422	23740	34162	1657	35819	63511	56.4%	16.41%	47	47
15	新竹縣湖口鄉	2018-11-25T01:18:02+08:00	10422	23740	34162	1657	35819	63511	56.4%	16.41%	47	47
15	新竹縣湖口鄉	2018-11-25T06:29:25+08:00	10422	23740	34162	1657	35819	63511	56.4%	16.41%	47	47
15	新竹縣湖口鄉	2018-11-24T23:05:11+08:00	6286	13623	19909	1052	20961	36848	56.89%	17.06%	29	47
15	新竹縣湖口鄉	2018-11-25T06:13:59+08:00	10422	23740	34162	1657	35819	63511	56.4%	16.41%	47	47
15	新竹縣湖口鄉	2018-11-24T22:41:44+08:00	4681	10918	15599	843	16442	28708	57.27%	16.31%	23	47
15	新竹縣湖口鄉	2018-11-25T06:19:04+08:00	10422	23740	34162	1657	35819	63511	56.4%	16.41%	47	47
15	新竹縣湖口鄉	2018-11-25T06:24:07+08:00	10422	23740	34162	1657	35819	63511	56.4%	16.41%	47	47
15	新竹縣湖口鄉	2018-11-24T22:30:17+08:00	3640	8312	11952	649	12601	22333	56.42%	16.3%	18	47
15	新竹縣湖口鄉	2018-11-24T23:51:42+08:00	8442	18748	27190	1358	28548	50605	56.41%	16.68%	38	47
15	新竹縣湖口鄉	2018-11-25T06:09:02+08:00	10422	23740	34162	1657	35819	63511	56.4%	16.41%	47	47
15	新竹縣湖口鄉	2018-11-24T23:23:45+08:00	6961	15201	22162	1161	23323	40961	56.94%	16.99%	32	47
15	新竹縣湖口鄉	2018-11-25T03:44:32+08:00	10422	23740	34162	1657	35819	63511	56.4%	16.41%	47	47
15	新竹縣湖口鄉	2018-11-25T03:32:45+08:00	10422	23740	34162	1657	35819	63511	56.4%	16.41%	47	47
15	新竹縣湖口鄉	2018-11-24T22:13:38+08:00	2840	6382	9222	496	9718	17196	56.51%	16.52%	14	47
15	新竹縣湖口鄉	2018-11-24T23:08:45+08:00	6466	14141	20607	1091	21698	38123	56.92%	16.96%	30	47
15	新竹縣湖口鄉	2018-11-25T00:23:11+08:00	9322	20896	30218	1492	31710	56233	56.39%	16.58%	42	47
15	新竹縣湖口鄉	2018-11-24T23:16:10+08:00	6712	14617	21329	1120	22449	39456	56.9%	17.01%	31	47
15	新竹縣湖口鄉	2018-11-24T23:47:37+08:00	8149	18146	26295	1320	27615	49112	56.23%	16.59%	37	47
15	新竹縣湖口鄉	2018-11-24T22:16:19+08:00	3074	6881	9955	528	10483	18598	56.37%	16.53%	15	47
15	新竹縣湖口鄉	2018-11-25T01:26:00+08:00	10422	23740	34162	1657	35819	63511	56.4%	16.41%	47	47
15	新竹縣湖口鄉	2018-11-24T22:33:45+08:00	4303	9980	14283	770	15053	26403	57.01%	16.3%	21	47
15	雲林縣崙背鄉	2018-11-25T00:05:14+08:00	2880	6338	9218	927	10145	21050	48.19%	13.68%	20	20
15	雲林縣崙背鄉	2018-11-25T00:09:45+08:00	2880	6338	9218	927	10145	21050	48.19%	13.68%	20	20
15	雲林縣崙背鄉	2018-11-25T01:12:55+08:00	2880	6338	9218	927	10145	21050	48.19%	13.68%	20	20
15	雲林縣崙背鄉	2018-11-24T22:41:46+08:00	2715	5876	8591	854	9445	19830	47.63%	13.69%	19	20
15	雲林縣崙背鄉	2018-11-25T06:29:27+08:00	2880	6338	9218	927	10145	21050	48.19%	13.68%	20	20
15	雲林縣崙背鄉	2018-11-24T23:05:13+08:00	2880	6338	9218	927	10145	21050	48.19%	13.68%	20	20
15	雲林縣崙背鄉	2018-11-25T06:19:07+08:00	2880	6338	9218	927	10145	21050	48.19%	13.68%	20	20
15	雲林縣崙背鄉	2018-11-24T22:26:45+08:00	2556	5514	8070	761	8831	18354	48.11%	13.93%	18	20
15	雲林縣崙背鄉	2018-11-24T22:54:34+08:00	2880	6338	9218	927	10145	21050	48.19%	13.68%	20	20
15	雲林縣崙背鄉	2018-11-24T23:43:26+08:00	2880	6338	9218	927	10145	21050	48.19%	13.68%	20	20
15	雲林縣崙背鄉	2018-11-24T22:50:59+08:00	2880	6338	9218	927	10145	21050	48.19%	13.68%	20	20
15	雲林縣崙背鄉	2018-11-25T00:00:20+08:00	2880	6338	9218	927	10145	21050	48.19%	13.68%	20	20
15	雲林縣崙背鄉	2018-11-25T00:23:13+08:00	2880	6338	9218	927	10145	21050	48.19%	13.68%	20	20
15	雲林縣崙背鄉	2018-11-25T03:32:48+08:00	2880	6338	9218	927	10145	21050	48.19%	13.68%	20	20
15	雲林縣崙背鄉	2018-11-25T03:44:36+08:00	2880	6338	9218	927	10145	21050	48.19%	13.68%	20	20
15	雲林縣崙背鄉	2018-11-24T23:08:47+08:00	2880	6338	9218	927	10145	21050	48.19%	13.68%	20	20
15	雲林縣崙背鄉	2018-11-24T22:23:24+08:00	2456	5278	7734	730	8464	17468	48.45%	14.06%	17	20
15	雲林縣崙背鄉	2018-11-25T06:24:10+08:00	2880	6338	9218	927	10145	21050	48.19%	13.68%	20	20
15	雲林縣崙背鄉	2018-11-25T01:02:40+08:00	2880	6338	9218	927	10145	21050	48.19%	13.68%	20	20
15	雲林縣崙背鄉	2018-11-24T23:23:47+08:00	2880	6338	9218	927	10145	21050	48.19%	13.68%	20	20
15	雲林縣崙背鄉	2018-11-25T03:50:00+08:00	2880	6338	9218	927	10145	21050	48.19%	13.68%	20	20
15	雲林縣崙背鄉	2018-11-24T22:33:47+08:00	2715	5876	8591	854	9445	19830	47.63%	13.69%	19	20
15	雲林縣崙背鄉	2018-11-25T01:26:03+08:00	2880	6338	9218	927	10145	21050	48.19%	13.68%	20	20
15	雲林縣崙背鄉	2018-11-25T03:39:04+08:00	2880	6338	9218	927	10145	21050	48.19%	13.68%	20	20
15	雲林縣崙背鄉	2018-11-25T00:14:19+08:00	2880	6338	9218	927	10145	21050	48.19%	13.68%	20	20
15	雲林縣崙背鄉	2018-11-24T23:16:12+08:00	2880	6338	9218	927	10145	21050	48.19%	13.68%	20	20
15	雲林縣崙背鄉	2018-11-24T23:35:19+08:00	2880	6338	9218	927	10145	21050	48.19%	13.68%	20	20
15	雲林縣崙背鄉	2018-11-24T22:45:17+08:00	2715	5876	8591	854	9445	19830	47.63%	13.69%	19	20
15	雲林縣崙背鄉	2018-11-25T01:18:05+08:00	2880	6338	9218	927	10145	21050	48.19%	13.68%	20	20
15	雲林縣崙背鄉	2018-11-25T03:56:24+08:00	2880	6338	9218	927	10145	21050	48.19%	13.68%	20	20
15	雲林縣崙背鄉	2018-11-24T22:58:04+08:00	2880	6338	9218	927	10145	21050	48.19%	13.68%	20	20
15	雲林縣崙背鄉	2018-11-24T23:01:42+08:00	2880	6338	9218	927	10145	21050	48.19%	13.68%	20	20
15	雲林縣崙背鄉	2018-11-25T00:57:47+08:00	2880	6338	9218	927	10145	21050	48.19%	13.68%	20	20
15	雲林縣崙背鄉	2018-11-24T22:19:46+08:00	2456	5278	7734	730	8464	17468	48.45%	14.06%	17	20
15	雲林縣崙背鄉	2018-11-24T22:13:41+08:00	2456	5278	7734	730	8464	17468	48.45%	14.06%	17	20
15	雲林縣崙背鄉	2018-11-25T04:03:02+08:00	2880	6338	9218	927	10145	21050	48.19%	13.68%	20	20
15	雲林縣崙背鄉	2018-11-24T22:30:19+08:00	2715	5876	8591	854	9445	19830	47.63%	13.69%	19	20
15	雲林縣崙背鄉	2018-11-24T22:40:37+08:00	2715	5876	8591	854	9445	19830	47.63%	13.69%	19	20
15	雲林縣崙背鄉	2018-11-24T23:51:45+08:00	2880	6338	9218	927	10145	21050	48.19%	13.68%	20	20
15	雲林縣崙背鄉	2018-11-25T06:09:05+08:00	2880	6338	9218	927	10145	21050	48.19%	13.68%	20	20
15	雲林縣崙背鄉	2018-11-24T23:55:57+08:00	2880	6338	9218	927	10145	21050	48.19%	13.68%	20	20
15	雲林縣崙背鄉	2018-11-24T23:27:27+08:00	2880	6338	9218	927	10145	21050	48.19%	13.68%	20	20
15	雲林縣崙背鄉	2018-11-25T06:14:02+08:00	2880	6338	9218	927	10145	21050	48.19%	13.68%	20	20
15	雲林縣崙背鄉	2018-11-24T23:47:39+08:00	2880	6338	9218	927	10145	21050	48.19%	13.68%	20	20
15	雲林縣崙背鄉	2018-11-25T00:18:43+08:00	2880	6338	9218	927	10145	21050	48.19%	13.68%	20	20
15	雲林縣崙背鄉	2018-11-24T22:16:21+08:00	2456	5278	7734	730	8464	17468	48.45%	14.06%	17	20
15	雲林縣崙背鄉	2018-11-24T23:12:27+08:00	2880	6338	9218	927	10145	21050	48.19%	13.68%	20	20
15	雲林縣崙背鄉	2018-11-24T23:39:28+08:00	2880	6338	9218	927	10145	21050	48.19%	13.68%	20	20
15	雲林縣崙背鄉	2018-11-24T22:37:10+08:00	2715	5876	8591	854	9445	19830	47.63%	13.69%	19	20
15	雲林縣崙背鄉	2018-11-24T23:31:23+08:00	2880	6338	9218	927	10145	21050	48.19%	13.68%	20	20
15	雲林縣崙背鄉	2018-11-24T23:20:02+08:00	2880	6338	9218	927	10145	21050	48.19%	13.68%	20	20
15	雲林縣崙背鄉	2018-11-25T01:07:36+08:00	2880	6338	9218	927	10145	21050	48.19%	13.68%	20	20
15	雲林縣斗南鎮	2018-11-25T00:05:14+08:00	6583	13713	20296	1405	21701	38138	56.9%	17.26%	33	33
15	雲林縣斗南鎮	2018-11-25T06:19:06+08:00	6583	13713	20296	1405	21701	38138	56.9%	17.26%	33	33
15	雲林縣斗南鎮	2018-11-25T00:09:45+08:00	6583	13713	20296	1405	21701	38138	56.9%	17.26%	33	33
15	雲林縣斗南鎮	2018-11-24T22:41:46+08:00	4558	9756	14314	1018	15332	27446	55.86%	16.61%	26	33
15	雲林縣斗南鎮	2018-11-24T22:37:09+08:00	4558	9756	14314	1018	15332	27446	55.86%	16.61%	26	33
15	雲林縣斗南鎮	2018-11-25T06:29:27+08:00	6583	13713	20296	1405	21701	38138	56.9%	17.26%	33	33
15	雲林縣斗南鎮	2018-11-24T23:05:13+08:00	5147	10995	16142	1140	17282	30712	56.27%	16.76%	28	33
15	雲林縣斗南鎮	2018-11-24T23:01:41+08:00	5147	10995	16142	1140	17282	30712	56.27%	16.76%	28	33
15	雲林縣斗南鎮	2018-11-24T22:26:45+08:00	4262	9173	13435	949	14384	25737	55.89%	16.56%	25	33
15	雲林縣斗南鎮	2018-11-24T22:54:34+08:00	4869	10409	15278	1083	16361	29148	56.13%	16.7%	27	33
15	雲林縣斗南鎮	2018-11-25T01:12:54+08:00	6583	13713	20296	1405	21701	38138	56.9%	17.26%	33	33
15	雲林縣斗南鎮	2018-11-24T23:43:26+08:00	6583	13713	20296	1405	21701	38138	56.9%	17.26%	33	33
15	雲林縣斗南鎮	2018-11-24T22:50:59+08:00	4558	9756	14314	1018	15332	27446	55.86%	16.61%	26	33
15	雲林縣斗南鎮	2018-11-25T00:00:20+08:00	6583	13713	20296	1405	21701	38138	56.9%	17.26%	33	33
15	雲林縣斗南鎮	2018-11-25T00:23:13+08:00	6583	13713	20296	1405	21701	38138	56.9%	17.26%	33	33
15	雲林縣斗南鎮	2018-11-25T03:44:36+08:00	6583	13713	20296	1405	21701	38138	56.9%	17.26%	33	33
15	雲林縣斗南鎮	2018-11-24T23:08:47+08:00	5147	10995	16142	1140	17282	30712	56.27%	16.76%	28	33
15	雲林縣斗南鎮	2018-11-24T22:23:24+08:00	4262	9173	13435	949	14384	25737	55.89%	16.56%	25	33
15	雲林縣斗南鎮	2018-11-25T01:02:40+08:00	6583	13713	20296	1405	21701	38138	56.9%	17.26%	33	33
15	雲林縣斗南鎮	2018-11-25T06:14:01+08:00	6583	13713	20296	1405	21701	38138	56.9%	17.26%	33	33
15	雲林縣斗南鎮	2018-11-25T03:32:47+08:00	6583	13713	20296	1405	21701	38138	56.9%	17.26%	33	33
15	雲林縣斗南鎮	2018-11-24T23:23:47+08:00	6055	12627	18682	1279	19961	35275	56.59%	17.17%	31	33
15	雲林縣斗南鎮	2018-11-25T03:50:00+08:00	6583	13713	20296	1405	21701	38138	56.9%	17.26%	33	33
15	雲林縣斗南鎮	2018-11-24T22:33:47+08:00	4558	9756	14314	1018	15332	27446	55.86%	16.61%	26	33
15	雲林縣斗南鎮	2018-11-25T03:39:03+08:00	6583	13713	20296	1405	21701	38138	56.9%	17.26%	33	33
15	雲林縣斗南鎮	2018-11-25T01:26:02+08:00	6583	13713	20296	1405	21701	38138	56.9%	17.26%	33	33
15	雲林縣斗南鎮	2018-11-25T00:14:19+08:00	6583	13713	20296	1405	21701	38138	56.9%	17.26%	33	33
15	雲林縣斗南鎮	2018-11-24T23:16:12+08:00	5672	12167	17839	1234	19073	33644	56.69%	16.86%	30	33
15	雲林縣斗南鎮	2018-11-24T23:35:19+08:00	6296	13133	19429	1334	20763	36552	56.8%	17.22%	32	33
15	雲林縣斗南鎮	2018-11-24T22:45:17+08:00	4558	9756	14314	1018	15332	27446	55.86%	16.61%	26	33
15	雲林縣斗南鎮	2018-11-25T01:18:05+08:00	6583	13713	20296	1405	21701	38138	56.9%	17.26%	33	33
15	雲林縣斗南鎮	2018-11-25T03:56:23+08:00	6583	13713	20296	1405	21701	38138	56.9%	17.26%	33	33
15	雲林縣斗南鎮	2018-11-24T22:58:04+08:00	5147	10995	16142	1140	17282	30712	56.27%	16.76%	28	33
15	雲林縣斗南鎮	2018-11-25T00:57:47+08:00	6583	13713	20296	1405	21701	38138	56.9%	17.26%	33	33
15	雲林縣斗南鎮	2018-11-24T22:19:46+08:00	4262	9173	13435	949	14384	25737	55.89%	16.56%	25	33
15	雲林縣斗南鎮	2018-11-25T06:24:09+08:00	6583	13713	20296	1405	21701	38138	56.9%	17.26%	33	33
15	雲林縣斗南鎮	2018-11-25T04:03:02+08:00	6583	13713	20296	1405	21701	38138	56.9%	17.26%	33	33
15	雲林縣斗南鎮	2018-11-24T22:30:19+08:00	4262	9173	13435	949	14384	25737	55.89%	16.56%	25	33
15	雲林縣斗南鎮	2018-11-24T22:13:40+08:00	4262	9173	13435	949	14384	25737	55.89%	16.56%	25	33
15	雲林縣斗南鎮	2018-11-24T22:40:37+08:00	4558	9756	14314	1018	15332	27446	55.86%	16.61%	26	33
15	雲林縣斗南鎮	2018-11-24T23:51:45+08:00	6583	13713	20296	1405	21701	38138	56.9%	17.26%	33	33
15	雲林縣斗南鎮	2018-11-25T06:09:05+08:00	6583	13713	20296	1405	21701	38138	56.9%	17.26%	33	33
15	雲林縣斗南鎮	2018-11-24T23:27:27+08:00	6055	12627	18682	1279	19961	35275	56.59%	17.17%	31	33
15	雲林縣斗南鎮	2018-11-24T23:55:56+08:00	6583	13713	20296	1405	21701	38138	56.9%	17.26%	33	33
15	雲林縣斗南鎮	2018-11-24T23:47:39+08:00	6583	13713	20296	1405	21701	38138	56.9%	17.26%	33	33
15	雲林縣斗南鎮	2018-11-24T23:31:22+08:00	6055	12627	18682	1279	19961	35275	56.59%	17.17%	31	33
15	雲林縣斗南鎮	2018-11-24T22:16:21+08:00	4262	9173	13435	949	14384	25737	55.89%	16.56%	25	33
15	雲林縣斗南鎮	2018-11-25T00:18:42+08:00	6583	13713	20296	1405	21701	38138	56.9%	17.26%	33	33
15	雲林縣斗南鎮	2018-11-24T23:12:26+08:00	5147	10995	16142	1140	17282	30712	56.27%	16.76%	28	33
15	雲林縣斗南鎮	2018-11-24T23:39:27+08:00	6583	13713	20296	1405	21701	38138	56.9%	17.26%	33	33
15	雲林縣斗南鎮	2018-11-24T23:20:02+08:00	6055	12627	18682	1279	19961	35275	56.59%	17.17%	31	33
15	雲林縣斗南鎮	2018-11-25T01:07:36+08:00	6583	13713	20296	1405	21701	38138	56.9%	17.26%	33	33
15	屏東縣九如鄉	2018-11-24T22:58:06+08:00	2083	4165	6248	750	6998	12807	54.64%	16.26%	10	14
15	屏東縣九如鄉	2018-11-25T06:19:08+08:00	2950	6397	9347	1075	10422	19132	54.47%	15.42%	14	14
15	屏東縣九如鄉	2018-11-24T23:43:27+08:00	2950	6397	9347	1075	10422	19132	54.47%	15.42%	14	14
15	屏東縣九如鄉	2018-11-24T22:54:35+08:00	2083	4165	6248	750	6998	12807	54.64%	16.26%	10	14
15	屏東縣九如鄉	2018-11-24T22:41:48+08:00	1814	3688	5502	661	6163	11207	54.99%	16.19%	9	14
15	屏東縣九如鄉	2018-11-24T23:05:14+08:00	2318	4712	7030	798	7828	14485	54.04%	16%	11	14
15	屏東縣九如鄉	2018-11-25T06:29:29+08:00	2950	6397	9347	1075	10422	19132	54.47%	15.42%	14	14
15	屏東縣九如鄉	2018-11-25T01:18:07+08:00	2950	6397	9347	1075	10422	19132	54.47%	15.42%	14	14
15	屏東縣九如鄉	2018-11-24T22:13:42+08:00	1814	3688	5502	661	6163	11207	54.99%	16.19%	9	14
15	屏東縣九如鄉	2018-11-24T23:51:46+08:00	2950	6397	9347	1075	10422	19132	54.47%	15.42%	14	14
15	屏東縣九如鄉	2018-11-25T06:09:06+08:00	2950	6397	9347	1075	10422	19132	54.47%	15.42%	14	14
15	屏東縣九如鄉	2018-11-25T06:24:11+08:00	2950	6397	9347	1075	10422	19132	54.47%	15.42%	14	14
15	屏東縣九如鄉	2018-11-24T23:08:49+08:00	2318	4712	7030	798	7828	14485	54.04%	16%	11	14
15	屏東縣九如鄉	2018-11-24T23:23:48+08:00	2732	5655	8387	942	9329	17133	54.45%	15.95%	13	14
15	屏東縣九如鄉	2018-11-25T03:44:38+08:00	2950	6397	9347	1075	10422	19132	54.47%	15.42%	14	14
15	屏東縣九如鄉	2018-11-25T00:23:15+08:00	2950	6397	9347	1075	10422	19132	54.47%	15.42%	14	14
15	屏東縣九如鄉	2018-11-25T00:00:21+08:00	2950	6397	9347	1075	10422	19132	54.47%	15.42%	14	14
15	屏東縣九如鄉	2018-11-24T22:51:00+08:00	2083	4165	6248	750	6998	12807	54.64%	16.26%	10	14
15	屏東縣九如鄉	2018-11-25T03:32:49+08:00	2950	6397	9347	1075	10422	19132	54.47%	15.42%	14	14
15	屏東縣九如鄉	2018-11-24T22:37:12+08:00	1814	3688	5502	661	6163	11207	54.99%	16.19%	9	14
15	屏東縣九如鄉	2018-11-24T23:16:13+08:00	2732	5655	8387	942	9329	17133	54.45%	15.95%	13	14
15	屏東縣九如鄉	2018-11-24T23:35:20+08:00	2732	5655	8387	942	9329	17133	54.45%	15.95%	13	14
15	屏東縣九如鄉	2018-11-25T01:26:05+08:00	2950	6397	9347	1075	10422	19132	54.47%	15.42%	14	14
15	屏東縣九如鄉	2018-11-25T03:39:05+08:00	2950	6397	9347	1075	10422	19132	54.47%	15.42%	14	14
15	屏東縣九如鄉	2018-11-24T22:33:48+08:00	1814	3688	5502	661	6163	11207	54.99%	16.19%	9	14
15	屏東縣九如鄉	2018-11-25T03:50:01+08:00	2950	6397	9347	1075	10422	19132	54.47%	15.42%	14	14
15	屏東縣九如鄉	2018-11-24T22:16:23+08:00	1814	3688	5502	661	6163	11207	54.99%	16.19%	9	14
15	屏東縣九如鄉	2018-11-25T00:14:21+08:00	2950	6397	9347	1075	10422	19132	54.47%	15.42%	14	14
15	屏東縣九如鄉	2018-11-25T01:12:56+08:00	2950	6397	9347	1075	10422	19132	54.47%	15.42%	14	14
15	屏東縣九如鄉	2018-11-24T23:01:43+08:00	2083	4165	6248	750	6998	12807	54.64%	16.26%	10	14
15	屏東縣九如鄉	2018-11-25T03:56:25+08:00	2950	6397	9347	1075	10422	19132	54.47%	15.42%	14	14
15	屏東縣九如鄉	2018-11-24T23:47:41+08:00	2950	6397	9347	1075	10422	19132	54.47%	15.42%	14	14
15	屏東縣九如鄉	2018-11-24T22:45:18+08:00	1814	3688	5502	661	6163	11207	54.99%	16.19%	9	14
15	屏東縣九如鄉	2018-11-25T00:09:47+08:00	2950	6397	9347	1075	10422	19132	54.47%	15.42%	14	14
15	屏東縣九如鄉	2018-11-24T22:26:46+08:00	1814	3688	5502	661	6163	11207	54.99%	16.19%	9	14
15	屏東縣九如鄉	2018-11-25T00:05:16+08:00	2950	6397	9347	1075	10422	19132	54.47%	15.42%	14	14
15	屏東縣九如鄉	2018-11-24T22:30:21+08:00	1814	3688	5502	661	6163	11207	54.99%	16.19%	9	14
15	屏東縣九如鄉	2018-11-24T22:40:38+08:00	1814	3688	5502	661	6163	11207	54.99%	16.19%	9	14
15	屏東縣九如鄉	2018-11-25T04:03:03+08:00	2950	6397	9347	1075	10422	19132	54.47%	15.42%	14	14
15	屏東縣九如鄉	2018-11-25T00:57:48+08:00	2950	6397	9347	1075	10422	19132	54.47%	15.42%	14	14
15	屏東縣九如鄉	2018-11-24T22:19:47+08:00	1814	3688	5502	661	6163	11207	54.99%	16.19%	9	14
15	屏東縣九如鄉	2018-11-24T23:27:28+08:00	2732	5655	8387	942	9329	17133	54.45%	15.95%	13	14
15	屏東縣九如鄉	2018-11-25T01:02:42+08:00	2950	6397	9347	1075	10422	19132	54.47%	15.42%	14	14
15	屏東縣九如鄉	2018-11-25T06:14:03+08:00	2950	6397	9347	1075	10422	19132	54.47%	15.42%	14	14
15	屏東縣九如鄉	2018-11-24T22:23:26+08:00	1814	3688	5502	661	6163	11207	54.99%	16.19%	9	14
15	屏東縣九如鄉	2018-11-24T23:55:58+08:00	2950	6397	9347	1075	10422	19132	54.47%	15.42%	14	14
15	屏東縣九如鄉	2018-11-25T00:18:44+08:00	2950	6397	9347	1075	10422	19132	54.47%	15.42%	14	14
15	屏東縣九如鄉	2018-11-24T23:20:03+08:00	2732	5655	8387	942	9329	17133	54.45%	15.95%	13	14
15	屏東縣九如鄉	2018-11-25T01:07:37+08:00	2950	6397	9347	1075	10422	19132	54.47%	15.42%	14	14
15	屏東縣九如鄉	2018-11-24T23:39:29+08:00	2950	6397	9347	1075	10422	19132	54.47%	15.42%	14	14
15	屏東縣九如鄉	2018-11-24T23:12:28+08:00	2537	5228	7765	879	8644	15967	54.14%	15.89%	12	14
15	屏東縣九如鄉	2018-11-24T23:31:24+08:00	2732	5655	8387	942	9329	17133	54.45%	15.95%	13	14
15	屏東縣崁頂鄉	2018-11-24T22:58:06+08:00	1607	3074	4681	449	5130	9827	52.2%	16.35%	10	12
15	屏東縣崁頂鄉	2018-11-25T06:19:08+08:00	2014	3865	5879	553	6432	12270	52.42%	16.41%	12	12
15	屏東縣崁頂鄉	2018-11-25T03:56:26+08:00	2014	3865	5879	553	6432	12270	52.42%	16.41%	12	12
15	屏東縣崁頂鄉	2018-11-24T23:39:30+08:00	2014	3865	5879	553	6432	12270	52.42%	16.41%	12	12
15	屏東縣崁頂鄉	2018-11-24T22:54:35+08:00	1607	3074	4681	449	5130	9827	52.2%	16.35%	10	12
15	屏東縣崁頂鄉	2018-11-24T22:41:48+08:00	1444	2754	4198	401	4599	8823	52.13%	16.37%	9	12
15	屏東縣崁頂鄉	2018-11-24T23:05:14+08:00	1607	3074	4681	449	5130	9827	52.2%	16.35%	10	12
15	屏東縣崁頂鄉	2018-11-25T06:29:29+08:00	2014	3865	5879	553	6432	12270	52.42%	16.41%	12	12
15	屏東縣崁頂鄉	2018-11-25T01:18:07+08:00	2014	3865	5879	553	6432	12270	52.42%	16.41%	12	12
15	屏東縣崁頂鄉	2018-11-24T23:43:28+08:00	2014	3865	5879	553	6432	12270	52.42%	16.41%	12	12
15	屏東縣崁頂鄉	2018-11-25T06:09:07+08:00	2014	3865	5879	553	6432	12270	52.42%	16.41%	12	12
15	屏東縣崁頂鄉	2018-11-24T22:13:42+08:00	1444	2754	4198	401	4599	8823	52.13%	16.37%	9	12
15	屏東縣崁頂鄉	2018-11-24T23:51:46+08:00	2014	3865	5879	553	6432	12270	52.42%	16.41%	12	12
15	屏東縣崁頂鄉	2018-11-25T06:24:11+08:00	2014	3865	5879	553	6432	12270	52.42%	16.41%	12	12
15	屏東縣崁頂鄉	2018-11-24T23:08:49+08:00	1607	3074	4681	449	5130	9827	52.2%	16.35%	10	12
15	屏東縣崁頂鄉	2018-11-24T22:51:01+08:00	1607	3074	4681	449	5130	9827	52.2%	16.35%	10	12
15	屏東縣崁頂鄉	2018-11-25T03:44:38+08:00	2014	3865	5879	553	6432	12270	52.42%	16.41%	12	12
15	屏東縣崁頂鄉	2018-11-25T00:23:15+08:00	2014	3865	5879	553	6432	12270	52.42%	16.41%	12	12
15	屏東縣崁頂鄉	2018-11-24T23:23:49+08:00	1782	3439	5221	502	5723	11017	51.95%	16.18%	11	12
15	屏東縣崁頂鄉	2018-11-24T22:37:12+08:00	1444	2754	4198	401	4599	8823	52.13%	16.37%	9	12
15	屏東縣崁頂鄉	2018-11-24T23:16:14+08:00	1782	3439	5221	502	5723	11017	51.95%	16.18%	11	12
15	屏東縣崁頂鄉	2018-11-25T01:26:05+08:00	2014	3865	5879	553	6432	12270	52.42%	16.41%	12	12
15	屏東縣崁頂鄉	2018-11-25T03:39:05+08:00	2014	3865	5879	553	6432	12270	52.42%	16.41%	12	12
15	屏東縣崁頂鄉	2018-11-24T22:33:48+08:00	1444	2754	4198	401	4599	8823	52.13%	16.37%	9	12
15	屏東縣崁頂鄉	2018-11-24T22:16:23+08:00	1444	2754	4198	401	4599	8823	52.13%	16.37%	9	12
15	屏東縣崁頂鄉	2018-11-25T00:14:21+08:00	2014	3865	5879	553	6432	12270	52.42%	16.41%	12	12
15	屏東縣崁頂鄉	2018-11-24T23:35:21+08:00	2014	3865	5879	553	6432	12270	52.42%	16.41%	12	12
15	屏東縣崁頂鄉	2018-11-25T00:09:48+08:00	2014	3865	5879	553	6432	12270	52.42%	16.41%	12	12
15	屏東縣崁頂鄉	2018-11-24T23:01:44+08:00	1607	3074	4681	449	5130	9827	52.2%	16.35%	10	12
15	屏東縣崁頂鄉	2018-11-24T22:26:47+08:00	1444	2754	4198	401	4599	8823	52.13%	16.37%	9	12
15	屏東縣崁頂鄉	2018-11-24T23:47:41+08:00	2014	3865	5879	553	6432	12270	52.42%	16.41%	12	12
15	屏東縣崁頂鄉	2018-11-24T22:45:18+08:00	1607	3074	4681	449	5130	9827	52.2%	16.35%	10	12
15	屏東縣崁頂鄉	2018-11-25T01:12:57+08:00	2014	3865	5879	553	6432	12270	52.42%	16.41%	12	12
15	屏東縣崁頂鄉	2018-11-25T00:05:16+08:00	2014	3865	5879	553	6432	12270	52.42%	16.41%	12	12
15	屏東縣崁頂鄉	2018-11-25T00:57:49+08:00	2014	3865	5879	553	6432	12270	52.42%	16.41%	12	12
15	屏東縣崁頂鄉	2018-11-24T22:19:48+08:00	1444	2754	4198	401	4599	8823	52.13%	16.37%	9	12
15	屏東縣崁頂鄉	2018-11-24T22:30:21+08:00	1444	2754	4198	401	4599	8823	52.13%	16.37%	9	12
15	屏東縣崁頂鄉	2018-11-25T03:32:50+08:00	2014	3865	5879	553	6432	12270	52.42%	16.41%	12	12
15	屏東縣崁頂鄉	2018-11-24T22:40:38+08:00	1444	2754	4198	401	4599	8823	52.13%	16.37%	9	12
15	屏東縣崁頂鄉	2018-11-25T04:03:03+08:00	2014	3865	5879	553	6432	12270	52.42%	16.41%	12	12
15	屏東縣崁頂鄉	2018-11-25T01:02:42+08:00	2014	3865	5879	553	6432	12270	52.42%	16.41%	12	12
15	屏東縣崁頂鄉	2018-11-25T06:14:03+08:00	2014	3865	5879	553	6432	12270	52.42%	16.41%	12	12
15	屏東縣崁頂鄉	2018-11-24T22:23:26+08:00	1444	2754	4198	401	4599	8823	52.13%	16.37%	9	12
15	屏東縣崁頂鄉	2018-11-24T23:27:29+08:00	2014	3865	5879	553	6432	12270	52.42%	16.41%	12	12
15	屏東縣崁頂鄉	2018-11-24T23:55:58+08:00	2014	3865	5879	553	6432	12270	52.42%	16.41%	12	12
15	屏東縣崁頂鄉	2018-11-25T00:00:22+08:00	2014	3865	5879	553	6432	12270	52.42%	16.41%	12	12
15	屏東縣崁頂鄉	2018-11-24T23:20:03+08:00	1782	3439	5221	502	5723	11017	51.95%	16.18%	11	12
15	屏東縣崁頂鄉	2018-11-25T00:18:45+08:00	2014	3865	5879	553	6432	12270	52.42%	16.41%	12	12
15	屏東縣崁頂鄉	2018-11-25T01:07:38+08:00	2014	3865	5879	553	6432	12270	52.42%	16.41%	12	12
15	屏東縣崁頂鄉	2018-11-25T03:50:02+08:00	2014	3865	5879	553	6432	12270	52.42%	16.41%	12	12
15	屏東縣崁頂鄉	2018-11-24T23:12:28+08:00	1607	3074	4681	449	5130	9827	52.2%	16.35%	10	12
15	屏東縣崁頂鄉	2018-11-24T23:31:24+08:00	2014	3865	5879	553	6432	12270	52.42%	16.41%	12	12
15	臺中市東區	2018-11-25T03:56:17+08:00	11829	23874	35703	2239	37942	64291	59.02%	18.4%	49	49
15	臺中市東區	2018-11-24T23:16:06+08:00	11046	22227	33273	2087	35360	59642	59.29%	18.52%	46	49
15	臺中市東區	2018-11-25T06:29:21+08:00	11829	23874	35703	2239	37942	64291	59.02%	18.4%	49	49
15	臺中市東區	2018-11-25T03:49:55+08:00	11829	23874	35703	2239	37942	64291	59.02%	18.4%	49	49
15	臺中市東區	2018-11-25T06:19:01+08:00	11829	23874	35703	2239	37942	64291	59.02%	18.4%	49	49
15	臺中市東區	2018-11-24T22:45:12+08:00	10881	21867	32748	2034	34782	58689	59.26%	18.54%	45	49
15	臺中市東區	2018-11-24T23:43:21+08:00	11501	23259	34760	2177	36937	62441	59.16%	18.42%	48	49
15	臺中市東區	2018-11-24T22:30:13+08:00	9787	19714	29501	1833	31334	52698	59.46%	18.57%	41	49
15	臺中市東區	2018-11-25T06:24:04+08:00	11829	23874	35703	2239	37942	64291	59.02%	18.4%	49	49
15	臺中市東區	2018-11-25T03:32:38+08:00	11829	23874	35703	2239	37942	64291	59.02%	18.4%	49	49
15	臺中市東區	2018-11-25T01:25:56+08:00	11829	23874	35703	2239	37942	64291	59.02%	18.4%	49	49
15	臺中市東區	2018-11-25T00:23:07+08:00	11501	23259	34760	2177	36937	62441	59.16%	18.42%	48	49
15	臺中市東區	2018-11-24T23:51:39+08:00	11501	23259	34760	2177	36937	62441	59.16%	18.42%	48	49
15	臺中市東區	2018-11-24T23:27:22+08:00	11259	22653	33912	2135	36047	60748	59.34%	18.53%	47	49
15	臺中市東區	2018-11-24T22:13:32+08:00	9017	18169	27186	1713	28899	48579	59.49%	18.56%	38	49
15	臺中市東區	2018-11-25T01:17:57+08:00	11829	23874	35703	2239	37942	64291	59.02%	18.4%	49	49
15	臺中市東區	2018-11-24T23:08:40+08:00	11046	22227	33273	2087	35360	59642	59.29%	18.52%	46	49
15	臺中市東區	2018-11-24T22:57:58+08:00	11046	22227	33273	2087	35360	59642	59.29%	18.52%	46	49
15	臺中市東區	2018-11-25T06:08:57+08:00	11829	23874	35703	2239	37942	64291	59.02%	18.4%	49	49
15	臺中市東區	2018-11-24T22:54:29+08:00	11046	22227	33273	2087	35360	59642	59.29%	18.52%	46	49
15	臺中市東區	2018-11-25T04:02:56+08:00	11829	23874	35703	2239	37942	64291	59.02%	18.4%	49	49
15	臺中市東區	2018-11-24T22:16:15+08:00	9282	18688	27970	1738	29708	50060	59.34%	18.54%	39	49
15	臺中市東區	2018-11-24T23:31:16+08:00	11501	23259	34760	2177	36937	62441	59.16%	18.42%	48	49
15	臺中市東區	2018-11-25T01:12:48+08:00	11829	23874	35703	2239	37942	64291	59.02%	18.4%	49	49
15	臺中市東區	2018-11-24T22:33:41+08:00	10048	20232	30280	1896	32176	54189	59.38%	18.54%	42	49
15	臺中市東區	2018-11-24T23:05:08+08:00	11046	22227	33273	2087	35360	59642	59.29%	18.52%	46	49
15	臺中市東區	2018-11-24T23:47:32+08:00	11501	23259	34760	2177	36937	62441	59.16%	18.42%	48	49
15	臺中市東區	2018-11-24T22:41:39+08:00	10881	21867	32748	2034	34782	58689	59.26%	18.54%	45	49
15	臺中市東區	2018-11-25T00:05:09+08:00	11501	23259	34760	2177	36937	62441	59.16%	18.42%	48	49
15	臺中市東區	2018-11-24T22:37:04+08:00	10296	20717	31013	1934	32947	55575	59.28%	18.53%	43	49
15	臺中市東區	2018-11-24T22:50:52+08:00	10881	21867	32748	2034	34782	58689	59.26%	18.54%	45	49
15	臺中市東區	2018-11-25T06:13:56+08:00	11829	23874	35703	2239	37942	64291	59.02%	18.4%	49	49
15	臺中市東區	2018-11-24T22:26:40+08:00	9787	19714	29501	1833	31334	52698	59.46%	18.57%	41	49
15	臺中市東區	2018-11-25T00:18:35+08:00	11501	23259	34760	2177	36937	62441	59.16%	18.42%	48	49
15	臺中市東區	2018-11-24T22:40:31+08:00	10881	21867	32748	2034	34782	58689	59.26%	18.54%	45	49
15	臺中市東區	2018-11-25T01:02:35+08:00	11829	23874	35703	2239	37942	64291	59.02%	18.4%	49	49
15	臺中市東區	2018-11-25T00:57:41+08:00	11829	23874	35703	2239	37942	64291	59.02%	18.4%	49	49
15	臺中市東區	2018-11-24T22:19:40+08:00	9282	18688	27970	1738	29708	50060	59.34%	18.54%	39	49
15	臺中市東區	2018-11-25T03:38:58+08:00	11829	23874	35703	2239	37942	64291	59.02%	18.4%	49	49
15	臺中市東區	2018-11-25T03:44:28+08:00	11829	23874	35703	2239	37942	64291	59.02%	18.4%	49	49
15	臺中市東區	2018-11-24T23:23:42+08:00	11259	22653	33912	2135	36047	60748	59.34%	18.53%	47	49
15	臺中市東區	2018-11-24T22:23:17+08:00	9787	19714	29501	1833	31334	52698	59.46%	18.57%	41	49
15	臺中市東區	2018-11-24T23:19:55+08:00	11259	22653	33912	2135	36047	60748	59.34%	18.53%	47	49
15	臺中市東區	2018-11-24T23:55:51+08:00	11501	23259	34760	2177	36937	62441	59.16%	18.42%	48	49
15	臺中市東區	2018-11-25T00:00:14+08:00	11501	23259	34760	2177	36937	62441	59.16%	18.42%	48	49
15	臺中市東區	2018-11-24T23:39:21+08:00	11501	23259	34760	2177	36937	62441	59.16%	18.42%	48	49
15	臺中市東區	2018-11-25T01:07:30+08:00	11829	23874	35703	2239	37942	64291	59.02%	18.4%	49	49
15	臺中市東區	2018-11-25T00:09:38+08:00	11501	23259	34760	2177	36937	62441	59.16%	18.42%	48	49
15	臺中市東區	2018-11-24T23:35:14+08:00	11501	23259	34760	2177	36937	62441	59.16%	18.42%	48	49
15	臺中市東區	2018-11-25T00:14:14+08:00	11501	23259	34760	2177	36937	62441	59.16%	18.42%	48	49
15	臺中市東區	2018-11-24T23:01:35+08:00	11046	22227	33273	2087	35360	59642	59.29%	18.52%	46	49
15	臺中市東區	2018-11-24T23:12:19+08:00	11046	22227	33273	2087	35360	59642	59.29%	18.52%	46	49
15	臺中市清水區	2018-11-25T03:56:17+08:00	12574	26528	39102	2788	41890	71528	58.56%	17.58%	59	59
15	臺中市清水區	2018-11-25T06:29:21+08:00	12574	26528	39102	2788	41890	71528	58.56%	17.58%	59	59
15	臺中市清水區	2018-11-25T03:49:55+08:00	12574	26528	39102	2788	41890	71528	58.56%	17.58%	59	59
15	臺中市清水區	2018-11-25T06:19:01+08:00	12574	26528	39102	2788	41890	71528	58.56%	17.58%	59	59
15	臺中市清水區	2018-11-24T23:16:07+08:00	12377	26166	38543	2760	41303	70452	58.63%	17.57%	58	59
15	臺中市清水區	2018-11-24T22:45:12+08:00	12163	25445	37608	2735	40343	68843	58.6%	17.67%	57	59
15	臺中市清水區	2018-11-24T23:43:21+08:00	12574	26528	39102	2788	41890	71528	58.56%	17.58%	59	59
15	臺中市清水區	2018-11-24T22:41:40+08:00	11902	24877	36779	2729	39508	67319	58.69%	17.68%	56	59
15	臺中市清水區	2018-11-25T01:25:57+08:00	12574	26528	39102	2788	41890	71528	58.56%	17.58%	59	59
15	臺中市清水區	2018-11-24T22:30:14+08:00	11666	24436	36102	2661	38763	66108	58.64%	17.65%	55	59
15	臺中市清水區	2018-11-25T06:24:04+08:00	12574	26528	39102	2788	41890	71528	58.56%	17.58%	59	59
15	臺中市清水區	2018-11-25T00:23:07+08:00	12574	26528	39102	2788	41890	71528	58.56%	17.58%	59	59
15	臺中市清水區	2018-11-25T03:32:39+08:00	12574	26528	39102	2788	41890	71528	58.56%	17.58%	59	59
15	臺中市清水區	2018-11-24T23:51:39+08:00	12574	26528	39102	2788	41890	71528	58.56%	17.58%	59	59
15	臺中市清水區	2018-11-24T23:27:22+08:00	12574	26528	39102	2788	41890	71528	58.56%	17.58%	59	59
15	臺中市清水區	2018-11-24T22:13:32+08:00	11382	23878	35260	2636	37896	64732	58.54%	17.58%	54	59
15	臺中市清水區	2018-11-24T23:08:41+08:00	12377	26166	38543	2760	41303	70452	58.63%	17.57%	58	59
15	臺中市清水區	2018-11-24T22:57:58+08:00	12377	26166	38543	2760	41303	70452	58.63%	17.57%	58	59
15	臺中市清水區	2018-11-24T23:19:56+08:00	12574	26528	39102	2788	41890	71528	58.56%	17.58%	59	59
15	臺中市清水區	2018-11-25T01:17:58+08:00	12574	26528	39102	2788	41890	71528	58.56%	17.58%	59	59
15	臺中市清水區	2018-11-24T22:54:29+08:00	12377	26166	38543	2760	41303	70452	58.63%	17.57%	58	59
15	臺中市清水區	2018-11-24T23:47:33+08:00	12574	26528	39102	2788	41890	71528	58.56%	17.58%	59	59
15	臺中市清水區	2018-11-25T04:02:56+08:00	12574	26528	39102	2788	41890	71528	58.56%	17.58%	59	59
15	臺中市清水區	2018-11-25T06:08:58+08:00	12574	26528	39102	2788	41890	71528	58.56%	17.58%	59	59
15	臺中市清水區	2018-11-24T22:16:15+08:00	11382	23878	35260	2636	37896	64732	58.54%	17.58%	54	59
15	臺中市清水區	2018-11-24T23:31:16+08:00	12574	26528	39102	2788	41890	71528	58.56%	17.58%	59	59
15	臺中市清水區	2018-11-25T01:12:48+08:00	12574	26528	39102	2788	41890	71528	58.56%	17.58%	59	59
15	臺中市清水區	2018-11-24T23:05:08+08:00	12377	26166	38543	2760	41303	70452	58.63%	17.57%	58	59
15	臺中市清水區	2018-11-25T00:05:09+08:00	12574	26528	39102	2788	41890	71528	58.56%	17.58%	59	59
15	臺中市清水區	2018-11-24T22:37:04+08:00	11666	24436	36102	2661	38763	66108	58.64%	17.65%	55	59
15	臺中市清水區	2018-11-24T22:50:52+08:00	12377	26166	38543	2760	41303	70452	58.63%	17.57%	58	59
15	臺中市清水區	2018-11-25T06:13:56+08:00	12574	26528	39102	2788	41890	71528	58.56%	17.58%	59	59
15	臺中市清水區	2018-11-24T22:26:40+08:00	11666	24436	36102	2661	38763	66108	58.64%	17.65%	55	59
15	臺中市清水區	2018-11-25T00:18:35+08:00	12574	26528	39102	2788	41890	71528	58.56%	17.58%	59	59
15	臺中市清水區	2018-11-24T22:19:41+08:00	11382	23878	35260	2636	37896	64732	58.54%	17.58%	54	59
15	臺中市清水區	2018-11-25T03:38:59+08:00	12574	26528	39102	2788	41890	71528	58.56%	17.58%	59	59
15	臺中市清水區	2018-11-24T22:40:31+08:00	11902	24877	36779	2729	39508	67319	58.69%	17.68%	56	59
15	臺中市清水區	2018-11-25T01:02:35+08:00	12574	26528	39102	2788	41890	71528	58.56%	17.58%	59	59
15	臺中市清水區	2018-11-25T00:57:41+08:00	12574	26528	39102	2788	41890	71528	58.56%	17.58%	59	59
15	臺中市清水區	2018-11-25T03:44:28+08:00	12574	26528	39102	2788	41890	71528	58.56%	17.58%	59	59
15	臺中市清水區	2018-11-24T23:23:42+08:00	12574	26528	39102	2788	41890	71528	58.56%	17.58%	59	59
15	臺中市清水區	2018-11-24T22:23:18+08:00	11666	24436	36102	2661	38763	66108	58.64%	17.65%	55	59
15	臺中市清水區	2018-11-25T00:00:15+08:00	12574	26528	39102	2788	41890	71528	58.56%	17.58%	59	59
15	臺中市清水區	2018-11-24T23:55:51+08:00	12574	26528	39102	2788	41890	71528	58.56%	17.58%	59	59
15	臺中市清水區	2018-11-24T23:39:21+08:00	12574	26528	39102	2788	41890	71528	58.56%	17.58%	59	59
15	臺中市清水區	2018-11-25T01:07:30+08:00	12574	26528	39102	2788	41890	71528	58.56%	17.58%	59	59
15	臺中市清水區	2018-11-24T23:12:20+08:00	12377	26166	38543	2760	41303	70452	58.63%	17.57%	58	59
15	臺中市清水區	2018-11-24T23:35:14+08:00	12574	26528	39102	2788	41890	71528	58.56%	17.58%	59	59
15	臺中市清水區	2018-11-25T00:14:14+08:00	12574	26528	39102	2788	41890	71528	58.56%	17.58%	59	59
15	臺中市清水區	2018-11-24T23:01:35+08:00	12377	26166	38543	2760	41303	70452	58.63%	17.57%	58	59
15	臺中市清水區	2018-11-25T00:09:39+08:00	12574	26528	39102	2788	41890	71528	58.56%	17.58%	59	59
15	臺中市清水區	2018-11-24T22:33:42+08:00	11666	24436	36102	2661	38763	66108	58.64%	17.65%	55	59
15	臺北市內湖區	2018-11-25T06:29:19+08:00	52518	80236	132754	5283	138037	236824	58.29%	22.18%	150	150
15	臺北市內湖區	2018-11-25T01:07:28+08:00	50586	77303	127889	5106	132995	228383	58.23%	22.15%	145	150
15	臺北市內湖區	2018-11-25T06:13:55+08:00	52518	80236	132754	5283	138037	236824	58.29%	22.18%	150	150
15	臺北市內湖區	2018-11-24T22:50:51+08:00	22334	34328	56662	2297	58959	101583	58.04%	21.99%	67	150
15	臺北市內湖區	2018-11-25T06:19:00+08:00	52518	80236	132754	5283	138037	236824	58.29%	22.18%	150	150
15	臺北市內湖區	2018-11-25T03:49:53+08:00	52518	80236	132754	5283	138037	236824	58.29%	22.18%	150	150
15	臺北市內湖區	2018-11-25T06:29:20+08:00	52518	80236	132754	5283	138037	236824	58.29%	22.18%	150	150
15	臺北市內湖區	2018-11-25T03:49:54+08:00	52518	80236	132754	5283	138037	236824	58.29%	22.18%	150	150
15	臺北市內湖區	2018-11-25T01:07:29+08:00	50586	77303	127889	5106	132995	228383	58.23%	22.15%	145	150
15	臺北市內湖區	2018-11-24T23:43:19+08:00	39875	60703	100578	3916	104494	179448	58.23%	22.22%	115	150
15	臺北市內湖區	2018-11-25T06:24:03+08:00	52518	80236	132754	5283	138037	236824	58.29%	22.18%	150	150
15	臺北市內湖區	2018-11-24T23:08:39+08:00	27502	42061	69563	2771	72334	124486	58.11%	22.09%	82	150
15	臺北市內湖區	2018-11-25T00:23:06+08:00	45402	69104	114506	4484	118990	204213	58.27%	22.23%	130	150
15	臺北市內湖區	2018-11-24T22:30:12+08:00	19429	29795	49224	2032	51256	87782	58.39%	22.13%	59	150
15	臺北市內湖區	2018-11-24T23:55:49+08:00	40642	61805	102447	3999	106446	182622	58.29%	22.25%	117	150
15	臺北市內湖區	2018-11-25T03:32:37+08:00	52518	80236	132754	5283	138037	236824	58.29%	22.18%	150	150
15	臺北市內湖區	2018-11-25T06:24:02+08:00	52518	80236	132754	5283	138037	236824	58.29%	22.18%	150	150
15	臺北市內湖區	2018-11-24T23:51:37+08:00	40642	61805	102447	3999	106446	182622	58.29%	22.25%	117	150
15	臺北市內湖區	2018-11-24T23:23:41+08:00	34007	51271	85278	3343	88621	152475	58.12%	22.3%	99	150
15	臺北市內湖區	2018-11-24T22:57:57+08:00	24373	37479	61852	2494	64346	110787	58.08%	22%	73	150
15	臺北市內湖區	2018-11-24T23:51:38+08:00	40642	61805	102447	3999	106446	182622	58.29%	22.25%	117	150
15	臺北市內湖區	2018-11-25T06:18:59+08:00	52518	80236	132754	5283	138037	236824	58.29%	22.18%	150	150
15	臺北市內湖區	2018-11-25T01:17:56+08:00	50586	77303	127889	5106	132995	228383	58.23%	22.15%	145	150
15	臺北市內湖區	2018-11-24T23:23:40+08:00	34007	51271	85278	3343	88621	152475	58.12%	22.3%	99	150
15	臺北市內湖區	2018-11-24T22:33:40+08:00	20098	30809	50907	2099	53006	90572	58.52%	22.19%	61	150
15	臺北市內湖區	2018-11-24T22:16:13+08:00	18087	27666	45753	1930	47683	81714	58.35%	22.13%	55	150
15	臺北市內湖區	2018-11-24T23:05:07+08:00	25806	39631	65437	2600	68037	116786	58.26%	22.1%	77	150
15	臺北市內湖區	2018-11-24T22:41:38+08:00	20437	31381	51818	2136	53954	92226	58.5%	22.16%	62	150
15	臺北市內湖區	2018-11-24T22:54:28+08:00	24373	37479	61852	2494	64346	110787	58.08%	22%	73	150
15	臺北市內湖區	2018-11-25T01:12:46+08:00	50586	77303	127889	5106	132995	228383	58.23%	22.15%	145	150
15	臺北市內湖區	2018-11-25T06:08:56+08:00	52518	80236	132754	5283	138037	236824	58.29%	22.18%	150	150
15	臺北市內湖區	2018-11-25T00:05:07+08:00	42149	64093	106242	4172	110414	189399	58.3%	22.25%	121	150
15	臺北市內湖區	2018-11-24T23:05:06+08:00	25806	39631	65437	2600	68037	116786	58.26%	22.1%	77	150
15	臺北市內湖區	2018-11-25T00:18:33+08:00	43877	66841	110718	4338	115056	197486	58.26%	22.22%	126	150
15	臺北市內湖區	2018-11-24T22:37:03+08:00	20437	31381	51818	2136	53954	92226	58.5%	22.16%	62	150
15	臺北市內湖區	2018-11-24T23:16:05+08:00	30340	46247	76587	3052	79639	136996	58.13%	22.15%	90	150
15	臺北市內湖區	2018-11-24T22:45:11+08:00	20437	31381	51818	2136	53954	92226	58.5%	22.16%	62	150
15	臺北市內湖區	2018-11-25T03:56:15+08:00	52518	80236	132754	5283	138037	236824	58.29%	22.18%	150	150
15	臺北市內湖區	2018-11-25T00:57:40+08:00	50260	76703	126963	5057	132020	226651	58.25%	22.18%	144	150
15	臺北市內湖區	2018-11-25T03:38:57+08:00	52518	80236	132754	5283	138037	236824	58.29%	22.18%	150	150
15	臺北市內湖區	2018-11-25T03:44:26+08:00	52518	80236	132754	5283	138037	236824	58.29%	22.18%	150	150
15	臺北市內湖區	2018-11-25T01:02:33+08:00	50586	77303	127889	5106	132995	228383	58.23%	22.15%	145	150
15	臺北市內湖區	2018-11-24T22:40:30+08:00	20437	31381	51818	2136	53954	92226	58.5%	22.16%	62	150
15	臺北市內湖區	2018-11-25T01:25:55+08:00	51301	78439	129740	5186	134926	231674	58.24%	22.14%	147	150
15	臺北市內湖區	2018-11-24T22:23:16+08:00	19429	29795	49224	2032	51256	87782	58.39%	22.13%	59	150
15	臺北市內湖區	2018-11-24T23:19:54+08:00	32831	49602	82433	3250	85683	147438	58.11%	22.27%	96	150
15	臺北市內湖區	2018-11-25T00:57:39+08:00	50260	76703	126963	5057	132020	226651	58.25%	22.18%	144	150
15	臺北市內湖區	2018-11-24T23:27:21+08:00	35171	53105	88276	3469	91745	157661	58.19%	22.31%	102	150
15	臺北市內湖區	2018-11-25T01:17:55+08:00	50586	77303	127889	5106	132995	228383	58.23%	22.15%	145	150
15	臺北市內湖區	2018-11-24T22:19:39+08:00	18786	28781	47567	1966	49533	84950	58.31%	22.11%	57	150
15	臺北市內湖區	2018-11-24T23:27:20+08:00	35171	53105	88276	3469	91745	157661	58.19%	22.31%	102	150
15	臺北市內湖區	2018-11-24T22:13:30+08:00	17409	26559	43968	1841	45809	78643	58.25%	22.14%	53	150
15	臺北市內湖區	2018-11-25T00:00:13+08:00	41064	62365	103429	4045	107474	184365	58.29%	22.27%	118	150
15	臺北市內湖區	2018-11-25T00:14:12+08:00	43195	65717	108912	4242	113154	194036	58.32%	22.26%	124	150
15	臺北市內湖區	2018-11-25T04:02:55+08:00	52518	80236	132754	5283	138037	236824	58.29%	22.18%	150	150
15	臺北市內湖區	2018-11-24T23:39:19+08:00	38765	58863	97628	3813	101441	174344	58.18%	22.23%	112	150
15	臺北市內湖區	2018-11-24T22:26:39+08:00	19429	29795	49224	2032	51256	87782	58.39%	22.13%	59	150
15	臺北市內湖區	2018-11-24T23:12:18+08:00	28219	43082	71301	2837	74138	127531	58.13%	22.13%	84	150
15	臺北市內湖區	2018-11-24T23:31:14+08:00	36543	55529	92072	3592	95664	164482	58.16%	22.22%	106	150
15	臺北市內湖區	2018-11-24T23:01:33+08:00	24740	38034	62774	2517	65291	112220	58.18%	22.05%	74	150
15	臺北市內湖區	2018-11-24T23:01:34+08:00	24740	38034	62774	2517	65291	112220	58.18%	22.05%	74	150
15	臺北市內湖區	2018-11-24T23:47:31+08:00	39875	60703	100578	3916	104494	179448	58.23%	22.22%	115	150
15	臺北市內湖區	2018-11-24T23:35:13+08:00	37265	56694	93959	3697	97656	167803	58.2%	22.21%	108	150
15	臺北市內湖區	2018-11-25T04:02:54+08:00	52518	80236	132754	5283	138037	236824	58.29%	22.18%	150	150
15	臺北市內湖區	2018-11-25T00:09:37+08:00	43195	65717	108912	4242	113154	194036	58.32%	22.26%	124	150
15	臺北市	2018-11-25T06:29:19+08:00	479771	751265	1231036	58945	1289981	2228430	57.89%	21.53%	563	1
15	臺北市	2018-11-25T01:07:28+08:00	435312	681099	1116411	53384	1169795	2017544	57.98%	21.58%	426	1
15	臺北市	2018-11-25T03:49:53+08:00	479771	751265	1231036	58945	1289981	2228430	57.89%	21.53%	563	1
15	臺北市	2018-11-24T22:50:50+08:00	239501	372561	612062	30037	642099	1109090	57.89%	21.59%	812	1
15	臺北市	2018-11-25T06:13:54+08:00	479771	751265	1231036	58945	1289981	2228430	57.89%	21.53%	563	1
15	臺北市	2018-11-24T23:43:19+08:00	339873	531106	870979	41885	912864	1575570	57.94%	21.57%	130	1
15	臺北市	2018-11-24T22:13:29+08:00	181991	282440	464431	23051	487482	842430	57.87%	21.6%	626	1
15	臺北市	2018-11-25T03:32:36+08:00	479560	750883	1230443	58921	1289364	2227286	57.89%	21.53%	562	1
15	臺北市	2018-11-25T00:23:06+08:00	395381	617462	1012843	48461	1061304	1832172	57.93%	21.58%	302	1
15	臺北市	2018-11-25T03:44:25+08:00	479771	751265	1231036	58945	1289981	2228430	57.89%	21.53%	563	1
15	臺北市	2018-11-24T23:08:38+08:00	279183	434897	714080	34812	748892	1293279	57.91%	21.59%	939	1
15	臺北市	2018-11-24T23:55:49+08:00	357380	558496	915876	44007	959883	1656615	57.94%	21.57%	186	1
15	臺北市	2018-11-25T06:24:02+08:00	479771	751265	1231036	58945	1289981	2228430	57.89%	21.53%	563	1
15	臺北市	2018-11-24T23:51:37+08:00	347283	542546	889829	42810	932639	1609443	57.95%	21.58%	153	1
15	臺北市	2018-11-24T22:23:15+08:00	199758	309501	509259	25137	534396	921994	57.96%	21.67%	681	1
15	臺北市	2018-11-24T22:40:29+08:00	224994	349553	574547	28259	602806	1039484	57.99%	21.64%	763	1
15	臺北市	2018-11-25T06:18:59+08:00	479771	751265	1231036	58945	1289981	2228430	57.89%	21.53%	563	1
15	臺北市	2018-11-24T22:57:56+08:00	256682	399595	656277	32173	688450	1189496	57.88%	21.58%	867	1
15	臺北市	2018-11-24T23:23:40+08:00	305884	476813	782697	37891	820588	1417619	57.88%	21.58%	024	1
15	臺北市	2018-11-24T22:33:40+08:00	214045	332106	546151	26917	573068	988075	58%	21.66%	728	1
15	臺北市	2018-11-24T22:54:27+08:00	244433	380281	624714	30673	655387	1131842	57.9%	21.6%	828	1
15	臺北市	2018-11-24T22:16:13+08:00	187198	290570	477768	23719	501487	866102	57.9%	21.61%	643	1
15	臺北市	2018-11-25T00:14:11+08:00	380417	594403	974820	46678	1021498	1763189	57.93%	21.58%	257	1
15	臺北市	2018-11-25T01:12:46+08:00	438740	687058	1125798	53755	1179553	2034086	57.99%	21.57%	437	1
15	臺北市	2018-11-24T22:41:37+08:00	224994	349553	574547	28259	602806	1039484	57.99%	21.64%	763	1
15	臺北市	2018-11-25T00:05:07+08:00	370222	578203	948425	45631	994056	1715665	57.94%	21.58%	225	1
15	臺北市	2018-11-24T23:05:06+08:00	271502	422702	694204	33916	728120	1256913	57.93%	21.6%	914	1
15	臺北市	2018-11-24T22:45:10+08:00	227905	354084	581989	28683	610672	1054108	57.93%	21.62%	773	1
15	臺北市	2018-11-24T23:16:05+08:00	294350	458593	752943	36597	789540	1362857	57.93%	21.6%	988	1
15	臺北市	2018-11-24T22:37:02+08:00	220848	342742	563590	27749	591339	1020231	57.96%	21.65%	750	1
15	臺北市	2018-11-25T00:18:32+08:00	390662	610280	1000942	47900	1048842	1811029	57.91%	21.57%	288	1
15	臺北市	2018-11-25T03:56:15+08:00	479771	751265	1231036	58945	1289981	2228430	57.89%	21.53%	563	1
15	臺北市	2018-11-25T03:38:57+08:00	479771	751265	1231036	58945	1289981	2228430	57.89%	21.53%	563	1
15	臺北市	2018-11-24T22:30:11+08:00	208655	323923	532578	26257	558835	963764	57.98%	21.65%	711	1
15	臺北市	2018-11-25T01:02:33+08:00	431994	675973	1107967	52964	1160931	2002888	57.96%	21.57%	416	1
15	臺北市	2018-11-25T01:25:55+08:00	444331	695690	1140021	54508	1194529	2060408	57.98%	21.57%	454	1
15	臺北市	2018-11-24T23:19:54+08:00	300924	468435	769359	37266	806625	1392992	57.91%	21.6%	007	1
15	臺北市	2018-11-25T00:57:39+08:00	426866	667377	1094243	52343	1146586	1978368	57.96%	21.58%	400	1
15	臺北市	2018-11-25T01:17:55+08:00	440476	689629	1130105	54003	1184108	2042051	57.99%	21.57%	442	1
15	臺北市	2018-11-24T22:19:39+08:00	193069	299703	492772	24352	517124	892714	57.93%	21.63%	661	1
15	臺北市	2018-11-24T23:27:20+08:00	312711	487639	800350	38668	839018	1450340	57.85%	21.56%	046	1
15	臺北市	2018-11-25T00:00:13+08:00	362869	567034	929903	44648	974551	1681711	57.95%	21.58%	203	1
15	臺北市	2018-11-24T23:35:12+08:00	324243	506907	831150	40013	871163	1505618	57.86%	21.54%	083	1
15	臺北市	2018-11-25T00:09:36+08:00	371106	579705	950811	45720	996531	1719904	57.94%	21.58%	228	1
15	臺北市	2018-11-24T23:12:18+08:00	283883	442202	726085	35309	761394	1315223	57.89%	21.58%	954	1
15	臺北市	2018-11-24T23:01:33+08:00	264450	411681	676131	33100	709231	1224905	57.9%	21.59%	892	1
15	臺北市	2018-11-24T23:31:13+08:00	321286	501951	823237	39621	862858	1491170	57.86%	21.55%	073	1
15	臺北市	2018-11-24T23:47:31+08:00	345204	539197	884401	42548	926949	1599653	57.95%	21.58%	146	1
15	臺北市	2018-11-25T04:02:54+08:00	479771	751265	1231036	58945	1289981	2228430	57.89%	21.53%	563	1
15	臺北市	2018-11-24T22:26:38+08:00	204616	317377	521993	25700	547693	944434	57.99%	21.67%	697	1
15	臺北市	2018-11-24T23:39:18+08:00	329587	514974	844561	40648	885209	1529120	57.89%	21.55%	099	1
15	臺北市	2018-11-25T06:08:55+08:00	479771	751265	1231036	58945	1289981	2228430	57.89%	21.53%	563	1
15	嘉義縣布袋鎮	2018-11-25T01:18:06+08:00	3048	7395	10443	1180	11623	23965	48.5%	12.72%	29	29
15	嘉義縣布袋鎮	2018-11-25T06:29:28+08:00	3048	7395	10443	1180	11623	23965	48.5%	12.72%	29	29
15	嘉義縣布袋鎮	2018-11-25T01:12:55+08:00	3048	7395	10443	1180	11623	23965	48.5%	12.72%	29	29
15	嘉義縣布袋鎮	2018-11-24T23:05:13+08:00	3048	7395	10443	1180	11623	23965	48.5%	12.72%	29	29
15	嘉義縣布袋鎮	2018-11-25T06:19:07+08:00	3048	7395	10443	1180	11623	23965	48.5%	12.72%	29	29
15	嘉義縣布袋鎮	2018-11-25T00:05:15+08:00	3048	7395	10443	1180	11623	23965	48.5%	12.72%	29	29
15	嘉義縣布袋鎮	2018-11-24T22:54:34+08:00	2906	7061	9967	1123	11090	22781	48.68%	12.76%	28	29
15	嘉義縣布袋鎮	2018-11-24T22:41:47+08:00	2906	7061	9967	1123	11090	22781	48.68%	12.76%	28	29
15	嘉義縣布袋鎮	2018-11-24T23:43:26+08:00	3048	7395	10443	1180	11623	23965	48.5%	12.72%	29	29
15	嘉義縣布袋鎮	2018-11-24T22:50:59+08:00	2906	7061	9967	1123	11090	22781	48.68%	12.76%	28	29
15	嘉義縣布袋鎮	2018-11-25T01:02:41+08:00	3048	7395	10443	1180	11623	23965	48.5%	12.72%	29	29
15	嘉義縣布袋鎮	2018-11-25T00:23:14+08:00	3048	7395	10443	1180	11623	23965	48.5%	12.72%	29	29
15	嘉義縣布袋鎮	2018-11-25T03:32:48+08:00	3048	7395	10443	1180	11623	23965	48.5%	12.72%	29	29
15	嘉義縣布袋鎮	2018-11-24T23:23:48+08:00	3048	7395	10443	1180	11623	23965	48.5%	12.72%	29	29
15	嘉義縣布袋鎮	2018-11-25T06:24:10+08:00	3048	7395	10443	1180	11623	23965	48.5%	12.72%	29	29
15	嘉義縣布袋鎮	2018-11-25T00:00:21+08:00	3048	7395	10443	1180	11623	23965	48.5%	12.72%	29	29
15	嘉義縣布袋鎮	2018-11-24T22:23:25+08:00	2569	6161	8730	968	9698	19631	49.4%	13.09%	25	29
15	嘉義縣布袋鎮	2018-11-25T03:44:37+08:00	3048	7395	10443	1180	11623	23965	48.5%	12.72%	29	29
15	嘉義縣布袋鎮	2018-11-24T23:08:48+08:00	3048	7395	10443	1180	11623	23965	48.5%	12.72%	29	29
15	嘉義縣布袋鎮	2018-11-24T22:33:47+08:00	2906	7061	9967	1123	11090	22781	48.68%	12.76%	28	29
15	嘉義縣布袋鎮	2018-11-24T22:16:22+08:00	2480	5977	8457	878	9335	18970	49.21%	13.07%	24	29
15	嘉義縣布袋鎮	2018-11-25T03:39:04+08:00	3048	7395	10443	1180	11623	23965	48.5%	12.72%	29	29
15	嘉義縣布袋鎮	2018-11-25T01:26:04+08:00	3048	7395	10443	1180	11623	23965	48.5%	12.72%	29	29
15	嘉義縣布袋鎮	2018-11-24T23:16:13+08:00	3048	7395	10443	1180	11623	23965	48.5%	12.72%	29	29
15	嘉義縣布袋鎮	2018-11-25T00:14:20+08:00	3048	7395	10443	1180	11623	23965	48.5%	12.72%	29	29
15	嘉義縣布袋鎮	2018-11-25T03:50:01+08:00	3048	7395	10443	1180	11623	23965	48.5%	12.72%	29	29
15	嘉義縣布袋鎮	2018-11-24T23:35:19+08:00	3048	7395	10443	1180	11623	23965	48.5%	12.72%	29	29
15	嘉義縣布袋鎮	2018-11-24T23:47:40+08:00	3048	7395	10443	1180	11623	23965	48.5%	12.72%	29	29
15	嘉義縣布袋鎮	2018-11-24T22:45:17+08:00	2906	7061	9967	1123	11090	22781	48.68%	12.76%	28	29
15	嘉義縣布袋鎮	2018-11-24T22:58:05+08:00	2906	7061	9967	1123	11090	22781	48.68%	12.76%	28	29
15	嘉義縣布袋鎮	2018-11-25T00:09:46+08:00	3048	7395	10443	1180	11623	23965	48.5%	12.72%	29	29
15	嘉義縣布袋鎮	2018-11-25T03:56:24+08:00	3048	7395	10443	1180	11623	23965	48.5%	12.72%	29	29
15	嘉義縣布袋鎮	2018-11-24T22:26:46+08:00	2689	6504	9193	1028	10221	20744	49.27%	12.96%	26	29
15	嘉義縣布袋鎮	2018-11-24T23:01:42+08:00	2906	7061	9967	1123	11090	22781	48.68%	12.76%	28	29
15	嘉義縣布袋鎮	2018-11-25T00:57:47+08:00	3048	7395	10443	1180	11623	23965	48.5%	12.72%	29	29
15	嘉義縣布袋鎮	2018-11-24T22:19:46+08:00	2480	5977	8457	878	9335	18970	49.21%	13.07%	24	29
15	嘉義縣布袋鎮	2018-11-24T22:13:41+08:00	2385	5735	8120	834	8954	18239	49.09%	13.08%	23	29
15	嘉義縣布袋鎮	2018-11-25T04:03:02+08:00	3048	7395	10443	1180	11623	23965	48.5%	12.72%	29	29
15	嘉義縣布袋鎮	2018-11-24T22:40:37+08:00	2906	7061	9967	1123	11090	22781	48.68%	12.76%	28	29
15	嘉義縣布袋鎮	2018-11-24T23:51:45+08:00	3048	7395	10443	1180	11623	23965	48.5%	12.72%	29	29
15	嘉義縣布袋鎮	2018-11-24T22:30:20+08:00	2689	6504	9193	1028	10221	20744	49.27%	12.96%	26	29
15	嘉義縣布袋鎮	2018-11-25T06:09:05+08:00	3048	7395	10443	1180	11623	23965	48.5%	12.72%	29	29
15	嘉義縣布袋鎮	2018-11-24T23:55:57+08:00	3048	7395	10443	1180	11623	23965	48.5%	12.72%	29	29
15	嘉義縣布袋鎮	2018-11-24T23:27:27+08:00	3048	7395	10443	1180	11623	23965	48.5%	12.72%	29	29
15	嘉義縣布袋鎮	2018-11-25T06:14:02+08:00	3048	7395	10443	1180	11623	23965	48.5%	12.72%	29	29
15	嘉義縣布袋鎮	2018-11-25T00:18:43+08:00	3048	7395	10443	1180	11623	23965	48.5%	12.72%	29	29
15	嘉義縣布袋鎮	2018-11-25T01:07:37+08:00	3048	7395	10443	1180	11623	23965	48.5%	12.72%	29	29
15	嘉義縣布袋鎮	2018-11-24T23:12:27+08:00	3048	7395	10443	1180	11623	23965	48.5%	12.72%	29	29
15	嘉義縣布袋鎮	2018-11-24T23:39:28+08:00	3048	7395	10443	1180	11623	23965	48.5%	12.72%	29	29
15	嘉義縣布袋鎮	2018-11-24T22:37:11+08:00	2906	7061	9967	1123	11090	22781	48.68%	12.76%	28	29
15	嘉義縣布袋鎮	2018-11-24T23:31:23+08:00	3048	7395	10443	1180	11623	23965	48.5%	12.72%	29	29
15	嘉義縣布袋鎮	2018-11-24T23:20:02+08:00	3048	7395	10443	1180	11623	23965	48.5%	12.72%	29	29
15	嘉義縣中埔鄉	2018-11-25T01:18:06+08:00	5328	11537	16865	1466	18331	39139	46.84%	13.61%	34	34
15	嘉義縣中埔鄉	2018-11-25T06:29:28+08:00	5328	11537	16865	1466	18331	39139	46.84%	13.61%	34	34
15	嘉義縣中埔鄉	2018-11-24T23:43:27+08:00	4554	9857	14411	1310	15721	33980	46.27%	13.4%	30	34
15	嘉義縣中埔鄉	2018-11-24T22:54:35+08:00	3226	6857	10083	908	10991	23570	46.63%	13.69%	24	34
15	嘉義縣中埔鄉	2018-11-24T23:05:14+08:00	3723	7921	11644	1060	12704	27240	46.64%	13.67%	26	34
15	嘉義縣中埔鄉	2018-11-25T06:19:07+08:00	5328	11537	16865	1466	18331	39139	46.84%	13.61%	34	34
15	嘉義縣中埔鄉	2018-11-25T00:05:15+08:00	5013	10841	15854	1413	17267	37042	46.61%	13.53%	32	34
15	嘉義縣中埔鄉	2018-11-24T22:41:47+08:00	2784	5883	8667	816	9483	20173	47.01%	13.8%	22	34
15	嘉義縣中埔鄉	2018-11-24T23:51:46+08:00	4554	9857	14411	1310	15721	33980	46.27%	13.4%	30	34
15	嘉義縣中埔鄉	2018-11-25T06:09:06+08:00	5328	11537	16865	1466	18331	39139	46.84%	13.61%	34	34
15	嘉義縣中埔鄉	2018-11-25T01:02:41+08:00	5328	11537	16865	1466	18331	39139	46.84%	13.61%	34	34
15	嘉義縣中埔鄉	2018-11-25T00:23:14+08:00	5328	11537	16865	1466	18331	39139	46.84%	13.61%	34	34
15	嘉義縣中埔鄉	2018-11-24T23:23:48+08:00	4145	8997	13142	1202	14344	30701	46.72%	13.5%	28	34
15	嘉義縣中埔鄉	2018-11-25T06:24:10+08:00	5328	11537	16865	1466	18331	39139	46.84%	13.61%	34	34
15	嘉義縣中埔鄉	2018-11-25T00:00:21+08:00	4765	10371	15136	1356	16492	35461	46.51%	13.44%	31	34
15	嘉義縣中埔鄉	2018-11-24T22:23:25+08:00	2152	4397	6549	586	7135	15273	46.72%	14.09%	18	34
15	嘉義縣中埔鄉	2018-11-24T22:51:00+08:00	3033	6425	9458	854	10312	21976	46.92%	13.8%	23	34
15	嘉義縣中埔鄉	2018-11-25T03:32:49+08:00	5328	11537	16865	1466	18331	39139	46.84%	13.61%	34	34
15	嘉義縣中埔鄉	2018-11-25T03:44:37+08:00	5328	11537	16865	1466	18331	39139	46.84%	13.61%	34	34
15	嘉義縣中埔鄉	2018-11-24T23:08:48+08:00	3723	7921	11644	1060	12704	27240	46.64%	13.67%	26	34
15	嘉義縣中埔鄉	2018-11-24T22:16:22+08:00	1919	3915	5834	535	6369	13335	47.76%	14.39%	16	34
15	嘉義縣中埔鄉	2018-11-25T01:26:04+08:00	5328	11537	16865	1466	18331	39139	46.84%	13.61%	34	34
15	嘉義縣中埔鄉	2018-11-24T23:16:13+08:00	4145	8997	13142	1202	14344	30701	46.72%	13.5%	28	34
15	嘉義縣中埔鄉	2018-11-24T23:35:20+08:00	4309	9365	13674	1219	14893	32171	46.29%	13.39%	29	34
15	嘉義縣中埔鄉	2018-11-25T00:14:20+08:00	5328	11537	16865	1466	18331	39139	46.84%	13.61%	34	34
15	嘉義縣中埔鄉	2018-11-25T03:39:05+08:00	5328	11537	16865	1466	18331	39139	46.84%	13.61%	34	34
15	嘉義縣中埔鄉	2018-11-24T22:33:48+08:00	2606	5462	8068	748	8816	18732	47.06%	13.91%	21	34
15	嘉義縣中埔鄉	2018-11-25T03:50:01+08:00	5328	11537	16865	1466	18331	39139	46.84%	13.61%	34	34
15	嘉義縣中埔鄉	2018-11-25T01:12:56+08:00	5328	11537	16865	1466	18331	39139	46.84%	13.61%	34	34
15	嘉義縣中埔鄉	2018-11-24T23:47:40+08:00	4554	9857	14411	1310	15721	33980	46.27%	13.4%	30	34
15	嘉義縣中埔鄉	2018-11-24T23:01:43+08:00	3456	7419	10875	983	11858	25452	46.59%	13.58%	25	34
15	嘉義縣中埔鄉	2018-11-24T22:58:05+08:00	3456	7419	10875	983	11858	25452	46.59%	13.58%	25	34
15	嘉義縣中埔鄉	2018-11-25T00:09:46+08:00	5328	11537	16865	1466	18331	39139	46.84%	13.61%	34	34
15	嘉義縣中埔鄉	2018-11-25T03:56:25+08:00	5328	11537	16865	1466	18331	39139	46.84%	13.61%	34	34
15	嘉義縣中埔鄉	2018-11-24T22:45:18+08:00	2784	5883	8667	816	9483	20173	47.01%	13.8%	22	34
15	嘉義縣中埔鄉	2018-11-24T22:26:46+08:00	2285	4712	6997	641	7638	16154	47.28%	14.15%	19	34
15	嘉義縣中埔鄉	2018-11-24T22:13:41+08:00	1667	3422	5089	493	5582	11605	48.1%	14.36%	15	34
15	嘉義縣中埔鄉	2018-11-25T04:03:03+08:00	5328	11537	16865	1466	18331	39139	46.84%	13.61%	34	34
15	嘉義縣中埔鄉	2018-11-25T00:57:48+08:00	5328	11537	16865	1466	18331	39139	46.84%	13.61%	34	34
15	嘉義縣中埔鄉	2018-11-24T22:19:47+08:00	1988	4047	6035	542	6577	14005	46.96%	14.19%	17	34
15	嘉義縣中埔鄉	2018-11-24T22:40:37+08:00	2784	5883	8667	816	9483	20173	47.01%	13.8%	22	34
15	嘉義縣中埔鄉	2018-11-24T22:30:20+08:00	2411	4976	7387	673	8060	17033	47.32%	14.15%	20	34
15	嘉義縣中埔鄉	2018-11-24T23:27:28+08:00	4309	9365	13674	1219	14893	32171	46.29%	13.39%	29	34
15	嘉義縣中埔鄉	2018-11-24T23:55:57+08:00	4554	9857	14411	1310	15721	33980	46.27%	13.4%	30	34
15	嘉義縣中埔鄉	2018-11-25T06:14:02+08:00	5328	11537	16865	1466	18331	39139	46.84%	13.61%	34	34
15	嘉義縣中埔鄉	2018-11-25T00:18:44+08:00	5328	11537	16865	1466	18331	39139	46.84%	13.61%	34	34
15	嘉義縣中埔鄉	2018-11-24T23:20:03+08:00	4145	8997	13142	1202	14344	30701	46.72%	13.5%	28	34
15	嘉義縣中埔鄉	2018-11-25T01:07:37+08:00	5328	11537	16865	1466	18331	39139	46.84%	13.61%	34	34
15	嘉義縣中埔鄉	2018-11-24T23:12:27+08:00	3914	8365	12279	1140	13419	28839	46.53%	13.57%	27	34
15	嘉義縣中埔鄉	2018-11-24T22:37:11+08:00	2784	5883	8667	816	9483	20173	47.01%	13.8%	22	34
15	嘉義縣中埔鄉	2018-11-24T23:39:29+08:00	4554	9857	14411	1310	15721	33980	46.27%	13.4%	30	34
15	嘉義縣中埔鄉	2018-11-24T23:31:24+08:00	4309	9365	13674	1219	14893	32171	46.29%	13.39%	29	34
15	金門縣金寧鄉	2018-11-25T03:56:28+08:00	3170	6573	9743	448	10191	28162	36.19%	11.26%	17	17
15	金門縣金寧鄉	2018-11-24T23:12:31+08:00	3073	6127	9200	410	9610	26328	36.5%	11.67%	16	17
15	金門縣金寧鄉	2018-11-24T23:47:43+08:00	3170	6573	9743	448	10191	28162	36.19%	11.26%	17	17
15	金門縣金寧鄉	2018-11-24T22:58:09+08:00	3073	6127	9200	410	9610	26328	36.5%	11.67%	16	17
15	金門縣金寧鄉	2018-11-24T23:56:01+08:00	3170	6573	9743	448	10191	28162	36.19%	11.26%	17	17
15	金門縣金寧鄉	2018-11-24T23:01:46+08:00	3073	6127	9200	410	9610	26328	36.5%	11.67%	16	17
15	金門縣金寧鄉	2018-11-25T03:32:53+08:00	3170	6573	9743	448	10191	28162	36.19%	11.26%	17	17
15	金門縣金寧鄉	2018-11-24T23:08:52+08:00	3073	6127	9200	410	9610	26328	36.5%	11.67%	16	17
15	金門縣金寧鄉	2018-11-24T23:51:49+08:00	3170	6573	9743	448	10191	28162	36.19%	11.26%	17	17
15	金門縣金寧鄉	2018-11-24T22:13:45+08:00	2278	5486	7764	375	8139	22716	35.83%	10.03%	14	17
15	金門縣金寧鄉	2018-11-25T03:44:41+08:00	3170	6573	9743	448	10191	28162	36.19%	11.26%	17	17
15	金門縣金寧鄉	2018-11-25T04:03:06+08:00	3170	6573	9743	448	10191	28162	36.19%	11.26%	17	17
15	金門縣金寧鄉	2018-11-24T23:27:31+08:00	3073	6127	9200	410	9610	26328	36.5%	11.67%	16	17
15	金門縣金寧鄉	2018-11-24T22:30:24+08:00	2278	5486	7764	375	8139	22716	35.83%	10.03%	14	17
15	金門縣金寧鄉	2018-11-25T00:57:51+08:00	3170	6573	9743	448	10191	28162	36.19%	11.26%	17	17
15	金門縣金寧鄉	2018-11-24T22:19:50+08:00	2278	5486	7764	375	8139	22716	35.83%	10.03%	14	17
15	金門縣金寧鄉	2018-11-25T00:09:50+08:00	3170	6573	9743	448	10191	28162	36.19%	11.26%	17	17
15	金門縣金寧鄉	2018-11-25T00:18:47+08:00	3170	6573	9743	448	10191	28162	36.19%	11.26%	17	17
15	金門縣金寧鄉	2018-11-24T22:37:14+08:00	2399	5882	8281	396	8677	24407	35.55%	9.83%	15	17
15	金門縣金寧鄉	2018-11-24T23:20:08+08:00	3073	6127	9200	410	9610	26328	36.5%	11.67%	16	17
15	金門縣金寧鄉	2018-11-24T23:31:27+08:00	3170	6573	9743	448	10191	28162	36.19%	11.26%	17	17
15	金門縣金寧鄉	2018-11-24T22:45:21+08:00	2399	5882	8281	396	8677	24407	35.55%	9.83%	15	17
15	金門縣金寧鄉	2018-11-24T22:54:38+08:00	3073	6127	9200	410	9610	26328	36.5%	11.67%	16	17
15	金門縣金寧鄉	2018-11-24T22:33:51+08:00	2399	5882	8281	396	8677	24407	35.55%	9.83%	15	17
15	金門縣金寧鄉	2018-11-24T23:39:33+08:00	3170	6573	9743	448	10191	28162	36.19%	11.26%	17	17
15	金門縣金寧鄉	2018-11-24T22:26:49+08:00	2278	5486	7764	375	8139	22716	35.83%	10.03%	14	17
15	金門縣金寧鄉	2018-11-25T01:07:40+08:00	3170	6573	9743	448	10191	28162	36.19%	11.26%	17	17
15	金門縣金寧鄉	2018-11-25T01:12:59+08:00	3170	6573	9743	448	10191	28162	36.19%	11.26%	17	17
15	金門縣金寧鄉	2018-11-25T00:05:18+08:00	3170	6573	9743	448	10191	28162	36.19%	11.26%	17	17
15	金門縣金寧鄉	2018-11-24T23:05:17+08:00	3073	6127	9200	410	9610	26328	36.5%	11.67%	16	17
15	金門縣金寧鄉	2018-11-24T23:23:51+08:00	3073	6127	9200	410	9610	26328	36.5%	11.67%	16	17
15	金門縣金寧鄉	2018-11-24T22:23:29+08:00	2278	5486	7764	375	8139	22716	35.83%	10.03%	14	17
15	金門縣金寧鄉	2018-11-25T00:23:17+08:00	3170	6573	9743	448	10191	28162	36.19%	11.26%	17	17
15	金門縣金寧鄉	2018-11-25T00:00:24+08:00	3170	6573	9743	448	10191	28162	36.19%	11.26%	17	17
15	金門縣金寧鄉	2018-11-25T01:02:45+08:00	3170	6573	9743	448	10191	28162	36.19%	11.26%	17	17
15	金門縣金寧鄉	2018-11-24T22:51:04+08:00	3073	6127	9200	410	9610	26328	36.5%	11.67%	16	17
15	金門縣金寧鄉	2018-11-25T06:09:10+08:00	3170	6573	9743	448	10191	28162	36.19%	11.26%	17	17
15	金門縣金寧鄉	2018-11-25T06:24:14+08:00	3170	6573	9743	448	10191	28162	36.19%	11.26%	17	17
15	金門縣金寧鄉	2018-11-24T22:40:40+08:00	2399	5882	8281	396	8677	24407	35.55%	9.83%	15	17
15	金門縣金寧鄉	2018-11-25T06:14:05+08:00	3170	6573	9743	448	10191	28162	36.19%	11.26%	17	17
15	金門縣金寧鄉	2018-11-24T23:35:23+08:00	3170	6573	9743	448	10191	28162	36.19%	11.26%	17	17
15	金門縣金寧鄉	2018-11-25T00:14:24+08:00	3170	6573	9743	448	10191	28162	36.19%	11.26%	17	17
15	金門縣金寧鄉	2018-11-25T03:50:04+08:00	3170	6573	9743	448	10191	28162	36.19%	11.26%	17	17
15	金門縣金寧鄉	2018-11-24T22:16:26+08:00	2278	5486	7764	375	8139	22716	35.83%	10.03%	14	17
15	金門縣金寧鄉	2018-11-24T23:43:31+08:00	3170	6573	9743	448	10191	28162	36.19%	11.26%	17	17
15	金門縣金寧鄉	2018-11-25T01:18:11+08:00	3170	6573	9743	448	10191	28162	36.19%	11.26%	17	17
15	金門縣金寧鄉	2018-11-25T06:29:31+08:00	3170	6573	9743	448	10191	28162	36.19%	11.26%	17	17
15	金門縣金寧鄉	2018-11-24T23:16:16+08:00	3073	6127	9200	410	9610	26328	36.5%	11.67%	16	17
15	金門縣金寧鄉	2018-11-25T06:19:11+08:00	3170	6573	9743	448	10191	28162	36.19%	11.26%	17	17
15	金門縣金寧鄉	2018-11-24T22:41:51+08:00	2399	5882	8281	396	8677	24407	35.55%	9.83%	15	17
15	金門縣金寧鄉	2018-11-25T03:39:08+08:00	3170	6573	9743	448	10191	28162	36.19%	11.26%	17	17
15	金門縣金寧鄉	2018-11-25T01:26:08+08:00	3170	6573	9743	448	10191	28162	36.19%	11.26%	17	17
15	高雄市茄萣區	2018-11-25T01:18:01+08:00	4510	8546	13056	1111	14167	26212	54.05%	17.21%	21	21
15	高雄市茄萣區	2018-11-24T22:58:01+08:00	4510	8546	13056	1111	14167	26212	54.05%	17.21%	21	21
15	高雄市茄萣區	2018-11-24T22:26:43+08:00	4510	8546	13056	1111	14167	26212	54.05%	17.21%	21	21
15	高雄市茄萣區	2018-11-25T00:09:42+08:00	4510	8546	13056	1111	14167	26212	54.05%	17.21%	21	21
15	高雄市茄萣區	2018-11-24T22:37:07+08:00	4510	8546	13056	1111	14167	26212	54.05%	17.21%	21	21
15	高雄市茄萣區	2018-11-24T22:50:56+08:00	4510	8546	13056	1111	14167	26212	54.05%	17.21%	21	21
15	高雄市茄萣區	2018-11-25T00:18:39+08:00	4510	8546	13056	1111	14167	26212	54.05%	17.21%	21	21
15	高雄市茄萣區	2018-11-24T22:45:14+08:00	4510	8546	13056	1111	14167	26212	54.05%	17.21%	21	21
15	高雄市茄萣區	2018-11-25T03:56:20+08:00	4510	8546	13056	1111	14167	26212	54.05%	17.21%	21	21
15	高雄市茄萣區	2018-11-25T00:05:12+08:00	4510	8546	13056	1111	14167	26212	54.05%	17.21%	21	21
15	高雄市茄萣區	2018-11-24T23:16:09+08:00	4510	8546	13056	1111	14167	26212	54.05%	17.21%	21	21
15	高雄市茄萣區	2018-11-25T01:02:38+08:00	4510	8546	13056	1111	14167	26212	54.05%	17.21%	21	21
15	高雄市茄萣區	2018-11-25T00:57:44+08:00	4510	8546	13056	1111	14167	26212	54.05%	17.21%	21	21
15	高雄市茄萣區	2018-11-24T22:40:34+08:00	4510	8546	13056	1111	14167	26212	54.05%	17.21%	21	21
15	高雄市茄萣區	2018-11-25T06:09:01+08:00	4510	8546	13056	1111	14167	26212	54.05%	17.21%	21	21
15	高雄市茄萣區	2018-11-24T22:19:43+08:00	4510	8546	13056	1111	14167	26212	54.05%	17.21%	21	21
15	高雄市茄萣區	2018-11-24T23:55:53+08:00	4510	8546	13056	1111	14167	26212	54.05%	17.21%	21	21
15	高雄市茄萣區	2018-11-25T03:44:31+08:00	4510	8546	13056	1111	14167	26212	54.05%	17.21%	21	21
15	高雄市茄萣區	2018-11-24T23:19:59+08:00	4510	8546	13056	1111	14167	26212	54.05%	17.21%	21	21
15	高雄市茄萣區	2018-11-25T00:00:17+08:00	4510	8546	13056	1111	14167	26212	54.05%	17.21%	21	21
15	高雄市茄萣區	2018-11-24T23:27:24+08:00	4510	8546	13056	1111	14167	26212	54.05%	17.21%	21	21
15	高雄市茄萣區	2018-11-25T01:07:33+08:00	4510	8546	13056	1111	14167	26212	54.05%	17.21%	21	21
15	高雄市茄萣區	2018-11-24T23:31:19+08:00	4510	8546	13056	1111	14167	26212	54.05%	17.21%	21	21
15	高雄市茄萣區	2018-11-24T23:12:23+08:00	4510	8546	13056	1111	14167	26212	54.05%	17.21%	21	21
15	高雄市茄萣區	2018-11-24T23:39:24+08:00	4510	8546	13056	1111	14167	26212	54.05%	17.21%	21	21
15	高雄市茄萣區	2018-11-24T23:01:38+08:00	4510	8546	13056	1111	14167	26212	54.05%	17.21%	21	21
15	高雄市茄萣區	2018-11-24T23:35:17+08:00	4510	8546	13056	1111	14167	26212	54.05%	17.21%	21	21
15	高雄市茄萣區	2018-11-25T04:02:59+08:00	4510	8546	13056	1111	14167	26212	54.05%	17.21%	21	21
15	高雄市茄萣區	2018-11-25T00:14:17+08:00	4510	8546	13056	1111	14167	26212	54.05%	17.21%	21	21
15	高雄市茄萣區	2018-11-24T23:43:23+08:00	4510	8546	13056	1111	14167	26212	54.05%	17.21%	21	21
15	高雄市茄萣區	2018-11-25T01:12:51+08:00	4510	8546	13056	1111	14167	26212	54.05%	17.21%	21	21
15	高雄市茄萣區	2018-11-24T22:54:31+08:00	4510	8546	13056	1111	14167	26212	54.05%	17.21%	21	21
15	高雄市茄萣區	2018-11-25T06:13:59+08:00	4510	8546	13056	1111	14167	26212	54.05%	17.21%	21	21
15	高雄市茄萣區	2018-11-24T22:41:43+08:00	4510	8546	13056	1111	14167	26212	54.05%	17.21%	21	21
15	高雄市茄萣區	2018-11-25T03:49:57+08:00	4510	8546	13056	1111	14167	26212	54.05%	17.21%	21	21
15	高雄市茄萣區	2018-11-24T23:05:10+08:00	4510	8546	13056	1111	14167	26212	54.05%	17.21%	21	21
15	高雄市茄萣區	2018-11-25T06:19:04+08:00	4510	8546	13056	1111	14167	26212	54.05%	17.21%	21	21
15	高雄市茄萣區	2018-11-25T06:29:24+08:00	4510	8546	13056	1111	14167	26212	54.05%	17.21%	21	21
15	高雄市茄萣區	2018-11-25T06:24:07+08:00	4510	8546	13056	1111	14167	26212	54.05%	17.21%	21	21
15	高雄市茄萣區	2018-11-24T22:30:16+08:00	4510	8546	13056	1111	14167	26212	54.05%	17.21%	21	21
15	高雄市茄萣區	2018-11-24T23:51:42+08:00	4510	8546	13056	1111	14167	26212	54.05%	17.21%	21	21
15	高雄市茄萣區	2018-11-24T22:13:36+08:00	3895	8258	12153	1024	13177	24427	53.94%	15.95%	20	21
15	高雄市茄萣區	2018-11-24T23:08:44+08:00	4510	8546	13056	1111	14167	26212	54.05%	17.21%	21	21
15	高雄市茄萣區	2018-11-24T22:23:21+08:00	4510	8546	13056	1111	14167	26212	54.05%	17.21%	21	21
15	高雄市茄萣區	2018-11-25T03:32:44+08:00	4510	8546	13056	1111	14167	26212	54.05%	17.21%	21	21
15	高雄市茄萣區	2018-11-24T23:23:44+08:00	4510	8546	13056	1111	14167	26212	54.05%	17.21%	21	21
15	高雄市茄萣區	2018-11-25T00:23:11+08:00	4510	8546	13056	1111	14167	26212	54.05%	17.21%	21	21
15	高雄市茄萣區	2018-11-25T01:26:00+08:00	4510	8546	13056	1111	14167	26212	54.05%	17.21%	21	21
15	高雄市茄萣區	2018-11-24T23:47:36+08:00	4510	8546	13056	1111	14167	26212	54.05%	17.21%	21	21
15	高雄市茄萣區	2018-11-25T03:39:01+08:00	4510	8546	13056	1111	14167	26212	54.05%	17.21%	21	21
15	高雄市茄萣區	2018-11-24T22:33:45+08:00	4510	8546	13056	1111	14167	26212	54.05%	17.21%	21	21
15	高雄市茄萣區	2018-11-24T22:16:18+08:00	3895	8258	12153	1024	13177	24427	53.94%	15.95%	20	21
15	高雄市茂林區	2018-11-24T22:26:43+08:00	170	553	723	31	754	1108	68.05%	15.34%	2	3
15	高雄市茂林區	2018-11-25T00:09:42+08:00	246	812	1058	52	1110	1615	68.73%	15.23%	3	3
15	高雄市茂林區	2018-11-25T03:56:21+08:00	246	812	1058	52	1110	1615	68.73%	15.23%	3	3
15	高雄市茂林區	2018-11-25T01:12:52+08:00	246	812	1058	52	1110	1615	68.73%	15.23%	3	3
15	高雄市茂林區	2018-11-24T22:37:07+08:00	170	553	723	31	754	1108	68.05%	15.34%	2	3
15	高雄市茂林區	2018-11-24T22:54:32+08:00	170	553	723	31	754	1108	68.05%	15.34%	2	3
15	高雄市茂林區	2018-11-24T22:50:56+08:00	170	553	723	31	754	1108	68.05%	15.34%	2	3
15	高雄市茂林區	2018-11-25T00:18:39+08:00	246	812	1058	52	1110	1615	68.73%	15.23%	3	3
15	高雄市茂林區	2018-11-25T00:05:12+08:00	246	812	1058	52	1110	1615	68.73%	15.23%	3	3
15	高雄市茂林區	2018-11-24T22:45:15+08:00	170	553	723	31	754	1108	68.05%	15.34%	2	3
15	高雄市茂林區	2018-11-25T01:02:38+08:00	246	812	1058	52	1110	1615	68.73%	15.23%	3	3
15	高雄市茂林區	2018-11-25T00:57:44+08:00	246	812	1058	52	1110	1615	68.73%	15.23%	3	3
15	高雄市茂林區	2018-11-24T22:40:34+08:00	170	553	723	31	754	1108	68.05%	15.34%	2	3
15	高雄市茂林區	2018-11-24T22:19:43+08:00	70	184	254	14	268	382	70.16%	18.32%	1	3
15	高雄市茂林區	2018-11-25T00:00:18+08:00	246	812	1058	52	1110	1615	68.73%	15.23%	3	3
15	高雄市茂林區	2018-11-24T23:55:54+08:00	246	812	1058	52	1110	1615	68.73%	15.23%	3	3
15	高雄市茂林區	2018-11-24T23:27:25+08:00	170	553	723	31	754	1108	68.05%	15.34%	2	3
15	高雄市茂林區	2018-11-24T23:19:59+08:00	170	553	723	31	754	1108	68.05%	15.34%	2	3
15	高雄市茂林區	2018-11-25T01:07:33+08:00	246	812	1058	52	1110	1615	68.73%	15.23%	3	3
15	高雄市茂林區	2018-11-24T23:39:25+08:00	170	553	723	31	754	1108	68.05%	15.34%	2	3
15	高雄市茂林區	2018-11-24T23:12:24+08:00	170	553	723	31	754	1108	68.05%	15.34%	2	3
15	高雄市茂林區	2018-11-24T23:01:38+08:00	170	553	723	31	754	1108	68.05%	15.34%	2	3
15	高雄市茂林區	2018-11-24T23:31:20+08:00	170	553	723	31	754	1108	68.05%	15.34%	2	3
15	高雄市茂林區	2018-11-24T23:35:17+08:00	170	553	723	31	754	1108	68.05%	15.34%	2	3
15	高雄市茂林區	2018-11-25T04:02:59+08:00	246	812	1058	52	1110	1615	68.73%	15.23%	3	3
15	高雄市茂林區	2018-11-25T00:14:17+08:00	246	812	1058	52	1110	1615	68.73%	15.23%	3	3
15	高雄市茂林區	2018-11-24T23:43:24+08:00	170	553	723	31	754	1108	68.05%	15.34%	2	3
15	高雄市茂林區	2018-11-24T22:58:02+08:00	170	553	723	31	754	1108	68.05%	15.34%	2	3
15	高雄市茂林區	2018-11-25T03:49:58+08:00	246	812	1058	52	1110	1615	68.73%	15.23%	3	3
15	高雄市茂林區	2018-11-25T01:18:02+08:00	246	812	1058	52	1110	1615	68.73%	15.23%	3	3
15	高雄市茂林區	2018-11-24T23:05:11+08:00	170	553	723	31	754	1108	68.05%	15.34%	2	3
15	高雄市茂林區	2018-11-25T06:13:59+08:00	246	812	1058	52	1110	1615	68.73%	15.23%	3	3
15	高雄市茂林區	2018-11-24T22:41:43+08:00	170	553	723	31	754	1108	68.05%	15.34%	2	3
15	高雄市茂林區	2018-11-25T06:19:04+08:00	246	812	1058	52	1110	1615	68.73%	15.23%	3	3
15	高雄市茂林區	2018-11-25T06:29:24+08:00	246	812	1058	52	1110	1615	68.73%	15.23%	3	3
15	高雄市茂林區	2018-11-25T06:24:07+08:00	246	812	1058	52	1110	1615	68.73%	15.23%	3	3
15	高雄市茂林區	2018-11-24T22:30:17+08:00	170	553	723	31	754	1108	68.05%	15.34%	2	3
15	高雄市茂林區	2018-11-24T23:51:42+08:00	246	812	1058	52	1110	1615	68.73%	15.23%	3	3
15	高雄市茂林區	2018-11-25T06:09:02+08:00	246	812	1058	52	1110	1615	68.73%	15.23%	3	3
15	高雄市茂林區	2018-11-24T23:23:45+08:00	170	553	723	31	754	1108	68.05%	15.34%	2	3
15	高雄市茂林區	2018-11-25T03:44:32+08:00	246	812	1058	52	1110	1615	68.73%	15.23%	3	3
15	高雄市茂林區	2018-11-24T23:08:44+08:00	170	553	723	31	754	1108	68.05%	15.34%	2	3
15	高雄市茂林區	2018-11-24T22:23:21+08:00	170	553	723	31	754	1108	68.05%	15.34%	2	3
15	高雄市茂林區	2018-11-25T03:32:44+08:00	246	812	1058	52	1110	1615	68.73%	15.23%	3	3
15	高雄市茂林區	2018-11-24T22:13:37+08:00	70	184	254	14	268	382	70.16%	18.32%	1	3
15	高雄市茂林區	2018-11-25T00:23:11+08:00	246	812	1058	52	1110	1615	68.73%	15.23%	3	3
15	高雄市茂林區	2018-11-24T23:16:10+08:00	170	553	723	31	754	1108	68.05%	15.34%	2	3
15	高雄市茂林區	2018-11-25T01:26:00+08:00	246	812	1058	52	1110	1615	68.73%	15.23%	3	3
15	高雄市茂林區	2018-11-24T23:47:36+08:00	170	553	723	31	754	1108	68.05%	15.34%	2	3
15	高雄市茂林區	2018-11-25T03:39:01+08:00	246	812	1058	52	1110	1615	68.73%	15.23%	3	3
15	高雄市茂林區	2018-11-24T22:33:45+08:00	170	553	723	31	754	1108	68.05%	15.34%	2	3
15	高雄市茂林區	2018-11-24T22:16:18+08:00	70	184	254	14	268	382	70.16%	18.32%	1	3
15	花蓮縣萬榮鄉	2018-11-24T23:56:00+08:00	502	1510	2012	178	2190	4183	52.35%	12%	6	7
15	花蓮縣萬榮鄉	2018-11-24T22:58:08+08:00	350	1131	1481	111	1592	3111	51.17%	11.25%	5	7
15	花蓮縣萬榮鄉	2018-11-25T01:18:09+08:00	502	1510	2012	178	2190	4183	52.35%	12%	6	7
15	花蓮縣萬榮鄉	2018-11-25T03:56:27+08:00	668	1986	2654	279	2933	5269	55.67%	12.68%	7	7
15	花蓮縣萬榮鄉	2018-11-24T23:47:42+08:00	502	1510	2012	178	2190	4183	52.35%	12%	6	7
15	花蓮縣萬榮鄉	2018-11-24T23:27:30+08:00	502	1510	2012	178	2190	4183	52.35%	12%	6	7
15	花蓮縣萬榮鄉	2018-11-25T06:09:09+08:00	668	1986	2654	279	2933	5269	55.67%	12.68%	7	7
15	花蓮縣萬榮鄉	2018-11-24T23:51:48+08:00	502	1510	2012	178	2190	4183	52.35%	12%	6	7
15	花蓮縣萬榮鄉	2018-11-24T22:30:23+08:00	350	1131	1481	111	1592	3111	51.17%	11.25%	5	7
15	花蓮縣萬榮鄉	2018-11-24T22:13:44+08:00	163	617	780	68	848	1677	50.57%	9.72%	3	7
15	花蓮縣萬榮鄉	2018-11-25T03:44:40+08:00	668	1986	2654	279	2933	5269	55.67%	12.68%	7	7
15	花蓮縣萬榮鄉	2018-11-25T00:57:50+08:00	502	1510	2012	178	2190	4183	52.35%	12%	6	7
15	花蓮縣萬榮鄉	2018-11-24T23:20:07+08:00	502	1510	2012	178	2190	4183	52.35%	12%	6	7
15	花蓮縣萬榮鄉	2018-11-24T22:16:25+08:00	163	617	780	68	848	1677	50.57%	9.72%	3	7
15	花蓮縣萬榮鄉	2018-11-24T23:31:26+08:00	502	1510	2012	178	2190	4183	52.35%	12%	6	7
15	花蓮縣萬榮鄉	2018-11-24T22:37:13+08:00	350	1131	1481	111	1592	3111	51.17%	11.25%	5	7
15	花蓮縣萬榮鄉	2018-11-25T00:18:46+08:00	502	1510	2012	178	2190	4183	52.35%	12%	6	7
15	花蓮縣萬榮鄉	2018-11-24T23:16:15+08:00	502	1510	2012	178	2190	4183	52.35%	12%	6	7
15	花蓮縣萬榮鄉	2018-11-25T01:12:58+08:00	502	1510	2012	178	2190	4183	52.35%	12%	6	7
15	花蓮縣萬榮鄉	2018-11-25T00:05:17+08:00	502	1510	2012	178	2190	4183	52.35%	12%	6	7
15	花蓮縣萬榮鄉	2018-11-24T23:05:16+08:00	350	1131	1481	111	1592	3111	51.17%	11.25%	5	7
15	花蓮縣萬榮鄉	2018-11-24T23:39:32+08:00	502	1510	2012	178	2190	4183	52.35%	12%	6	7
15	花蓮縣萬榮鄉	2018-11-24T22:54:37+08:00	350	1131	1481	111	1592	3111	51.17%	11.25%	5	7
15	花蓮縣萬榮鄉	2018-11-24T22:33:50+08:00	350	1131	1481	111	1592	3111	51.17%	11.25%	5	7
15	花蓮縣萬榮鄉	2018-11-24T22:45:20+08:00	350	1131	1481	111	1592	3111	51.17%	11.25%	5	7
15	花蓮縣萬榮鄉	2018-11-24T22:26:48+08:00	350	1131	1481	111	1592	3111	51.17%	11.25%	5	7
15	花蓮縣萬榮鄉	2018-11-24T23:01:45+08:00	350	1131	1481	111	1592	3111	51.17%	11.25%	5	7
15	花蓮縣萬榮鄉	2018-11-25T00:09:49+08:00	502	1510	2012	178	2190	4183	52.35%	12%	6	7
15	花蓮縣萬榮鄉	2018-11-25T04:03:05+08:00	668	1986	2654	279	2933	5269	55.67%	12.68%	7	7
15	花蓮縣萬榮鄉	2018-11-24T23:23:50+08:00	502	1510	2012	178	2190	4183	52.35%	12%	6	7
15	花蓮縣萬榮鄉	2018-11-24T22:19:49+08:00	163	617	780	68	848	1677	50.57%	9.72%	3	7
15	花蓮縣萬榮鄉	2018-11-25T03:32:51+08:00	668	1986	2654	279	2933	5269	55.67%	12.68%	7	7
15	花蓮縣萬榮鄉	2018-11-24T23:08:50+08:00	350	1131	1481	111	1592	3111	51.17%	11.25%	5	7
15	花蓮縣萬榮鄉	2018-11-25T06:14:04+08:00	668	1986	2654	279	2933	5269	55.67%	12.68%	7	7
15	花蓮縣萬榮鄉	2018-11-25T00:00:23+08:00	502	1510	2012	178	2190	4183	52.35%	12%	6	7
15	花蓮縣萬榮鄉	2018-11-24T22:51:03+08:00	350	1131	1481	111	1592	3111	51.17%	11.25%	5	7
15	花蓮縣萬榮鄉	2018-11-24T22:23:28+08:00	231	805	1036	83	1119	2338	47.86%	9.88%	4	7
15	花蓮縣萬榮鄉	2018-11-24T22:40:40+08:00	350	1131	1481	111	1592	3111	51.17%	11.25%	5	7
15	花蓮縣萬榮鄉	2018-11-25T06:24:13+08:00	668	1986	2654	279	2933	5269	55.67%	12.68%	7	7
15	花蓮縣萬榮鄉	2018-11-25T01:02:44+08:00	502	1510	2012	178	2190	4183	52.35%	12%	6	7
15	花蓮縣萬榮鄉	2018-11-25T00:23:16+08:00	502	1510	2012	178	2190	4183	52.35%	12%	6	7
15	花蓮縣萬榮鄉	2018-11-25T06:19:10+08:00	668	1986	2654	279	2933	5269	55.67%	12.68%	7	7
15	花蓮縣萬榮鄉	2018-11-25T06:29:30+08:00	668	1986	2654	279	2933	5269	55.67%	12.68%	7	7
15	花蓮縣萬榮鄉	2018-11-24T23:12:29+08:00	350	1131	1481	111	1592	3111	51.17%	11.25%	5	7
15	花蓮縣萬榮鄉	2018-11-25T03:50:03+08:00	668	1986	2654	279	2933	5269	55.67%	12.68%	7	7
15	花蓮縣萬榮鄉	2018-11-25T01:07:39+08:00	502	1510	2012	178	2190	4183	52.35%	12%	6	7
15	花蓮縣萬榮鄉	2018-11-25T01:26:07+08:00	502	1510	2012	178	2190	4183	52.35%	12%	6	7
15	花蓮縣萬榮鄉	2018-11-25T03:39:07+08:00	668	1986	2654	279	2933	5269	55.67%	12.68%	7	7
15	花蓮縣萬榮鄉	2018-11-24T22:41:50+08:00	350	1131	1481	111	1592	3111	51.17%	11.25%	5	7
15	花蓮縣萬榮鄉	2018-11-25T00:14:22+08:00	502	1510	2012	178	2190	4183	52.35%	12%	6	7
15	花蓮縣萬榮鄉	2018-11-24T23:35:22+08:00	502	1510	2012	178	2190	4183	52.35%	12%	6	7
15	花蓮縣萬榮鄉	2018-11-24T23:43:30+08:00	502	1510	2012	178	2190	4183	52.35%	12%	6	7
15	花蓮縣鳳林鎮	2018-11-24T23:56:00+08:00	1152	3041	4193	411	4604	8484	54.27%	13.58%	14	15
15	花蓮縣鳳林鎮	2018-11-24T23:05:15+08:00	1046	2774	3820	366	4186	7742	54.07%	13.51%	13	15
15	花蓮縣鳳林鎮	2018-11-24T23:43:29+08:00	1152	3041	4193	411	4604	8484	54.27%	13.58%	14	15
15	花蓮縣鳳林鎮	2018-11-25T01:18:09+08:00	1327	3547	4874	466	5340	9676	55.19%	13.71%	15	15
15	花蓮縣鳳林鎮	2018-11-25T03:56:27+08:00	1327	3547	4874	466	5340	9676	55.19%	13.71%	15	15
15	花蓮縣鳳林鎮	2018-11-25T06:19:09+08:00	1327	3547	4874	466	5340	9676	55.19%	13.71%	15	15
15	花蓮縣鳳林鎮	2018-11-24T22:58:07+08:00	1046	2774	3820	366	4186	7742	54.07%	13.51%	13	15
15	花蓮縣鳳林鎮	2018-11-24T22:41:49+08:00	934	2502	3436	322	3758	6758	55.61%	13.82%	12	15
15	花蓮縣鳳林鎮	2018-11-24T23:39:31+08:00	1152	3041	4193	411	4604	8484	54.27%	13.58%	14	15
15	花蓮縣鳳林鎮	2018-11-24T23:47:42+08:00	1152	3041	4193	411	4604	8484	54.27%	13.58%	14	15
15	花蓮縣鳳林鎮	2018-11-24T22:30:22+08:00	843	2230	3073	284	3357	6157	54.52%	13.69%	11	15
15	花蓮縣鳳林鎮	2018-11-24T23:51:47+08:00	1152	3041	4193	411	4604	8484	54.27%	13.58%	14	15
15	花蓮縣鳳林鎮	2018-11-24T23:27:30+08:00	1152	3041	4193	411	4604	8484	54.27%	13.58%	14	15
15	花蓮縣鳳林鎮	2018-11-25T06:09:08+08:00	1327	3547	4874	466	5340	9676	55.19%	13.71%	15	15
15	花蓮縣鳳林鎮	2018-11-24T22:13:44+08:00	843	2230	3073	284	3357	6157	54.52%	13.69%	11	15
15	花蓮縣鳳林鎮	2018-11-25T00:57:50+08:00	1327	3547	4874	466	5340	9676	55.19%	13.71%	15	15
15	花蓮縣鳳林鎮	2018-11-25T03:44:39+08:00	1327	3547	4874	466	5340	9676	55.19%	13.71%	15	15
15	花蓮縣鳳林鎮	2018-11-24T23:31:26+08:00	1152	3041	4193	411	4604	8484	54.27%	13.58%	14	15
15	花蓮縣鳳林鎮	2018-11-24T22:33:49+08:00	843	2230	3073	284	3357	6157	54.52%	13.69%	11	15
15	花蓮縣鳳林鎮	2018-11-24T22:37:13+08:00	843	2230	3073	284	3357	6157	54.52%	13.69%	11	15
15	花蓮縣鳳林鎮	2018-11-24T22:16:24+08:00	843	2230	3073	284	3357	6157	54.52%	13.69%	11	15
15	花蓮縣鳳林鎮	2018-11-25T00:18:46+08:00	1327	3547	4874	466	5340	9676	55.19%	13.71%	15	15
15	花蓮縣鳳林鎮	2018-11-24T23:35:21+08:00	1152	3041	4193	411	4604	8484	54.27%	13.58%	14	15
15	花蓮縣鳳林鎮	2018-11-24T23:16:15+08:00	1046	2774	3820	366	4186	7742	54.07%	13.51%	13	15
15	花蓮縣鳳林鎮	2018-11-24T22:54:36+08:00	1046	2774	3820	366	4186	7742	54.07%	13.51%	13	15
15	花蓮縣鳳林鎮	2018-11-25T01:12:58+08:00	1327	3547	4874	466	5340	9676	55.19%	13.71%	15	15
15	花蓮縣鳳林鎮	2018-11-25T00:05:17+08:00	1152	3041	4193	411	4604	8484	54.27%	13.58%	14	15
15	花蓮縣鳳林鎮	2018-11-24T22:45:20+08:00	934	2502	3436	322	3758	6758	55.61%	13.82%	12	15
15	花蓮縣鳳林鎮	2018-11-24T22:26:48+08:00	843	2230	3073	284	3357	6157	54.52%	13.69%	11	15
15	花蓮縣鳳林鎮	2018-11-24T23:01:45+08:00	1046	2774	3820	366	4186	7742	54.07%	13.51%	13	15
15	花蓮縣鳳林鎮	2018-11-25T00:09:49+08:00	1152	3041	4193	411	4604	8484	54.27%	13.58%	14	15
15	花蓮縣鳳林鎮	2018-11-25T04:03:05+08:00	1327	3547	4874	466	5340	9676	55.19%	13.71%	15	15
15	花蓮縣鳳林鎮	2018-11-24T23:23:50+08:00	1046	2774	3820	366	4186	7742	54.07%	13.51%	13	15
15	花蓮縣鳳林鎮	2018-11-24T22:19:49+08:00	843	2230	3073	284	3357	6157	54.52%	13.69%	11	15
15	花蓮縣鳳林鎮	2018-11-24T22:40:39+08:00	934	2502	3436	322	3758	6758	55.61%	13.82%	12	15
15	花蓮縣鳳林鎮	2018-11-25T03:32:51+08:00	1327	3547	4874	466	5340	9676	55.19%	13.71%	15	15
15	花蓮縣鳳林鎮	2018-11-24T23:08:50+08:00	1046	2774	3820	366	4186	7742	54.07%	13.51%	13	15
15	花蓮縣鳳林鎮	2018-11-24T22:23:27+08:00	843	2230	3073	284	3357	6157	54.52%	13.69%	11	15
15	花蓮縣鳳林鎮	2018-11-24T22:51:02+08:00	1046	2774	3820	366	4186	7742	54.07%	13.51%	13	15
15	花蓮縣鳳林鎮	2018-11-25T06:14:04+08:00	1327	3547	4874	466	5340	9676	55.19%	13.71%	15	15
15	花蓮縣鳳林鎮	2018-11-25T00:00:23+08:00	1152	3041	4193	411	4604	8484	54.27%	13.58%	14	15
15	花蓮縣鳳林鎮	2018-11-25T06:24:12+08:00	1327	3547	4874	466	5340	9676	55.19%	13.71%	15	15
15	花蓮縣鳳林鎮	2018-11-25T00:23:16+08:00	1327	3547	4874	466	5340	9676	55.19%	13.71%	15	15
15	花蓮縣鳳林鎮	2018-11-25T01:02:43+08:00	1327	3547	4874	466	5340	9676	55.19%	13.71%	15	15
15	花蓮縣鳳林鎮	2018-11-25T06:29:30+08:00	1327	3547	4874	466	5340	9676	55.19%	13.71%	15	15
15	花蓮縣鳳林鎮	2018-11-24T23:12:29+08:00	1046	2774	3820	366	4186	7742	54.07%	13.51%	13	15
15	花蓮縣鳳林鎮	2018-11-25T03:50:03+08:00	1327	3547	4874	466	5340	9676	55.19%	13.71%	15	15
15	花蓮縣鳳林鎮	2018-11-25T01:07:39+08:00	1327	3547	4874	466	5340	9676	55.19%	13.71%	15	15
15	花蓮縣鳳林鎮	2018-11-25T01:26:07+08:00	1327	3547	4874	466	5340	9676	55.19%	13.71%	15	15
15	花蓮縣鳳林鎮	2018-11-25T03:39:07+08:00	1327	3547	4874	466	5340	9676	55.19%	13.71%	15	15
15	花蓮縣鳳林鎮	2018-11-25T00:14:22+08:00	1152	3041	4193	411	4604	8484	54.27%	13.58%	14	15
15	花蓮縣鳳林鎮	2018-11-24T23:20:05+08:00	1046	2774	3820	366	4186	7742	54.07%	13.51%	13	15
15	臺南市學甲區	2018-11-24T22:41:41+08:00	3357	6682	10039	668	10707	22567	47.45%	14.88%	26	26
15	臺南市學甲區	2018-11-25T00:18:37+08:00	3357	6682	10039	668	10707	22567	47.45%	14.88%	26	26
15	臺南市學甲區	2018-11-24T22:45:13+08:00	3357	6682	10039	668	10707	22567	47.45%	14.88%	26	26
15	臺南市學甲區	2018-11-24T23:16:07+08:00	3357	6682	10039	668	10707	22567	47.45%	14.88%	26	26
15	臺南市學甲區	2018-11-25T03:56:18+08:00	3357	6682	10039	668	10707	22567	47.45%	14.88%	26	26
15	臺南市學甲區	2018-11-24T22:58:00+08:00	3357	6682	10039	668	10707	22567	47.45%	14.88%	26	26
15	臺南市學甲區	2018-11-24T23:51:40+08:00	3357	6682	10039	668	10707	22567	47.45%	14.88%	26	26
15	臺南市學甲區	2018-11-24T22:40:32+08:00	3357	6682	10039	668	10707	22567	47.45%	14.88%	26	26
15	臺南市學甲區	2018-11-25T01:02:36+08:00	3357	6682	10039	668	10707	22567	47.45%	14.88%	26	26
15	臺南市學甲區	2018-11-24T22:19:42+08:00	3357	6682	10039	668	10707	22567	47.45%	14.88%	26	26
15	臺南市學甲區	2018-11-25T01:25:58+08:00	3357	6682	10039	668	10707	22567	47.45%	14.88%	26	26
15	臺南市學甲區	2018-11-24T22:30:15+08:00	3357	6682	10039	668	10707	22567	47.45%	14.88%	26	26
15	臺南市學甲區	2018-11-25T00:23:09+08:00	3357	6682	10039	668	10707	22567	47.45%	14.88%	26	26
15	臺南市學甲區	2018-11-25T00:57:42+08:00	3357	6682	10039	668	10707	22567	47.45%	14.88%	26	26
15	臺南市學甲區	2018-11-25T06:24:05+08:00	3357	6682	10039	668	10707	22567	47.45%	14.88%	26	26
15	臺南市學甲區	2018-11-25T00:00:16+08:00	3357	6682	10039	668	10707	22567	47.45%	14.88%	26	26
15	臺南市學甲區	2018-11-25T01:17:59+08:00	3357	6682	10039	668	10707	22567	47.45%	14.88%	26	26
15	臺南市學甲區	2018-11-24T23:19:57+08:00	3357	6682	10039	668	10707	22567	47.45%	14.88%	26	26
15	臺南市學甲區	2018-11-24T23:55:52+08:00	3357	6682	10039	668	10707	22567	47.45%	14.88%	26	26
15	臺南市學甲區	2018-11-24T22:13:33+08:00	3357	6682	10039	668	10707	22567	47.45%	14.88%	26	26
15	臺南市學甲區	2018-11-24T23:27:23+08:00	3357	6682	10039	668	10707	22567	47.45%	14.88%	26	26
15	臺南市學甲區	2018-11-24T23:39:22+08:00	3357	6682	10039	668	10707	22567	47.45%	14.88%	26	26
15	臺南市學甲區	2018-11-25T01:12:49+08:00	3357	6682	10039	668	10707	22567	47.45%	14.88%	26	26
15	臺南市學甲區	2018-11-25T06:08:59+08:00	3357	6682	10039	668	10707	22567	47.45%	14.88%	26	26
15	臺南市學甲區	2018-11-24T23:31:17+08:00	3357	6682	10039	668	10707	22567	47.45%	14.88%	26	26
15	臺南市學甲區	2018-11-24T23:47:34+08:00	3357	6682	10039	668	10707	22567	47.45%	14.88%	26	26
15	臺南市學甲區	2018-11-24T23:05:09+08:00	3357	6682	10039	668	10707	22567	47.45%	14.88%	26	26
15	臺南市學甲區	2018-11-24T23:01:36+08:00	3357	6682	10039	668	10707	22567	47.45%	14.88%	26	26
15	臺南市學甲區	2018-11-25T04:02:57+08:00	3357	6682	10039	668	10707	22567	47.45%	14.88%	26	26
15	臺南市學甲區	2018-11-25T00:05:10+08:00	3357	6682	10039	668	10707	22567	47.45%	14.88%	26	26
15	臺南市學甲區	2018-11-25T06:19:02+08:00	3357	6682	10039	668	10707	22567	47.45%	14.88%	26	26
15	臺南市學甲區	2018-11-25T06:29:22+08:00	3357	6682	10039	668	10707	22567	47.45%	14.88%	26	26
15	臺南市學甲區	2018-11-25T03:49:56+08:00	3357	6682	10039	668	10707	22567	47.45%	14.88%	26	26
15	臺南市學甲區	2018-11-24T22:54:30+08:00	3357	6682	10039	668	10707	22567	47.45%	14.88%	26	26
15	臺南市學甲區	2018-11-24T22:50:54+08:00	3357	6682	10039	668	10707	22567	47.45%	14.88%	26	26
15	臺南市學甲區	2018-11-25T06:13:57+08:00	3357	6682	10039	668	10707	22567	47.45%	14.88%	26	26
15	臺南市學甲區	2018-11-24T22:37:05+08:00	3357	6682	10039	668	10707	22567	47.45%	14.88%	26	26
15	臺南市學甲區	2018-11-24T23:43:22+08:00	3357	6682	10039	668	10707	22567	47.45%	14.88%	26	26
15	臺南市學甲區	2018-11-25T00:09:40+08:00	3357	6682	10039	668	10707	22567	47.45%	14.88%	26	26
15	臺南市學甲區	2018-11-24T22:26:41+08:00	3357	6682	10039	668	10707	22567	47.45%	14.88%	26	26
15	臺南市學甲區	2018-11-25T03:38:59+08:00	3357	6682	10039	668	10707	22567	47.45%	14.88%	26	26
15	臺南市學甲區	2018-11-25T03:44:29+08:00	3357	6682	10039	668	10707	22567	47.45%	14.88%	26	26
15	臺南市學甲區	2018-11-25T03:32:42+08:00	3357	6682	10039	668	10707	22567	47.45%	14.88%	26	26
15	臺南市學甲區	2018-11-24T23:08:42+08:00	3357	6682	10039	668	10707	22567	47.45%	14.88%	26	26
15	臺南市學甲區	2018-11-24T22:23:19+08:00	3357	6682	10039	668	10707	22567	47.45%	14.88%	26	26
15	臺南市學甲區	2018-11-24T23:23:43+08:00	3357	6682	10039	668	10707	22567	47.45%	14.88%	26	26
15	臺南市學甲區	2018-11-25T00:14:15+08:00	3357	6682	10039	668	10707	22567	47.45%	14.88%	26	26
15	臺南市學甲區	2018-11-24T23:35:15+08:00	3357	6682	10039	668	10707	22567	47.45%	14.88%	26	26
15	臺南市學甲區	2018-11-24T22:33:43+08:00	3357	6682	10039	668	10707	22567	47.45%	14.88%	26	26
15	臺南市學甲區	2018-11-24T23:12:21+08:00	3357	6682	10039	668	10707	22567	47.45%	14.88%	26	26
15	臺南市學甲區	2018-11-24T22:16:16+08:00	3357	6682	10039	668	10707	22567	47.45%	14.88%	26	26
15	臺南市學甲區	2018-11-25T01:07:31+08:00	3357	6682	10039	668	10707	22567	47.45%	14.88%	26	26
15	屏東縣霧臺鄉	2018-11-25T03:56:26+08:00	433	1268	1701	108	1809	2950	61.32%	14.68%	8	8
15	屏東縣霧臺鄉	2018-11-24T23:05:15+08:00	301	840	1141	69	1210	1977	61.2%	15.23%	6	8
15	屏東縣霧臺鄉	2018-11-25T01:18:08+08:00	433	1268	1701	108	1809	2950	61.32%	14.68%	8	8
15	屏東縣霧臺鄉	2018-11-24T23:39:30+08:00	433	1268	1701	108	1809	2950	61.32%	14.68%	8	8
15	屏東縣霧臺鄉	2018-11-24T22:41:48+08:00	301	840	1141	69	1210	1977	61.2%	15.23%	6	8
15	屏東縣霧臺鄉	2018-11-25T06:29:29+08:00	433	1268	1701	108	1809	2950	61.32%	14.68%	8	8
15	屏東縣霧臺鄉	2018-11-25T06:19:09+08:00	433	1268	1701	108	1809	2950	61.32%	14.68%	8	8
15	屏東縣霧臺鄉	2018-11-24T22:58:07+08:00	301	840	1141	69	1210	1977	61.2%	15.23%	6	8
15	屏東縣霧臺鄉	2018-11-24T23:43:28+08:00	433	1268	1701	108	1809	2950	61.32%	14.68%	8	8
15	屏東縣霧臺鄉	2018-11-25T06:09:07+08:00	433	1268	1701	108	1809	2950	61.32%	14.68%	8	8
15	屏東縣霧臺鄉	2018-11-24T22:30:22+08:00	223	604	827	56	883	1494	59.1%	14.93%	5	8
15	屏東縣霧臺鄉	2018-11-24T23:51:47+08:00	433	1268	1701	108	1809	2950	61.32%	14.68%	8	8
15	屏東縣霧臺鄉	2018-11-24T22:13:43+08:00	223	604	827	56	883	1494	59.1%	14.93%	5	8
15	屏東縣霧臺鄉	2018-11-24T23:08:49+08:00	393	1126	1519	79	1598	2654	60.21%	14.81%	7	8
15	屏東縣霧臺鄉	2018-11-24T22:51:01+08:00	301	840	1141	69	1210	1977	61.2%	15.23%	6	8
15	屏東縣霧臺鄉	2018-11-25T03:44:38+08:00	433	1268	1701	108	1809	2950	61.32%	14.68%	8	8
15	屏東縣霧臺鄉	2018-11-25T00:23:15+08:00	433	1268	1701	108	1809	2950	61.32%	14.68%	8	8
15	屏東縣霧臺鄉	2018-11-24T23:23:49+08:00	433	1268	1701	108	1809	2950	61.32%	14.68%	8	8
15	屏東縣霧臺鄉	2018-11-24T22:33:49+08:00	301	840	1141	69	1210	1977	61.2%	15.23%	6	8
15	屏東縣霧臺鄉	2018-11-24T22:37:12+08:00	301	840	1141	69	1210	1977	61.2%	15.23%	6	8
15	屏東縣霧臺鄉	2018-11-24T23:16:14+08:00	433	1268	1701	108	1809	2950	61.32%	14.68%	8	8
15	屏東縣霧臺鄉	2018-11-25T01:26:05+08:00	433	1268	1701	108	1809	2950	61.32%	14.68%	8	8
15	屏東縣霧臺鄉	2018-11-24T22:16:23+08:00	223	604	827	56	883	1494	59.1%	14.93%	5	8
15	屏東縣霧臺鄉	2018-11-25T00:14:21+08:00	433	1268	1701	108	1809	2950	61.32%	14.68%	8	8
15	屏東縣霧臺鄉	2018-11-24T23:35:21+08:00	433	1268	1701	108	1809	2950	61.32%	14.68%	8	8
15	屏東縣霧臺鄉	2018-11-24T22:45:19+08:00	301	840	1141	69	1210	1977	61.2%	15.23%	6	8
15	屏東縣霧臺鄉	2018-11-24T22:54:36+08:00	301	840	1141	69	1210	1977	61.2%	15.23%	6	8
15	屏東縣霧臺鄉	2018-11-25T00:09:48+08:00	433	1268	1701	108	1809	2950	61.32%	14.68%	8	8
15	屏東縣霧臺鄉	2018-11-24T23:01:44+08:00	301	840	1141	69	1210	1977	61.2%	15.23%	6	8
15	屏東縣霧臺鄉	2018-11-24T22:26:47+08:00	223	604	827	56	883	1494	59.1%	14.93%	5	8
15	屏東縣霧臺鄉	2018-11-24T23:47:41+08:00	433	1268	1701	108	1809	2950	61.32%	14.68%	8	8
15	屏東縣霧臺鄉	2018-11-25T01:12:57+08:00	433	1268	1701	108	1809	2950	61.32%	14.68%	8	8
15	屏東縣霧臺鄉	2018-11-25T00:05:16+08:00	433	1268	1701	108	1809	2950	61.32%	14.68%	8	8
15	屏東縣霧臺鄉	2018-11-25T00:57:49+08:00	433	1268	1701	108	1809	2950	61.32%	14.68%	8	8
15	屏東縣霧臺鄉	2018-11-24T22:19:48+08:00	223	604	827	56	883	1494	59.1%	14.93%	5	8
15	屏東縣霧臺鄉	2018-11-25T03:32:50+08:00	433	1268	1701	108	1809	2950	61.32%	14.68%	8	8
15	屏東縣霧臺鄉	2018-11-25T04:03:04+08:00	433	1268	1701	108	1809	2950	61.32%	14.68%	8	8
15	屏東縣霧臺鄉	2018-11-24T22:40:39+08:00	301	840	1141	69	1210	1977	61.2%	15.23%	6	8
15	屏東縣霧臺鄉	2018-11-25T01:02:42+08:00	433	1268	1701	108	1809	2950	61.32%	14.68%	8	8
15	屏東縣霧臺鄉	2018-11-25T06:14:03+08:00	433	1268	1701	108	1809	2950	61.32%	14.68%	8	8
15	屏東縣霧臺鄉	2018-11-24T23:55:59+08:00	433	1268	1701	108	1809	2950	61.32%	14.68%	8	8
15	屏東縣霧臺鄉	2018-11-25T06:24:12+08:00	433	1268	1701	108	1809	2950	61.32%	14.68%	8	8
15	屏東縣霧臺鄉	2018-11-24T22:23:26+08:00	223	604	827	56	883	1494	59.1%	14.93%	5	8
15	屏東縣霧臺鄉	2018-11-24T23:27:29+08:00	433	1268	1701	108	1809	2950	61.32%	14.68%	8	8
15	屏東縣霧臺鄉	2018-11-25T00:00:22+08:00	433	1268	1701	108	1809	2950	61.32%	14.68%	8	8
15	屏東縣霧臺鄉	2018-11-24T23:31:25+08:00	433	1268	1701	108	1809	2950	61.32%	14.68%	8	8
15	屏東縣霧臺鄉	2018-11-24T23:20:04+08:00	433	1268	1701	108	1809	2950	61.32%	14.68%	8	8
15	屏東縣霧臺鄉	2018-11-25T00:18:45+08:00	433	1268	1701	108	1809	2950	61.32%	14.68%	8	8
15	屏東縣霧臺鄉	2018-11-25T01:07:38+08:00	433	1268	1701	108	1809	2950	61.32%	14.68%	8	8
15	屏東縣霧臺鄉	2018-11-25T03:39:06+08:00	433	1268	1701	108	1809	2950	61.32%	14.68%	8	8
15	屏東縣霧臺鄉	2018-11-25T03:50:02+08:00	433	1268	1701	108	1809	2950	61.32%	14.68%	8	8
15	屏東縣霧臺鄉	2018-11-24T23:12:28+08:00	393	1126	1519	79	1598	2654	60.21%	14.81%	7	8
15	臺南市白河區	2018-11-25T03:49:55+08:00	3476	6415	9891	838	10729	24894	43.1%	13.96%	32	32
15	臺南市白河區	2018-11-24T22:41:41+08:00	3476	6415	9891	838	10729	24894	43.1%	13.96%	32	32
15	臺南市白河區	2018-11-24T22:45:13+08:00	3476	6415	9891	838	10729	24894	43.1%	13.96%	32	32
15	臺南市白河區	2018-11-24T23:16:07+08:00	3476	6415	9891	838	10729	24894	43.1%	13.96%	32	32
15	臺南市白河區	2018-11-25T03:56:18+08:00	3476	6415	9891	838	10729	24894	43.1%	13.96%	32	32
15	臺南市白河區	2018-11-24T23:43:21+08:00	3476	6415	9891	838	10729	24894	43.1%	13.96%	32	32
15	臺南市白河區	2018-11-25T00:18:36+08:00	3476	6415	9891	838	10729	24894	43.1%	13.96%	32	32
15	臺南市白河區	2018-11-24T23:51:40+08:00	3476	6415	9891	838	10729	24894	43.1%	13.96%	32	32
15	臺南市白河區	2018-11-24T22:40:32+08:00	3476	6415	9891	838	10729	24894	43.1%	13.96%	32	32
15	臺南市白河區	2018-11-25T01:25:57+08:00	3476	6415	9891	838	10729	24894	43.1%	13.96%	32	32
15	臺南市白河區	2018-11-25T01:02:36+08:00	3476	6415	9891	838	10729	24894	43.1%	13.96%	32	32
15	臺南市白河區	2018-11-24T22:30:14+08:00	3476	6415	9891	838	10729	24894	43.1%	13.96%	32	32
15	臺南市白河區	2018-11-25T00:23:08+08:00	3476	6415	9891	838	10729	24894	43.1%	13.96%	32	32
15	臺南市白河區	2018-11-25T00:57:42+08:00	3476	6415	9891	838	10729	24894	43.1%	13.96%	32	32
15	臺南市白河區	2018-11-25T06:24:05+08:00	3476	6415	9891	838	10729	24894	43.1%	13.96%	32	32
15	臺南市白河區	2018-11-24T23:27:22+08:00	3476	6415	9891	838	10729	24894	43.1%	13.96%	32	32
15	臺南市白河區	2018-11-24T22:57:59+08:00	3476	6415	9891	838	10729	24894	43.1%	13.96%	32	32
15	臺南市白河區	2018-11-24T23:19:57+08:00	3476	6415	9891	838	10729	24894	43.1%	13.96%	32	32
15	臺南市白河區	2018-11-25T03:32:41+08:00	3476	6415	9891	838	10729	24894	43.1%	13.96%	32	32
15	臺南市白河區	2018-11-24T23:08:41+08:00	3476	6415	9891	838	10729	24894	43.1%	13.96%	32	32
15	臺南市白河區	2018-11-24T22:13:33+08:00	3476	6415	9891	838	10729	24894	43.1%	13.96%	32	32
15	臺南市白河區	2018-11-25T01:17:58+08:00	3476	6415	9891	838	10729	24894	43.1%	13.96%	32	32
15	臺南市白河區	2018-11-24T23:39:22+08:00	3476	6415	9891	838	10729	24894	43.1%	13.96%	32	32
15	臺南市白河區	2018-11-25T01:12:49+08:00	3476	6415	9891	838	10729	24894	43.1%	13.96%	32	32
15	臺南市白河區	2018-11-25T06:08:59+08:00	3476	6415	9891	838	10729	24894	43.1%	13.96%	32	32
15	臺南市白河區	2018-11-24T23:31:17+08:00	3476	6415	9891	838	10729	24894	43.1%	13.96%	32	32
15	臺南市白河區	2018-11-24T23:47:33+08:00	3476	6415	9891	838	10729	24894	43.1%	13.96%	32	32
15	臺南市白河區	2018-11-24T23:05:09+08:00	3476	6415	9891	838	10729	24894	43.1%	13.96%	32	32
15	臺南市白河區	2018-11-24T23:01:36+08:00	3476	6415	9891	838	10729	24894	43.1%	13.96%	32	32
15	臺南市白河區	2018-11-25T04:02:57+08:00	3476	6415	9891	838	10729	24894	43.1%	13.96%	32	32
15	臺南市白河區	2018-11-25T00:05:10+08:00	3476	6415	9891	838	10729	24894	43.1%	13.96%	32	32
15	臺南市白河區	2018-11-25T06:19:02+08:00	3476	6415	9891	838	10729	24894	43.1%	13.96%	32	32
15	臺南市白河區	2018-11-25T06:29:22+08:00	3476	6415	9891	838	10729	24894	43.1%	13.96%	32	32
15	臺南市白河區	2018-11-24T22:54:30+08:00	3476	6415	9891	838	10729	24894	43.1%	13.96%	32	32
15	臺南市白河區	2018-11-25T06:13:57+08:00	3476	6415	9891	838	10729	24894	43.1%	13.96%	32	32
15	臺南市白河區	2018-11-24T22:50:53+08:00	3476	6415	9891	838	10729	24894	43.1%	13.96%	32	32
15	臺南市白河區	2018-11-24T22:37:05+08:00	3476	6415	9891	838	10729	24894	43.1%	13.96%	32	32
15	臺南市白河區	2018-11-24T22:26:41+08:00	3476	6415	9891	838	10729	24894	43.1%	13.96%	32	32
15	臺南市白河區	2018-11-24T22:19:41+08:00	3476	6415	9891	838	10729	24894	43.1%	13.96%	32	32
15	臺南市白河區	2018-11-25T03:38:59+08:00	3476	6415	9891	838	10729	24894	43.1%	13.96%	32	32
15	臺南市白河區	2018-11-25T03:44:29+08:00	3476	6415	9891	838	10729	24894	43.1%	13.96%	32	32
15	臺南市白河區	2018-11-25T00:00:15+08:00	3476	6415	9891	838	10729	24894	43.1%	13.96%	32	32
15	臺南市白河區	2018-11-24T22:23:19+08:00	3476	6415	9891	838	10729	24894	43.1%	13.96%	32	32
15	臺南市白河區	2018-11-24T23:23:43+08:00	3476	6415	9891	838	10729	24894	43.1%	13.96%	32	32
15	臺南市白河區	2018-11-24T23:55:51+08:00	3476	6415	9891	838	10729	24894	43.1%	13.96%	32	32
15	臺南市白河區	2018-11-24T23:35:15+08:00	3476	6415	9891	838	10729	24894	43.1%	13.96%	32	32
15	臺南市白河區	2018-11-24T23:12:20+08:00	3476	6415	9891	838	10729	24894	43.1%	13.96%	32	32
15	臺南市白河區	2018-11-25T00:14:14+08:00	3476	6415	9891	838	10729	24894	43.1%	13.96%	32	32
15	臺南市白河區	2018-11-24T22:16:16+08:00	3476	6415	9891	838	10729	24894	43.1%	13.96%	32	32
15	臺南市白河區	2018-11-25T00:09:39+08:00	3476	6415	9891	838	10729	24894	43.1%	13.96%	32	32
15	臺南市白河區	2018-11-25T01:07:31+08:00	3476	6415	9891	838	10729	24894	43.1%	13.96%	32	32
15	臺南市白河區	2018-11-24T22:33:42+08:00	3476	6415	9891	838	10729	24894	43.1%	13.96%	32	32
15	全國	2018-11-25T06:29:19+08:00	3507665	6805171	10312836	619001	10931837	19757067	55.33%	17.75%	887	15
15	全國	2018-11-25T01:07:28+08:00	3419991	6646535	10066526	607243	10673769	19293289	55.32%	17.73%	593	15
15	全國	2018-11-25T03:49:53+08:00	3507665	6805171	10312836	619001	10931837	19757067	55.33%	17.75%	887	15
15	全國	2018-11-24T22:50:50+08:00	2455342	4800985	7256327	459699	7716026	13991234	55.15%	17.55%	989	15
15	全國	2018-11-25T06:13:54+08:00	3507665	6805171	10312836	619001	10931837	19757067	55.33%	17.75%	887	15
15	全國	2018-11-24T23:43:19+08:00	3044799	5934876	8979675	552607	9532282	17243920	55.28%	17.66%	241	15
15	全國	2018-11-24T22:13:29+08:00	1910727	3739467	5650194	368025	6018219	10944016	54.99%	17.46%	766	15
15	全國	2018-11-25T03:32:36+08:00	3507145	6804045	10311190	618915	10930105	19753878	55.33%	17.75%	885	15
15	全國	2018-11-25T00:23:06+08:00	3283262	6392923	9676185	588200	10264385	18563955	55.29%	17.69%	115	15
15	全國	2018-11-25T03:44:25+08:00	3507356	6804427	10311783	618939	10930722	19755022	55.33%	17.75%	886	15
15	全國	2018-11-24T23:08:38+08:00	2686661	5244211	7930872	496273	8427145	15260068	55.22%	17.61%	885	15
15	全國	2018-11-24T23:55:49+08:00	3131547	6101634	9233181	565728	9798909	17723147	55.29%	17.67%	563	15
15	全國	2018-11-25T06:24:02+08:00	3507665	6805171	10312836	619001	10931837	19757067	55.33%	17.75%	887	15
15	全國	2018-11-24T23:51:37+08:00	3090179	6022579	9112758	559736	9672494	17495029	55.29%	17.66%	414	15
15	全國	2018-11-24T22:23:15+08:00	2068143	4041747	6109890	394671	6504561	11817097	55.04%	17.5%	403	15
15	全國	2018-11-24T22:40:29+08:00	2329709	4555284	6884993	439452	7324445	13287063	55.12%	17.53%	481	15
15	全國	2018-11-25T06:18:59+08:00	3507665	6805171	10312836	619001	10931837	19757067	55.33%	17.75%	887	15
15	全國	2018-11-24T22:57:56+08:00	2532369	4947953	7480322	472005	7952327	14415164	55.17%	17.57%	288	15
15	全國	2018-11-24T23:23:40+08:00	2851257	5562585	8413842	522775	8936617	16173251	55.26%	17.63%	522	15
15	全國	2018-11-24T22:33:40+08:00	2198984	4296719	6495703	417124	6912827	12548089	55.09%	17.52%	940	15
15	全國	2018-11-24T22:54:27+08:00	2494125	4875163	7369288	465975	7835263	14205809	55.16%	17.56%	142	15
15	全國	2018-11-24T22:16:13+08:00	1962903	3839986	5802889	376814	6179703	11235773	55%	17.47%	979	15
15	全國	2018-11-25T00:14:11+08:00	3236418	6304644	9541062	581285	10122347	18307476	55.29%	17.68%	948	15
15	全國	2018-11-25T01:12:46+08:00	3424858	6656264	10081122	607889	10689011	19320073	55.33%	17.73%	609	15
15	全國	2018-11-24T22:41:37+08:00	2329709	4555284	6884993	439452	7324445	13287063	55.12%	17.53%	481	15
15	全國	2018-11-25T00:05:07+08:00	3190315	6213936	9404251	574364	9978615	18049785	55.28%	17.68%	778	15
15	全國	2018-11-24T23:05:06+08:00	2652534	5178093	7830627	491078	8321705	15071760	55.21%	17.6%	752	15
15	全國	2018-11-24T22:45:10+08:00	2370194	4635182	7005376	445983	7451359	13518440	55.12%	17.53%	651	15
15	全國	2018-11-24T23:16:05+08:00	2784800	5434176	8218976	512071	8731047	15803288	55.25%	17.62%	273	15
15	全國	2018-11-24T22:37:02+08:00	2246592	4389852	6636444	425379	7061823	12815992	55.1%	17.53%	134	15
15	全國	2018-11-25T00:18:32+08:00	3254962	6340004	9594966	583914	10178880	18408849	55.29%	17.68%	013	15
15	全國	2018-11-25T03:56:15+08:00	3507665	6805171	10312836	619001	10931837	19757067	55.33%	17.75%	887	15
15	全國	2018-11-25T03:38:57+08:00	3507356	6804427	10311783	618939	10930722	19755022	55.33%	17.75%	886	15
15	全國	2018-11-24T22:30:11+08:00	2159554	4220223	6379777	410307	6790084	12328706	55.08%	17.52%	776	15
15	全國	2018-11-25T01:02:33+08:00	3410002	6626857	10036859	605741	10642600	19236707	55.32%	17.73%	556	15
15	全國	2018-11-25T01:25:55+08:00	3445013	6693762	10138775	610560	10749335	19429484	55.32%	17.73%	677	15
15	全國	2018-11-25T00:57:39+08:00	3397664	6604734	10002398	604021	10606419	19170291	55.33%	17.72%	515	15
15	全國	2018-11-24T23:19:53+08:00	2820434	5500955	8321389	517803	8839192	15998727	55.25%	17.63%	405	15
15	全國	2018-11-25T01:17:55+08:00	3434875	6674118	10108993	609040	10718033	19372749	55.33%	17.73%	640	15
15	全國	2018-11-24T22:19:39+08:00	2015027	3938280	5953307	385643	6338950	11519747	55.03%	17.49%	189	15
15	全國	2018-11-24T23:27:20+08:00	2881116	5619532	8500648	527330	9027978	16339839	55.25%	17.63%	633	15
15	全國	2018-11-25T00:00:13+08:00	3153922	6144315	9298237	569023	9867260	17848468	55.28%	17.67%	644	15
15	全國	2018-11-24T23:35:12+08:00	2963598	5779120	8742718	540039	9282757	16799513	55.26%	17.64%	940	15
15	全國	2018-11-25T00:09:36+08:00	3201696	6238539	9440235	576199	10016434	18118770	55.28%	17.67%	822	15
15	全國	2018-11-24T23:01:33+08:00	2614539	5104522	7719061	484736	8203797	14862285	55.2%	17.59%	603	15
15	全國	2018-11-24T23:31:13+08:00	2936254	5726570	8662824	535860	9198684	16646893	55.26%	17.64%	837	15
15	全國	2018-11-24T23:47:31+08:00	3071100	5985213	9056313	556742	9613055	17387690	55.29%	17.66%	339	15
15	全國	2018-11-25T04:02:54+08:00	3507665	6805171	10312836	619001	10931837	19757067	55.33%	17.75%	887	15
15	全國	2018-11-24T22:26:38+08:00	2114383	4131382	6245765	402492	6648257	12075423	55.06%	17.51%	590	15
15	全國	2018-11-24T23:12:17+08:00	2716043	5299770	8015813	501172	8516985	15422249	55.23%	17.61%	002	15
15	全國	2018-11-24T23:39:18+08:00	2994675	5840348	8835023	544858	9379881	16972887	55.26%	17.64%	058	15
15	全國	2018-11-25T06:08:55+08:00	3507665	6805171	10312836	619001	10931837	19757067	55.33%	17.75%	887	15
15	屏東縣高樹鄉	2018-11-24T22:58:06+08:00	2906	5586	8492	977	9469	19322	49.01%	15.04%	20	22
15	屏東縣高樹鄉	2018-11-25T06:19:08+08:00	3246	6296	9542	1121	10663	21697	49.15%	14.96%	22	22
15	屏東縣高樹鄉	2018-11-24T23:43:27+08:00	3246	6296	9542	1121	10663	21697	49.15%	14.96%	22	22
15	屏東縣高樹鄉	2018-11-24T22:54:35+08:00	2906	5586	8492	977	9469	19322	49.01%	15.04%	20	22
15	屏東縣高樹鄉	2018-11-24T22:41:48+08:00	2906	5586	8492	977	9469	19322	49.01%	15.04%	20	22
15	屏東縣高樹鄉	2018-11-24T23:05:14+08:00	2906	5586	8492	977	9469	19322	49.01%	15.04%	20	22
15	屏東縣高樹鄉	2018-11-25T06:29:29+08:00	3246	6296	9542	1121	10663	21697	49.15%	14.96%	22	22
15	屏東縣高樹鄉	2018-11-25T01:18:07+08:00	3246	6296	9542	1121	10663	21697	49.15%	14.96%	22	22
15	屏東縣高樹鄉	2018-11-24T22:13:42+08:00	2760	5302	8062	931	8993	18400	48.88%	15%	19	22
15	屏東縣高樹鄉	2018-11-24T23:51:46+08:00	3246	6296	9542	1121	10663	21697	49.15%	14.96%	22	22
15	屏東縣高樹鄉	2018-11-25T06:09:06+08:00	3246	6296	9542	1121	10663	21697	49.15%	14.96%	22	22
15	屏東縣高樹鄉	2018-11-25T06:24:11+08:00	3246	6296	9542	1121	10663	21697	49.15%	14.96%	22	22
15	屏東縣高樹鄉	2018-11-24T23:08:49+08:00	2906	5586	8492	977	9469	19322	49.01%	15.04%	20	22
15	屏東縣高樹鄉	2018-11-24T23:23:48+08:00	3062	5955	9017	1049	10066	20438	49.25%	14.98%	21	22
15	屏東縣高樹鄉	2018-11-25T03:44:38+08:00	3246	6296	9542	1121	10663	21697	49.15%	14.96%	22	22
15	屏東縣高樹鄉	2018-11-25T00:23:15+08:00	3246	6296	9542	1121	10663	21697	49.15%	14.96%	22	22
15	屏東縣高樹鄉	2018-11-25T00:00:21+08:00	3246	6296	9542	1121	10663	21697	49.15%	14.96%	22	22
15	屏東縣高樹鄉	2018-11-24T22:51:00+08:00	2906	5586	8492	977	9469	19322	49.01%	15.04%	20	22
15	屏東縣高樹鄉	2018-11-25T03:32:49+08:00	3246	6296	9542	1121	10663	21697	49.15%	14.96%	22	22
15	屏東縣高樹鄉	2018-11-24T22:37:12+08:00	2906	5586	8492	977	9469	19322	49.01%	15.04%	20	22
15	屏東縣高樹鄉	2018-11-24T23:16:14+08:00	3062	5955	9017	1049	10066	20438	49.25%	14.98%	21	22
15	屏東縣高樹鄉	2018-11-24T23:35:20+08:00	3246	6296	9542	1121	10663	21697	49.15%	14.96%	22	22
15	屏東縣高樹鄉	2018-11-25T01:26:05+08:00	3246	6296	9542	1121	10663	21697	49.15%	14.96%	22	22
15	屏東縣高樹鄉	2018-11-25T03:39:05+08:00	3246	6296	9542	1121	10663	21697	49.15%	14.96%	22	22
15	屏東縣高樹鄉	2018-11-24T22:33:48+08:00	2906	5586	8492	977	9469	19322	49.01%	15.04%	20	22
15	屏東縣高樹鄉	2018-11-25T03:50:01+08:00	3246	6296	9542	1121	10663	21697	49.15%	14.96%	22	22
15	屏東縣高樹鄉	2018-11-24T22:16:23+08:00	2906	5586	8492	977	9469	19322	49.01%	15.04%	20	22
15	屏東縣高樹鄉	2018-11-25T00:14:21+08:00	3246	6296	9542	1121	10663	21697	49.15%	14.96%	22	22
15	屏東縣高樹鄉	2018-11-25T01:12:56+08:00	3246	6296	9542	1121	10663	21697	49.15%	14.96%	22	22
15	屏東縣高樹鄉	2018-11-24T23:01:43+08:00	2906	5586	8492	977	9469	19322	49.01%	15.04%	20	22
15	屏東縣高樹鄉	2018-11-25T03:56:25+08:00	3246	6296	9542	1121	10663	21697	49.15%	14.96%	22	22
15	屏東縣高樹鄉	2018-11-24T23:47:41+08:00	3246	6296	9542	1121	10663	21697	49.15%	14.96%	22	22
15	屏東縣高樹鄉	2018-11-24T22:45:18+08:00	2906	5586	8492	977	9469	19322	49.01%	15.04%	20	22
15	屏東縣高樹鄉	2018-11-25T00:09:47+08:00	3246	6296	9542	1121	10663	21697	49.15%	14.96%	22	22
15	屏東縣高樹鄉	2018-11-24T22:26:46+08:00	2906	5586	8492	977	9469	19322	49.01%	15.04%	20	22
15	屏東縣高樹鄉	2018-11-25T00:05:16+08:00	3246	6296	9542	1121	10663	21697	49.15%	14.96%	22	22
15	屏東縣高樹鄉	2018-11-24T22:30:21+08:00	2906	5586	8492	977	9469	19322	49.01%	15.04%	20	22
15	屏東縣高樹鄉	2018-11-24T22:40:38+08:00	2906	5586	8492	977	9469	19322	49.01%	15.04%	20	22
15	屏東縣高樹鄉	2018-11-25T04:03:03+08:00	3246	6296	9542	1121	10663	21697	49.15%	14.96%	22	22
15	屏東縣高樹鄉	2018-11-25T00:57:48+08:00	3246	6296	9542	1121	10663	21697	49.15%	14.96%	22	22
15	屏東縣高樹鄉	2018-11-24T22:19:47+08:00	2906	5586	8492	977	9469	19322	49.01%	15.04%	20	22
15	屏東縣高樹鄉	2018-11-24T23:27:28+08:00	3062	5955	9017	1049	10066	20438	49.25%	14.98%	21	22
15	屏東縣高樹鄉	2018-11-25T01:02:42+08:00	3246	6296	9542	1121	10663	21697	49.15%	14.96%	22	22
15	屏東縣高樹鄉	2018-11-25T06:14:03+08:00	3246	6296	9542	1121	10663	21697	49.15%	14.96%	22	22
15	屏東縣高樹鄉	2018-11-24T22:23:26+08:00	2906	5586	8492	977	9469	19322	49.01%	15.04%	20	22
15	屏東縣高樹鄉	2018-11-24T23:55:58+08:00	3246	6296	9542	1121	10663	21697	49.15%	14.96%	22	22
15	屏東縣高樹鄉	2018-11-25T00:18:44+08:00	3246	6296	9542	1121	10663	21697	49.15%	14.96%	22	22
15	屏東縣高樹鄉	2018-11-24T23:20:03+08:00	3062	5955	9017	1049	10066	20438	49.25%	14.98%	21	22
15	屏東縣高樹鄉	2018-11-25T01:07:37+08:00	3246	6296	9542	1121	10663	21697	49.15%	14.96%	22	22
15	屏東縣高樹鄉	2018-11-24T23:39:29+08:00	3246	6296	9542	1121	10663	21697	49.15%	14.96%	22	22
15	屏東縣高樹鄉	2018-11-24T23:12:28+08:00	3062	5955	9017	1049	10066	20438	49.25%	14.98%	21	22
15	屏東縣高樹鄉	2018-11-24T23:31:24+08:00	3246	6296	9542	1121	10663	21697	49.15%	14.96%	22	22
15	臺南市安南區	2018-11-24T23:16:08+08:00	18803	35524	54327	3185	57512	110507	52.04%	17.02%	65	90
15	臺南市安南區	2018-11-25T03:56:19+08:00	27446	51577	79023	4606	83629	159654	52.38%	17.19%	90	90
15	臺南市安南區	2018-11-25T00:18:37+08:00	26007	49093	75100	4370	79470	151590	52.42%	17.16%	86	90
15	臺南市安南區	2018-11-24T22:45:14+08:00	15012	28262	43274	2541	45815	87594	52.3%	17.14%	54	90
15	臺南市安南區	2018-11-24T22:58:00+08:00	17332	32884	50216	2939	53155	101881	52.17%	17.01%	61	90
15	臺南市安南區	2018-11-24T22:26:42+08:00	12577	23781	36358	2123	38481	73081	52.66%	17.21%	46	90
15	臺南市安南區	2018-11-25T01:18:00+08:00	27446	51577	79023	4606	83629	159654	52.38%	17.19%	90	90
15	臺南市安南區	2018-11-24T22:37:06+08:00	13938	26396	40334	2361	42695	81372	52.47%	17.13%	51	90
15	臺南市安南區	2018-11-25T06:09:00+08:00	27446	51577	79023	4606	83629	159654	52.38%	17.19%	90	90
15	臺南市安南區	2018-11-25T00:57:43+08:00	27446	51577	79023	4606	83629	159654	52.38%	17.19%	90	90
15	臺南市安南區	2018-11-24T22:19:42+08:00	12266	23232	35498	2079	37577	71297	52.7%	17.2%	45	90
15	臺南市安南區	2018-11-25T01:25:58+08:00	27446	51577	79023	4606	83629	159654	52.38%	17.19%	90	90
15	臺南市安南區	2018-11-24T22:30:15+08:00	13209	24988	38197	2257	40454	77009	52.53%	17.15%	48	90
15	臺南市安南區	2018-11-25T01:02:37+08:00	27446	51577	79023	4606	83629	159654	52.38%	17.19%	90	90
15	臺南市安南區	2018-11-24T22:40:33+08:00	14666	27729	42395	2485	44880	85685	52.38%	17.12%	53	90
15	臺南市安南區	2018-11-24T23:51:41+08:00	24361	45826	70187	4100	74287	141566	52.48%	17.21%	81	90
15	臺南市安南區	2018-11-25T00:00:16+08:00	25021	47159	72180	4190	76370	145866	52.36%	17.15%	83	90
15	臺南市安南區	2018-11-24T22:13:35+08:00	11548	21531	33079	1952	35031	65982	53.09%	17.5%	42	90
15	臺南市安南區	2018-11-24T23:55:52+08:00	25021	47159	72180	4190	76370	145866	52.36%	17.15%	83	90
15	臺南市安南區	2018-11-24T23:19:58+08:00	19130	36190	55320	3248	58568	112310	52.15%	17.03%	66	90
15	臺南市安南區	2018-11-24T23:27:24+08:00	20160	37946	58106	3421	61527	117522	52.35%	17.15%	69	90
15	臺南市安南區	2018-11-25T03:44:30+08:00	27446	51577	79023	4606	83629	159654	52.38%	17.19%	90	90
15	臺南市安南區	2018-11-24T23:01:37+08:00	17332	32884	50216	2939	53155	101881	52.17%	17.01%	61	90
15	臺南市安南區	2018-11-25T04:02:58+08:00	27446	51577	79023	4606	83629	159654	52.38%	17.19%	90	90
15	臺南市安南區	2018-11-25T00:14:16+08:00	26007	49093	75100	4370	79470	151590	52.42%	17.16%	86	90
15	臺南市安南區	2018-11-24T23:35:16+08:00	22069	41413	63482	3783	67265	128707	52.26%	17.15%	74	90
15	臺南市安南區	2018-11-24T23:12:22+08:00	18057	34199	52256	3046	55302	105817	52.26%	17.06%	63	90
15	臺南市安南區	2018-11-24T23:31:18+08:00	21314	40114	61428	3632	65060	124467	52.27%	17.12%	72	90
15	臺南市安南區	2018-11-24T23:39:23+08:00	22674	42608	65282	3894	69176	132066	52.38%	17.17%	76	90
15	臺南市安南區	2018-11-25T01:07:32+08:00	27446	51577	79023	4606	83629	159654	52.38%	17.19%	90	90
15	臺南市安南區	2018-11-24T23:47:35+08:00	23481	44167	67648	3963	71611	136628	52.41%	17.19%	78	90
15	臺南市安南區	2018-11-24T22:41:42+08:00	14666	27729	42395	2485	44880	85685	52.38%	17.12%	53	90
15	臺南市安南區	2018-11-25T06:13:58+08:00	27446	51577	79023	4606	83629	159654	52.38%	17.19%	90	90
15	臺南市安南區	2018-11-24T22:54:31+08:00	16979	32274	49253	2887	52140	100081	52.1%	16.97%	60	90
15	臺南市安南區	2018-11-24T22:50:55+08:00	16029	30309	46338	2715	49053	93972	52.2%	17.06%	57	90
15	臺南市安南區	2018-11-25T00:09:41+08:00	26007	49093	75100	4370	79470	151590	52.42%	17.16%	86	90
15	臺南市安南區	2018-11-25T01:12:50+08:00	27446	51577	79023	4606	83629	159654	52.38%	17.19%	90	90
15	臺南市安南區	2018-11-24T23:43:22+08:00	23201	43400	66601	3920	70521	134615	52.39%	17.24%	77	90
15	臺南市安南區	2018-11-25T06:29:23+08:00	27446	51577	79023	4606	83629	159654	52.38%	17.19%	90	90
15	臺南市安南區	2018-11-25T03:49:57+08:00	27446	51577	79023	4606	83629	159654	52.38%	17.19%	90	90
15	臺南市安南區	2018-11-24T23:05:10+08:00	17332	32884	50216	2939	53155	101881	52.17%	17.01%	61	90
15	臺南市安南區	2018-11-25T06:19:03+08:00	27446	51577	79023	4606	83629	159654	52.38%	17.19%	90	90
15	臺南市安南區	2018-11-25T00:05:11+08:00	26007	49093	75100	4370	79470	151590	52.42%	17.16%	86	90
15	臺南市安南區	2018-11-25T06:24:06+08:00	27446	51577	79023	4606	83629	159654	52.38%	17.19%	90	90
15	臺南市安南區	2018-11-24T23:08:43+08:00	17803	33692	51495	2990	54485	104324	52.23%	17.07%	62	90
15	臺南市安南區	2018-11-24T22:23:20+08:00	12577	23781	36358	2123	38481	73081	52.66%	17.21%	46	90
15	臺南市安南區	2018-11-25T00:23:10+08:00	26007	49093	75100	4370	79470	151590	52.42%	17.16%	86	90
15	臺南市安南區	2018-11-25T03:32:43+08:00	27446	51577	79023	4606	83629	159654	52.38%	17.19%	90	90
15	臺南市安南區	2018-11-24T23:23:44+08:00	19430	36790	56220	3296	59516	114073	52.17%	17.03%	67	90
15	臺南市安南區	2018-11-24T22:33:44+08:00	13739	25932	39671	2342	42013	79992	52.52%	17.18%	50	90
15	臺南市安南區	2018-11-24T22:16:17+08:00	11786	21973	33759	1995	35754	67429	53.02%	17.48%	43	90
15	臺南市安南區	2018-11-25T03:39:00+08:00	27446	51577	79023	4606	83629	159654	52.38%	17.19%	90	90
15	屏東縣屏東市	2018-11-24T22:58:06+08:00	22629	43426	66055	3680	69735	130654	53.37%	17.32%	121	149
15	屏東縣屏東市	2018-11-25T06:19:08+08:00	29361	56512	85873	4547	90420	170148	53.14%	17.26%	149	149
15	屏東縣屏東市	2018-11-25T06:29:28+08:00	29361	56512	85873	4547	90420	170148	53.14%	17.26%	149	149
15	屏東縣屏東市	2018-11-24T23:43:27+08:00	26826	52168	78994	4250	83244	156871	53.07%	17.1%	140	149
15	屏東縣屏東市	2018-11-24T22:54:35+08:00	22629	43426	66055	3680	69735	130654	53.37%	17.32%	121	149
15	屏東縣屏東市	2018-11-24T22:41:48+08:00	20537	39263	59800	3361	63161	118425	53.33%	17.34%	112	149
15	屏東縣屏東市	2018-11-24T23:05:14+08:00	23203	44793	67996	3819	71815	134677	53.32%	17.23%	124	149
15	屏東縣屏東市	2018-11-25T01:18:07+08:00	29361	56512	85873	4547	90420	170148	53.14%	17.26%	149	149
15	屏東縣屏東市	2018-11-25T00:05:15+08:00	27746	54113	81859	4376	86235	162354	53.12%	17.09%	144	149
15	屏東縣屏東市	2018-11-24T22:13:42+08:00	13823	26619	40442	2440	42882	80711	53.13%	17.13%	82	149
15	屏東縣屏東市	2018-11-24T23:51:46+08:00	27498	53579	81077	4349	85426	160762	53.14%	17.1%	143	149
15	屏東縣屏東市	2018-11-25T06:09:06+08:00	29361	56512	85873	4547	90420	170148	53.14%	17.26%	149	149
15	屏東縣屏東市	2018-11-25T01:02:41+08:00	29361	56512	85873	4547	90420	170148	53.14%	17.26%	149	149
15	屏東縣屏東市	2018-11-25T00:23:14+08:00	28196	55015	83211	4451	87662	164972	53.14%	17.09%	146	149
15	屏東縣屏東市	2018-11-25T06:24:11+08:00	29361	56512	85873	4547	90420	170148	53.14%	17.26%	149	149
15	屏東縣屏東市	2018-11-24T23:23:48+08:00	25337	49170	74507	4060	78567	147673	53.2%	17.16%	134	149
15	屏東縣屏東市	2018-11-25T00:00:21+08:00	27498	53579	81077	4349	85426	160762	53.14%	17.1%	143	149
15	屏東縣屏東市	2018-11-24T22:23:25+08:00	16020	30898	46918	2771	49689	93497	53.15%	17.13%	92	149
15	屏東縣屏東市	2018-11-24T22:51:00+08:00	21724	41600	63324	3548	66872	125191	53.42%	17.35%	117	149
15	屏東縣屏東市	2018-11-25T03:32:49+08:00	29361	56512	85873	4547	90420	170148	53.14%	17.26%	149	149
15	屏東縣屏東市	2018-11-25T03:44:37+08:00	29361	56512	85873	4547	90420	170148	53.14%	17.26%	149	149
15	屏東縣屏東市	2018-11-24T23:08:48+08:00	23667	45724	69391	3889	73280	137446	53.32%	17.22%	126	149
15	屏東縣屏東市	2018-11-24T22:16:22+08:00	14726	28280	43006	2560	45566	85786	53.12%	17.17%	86	149
15	屏東縣屏東市	2018-11-25T01:26:04+08:00	29361	56512	85873	4547	90420	170148	53.14%	17.26%	149	149
15	屏東縣屏東市	2018-11-24T23:16:13+08:00	24429	47316	71745	3997	75742	142250	53.25%	17.17%	130	149
15	屏東縣屏東市	2018-11-24T23:35:20+08:00	26826	52168	78994	4250	83244	156871	53.07%	17.1%	140	149
15	屏東縣屏東市	2018-11-25T00:14:20+08:00	28040	54789	82829	4408	87237	164304	53.09%	17.07%	145	149
15	屏東縣屏東市	2018-11-25T03:39:05+08:00	29361	56512	85873	4547	90420	170148	53.14%	17.26%	149	149
15	屏東縣屏東市	2018-11-24T22:33:48+08:00	18322	35391	53713	3090	56803	106663	53.25%	17.18%	103	149
15	屏東縣屏東市	2018-11-25T03:50:01+08:00	29361	56512	85873	4547	90420	170148	53.14%	17.26%	149	149
15	屏東縣屏東市	2018-11-25T01:12:56+08:00	29361	56512	85873	4547	90420	170148	53.14%	17.26%	149	149
15	屏東縣屏東市	2018-11-24T23:47:40+08:00	27308	53078	80386	4313	84699	159392	53.14%	17.13%	142	149
15	屏東縣屏東市	2018-11-24T23:01:43+08:00	22815	43927	66742	3769	70511	132122	53.37%	17.27%	122	149
15	屏東縣屏東市	2018-11-25T00:09:46+08:00	28040	54789	82829	4408	87237	164304	53.09%	17.07%	145	149
15	屏東縣屏東市	2018-11-25T03:56:25+08:00	29361	56512	85873	4547	90420	170148	53.14%	17.26%	149	149
15	屏東縣屏東市	2018-11-24T22:45:18+08:00	21066	40325	61391	3408	64799	121431	53.36%	17.35%	114	149
15	屏東縣屏東市	2018-11-24T22:26:46+08:00	16207	31282	47489	2793	50282	94712	53.09%	17.11%	93	149
15	屏東縣屏東市	2018-11-24T22:30:21+08:00	16650	32245	48895	2842	51737	97456	53.09%	17.08%	95	149
15	屏東縣屏東市	2018-11-24T22:40:38+08:00	20537	39263	59800	3361	63161	118425	53.33%	17.34%	112	149
15	屏東縣屏東市	2018-11-25T04:03:03+08:00	29361	56512	85873	4547	90420	170148	53.14%	17.26%	149	149
15	屏東縣屏東市	2018-11-25T00:57:48+08:00	29361	56512	85873	4547	90420	170148	53.14%	17.26%	149	149
15	屏東縣屏東市	2018-11-24T22:19:47+08:00	15617	29950	45567	2714	48281	90893	53.12%	17.18%	90	149
15	屏東縣屏東市	2018-11-24T23:27:28+08:00	26364	51212	77576	4145	81721	154071	53.04%	17.11%	138	149
15	屏東縣屏東市	2018-11-25T06:14:03+08:00	29361	56512	85873	4547	90420	170148	53.14%	17.26%	149	149
15	屏東縣屏東市	2018-11-24T23:55:58+08:00	27498	53579	81077	4349	85426	160762	53.14%	17.1%	143	149
15	屏東縣屏東市	2018-11-25T00:18:44+08:00	28040	54789	82829	4408	87237	164304	53.09%	17.07%	145	149
15	屏東縣屏東市	2018-11-24T23:20:03+08:00	24874	48258	73132	4022	77154	145022	53.2%	17.15%	132	149
15	屏東縣屏東市	2018-11-25T01:07:37+08:00	29361	56512	85873	4547	90420	170148	53.14%	17.26%	149	149
15	屏東縣屏東市	2018-11-24T22:37:11+08:00	19706	37552	57258	3255	60513	113340	53.39%	17.39%	108	149
15	屏東縣屏東市	2018-11-24T23:39:29+08:00	26826	52168	78994	4250	83244	156871	53.07%	17.1%	140	149
15	屏東縣屏東市	2018-11-24T23:12:28+08:00	23870	46108	69978	3920	73898	138764	53.25%	17.2%	127	149
15	屏東縣屏東市	2018-11-24T23:31:24+08:00	26364	51212	77576	4145	81721	154071	53.04%	17.11%	138	149
15	臺南市南化區	2018-11-24T23:16:08+08:00	1054	2331	3385	323	3708	7786	47.62%	13.54%	10	10
15	臺南市南化區	2018-11-25T03:56:19+08:00	1054	2331	3385	323	3708	7786	47.62%	13.54%	10	10
15	臺南市南化區	2018-11-25T00:18:37+08:00	1054	2331	3385	323	3708	7786	47.62%	13.54%	10	10
15	臺南市南化區	2018-11-24T22:45:13+08:00	1054	2331	3385	323	3708	7786	47.62%	13.54%	10	10
15	臺南市南化區	2018-11-24T22:58:00+08:00	1054	2331	3385	323	3708	7786	47.62%	13.54%	10	10
15	臺南市南化區	2018-11-24T22:37:06+08:00	1054	2331	3385	323	3708	7786	47.62%	13.54%	10	10
15	臺南市南化區	2018-11-25T06:09:00+08:00	1054	2331	3385	323	3708	7786	47.62%	13.54%	10	10
15	臺南市南化區	2018-11-24T22:40:32+08:00	1054	2331	3385	323	3708	7786	47.62%	13.54%	10	10
15	臺南市南化區	2018-11-25T01:02:36+08:00	1054	2331	3385	323	3708	7786	47.62%	13.54%	10	10
15	臺南市南化區	2018-11-25T00:57:43+08:00	1054	2331	3385	323	3708	7786	47.62%	13.54%	10	10
15	臺南市南化區	2018-11-24T22:19:42+08:00	1054	2331	3385	323	3708	7786	47.62%	13.54%	10	10
15	臺南市南化區	2018-11-25T01:25:58+08:00	1054	2331	3385	323	3708	7786	47.62%	13.54%	10	10
15	臺南市南化區	2018-11-24T22:30:15+08:00	1054	2331	3385	323	3708	7786	47.62%	13.54%	10	10
15	臺南市南化區	2018-11-24T23:51:41+08:00	1054	2331	3385	323	3708	7786	47.62%	13.54%	10	10
15	臺南市南化區	2018-11-25T00:23:09+08:00	1054	2331	3385	323	3708	7786	47.62%	13.54%	10	10
15	臺南市南化區	2018-11-25T06:24:05+08:00	1054	2331	3385	323	3708	7786	47.62%	13.54%	10	10
15	臺南市南化區	2018-11-25T00:00:16+08:00	1054	2331	3385	323	3708	7786	47.62%	13.54%	10	10
15	臺南市南化區	2018-11-25T01:17:59+08:00	1054	2331	3385	323	3708	7786	47.62%	13.54%	10	10
15	臺南市南化區	2018-11-24T23:19:57+08:00	1054	2331	3385	323	3708	7786	47.62%	13.54%	10	10
15	臺南市南化區	2018-11-24T23:55:52+08:00	1054	2331	3385	323	3708	7786	47.62%	13.54%	10	10
15	臺南市南化區	2018-11-24T22:13:34+08:00	1054	2331	3385	323	3708	7786	47.62%	13.54%	10	10
15	臺南市南化區	2018-11-24T23:27:23+08:00	1054	2331	3385	323	3708	7786	47.62%	13.54%	10	10
15	臺南市南化區	2018-11-25T03:44:30+08:00	1054	2331	3385	323	3708	7786	47.62%	13.54%	10	10
15	臺南市南化區	2018-11-25T04:02:58+08:00	1054	2331	3385	323	3708	7786	47.62%	13.54%	10	10
15	臺南市南化區	2018-11-24T23:47:34+08:00	1054	2331	3385	323	3708	7786	47.62%	13.54%	10	10
15	臺南市南化區	2018-11-24T23:05:09+08:00	1054	2331	3385	323	3708	7786	47.62%	13.54%	10	10
15	臺南市南化區	2018-11-24T23:01:36+08:00	1054	2331	3385	323	3708	7786	47.62%	13.54%	10	10
15	臺南市南化區	2018-11-24T23:31:18+08:00	1054	2331	3385	323	3708	7786	47.62%	13.54%	10	10
15	臺南市南化區	2018-11-24T23:39:23+08:00	1054	2331	3385	323	3708	7786	47.62%	13.54%	10	10
15	臺南市南化區	2018-11-25T01:07:32+08:00	1054	2331	3385	323	3708	7786	47.62%	13.54%	10	10
15	臺南市南化區	2018-11-24T22:41:42+08:00	1054	2331	3385	323	3708	7786	47.62%	13.54%	10	10
15	臺南市南化區	2018-11-25T06:13:58+08:00	1054	2331	3385	323	3708	7786	47.62%	13.54%	10	10
15	臺南市南化區	2018-11-25T00:05:10+08:00	1054	2331	3385	323	3708	7786	47.62%	13.54%	10	10
15	臺南市南化區	2018-11-25T06:19:02+08:00	1054	2331	3385	323	3708	7786	47.62%	13.54%	10	10
15	臺南市南化區	2018-11-25T03:49:56+08:00	1054	2331	3385	323	3708	7786	47.62%	13.54%	10	10
15	臺南市南化區	2018-11-24T22:54:30+08:00	1054	2331	3385	323	3708	7786	47.62%	13.54%	10	10
15	臺南市南化區	2018-11-24T22:50:54+08:00	1054	2331	3385	323	3708	7786	47.62%	13.54%	10	10
15	臺南市南化區	2018-11-25T01:12:50+08:00	1054	2331	3385	323	3708	7786	47.62%	13.54%	10	10
15	臺南市南化區	2018-11-24T23:43:22+08:00	1054	2331	3385	323	3708	7786	47.62%	13.54%	10	10
15	臺南市南化區	2018-11-25T00:09:40+08:00	1054	2331	3385	323	3708	7786	47.62%	13.54%	10	10
15	臺南市南化區	2018-11-25T06:29:23+08:00	1054	2331	3385	323	3708	7786	47.62%	13.54%	10	10
15	臺南市南化區	2018-11-24T22:26:41+08:00	1054	2331	3385	323	3708	7786	47.62%	13.54%	10	10
15	臺南市南化區	2018-11-25T03:32:42+08:00	1054	2331	3385	323	3708	7786	47.62%	13.54%	10	10
15	臺南市南化區	2018-11-24T23:08:42+08:00	1054	2331	3385	323	3708	7786	47.62%	13.54%	10	10
15	臺南市南化區	2018-11-24T22:23:19+08:00	1054	2331	3385	323	3708	7786	47.62%	13.54%	10	10
15	臺南市南化區	2018-11-24T23:23:43+08:00	1054	2331	3385	323	3708	7786	47.62%	13.54%	10	10
15	臺南市南化區	2018-11-25T00:14:15+08:00	1054	2331	3385	323	3708	7786	47.62%	13.54%	10	10
15	臺南市南化區	2018-11-24T23:35:15+08:00	1054	2331	3385	323	3708	7786	47.62%	13.54%	10	10
15	臺南市南化區	2018-11-24T22:33:43+08:00	1054	2331	3385	323	3708	7786	47.62%	13.54%	10	10
15	臺南市南化區	2018-11-25T03:39:00+08:00	1054	2331	3385	323	3708	7786	47.62%	13.54%	10	10
15	臺南市南化區	2018-11-24T23:12:21+08:00	1054	2331	3385	323	3708	7786	47.62%	13.54%	10	10
15	臺南市南化區	2018-11-24T22:16:16+08:00	1054	2331	3385	323	3708	7786	47.62%	13.54%	10	10
15	桃園市大溪區	2018-11-24T23:16:06+08:00	11654	24670	36324	2666	38990	74002	52.69%	15.75%	56	59
15	桃園市大溪區	2018-11-24T23:43:20+08:00	12329	26181	38510	2824	41334	78285	52.8%	15.75%	59	59
15	桃園市大溪區	2018-11-25T06:13:55+08:00	12329	26181	38510	2824	41334	78285	52.8%	15.75%	59	59
15	桃園市大溪區	2018-11-25T06:19:00+08:00	12329	26181	38510	2824	41334	78285	52.8%	15.75%	59	59
15	桃園市大溪區	2018-11-25T06:29:20+08:00	12329	26181	38510	2824	41334	78285	52.8%	15.75%	59	59
15	桃園市大溪區	2018-11-25T03:49:54+08:00	12329	26181	38510	2824	41334	78285	52.8%	15.75%	59	59
15	桃園市大溪區	2018-11-25T03:56:16+08:00	12329	26181	38510	2824	41334	78285	52.8%	15.75%	59	59
15	桃園市大溪區	2018-11-25T01:07:29+08:00	12329	26181	38510	2824	41334	78285	52.8%	15.75%	59	59
15	桃園市大溪區	2018-11-24T22:30:13+08:00	9407	19507	28914	2180	31094	59368	52.38%	15.85%	45	59
15	桃園市大溪區	2018-11-25T06:24:03+08:00	12329	26181	38510	2824	41334	78285	52.8%	15.75%	59	59
15	桃園市大溪區	2018-11-25T03:32:38+08:00	12329	26181	38510	2824	41334	78285	52.8%	15.75%	59	59
15	桃園市大溪區	2018-11-25T01:25:56+08:00	12329	26181	38510	2824	41334	78285	52.8%	15.75%	59	59
15	桃園市大溪區	2018-11-25T00:23:07+08:00	12329	26181	38510	2824	41334	78285	52.8%	15.75%	59	59
15	桃園市大溪區	2018-11-24T23:51:39+08:00	12329	26181	38510	2824	41334	78285	52.8%	15.75%	59	59
15	桃園市大溪區	2018-11-24T23:23:41+08:00	11871	25151	37022	2713	39735	75496	52.63%	15.72%	57	59
15	桃園市大溪區	2018-11-25T01:17:57+08:00	12329	26181	38510	2824	41334	78285	52.8%	15.75%	59	59
15	桃園市大溪區	2018-11-24T23:08:40+08:00	11385	24162	35547	2614	38161	72525	52.62%	15.7%	55	59
15	桃園市大溪區	2018-11-24T22:57:58+08:00	10958	23074	34032	2562	36594	69564	52.6%	15.75%	53	59
15	桃園市大溪區	2018-11-25T06:08:57+08:00	12329	26181	38510	2824	41334	78285	52.8%	15.75%	59	59
15	桃園市大溪區	2018-11-25T01:12:47+08:00	12329	26181	38510	2824	41334	78285	52.8%	15.75%	59	59
15	桃園市大溪區	2018-11-24T22:16:14+08:00	7695	15716	23411	1766	25177	47868	52.6%	16.08%	37	59
15	桃園市大溪區	2018-11-25T00:05:08+08:00	12329	26181	38510	2824	41334	78285	52.8%	15.75%	59	59
15	桃園市大溪區	2018-11-24T23:05:07+08:00	11385	24162	35547	2614	38161	72525	52.62%	15.7%	55	59
15	桃園市大溪區	2018-11-24T22:54:28+08:00	10601	22094	32695	2495	35190	66836	52.65%	15.86%	51	59
15	桃園市大溪區	2018-11-24T22:33:41+08:00	9585	19856	29441	2213	31654	60374	52.43%	15.88%	46	59
15	桃園市大溪區	2018-11-24T23:47:32+08:00	12329	26181	38510	2824	41334	78285	52.8%	15.75%	59	59
15	桃園市大溪區	2018-11-24T22:41:39+08:00	9585	19856	29441	2213	31654	60374	52.43%	15.88%	46	59
15	桃園市大溪區	2018-11-24T22:37:04+08:00	9585	19856	29441	2213	31654	60374	52.43%	15.88%	46	59
15	桃園市大溪區	2018-11-25T00:18:34+08:00	12329	26181	38510	2824	41334	78285	52.8%	15.75%	59	59
15	桃園市大溪區	2018-11-24T22:50:52+08:00	10139	21082	31221	2381	33602	64064	52.45%	15.83%	49	59
15	桃園市大溪區	2018-11-24T22:26:40+08:00	8906	18505	27411	2111	29522	56242	52.49%	15.84%	43	59
15	桃園市大溪區	2018-11-24T22:45:11+08:00	9772	20160	29932	2253	32185	61430	52.39%	15.91%	47	59
15	桃園市大溪區	2018-11-25T00:57:40+08:00	12329	26181	38510	2824	41334	78285	52.8%	15.75%	59	59
15	桃園市大溪區	2018-11-25T03:44:27+08:00	12329	26181	38510	2824	41334	78285	52.8%	15.75%	59	59
15	桃園市大溪區	2018-11-24T22:19:40+08:00	8263	16980	25243	1895	27138	51628	52.56%	16%	40	59
15	桃園市大溪區	2018-11-25T01:02:34+08:00	12329	26181	38510	2824	41334	78285	52.8%	15.75%	59	59
15	桃園市大溪區	2018-11-24T22:40:30+08:00	9585	19856	29441	2213	31654	60374	52.43%	15.88%	46	59
15	桃園市大溪區	2018-11-25T03:38:58+08:00	12329	26181	38510	2824	41334	78285	52.8%	15.75%	59	59
15	桃園市大溪區	2018-11-24T22:13:31+08:00	7466	15211	22677	1717	24394	46461	52.5%	16.07%	36	59
15	桃園市大溪區	2018-11-24T23:27:21+08:00	11871	25151	37022	2713	39735	75496	52.63%	15.72%	57	59
15	桃園市大溪區	2018-11-24T23:55:50+08:00	12329	26181	38510	2824	41334	78285	52.8%	15.75%	59	59
15	桃園市大溪區	2018-11-24T22:23:17+08:00	8465	17486	25951	1979	27930	53345	52.36%	15.87%	41	59
15	桃園市大溪區	2018-11-24T23:19:55+08:00	11871	25151	37022	2713	39735	75496	52.63%	15.72%	57	59
15	桃園市大溪區	2018-11-25T00:00:14+08:00	12329	26181	38510	2824	41334	78285	52.8%	15.75%	59	59
15	桃園市大溪區	2018-11-25T04:02:55+08:00	12329	26181	38510	2824	41334	78285	52.8%	15.75%	59	59
15	桃園市大溪區	2018-11-25T00:09:38+08:00	12329	26181	38510	2824	41334	78285	52.8%	15.75%	59	59
15	桃園市大溪區	2018-11-24T23:01:34+08:00	11141	23571	34712	2587	37299	70933	52.58%	15.71%	54	59
15	桃園市大溪區	2018-11-24T23:35:14+08:00	11871	25151	37022	2713	39735	75496	52.63%	15.72%	57	59
15	桃園市大溪區	2018-11-25T00:14:13+08:00	12329	26181	38510	2824	41334	78285	52.8%	15.75%	59	59
15	桃園市大溪區	2018-11-24T23:12:19+08:00	11385	24162	35547	2614	38161	72525	52.62%	15.7%	55	59
15	桃園市大溪區	2018-11-24T23:31:15+08:00	11871	25151	37022	2713	39735	75496	52.63%	15.72%	57	59
15	桃園市大溪區	2018-11-24T23:39:20+08:00	11871	25151	37022	2713	39735	75496	52.63%	15.72%	57	59
15	臺北市南港區	2018-11-25T06:29:19+08:00	22312	34517	56829	2479	59308	101907	58.2%	21.89%	72	72
15	臺北市南港區	2018-11-25T01:07:28+08:00	22312	34517	56829	2479	59308	101907	58.2%	21.89%	72	72
15	臺北市南港區	2018-11-25T06:13:55+08:00	22312	34517	56829	2479	59308	101907	58.2%	21.89%	72	72
15	臺北市南港區	2018-11-24T22:50:51+08:00	21997	34101	56098	2448	58546	100518	58.24%	21.88%	71	72
15	臺北市南港區	2018-11-25T06:19:00+08:00	22312	34517	56829	2479	59308	101907	58.2%	21.89%	72	72
15	臺北市南港區	2018-11-25T03:49:53+08:00	22312	34517	56829	2479	59308	101907	58.2%	21.89%	72	72
15	臺北市南港區	2018-11-25T06:29:20+08:00	22312	34517	56829	2479	59308	101907	58.2%	21.89%	72	72
15	臺北市南港區	2018-11-25T03:49:54+08:00	22312	34517	56829	2479	59308	101907	58.2%	21.89%	72	72
15	臺北市南港區	2018-11-25T06:13:54+08:00	22312	34517	56829	2479	59308	101907	58.2%	21.89%	72	72
15	臺北市南港區	2018-11-25T01:07:29+08:00	22312	34517	56829	2479	59308	101907	58.2%	21.89%	72	72
15	臺北市南港區	2018-11-24T23:43:19+08:00	22312	34517	56829	2479	59308	101907	58.2%	21.89%	72	72
15	臺北市南港區	2018-11-24T22:13:29+08:00	21997	34101	56098	2448	58546	100518	58.24%	21.88%	71	72
15	臺北市南港區	2018-11-25T06:24:03+08:00	22312	34517	56829	2479	59308	101907	58.2%	21.89%	72	72
15	臺北市南港區	2018-11-24T23:08:39+08:00	22312	34517	56829	2479	59308	101907	58.2%	21.89%	72	72
15	臺北市南港區	2018-11-25T00:23:06+08:00	22312	34517	56829	2479	59308	101907	58.2%	21.89%	72	72
15	臺北市南港區	2018-11-24T22:30:12+08:00	21997	34101	56098	2448	58546	100518	58.24%	21.88%	71	72
15	臺北市南港區	2018-11-24T23:55:49+08:00	22312	34517	56829	2479	59308	101907	58.2%	21.89%	72	72
15	臺北市南港區	2018-11-25T03:32:37+08:00	22312	34517	56829	2479	59308	101907	58.2%	21.89%	72	72
15	臺北市南港區	2018-11-25T06:24:02+08:00	22312	34517	56829	2479	59308	101907	58.2%	21.89%	72	72
15	臺北市南港區	2018-11-24T23:51:37+08:00	22312	34517	56829	2479	59308	101907	58.2%	21.89%	72	72
15	臺北市南港區	2018-11-24T23:23:41+08:00	22312	34517	56829	2479	59308	101907	58.2%	21.89%	72	72
15	臺北市南港區	2018-11-24T22:57:57+08:00	22312	34517	56829	2479	59308	101907	58.2%	21.89%	72	72
15	臺北市南港區	2018-11-24T23:51:38+08:00	22312	34517	56829	2479	59308	101907	58.2%	21.89%	72	72
15	臺北市南港區	2018-11-25T06:18:59+08:00	22312	34517	56829	2479	59308	101907	58.2%	21.89%	72	72
15	臺北市南港區	2018-11-25T01:17:56+08:00	22312	34517	56829	2479	59308	101907	58.2%	21.89%	72	72
15	臺北市南港區	2018-11-24T23:23:40+08:00	22312	34517	56829	2479	59308	101907	58.2%	21.89%	72	72
15	臺北市南港區	2018-11-24T22:33:40+08:00	21997	34101	56098	2448	58546	100518	58.24%	21.88%	71	72
15	臺北市南港區	2018-11-24T22:16:13+08:00	21997	34101	56098	2448	58546	100518	58.24%	21.88%	71	72
15	臺北市南港區	2018-11-24T23:05:07+08:00	22312	34517	56829	2479	59308	101907	58.2%	21.89%	72	72
15	臺北市南港區	2018-11-24T22:41:38+08:00	21997	34101	56098	2448	58546	100518	58.24%	21.88%	71	72
15	臺北市南港區	2018-11-24T22:54:28+08:00	22312	34517	56829	2479	59308	101907	58.2%	21.89%	72	72
15	臺北市南港區	2018-11-25T01:12:46+08:00	22312	34517	56829	2479	59308	101907	58.2%	21.89%	72	72
15	臺北市南港區	2018-11-25T06:08:56+08:00	22312	34517	56829	2479	59308	101907	58.2%	21.89%	72	72
15	臺北市南港區	2018-11-24T22:41:37+08:00	21997	34101	56098	2448	58546	100518	58.24%	21.88%	71	72
15	臺北市南港區	2018-11-25T00:05:07+08:00	22312	34517	56829	2479	59308	101907	58.2%	21.89%	72	72
15	臺北市南港區	2018-11-24T23:05:06+08:00	22312	34517	56829	2479	59308	101907	58.2%	21.89%	72	72
15	臺北市南港區	2018-11-25T00:18:33+08:00	22312	34517	56829	2479	59308	101907	58.2%	21.89%	72	72
15	臺北市南港區	2018-11-24T22:37:03+08:00	21997	34101	56098	2448	58546	100518	58.24%	21.88%	71	72
15	臺北市南港區	2018-11-24T22:45:10+08:00	21997	34101	56098	2448	58546	100518	58.24%	21.88%	71	72
15	臺北市南港區	2018-11-24T23:16:05+08:00	22312	34517	56829	2479	59308	101907	58.2%	21.89%	72	72
15	臺北市南港區	2018-11-24T22:45:11+08:00	21997	34101	56098	2448	58546	100518	58.24%	21.88%	71	72
15	臺北市南港區	2018-11-25T03:56:15+08:00	22312	34517	56829	2479	59308	101907	58.2%	21.89%	72	72
15	臺北市南港區	2018-11-25T03:38:57+08:00	22312	34517	56829	2479	59308	101907	58.2%	21.89%	72	72
15	臺北市南港區	2018-11-25T03:44:26+08:00	22312	34517	56829	2479	59308	101907	58.2%	21.89%	72	72
15	臺北市南港區	2018-11-25T01:02:33+08:00	22312	34517	56829	2479	59308	101907	58.2%	21.89%	72	72
15	臺北市南港區	2018-11-24T22:40:30+08:00	21997	34101	56098	2448	58546	100518	58.24%	21.88%	71	72
15	臺北市南港區	2018-11-25T01:25:55+08:00	22312	34517	56829	2479	59308	101907	58.2%	21.89%	72	72
15	臺北市南港區	2018-11-24T22:23:16+08:00	21997	34101	56098	2448	58546	100518	58.24%	21.88%	71	72
15	臺北市南港區	2018-11-24T23:19:54+08:00	22312	34517	56829	2479	59308	101907	58.2%	21.89%	72	72
15	臺北市南港區	2018-11-25T00:57:39+08:00	22312	34517	56829	2479	59308	101907	58.2%	21.89%	72	72
15	臺北市南港區	2018-11-24T23:27:21+08:00	22312	34517	56829	2479	59308	101907	58.2%	21.89%	72	72
15	臺北市南港區	2018-11-25T01:17:55+08:00	22312	34517	56829	2479	59308	101907	58.2%	21.89%	72	72
15	臺北市南港區	2018-11-24T22:19:39+08:00	21997	34101	56098	2448	58546	100518	58.24%	21.88%	71	72
15	臺北市南港區	2018-11-24T23:27:20+08:00	22312	34517	56829	2479	59308	101907	58.2%	21.89%	72	72
15	臺北市南港區	2018-11-24T22:13:30+08:00	21997	34101	56098	2448	58546	100518	58.24%	21.88%	71	72
15	臺北市南港區	2018-11-25T00:00:13+08:00	22312	34517	56829	2479	59308	101907	58.2%	21.89%	72	72
15	臺北市南港區	2018-11-25T00:14:12+08:00	22312	34517	56829	2479	59308	101907	58.2%	21.89%	72	72
15	臺北市南港區	2018-11-25T04:02:55+08:00	22312	34517	56829	2479	59308	101907	58.2%	21.89%	72	72
15	臺北市南港區	2018-11-24T23:39:19+08:00	22312	34517	56829	2479	59308	101907	58.2%	21.89%	72	72
15	臺北市南港區	2018-11-24T22:26:39+08:00	21997	34101	56098	2448	58546	100518	58.24%	21.88%	71	72
15	臺北市南港區	2018-11-24T23:12:18+08:00	22312	34517	56829	2479	59308	101907	58.2%	21.89%	72	72
15	臺北市南港區	2018-11-24T23:31:14+08:00	22312	34517	56829	2479	59308	101907	58.2%	21.89%	72	72
15	臺北市南港區	2018-11-24T23:01:33+08:00	22312	34517	56829	2479	59308	101907	58.2%	21.89%	72	72
15	臺北市南港區	2018-11-24T23:01:34+08:00	22312	34517	56829	2479	59308	101907	58.2%	21.89%	72	72
15	臺北市南港區	2018-11-24T23:47:31+08:00	22312	34517	56829	2479	59308	101907	58.2%	21.89%	72	72
15	臺北市南港區	2018-11-24T23:35:13+08:00	22312	34517	56829	2479	59308	101907	58.2%	21.89%	72	72
15	臺北市南港區	2018-11-25T04:02:54+08:00	22312	34517	56829	2479	59308	101907	58.2%	21.89%	72	72
15	臺北市南港區	2018-11-25T00:09:37+08:00	22312	34517	56829	2479	59308	101907	58.2%	21.89%	72	72
15	桃園市復興區	2018-11-25T03:56:17+08:00	984	4041	5025	294	5319	9766	54.46%	10.08%	10	10
15	桃園市復興區	2018-11-24T23:16:06+08:00	644	2436	3080	175	3255	5868	55.47%	10.97%	7	10
15	桃園市復興區	2018-11-25T06:29:21+08:00	984	4041	5025	294	5319	9766	54.46%	10.08%	10	10
15	桃園市復興區	2018-11-25T03:49:55+08:00	984	4041	5025	294	5319	9766	54.46%	10.08%	10	10
15	桃園市復興區	2018-11-25T06:19:01+08:00	984	4041	5025	294	5319	9766	54.46%	10.08%	10	10
15	桃園市復興區	2018-11-24T23:43:20+08:00	854	3260	4114	257	4371	7859	55.62%	10.87%	8	10
15	桃園市復興區	2018-11-24T22:45:12+08:00	453	1627	2080	115	2195	4101	53.52%	11.05%	5	10
15	桃園市復興區	2018-11-24T22:30:13+08:00	381	1327	1708	102	1810	3341	54.18%	11.4%	4	10
15	桃園市復興區	2018-11-25T06:24:04+08:00	984	4041	5025	294	5319	9766	54.46%	10.08%	10	10
15	桃園市復興區	2018-11-25T03:32:38+08:00	984	4041	5025	294	5319	9766	54.46%	10.08%	10	10
15	桃園市復興區	2018-11-25T01:25:56+08:00	984	4041	5025	294	5319	9766	54.46%	10.08%	10	10
15	桃園市復興區	2018-11-25T00:23:07+08:00	895	3478	4373	263	4636	8542	54.27%	10.48%	9	10
15	桃園市復興區	2018-11-24T23:51:39+08:00	854	3260	4114	257	4371	7859	55.62%	10.87%	8	10
15	桃園市復興區	2018-11-24T23:27:22+08:00	644	2436	3080	175	3255	5868	55.47%	10.97%	7	10
15	桃園市復興區	2018-11-24T22:13:32+08:00	299	1037	1336	84	1420	2625	54.1%	11.39%	3	10
15	桃園市復興區	2018-11-25T01:17:57+08:00	895	3478	4373	263	4636	8542	54.27%	10.48%	9	10
15	桃園市復興區	2018-11-24T23:08:40+08:00	644	2436	3080	175	3255	5868	55.47%	10.97%	7	10
15	桃園市復興區	2018-11-24T22:57:58+08:00	510	1970	2480	131	2611	4852	53.81%	10.51%	6	10
15	桃園市復興區	2018-11-25T06:08:57+08:00	984	4041	5025	294	5319	9766	54.46%	10.08%	10	10
15	桃園市復興區	2018-11-24T22:54:29+08:00	510	1970	2480	131	2611	4852	53.81%	10.51%	6	10
15	桃園市復興區	2018-11-24T22:16:14+08:00	299	1037	1336	84	1420	2625	54.1%	11.39%	3	10
15	桃園市復興區	2018-11-25T04:02:56+08:00	984	4041	5025	294	5319	9766	54.46%	10.08%	10	10
15	桃園市復興區	2018-11-25T01:12:48+08:00	895	3478	4373	263	4636	8542	54.27%	10.48%	9	10
15	桃園市復興區	2018-11-24T22:33:41+08:00	381	1327	1708	102	1810	3341	54.18%	11.4%	4	10
15	桃園市復興區	2018-11-24T23:05:08+08:00	644	2436	3080	175	3255	5868	55.47%	10.97%	7	10
15	桃園市復興區	2018-11-24T23:47:32+08:00	854	3260	4114	257	4371	7859	55.62%	10.87%	8	10
15	桃園市復興區	2018-11-24T22:41:39+08:00	453	1627	2080	115	2195	4101	53.52%	11.05%	5	10
15	桃園市復興區	2018-11-25T00:05:09+08:00	895	3478	4373	263	4636	8542	54.27%	10.48%	9	10
15	桃園市復興區	2018-11-24T22:37:04+08:00	453	1627	2080	115	2195	4101	53.52%	11.05%	5	10
15	桃園市復興區	2018-11-24T22:50:52+08:00	453	1627	2080	115	2195	4101	53.52%	11.05%	5	10
15	桃園市復興區	2018-11-25T06:13:56+08:00	984	4041	5025	294	5319	9766	54.46%	10.08%	10	10
15	桃園市復興區	2018-11-24T22:26:40+08:00	381	1327	1708	102	1810	3341	54.18%	11.4%	4	10
15	桃園市復興區	2018-11-25T00:18:35+08:00	895	3478	4373	263	4636	8542	54.27%	10.48%	9	10
15	桃園市復興區	2018-11-24T22:40:31+08:00	453	1627	2080	115	2195	4101	53.52%	11.05%	5	10
15	桃園市復興區	2018-11-25T03:44:27+08:00	984	4041	5025	294	5319	9766	54.46%	10.08%	10	10
15	桃園市復興區	2018-11-25T00:57:41+08:00	895	3478	4373	263	4636	8542	54.27%	10.48%	9	10
15	桃園市復興區	2018-11-24T22:19:40+08:00	381	1327	1708	102	1810	3341	54.18%	11.4%	4	10
15	桃園市復興區	2018-11-25T01:02:34+08:00	895	3478	4373	263	4636	8542	54.27%	10.48%	9	10
15	桃園市復興區	2018-11-25T03:38:58+08:00	984	4041	5025	294	5319	9766	54.46%	10.08%	10	10
15	桃園市復興區	2018-11-24T23:23:42+08:00	644	2436	3080	175	3255	5868	55.47%	10.97%	7	10
15	桃園市復興區	2018-11-24T23:55:50+08:00	854	3260	4114	257	4371	7859	55.62%	10.87%	8	10
15	桃園市復興區	2018-11-24T22:23:17+08:00	381	1327	1708	102	1810	3341	54.18%	11.4%	4	10
15	桃園市復興區	2018-11-24T23:19:55+08:00	644	2436	3080	175	3255	5868	55.47%	10.97%	7	10
15	桃園市復興區	2018-11-25T00:00:14+08:00	854	3260	4114	257	4371	7859	55.62%	10.87%	8	10
15	桃園市復興區	2018-11-25T01:07:30+08:00	895	3478	4373	263	4636	8542	54.27%	10.48%	9	10
15	桃園市復興區	2018-11-25T00:09:38+08:00	895	3478	4373	263	4636	8542	54.27%	10.48%	9	10
15	桃園市復興區	2018-11-24T23:35:14+08:00	854	3260	4114	257	4371	7859	55.62%	10.87%	8	10
15	桃園市復興區	2018-11-25T00:14:13+08:00	895	3478	4373	263	4636	8542	54.27%	10.48%	9	10
15	桃園市復興區	2018-11-24T23:01:35+08:00	644	2436	3080	175	3255	5868	55.47%	10.97%	7	10
15	桃園市復興區	2018-11-24T23:12:19+08:00	644	2436	3080	175	3255	5868	55.47%	10.97%	7	10
15	桃園市復興區	2018-11-24T23:31:15+08:00	854	3260	4114	257	4371	7859	55.62%	10.87%	8	10
15	桃園市復興區	2018-11-24T23:39:20+08:00	854	3260	4114	257	4371	7859	55.62%	10.87%	8	10
15	高雄市	2018-11-24T23:16:08+08:00	334459	665002	999461	63453	1062914	1810225	58.72%	18.48%	493	1
15	高雄市	2018-11-25T03:56:19+08:00	436565	870018	1306583	78331	1384914	2353342	58.85%	18.55%	823	1
15	高雄市	2018-11-24T22:45:14+08:00	286327	570637	856964	56031	912995	1558652	58.58%	18.37%	325	1
15	高雄市	2018-11-24T22:58:00+08:00	309158	614444	923602	59461	983063	1675772	58.66%	18.45%	403	1
15	高雄市	2018-11-24T22:26:42+08:00	256510	510761	767271	50986	818257	1397507	58.55%	18.35%	213	1
15	高雄市	2018-11-25T01:18:00+08:00	428119	852948	1281067	77123	1358190	2307433	58.86%	18.55%	796	1
15	高雄市	2018-11-25T00:18:38+08:00	403625	805296	1208921	73992	1282913	2179665	58.86%	18.52%	724	1
15	高雄市	2018-11-24T22:37:06+08:00	277692	553715	831407	54593	886000	1512997	58.56%	18.35%	293	1
15	高雄市	2018-11-25T06:09:00+08:00	436565	870018	1306583	78331	1384914	2353342	58.85%	18.55%	823	1
15	高雄市	2018-11-25T01:25:59+08:00	429465	855907	1285372	77370	1362742	2316269	58.83%	18.54%	801	1
15	高雄市	2018-11-25T00:57:43+08:00	424554	845459	1270013	76683	1346696	2287628	58.87%	18.56%	786	1
15	高雄市	2018-11-24T22:19:42+08:00	244550	485674	730224	48786	779010	1331568	58.5%	18.37%	167	1
15	高雄市	2018-11-25T01:02:37+08:00	424914	846093	1271007	76737	1347744	2289722	58.86%	18.56%	787	1
15	高雄市	2018-11-24T22:40:33+08:00	282026	561799	843825	55304	899129	1535290	58.56%	18.37%	309	1
15	高雄市	2018-11-24T23:51:41+08:00	382931	762316	1145247	70654	1215901	2066849	58.83%	18.53%	653	1
15	高雄市	2018-11-24T22:13:35+08:00	230187	458650	688837	46590	735427	1256056	58.55%	18.33%	116	1
15	高雄市	2018-11-24T23:55:52+08:00	385001	766875	1151876	70967	1222843	2078415	58.84%	18.52%	660	1
15	高雄市	2018-11-25T00:00:17+08:00	387819	772690	1160509	71370	1231879	2093370	58.85%	18.53%	670	1
15	高雄市	2018-11-24T23:19:58+08:00	337926	671253	1009179	63878	1073057	1827255	58.73%	18.49%	504	1
15	高雄市	2018-11-24T23:27:24+08:00	347072	690142	1037214	65220	1102434	1877212	58.73%	18.49%	534	1
15	高雄市	2018-11-25T03:44:30+08:00	436256	869274	1305530	78269	1383799	2351297	58.85%	18.55%	822	1
15	高雄市	2018-11-24T23:01:37+08:00	315373	626593	941966	60438	1002404	1708565	58.67%	18.46%	425	1
15	高雄市	2018-11-25T04:02:58+08:00	436565	870018	1306583	78331	1384914	2353342	58.85%	18.55%	823	1
15	高雄市	2018-11-25T00:14:16+08:00	399697	797293	1196990	73241	1270231	2158266	58.85%	18.52%	711	1
15	高雄市	2018-11-24T23:35:16+08:00	358919	714498	1073417	66971	1140388	1941069	58.75%	18.49%	574	1
15	高雄市	2018-11-24T23:12:22+08:00	325620	646737	972357	62107	1034464	1761834	58.72%	18.48%	462	1
15	高雄市	2018-11-24T23:31:18+08:00	354977	706535	1061512	66436	1127948	1920178	58.74%	18.49%	561	1
15	高雄市	2018-11-24T23:39:23+08:00	362732	722235	1084967	67566	1152533	1961557	58.76%	18.49%	588	1
15	高雄市	2018-11-25T01:07:32+08:00	426339	849187	1275526	76895	1352421	2297680	58.86%	18.56%	791	1
15	高雄市	2018-11-24T23:47:35+08:00	376419	748793	1125212	69629	1194841	2031385	58.82%	18.53%	631	1
15	高雄市	2018-11-24T22:41:42+08:00	282026	561799	843825	55304	899129	1535290	58.56%	18.37%	309	1
15	高雄市	2018-11-25T06:13:58+08:00	436565	870018	1306583	78331	1384914	2353342	58.85%	18.55%	823	1
15	高雄市	2018-11-24T22:54:31+08:00	305190	606682	911872	58902	970774	1655849	58.63%	18.43%	390	1
15	高雄市	2018-11-24T22:50:55+08:00	297235	591694	888929	57659	946588	1615267	58.6%	18.4%	363	1
15	高雄市	2018-11-25T00:09:41+08:00	393821	784993	1178814	72239	1251053	2125935	58.85%	18.52%	691	1
15	高雄市	2018-11-25T01:12:50+08:00	426915	850716	1277631	77010	1354641	2301497	58.86%	18.55%	793	1
15	高雄市	2018-11-24T23:43:22+08:00	372139	740119	1112258	68949	1181207	2008795	58.8%	18.53%	617	1
15	高雄市	2018-11-25T06:29:23+08:00	436565	870018	1306583	78331	1384914	2353342	58.85%	18.55%	823	1
15	高雄市	2018-11-25T03:49:57+08:00	436565	870018	1306583	78331	1384914	2353342	58.85%	18.55%	823	1
15	高雄市	2018-11-24T23:05:10+08:00	319963	635896	955859	61155	1017014	1732723	58.69%	18.47%	441	1
15	高雄市	2018-11-25T06:19:03+08:00	436565	870018	1306583	78331	1384914	2353342	58.85%	18.55%	823	1
15	高雄市	2018-11-25T00:05:11+08:00	391437	780122	1171559	71921	1243480	2113128	58.85%	18.52%	683	1
15	高雄市	2018-11-25T06:24:06+08:00	436565	870018	1306583	78331	1384914	2353342	58.85%	18.55%	823	1
15	高雄市	2018-11-24T22:30:16+08:00	260778	519620	780398	51709	832107	1420927	58.56%	18.35%	230	1
15	高雄市	2018-11-24T23:08:43+08:00	323109	641838	964947	61662	1026609	1748430	58.72%	18.48%	452	1
15	高雄市	2018-11-24T22:23:20+08:00	250984	499009	749993	50063	800056	1366874	58.53%	18.36%	191	1
15	高雄市	2018-11-25T00:23:10+08:00	404885	807742	1212627	74153	1286780	2186209	58.86%	18.52%	728	1
15	高雄市	2018-11-25T03:32:43+08:00	436256	869274	1305530	78269	1383799	2351297	58.85%	18.55%	822	1
15	高雄市	2018-11-24T23:23:44+08:00	343620	683244	1026864	64645	1091509	1858739	58.72%	18.49%	523	1
15	高雄市	2018-11-24T22:33:44+08:00	270067	538572	808639	53227	861866	1472265	58.54%	18.34%	266	1
15	高雄市	2018-11-24T22:16:17+08:00	236062	470545	706607	47566	754173	1289218	58.5%	18.31%	137	1
15	高雄市	2018-11-25T03:39:00+08:00	436256	869274	1305530	78269	1383799	2351297	58.85%	18.55%	822	1
15	高雄市旗津區	2018-11-24T22:58:01+08:00	3880	7095	10975	921	11896	22815	52.14%	17.01%	17	18
15	高雄市旗津區	2018-11-24T22:45:14+08:00	3880	7095	10975	921	11896	22815	52.14%	17.01%	17	18
15	高雄市旗津區	2018-11-25T03:56:20+08:00	4223	7751	11974	1017	12991	24860	52.26%	16.99%	18	18
15	高雄市旗津區	2018-11-24T22:26:42+08:00	3880	7095	10975	921	11896	22815	52.14%	17.01%	17	18
15	高雄市旗津區	2018-11-25T01:18:00+08:00	4223	7751	11974	1017	12991	24860	52.26%	16.99%	18	18
15	高雄市旗津區	2018-11-24T23:16:09+08:00	3880	7095	10975	921	11896	22815	52.14%	17.01%	17	18
15	高雄市旗津區	2018-11-25T00:18:38+08:00	4223	7751	11974	1017	12991	24860	52.26%	16.99%	18	18
15	高雄市旗津區	2018-11-24T22:37:06+08:00	3880	7095	10975	921	11896	22815	52.14%	17.01%	17	18
15	高雄市旗津區	2018-11-25T06:09:00+08:00	4223	7751	11974	1017	12991	24860	52.26%	16.99%	18	18
15	高雄市旗津區	2018-11-25T01:25:59+08:00	4223	7751	11974	1017	12991	24860	52.26%	16.99%	18	18
15	高雄市旗津區	2018-11-25T00:57:43+08:00	4223	7751	11974	1017	12991	24860	52.26%	16.99%	18	18
15	高雄市旗津區	2018-11-25T01:02:37+08:00	4223	7751	11974	1017	12991	24860	52.26%	16.99%	18	18
15	高雄市旗津區	2018-11-24T22:40:33+08:00	3880	7095	10975	921	11896	22815	52.14%	17.01%	17	18
15	高雄市旗津區	2018-11-24T23:51:41+08:00	4223	7751	11974	1017	12991	24860	52.26%	16.99%	18	18
15	高雄市旗津區	2018-11-24T22:19:43+08:00	3880	7095	10975	921	11896	22815	52.14%	17.01%	17	18
15	高雄市旗津區	2018-11-24T23:55:53+08:00	4223	7751	11974	1017	12991	24860	52.26%	16.99%	18	18
15	高雄市旗津區	2018-11-25T03:44:31+08:00	4223	7751	11974	1017	12991	24860	52.26%	16.99%	18	18
15	高雄市旗津區	2018-11-25T00:00:17+08:00	4223	7751	11974	1017	12991	24860	52.26%	16.99%	18	18
15	高雄市旗津區	2018-11-24T23:19:58+08:00	3880	7095	10975	921	11896	22815	52.14%	17.01%	17	18
15	高雄市旗津區	2018-11-24T23:27:24+08:00	3880	7095	10975	921	11896	22815	52.14%	17.01%	17	18
15	高雄市旗津區	2018-11-24T23:01:37+08:00	3880	7095	10975	921	11896	22815	52.14%	17.01%	17	18
15	高雄市旗津區	2018-11-24T23:12:23+08:00	3880	7095	10975	921	11896	22815	52.14%	17.01%	17	18
15	高雄市旗津區	2018-11-25T04:02:58+08:00	4223	7751	11974	1017	12991	24860	52.26%	16.99%	18	18
15	高雄市旗津區	2018-11-25T00:14:16+08:00	4223	7751	11974	1017	12991	24860	52.26%	16.99%	18	18
15	高雄市旗津區	2018-11-24T23:35:16+08:00	3880	7095	10975	921	11896	22815	52.14%	17.01%	17	18
15	高雄市旗津區	2018-11-24T23:39:24+08:00	3880	7095	10975	921	11896	22815	52.14%	17.01%	17	18
15	高雄市旗津區	2018-11-24T23:31:18+08:00	3880	7095	10975	921	11896	22815	52.14%	17.01%	17	18
15	高雄市旗津區	2018-11-25T01:07:32+08:00	4223	7751	11974	1017	12991	24860	52.26%	16.99%	18	18
15	高雄市旗津區	2018-11-24T23:47:35+08:00	4223	7751	11974	1017	12991	24860	52.26%	16.99%	18	18
15	高雄市旗津區	2018-11-24T23:43:23+08:00	4223	7751	11974	1017	12991	24860	52.26%	16.99%	18	18
15	高雄市旗津區	2018-11-24T22:41:42+08:00	3880	7095	10975	921	11896	22815	52.14%	17.01%	17	18
15	高雄市旗津區	2018-11-25T01:12:51+08:00	4223	7751	11974	1017	12991	24860	52.26%	16.99%	18	18
15	高雄市旗津區	2018-11-25T06:13:58+08:00	4223	7751	11974	1017	12991	24860	52.26%	16.99%	18	18
15	高雄市旗津區	2018-11-24T22:54:31+08:00	3880	7095	10975	921	11896	22815	52.14%	17.01%	17	18
15	高雄市旗津區	2018-11-24T22:50:55+08:00	3880	7095	10975	921	11896	22815	52.14%	17.01%	17	18
15	高雄市旗津區	2018-11-25T00:09:41+08:00	4223	7751	11974	1017	12991	24860	52.26%	16.99%	18	18
15	高雄市旗津區	2018-11-25T06:29:23+08:00	4223	7751	11974	1017	12991	24860	52.26%	16.99%	18	18
15	高雄市旗津區	2018-11-25T03:49:57+08:00	4223	7751	11974	1017	12991	24860	52.26%	16.99%	18	18
15	高雄市旗津區	2018-11-24T23:05:10+08:00	3880	7095	10975	921	11896	22815	52.14%	17.01%	17	18
15	高雄市旗津區	2018-11-25T06:19:03+08:00	4223	7751	11974	1017	12991	24860	52.26%	16.99%	18	18
15	高雄市旗津區	2018-11-25T00:05:11+08:00	4223	7751	11974	1017	12991	24860	52.26%	16.99%	18	18
15	高雄市旗津區	2018-11-25T06:24:06+08:00	4223	7751	11974	1017	12991	24860	52.26%	16.99%	18	18
15	高雄市旗津區	2018-11-24T22:30:16+08:00	3880	7095	10975	921	11896	22815	52.14%	17.01%	17	18
15	高雄市旗津區	2018-11-24T22:13:36+08:00	3880	7095	10975	921	11896	22815	52.14%	17.01%	17	18
15	高雄市旗津區	2018-11-24T23:08:43+08:00	3880	7095	10975	921	11896	22815	52.14%	17.01%	17	18
15	高雄市旗津區	2018-11-24T22:23:20+08:00	3880	7095	10975	921	11896	22815	52.14%	17.01%	17	18
15	高雄市旗津區	2018-11-25T00:23:10+08:00	4223	7751	11974	1017	12991	24860	52.26%	16.99%	18	18
15	高雄市旗津區	2018-11-25T03:32:43+08:00	4223	7751	11974	1017	12991	24860	52.26%	16.99%	18	18
15	高雄市旗津區	2018-11-24T23:23:44+08:00	3880	7095	10975	921	11896	22815	52.14%	17.01%	17	18
15	高雄市旗津區	2018-11-24T22:33:44+08:00	3880	7095	10975	921	11896	22815	52.14%	17.01%	17	18
15	高雄市旗津區	2018-11-24T22:16:17+08:00	3880	7095	10975	921	11896	22815	52.14%	17.01%	17	18
15	高雄市旗津區	2018-11-25T03:39:01+08:00	4223	7751	11974	1017	12991	24860	52.26%	16.99%	18	18
15	苗栗縣三義鄉	2018-11-24T22:26:44+08:00	1984	5101	7085	382	7467	12691	58.84%	15.63%	15	16
15	苗栗縣三義鄉	2018-11-25T00:05:13+08:00	2166	5583	7749	402	8151	13889	58.69%	15.6%	16	16
15	苗栗縣三義鄉	2018-11-24T23:05:12+08:00	2166	5583	7749	402	8151	13889	58.69%	15.6%	16	16
15	苗栗縣三義鄉	2018-11-25T00:09:43+08:00	2166	5583	7749	402	8151	13889	58.69%	15.6%	16	16
15	苗栗縣三義鄉	2018-11-24T22:37:08+08:00	1984	5101	7085	382	7467	12691	58.84%	15.63%	15	16
15	苗栗縣三義鄉	2018-11-24T22:54:33+08:00	2166	5583	7749	402	8151	13889	58.69%	15.6%	16	16
15	苗栗縣三義鄉	2018-11-24T22:50:57+08:00	2166	5583	7749	402	8151	13889	58.69%	15.6%	16	16
15	苗栗縣三義鄉	2018-11-25T01:12:53+08:00	2166	5583	7749	402	8151	13889	58.69%	15.6%	16	16
15	苗栗縣三義鄉	2018-11-24T22:40:35+08:00	2166	5583	7749	402	8151	13889	58.69%	15.6%	16	16
15	苗栗縣三義鄉	2018-11-25T01:02:39+08:00	2166	5583	7749	402	8151	13889	58.69%	15.6%	16	16
15	苗栗縣三義鄉	2018-11-25T04:03:00+08:00	2166	5583	7749	402	8151	13889	58.69%	15.6%	16	16
15	苗栗縣三義鄉	2018-11-25T00:57:45+08:00	2166	5583	7749	402	8151	13889	58.69%	15.6%	16	16
15	苗栗縣三義鄉	2018-11-24T22:19:44+08:00	1677	4290	5967	326	6293	10622	59.24%	15.79%	13	16
15	苗栗縣三義鄉	2018-11-25T06:14:00+08:00	2166	5583	7749	402	8151	13889	58.69%	15.6%	16	16
15	苗栗縣三義鄉	2018-11-24T23:23:46+08:00	2166	5583	7749	402	8151	13889	58.69%	15.6%	16	16
15	苗栗縣三義鄉	2018-11-25T03:32:46+08:00	2166	5583	7749	402	8151	13889	58.69%	15.6%	16	16
15	苗栗縣三義鄉	2018-11-24T23:55:55+08:00	2166	5583	7749	402	8151	13889	58.69%	15.6%	16	16
15	苗栗縣三義鄉	2018-11-25T00:00:19+08:00	2166	5583	7749	402	8151	13889	58.69%	15.6%	16	16
15	苗栗縣三義鄉	2018-11-25T00:23:12+08:00	2166	5583	7749	402	8151	13889	58.69%	15.6%	16	16
15	苗栗縣三義鄉	2018-11-24T22:23:22+08:00	1803	4652	6455	361	6816	11475	59.4%	15.71%	14	16
15	苗栗縣三義鄉	2018-11-24T23:01:39+08:00	2166	5583	7749	402	8151	13889	58.69%	15.6%	16	16
15	苗栗縣三義鄉	2018-11-24T23:31:21+08:00	2166	5583	7749	402	8151	13889	58.69%	15.6%	16	16
15	苗栗縣三義鄉	2018-11-24T23:20:00+08:00	2166	5583	7749	402	8151	13889	58.69%	15.6%	16	16
15	苗栗縣三義鄉	2018-11-25T01:07:34+08:00	2166	5583	7749	402	8151	13889	58.69%	15.6%	16	16
15	苗栗縣三義鄉	2018-11-24T23:35:18+08:00	2166	5583	7749	402	8151	13889	58.69%	15.6%	16	16
15	苗栗縣三義鄉	2018-11-25T00:14:18+08:00	2166	5583	7749	402	8151	13889	58.69%	15.6%	16	16
15	苗栗縣三義鄉	2018-11-24T23:12:25+08:00	2166	5583	7749	402	8151	13889	58.69%	15.6%	16	16
15	苗栗縣三義鄉	2018-11-25T03:39:02+08:00	2166	5583	7749	402	8151	13889	58.69%	15.6%	16	16
15	苗栗縣三義鄉	2018-11-24T22:33:46+08:00	1984	5101	7085	382	7467	12691	58.84%	15.63%	15	16
15	苗栗縣三義鄉	2018-11-25T00:18:41+08:00	2166	5583	7749	402	8151	13889	58.69%	15.6%	16	16
15	苗栗縣三義鄉	2018-11-24T22:41:45+08:00	2166	5583	7749	402	8151	13889	58.69%	15.6%	16	16
15	苗栗縣三義鄉	2018-11-24T23:43:24+08:00	2166	5583	7749	402	8151	13889	58.69%	15.6%	16	16
15	苗栗縣三義鄉	2018-11-25T03:56:22+08:00	2166	5583	7749	402	8151	13889	58.69%	15.6%	16	16
15	苗栗縣三義鄉	2018-11-25T06:29:25+08:00	2166	5583	7749	402	8151	13889	58.69%	15.6%	16	16
15	苗栗縣三義鄉	2018-11-25T06:19:05+08:00	2166	5583	7749	402	8151	13889	58.69%	15.6%	16	16
15	苗栗縣三義鄉	2018-11-24T22:45:16+08:00	2166	5583	7749	402	8151	13889	58.69%	15.6%	16	16
15	苗栗縣三義鄉	2018-11-25T01:18:03+08:00	2166	5583	7749	402	8151	13889	58.69%	15.6%	16	16
15	苗栗縣三義鄉	2018-11-25T03:49:59+08:00	2166	5583	7749	402	8151	13889	58.69%	15.6%	16	16
15	苗栗縣三義鄉	2018-11-24T22:58:03+08:00	2166	5583	7749	402	8151	13889	58.69%	15.6%	16	16
15	苗栗縣三義鄉	2018-11-25T06:09:03+08:00	2166	5583	7749	402	8151	13889	58.69%	15.6%	16	16
15	苗栗縣三義鄉	2018-11-24T23:51:43+08:00	2166	5583	7749	402	8151	13889	58.69%	15.6%	16	16
15	苗栗縣三義鄉	2018-11-25T06:24:08+08:00	2166	5583	7749	402	8151	13889	58.69%	15.6%	16	16
15	苗栗縣三義鄉	2018-11-24T22:30:18+08:00	1984	5101	7085	382	7467	12691	58.84%	15.63%	15	16
15	苗栗縣三義鄉	2018-11-24T23:27:26+08:00	2166	5583	7749	402	8151	13889	58.69%	15.6%	16	16
15	苗栗縣三義鄉	2018-11-24T23:08:45+08:00	2166	5583	7749	402	8151	13889	58.69%	15.6%	16	16
15	苗栗縣三義鄉	2018-11-24T22:13:39+08:00	1677	4290	5967	326	6293	10622	59.24%	15.79%	13	16
15	苗栗縣三義鄉	2018-11-25T03:44:33+08:00	2166	5583	7749	402	8151	13889	58.69%	15.6%	16	16
15	苗栗縣三義鄉	2018-11-24T23:16:10+08:00	2166	5583	7749	402	8151	13889	58.69%	15.6%	16	16
15	苗栗縣三義鄉	2018-11-24T23:47:37+08:00	2166	5583	7749	402	8151	13889	58.69%	15.6%	16	16
15	苗栗縣三義鄉	2018-11-24T22:16:19+08:00	1677	4290	5967	326	6293	10622	59.24%	15.79%	13	16
15	苗栗縣三義鄉	2018-11-24T23:39:26+08:00	2166	5583	7749	402	8151	13889	58.69%	15.6%	16	16
15	苗栗縣三義鄉	2018-11-25T01:26:01+08:00	2166	5583	7749	402	8151	13889	58.69%	15.6%	16	16
15	苗栗縣通霄鎮	2018-11-24T22:26:44+08:00	3718	8284	12002	1088	13090	24253	53.97%	15.33%	29	34
15	苗栗縣通霄鎮	2018-11-25T00:05:13+08:00	4556	10178	14734	1346	16080	29709	54.13%	15.34%	34	34
15	苗栗縣通霄鎮	2018-11-25T03:56:21+08:00	4556	10178	14734	1346	16080	29709	54.13%	15.34%	34	34
15	苗栗縣通霄鎮	2018-11-25T01:12:52+08:00	4556	10178	14734	1346	16080	29709	54.13%	15.34%	34	34
15	苗栗縣通霄鎮	2018-11-24T22:54:32+08:00	4184	9264	13448	1211	14659	27281	53.73%	15.34%	32	34
15	苗栗縣通霄鎮	2018-11-25T00:09:43+08:00	4556	10178	14734	1346	16080	29709	54.13%	15.34%	34	34
15	苗栗縣通霄鎮	2018-11-24T22:37:08+08:00	3718	8284	12002	1088	13090	24253	53.97%	15.33%	29	34
15	苗栗縣通霄鎮	2018-11-24T22:45:15+08:00	3857	8551	12408	1109	13517	25022	54.02%	15.41%	30	34
15	苗栗縣通霄鎮	2018-11-24T22:50:57+08:00	4021	8910	12931	1152	14083	26143	53.87%	15.38%	31	34
15	苗栗縣通霄鎮	2018-11-24T22:40:35+08:00	3718	8284	12002	1088	13090	24253	53.97%	15.33%	29	34
15	苗栗縣通霄鎮	2018-11-25T01:02:39+08:00	4556	10178	14734	1346	16080	29709	54.13%	15.34%	34	34
15	苗栗縣通霄鎮	2018-11-25T04:03:00+08:00	4556	10178	14734	1346	16080	29709	54.13%	15.34%	34	34
15	苗栗縣通霄鎮	2018-11-25T00:57:45+08:00	4556	10178	14734	1346	16080	29709	54.13%	15.34%	34	34
15	苗栗縣通霄鎮	2018-11-24T22:19:44+08:00	3718	8284	12002	1088	13090	24253	53.97%	15.33%	29	34
15	苗栗縣通霄鎮	2018-11-25T06:14:00+08:00	4556	10178	14734	1346	16080	29709	54.13%	15.34%	34	34
15	苗栗縣通霄鎮	2018-11-25T00:00:18+08:00	4556	10178	14734	1346	16080	29709	54.13%	15.34%	34	34
15	苗栗縣通霄鎮	2018-11-24T23:27:25+08:00	4556	10178	14734	1346	16080	29709	54.13%	15.34%	34	34
15	苗栗縣通霄鎮	2018-11-24T23:55:55+08:00	4556	10178	14734	1346	16080	29709	54.13%	15.34%	34	34
15	苗栗縣通霄鎮	2018-11-25T00:23:12+08:00	4556	10178	14734	1346	16080	29709	54.13%	15.34%	34	34
15	苗栗縣通霄鎮	2018-11-24T22:23:22+08:00	3718	8284	12002	1088	13090	24253	53.97%	15.33%	29	34
15	苗栗縣通霄鎮	2018-11-24T23:01:39+08:00	4184	9264	13448	1211	14659	27281	53.73%	15.34%	32	34
15	苗栗縣通霄鎮	2018-11-24T23:39:25+08:00	4556	10178	14734	1346	16080	29709	54.13%	15.34%	34	34
15	苗栗縣通霄鎮	2018-11-24T23:20:00+08:00	4556	10178	14734	1346	16080	29709	54.13%	15.34%	34	34
15	苗栗縣通霄鎮	2018-11-25T01:07:34+08:00	4556	10178	14734	1346	16080	29709	54.13%	15.34%	34	34
15	苗栗縣通霄鎮	2018-11-25T00:18:40+08:00	4556	10178	14734	1346	16080	29709	54.13%	15.34%	34	34
15	苗栗縣通霄鎮	2018-11-24T23:12:25+08:00	4184	9264	13448	1211	14659	27281	53.73%	15.34%	32	34
15	苗栗縣通霄鎮	2018-11-25T03:39:02+08:00	4556	10178	14734	1346	16080	29709	54.13%	15.34%	34	34
15	苗栗縣通霄鎮	2018-11-24T23:31:20+08:00	4556	10178	14734	1346	16080	29709	54.13%	15.34%	34	34
15	苗栗縣通霄鎮	2018-11-24T23:35:17+08:00	4556	10178	14734	1346	16080	29709	54.13%	15.34%	34	34
15	苗栗縣通霄鎮	2018-11-25T00:14:17+08:00	4556	10178	14734	1346	16080	29709	54.13%	15.34%	34	34
15	苗栗縣通霄鎮	2018-11-24T23:43:24+08:00	4556	10178	14734	1346	16080	29709	54.13%	15.34%	34	34
15	苗栗縣通霄鎮	2018-11-24T22:58:02+08:00	4184	9264	13448	1211	14659	27281	53.73%	15.34%	32	34
15	苗栗縣通霄鎮	2018-11-25T03:49:58+08:00	4556	10178	14734	1346	16080	29709	54.13%	15.34%	34	34
15	苗栗縣通霄鎮	2018-11-25T01:18:02+08:00	4556	10178	14734	1346	16080	29709	54.13%	15.34%	34	34
15	苗栗縣通霄鎮	2018-11-25T06:29:25+08:00	4556	10178	14734	1346	16080	29709	54.13%	15.34%	34	34
15	苗栗縣通霄鎮	2018-11-25T06:19:05+08:00	4556	10178	14734	1346	16080	29709	54.13%	15.34%	34	34
15	苗栗縣通霄鎮	2018-11-24T23:05:11+08:00	4184	9264	13448	1211	14659	27281	53.73%	15.34%	32	34
15	苗栗縣通霄鎮	2018-11-24T22:41:44+08:00	3718	8284	12002	1088	13090	24253	53.97%	15.33%	29	34
15	苗栗縣通霄鎮	2018-11-24T23:51:43+08:00	4556	10178	14734	1346	16080	29709	54.13%	15.34%	34	34
15	苗栗縣通霄鎮	2018-11-24T22:30:17+08:00	3718	8284	12002	1088	13090	24253	53.97%	15.33%	29	34
15	苗栗縣通霄鎮	2018-11-25T06:24:08+08:00	4556	10178	14734	1346	16080	29709	54.13%	15.34%	34	34
15	苗栗縣通霄鎮	2018-11-25T06:09:02+08:00	4556	10178	14734	1346	16080	29709	54.13%	15.34%	34	34
15	苗栗縣通霄鎮	2018-11-24T23:23:45+08:00	4556	10178	14734	1346	16080	29709	54.13%	15.34%	34	34
15	苗栗縣通霄鎮	2018-11-25T03:44:32+08:00	4556	10178	14734	1346	16080	29709	54.13%	15.34%	34	34
15	苗栗縣通霄鎮	2018-11-25T03:32:45+08:00	4556	10178	14734	1346	16080	29709	54.13%	15.34%	34	34
15	苗栗縣通霄鎮	2018-11-24T22:13:38+08:00	3718	8284	12002	1088	13090	24253	53.97%	15.33%	29	34
15	苗栗縣通霄鎮	2018-11-24T23:08:45+08:00	4184	9264	13448	1211	14659	27281	53.73%	15.34%	32	34
15	苗栗縣通霄鎮	2018-11-24T23:16:10+08:00	4556	10178	14734	1346	16080	29709	54.13%	15.34%	34	34
15	苗栗縣通霄鎮	2018-11-24T23:47:37+08:00	4556	10178	14734	1346	16080	29709	54.13%	15.34%	34	34
15	苗栗縣通霄鎮	2018-11-24T22:16:19+08:00	3718	8284	12002	1088	13090	24253	53.97%	15.33%	29	34
15	苗栗縣通霄鎮	2018-11-25T01:26:01+08:00	4556	10178	14734	1346	16080	29709	54.13%	15.34%	34	34
15	苗栗縣通霄鎮	2018-11-24T22:33:45+08:00	3718	8284	12002	1088	13090	24253	53.97%	15.33%	29	34
15	澎湖縣	2018-11-25T03:56:28+08:00	11489	26451	37940	2808	40748	90405	45.07%	12.71%	116	116
15	澎湖縣	2018-11-24T22:58:08+08:00	7580	18308	25888	2060	27948	63601	43.94%	11.92%	95	116
15	澎湖縣	2018-11-24T23:47:43+08:00	9563	23188	32751	2545	35296	79372	44.47%	12.05%	108	116
15	澎湖縣	2018-11-24T23:56:01+08:00	9563	23188	32751	2545	35296	79372	44.47%	12.05%	108	116
15	澎湖縣	2018-11-24T23:01:46+08:00	7580	18308	25888	2060	27948	63601	43.94%	11.92%	95	116
15	澎湖縣	2018-11-24T23:12:30+08:00	7873	19031	26904	2154	29058	65840	44.13%	11.96%	97	116
15	澎湖縣	2018-11-24T23:27:30+08:00	9303	22549	31852	2501	34353	77396	44.39%	12.02%	106	116
15	澎湖縣	2018-11-25T06:09:09+08:00	11489	26451	37940	2808	40748	90405	45.07%	12.71%	116	116
15	澎湖縣	2018-11-24T22:13:45+08:00	5755	13823	19578	1621	21199	49263	43.03%	11.68%	81	116
15	澎湖縣	2018-11-25T04:03:06+08:00	11489	26451	37940	2808	40748	90405	45.07%	12.71%	116	116
15	澎湖縣	2018-11-24T23:51:48+08:00	9563	23188	32751	2545	35296	79372	44.47%	12.05%	108	116
15	澎湖縣	2018-11-24T22:30:23+08:00	6786	16286	23072	1890	24962	56785	43.96%	11.95%	89	116
15	澎湖縣	2018-11-25T03:32:52+08:00	11489	26451	37940	2808	40748	90405	45.07%	12.71%	116	116
15	澎湖縣	2018-11-25T03:44:40+08:00	11489	26451	37940	2808	40748	90405	45.07%	12.71%	116	116
15	澎湖縣	2018-11-25T00:57:51+08:00	11489	26451	37940	2808	40748	90405	45.07%	12.71%	116	116
15	澎湖縣	2018-11-24T22:19:50+08:00	6179	14914	21093	1711	22804	52256	43.64%	11.82%	83	116
15	澎湖縣	2018-11-24T22:16:25+08:00	5983	14422	20405	1653	22058	50744	43.47%	11.79%	82	116
15	澎湖縣	2018-11-25T00:09:50+08:00	10286	24885	35171	2654	37825	84247	44.9%	12.21%	112	116
15	澎湖縣	2018-11-25T00:18:47+08:00	11298	26004	37302	2767	40069	89057	44.99%	12.69%	115	116
15	澎湖縣	2018-11-24T22:37:14+08:00	7366	17755	25121	2017	27138	62047	43.74%	11.87%	94	116
15	澎湖縣	2018-11-24T23:20:08+08:00	8671	21135	29806	2344	32150	72188	44.54%	12.01%	102	116
15	澎湖縣	2018-11-24T23:31:27+08:00	9505	23051	32556	2544	35100	78896	44.49%	12.05%	107	116
15	澎湖縣	2018-11-24T22:45:21+08:00	7580	18308	25888	2060	27948	63601	43.94%	11.92%	95	116
15	澎湖縣	2018-11-25T01:12:58+08:00	11489	26451	37940	2808	40748	90405	45.07%	12.71%	116	116
15	澎湖縣	2018-11-24T23:05:16+08:00	7873	19031	26904	2154	29058	65840	44.13%	11.96%	97	116
15	澎湖縣	2018-11-24T22:26:49+08:00	6560	15771	22331	1821	24152	55006	43.91%	11.93%	86	116
15	澎湖縣	2018-11-25T01:07:40+08:00	11489	26451	37940	2808	40748	90405	45.07%	12.71%	116	116
15	澎湖縣	2018-11-24T23:39:32+08:00	9563	23188	32751	2545	35296	79372	44.47%	12.05%	108	116
15	澎湖縣	2018-11-24T22:54:37+08:00	7580	18308	25888	2060	27948	63601	43.94%	11.92%	95	116
15	澎湖縣	2018-11-24T22:33:50+08:00	7097	17163	24260	1958	26218	59682	43.93%	11.89%	92	116
15	澎湖縣	2018-11-25T00:05:18+08:00	10286	24885	35171	2654	37825	84247	44.9%	12.21%	112	116
15	澎湖縣	2018-11-24T23:08:51+08:00	7873	19031	26904	2154	29058	65840	44.13%	11.96%	97	116
15	澎湖縣	2018-11-24T23:23:51+08:00	8809	21411	30220	2431	32651	73617	44.35%	11.97%	103	116
15	澎湖縣	2018-11-25T00:23:17+08:00	11298	26004	37302	2767	40069	89057	44.99%	12.69%	115	116
15	澎湖縣	2018-11-25T00:00:24+08:00	9798	23682	33480	2570	36050	80812	44.61%	12.12%	109	116
15	澎湖縣	2018-11-24T22:51:03+08:00	7580	18308	25888	2060	27948	63601	43.94%	11.92%	95	116
15	澎湖縣	2018-11-24T22:23:28+08:00	6310	15213	21523	1734	23257	53148	43.76%	11.87%	84	116
15	澎湖縣	2018-11-24T22:40:40+08:00	7580	18308	25888	2060	27948	63601	43.94%	11.92%	95	116
15	澎湖縣	2018-11-25T06:24:13+08:00	11489	26451	37940	2808	40748	90405	45.07%	12.71%	116	116
15	澎湖縣	2018-11-25T01:02:44+08:00	11489	26451	37940	2808	40748	90405	45.07%	12.71%	116	116
15	澎湖縣	2018-11-25T06:14:05+08:00	11489	26451	37940	2808	40748	90405	45.07%	12.71%	116	116
15	澎湖縣	2018-11-25T06:19:10+08:00	11489	26451	37940	2808	40748	90405	45.07%	12.71%	116	116
15	澎湖縣	2018-11-25T00:14:23+08:00	11137	25581	36718	2719	39437	87773	44.93%	12.69%	114	116
15	澎湖縣	2018-11-25T01:18:10+08:00	11489	26451	37940	2808	40748	90405	45.07%	12.71%	116	116
15	澎湖縣	2018-11-25T03:50:04+08:00	11489	26451	37940	2808	40748	90405	45.07%	12.71%	116	116
15	澎湖縣	2018-11-25T03:39:07+08:00	11489	26451	37940	2808	40748	90405	45.07%	12.71%	116	116
15	澎湖縣	2018-11-24T22:41:50+08:00	7580	18308	25888	2060	27948	63601	43.94%	11.92%	95	116
15	澎湖縣	2018-11-25T06:29:31+08:00	11489	26451	37940	2808	40748	90405	45.07%	12.71%	116	116
15	澎湖縣	2018-11-24T23:16:16+08:00	8370	20404	28774	2267	31041	69980	44.36%	11.96%	100	116
15	澎湖縣	2018-11-24T23:35:22+08:00	9563	23188	32751	2545	35296	79372	44.47%	12.05%	108	116
15	澎湖縣	2018-11-24T23:43:30+08:00	9563	23188	32751	2545	35296	79372	44.47%	12.05%	108	116
15	澎湖縣	2018-11-25T01:26:08+08:00	11489	26451	37940	2808	40748	90405	45.07%	12.71%	116	116
15	南投縣竹山鎮	2018-11-25T00:05:14+08:00	7543	16737	24280	1780	26060	47034	55.41%	16.04%	53	53
15	南投縣竹山鎮	2018-11-24T23:01:40+08:00	6616	14531	21147	1533	22680	41236	55%	16.04%	48	53
15	南投縣竹山鎮	2018-11-25T06:19:06+08:00	7543	16737	24280	1780	26060	47034	55.41%	16.04%	53	53
15	南投縣竹山鎮	2018-11-24T23:05:12+08:00	6844	15039	21883	1573	23456	42522	55.16%	16.1%	49	53
15	南投縣竹山鎮	2018-11-25T00:09:45+08:00	7543	16737	24280	1780	26060	47034	55.41%	16.04%	53	53
15	南投縣竹山鎮	2018-11-25T06:29:26+08:00	7543	16737	24280	1780	26060	47034	55.41%	16.04%	53	53
15	南投縣竹山鎮	2018-11-24T22:50:58+08:00	6616	14531	21147	1533	22680	41236	55%	16.04%	48	53
15	南投縣竹山鎮	2018-11-24T22:41:46+08:00	6616	14531	21147	1533	22680	41236	55%	16.04%	48	53
15	南投縣竹山鎮	2018-11-24T22:37:09+08:00	6490	14281	20771	1487	22258	40415	55.07%	16.06%	47	53
15	南投縣竹山鎮	2018-11-24T22:26:45+08:00	6335	13869	20204	1426	21630	39193	55.19%	16.16%	46	53
15	南投縣竹山鎮	2018-11-24T22:54:33+08:00	6616	14531	21147	1533	22680	41236	55%	16.04%	48	53
15	南投縣竹山鎮	2018-11-25T01:12:54+08:00	7543	16737	24280	1780	26060	47034	55.41%	16.04%	53	53
15	南投縣竹山鎮	2018-11-24T22:19:45+08:00	6335	13869	20204	1426	21630	39193	55.19%	16.16%	46	53
15	南投縣竹山鎮	2018-11-25T04:03:01+08:00	7543	16737	24280	1780	26060	47034	55.41%	16.04%	53	53
15	南投縣竹山鎮	2018-11-25T00:23:13+08:00	7543	16737	24280	1780	26060	47034	55.41%	16.04%	53	53
15	南投縣竹山鎮	2018-11-24T22:23:23+08:00	6335	13869	20204	1426	21630	39193	55.19%	16.16%	46	53
15	南投縣竹山鎮	2018-11-25T00:00:19+08:00	7543	16737	24280	1780	26060	47034	55.41%	16.04%	53	53
15	南投縣竹山鎮	2018-11-25T01:02:40+08:00	7543	16737	24280	1780	26060	47034	55.41%	16.04%	53	53
15	南投縣竹山鎮	2018-11-25T06:14:01+08:00	7543	16737	24280	1780	26060	47034	55.41%	16.04%	53	53
15	南投縣竹山鎮	2018-11-25T03:32:47+08:00	7543	16737	24280	1780	26060	47034	55.41%	16.04%	53	53
15	南投縣竹山鎮	2018-11-24T23:08:46+08:00	7244	15959	23203	1677	24880	45005	55.28%	16.1%	51	53
15	南投縣竹山鎮	2018-11-24T23:23:47+08:00	7543	16737	24280	1780	26060	47034	55.41%	16.04%	53	53
15	南投縣竹山鎮	2018-11-25T03:50:00+08:00	7543	16737	24280	1780	26060	47034	55.41%	16.04%	53	53
15	南投縣竹山鎮	2018-11-25T03:39:03+08:00	7543	16737	24280	1780	26060	47034	55.41%	16.04%	53	53
15	南投縣竹山鎮	2018-11-24T23:35:18+08:00	7543	16737	24280	1780	26060	47034	55.41%	16.04%	53	53
15	南投縣竹山鎮	2018-11-25T01:26:02+08:00	7543	16737	24280	1780	26060	47034	55.41%	16.04%	53	53
15	南投縣竹山鎮	2018-11-24T23:20:01+08:00	7373	16248	23621	1736	25357	45864	55.29%	16.08%	52	53
15	南投縣竹山鎮	2018-11-25T01:07:35+08:00	7543	16737	24280	1780	26060	47034	55.41%	16.04%	53	53
15	南投縣竹山鎮	2018-11-24T22:33:46+08:00	6490	14281	20771	1487	22258	40415	55.07%	16.06%	47	53
15	南投縣竹山鎮	2018-11-25T00:14:19+08:00	7543	16737	24280	1780	26060	47034	55.41%	16.04%	53	53
15	南投縣竹山鎮	2018-11-24T23:16:12+08:00	7373	16248	23621	1736	25357	45864	55.29%	16.08%	52	53
15	南投縣竹山鎮	2018-11-24T22:45:16+08:00	6616	14531	21147	1533	22680	41236	55%	16.04%	48	53
15	南投縣竹山鎮	2018-11-24T23:43:25+08:00	7543	16737	24280	1780	26060	47034	55.41%	16.04%	53	53
15	南投縣竹山鎮	2018-11-25T03:56:23+08:00	7543	16737	24280	1780	26060	47034	55.41%	16.04%	53	53
15	南投縣竹山鎮	2018-11-24T22:58:04+08:00	6616	14531	21147	1533	22680	41236	55%	16.04%	48	53
15	南投縣竹山鎮	2018-11-25T01:18:04+08:00	7543	16737	24280	1780	26060	47034	55.41%	16.04%	53	53
15	南投縣竹山鎮	2018-11-25T06:24:09+08:00	7543	16737	24280	1780	26060	47034	55.41%	16.04%	53	53
15	南投縣竹山鎮	2018-11-25T06:09:04+08:00	7543	16737	24280	1780	26060	47034	55.41%	16.04%	53	53
15	南投縣竹山鎮	2018-11-24T23:51:44+08:00	7543	16737	24280	1780	26060	47034	55.41%	16.04%	53	53
15	南投縣竹山鎮	2018-11-24T22:40:36+08:00	6616	14531	21147	1533	22680	41236	55%	16.04%	48	53
15	南投縣竹山鎮	2018-11-24T22:30:19+08:00	6335	13869	20204	1426	21630	39193	55.19%	16.16%	46	53
15	南投縣竹山鎮	2018-11-24T22:13:40+08:00	6217	13579	19796	1401	21197	38285	55.37%	16.24%	45	53
15	南投縣竹山鎮	2018-11-25T00:57:46+08:00	7543	16737	24280	1780	26060	47034	55.41%	16.04%	53	53
15	南投縣竹山鎮	2018-11-24T23:27:26+08:00	7543	16737	24280	1780	26060	47034	55.41%	16.04%	53	53
15	南投縣竹山鎮	2018-11-25T03:44:35+08:00	7543	16737	24280	1780	26060	47034	55.41%	16.04%	53	53
15	南投縣竹山鎮	2018-11-24T23:55:56+08:00	7543	16737	24280	1780	26060	47034	55.41%	16.04%	53	53
15	南投縣竹山鎮	2018-11-24T23:31:22+08:00	7543	16737	24280	1780	26060	47034	55.41%	16.04%	53	53
15	南投縣竹山鎮	2018-11-25T00:18:42+08:00	7543	16737	24280	1780	26060	47034	55.41%	16.04%	53	53
15	南投縣竹山鎮	2018-11-24T23:47:38+08:00	7543	16737	24280	1780	26060	47034	55.41%	16.04%	53	53
15	南投縣竹山鎮	2018-11-24T23:12:26+08:00	7373	16248	23621	1736	25357	45864	55.29%	16.08%	52	53
15	南投縣竹山鎮	2018-11-24T22:16:20+08:00	6217	13579	19796	1401	21197	38285	55.37%	16.24%	45	53
15	南投縣竹山鎮	2018-11-24T23:39:27+08:00	7543	16737	24280	1780	26060	47034	55.41%	16.04%	53	53
15	臺東縣金峰鄉	2018-11-25T03:56:28+08:00	454	1176	1630	170	1800	3028	59.45%	14.99%	5	5
15	臺東縣金峰鄉	2018-11-24T22:58:08+08:00	196	527	723	85	808	1267	63.77%	15.47%	3	5
15	臺東縣金峰鄉	2018-11-24T23:47:43+08:00	305	771	1076	125	1201	1787	67.21%	17.07%	4	5
15	臺東縣金峰鄉	2018-11-24T23:56:01+08:00	305	771	1076	125	1201	1787	67.21%	17.07%	4	5
15	臺東縣金峰鄉	2018-11-24T23:01:46+08:00	196	527	723	85	808	1267	63.77%	15.47%	3	5
15	臺東縣金峰鄉	2018-11-24T23:12:30+08:00	196	527	723	85	808	1267	63.77%	15.47%	3	5
15	臺東縣金峰鄉	2018-11-24T23:27:30+08:00	305	771	1076	125	1201	1787	67.21%	17.07%	4	5
15	臺東縣金峰鄉	2018-11-25T06:09:09+08:00	454	1176	1630	170	1800	3028	59.45%	14.99%	5	5
15	臺東縣金峰鄉	2018-11-24T22:13:45+08:00	48	144	192	31	223	330	67.58%	14.55%	1	5
15	臺東縣金峰鄉	2018-11-25T04:03:06+08:00	454	1176	1630	170	1800	3028	59.45%	14.99%	5	5
15	臺東縣金峰鄉	2018-11-24T23:51:48+08:00	305	771	1076	125	1201	1787	67.21%	17.07%	4	5
15	臺東縣金峰鄉	2018-11-24T22:30:23+08:00	92	267	359	53	412	666	61.86%	13.81%	2	5
15	臺東縣金峰鄉	2018-11-25T03:32:52+08:00	454	1176	1630	170	1800	3028	59.45%	14.99%	5	5
15	臺東縣金峰鄉	2018-11-25T03:44:40+08:00	454	1176	1630	170	1800	3028	59.45%	14.99%	5	5
15	臺東縣金峰鄉	2018-11-25T00:57:51+08:00	454	1176	1630	170	1800	3028	59.45%	14.99%	5	5
15	臺東縣金峰鄉	2018-11-24T22:19:50+08:00	48	144	192	31	223	330	67.58%	14.55%	1	5
15	臺東縣金峰鄉	2018-11-24T22:16:25+08:00	48	144	192	31	223	330	67.58%	14.55%	1	5
15	臺東縣金峰鄉	2018-11-25T00:09:50+08:00	305	771	1076	125	1201	1787	67.21%	17.07%	4	5
15	臺東縣金峰鄉	2018-11-25T00:18:47+08:00	305	771	1076	125	1201	1787	67.21%	17.07%	4	5
15	臺東縣金峰鄉	2018-11-24T22:37:14+08:00	92	267	359	53	412	666	61.86%	13.81%	2	5
15	臺東縣金峰鄉	2018-11-24T23:20:08+08:00	196	527	723	85	808	1267	63.77%	15.47%	3	5
15	臺東縣金峰鄉	2018-11-24T23:31:27+08:00	305	771	1076	125	1201	1787	67.21%	17.07%	4	5
15	臺東縣金峰鄉	2018-11-25T01:12:58+08:00	454	1176	1630	170	1800	3028	59.45%	14.99%	5	5
15	臺東縣金峰鄉	2018-11-24T23:05:16+08:00	196	527	723	85	808	1267	63.77%	15.47%	3	5
15	臺東縣金峰鄉	2018-11-25T01:07:40+08:00	454	1176	1630	170	1800	3028	59.45%	14.99%	5	5
15	臺東縣金峰鄉	2018-11-24T23:39:32+08:00	305	771	1076	125	1201	1787	67.21%	17.07%	4	5
15	臺東縣金峰鄉	2018-11-24T22:54:37+08:00	196	527	723	85	808	1267	63.77%	15.47%	3	5
15	臺東縣金峰鄉	2018-11-24T22:33:50+08:00	92	267	359	53	412	666	61.86%	13.81%	2	5
15	臺東縣金峰鄉	2018-11-24T22:45:20+08:00	196	527	723	85	808	1267	63.77%	15.47%	3	5
15	臺東縣金峰鄉	2018-11-25T00:05:18+08:00	305	771	1076	125	1201	1787	67.21%	17.07%	4	5
15	臺東縣金峰鄉	2018-11-24T22:26:48+08:00	92	267	359	53	412	666	61.86%	13.81%	2	5
15	臺東縣金峰鄉	2018-11-24T23:08:51+08:00	196	527	723	85	808	1267	63.77%	15.47%	3	5
15	臺東縣金峰鄉	2018-11-24T23:23:51+08:00	305	771	1076	125	1201	1787	67.21%	17.07%	4	5
15	臺東縣金峰鄉	2018-11-25T00:23:17+08:00	305	771	1076	125	1201	1787	67.21%	17.07%	4	5
15	臺東縣金峰鄉	2018-11-25T00:00:24+08:00	305	771	1076	125	1201	1787	67.21%	17.07%	4	5
15	臺東縣金峰鄉	2018-11-24T22:51:03+08:00	196	527	723	85	808	1267	63.77%	15.47%	3	5
15	臺東縣金峰鄉	2018-11-24T22:23:28+08:00	48	144	192	31	223	330	67.58%	14.55%	1	5
15	臺東縣金峰鄉	2018-11-24T22:40:40+08:00	196	527	723	85	808	1267	63.77%	15.47%	3	5
15	臺東縣金峰鄉	2018-11-25T06:24:13+08:00	454	1176	1630	170	1800	3028	59.45%	14.99%	5	5
15	臺東縣金峰鄉	2018-11-25T01:02:44+08:00	454	1176	1630	170	1800	3028	59.45%	14.99%	5	5
15	臺東縣金峰鄉	2018-11-25T06:14:05+08:00	454	1176	1630	170	1800	3028	59.45%	14.99%	5	5
15	臺東縣金峰鄉	2018-11-25T06:19:10+08:00	454	1176	1630	170	1800	3028	59.45%	14.99%	5	5
15	臺東縣金峰鄉	2018-11-25T00:14:23+08:00	305	771	1076	125	1201	1787	67.21%	17.07%	4	5
15	臺東縣金峰鄉	2018-11-25T01:18:10+08:00	454	1176	1630	170	1800	3028	59.45%	14.99%	5	5
15	臺東縣金峰鄉	2018-11-25T03:50:04+08:00	454	1176	1630	170	1800	3028	59.45%	14.99%	5	5
15	臺東縣金峰鄉	2018-11-25T03:39:07+08:00	454	1176	1630	170	1800	3028	59.45%	14.99%	5	5
15	臺東縣金峰鄉	2018-11-24T22:41:50+08:00	196	527	723	85	808	1267	63.77%	15.47%	3	5
15	臺東縣金峰鄉	2018-11-25T06:29:31+08:00	454	1176	1630	170	1800	3028	59.45%	14.99%	5	5
15	臺東縣金峰鄉	2018-11-24T23:16:16+08:00	196	527	723	85	808	1267	63.77%	15.47%	3	5
15	臺東縣金峰鄉	2018-11-24T23:35:22+08:00	305	771	1076	125	1201	1787	67.21%	17.07%	4	5
15	臺東縣金峰鄉	2018-11-24T23:43:30+08:00	305	771	1076	125	1201	1787	67.21%	17.07%	4	5
15	臺東縣金峰鄉	2018-11-25T01:26:08+08:00	454	1176	1630	170	1800	3028	59.45%	14.99%	5	5
15	臺東縣卑南鄉	2018-11-24T23:56:00+08:00	2112	4952	7064	803	7867	14976	52.53%	14.1%	22	22
15	臺東縣卑南鄉	2018-11-24T22:58:08+08:00	1932	4557	6489	749	7238	13871	52.18%	13.93%	21	22
15	臺東縣卑南鄉	2018-11-25T01:18:09+08:00	2112	4952	7064	803	7867	14976	52.53%	14.1%	22	22
15	臺東縣卑南鄉	2018-11-25T03:56:27+08:00	2112	4952	7064	803	7867	14976	52.53%	14.1%	22	22
15	臺東縣卑南鄉	2018-11-24T23:47:42+08:00	2112	4952	7064	803	7867	14976	52.53%	14.1%	22	22
15	臺東縣卑南鄉	2018-11-24T23:12:30+08:00	1932	4557	6489	749	7238	13871	52.18%	13.93%	21	22
15	臺東縣卑南鄉	2018-11-24T23:27:30+08:00	1932	4557	6489	749	7238	13871	52.18%	13.93%	21	22
15	臺東縣卑南鄉	2018-11-25T06:09:09+08:00	2112	4952	7064	803	7867	14976	52.53%	14.1%	22	22
15	臺東縣卑南鄉	2018-11-24T23:51:48+08:00	2112	4952	7064	803	7867	14976	52.53%	14.1%	22	22
15	臺東縣卑南鄉	2018-11-24T22:30:23+08:00	1796	4271	6067	701	6768	12903	52.45%	13.92%	20	22
15	臺東縣卑南鄉	2018-11-25T03:32:52+08:00	2112	4952	7064	803	7867	14976	52.53%	14.1%	22	22
15	臺東縣卑南鄉	2018-11-24T22:13:44+08:00	1796	4271	6067	701	6768	12903	52.45%	13.92%	20	22
15	臺東縣卑南鄉	2018-11-25T03:44:40+08:00	2112	4952	7064	803	7867	14976	52.53%	14.1%	22	22
15	臺東縣卑南鄉	2018-11-25T00:57:50+08:00	2112	4952	7064	803	7867	14976	52.53%	14.1%	22	22
15	臺東縣卑南鄉	2018-11-24T22:16:25+08:00	1796	4271	6067	701	6768	12903	52.45%	13.92%	20	22
15	臺東縣卑南鄉	2018-11-24T23:31:26+08:00	1932	4557	6489	749	7238	13871	52.18%	13.93%	21	22
15	臺東縣卑南鄉	2018-11-25T00:09:50+08:00	2112	4952	7064	803	7867	14976	52.53%	14.1%	22	22
15	臺東縣卑南鄉	2018-11-25T00:18:47+08:00	2112	4952	7064	803	7867	14976	52.53%	14.1%	22	22
15	臺東縣卑南鄉	2018-11-24T23:20:08+08:00	1932	4557	6489	749	7238	13871	52.18%	13.93%	21	22
15	臺東縣卑南鄉	2018-11-24T22:37:13+08:00	1796	4271	6067	701	6768	12903	52.45%	13.92%	20	22
15	臺東縣卑南鄉	2018-11-24T23:16:15+08:00	1932	4557	6489	749	7238	13871	52.18%	13.93%	21	22
15	臺東縣卑南鄉	2018-11-25T01:12:58+08:00	2112	4952	7064	803	7867	14976	52.53%	14.1%	22	22
15	臺東縣卑南鄉	2018-11-25T00:05:17+08:00	2112	4952	7064	803	7867	14976	52.53%	14.1%	22	22
15	臺東縣卑南鄉	2018-11-24T23:05:16+08:00	1932	4557	6489	749	7238	13871	52.18%	13.93%	21	22
15	臺東縣卑南鄉	2018-11-24T23:39:32+08:00	1932	4557	6489	749	7238	13871	52.18%	13.93%	21	22
15	臺東縣卑南鄉	2018-11-24T22:54:37+08:00	1932	4557	6489	749	7238	13871	52.18%	13.93%	21	22
15	臺東縣卑南鄉	2018-11-24T22:33:50+08:00	1796	4271	6067	701	6768	12903	52.45%	13.92%	20	22
15	臺東縣卑南鄉	2018-11-24T22:45:20+08:00	1796	4271	6067	701	6768	12903	52.45%	13.92%	20	22
15	臺東縣卑南鄉	2018-11-24T22:26:48+08:00	1796	4271	6067	701	6768	12903	52.45%	13.92%	20	22
15	臺東縣卑南鄉	2018-11-24T23:01:45+08:00	1932	4557	6489	749	7238	13871	52.18%	13.93%	21	22
15	臺東縣卑南鄉	2018-11-25T04:03:05+08:00	2112	4952	7064	803	7867	14976	52.53%	14.1%	22	22
15	臺東縣卑南鄉	2018-11-24T23:08:51+08:00	1932	4557	6489	749	7238	13871	52.18%	13.93%	21	22
15	臺東縣卑南鄉	2018-11-24T23:23:50+08:00	1932	4557	6489	749	7238	13871	52.18%	13.93%	21	22
15	臺東縣卑南鄉	2018-11-24T22:19:49+08:00	1796	4271	6067	701	6768	12903	52.45%	13.92%	20	22
15	臺東縣卑南鄉	2018-11-25T00:00:23+08:00	2112	4952	7064	803	7867	14976	52.53%	14.1%	22	22
15	臺東縣卑南鄉	2018-11-24T22:51:03+08:00	1796	4271	6067	701	6768	12903	52.45%	13.92%	20	22
15	臺東縣卑南鄉	2018-11-24T22:23:28+08:00	1796	4271	6067	701	6768	12903	52.45%	13.92%	20	22
15	臺東縣卑南鄉	2018-11-24T22:40:40+08:00	1796	4271	6067	701	6768	12903	52.45%	13.92%	20	22
15	臺東縣卑南鄉	2018-11-25T06:24:13+08:00	2112	4952	7064	803	7867	14976	52.53%	14.1%	22	22
15	臺東縣卑南鄉	2018-11-25T01:02:44+08:00	2112	4952	7064	803	7867	14976	52.53%	14.1%	22	22
15	臺東縣卑南鄉	2018-11-25T06:14:05+08:00	2112	4952	7064	803	7867	14976	52.53%	14.1%	22	22
15	臺東縣卑南鄉	2018-11-25T00:23:16+08:00	2112	4952	7064	803	7867	14976	52.53%	14.1%	22	22
15	臺東縣卑南鄉	2018-11-25T06:19:10+08:00	2112	4952	7064	803	7867	14976	52.53%	14.1%	22	22
15	臺東縣卑南鄉	2018-11-25T03:50:03+08:00	2112	4952	7064	803	7867	14976	52.53%	14.1%	22	22
15	臺東縣卑南鄉	2018-11-25T01:07:39+08:00	2112	4952	7064	803	7867	14976	52.53%	14.1%	22	22
15	臺東縣卑南鄉	2018-11-25T01:26:07+08:00	2112	4952	7064	803	7867	14976	52.53%	14.1%	22	22
15	臺東縣卑南鄉	2018-11-25T03:39:07+08:00	2112	4952	7064	803	7867	14976	52.53%	14.1%	22	22
15	臺東縣卑南鄉	2018-11-24T22:41:50+08:00	1796	4271	6067	701	6768	12903	52.45%	13.92%	20	22
15	臺東縣卑南鄉	2018-11-25T00:14:22+08:00	2112	4952	7064	803	7867	14976	52.53%	14.1%	22	22
15	臺東縣卑南鄉	2018-11-25T06:29:31+08:00	2112	4952	7064	803	7867	14976	52.53%	14.1%	22	22
15	臺東縣卑南鄉	2018-11-24T23:35:22+08:00	1932	4557	6489	749	7238	13871	52.18%	13.93%	21	22
15	臺東縣卑南鄉	2018-11-24T23:43:30+08:00	2112	4952	7064	803	7867	14976	52.53%	14.1%	22	22
15	臺中市大肚區	2018-11-25T03:49:55+08:00	7860	18142	26002	1772	27774	47457	58.52%	16.56%	33	33
15	臺中市大肚區	2018-11-25T06:19:01+08:00	7860	18142	26002	1772	27774	47457	58.52%	16.56%	33	33
15	臺中市大肚區	2018-11-24T23:16:07+08:00	6844	15634	22478	1534	24012	41080	58.45%	16.66%	29	33
15	臺中市大肚區	2018-11-25T03:56:18+08:00	7860	18142	26002	1772	27774	47457	58.52%	16.56%	33	33
15	臺中市大肚區	2018-11-24T22:45:12+08:00	5092	11585	16677	1106	17783	30434	58.43%	16.73%	22	33
15	臺中市大肚區	2018-11-24T23:43:21+08:00	7409	16981	24390	1681	26071	44572	58.49%	16.62%	31	33
15	臺中市大肚區	2018-11-24T22:41:40+08:00	4836	10965	15801	1060	16861	28914	58.31%	16.73%	21	33
15	臺中市大肚區	2018-11-25T00:18:36+08:00	7660	17608	25268	1724	26992	46201	58.42%	16.58%	32	33
15	臺中市大肚區	2018-11-24T23:51:40+08:00	7409	16981	24390	1681	26071	44572	58.49%	16.62%	31	33
15	臺中市大肚區	2018-11-25T01:25:57+08:00	7860	18142	26002	1772	27774	47457	58.52%	16.56%	33	33
15	臺中市大肚區	2018-11-24T22:30:14+08:00	4112	9392	13504	860	14364	24749	58.04%	16.61%	18	33
15	臺中市大肚區	2018-11-25T06:24:04+08:00	7860	18142	26002	1772	27774	47457	58.52%	16.56%	33	33
15	臺中市大肚區	2018-11-25T00:23:08+08:00	7660	17608	25268	1724	26992	46201	58.42%	16.58%	32	33
15	臺中市大肚區	2018-11-24T23:27:22+08:00	7409	16981	24390	1681	26071	44572	58.49%	16.62%	31	33
15	臺中市大肚區	2018-11-24T22:57:59+08:00	6057	13967	20024	1311	21335	36571	58.34%	16.56%	26	33
15	臺中市大肚區	2018-11-25T03:32:41+08:00	7860	18142	26002	1772	27774	47457	58.52%	16.56%	33	33
15	臺中市大肚區	2018-11-24T23:08:41+08:00	6573	15070	21643	1451	23094	39595	58.33%	16.6%	28	33
15	臺中市大肚區	2018-11-24T22:13:33+08:00	3842	8774	12616	794	13410	22996	58.31%	16.71%	17	33
15	臺中市大肚區	2018-11-24T23:19:56+08:00	7158	16288	23446	1590	25036	42902	58.36%	16.68%	30	33
15	臺中市大肚區	2018-11-25T01:17:58+08:00	7860	18142	26002	1772	27774	47457	58.52%	16.56%	33	33
15	臺中市大肚區	2018-11-24T22:54:29+08:00	5509	12621	18130	1211	19341	33162	58.32%	16.61%	24	33
15	臺中市大肚區	2018-11-24T23:47:33+08:00	7409	16981	24390	1681	26071	44572	58.49%	16.62%	31	33
15	臺中市大肚區	2018-11-25T06:08:58+08:00	7860	18142	26002	1772	27774	47457	58.52%	16.56%	33	33
15	臺中市大肚區	2018-11-24T22:16:15+08:00	3842	8774	12616	794	13410	22996	58.31%	16.71%	17	33
15	臺中市大肚區	2018-11-24T23:31:16+08:00	7409	16981	24390	1681	26071	44572	58.49%	16.62%	31	33
15	臺中市大肚區	2018-11-25T01:12:48+08:00	7860	18142	26002	1772	27774	47457	58.52%	16.56%	33	33
15	臺中市大肚區	2018-11-24T23:05:08+08:00	6347	14600	20947	1409	22356	38301	58.37%	16.57%	27	33
15	臺中市大肚區	2018-11-25T04:02:57+08:00	7860	18142	26002	1772	27774	47457	58.52%	16.56%	33	33
15	臺中市大肚區	2018-11-25T00:05:09+08:00	7660	17608	25268	1724	26992	46201	58.42%	16.58%	32	33
15	臺中市大肚區	2018-11-25T06:29:22+08:00	7860	18142	26002	1772	27774	47457	58.52%	16.56%	33	33
15	臺中市大肚區	2018-11-25T06:13:57+08:00	7860	18142	26002	1772	27774	47457	58.52%	16.56%	33	33
15	臺中市大肚區	2018-11-24T22:50:53+08:00	5294	12141	17435	1160	18595	31770	58.53%	16.66%	23	33
15	臺中市大肚區	2018-11-24T22:37:05+08:00	4836	10965	15801	1060	16861	28914	58.31%	16.73%	21	33
15	臺中市大肚區	2018-11-24T22:26:41+08:00	4112	9392	13504	860	14364	24749	58.04%	16.61%	18	33
15	臺中市大肚區	2018-11-24T22:19:41+08:00	4112	9392	13504	860	14364	24749	58.04%	16.61%	18	33
15	臺中市大肚區	2018-11-25T03:38:59+08:00	7860	18142	26002	1772	27774	47457	58.52%	16.56%	33	33
15	臺中市大肚區	2018-11-24T22:40:31+08:00	4836	10965	15801	1060	16861	28914	58.31%	16.73%	21	33
15	臺中市大肚區	2018-11-25T01:02:35+08:00	7860	18142	26002	1772	27774	47457	58.52%	16.56%	33	33
15	臺中市大肚區	2018-11-25T00:57:41+08:00	7860	18142	26002	1772	27774	47457	58.52%	16.56%	33	33
15	臺中市大肚區	2018-11-25T03:44:28+08:00	7860	18142	26002	1772	27774	47457	58.52%	16.56%	33	33
15	臺中市大肚區	2018-11-24T23:23:42+08:00	7409	16981	24390	1681	26071	44572	58.49%	16.62%	31	33
15	臺中市大肚區	2018-11-24T22:23:18+08:00	4112	9392	13504	860	14364	24749	58.04%	16.61%	18	33
15	臺中市大肚區	2018-11-25T00:00:15+08:00	7660	17608	25268	1724	26992	46201	58.42%	16.58%	32	33
15	臺中市大肚區	2018-11-24T23:55:51+08:00	7409	16981	24390	1681	26071	44572	58.49%	16.62%	31	33
15	臺中市大肚區	2018-11-24T23:35:15+08:00	7409	16981	24390	1681	26071	44572	58.49%	16.62%	31	33
15	臺中市大肚區	2018-11-24T23:39:21+08:00	7409	16981	24390	1681	26071	44572	58.49%	16.62%	31	33
15	臺中市大肚區	2018-11-24T23:12:20+08:00	6844	15634	22478	1534	24012	41080	58.45%	16.66%	29	33
15	臺中市大肚區	2018-11-25T00:14:14+08:00	7660	17608	25268	1724	26992	46201	58.42%	16.58%	32	33
15	臺中市大肚區	2018-11-24T23:01:35+08:00	6057	13967	20024	1311	21335	36571	58.34%	16.56%	26	33
15	臺中市大肚區	2018-11-25T00:09:39+08:00	7660	17608	25268	1724	26992	46201	58.42%	16.58%	32	33
15	臺中市大肚區	2018-11-25T01:07:31+08:00	7860	18142	26002	1772	27774	47457	58.52%	16.56%	33	33
15	臺中市大肚區	2018-11-24T22:33:42+08:00	4277	9754	14031	916	14947	25611	58.36%	16.7%	19	33
15	宜蘭縣壯圍鄉	2018-11-25T03:56:26+08:00	3935	7302	11237	1133	12370	21447	57.68%	18.35%	23	23
15	宜蘭縣壯圍鄉	2018-11-24T23:05:15+08:00	3935	7302	11237	1133	12370	21447	57.68%	18.35%	23	23
15	宜蘭縣壯圍鄉	2018-11-25T01:18:08+08:00	3935	7302	11237	1133	12370	21447	57.68%	18.35%	23	23
15	宜蘭縣壯圍鄉	2018-11-24T23:43:29+08:00	3935	7302	11237	1133	12370	21447	57.68%	18.35%	23	23
15	宜蘭縣壯圍鄉	2018-11-25T06:19:09+08:00	3935	7302	11237	1133	12370	21447	57.68%	18.35%	23	23
15	宜蘭縣壯圍鄉	2018-11-24T22:58:07+08:00	3671	6776	10447	1058	11505	20012	57.49%	18.34%	22	23
15	宜蘭縣壯圍鄉	2018-11-24T22:41:49+08:00	3671	6776	10447	1058	11505	20012	57.49%	18.34%	22	23
15	宜蘭縣壯圍鄉	2018-11-24T23:39:31+08:00	3935	7302	11237	1133	12370	21447	57.68%	18.35%	23	23
15	宜蘭縣壯圍鄉	2018-11-24T23:47:42+08:00	3935	7302	11237	1133	12370	21447	57.68%	18.35%	23	23
15	宜蘭縣壯圍鄉	2018-11-24T22:30:22+08:00	3671	6776	10447	1058	11505	20012	57.49%	18.34%	22	23
15	宜蘭縣壯圍鄉	2018-11-24T23:51:47+08:00	3935	7302	11237	1133	12370	21447	57.68%	18.35%	23	23
15	宜蘭縣壯圍鄉	2018-11-25T06:09:08+08:00	3935	7302	11237	1133	12370	21447	57.68%	18.35%	23	23
15	宜蘭縣壯圍鄉	2018-11-24T22:13:43+08:00	3467	6502	9969	993	10962	19101	57.39%	18.15%	21	23
15	宜蘭縣壯圍鄉	2018-11-25T00:57:50+08:00	3935	7302	11237	1133	12370	21447	57.68%	18.35%	23	23
15	宜蘭縣壯圍鄉	2018-11-25T03:44:39+08:00	3935	7302	11237	1133	12370	21447	57.68%	18.35%	23	23
15	宜蘭縣壯圍鄉	2018-11-24T23:23:49+08:00	3935	7302	11237	1133	12370	21447	57.68%	18.35%	23	23
15	宜蘭縣壯圍鄉	2018-11-24T22:33:49+08:00	3671	6776	10447	1058	11505	20012	57.49%	18.34%	22	23
15	宜蘭縣壯圍鄉	2018-11-24T22:37:13+08:00	3671	6776	10447	1058	11505	20012	57.49%	18.34%	22	23
15	宜蘭縣壯圍鄉	2018-11-24T22:16:24+08:00	3467	6502	9969	993	10962	19101	57.39%	18.15%	21	23
15	宜蘭縣壯圍鄉	2018-11-24T23:35:21+08:00	3935	7302	11237	1133	12370	21447	57.68%	18.35%	23	23
15	宜蘭縣壯圍鄉	2018-11-24T23:16:15+08:00	3935	7302	11237	1133	12370	21447	57.68%	18.35%	23	23
15	宜蘭縣壯圍鄉	2018-11-24T22:45:19+08:00	3671	6776	10447	1058	11505	20012	57.49%	18.34%	22	23
15	宜蘭縣壯圍鄉	2018-11-24T22:54:36+08:00	3671	6776	10447	1058	11505	20012	57.49%	18.34%	22	23
15	宜蘭縣壯圍鄉	2018-11-24T23:01:44+08:00	3671	6776	10447	1058	11505	20012	57.49%	18.34%	22	23
15	宜蘭縣壯圍鄉	2018-11-24T22:26:47+08:00	3671	6776	10447	1058	11505	20012	57.49%	18.34%	22	23
15	宜蘭縣壯圍鄉	2018-11-25T00:05:17+08:00	3935	7302	11237	1133	12370	21447	57.68%	18.35%	23	23
15	宜蘭縣壯圍鄉	2018-11-25T01:12:57+08:00	3935	7302	11237	1133	12370	21447	57.68%	18.35%	23	23
15	宜蘭縣壯圍鄉	2018-11-25T00:09:49+08:00	3935	7302	11237	1133	12370	21447	57.68%	18.35%	23	23
15	宜蘭縣壯圍鄉	2018-11-24T22:19:48+08:00	3671	6776	10447	1058	11505	20012	57.49%	18.34%	22	23
15	宜蘭縣壯圍鄉	2018-11-25T04:03:04+08:00	3935	7302	11237	1133	12370	21447	57.68%	18.35%	23	23
15	宜蘭縣壯圍鄉	2018-11-24T22:40:39+08:00	3671	6776	10447	1058	11505	20012	57.49%	18.34%	22	23
15	宜蘭縣壯圍鄉	2018-11-25T03:32:51+08:00	3935	7302	11237	1133	12370	21447	57.68%	18.35%	23	23
15	宜蘭縣壯圍鄉	2018-11-24T23:08:50+08:00	3935	7302	11237	1133	12370	21447	57.68%	18.35%	23	23
15	宜蘭縣壯圍鄉	2018-11-24T22:23:27+08:00	3671	6776	10447	1058	11505	20012	57.49%	18.34%	22	23
15	宜蘭縣壯圍鄉	2018-11-24T22:51:02+08:00	3671	6776	10447	1058	11505	20012	57.49%	18.34%	22	23
15	宜蘭縣壯圍鄉	2018-11-25T06:14:04+08:00	3935	7302	11237	1133	12370	21447	57.68%	18.35%	23	23
15	宜蘭縣壯圍鄉	2018-11-24T23:55:59+08:00	3935	7302	11237	1133	12370	21447	57.68%	18.35%	23	23
15	宜蘭縣壯圍鄉	2018-11-25T06:24:12+08:00	3935	7302	11237	1133	12370	21447	57.68%	18.35%	23	23
15	宜蘭縣壯圍鄉	2018-11-24T23:27:29+08:00	3935	7302	11237	1133	12370	21447	57.68%	18.35%	23	23
15	宜蘭縣壯圍鄉	2018-11-25T00:00:22+08:00	3935	7302	11237	1133	12370	21447	57.68%	18.35%	23	23
15	宜蘭縣壯圍鄉	2018-11-25T00:23:16+08:00	3935	7302	11237	1133	12370	21447	57.68%	18.35%	23	23
15	宜蘭縣壯圍鄉	2018-11-25T01:02:43+08:00	3935	7302	11237	1133	12370	21447	57.68%	18.35%	23	23
15	宜蘭縣壯圍鄉	2018-11-25T06:29:30+08:00	3935	7302	11237	1133	12370	21447	57.68%	18.35%	23	23
15	宜蘭縣壯圍鄉	2018-11-24T23:12:29+08:00	3935	7302	11237	1133	12370	21447	57.68%	18.35%	23	23
15	宜蘭縣壯圍鄉	2018-11-24T23:31:25+08:00	3935	7302	11237	1133	12370	21447	57.68%	18.35%	23	23
15	宜蘭縣壯圍鄉	2018-11-24T23:20:04+08:00	3935	7302	11237	1133	12370	21447	57.68%	18.35%	23	23
15	宜蘭縣壯圍鄉	2018-11-25T00:14:22+08:00	3935	7302	11237	1133	12370	21447	57.68%	18.35%	23	23
15	宜蘭縣壯圍鄉	2018-11-25T00:18:45+08:00	3935	7302	11237	1133	12370	21447	57.68%	18.35%	23	23
15	宜蘭縣壯圍鄉	2018-11-25T01:07:38+08:00	3935	7302	11237	1133	12370	21447	57.68%	18.35%	23	23
15	宜蘭縣壯圍鄉	2018-11-25T03:39:06+08:00	3935	7302	11237	1133	12370	21447	57.68%	18.35%	23	23
15	宜蘭縣壯圍鄉	2018-11-25T01:26:06+08:00	3935	7302	11237	1133	12370	21447	57.68%	18.35%	23	23
15	宜蘭縣壯圍鄉	2018-11-25T03:50:02+08:00	3935	7302	11237	1133	12370	21447	57.68%	18.35%	23	23
15	新北市板橋區	2018-11-25T06:29:19+08:00	89876	156175	246051	16356	262407	463411	56.63%	19.39%	338	338
15	新北市板橋區	2018-11-25T01:07:28+08:00	89876	156175	246051	16356	262407	463411	56.63%	19.39%	338	338
15	新北市板橋區	2018-11-25T06:13:55+08:00	89876	156175	246051	16356	262407	463411	56.63%	19.39%	338	338
15	新北市板橋區	2018-11-24T22:50:51+08:00	78426	136270	214696	14240	228936	401891	56.96%	19.51%	300	338
15	新北市板橋區	2018-11-25T03:49:53+08:00	89876	156175	246051	16356	262407	463411	56.63%	19.39%	338	338
15	新北市板橋區	2018-11-24T23:43:19+08:00	86714	150578	237292	15809	253101	445451	56.82%	19.47%	328	338
15	新北市板橋區	2018-11-24T23:08:39+08:00	80942	140853	221795	14703	236498	415206	56.96%	19.49%	309	338
15	新北市板橋區	2018-11-25T00:23:06+08:00	89145	155043	244188	16278	260466	459984	56.63%	19.38%	336	338
15	新北市板橋區	2018-11-24T22:30:12+08:00	71990	125042	197032	13152	210184	367959	57.12%	19.56%	279	338
15	新北市板橋區	2018-11-24T23:55:49+08:00	88023	152977	241000	16024	257024	453851	56.63%	19.39%	332	338
15	新北市板橋區	2018-11-25T03:32:37+08:00	89876	156175	246051	16356	262407	463411	56.63%	19.39%	338	338
15	新北市板橋區	2018-11-25T06:24:02+08:00	89876	156175	246051	16356	262407	463411	56.63%	19.39%	338	338
15	新北市板橋區	2018-11-24T23:51:37+08:00	87009	151152	238161	15893	254054	447251	56.8%	19.45%	329	338
15	新北市板橋區	2018-11-24T22:57:57+08:00	79882	138952	218834	14560	233394	409623	56.98%	19.5%	305	338
15	新北市板橋區	2018-11-25T06:18:59+08:00	89876	156175	246051	16356	262407	463411	56.63%	19.39%	338	338
15	新北市板橋區	2018-11-24T23:23:40+08:00	83792	145548	229340	15169	244509	429875	56.88%	19.49%	318	338
15	新北市板橋區	2018-11-24T22:33:40+08:00	74668	129522	204190	13550	217740	381710	57.04%	19.56%	287	338
15	新北市板橋區	2018-11-24T22:16:13+08:00	66388	115414	181802	11968	193770	338360	57.27%	19.62%	259	338
15	新北市板橋區	2018-11-24T23:05:07+08:00	80066	139283	219349	14587	233936	410553	56.98%	19.5%	306	338
15	新北市板橋區	2018-11-24T22:41:38+08:00	76321	132574	208895	13939	222834	390747	57.03%	19.53%	293	338
15	新北市板橋區	2018-11-24T22:54:28+08:00	79225	137751	216976	14448	231424	406215	56.97%	19.5%	303	338
15	新北市板橋區	2018-11-25T01:12:46+08:00	89876	156175	246051	16356	262407	463411	56.63%	19.39%	338	338
15	新北市板橋區	2018-11-25T06:08:56+08:00	89876	156175	246051	16356	262407	463411	56.63%	19.39%	338	338
15	新北市板橋區	2018-11-25T00:05:07+08:00	89145	155043	244188	16278	260466	459984	56.63%	19.38%	336	338
15	新北市板橋區	2018-11-25T00:18:33+08:00	89145	155043	244188	16278	260466	459984	56.63%	19.38%	336	338
15	新北市板橋區	2018-11-24T22:37:03+08:00	75283	130719	206002	13676	219678	385158	57.04%	19.55%	289	338
15	新北市板橋區	2018-11-24T23:16:05+08:00	82303	143062	225365	14871	240236	421906	56.94%	19.51%	313	338
15	新北市板橋區	2018-11-24T22:45:11+08:00	77135	134235	211370	14060	225430	395522	57%	19.5%	296	338
15	新北市板橋區	2018-11-25T03:56:15+08:00	89876	156175	246051	16356	262407	463411	56.63%	19.39%	338	338
15	新北市板橋區	2018-11-25T03:38:57+08:00	89876	156175	246051	16356	262407	463411	56.63%	19.39%	338	338
15	新北市板橋區	2018-11-25T03:44:26+08:00	89876	156175	246051	16356	262407	463411	56.63%	19.39%	338	338
15	新北市板橋區	2018-11-25T01:02:33+08:00	89876	156175	246051	16356	262407	463411	56.63%	19.39%	338	338
15	新北市板橋區	2018-11-24T22:40:30+08:00	76321	132574	208895	13939	222834	390747	57.03%	19.53%	293	338
15	新北市板橋區	2018-11-25T01:25:55+08:00	89876	156175	246051	16356	262407	463411	56.63%	19.39%	338	338
15	新北市板橋區	2018-11-24T22:23:16+08:00	68894	119824	188718	12465	201183	351871	57.18%	19.58%	268	338
15	新北市板橋區	2018-11-24T23:19:54+08:00	83399	144871	228270	15102	243372	427785	56.89%	19.5%	317	338
15	新北市板橋區	2018-11-25T00:57:39+08:00	89876	156175	246051	16356	262407	463411	56.63%	19.39%	338	338
15	新北市板橋區	2018-11-24T23:27:21+08:00	84084	146004	230088	15226	245314	431406	56.86%	19.49%	319	338
15	新北市板橋區	2018-11-25T01:17:55+08:00	89876	156175	246051	16356	262407	463411	56.63%	19.39%	338	338
15	新北市板橋區	2018-11-24T22:19:39+08:00	68314	118972	187286	12388	199674	349022	57.21%	19.57%	266	338
15	新北市板橋區	2018-11-24T22:13:30+08:00	64826	112561	177387	11639	189026	330204	57.25%	19.63%	254	338
15	新北市板橋區	2018-11-25T00:00:13+08:00	88834	154397	243231	16213	259444	458223	56.62%	19.39%	335	338
15	新北市板橋區	2018-11-25T00:14:12+08:00	89145	155043	244188	16278	260466	459984	56.63%	19.38%	336	338
15	新北市板橋區	2018-11-25T04:02:55+08:00	89876	156175	246051	16356	262407	463411	56.63%	19.39%	338	338
15	新北市板橋區	2018-11-24T23:39:19+08:00	86126	149598	235724	15648	251372	442199	56.85%	19.48%	326	338
15	新北市板橋區	2018-11-24T22:26:39+08:00	70682	122596	193278	12822	206100	360836	57.12%	19.59%	274	338
15	新北市板橋區	2018-11-24T23:12:18+08:00	81583	141862	223445	14806	238251	418516	56.93%	19.49%	311	338
15	新北市板橋區	2018-11-24T23:31:14+08:00	84999	147536	232535	15340	247875	436127	56.84%	19.49%	322	338
15	新北市板橋區	2018-11-24T23:01:33+08:00	80066	139283	219349	14587	233936	410553	56.98%	19.5%	306	338
15	新北市板橋區	2018-11-24T23:47:31+08:00	86714	150578	237292	15809	253101	445451	56.82%	19.47%	328	338
15	新北市板橋區	2018-11-24T23:35:13+08:00	85595	148608	234203	15476	249679	439305	56.84%	19.48%	324	338
15	新北市板橋區	2018-11-25T00:09:37+08:00	89145	155043	244188	16278	260466	459984	56.63%	19.38%	336	338
15	連江縣東引鄉	2018-11-24T23:12:31+08:00	165	397	562	15	577	1138	50.7%	14.5%	1	1
15	連江縣東引鄉	2018-11-24T23:47:44+08:00	165	397	562	15	577	1138	50.7%	14.5%	1	1
15	連江縣東引鄉	2018-11-24T22:58:09+08:00	165	397	562	15	577	1138	50.7%	14.5%	1	1
15	連江縣東引鄉	2018-11-24T23:56:01+08:00	165	397	562	15	577	1138	50.7%	14.5%	1	1
15	連江縣東引鄉	2018-11-25T03:56:29+08:00	165	397	562	15	577	1138	50.7%	14.5%	1	1
15	連江縣東引鄉	2018-11-24T23:01:46+08:00	165	397	562	15	577	1138	50.7%	14.5%	1	1
15	連江縣東引鄉	2018-11-25T03:32:53+08:00	165	397	562	15	577	1138	50.7%	14.5%	1	1
15	連江縣東引鄉	2018-11-24T23:08:52+08:00	165	397	562	15	577	1138	50.7%	14.5%	1	1
15	連江縣東引鄉	2018-11-24T23:51:49+08:00	165	397	562	15	577	1138	50.7%	14.5%	1	1
15	連江縣東引鄉	2018-11-24T22:13:45+08:00	0	0	0	0	0	0	0%	0%	0	1
15	連江縣東引鄉	2018-11-25T03:44:41+08:00	165	397	562	15	577	1138	50.7%	14.5%	1	1
15	連江縣東引鄉	2018-11-25T04:03:06+08:00	165	397	562	15	577	1138	50.7%	14.5%	1	1
15	連江縣東引鄉	2018-11-24T23:27:31+08:00	165	397	562	15	577	1138	50.7%	14.5%	1	1
15	連江縣東引鄉	2018-11-24T22:30:24+08:00	0	0	0	0	0	0	0%	0%	0	1
15	連江縣東引鄉	2018-11-24T22:19:50+08:00	0	0	0	0	0	0	0%	0%	0	1
15	連江縣東引鄉	2018-11-25T06:14:06+08:00	165	397	562	15	577	1138	50.7%	14.5%	1	1
15	連江縣東引鄉	2018-11-24T23:20:09+08:00	165	397	562	15	577	1138	50.7%	14.5%	1	1
15	連江縣東引鄉	2018-11-24T23:31:28+08:00	165	397	562	15	577	1138	50.7%	14.5%	1	1
15	連江縣東引鄉	2018-11-24T22:37:14+08:00	0	0	0	0	0	0	0%	0%	0	1
15	連江縣東引鄉	2018-11-25T00:18:48+08:00	165	397	562	15	577	1138	50.7%	14.5%	1	1
15	連江縣東引鄉	2018-11-25T06:29:32+08:00	165	397	562	15	577	1138	50.7%	14.5%	1	1
15	連江縣東引鄉	2018-11-25T00:09:51+08:00	165	397	562	15	577	1138	50.7%	14.5%	1	1
15	連江縣東引鄉	2018-11-24T22:45:21+08:00	165	397	562	15	577	1138	50.7%	14.5%	1	1
15	連江縣東引鄉	2018-11-24T22:54:38+08:00	165	397	562	15	577	1138	50.7%	14.5%	1	1
15	連江縣東引鄉	2018-11-24T22:33:51+08:00	0	0	0	0	0	0	0%	0%	0	1
15	連江縣東引鄉	2018-11-24T23:39:33+08:00	165	397	562	15	577	1138	50.7%	14.5%	1	1
15	連江縣東引鄉	2018-11-24T22:26:49+08:00	0	0	0	0	0	0	0%	0%	0	1
15	連江縣東引鄉	2018-11-25T01:12:59+08:00	165	397	562	15	577	1138	50.7%	14.5%	1	1
15	連江縣東引鄉	2018-11-25T00:05:18+08:00	165	397	562	15	577	1138	50.7%	14.5%	1	1
15	連江縣東引鄉	2018-11-25T01:07:41+08:00	165	397	562	15	577	1138	50.7%	14.5%	1	1
15	連江縣東引鄉	2018-11-24T23:05:17+08:00	165	397	562	15	577	1138	50.7%	14.5%	1	1
15	連江縣東引鄉	2018-11-24T23:23:51+08:00	165	397	562	15	577	1138	50.7%	14.5%	1	1
15	連江縣東引鄉	2018-11-24T22:23:29+08:00	0	0	0	0	0	0	0%	0%	0	1
15	連江縣東引鄉	2018-11-25T00:00:24+08:00	165	397	562	15	577	1138	50.7%	14.5%	1	1
15	連江縣東引鄉	2018-11-25T01:02:45+08:00	165	397	562	15	577	1138	50.7%	14.5%	1	1
15	連江縣東引鄉	2018-11-24T22:40:41+08:00	0	0	0	0	0	0	0%	0%	0	1
15	連江縣東引鄉	2018-11-25T00:57:52+08:00	165	397	562	15	577	1138	50.7%	14.5%	1	1
15	連江縣東引鄉	2018-11-24T22:51:04+08:00	165	397	562	15	577	1138	50.7%	14.5%	1	1
15	連江縣東引鄉	2018-11-25T06:09:10+08:00	165	397	562	15	577	1138	50.7%	14.5%	1	1
15	連江縣東引鄉	2018-11-25T06:24:14+08:00	165	397	562	15	577	1138	50.7%	14.5%	1	1
15	連江縣東引鄉	2018-11-25T00:23:18+08:00	165	397	562	15	577	1138	50.7%	14.5%	1	1
15	連江縣東引鄉	2018-11-24T23:35:23+08:00	165	397	562	15	577	1138	50.7%	14.5%	1	1
15	連江縣東引鄉	2018-11-25T00:14:24+08:00	165	397	562	15	577	1138	50.7%	14.5%	1	1
15	連江縣東引鄉	2018-11-25T03:50:04+08:00	165	397	562	15	577	1138	50.7%	14.5%	1	1
15	連江縣東引鄉	2018-11-24T22:16:26+08:00	0	0	0	0	0	0	0%	0%	0	1
15	連江縣東引鄉	2018-11-24T23:43:31+08:00	165	397	562	15	577	1138	50.7%	14.5%	1	1
15	連江縣東引鄉	2018-11-25T01:18:11+08:00	165	397	562	15	577	1138	50.7%	14.5%	1	1
15	連江縣東引鄉	2018-11-24T23:16:16+08:00	165	397	562	15	577	1138	50.7%	14.5%	1	1
15	連江縣東引鄉	2018-11-25T06:19:11+08:00	165	397	562	15	577	1138	50.7%	14.5%	1	1
15	連江縣東引鄉	2018-11-24T22:41:51+08:00	0	0	0	0	0	0	0%	0%	0	1
15	連江縣東引鄉	2018-11-25T03:39:08+08:00	165	397	562	15	577	1138	50.7%	14.5%	1	1
15	連江縣東引鄉	2018-11-25T01:26:08+08:00	165	397	562	15	577	1138	50.7%	14.5%	1	1
15	桃園市八德區	2018-11-24T23:16:06+08:00	24110	48937	73047	4189	77236	152876	50.52%	15.77%	94	101
15	桃園市八德區	2018-11-24T23:43:20+08:00	24918	50558	75476	4322	79798	157887	50.54%	15.78%	97	101
15	桃園市八德區	2018-11-25T06:19:00+08:00	26246	52650	78896	4541	83437	165065	50.55%	15.9%	101	101
15	桃園市八德區	2018-11-25T06:29:20+08:00	26246	52650	78896	4541	83437	165065	50.55%	15.9%	101	101
15	桃園市八德區	2018-11-25T03:49:54+08:00	26246	52650	78896	4541	83437	165065	50.55%	15.9%	101	101
15	桃園市八德區	2018-11-25T03:56:16+08:00	26246	52650	78896	4541	83437	165065	50.55%	15.9%	101	101
15	桃園市八德區	2018-11-24T22:30:13+08:00	18357	37214	55571	3288	58859	115685	50.88%	15.87%	74	101
15	桃園市八德區	2018-11-25T06:24:03+08:00	26246	52650	78896	4541	83437	165065	50.55%	15.9%	101	101
15	桃園市八德區	2018-11-25T03:32:38+08:00	26246	52650	78896	4541	83437	165065	50.55%	15.9%	101	101
15	桃園市八德區	2018-11-25T01:25:56+08:00	26246	52650	78896	4541	83437	165065	50.55%	15.9%	101	101
15	桃園市八德區	2018-11-25T00:23:07+08:00	26246	52650	78896	4541	83437	165065	50.55%	15.9%	101	101
15	桃園市八德區	2018-11-24T23:51:39+08:00	25171	51142	76313	4369	80682	159622	50.55%	15.77%	98	101
15	桃園市八德區	2018-11-24T22:13:32+08:00	16029	32377	48406	2893	51299	100506	51.04%	15.95%	66	101
15	桃園市八德區	2018-11-24T23:23:41+08:00	24110	48937	73047	4189	77236	152876	50.52%	15.77%	94	101
15	桃園市八德區	2018-11-25T01:17:57+08:00	26246	52650	78896	4541	83437	165065	50.55%	15.9%	101	101
15	桃園市八德區	2018-11-24T23:08:40+08:00	23478	47665	71143	4097	75240	149171	50.44%	15.74%	92	101
15	桃園市八德區	2018-11-24T22:57:58+08:00	22591	45861	68452	3946	72398	143202	50.56%	15.78%	89	101
15	桃園市八德區	2018-11-25T06:08:57+08:00	26246	52650	78896	4541	83437	165065	50.55%	15.9%	101	101
15	桃園市八德區	2018-11-24T22:54:29+08:00	21596	43855	65451	3813	69264	137158	50.5%	15.75%	86	101
15	桃園市八德區	2018-11-25T01:12:47+08:00	26246	52650	78896	4541	83437	165065	50.55%	15.9%	101	101
15	桃園市八德區	2018-11-24T22:16:14+08:00	16253	32982	49235	2965	52200	102118	51.12%	15.92%	67	101
15	桃園市八德區	2018-11-25T00:05:08+08:00	25440	51624	77064	4419	81483	161100	50.58%	15.79%	99	101
15	桃園市八德區	2018-11-24T23:05:07+08:00	23478	47665	71143	4097	75240	149171	50.44%	15.74%	92	101
15	桃園市八德區	2018-11-25T04:02:56+08:00	26246	52650	78896	4541	83437	165065	50.55%	15.9%	101	101
15	桃園市八德區	2018-11-24T22:33:41+08:00	19451	39537	58988	3452	62440	123084	50.73%	15.8%	78	101
15	桃園市八德區	2018-11-24T23:47:32+08:00	25171	51142	76313	4369	80682	159622	50.55%	15.77%	98	101
15	桃園市八德區	2018-11-24T22:41:39+08:00	20360	41257	61617	3598	65215	128438	50.78%	15.85%	81	101
15	桃園市八德區	2018-11-24T22:37:04+08:00	19743	40008	59751	3500	63251	124589	50.77%	15.85%	79	101
15	桃園市八德區	2018-11-24T22:50:52+08:00	21106	42868	63974	3711	67685	133992	50.51%	15.75%	84	101
15	桃園市八德區	2018-11-25T06:13:56+08:00	26246	52650	78896	4541	83437	165065	50.55%	15.9%	101	101
15	桃園市八德區	2018-11-24T22:26:40+08:00	17806	36032	53838	3189	57027	111836	50.99%	15.92%	72	101
15	桃園市八德區	2018-11-24T22:45:11+08:00	20659	41900	62559	3632	66191	130699	50.64%	15.81%	82	101
15	桃園市八德區	2018-11-25T00:18:35+08:00	26246	52650	78896	4541	83437	165065	50.55%	15.9%	101	101
15	桃園市八德區	2018-11-24T22:40:31+08:00	20360	41257	61617	3598	65215	128438	50.78%	15.85%	81	101
15	桃園市八德區	2018-11-25T03:44:27+08:00	26246	52650	78896	4541	83437	165065	50.55%	15.9%	101	101
15	桃園市八德區	2018-11-25T00:57:41+08:00	26246	52650	78896	4541	83437	165065	50.55%	15.9%	101	101
15	桃園市八德區	2018-11-24T22:19:40+08:00	16813	34080	50893	3061	53954	105694	51.05%	15.91%	69	101
15	桃園市八德區	2018-11-25T01:02:34+08:00	26246	52650	78896	4541	83437	165065	50.55%	15.9%	101	101
15	桃園市八德區	2018-11-25T03:38:58+08:00	26246	52650	78896	4541	83437	165065	50.55%	15.9%	101	101
15	桃園市八德區	2018-11-24T23:27:21+08:00	24678	49989	74667	4283	78950	156280	50.52%	15.79%	96	101
15	桃園市八德區	2018-11-24T23:55:50+08:00	25171	51142	76313	4369	80682	159622	50.55%	15.77%	98	101
15	桃園市八德區	2018-11-24T22:23:17+08:00	17181	34732	51913	3108	55021	107776	51.05%	15.94%	70	101
15	桃園市八德區	2018-11-24T23:19:55+08:00	24110	48937	73047	4189	77236	152876	50.52%	15.77%	94	101
15	桃園市八德區	2018-11-25T00:00:14+08:00	25171	51142	76313	4369	80682	159622	50.55%	15.77%	98	101
15	桃園市八德區	2018-11-25T01:07:30+08:00	26246	52650	78896	4541	83437	165065	50.55%	15.9%	101	101
15	桃園市八德區	2018-11-25T00:09:38+08:00	26246	52650	78896	4541	83437	165065	50.55%	15.9%	101	101
15	桃園市八德區	2018-11-24T23:35:14+08:00	24678	49989	74667	4283	78950	156280	50.52%	15.79%	96	101
15	桃園市八德區	2018-11-25T00:14:13+08:00	26246	52650	78896	4541	83437	165065	50.55%	15.9%	101	101
15	桃園市八德區	2018-11-24T23:01:35+08:00	22897	46464	69361	3956	73317	145263	50.47%	15.76%	90	101
15	桃園市八德區	2018-11-24T23:12:19+08:00	23797	48313	72110	4153	76263	151012	50.5%	15.76%	93	101
15	桃園市八德區	2018-11-24T23:31:15+08:00	24678	49989	74667	4283	78950	156280	50.52%	15.79%	96	101
15	桃園市八德區	2018-11-24T23:39:20+08:00	24918	50558	75476	4322	79798	157887	50.54%	15.78%	97	101
15	臺北市信義區	2018-11-25T06:29:19+08:00	40135	65500	105635	4827	110462	190444	58%	21.07%	142	142
15	臺北市信義區	2018-11-25T01:07:28+08:00	39514	64549	104063	4758	108821	187741	57.96%	21.05%	140	142
15	臺北市信義區	2018-11-25T06:13:55+08:00	40135	65500	105635	4827	110462	190444	58%	21.07%	142	142
15	臺北市信義區	2018-11-24T22:50:51+08:00	25360	40670	66030	2927	68957	116892	58.99%	21.7%	91	142
15	臺北市信義區	2018-11-25T06:19:00+08:00	40135	65500	105635	4827	110462	190444	58%	21.07%	142	142
15	臺北市信義區	2018-11-25T03:49:53+08:00	40135	65500	105635	4827	110462	190444	58%	21.07%	142	142
15	臺北市信義區	2018-11-24T22:50:50+08:00	25360	40670	66030	2927	68957	116892	58.99%	21.7%	91	142
15	臺北市信義區	2018-11-25T06:13:54+08:00	40135	65500	105635	4827	110462	190444	58%	21.07%	142	142
15	臺北市信義區	2018-11-24T23:43:19+08:00	33698	54739	88437	4109	92546	159267	58.11%	21.16%	120	142
15	臺北市信義區	2018-11-24T22:13:29+08:00	18986	30711	49697	2111	51808	87259	59.37%	21.76%	69	142
15	臺北市信義區	2018-11-25T06:24:03+08:00	40135	65500	105635	4827	110462	190444	58%	21.07%	142	142
15	臺北市信義區	2018-11-25T03:32:36+08:00	40135	65500	105635	4827	110462	190444	58%	21.07%	142	142
15	臺北市信義區	2018-11-24T23:08:39+08:00	28487	45934	74421	3363	77784	132485	58.71%	21.5%	102	142
15	臺北市信義區	2018-11-25T00:23:06+08:00	37295	60592	97887	4478	102365	176414	58.03%	21.14%	132	142
15	臺北市信義區	2018-11-24T22:30:12+08:00	21631	35050	56681	2432	59113	99957	59.14%	21.64%	78	142
15	臺北市信義區	2018-11-24T23:08:38+08:00	28487	45934	74421	3363	77784	132485	58.71%	21.5%	102	142
15	臺北市信義區	2018-11-24T23:55:49+08:00	34782	56537	91319	4208	95527	164570	58.05%	21.14%	124	142
15	臺北市信義區	2018-11-25T03:32:37+08:00	40135	65500	105635	4827	110462	190444	58%	21.07%	142	142
15	臺北市信義區	2018-11-25T06:24:02+08:00	40135	65500	105635	4827	110462	190444	58%	21.07%	142	142
15	臺北市信義區	2018-11-24T23:51:37+08:00	34009	55267	89276	4134	93410	160805	58.09%	21.15%	121	142
15	臺北市信義區	2018-11-24T23:23:41+08:00	30392	49352	79744	3643	83387	143652	58.05%	21.16%	109	142
15	臺北市信義區	2018-11-24T22:23:15+08:00	20162	32511	52673	2253	54926	92856	59.15%	21.71%	73	142
15	臺北市信義區	2018-11-24T22:40:29+08:00	23668	37981	61649	2719	64368	108921	59.1%	21.73%	85	142
15	臺北市信義區	2018-11-24T22:57:57+08:00	26875	43445	70320	3161	73481	124829	58.87%	21.53%	96	142
15	臺北市信義區	2018-11-25T06:18:59+08:00	40135	65500	105635	4827	110462	190444	58%	21.07%	142	142
15	臺北市信義區	2018-11-24T22:57:56+08:00	26875	43445	70320	3161	73481	124829	58.87%	21.53%	96	142
15	臺北市信義區	2018-11-25T01:17:56+08:00	40135	65500	105635	4827	110462	190444	58%	21.07%	142	142
15	臺北市信義區	2018-11-24T23:23:40+08:00	30392	49352	79744	3643	83387	143652	58.05%	21.16%	109	142
15	臺北市信義區	2018-11-24T22:33:40+08:00	23115	36951	60066	2630	62696	106152	59.06%	21.78%	83	142
15	臺北市信義區	2018-11-24T22:54:27+08:00	25360	40670	66030	2927	68957	116892	58.99%	21.7%	91	142
15	臺北市信義區	2018-11-24T22:16:13+08:00	19273	31227	50500	2152	52652	88709	59.35%	21.73%	70	142
15	臺北市信義區	2018-11-25T00:14:11+08:00	36924	60001	96925	4442	101367	174683	58.03%	21.14%	131	142
15	臺北市信義區	2018-11-24T23:05:07+08:00	28002	45239	73241	3298	76539	130208	58.78%	21.51%	100	142
15	臺北市信義區	2018-11-24T22:41:38+08:00	23668	37981	61649	2719	64368	108921	59.1%	21.73%	85	142
15	臺北市信義區	2018-11-24T22:54:28+08:00	25360	40670	66030	2927	68957	116892	58.99%	21.7%	91	142
15	臺北市信義區	2018-11-25T01:12:46+08:00	40135	65500	105635	4827	110462	190444	58%	21.07%	142	142
15	臺北市信義區	2018-11-25T06:08:56+08:00	40135	65500	105635	4827	110462	190444	58%	21.07%	142	142
15	臺北市信義區	2018-11-24T22:41:37+08:00	23668	37981	61649	2719	64368	108921	59.1%	21.73%	85	142
15	臺北市信義區	2018-11-25T00:05:07+08:00	35686	57978	93664	4339	98003	168732	58.08%	21.15%	127	142
15	臺北市信義區	2018-11-24T23:05:06+08:00	28002	45239	73241	3298	76539	130208	58.78%	21.51%	100	142
15	臺北市信義區	2018-11-25T00:18:33+08:00	37295	60592	97887	4478	102365	176414	58.03%	21.14%	132	142
15	臺北市信義區	2018-11-24T22:37:03+08:00	23668	37981	61649	2719	64368	108921	59.1%	21.73%	85	142
15	臺北市信義區	2018-11-24T22:45:10+08:00	23953	38395	62348	2759	65107	110232	59.06%	21.73%	86	142
15	臺北市信義區	2018-11-24T23:16:05+08:00	29154	46931	76085	3431	79516	135466	58.7%	21.52%	104	142
15	臺北市信義區	2018-11-24T22:45:11+08:00	23953	38395	62348	2759	65107	110232	59.06%	21.73%	86	142
15	臺北市信義區	2018-11-24T22:37:02+08:00	23668	37981	61649	2719	64368	108921	59.1%	21.73%	85	142
15	臺北市信義區	2018-11-25T03:56:15+08:00	40135	65500	105635	4827	110462	190444	58%	21.07%	142	142
15	臺北市信義區	2018-11-25T03:38:57+08:00	40135	65500	105635	4827	110462	190444	58%	21.07%	142	142
15	臺北市信義區	2018-11-25T03:44:26+08:00	40135	65500	105635	4827	110462	190444	58%	21.07%	142	142
15	臺北市信義區	2018-11-24T22:30:11+08:00	21631	35050	56681	2432	59113	99957	59.14%	21.64%	78	142
15	臺北市信義區	2018-11-25T01:02:33+08:00	39514	64549	104063	4758	108821	187741	57.96%	21.05%	140	142
15	臺北市信義區	2018-11-24T22:40:30+08:00	23668	37981	61649	2719	64368	108921	59.1%	21.73%	85	142
15	臺北市信義區	2018-11-25T01:25:55+08:00	40135	65500	105635	4827	110462	190444	58%	21.07%	142	142
15	臺北市信義區	2018-11-24T22:23:16+08:00	20162	32511	52673	2253	54926	92856	59.15%	21.71%	73	142
15	臺北市信義區	2018-11-24T23:19:54+08:00	29710	47805	77515	3476	80991	139162	58.2%	21.35%	106	142
15	臺北市信義區	2018-11-25T00:57:39+08:00	39514	64549	104063	4758	108821	187741	57.96%	21.05%	140	142
15	臺北市信義區	2018-11-24T23:27:21+08:00	31018	50336	81354	3708	85062	146789	57.95%	21.13%	111	142
15	臺北市信義區	2018-11-25T01:17:55+08:00	40135	65500	105635	4827	110462	190444	58%	21.07%	142	142
15	臺北市信義區	2018-11-24T22:19:39+08:00	19599	31704	51303	2179	53482	90284	59.24%	21.71%	71	142
15	臺北市信義區	2018-11-24T23:27:20+08:00	31018	50336	81354	3708	85062	146789	57.95%	21.13%	111	142
15	臺北市信義區	2018-11-24T22:13:30+08:00	18986	30711	49697	2111	51808	87259	59.37%	21.76%	69	142
15	臺北市信義區	2018-11-25T00:00:13+08:00	35080	57025	92105	4229	96334	165975	58.04%	21.14%	125	142
15	臺北市信義區	2018-11-25T00:14:12+08:00	36924	60001	96925	4442	101367	174683	58.03%	21.14%	131	142
15	臺北市信義區	2018-11-24T23:35:12+08:00	31970	51872	83842	3848	87690	151232	57.98%	21.14%	114	142
15	臺北市信義區	2018-11-25T04:02:55+08:00	40135	65500	105635	4827	110462	190444	58%	21.07%	142	142
15	臺北市信義區	2018-11-25T00:09:36+08:00	36582	59444	96026	4422	100448	173026	58.05%	21.14%	130	142
15	臺北市信義區	2018-11-24T23:39:19+08:00	32582	52922	85504	3928	89432	154004	58.07%	21.16%	116	142
15	臺北市信義區	2018-11-24T22:26:39+08:00	20783	33633	54416	2301	56717	95778	59.22%	21.7%	75	142
15	臺北市信義區	2018-11-24T23:12:18+08:00	28808	46357	75165	3388	78553	133845	58.69%	21.52%	103	142
15	臺北市信義區	2018-11-24T23:31:14+08:00	31970	51872	83842	3848	87690	151232	57.98%	21.14%	114	142
15	臺北市信義區	2018-11-24T23:01:33+08:00	27432	44323	71755	3227	74982	127598	58.76%	21.5%	98	142
15	臺北市信義區	2018-11-24T23:47:31+08:00	34009	55267	89276	4134	93410	160805	58.09%	21.15%	121	142
15	臺北市信義區	2018-11-24T23:35:13+08:00	31970	51872	83842	3848	87690	151232	57.98%	21.14%	114	142
15	臺北市信義區	2018-11-25T04:02:54+08:00	40135	65500	105635	4827	110462	190444	58%	21.07%	142	142
15	臺北市信義區	2018-11-25T00:09:37+08:00	36582	59444	96026	4422	100448	173026	58.05%	21.14%	130	142
15	臺北市信義區	2018-11-24T23:39:18+08:00	32582	52922	85504	3928	89432	154004	58.07%	21.16%	116	142
15	臺北市信義區	2018-11-25T06:08:55+08:00	40135	65500	105635	4827	110462	190444	58%	21.07%	142	142
15	臺北市北投區	2018-11-25T06:29:19+08:00	44378	69714	114092	6007	120099	213250	56.32%	20.81%	141	141
15	臺北市北投區	2018-11-24T23:43:20+08:00	22216	34804	57020	3035	60055	106836	56.21%	20.79%	74	141
15	臺北市北投區	2018-11-25T01:07:28+08:00	36998	58072	95070	5064	100134	177171	56.52%	20.88%	119	141
15	臺北市北投區	2018-11-25T06:13:55+08:00	44378	69714	114092	6007	120099	213250	56.32%	20.81%	141	141
15	臺北市北投區	2018-11-24T22:50:51+08:00	12990	19775	32765	1759	34524	61309	56.31%	21.19%	44	141
15	臺北市北投區	2018-11-25T06:19:00+08:00	44378	69714	114092	6007	120099	213250	56.32%	20.81%	141	141
15	臺北市北投區	2018-11-25T03:49:53+08:00	44378	69714	114092	6007	120099	213250	56.32%	20.81%	141	141
15	臺北市北投區	2018-11-25T06:29:20+08:00	44378	69714	114092	6007	120099	213250	56.32%	20.81%	141	141
15	臺北市北投區	2018-11-25T03:49:54+08:00	44378	69714	114092	6007	120099	213250	56.32%	20.81%	141	141
15	臺北市北投區	2018-11-25T01:07:29+08:00	36998	58072	95070	5064	100134	177171	56.52%	20.88%	119	141
15	臺北市北投區	2018-11-24T23:43:19+08:00	22216	34804	57020	3035	60055	106836	56.21%	20.79%	74	141
15	臺北市北投區	2018-11-25T06:24:03+08:00	44378	69714	114092	6007	120099	213250	56.32%	20.81%	141	141
15	臺北市北投區	2018-11-24T23:08:39+08:00	17157	26798	43955	2358	46313	82141	56.38%	20.89%	58	141
15	臺北市北投區	2018-11-25T00:23:06+08:00	30374	47585	77959	4150	82109	145622	56.39%	20.86%	99	141
15	臺北市北投區	2018-11-24T22:30:12+08:00	10022	15235	25257	1411	26668	47810	55.78%	20.96%	35	141
15	臺北市北投區	2018-11-24T23:55:49+08:00	23693	37108	60801	3245	64046	114100	56.13%	20.77%	79	141
15	臺北市北投區	2018-11-25T03:32:37+08:00	44378	69714	114092	6007	120099	213250	56.32%	20.81%	141	141
15	臺北市北投區	2018-11-25T06:24:02+08:00	44378	69714	114092	6007	120099	213250	56.32%	20.81%	141	141
15	臺北市北投區	2018-11-24T23:51:37+08:00	23160	36203	59363	3148	62511	111150	56.24%	20.84%	77	141
15	臺北市北投區	2018-11-24T23:23:41+08:00	19269	30361	49630	2636	52266	92599	56.44%	20.81%	65	141
15	臺北市北投區	2018-11-24T22:57:57+08:00	14521	22324	36845	1937	38782	68826	56.35%	21.1%	49	141
15	臺北市北投區	2018-11-24T23:51:38+08:00	23160	36203	59363	3148	62511	111150	56.24%	20.84%	77	141
15	臺北市北投區	2018-11-25T06:18:59+08:00	44378	69714	114092	6007	120099	213250	56.32%	20.81%	141	141
15	臺北市北投區	2018-11-25T01:17:56+08:00	38089	59607	97696	5181	102877	182327	56.42%	20.89%	122	141
15	臺北市北投區	2018-11-24T23:23:40+08:00	19269	30361	49630	2636	52266	92599	56.44%	20.81%	65	141
15	臺北市北投區	2018-11-24T22:33:40+08:00	11062	16785	27847	1502	29349	52556	55.84%	21.05%	38	141
15	臺北市北投區	2018-11-24T22:16:13+08:00	7534	11873	19407	1133	20540	37108	55.35%	20.3%	28	141
15	臺北市北投區	2018-11-25T01:12:47+08:00	37373	58609	95982	5086	101068	179043	56.45%	20.87%	120	141
15	臺北市北投區	2018-11-24T23:05:07+08:00	15906	24658	40564	2184	42748	75758	56.43%	21%	54	141
15	臺北市北投區	2018-11-24T22:41:38+08:00	11755	17860	29615	1585	31200	55653	56.06%	21.12%	40	141
15	臺北市北投區	2018-11-24T22:54:28+08:00	13290	20342	33632	1787	35419	62806	56.39%	21.16%	45	141
15	臺北市北投區	2018-11-25T01:12:46+08:00	37373	58609	95982	5086	101068	179043	56.45%	20.87%	120	141
15	臺北市北投區	2018-11-25T06:08:56+08:00	44378	69714	114092	6007	120099	213250	56.32%	20.81%	141	141
15	臺北市北投區	2018-11-25T00:05:07+08:00	26537	41195	67732	3629	71361	127185	56.11%	20.86%	87	141
15	臺北市北投區	2018-11-25T00:18:33+08:00	30026	47102	77128	4113	81241	144136	56.36%	20.83%	98	141
15	臺北市北投區	2018-11-24T22:37:03+08:00	11393	17269	28662	1545	30207	54056	55.88%	21.08%	39	141
15	臺北市北投區	2018-11-25T00:18:34+08:00	30026	47102	77128	4113	81241	144136	56.36%	20.83%	98	141
15	臺北市北投區	2018-11-24T23:16:05+08:00	18400	28822	47222	2520	49742	88040	56.5%	20.9%	62	141
15	臺北市北投區	2018-11-24T22:45:11+08:00	12390	18827	31217	1667	32884	58554	56.16%	21.16%	42	141
15	臺北市北投區	2018-11-25T03:56:15+08:00	44378	69714	114092	6007	120099	213250	56.32%	20.81%	141	141
15	臺北市北投區	2018-11-25T00:57:40+08:00	34975	54940	89915	4826	94741	168040	56.38%	20.81%	113	141
15	臺北市北投區	2018-11-25T03:38:57+08:00	44378	69714	114092	6007	120099	213250	56.32%	20.81%	141	141
15	臺北市北投區	2018-11-25T03:44:26+08:00	44378	69714	114092	6007	120099	213250	56.32%	20.81%	141	141
15	臺北市北投區	2018-11-25T01:02:33+08:00	35604	56006	91610	4877	96487	171038	56.41%	20.82%	115	141
15	臺北市北投區	2018-11-24T22:40:30+08:00	11755	17860	29615	1585	31200	55653	56.06%	21.12%	40	141
15	臺北市北投區	2018-11-25T01:25:55+08:00	38089	59607	97696	5181	102877	182327	56.42%	20.89%	122	141
15	臺北市北投區	2018-11-24T22:23:16+08:00	9439	14327	23766	1315	25081	45162	55.54%	20.9%	33	141
15	臺北市北投區	2018-11-24T23:19:54+08:00	18646	29300	47946	2573	50519	89508	56.44%	20.83%	63	141
15	臺北市北投區	2018-11-25T00:57:39+08:00	34975	54940	89915	4826	94741	168040	56.38%	20.81%	113	141
15	臺北市北投區	2018-11-24T23:27:21+08:00	19943	31298	51241	2765	54006	96104	56.2%	20.75%	67	141
15	臺北市北投區	2018-11-25T01:17:55+08:00	38089	59607	97696	5181	102877	182327	56.42%	20.89%	122	141
15	臺北市北投區	2018-11-24T22:19:39+08:00	8241	12918	21159	1183	22342	40427	55.27%	20.38%	30	141
15	臺北市北投區	2018-11-24T23:27:20+08:00	19943	31298	51241	2765	54006	96104	56.2%	20.75%	67	141
15	臺北市北投區	2018-11-24T22:13:30+08:00	7534	11873	19407	1133	20540	37108	55.35%	20.3%	28	141
15	臺北市北投區	2018-11-25T00:00:13+08:00	24432	38176	62608	3346	65954	117576	56.09%	20.78%	81	141
15	臺北市北投區	2018-11-25T00:14:12+08:00	27935	43519	71454	3822	75276	133892	56.22%	20.86%	91	141
15	臺北市北投區	2018-11-25T04:02:55+08:00	44378	69714	114092	6007	120099	213250	56.32%	20.81%	141	141
15	臺北市北投區	2018-11-24T23:39:19+08:00	21866	34326	56192	3003	59195	105380	56.17%	20.75%	73	141
15	臺北市北投區	2018-11-24T22:26:39+08:00	10022	15235	25257	1411	26668	47810	55.78%	20.96%	35	141
15	臺北市北投區	2018-11-24T23:12:18+08:00	17786	27812	45598	2446	48044	85308	56.32%	20.85%	60	141
15	臺北市北投區	2018-11-24T23:31:14+08:00	21265	33459	54724	2918	57642	102575	56.19%	20.73%	71	141
15	臺北市北投區	2018-11-24T23:01:33+08:00	15615	24131	39746	2092	41838	74159	56.42%	21.06%	53	141
15	臺北市北投區	2018-11-24T23:01:34+08:00	15615	24131	39746	2092	41838	74159	56.42%	21.06%	53	141
15	臺北市北投區	2018-11-24T23:47:31+08:00	22589	35289	57878	3055	60933	108510	56.15%	20.82%	75	141
15	臺北市北投區	2018-11-24T23:35:13+08:00	21866	34326	56192	3003	59195	105380	56.17%	20.75%	73	141
15	臺北市北投區	2018-11-25T00:09:37+08:00	27572	42885	70457	3773	74230	132108	56.19%	20.87%	90	141
15	臺中市東勢區	2018-11-25T03:56:17+08:00	6696	16783	23479	1855	25334	43181	58.67%	15.51%	39	39
15	臺中市東勢區	2018-11-25T06:29:21+08:00	6696	16783	23479	1855	25334	43181	58.67%	15.51%	39	39
15	臺中市東勢區	2018-11-25T03:49:55+08:00	6696	16783	23479	1855	25334	43181	58.67%	15.51%	39	39
15	臺中市東勢區	2018-11-25T06:19:01+08:00	6696	16783	23479	1855	25334	43181	58.67%	15.51%	39	39
15	臺中市東勢區	2018-11-24T23:16:07+08:00	6476	16170	22646	1760	24406	41553	58.73%	15.58%	38	39
15	臺中市東勢區	2018-11-24T22:45:12+08:00	6476	16170	22646	1760	24406	41553	58.73%	15.58%	38	39
15	臺中市東勢區	2018-11-24T23:43:21+08:00	6476	16170	22646	1760	24406	41553	58.73%	15.58%	38	39
15	臺中市東勢區	2018-11-24T22:41:40+08:00	6476	16170	22646	1760	24406	41553	58.73%	15.58%	38	39
15	臺中市東勢區	2018-11-25T01:25:57+08:00	6696	16783	23479	1855	25334	43181	58.67%	15.51%	39	39
15	臺中市東勢區	2018-11-24T22:30:14+08:00	6306	15745	22051	1722	23773	40339	58.93%	15.63%	37	39
15	臺中市東勢區	2018-11-25T06:24:04+08:00	6696	16783	23479	1855	25334	43181	58.67%	15.51%	39	39
15	臺中市東勢區	2018-11-25T00:23:07+08:00	6696	16783	23479	1855	25334	43181	58.67%	15.51%	39	39
15	臺中市東勢區	2018-11-25T03:32:39+08:00	6696	16783	23479	1855	25334	43181	58.67%	15.51%	39	39
15	臺中市東勢區	2018-11-24T23:51:39+08:00	6476	16170	22646	1760	24406	41553	58.73%	15.58%	38	39
15	臺中市東勢區	2018-11-24T23:27:22+08:00	6476	16170	22646	1760	24406	41553	58.73%	15.58%	38	39
15	臺中市東勢區	2018-11-24T22:13:32+08:00	6110	15154	21264	1680	22944	38908	58.97%	15.7%	36	39
15	臺中市東勢區	2018-11-25T01:17:57+08:00	6696	16783	23479	1855	25334	43181	58.67%	15.51%	39	39
15	臺中市東勢區	2018-11-24T23:08:41+08:00	6476	16170	22646	1760	24406	41553	58.73%	15.58%	38	39
15	臺中市東勢區	2018-11-24T22:57:58+08:00	6476	16170	22646	1760	24406	41553	58.73%	15.58%	38	39
15	臺中市東勢區	2018-11-24T23:19:56+08:00	6476	16170	22646	1760	24406	41553	58.73%	15.58%	38	39
15	臺中市東勢區	2018-11-24T22:54:29+08:00	6476	16170	22646	1760	24406	41553	58.73%	15.58%	38	39
15	臺中市東勢區	2018-11-24T23:47:33+08:00	6476	16170	22646	1760	24406	41553	58.73%	15.58%	38	39
15	臺中市東勢區	2018-11-25T04:02:56+08:00	6696	16783	23479	1855	25334	43181	58.67%	15.51%	39	39
15	臺中市東勢區	2018-11-25T06:08:58+08:00	6696	16783	23479	1855	25334	43181	58.67%	15.51%	39	39
15	臺中市東勢區	2018-11-24T22:16:15+08:00	6110	15154	21264	1680	22944	38908	58.97%	15.7%	36	39
15	臺中市東勢區	2018-11-24T23:31:16+08:00	6476	16170	22646	1760	24406	41553	58.73%	15.58%	38	39
15	臺中市東勢區	2018-11-25T01:12:48+08:00	6696	16783	23479	1855	25334	43181	58.67%	15.51%	39	39
15	臺中市東勢區	2018-11-24T23:05:08+08:00	6476	16170	22646	1760	24406	41553	58.73%	15.58%	38	39
15	臺中市東勢區	2018-11-25T00:05:09+08:00	6696	16783	23479	1855	25334	43181	58.67%	15.51%	39	39
15	臺中市東勢區	2018-11-24T22:37:04+08:00	6476	16170	22646	1760	24406	41553	58.73%	15.58%	38	39
15	臺中市東勢區	2018-11-24T22:50:52+08:00	6476	16170	22646	1760	24406	41553	58.73%	15.58%	38	39
15	臺中市東勢區	2018-11-25T06:13:56+08:00	6696	16783	23479	1855	25334	43181	58.67%	15.51%	39	39
15	臺中市東勢區	2018-11-24T22:26:40+08:00	6306	15745	22051	1722	23773	40339	58.93%	15.63%	37	39
15	臺中市東勢區	2018-11-25T00:18:35+08:00	6696	16783	23479	1855	25334	43181	58.67%	15.51%	39	39
15	臺中市東勢區	2018-11-24T22:19:41+08:00	6306	15745	22051	1722	23773	40339	58.93%	15.63%	37	39
15	臺中市東勢區	2018-11-25T03:38:59+08:00	6696	16783	23479	1855	25334	43181	58.67%	15.51%	39	39
15	臺中市東勢區	2018-11-24T22:40:31+08:00	6476	16170	22646	1760	24406	41553	58.73%	15.58%	38	39
15	臺中市東勢區	2018-11-25T01:02:35+08:00	6696	16783	23479	1855	25334	43181	58.67%	15.51%	39	39
15	臺中市東勢區	2018-11-25T00:57:41+08:00	6696	16783	23479	1855	25334	43181	58.67%	15.51%	39	39
15	臺中市東勢區	2018-11-25T03:44:28+08:00	6696	16783	23479	1855	25334	43181	58.67%	15.51%	39	39
15	臺中市東勢區	2018-11-24T23:23:42+08:00	6476	16170	22646	1760	24406	41553	58.73%	15.58%	38	39
15	臺中市東勢區	2018-11-24T22:23:18+08:00	6306	15745	22051	1722	23773	40339	58.93%	15.63%	37	39
15	臺中市東勢區	2018-11-25T00:00:15+08:00	6476	16170	22646	1760	24406	41553	58.73%	15.58%	38	39
15	臺中市東勢區	2018-11-24T23:55:51+08:00	6476	16170	22646	1760	24406	41553	58.73%	15.58%	38	39
15	臺中市東勢區	2018-11-24T23:39:21+08:00	6476	16170	22646	1760	24406	41553	58.73%	15.58%	38	39
15	臺中市東勢區	2018-11-25T01:07:30+08:00	6696	16783	23479	1855	25334	43181	58.67%	15.51%	39	39
15	臺中市東勢區	2018-11-24T23:12:20+08:00	6476	16170	22646	1760	24406	41553	58.73%	15.58%	38	39
15	臺中市東勢區	2018-11-24T23:35:14+08:00	6476	16170	22646	1760	24406	41553	58.73%	15.58%	38	39
15	臺中市東勢區	2018-11-25T00:14:14+08:00	6696	16783	23479	1855	25334	43181	58.67%	15.51%	39	39
15	臺中市東勢區	2018-11-24T23:01:35+08:00	6476	16170	22646	1760	24406	41553	58.73%	15.58%	38	39
15	臺中市東勢區	2018-11-25T00:09:39+08:00	6696	16783	23479	1855	25334	43181	58.67%	15.51%	39	39
15	臺中市東勢區	2018-11-24T22:33:42+08:00	6306	15745	22051	1722	23773	40339	58.93%	15.63%	37	39
15	臺中市	2018-11-25T03:56:17+08:00	411320	850532	1261852	71273	1333125	2295642	58.07%	17.92%	601	1
15	臺中市	2018-11-24T23:16:06+08:00	364137	753272	1117409	63984	1181393	2027229	58.28%	17.96%	443	1
15	臺中市	2018-11-25T06:29:21+08:00	411320	850532	1261852	71273	1333125	2295642	58.07%	17.92%	601	1
15	臺中市	2018-11-25T03:49:55+08:00	411320	850532	1261852	71273	1333125	2295642	58.07%	17.92%	601	1
15	臺中市	2018-11-25T06:19:01+08:00	411320	850532	1261852	71273	1333125	2295642	58.07%	17.92%	601	1
15	臺中市	2018-11-24T23:43:20+08:00	388236	802849	1191085	67879	1258964	2163576	58.19%	17.94%	525	1
15	臺中市	2018-11-24T22:45:12+08:00	323281	668131	991412	57183	1048595	1797032	58.35%	17.99%	300	1
15	臺中市	2018-11-24T22:30:13+08:00	295338	610984	906322	52652	958974	1644024	58.33%	17.96%	200	1
15	臺中市	2018-11-25T06:24:04+08:00	411320	850532	1261852	71273	1333125	2295642	58.07%	17.92%	601	1
15	臺中市	2018-11-25T03:32:38+08:00	411320	850532	1261852	71273	1333125	2295642	58.07%	17.92%	601	1
15	臺中市	2018-11-25T01:25:56+08:00	409722	847385	1257107	71065	1328172	2286569	58.09%	17.92%	596	1
15	臺中市	2018-11-25T00:23:07+08:00	403730	835294	1239024	70153	1309177	2252020	58.13%	17.93%	576	1
15	臺中市	2018-11-24T23:51:39+08:00	391031	808567	1199598	68247	1267845	2178980	58.19%	17.95%	534	1
15	臺中市	2018-11-24T23:27:22+08:00	373468	772296	1145764	65606	1211370	2080193	58.23%	17.95%	474	1
15	臺中市	2018-11-24T22:13:32+08:00	259178	536586	795764	47086	842850	1443933	58.37%	17.95%	074	1
15	臺中市	2018-11-25T01:17:57+08:00	409509	846727	1256236	71050	1327286	2284808	58.09%	17.92%	595	1
15	臺中市	2018-11-24T23:08:40+08:00	356368	736478	1092846	62564	1155410	1982567	58.28%	17.98%	416	1
15	臺中市	2018-11-24T22:57:58+08:00	344572	712052	1056624	60675	1117299	1914787	58.35%	18%	374	1
15	臺中市	2018-11-25T06:08:57+08:00	411320	850532	1261852	71273	1333125	2295642	58.07%	17.92%	601	1
15	臺中市	2018-11-24T22:54:29+08:00	337568	698150	1035718	59576	1095294	1877091	58.35%	17.98%	351	1
15	臺中市	2018-11-24T22:16:14+08:00	265157	548840	813997	48048	862045	1477411	58.35%	17.95%	095	1
15	臺中市	2018-11-25T04:02:56+08:00	411320	850532	1261852	71273	1333125	2295642	58.07%	17.92%	601	1
15	臺中市	2018-11-25T01:12:48+08:00	409509	846727	1256236	71050	1327286	2284808	58.09%	17.92%	595	1
15	臺中市	2018-11-24T22:33:41+08:00	307325	635352	942677	54669	997346	1708711	58.37%	17.99%	242	1
15	臺中市	2018-11-24T23:05:08+08:00	352601	727802	1080403	61914	1142317	1959309	58.3%	18%	401	1
15	臺中市	2018-11-24T23:47:32+08:00	389403	805169	1194572	68062	1262634	2170160	58.18%	17.94%	529	1
15	臺中市	2018-11-24T22:41:39+08:00	317999	657146	975145	56454	1031599	1767367	58.37%	17.99%	281	1
15	臺中市	2018-11-25T00:05:09+08:00	397378	821924	1219302	69224	1288526	2215879	58.15%	17.93%	555	1
15	臺中市	2018-11-24T22:37:04+08:00	312856	646590	959446	55632	1015078	1739675	58.35%	17.98%	262	1
15	臺中市	2018-11-24T22:50:52+08:00	334048	690947	1024995	59001	1083996	1857403	58.36%	17.98%	338	1
15	臺中市	2018-11-25T06:13:56+08:00	411320	850532	1261852	71273	1333125	2295642	58.07%	17.92%	601	1
15	臺中市	2018-11-24T22:26:40+08:00	287093	593660	880753	51524	932277	1597980	58.34%	17.97%	171	1
15	臺中市	2018-11-25T00:18:35+08:00	401370	830429	1231799	69806	1301605	2238579	58.14%	17.93%	568	1
15	臺中市	2018-11-24T22:40:31+08:00	317999	657146	975145	56454	1031599	1767367	58.37%	17.99%	281	1
15	臺中市	2018-11-25T01:02:35+08:00	409238	845883	1255121	71002	1326123	2282657	58.1%	17.93%	594	1
15	臺中市	2018-11-25T00:57:41+08:00	409238	845883	1255121	71002	1326123	2282657	58.1%	17.93%	594	1
15	臺中市	2018-11-24T22:19:40+08:00	271091	561285	832376	49116	881492	1511001	58.34%	17.94%	116	1
15	臺中市	2018-11-25T03:38:58+08:00	411320	850532	1261852	71273	1333125	2295642	58.07%	17.92%	601	1
15	臺中市	2018-11-25T03:44:28+08:00	411320	850532	1261852	71273	1333125	2295642	58.07%	17.92%	601	1
15	臺中市	2018-11-24T23:23:42+08:00	371352	768012	1139364	65331	1204695	2068711	58.23%	17.95%	467	1
15	臺中市	2018-11-24T23:55:50+08:00	391889	810398	1202287	68368	1270655	2184001	58.18%	17.94%	537	1
15	臺中市	2018-11-24T22:23:17+08:00	279479	578635	858114	50400	908514	1557107	58.35%	17.95%	145	1
15	臺中市	2018-11-24T23:19:55+08:00	367322	759183	1126505	64557	1191062	2044371	58.26%	17.97%	454	1
15	臺中市	2018-11-25T00:00:14+08:00	393060	812940	1206000	68567	1274567	2191228	58.17%	17.94%	541	1
15	臺中市	2018-11-25T01:07:30+08:00	409238	845883	1255121	71002	1326123	2282657	58.1%	17.93%	594	1
15	臺中市	2018-11-25T00:09:38+08:00	398725	824757	1223482	69388	1292870	2222995	58.16%	17.94%	559	1
15	臺中市	2018-11-24T23:35:14+08:00	381066	788296	1169362	66884	1236246	2124578	58.19%	17.94%	500	1
15	臺中市	2018-11-25T00:14:13+08:00	400463	828451	1228914	69637	1298551	2233119	58.15%	17.93%	565	1
15	臺中市	2018-11-24T23:01:35+08:00	347861	719163	1067024	61171	1128195	1934190	58.33%	17.98%	386	1
15	臺中市	2018-11-24T23:12:19+08:00	358744	741609	1100353	63102	1163455	1996328	58.28%	17.97%	425	1
15	臺中市	2018-11-24T23:31:15+08:00	378843	783790	1162633	66554	1229187	2111889	58.2%	17.94%	492	1
15	臺中市	2018-11-24T23:39:20+08:00	385223	796590	1181813	67496	1249309	2146679	58.2%	17.95%	514	1
15	新竹縣芎林鄉	2018-11-24T22:26:43+08:00	1719	4096	5815	423	6238	10375	60.13%	16.57%	12	19
15	新竹縣芎林鄉	2018-11-25T03:56:21+08:00	2855	6702	9557	645	10202	17293	58.99%	16.51%	19	19
15	新竹縣芎林鄉	2018-11-25T01:12:52+08:00	2855	6702	9557	645	10202	17293	58.99%	16.51%	19	19
15	新竹縣芎林鄉	2018-11-24T22:54:32+08:00	2203	5088	7291	522	7813	12999	60.1%	16.95%	15	19
15	新竹縣芎林鄉	2018-11-24T22:50:56+08:00	2203	5088	7291	522	7813	12999	60.1%	16.95%	15	19
15	新竹縣芎林鄉	2018-11-25T00:09:43+08:00	2855	6702	9557	645	10202	17293	58.99%	16.51%	19	19
15	新竹縣芎林鄉	2018-11-25T00:05:12+08:00	2655	6252	8907	611	9518	15939	59.72%	16.66%	18	19
15	新竹縣芎林鄉	2018-11-24T22:37:08+08:00	1968	4715	6683	470	7153	11921	60%	16.51%	14	19
15	新竹縣芎林鄉	2018-11-24T22:45:15+08:00	1968	4715	6683	470	7153	11921	60%	16.51%	14	19
15	新竹縣芎林鄉	2018-11-25T01:02:38+08:00	2855	6702	9557	645	10202	17293	58.99%	16.51%	19	19
15	新竹縣芎林鄉	2018-11-24T22:40:34+08:00	1968	4715	6683	470	7153	11921	60%	16.51%	14	19
15	新竹縣芎林鄉	2018-11-25T04:03:00+08:00	2855	6702	9557	645	10202	17293	58.99%	16.51%	19	19
15	新竹縣芎林鄉	2018-11-25T00:57:45+08:00	2855	6702	9557	645	10202	17293	58.99%	16.51%	19	19
15	新竹縣芎林鄉	2018-11-24T22:19:44+08:00	1719	4096	5815	423	6238	10375	60.13%	16.57%	12	19
15	新竹縣芎林鄉	2018-11-25T00:00:18+08:00	2655	6252	8907	611	9518	15939	59.72%	16.66%	18	19
15	新竹縣芎林鄉	2018-11-24T23:55:54+08:00	2655	6252	8907	611	9518	15939	59.72%	16.66%	18	19
15	新竹縣芎林鄉	2018-11-24T23:27:25+08:00	2476	5856	8332	586	8918	14845	60.07%	16.68%	17	19
15	新竹縣芎林鄉	2018-11-24T22:23:22+08:00	1719	4096	5815	423	6238	10375	60.13%	16.57%	12	19
15	新竹縣芎林鄉	2018-11-24T23:01:39+08:00	2203	5088	7291	522	7813	12999	60.1%	16.95%	15	19
15	新竹縣芎林鄉	2018-11-24T23:39:25+08:00	2655	6252	8907	611	9518	15939	59.72%	16.66%	18	19
15	新竹縣芎林鄉	2018-11-24T23:20:00+08:00	2299	5353	7652	542	8194	13533	60.55%	16.99%	16	19
15	新竹縣芎林鄉	2018-11-25T01:07:34+08:00	2855	6702	9557	645	10202	17293	58.99%	16.51%	19	19
15	新竹縣芎林鄉	2018-11-24T23:12:24+08:00	2299	5353	7652	542	8194	13533	60.55%	16.99%	16	19
15	新竹縣芎林鄉	2018-11-25T00:18:40+08:00	2855	6702	9557	645	10202	17293	58.99%	16.51%	19	19
15	新竹縣芎林鄉	2018-11-25T03:39:02+08:00	2855	6702	9557	645	10202	17293	58.99%	16.51%	19	19
15	新竹縣芎林鄉	2018-11-24T23:31:20+08:00	2476	5856	8332	586	8918	14845	60.07%	16.68%	17	19
15	新竹縣芎林鄉	2018-11-24T23:35:17+08:00	2655	6252	8907	611	9518	15939	59.72%	16.66%	18	19
15	新竹縣芎林鄉	2018-11-25T00:14:17+08:00	2855	6702	9557	645	10202	17293	58.99%	16.51%	19	19
15	新竹縣芎林鄉	2018-11-24T23:43:24+08:00	2655	6252	8907	611	9518	15939	59.72%	16.66%	18	19
15	新竹縣芎林鄉	2018-11-24T22:58:02+08:00	2203	5088	7291	522	7813	12999	60.1%	16.95%	15	19
15	新竹縣芎林鄉	2018-11-25T03:49:58+08:00	2855	6702	9557	645	10202	17293	58.99%	16.51%	19	19
15	新竹縣芎林鄉	2018-11-25T01:18:02+08:00	2855	6702	9557	645	10202	17293	58.99%	16.51%	19	19
15	新竹縣芎林鄉	2018-11-25T06:29:25+08:00	2855	6702	9557	645	10202	17293	58.99%	16.51%	19	19
15	新竹縣芎林鄉	2018-11-24T23:05:11+08:00	2299	5353	7652	542	8194	13533	60.55%	16.99%	16	19
15	新竹縣芎林鄉	2018-11-25T06:13:59+08:00	2855	6702	9557	645	10202	17293	58.99%	16.51%	19	19
15	新竹縣芎林鄉	2018-11-24T22:41:44+08:00	1968	4715	6683	470	7153	11921	60%	16.51%	14	19
15	新竹縣芎林鄉	2018-11-25T06:19:04+08:00	2855	6702	9557	645	10202	17293	58.99%	16.51%	19	19
15	新竹縣芎林鄉	2018-11-24T22:30:17+08:00	1719	4096	5815	423	6238	10375	60.13%	16.57%	12	19
15	新竹縣芎林鄉	2018-11-25T06:24:08+08:00	2855	6702	9557	645	10202	17293	58.99%	16.51%	19	19
15	新竹縣芎林鄉	2018-11-24T23:51:42+08:00	2655	6252	8907	611	9518	15939	59.72%	16.66%	18	19
15	新竹縣芎林鄉	2018-11-25T06:09:02+08:00	2855	6702	9557	645	10202	17293	58.99%	16.51%	19	19
15	新竹縣芎林鄉	2018-11-24T23:23:45+08:00	2299	5353	7652	542	8194	13533	60.55%	16.99%	16	19
15	新竹縣芎林鄉	2018-11-25T03:44:32+08:00	2855	6702	9557	645	10202	17293	58.99%	16.51%	19	19
15	新竹縣芎林鄉	2018-11-25T03:32:45+08:00	2855	6702	9557	645	10202	17293	58.99%	16.51%	19	19
15	新竹縣芎林鄉	2018-11-24T22:13:38+08:00	1719	4096	5815	423	6238	10375	60.13%	16.57%	12	19
15	新竹縣芎林鄉	2018-11-24T23:08:45+08:00	2299	5353	7652	542	8194	13533	60.55%	16.99%	16	19
15	新竹縣芎林鄉	2018-11-25T00:23:11+08:00	2855	6702	9557	645	10202	17293	58.99%	16.51%	19	19
15	新竹縣芎林鄉	2018-11-24T23:16:10+08:00	2299	5353	7652	542	8194	13533	60.55%	16.99%	16	19
15	新竹縣芎林鄉	2018-11-24T23:47:37+08:00	2655	6252	8907	611	9518	15939	59.72%	16.66%	18	19
15	新竹縣芎林鄉	2018-11-24T22:16:19+08:00	1719	4096	5815	423	6238	10375	60.13%	16.57%	12	19
15	新竹縣芎林鄉	2018-11-25T01:26:00+08:00	2855	6702	9557	645	10202	17293	58.99%	16.51%	19	19
15	新竹縣芎林鄉	2018-11-24T22:33:45+08:00	1894	4560	6454	457	6911	11504	60.07%	16.46%	13	19
15	苗栗縣泰安鄉	2018-11-24T22:26:44+08:00	695	2121	2816	193	3009	4591	65.54%	15.14%	9	10
15	苗栗縣泰安鄉	2018-11-25T00:05:13+08:00	777	2490	3267	199	3466	5180	66.91%	15%	10	10
15	苗栗縣泰安鄉	2018-11-24T23:01:40+08:00	777	2490	3267	199	3466	5180	66.91%	15%	10	10
15	苗栗縣泰安鄉	2018-11-24T23:05:12+08:00	777	2490	3267	199	3466	5180	66.91%	15%	10	10
15	苗栗縣泰安鄉	2018-11-25T06:29:26+08:00	777	2490	3267	199	3466	5180	66.91%	15%	10	10
15	苗栗縣泰安鄉	2018-11-25T00:09:44+08:00	777	2490	3267	199	3466	5180	66.91%	15%	10	10
15	苗栗縣泰安鄉	2018-11-24T22:37:08+08:00	695	2121	2816	193	3009	4591	65.54%	15.14%	9	10
15	苗栗縣泰安鄉	2018-11-24T22:54:33+08:00	695	2121	2816	193	3009	4591	65.54%	15.14%	9	10
15	苗栗縣泰安鄉	2018-11-24T22:50:57+08:00	695	2121	2816	193	3009	4591	65.54%	15.14%	9	10
15	苗栗縣泰安鄉	2018-11-25T01:12:53+08:00	777	2490	3267	199	3466	5180	66.91%	15%	10	10
15	苗栗縣泰安鄉	2018-11-24T22:40:35+08:00	695	2121	2816	193	3009	4591	65.54%	15.14%	9	10
15	苗栗縣泰安鄉	2018-11-24T22:19:45+08:00	695	2121	2816	193	3009	4591	65.54%	15.14%	9	10
15	苗栗縣泰安鄉	2018-11-25T01:02:39+08:00	777	2490	3267	199	3466	5180	66.91%	15%	10	10
15	苗栗縣泰安鄉	2018-11-25T04:03:00+08:00	777	2490	3267	199	3466	5180	66.91%	15%	10	10
15	苗栗縣泰安鄉	2018-11-25T06:14:00+08:00	777	2490	3267	199	3466	5180	66.91%	15%	10	10
15	苗栗縣泰安鄉	2018-11-24T23:23:46+08:00	777	2490	3267	199	3466	5180	66.91%	15%	10	10
15	苗栗縣泰安鄉	2018-11-24T22:23:23+08:00	695	2121	2816	193	3009	4591	65.54%	15.14%	9	10
15	苗栗縣泰安鄉	2018-11-25T03:32:46+08:00	777	2490	3267	199	3466	5180	66.91%	15%	10	10
15	苗栗縣泰安鄉	2018-11-24T23:55:55+08:00	777	2490	3267	199	3466	5180	66.91%	15%	10	10
15	苗栗縣泰安鄉	2018-11-25T00:00:19+08:00	777	2490	3267	199	3466	5180	66.91%	15%	10	10
15	苗栗縣泰安鄉	2018-11-25T00:23:12+08:00	777	2490	3267	199	3466	5180	66.91%	15%	10	10
15	苗栗縣泰安鄉	2018-11-24T23:08:46+08:00	777	2490	3267	199	3466	5180	66.91%	15%	10	10
15	苗栗縣泰安鄉	2018-11-24T23:31:21+08:00	777	2490	3267	199	3466	5180	66.91%	15%	10	10
15	苗栗縣泰安鄉	2018-11-24T23:20:00+08:00	777	2490	3267	199	3466	5180	66.91%	15%	10	10
15	苗栗縣泰安鄉	2018-11-24T23:35:18+08:00	777	2490	3267	199	3466	5180	66.91%	15%	10	10
15	苗栗縣泰安鄉	2018-11-25T00:14:18+08:00	777	2490	3267	199	3466	5180	66.91%	15%	10	10
15	苗栗縣泰安鄉	2018-11-24T23:12:25+08:00	777	2490	3267	199	3466	5180	66.91%	15%	10	10
15	苗栗縣泰安鄉	2018-11-25T03:39:02+08:00	777	2490	3267	199	3466	5180	66.91%	15%	10	10
15	苗栗縣泰安鄉	2018-11-25T01:07:35+08:00	777	2490	3267	199	3466	5180	66.91%	15%	10	10
15	苗栗縣泰安鄉	2018-11-24T22:33:46+08:00	695	2121	2816	193	3009	4591	65.54%	15.14%	9	10
15	苗栗縣泰安鄉	2018-11-25T00:18:41+08:00	777	2490	3267	199	3466	5180	66.91%	15%	10	10
15	苗栗縣泰安鄉	2018-11-24T22:41:45+08:00	695	2121	2816	193	3009	4591	65.54%	15.14%	9	10
15	苗栗縣泰安鄉	2018-11-25T03:56:22+08:00	777	2490	3267	199	3466	5180	66.91%	15%	10	10
15	苗栗縣泰安鄉	2018-11-25T06:19:05+08:00	777	2490	3267	199	3466	5180	66.91%	15%	10	10
15	苗栗縣泰安鄉	2018-11-24T22:45:16+08:00	695	2121	2816	193	3009	4591	65.54%	15.14%	9	10
15	苗栗縣泰安鄉	2018-11-24T23:43:25+08:00	777	2490	3267	199	3466	5180	66.91%	15%	10	10
15	苗栗縣泰安鄉	2018-11-25T01:18:03+08:00	777	2490	3267	199	3466	5180	66.91%	15%	10	10
15	苗栗縣泰安鄉	2018-11-25T03:49:59+08:00	777	2490	3267	199	3466	5180	66.91%	15%	10	10
15	苗栗縣泰安鄉	2018-11-24T22:58:03+08:00	777	2490	3267	199	3466	5180	66.91%	15%	10	10
15	苗栗縣泰安鄉	2018-11-25T06:09:03+08:00	777	2490	3267	199	3466	5180	66.91%	15%	10	10
15	苗栗縣泰安鄉	2018-11-24T23:51:43+08:00	777	2490	3267	199	3466	5180	66.91%	15%	10	10
15	苗栗縣泰安鄉	2018-11-25T06:24:08+08:00	777	2490	3267	199	3466	5180	66.91%	15%	10	10
15	苗栗縣泰安鄉	2018-11-25T00:57:46+08:00	777	2490	3267	199	3466	5180	66.91%	15%	10	10
15	苗栗縣泰安鄉	2018-11-24T22:30:18+08:00	695	2121	2816	193	3009	4591	65.54%	15.14%	9	10
15	苗栗縣泰安鄉	2018-11-24T23:27:26+08:00	777	2490	3267	199	3466	5180	66.91%	15%	10	10
15	苗栗縣泰安鄉	2018-11-24T22:13:39+08:00	695	2121	2816	193	3009	4591	65.54%	15.14%	9	10
15	苗栗縣泰安鄉	2018-11-25T03:44:34+08:00	777	2490	3267	199	3466	5180	66.91%	15%	10	10
15	苗栗縣泰安鄉	2018-11-24T23:39:26+08:00	777	2490	3267	199	3466	5180	66.91%	15%	10	10
15	苗栗縣泰安鄉	2018-11-24T23:16:11+08:00	777	2490	3267	199	3466	5180	66.91%	15%	10	10
15	苗栗縣泰安鄉	2018-11-24T23:47:38+08:00	777	2490	3267	199	3466	5180	66.91%	15%	10	10
15	苗栗縣泰安鄉	2018-11-25T01:26:01+08:00	777	2490	3267	199	3466	5180	66.91%	15%	10	10
15	苗栗縣泰安鄉	2018-11-24T22:16:20+08:00	695	2121	2816	193	3009	4591	65.54%	15.14%	9	10
15	基隆市仁愛區	2018-11-24T23:47:44+08:00	6390	11793	18183	1326	19509	36738	53.1%	17.39%	35	35
15	基隆市仁愛區	2018-11-24T22:58:09+08:00	6390	11793	18183	1326	19509	36738	53.1%	17.39%	35	35
15	基隆市仁愛區	2018-11-25T03:56:29+08:00	6390	11793	18183	1326	19509	36738	53.1%	17.39%	35	35
15	基隆市仁愛區	2018-11-24T23:01:46+08:00	6390	11793	18183	1326	19509	36738	53.1%	17.39%	35	35
15	基隆市仁愛區	2018-11-25T03:32:53+08:00	6390	11793	18183	1326	19509	36738	53.1%	17.39%	35	35
15	基隆市仁愛區	2018-11-24T23:08:52+08:00	6390	11793	18183	1326	19509	36738	53.1%	17.39%	35	35
15	基隆市仁愛區	2018-11-24T23:51:49+08:00	6390	11793	18183	1326	19509	36738	53.1%	17.39%	35	35
15	基隆市仁愛區	2018-11-25T03:44:41+08:00	6390	11793	18183	1326	19509	36738	53.1%	17.39%	35	35
15	基隆市仁愛區	2018-11-25T04:03:06+08:00	6390	11793	18183	1326	19509	36738	53.1%	17.39%	35	35
15	基隆市仁愛區	2018-11-24T23:27:31+08:00	6390	11793	18183	1326	19509	36738	53.1%	17.39%	35	35
15	基隆市仁愛區	2018-11-24T22:30:24+08:00	6390	11793	18183	1326	19509	36738	53.1%	17.39%	35	35
15	基隆市仁愛區	2018-11-24T22:19:51+08:00	6390	11793	18183	1326	19509	36738	53.1%	17.39%	35	35
15	基隆市仁愛區	2018-11-25T06:14:06+08:00	6390	11793	18183	1326	19509	36738	53.1%	17.39%	35	35
15	基隆市仁愛區	2018-11-24T23:20:09+08:00	6390	11793	18183	1326	19509	36738	53.1%	17.39%	35	35
15	基隆市仁愛區	2018-11-24T23:31:28+08:00	6390	11793	18183	1326	19509	36738	53.1%	17.39%	35	35
15	基隆市仁愛區	2018-11-24T22:37:15+08:00	6390	11793	18183	1326	19509	36738	53.1%	17.39%	35	35
15	基隆市仁愛區	2018-11-25T00:18:48+08:00	6390	11793	18183	1326	19509	36738	53.1%	17.39%	35	35
15	基隆市仁愛區	2018-11-25T06:29:32+08:00	6390	11793	18183	1326	19509	36738	53.1%	17.39%	35	35
15	基隆市仁愛區	2018-11-25T00:09:51+08:00	6390	11793	18183	1326	19509	36738	53.1%	17.39%	35	35
15	基隆市仁愛區	2018-11-24T22:45:21+08:00	6390	11793	18183	1326	19509	36738	53.1%	17.39%	35	35
15	基隆市仁愛區	2018-11-24T22:54:38+08:00	6390	11793	18183	1326	19509	36738	53.1%	17.39%	35	35
15	基隆市仁愛區	2018-11-24T23:12:32+08:00	6390	11793	18183	1326	19509	36738	53.1%	17.39%	35	35
15	基隆市仁愛區	2018-11-24T22:33:51+08:00	6390	11793	18183	1326	19509	36738	53.1%	17.39%	35	35
15	基隆市仁愛區	2018-11-24T23:39:33+08:00	6390	11793	18183	1326	19509	36738	53.1%	17.39%	35	35
15	基隆市仁愛區	2018-11-25T00:05:19+08:00	6390	11793	18183	1326	19509	36738	53.1%	17.39%	35	35
15	基隆市仁愛區	2018-11-24T22:26:49+08:00	6390	11793	18183	1326	19509	36738	53.1%	17.39%	35	35
15	基隆市仁愛區	2018-11-25T01:12:59+08:00	6390	11793	18183	1326	19509	36738	53.1%	17.39%	35	35
15	基隆市仁愛區	2018-11-25T01:07:41+08:00	6390	11793	18183	1326	19509	36738	53.1%	17.39%	35	35
15	基隆市仁愛區	2018-11-24T23:05:17+08:00	6390	11793	18183	1326	19509	36738	53.1%	17.39%	35	35
15	基隆市仁愛區	2018-11-24T23:56:02+08:00	6390	11793	18183	1326	19509	36738	53.1%	17.39%	35	35
15	基隆市仁愛區	2018-11-24T22:13:46+08:00	6024	11115	17139	1237	18376	34584	53.13%	17.42%	33	35
15	基隆市仁愛區	2018-11-24T23:23:51+08:00	6390	11793	18183	1326	19509	36738	53.1%	17.39%	35	35
15	基隆市仁愛區	2018-11-24T22:23:29+08:00	6390	11793	18183	1326	19509	36738	53.1%	17.39%	35	35
15	基隆市仁愛區	2018-11-25T01:02:45+08:00	6390	11793	18183	1326	19509	36738	53.1%	17.39%	35	35
15	基隆市仁愛區	2018-11-24T22:40:41+08:00	6390	11793	18183	1326	19509	36738	53.1%	17.39%	35	35
15	基隆市仁愛區	2018-11-25T00:57:52+08:00	6390	11793	18183	1326	19509	36738	53.1%	17.39%	35	35
15	基隆市仁愛區	2018-11-24T22:51:04+08:00	6390	11793	18183	1326	19509	36738	53.1%	17.39%	35	35
15	基隆市仁愛區	2018-11-25T06:09:10+08:00	6390	11793	18183	1326	19509	36738	53.1%	17.39%	35	35
15	基隆市仁愛區	2018-11-25T06:24:14+08:00	6390	11793	18183	1326	19509	36738	53.1%	17.39%	35	35
15	基隆市仁愛區	2018-11-25T00:23:18+08:00	6390	11793	18183	1326	19509	36738	53.1%	17.39%	35	35
15	基隆市仁愛區	2018-11-25T00:00:25+08:00	6390	11793	18183	1326	19509	36738	53.1%	17.39%	35	35
15	基隆市仁愛區	2018-11-24T23:35:23+08:00	6390	11793	18183	1326	19509	36738	53.1%	17.39%	35	35
15	基隆市仁愛區	2018-11-25T00:14:24+08:00	6390	11793	18183	1326	19509	36738	53.1%	17.39%	35	35
15	基隆市仁愛區	2018-11-25T01:26:09+08:00	6390	11793	18183	1326	19509	36738	53.1%	17.39%	35	35
15	基隆市仁愛區	2018-11-25T03:50:04+08:00	6390	11793	18183	1326	19509	36738	53.1%	17.39%	35	35
15	基隆市仁愛區	2018-11-24T22:16:26+08:00	6390	11793	18183	1326	19509	36738	53.1%	17.39%	35	35
15	基隆市仁愛區	2018-11-24T23:43:31+08:00	6390	11793	18183	1326	19509	36738	53.1%	17.39%	35	35
15	基隆市仁愛區	2018-11-25T01:18:11+08:00	6390	11793	18183	1326	19509	36738	53.1%	17.39%	35	35
15	基隆市仁愛區	2018-11-24T23:16:16+08:00	6390	11793	18183	1326	19509	36738	53.1%	17.39%	35	35
15	基隆市仁愛區	2018-11-25T06:19:11+08:00	6390	11793	18183	1326	19509	36738	53.1%	17.39%	35	35
15	基隆市仁愛區	2018-11-24T22:41:51+08:00	6390	11793	18183	1326	19509	36738	53.1%	17.39%	35	35
15	基隆市仁愛區	2018-11-25T03:39:08+08:00	6390	11793	18183	1326	19509	36738	53.1%	17.39%	35	35
15	苗栗縣大湖鄉	2018-11-24T22:26:44+08:00	1898	4329	6227	534	6761	12653	53.43%	15%	15	15
15	苗栗縣大湖鄉	2018-11-25T00:05:13+08:00	1898	4329	6227	534	6761	12653	53.43%	15%	15	15
15	苗栗縣大湖鄉	2018-11-25T00:09:43+08:00	1898	4329	6227	534	6761	12653	53.43%	15%	15	15
15	苗栗縣大湖鄉	2018-11-24T22:37:08+08:00	1898	4329	6227	534	6761	12653	53.43%	15%	15	15
15	苗栗縣大湖鄉	2018-11-24T22:45:15+08:00	1898	4329	6227	534	6761	12653	53.43%	15%	15	15
15	苗栗縣大湖鄉	2018-11-24T22:54:33+08:00	1898	4329	6227	534	6761	12653	53.43%	15%	15	15
15	苗栗縣大湖鄉	2018-11-24T22:50:57+08:00	1898	4329	6227	534	6761	12653	53.43%	15%	15	15
15	苗栗縣大湖鄉	2018-11-25T01:12:53+08:00	1898	4329	6227	534	6761	12653	53.43%	15%	15	15
15	苗栗縣大湖鄉	2018-11-24T22:40:35+08:00	1898	4329	6227	534	6761	12653	53.43%	15%	15	15
15	苗栗縣大湖鄉	2018-11-25T01:02:39+08:00	1898	4329	6227	534	6761	12653	53.43%	15%	15	15
15	苗栗縣大湖鄉	2018-11-25T04:03:00+08:00	1898	4329	6227	534	6761	12653	53.43%	15%	15	15
15	苗栗縣大湖鄉	2018-11-25T00:57:45+08:00	1898	4329	6227	534	6761	12653	53.43%	15%	15	15
15	苗栗縣大湖鄉	2018-11-24T22:19:44+08:00	1898	4329	6227	534	6761	12653	53.43%	15%	15	15
15	苗栗縣大湖鄉	2018-11-25T06:14:00+08:00	1898	4329	6227	534	6761	12653	53.43%	15%	15	15
15	苗栗縣大湖鄉	2018-11-25T00:00:18+08:00	1898	4329	6227	534	6761	12653	53.43%	15%	15	15
15	苗栗縣大湖鄉	2018-11-24T23:23:46+08:00	1898	4329	6227	534	6761	12653	53.43%	15%	15	15
15	苗栗縣大湖鄉	2018-11-24T23:27:25+08:00	1898	4329	6227	534	6761	12653	53.43%	15%	15	15
15	苗栗縣大湖鄉	2018-11-24T23:55:55+08:00	1898	4329	6227	534	6761	12653	53.43%	15%	15	15
15	苗栗縣大湖鄉	2018-11-25T00:23:12+08:00	1898	4329	6227	534	6761	12653	53.43%	15%	15	15
15	苗栗縣大湖鄉	2018-11-24T22:23:22+08:00	1898	4329	6227	534	6761	12653	53.43%	15%	15	15
15	苗栗縣大湖鄉	2018-11-24T23:01:39+08:00	1898	4329	6227	534	6761	12653	53.43%	15%	15	15
15	苗栗縣大湖鄉	2018-11-24T23:20:00+08:00	1898	4329	6227	534	6761	12653	53.43%	15%	15	15
15	苗栗縣大湖鄉	2018-11-25T01:07:34+08:00	1898	4329	6227	534	6761	12653	53.43%	15%	15	15
15	苗栗縣大湖鄉	2018-11-24T23:35:18+08:00	1898	4329	6227	534	6761	12653	53.43%	15%	15	15
15	苗栗縣大湖鄉	2018-11-25T00:18:40+08:00	1898	4329	6227	534	6761	12653	53.43%	15%	15	15
15	苗栗縣大湖鄉	2018-11-25T00:14:18+08:00	1898	4329	6227	534	6761	12653	53.43%	15%	15	15
15	苗栗縣大湖鄉	2018-11-24T23:12:25+08:00	1898	4329	6227	534	6761	12653	53.43%	15%	15	15
15	苗栗縣大湖鄉	2018-11-25T03:39:02+08:00	1898	4329	6227	534	6761	12653	53.43%	15%	15	15
15	苗栗縣大湖鄉	2018-11-24T22:33:46+08:00	1898	4329	6227	534	6761	12653	53.43%	15%	15	15
15	苗栗縣大湖鄉	2018-11-24T23:31:20+08:00	1898	4329	6227	534	6761	12653	53.43%	15%	15	15
15	苗栗縣大湖鄉	2018-11-24T23:43:24+08:00	1898	4329	6227	534	6761	12653	53.43%	15%	15	15
15	苗栗縣大湖鄉	2018-11-24T22:58:02+08:00	1898	4329	6227	534	6761	12653	53.43%	15%	15	15
15	苗栗縣大湖鄉	2018-11-25T03:56:22+08:00	1898	4329	6227	534	6761	12653	53.43%	15%	15	15
15	苗栗縣大湖鄉	2018-11-25T06:29:25+08:00	1898	4329	6227	534	6761	12653	53.43%	15%	15	15
15	苗栗縣大湖鄉	2018-11-25T06:19:05+08:00	1898	4329	6227	534	6761	12653	53.43%	15%	15	15
15	苗栗縣大湖鄉	2018-11-24T23:05:11+08:00	1898	4329	6227	534	6761	12653	53.43%	15%	15	15
15	苗栗縣大湖鄉	2018-11-24T22:41:44+08:00	1898	4329	6227	534	6761	12653	53.43%	15%	15	15
15	苗栗縣大湖鄉	2018-11-25T01:18:03+08:00	1898	4329	6227	534	6761	12653	53.43%	15%	15	15
15	苗栗縣大湖鄉	2018-11-25T03:49:59+08:00	1898	4329	6227	534	6761	12653	53.43%	15%	15	15
15	苗栗縣大湖鄉	2018-11-25T06:09:03+08:00	1898	4329	6227	534	6761	12653	53.43%	15%	15	15
15	苗栗縣大湖鄉	2018-11-24T23:51:43+08:00	1898	4329	6227	534	6761	12653	53.43%	15%	15	15
15	苗栗縣大湖鄉	2018-11-25T06:24:08+08:00	1898	4329	6227	534	6761	12653	53.43%	15%	15	15
15	苗栗縣大湖鄉	2018-11-24T22:30:18+08:00	1898	4329	6227	534	6761	12653	53.43%	15%	15	15
15	苗栗縣大湖鄉	2018-11-25T03:32:45+08:00	1898	4329	6227	534	6761	12653	53.43%	15%	15	15
15	苗栗縣大湖鄉	2018-11-24T22:13:38+08:00	1898	4329	6227	534	6761	12653	53.43%	15%	15	15
15	苗栗縣大湖鄉	2018-11-24T23:08:45+08:00	1898	4329	6227	534	6761	12653	53.43%	15%	15	15
15	苗栗縣大湖鄉	2018-11-25T03:44:33+08:00	1898	4329	6227	534	6761	12653	53.43%	15%	15	15
15	苗栗縣大湖鄉	2018-11-24T23:16:10+08:00	1898	4329	6227	534	6761	12653	53.43%	15%	15	15
15	苗栗縣大湖鄉	2018-11-24T23:47:37+08:00	1898	4329	6227	534	6761	12653	53.43%	15%	15	15
15	苗栗縣大湖鄉	2018-11-24T22:16:19+08:00	1898	4329	6227	534	6761	12653	53.43%	15%	15	15
15	苗栗縣大湖鄉	2018-11-24T23:39:26+08:00	1898	4329	6227	534	6761	12653	53.43%	15%	15	15
15	苗栗縣大湖鄉	2018-11-25T01:26:01+08:00	1898	4329	6227	534	6761	12653	53.43%	15%	15	15
15	雲林縣	2018-11-25T00:05:14+08:00	84799	183303	268102	23312	291414	564521	51.62%	15.02%	544	557
15	雲林縣	2018-11-25T06:19:06+08:00	88127	190434	278561	23887	302448	584480	51.75%	15.08%	557	557
15	雲林縣	2018-11-25T00:09:45+08:00	85381	184614	269995	23455	293450	568154	51.65%	15.03%	547	557
15	雲林縣	2018-11-24T22:50:58+08:00	70928	154447	225375	20463	245838	482314	50.97%	14.71%	485	557
15	雲林縣	2018-11-24T22:41:46+08:00	68181	148690	216871	19801	236672	465569	50.83%	14.64%	471	557
15	雲林縣	2018-11-24T22:37:09+08:00	67212	146618	213830	19508	233338	459069	50.83%	14.64%	466	557
15	雲林縣	2018-11-25T06:29:27+08:00	88127	190434	278561	23887	302448	584480	51.75%	15.08%	557	557
15	雲林縣	2018-11-24T23:05:13+08:00	74894	162843	237737	21440	259177	506755	51.14%	14.78%	502	557
15	雲林縣	2018-11-24T23:01:41+08:00	74517	162002	236519	21343	257862	504019	51.16%	14.78%	500	557
15	雲林縣	2018-11-24T22:26:45+08:00	62627	136660	199287	18285	217572	429326	50.68%	14.59%	443	557
15	雲林縣	2018-11-24T22:54:34+08:00	72977	158912	231889	20944	252833	495251	51.05%	14.74%	494	557
15	雲林縣	2018-11-25T01:12:54+08:00	88127	190434	278561	23887	302448	584480	51.75%	15.08%	557	557
15	雲林縣	2018-11-24T23:43:26+08:00	82932	179369	262301	22958	285259	553294	51.56%	14.99%	534	557
15	雲林縣	2018-11-25T00:00:20+08:00	83884	181307	265191	23160	288351	559007	51.58%	15.01%	539	557
15	雲林縣	2018-11-25T00:23:13+08:00	86680	187543	274223	23715	297938	576380	51.69%	15.04%	552	557
15	雲林縣	2018-11-25T03:44:36+08:00	88127	190434	278561	23887	302448	584480	51.75%	15.08%	557	557
15	雲林縣	2018-11-24T23:08:47+08:00	75440	164013	239453	21494	260947	509599	51.21%	14.8%	504	557
15	雲林縣	2018-11-24T22:23:24+08:00	61520	134374	195894	18057	213951	422182	50.68%	14.57%	437	557
15	雲林縣	2018-11-25T01:02:40+08:00	88127	190434	278561	23887	302448	584480	51.75%	15.08%	557	557
15	雲林縣	2018-11-25T06:14:01+08:00	88127	190434	278561	23887	302448	584480	51.75%	15.08%	557	557
15	雲林縣	2018-11-25T03:32:47+08:00	88127	190434	278561	23887	302448	584480	51.75%	15.08%	557	557
15	雲林縣	2018-11-24T23:23:47+08:00	78901	170897	249798	22218	272016	529577	51.36%	14.9%	518	557
15	雲林縣	2018-11-25T03:50:00+08:00	88127	190434	278561	23887	302448	584480	51.75%	15.08%	557	557
15	雲林縣	2018-11-24T22:33:47+08:00	65975	143822	209797	19226	229023	450633	50.82%	14.64%	460	557
15	雲林縣	2018-11-25T03:39:03+08:00	88127	190434	278561	23887	302448	584480	51.75%	15.08%	557	557
15	雲林縣	2018-11-25T01:26:02+08:00	88127	190434	278561	23887	302448	584480	51.75%	15.08%	557	557
15	雲林縣	2018-11-24T23:20:01+08:00	77711	168581	246292	21941	268233	522650	51.32%	14.87%	513	557
15	雲林縣	2018-11-25T00:14:19+08:00	85381	184614	269995	23455	293450	568154	51.65%	15.03%	547	557
15	雲林縣	2018-11-24T23:16:12+08:00	76730	166699	243429	21780	265209	517105	51.29%	14.84%	509	557
15	雲林縣	2018-11-24T23:35:19+08:00	81430	176214	257644	22652	280296	544262	51.5%	14.96%	528	557
15	雲林縣	2018-11-24T22:45:17+08:00	68807	149950	218757	19954	238711	469494	50.84%	14.66%	474	557
15	雲林縣	2018-11-25T01:18:05+08:00	88127	190434	278561	23887	302448	584480	51.75%	15.08%	557	557
15	雲林縣	2018-11-25T03:56:23+08:00	88127	190434	278561	23887	302448	584480	51.75%	15.08%	557	557
15	雲林縣	2018-11-24T22:58:04+08:00	73768	160475	234243	21102	255345	499556	51.11%	14.77%	497	557
15	雲林縣	2018-11-25T00:57:47+08:00	88127	190434	278561	23887	302448	584480	51.75%	15.08%	557	557
15	雲林縣	2018-11-24T22:19:46+08:00	59998	131089	191087	17543	208630	412516	50.58%	14.54%	430	557
15	雲林縣	2018-11-25T06:24:09+08:00	88127	190434	278561	23887	302448	584480	51.75%	15.08%	557	557
15	雲林縣	2018-11-25T04:03:02+08:00	88127	190434	278561	23887	302448	584480	51.75%	15.08%	557	557
15	雲林縣	2018-11-25T06:09:04+08:00	88127	190434	278561	23887	302448	584480	51.75%	15.08%	557	557
15	雲林縣	2018-11-24T22:40:36+08:00	68181	148690	216871	19801	236672	465569	50.83%	14.64%	471	557
15	雲林縣	2018-11-24T22:30:19+08:00	63481	138579	202060	18599	220659	435478	50.67%	14.58%	448	557
15	雲林縣	2018-11-24T22:13:40+08:00	57981	126825	184806	16836	201642	398441	50.61%	14.55%	418	557
15	雲林縣	2018-11-24T23:51:45+08:00	83623	180641	264264	23095	287359	556994	51.59%	15.01%	537	557
15	雲林縣	2018-11-24T23:27:27+08:00	80058	173222	253280	22445	275725	536045	51.44%	14.93%	523	557
15	雲林縣	2018-11-24T23:55:56+08:00	83623	180641	264264	23095	287359	556994	51.59%	15.01%	537	557
15	雲林縣	2018-11-24T23:47:39+08:00	83277	179814	263091	22995	286086	554601	51.58%	15.02%	535	557
15	雲林縣	2018-11-24T23:31:22+08:00	81189	175708	256897	22597	279494	542985	51.47%	14.95%	527	557
15	雲林縣	2018-11-24T22:16:21+08:00	59133	129253	188386	17180	205566	406529	50.57%	14.55%	425	557
15	雲林縣	2018-11-25T00:18:42+08:00	86469	187058	273527	23684	297211	575187	51.67%	15.03%	551	557
15	雲林縣	2018-11-24T23:12:26+08:00	75440	164013	239453	21494	260947	509599	51.21%	14.8%	504	557
15	雲林縣	2018-11-24T23:39:27+08:00	82669	178791	261460	22904	284364	551522	51.56%	14.99%	533	557
15	雲林縣	2018-11-25T01:07:36+08:00	88127	190434	278561	23887	302448	584480	51.75%	15.08%	557	557
15	雲林縣林內鄉	2018-11-25T00:05:14+08:00	2539	5386	7925	877	8802	15551	56.6%	16.33%	15	15
15	雲林縣林內鄉	2018-11-25T06:19:06+08:00	2539	5386	7925	877	8802	15551	56.6%	16.33%	15	15
15	雲林縣林內鄉	2018-11-25T00:09:45+08:00	2539	5386	7925	877	8802	15551	56.6%	16.33%	15	15
15	雲林縣林內鄉	2018-11-25T01:12:55+08:00	2539	5386	7925	877	8802	15551	56.6%	16.33%	15	15
15	雲林縣林內鄉	2018-11-24T22:41:46+08:00	2539	5386	7925	877	8802	15551	56.6%	16.33%	15	15
15	雲林縣林內鄉	2018-11-25T06:29:27+08:00	2539	5386	7925	877	8802	15551	56.6%	16.33%	15	15
15	雲林縣林內鄉	2018-11-24T23:05:13+08:00	2539	5386	7925	877	8802	15551	56.6%	16.33%	15	15
15	雲林縣林內鄉	2018-11-24T22:26:45+08:00	2539	5386	7925	877	8802	15551	56.6%	16.33%	15	15
15	雲林縣林內鄉	2018-11-24T22:54:34+08:00	2539	5386	7925	877	8802	15551	56.6%	16.33%	15	15
15	雲林縣林內鄉	2018-11-24T23:43:26+08:00	2539	5386	7925	877	8802	15551	56.6%	16.33%	15	15
15	雲林縣林內鄉	2018-11-24T22:50:59+08:00	2539	5386	7925	877	8802	15551	56.6%	16.33%	15	15
15	雲林縣林內鄉	2018-11-25T00:00:20+08:00	2539	5386	7925	877	8802	15551	56.6%	16.33%	15	15
15	雲林縣林內鄉	2018-11-25T00:23:13+08:00	2539	5386	7925	877	8802	15551	56.6%	16.33%	15	15
15	雲林縣林內鄉	2018-11-25T03:32:48+08:00	2539	5386	7925	877	8802	15551	56.6%	16.33%	15	15
15	雲林縣林內鄉	2018-11-25T03:44:36+08:00	2539	5386	7925	877	8802	15551	56.6%	16.33%	15	15
15	雲林縣林內鄉	2018-11-24T23:08:47+08:00	2539	5386	7925	877	8802	15551	56.6%	16.33%	15	15
15	雲林縣林內鄉	2018-11-24T22:23:24+08:00	2539	5386	7925	877	8802	15551	56.6%	16.33%	15	15
15	雲林縣林內鄉	2018-11-25T06:24:10+08:00	2539	5386	7925	877	8802	15551	56.6%	16.33%	15	15
15	雲林縣林內鄉	2018-11-25T01:02:40+08:00	2539	5386	7925	877	8802	15551	56.6%	16.33%	15	15
15	雲林縣林內鄉	2018-11-24T23:23:47+08:00	2539	5386	7925	877	8802	15551	56.6%	16.33%	15	15
15	雲林縣林內鄉	2018-11-25T03:50:00+08:00	2539	5386	7925	877	8802	15551	56.6%	16.33%	15	15
15	雲林縣林內鄉	2018-11-24T22:33:47+08:00	2539	5386	7925	877	8802	15551	56.6%	16.33%	15	15
15	雲林縣林內鄉	2018-11-25T01:26:03+08:00	2539	5386	7925	877	8802	15551	56.6%	16.33%	15	15
15	雲林縣林內鄉	2018-11-25T03:39:04+08:00	2539	5386	7925	877	8802	15551	56.6%	16.33%	15	15
15	雲林縣林內鄉	2018-11-25T00:14:19+08:00	2539	5386	7925	877	8802	15551	56.6%	16.33%	15	15
15	雲林縣林內鄉	2018-11-24T23:16:12+08:00	2539	5386	7925	877	8802	15551	56.6%	16.33%	15	15
15	雲林縣林內鄉	2018-11-24T23:35:19+08:00	2539	5386	7925	877	8802	15551	56.6%	16.33%	15	15
15	雲林縣林內鄉	2018-11-24T22:45:17+08:00	2539	5386	7925	877	8802	15551	56.6%	16.33%	15	15
15	雲林縣林內鄉	2018-11-25T01:18:05+08:00	2539	5386	7925	877	8802	15551	56.6%	16.33%	15	15
15	雲林縣林內鄉	2018-11-25T03:56:24+08:00	2539	5386	7925	877	8802	15551	56.6%	16.33%	15	15
15	雲林縣林內鄉	2018-11-24T22:58:04+08:00	2539	5386	7925	877	8802	15551	56.6%	16.33%	15	15
15	雲林縣林內鄉	2018-11-24T23:01:42+08:00	2539	5386	7925	877	8802	15551	56.6%	16.33%	15	15
15	雲林縣林內鄉	2018-11-25T00:57:47+08:00	2539	5386	7925	877	8802	15551	56.6%	16.33%	15	15
15	雲林縣林內鄉	2018-11-24T22:19:46+08:00	2329	4863	7192	808	8000	14060	56.9%	16.56%	14	15
15	雲林縣林內鄉	2018-11-24T22:13:41+08:00	2329	4863	7192	808	8000	14060	56.9%	16.56%	14	15
15	雲林縣林內鄉	2018-11-25T04:03:02+08:00	2539	5386	7925	877	8802	15551	56.6%	16.33%	15	15
15	雲林縣林內鄉	2018-11-24T22:30:19+08:00	2539	5386	7925	877	8802	15551	56.6%	16.33%	15	15
15	雲林縣林內鄉	2018-11-24T22:40:37+08:00	2539	5386	7925	877	8802	15551	56.6%	16.33%	15	15
15	雲林縣林內鄉	2018-11-24T23:51:45+08:00	2539	5386	7925	877	8802	15551	56.6%	16.33%	15	15
15	雲林縣林內鄉	2018-11-25T06:09:05+08:00	2539	5386	7925	877	8802	15551	56.6%	16.33%	15	15
15	雲林縣林內鄉	2018-11-24T23:55:57+08:00	2539	5386	7925	877	8802	15551	56.6%	16.33%	15	15
15	雲林縣林內鄉	2018-11-24T23:27:27+08:00	2539	5386	7925	877	8802	15551	56.6%	16.33%	15	15
15	雲林縣林內鄉	2018-11-25T06:14:02+08:00	2539	5386	7925	877	8802	15551	56.6%	16.33%	15	15
15	雲林縣林內鄉	2018-11-24T23:47:39+08:00	2539	5386	7925	877	8802	15551	56.6%	16.33%	15	15
15	雲林縣林內鄉	2018-11-25T00:18:43+08:00	2539	5386	7925	877	8802	15551	56.6%	16.33%	15	15
15	雲林縣林內鄉	2018-11-24T23:31:22+08:00	2539	5386	7925	877	8802	15551	56.6%	16.33%	15	15
15	雲林縣林內鄉	2018-11-24T22:16:21+08:00	2329	4863	7192	808	8000	14060	56.9%	16.56%	14	15
15	雲林縣林內鄉	2018-11-24T23:12:27+08:00	2539	5386	7925	877	8802	15551	56.6%	16.33%	15	15
15	雲林縣林內鄉	2018-11-24T23:39:28+08:00	2539	5386	7925	877	8802	15551	56.6%	16.33%	15	15
15	雲林縣林內鄉	2018-11-24T22:37:10+08:00	2539	5386	7925	877	8802	15551	56.6%	16.33%	15	15
15	雲林縣林內鄉	2018-11-24T23:20:02+08:00	2539	5386	7925	877	8802	15551	56.6%	16.33%	15	15
15	雲林縣林內鄉	2018-11-25T01:07:36+08:00	2539	5386	7925	877	8802	15551	56.6%	16.33%	15	15
15	花蓮縣	2018-11-24T23:56:00+08:00	29030	73632	102662	7329	109991	208150	52.84%	13.95%	242	299
15	花蓮縣	2018-11-24T23:05:15+08:00	20540	52528	73068	5506	78574	148838	52.79%	13.8%	186	299
15	花蓮縣	2018-11-25T01:18:08+08:00	36444	91940	128384	8911	137295	260456	52.71%	13.99%	284	299
15	花蓮縣	2018-11-24T23:43:29+08:00	27651	70215	97866	7080	104946	198604	52.84%	13.92%	233	299
15	花蓮縣	2018-11-25T03:56:27+08:00	38850	97972	136822	9514	146336	278059	52.63%	13.97%	299	299
15	花蓮縣	2018-11-25T06:19:09+08:00	38850	97972	136822	9514	146336	278059	52.63%	13.97%	299	299
15	花蓮縣	2018-11-24T22:58:07+08:00	19268	49555	68823	5275	74098	140807	52.62%	13.68%	178	299
15	花蓮縣	2018-11-24T22:41:49+08:00	15649	40695	56344	4398	60742	115575	52.56%	13.54%	156	299
15	花蓮縣	2018-11-24T23:39:31+08:00	26255	66480	92735	6753	99488	188942	52.66%	13.9%	224	299
15	花蓮縣	2018-11-24T23:47:42+08:00	28286	71708	99994	7191	107185	202805	52.85%	13.95%	237	299
15	花蓮縣	2018-11-24T22:30:22+08:00	14619	38305	52924	4152	57076	109191	52.27%	13.39%	149	299
15	花蓮縣	2018-11-24T23:51:47+08:00	29030	73632	102662	7329	109991	208150	52.84%	13.95%	242	299
15	花蓮縣	2018-11-25T06:09:08+08:00	38850	97972	136822	9514	146336	278059	52.63%	13.97%	299	299
15	花蓮縣	2018-11-24T22:13:43+08:00	13346	34664	48010	3762	51772	99500	52.03%	13.41%	138	299
15	花蓮縣	2018-11-25T00:57:50+08:00	35711	90249	125960	8724	134684	255657	52.68%	13.97%	280	299
15	花蓮縣	2018-11-25T03:44:39+08:00	38850	97972	136822	9514	146336	278059	52.63%	13.97%	299	299
15	花蓮縣	2018-11-24T23:31:26+08:00	25055	63445	88500	6526	95026	179756	52.86%	13.94%	216	299
15	花蓮縣	2018-11-24T22:33:49+08:00	15558	40423	55981	4360	60341	114974	52.48%	13.53%	155	299
15	花蓮縣	2018-11-24T22:37:13+08:00	15558	40423	55981	4360	60341	114974	52.48%	13.53%	155	299
15	花蓮縣	2018-11-24T22:16:24+08:00	13346	34664	48010	3762	51772	99500	52.03%	13.41%	138	299
15	花蓮縣	2018-11-25T00:18:46+08:00	31953	80819	112772	7986	120758	228812	52.78%	13.96%	259	299
15	花蓮縣	2018-11-24T23:35:21+08:00	25949	65731	91680	6698	98378	186648	52.71%	13.9%	222	299
15	花蓮縣	2018-11-24T23:16:15+08:00	22014	55935	77949	5863	83812	159121	52.67%	13.83%	198	299
15	花蓮縣	2018-11-24T22:45:19+08:00	16174	42057	58231	4481	62712	119299	52.57%	13.56%	159	299
15	花蓮縣	2018-11-24T22:54:36+08:00	19042	49030	68072	5228	73300	139340	52.61%	13.67%	177	299
15	花蓮縣	2018-11-25T00:05:17+08:00	29849	75681	105530	7498	113028	214490	52.7%	13.92%	247	299
15	花蓮縣	2018-11-25T01:12:57+08:00	36444	91940	128384	8911	137295	260456	52.71%	13.99%	284	299
15	花蓮縣	2018-11-24T22:26:48+08:00	14452	37697	52149	4016	56165	107624	52.19%	13.43%	147	299
15	花蓮縣	2018-11-24T23:01:45+08:00	20103	51529	71632	5417	77049	146266	52.68%	13.74%	183	299
15	花蓮縣	2018-11-25T00:09:49+08:00	30323	76897	107220	7648	114868	218021	52.69%	13.91%	250	299
15	花蓮縣	2018-11-25T04:03:05+08:00	38850	97972	136822	9514	146336	278059	52.63%	13.97%	299	299
15	花蓮縣	2018-11-24T23:23:50+08:00	23509	59938	83447	6240	89687	170158	52.71%	13.82%	207	299
15	花蓮縣	2018-11-24T22:19:49+08:00	13770	35771	49541	3875	53416	102447	52.14%	13.44%	141	299
15	花蓮縣	2018-11-24T22:40:39+08:00	15649	40695	56344	4398	60742	115575	52.56%	13.54%	156	299
15	花蓮縣	2018-11-25T03:32:51+08:00	38850	97972	136822	9514	146336	278059	52.63%	13.97%	299	299
15	花蓮縣	2018-11-24T23:08:50+08:00	21015	53568	74583	5596	80179	152160	52.69%	13.81%	190	299
15	花蓮縣	2018-11-24T22:23:27+08:00	14333	37371	51704	3988	55692	106851	52.12%	13.41%	146	299
15	花蓮縣	2018-11-24T22:51:02+08:00	18379	47161	65540	5029	70569	134579	52.44%	13.66%	173	299
15	花蓮縣	2018-11-25T06:14:04+08:00	38850	97972	136822	9514	146336	278059	52.63%	13.97%	299	299
15	花蓮縣	2018-11-25T00:00:23+08:00	29478	74804	104282	7458	111740	212071	52.69%	13.9%	245	299
15	花蓮縣	2018-11-25T06:24:12+08:00	38850	97972	136822	9514	146336	278059	52.63%	13.97%	299	299
15	花蓮縣	2018-11-24T23:27:29+08:00	23886	60886	84772	6308	91080	172574	52.78%	13.84%	209	299
15	花蓮縣	2018-11-25T00:23:16+08:00	32429	81920	114349	8044	122393	232557	52.63%	13.94%	262	299
15	花蓮縣	2018-11-25T01:02:43+08:00	35924	90740	126664	8770	135434	256988	52.7%	13.98%	281	299
15	花蓮縣	2018-11-25T06:29:30+08:00	38850	97972	136822	9514	146336	278059	52.63%	13.97%	299	299
15	花蓮縣	2018-11-24T23:12:29+08:00	21476	54549	76025	5695	81720	155327	52.61%	13.83%	193	299
15	花蓮縣	2018-11-25T03:50:03+08:00	38850	97972	136822	9514	146336	278059	52.63%	13.97%	299	299
15	花蓮縣	2018-11-25T01:07:39+08:00	36620	92365	128985	8926	137911	261619	52.71%	14%	285	299
15	花蓮縣	2018-11-25T01:26:07+08:00	37000	93267	130267	8985	139252	264340	52.68%	14%	287	299
15	花蓮縣	2018-11-25T00:14:22+08:00	30866	78010	108876	7708	116584	221344	52.67%	13.94%	253	299
15	花蓮縣	2018-11-25T03:39:06+08:00	38850	97972	136822	9514	146336	278059	52.63%	13.97%	299	299
15	花蓮縣	2018-11-24T23:20:05+08:00	23154	59028	82182	6166	88348	167922	52.61%	13.79%	205	299
15	花蓮縣富里鄉	2018-11-24T23:56:00+08:00	1034	2693	3727	424	4151	9065	45.79%	11.41%	13	13
15	花蓮縣富里鄉	2018-11-24T22:58:08+08:00	1034	2693	3727	424	4151	9065	45.79%	11.41%	13	13
15	花蓮縣富里鄉	2018-11-25T01:18:09+08:00	1034	2693	3727	424	4151	9065	45.79%	11.41%	13	13
15	花蓮縣富里鄉	2018-11-25T03:56:27+08:00	1034	2693	3727	424	4151	9065	45.79%	11.41%	13	13
15	花蓮縣富里鄉	2018-11-24T23:47:42+08:00	1034	2693	3727	424	4151	9065	45.79%	11.41%	13	13
15	花蓮縣富里鄉	2018-11-24T22:30:22+08:00	1034	2693	3727	424	4151	9065	45.79%	11.41%	13	13
15	花蓮縣富里鄉	2018-11-24T23:27:30+08:00	1034	2693	3727	424	4151	9065	45.79%	11.41%	13	13
15	花蓮縣富里鄉	2018-11-24T23:51:48+08:00	1034	2693	3727	424	4151	9065	45.79%	11.41%	13	13
15	花蓮縣富里鄉	2018-11-25T06:09:08+08:00	1034	2693	3727	424	4151	9065	45.79%	11.41%	13	13
15	花蓮縣富里鄉	2018-11-24T22:13:44+08:00	1034	2693	3727	424	4151	9065	45.79%	11.41%	13	13
15	花蓮縣富里鄉	2018-11-25T00:57:50+08:00	1034	2693	3727	424	4151	9065	45.79%	11.41%	13	13
15	花蓮縣富里鄉	2018-11-25T03:44:39+08:00	1034	2693	3727	424	4151	9065	45.79%	11.41%	13	13
15	花蓮縣富里鄉	2018-11-24T22:16:25+08:00	1034	2693	3727	424	4151	9065	45.79%	11.41%	13	13
15	花蓮縣富里鄉	2018-11-24T23:31:26+08:00	1034	2693	3727	424	4151	9065	45.79%	11.41%	13	13
15	花蓮縣富里鄉	2018-11-24T22:37:13+08:00	1034	2693	3727	424	4151	9065	45.79%	11.41%	13	13
15	花蓮縣富里鄉	2018-11-24T23:20:06+08:00	1034	2693	3727	424	4151	9065	45.79%	11.41%	13	13
15	花蓮縣富里鄉	2018-11-25T00:18:46+08:00	1034	2693	3727	424	4151	9065	45.79%	11.41%	13	13
15	花蓮縣富里鄉	2018-11-24T23:16:15+08:00	1034	2693	3727	424	4151	9065	45.79%	11.41%	13	13
15	花蓮縣富里鄉	2018-11-25T01:12:58+08:00	1034	2693	3727	424	4151	9065	45.79%	11.41%	13	13
15	花蓮縣富里鄉	2018-11-25T00:05:17+08:00	1034	2693	3727	424	4151	9065	45.79%	11.41%	13	13
15	花蓮縣富里鄉	2018-11-24T23:05:16+08:00	1034	2693	3727	424	4151	9065	45.79%	11.41%	13	13
15	花蓮縣富里鄉	2018-11-24T23:39:32+08:00	1034	2693	3727	424	4151	9065	45.79%	11.41%	13	13
15	花蓮縣富里鄉	2018-11-24T22:54:37+08:00	1034	2693	3727	424	4151	9065	45.79%	11.41%	13	13
15	花蓮縣富里鄉	2018-11-24T22:33:50+08:00	1034	2693	3727	424	4151	9065	45.79%	11.41%	13	13
15	花蓮縣富里鄉	2018-11-24T22:45:20+08:00	1034	2693	3727	424	4151	9065	45.79%	11.41%	13	13
15	花蓮縣富里鄉	2018-11-24T22:26:48+08:00	1034	2693	3727	424	4151	9065	45.79%	11.41%	13	13
15	花蓮縣富里鄉	2018-11-24T23:01:45+08:00	1034	2693	3727	424	4151	9065	45.79%	11.41%	13	13
15	花蓮縣富里鄉	2018-11-25T00:09:49+08:00	1034	2693	3727	424	4151	9065	45.79%	11.41%	13	13
15	花蓮縣富里鄉	2018-11-25T04:03:05+08:00	1034	2693	3727	424	4151	9065	45.79%	11.41%	13	13
15	花蓮縣富里鄉	2018-11-24T23:23:50+08:00	1034	2693	3727	424	4151	9065	45.79%	11.41%	13	13
15	花蓮縣富里鄉	2018-11-24T22:19:49+08:00	1034	2693	3727	424	4151	9065	45.79%	11.41%	13	13
15	花蓮縣富里鄉	2018-11-25T03:32:51+08:00	1034	2693	3727	424	4151	9065	45.79%	11.41%	13	13
15	花蓮縣富里鄉	2018-11-24T23:08:50+08:00	1034	2693	3727	424	4151	9065	45.79%	11.41%	13	13
15	花蓮縣富里鄉	2018-11-25T06:14:04+08:00	1034	2693	3727	424	4151	9065	45.79%	11.41%	13	13
15	花蓮縣富里鄉	2018-11-25T00:00:23+08:00	1034	2693	3727	424	4151	9065	45.79%	11.41%	13	13
15	花蓮縣富里鄉	2018-11-24T22:51:03+08:00	1034	2693	3727	424	4151	9065	45.79%	11.41%	13	13
15	花蓮縣富里鄉	2018-11-24T22:23:28+08:00	1034	2693	3727	424	4151	9065	45.79%	11.41%	13	13
15	花蓮縣富里鄉	2018-11-24T22:40:40+08:00	1034	2693	3727	424	4151	9065	45.79%	11.41%	13	13
15	花蓮縣富里鄉	2018-11-25T06:24:13+08:00	1034	2693	3727	424	4151	9065	45.79%	11.41%	13	13
15	花蓮縣富里鄉	2018-11-25T01:02:44+08:00	1034	2693	3727	424	4151	9065	45.79%	11.41%	13	13
15	花蓮縣富里鄉	2018-11-25T00:23:16+08:00	1034	2693	3727	424	4151	9065	45.79%	11.41%	13	13
15	花蓮縣富里鄉	2018-11-25T06:19:10+08:00	1034	2693	3727	424	4151	9065	45.79%	11.41%	13	13
15	花蓮縣富里鄉	2018-11-25T06:29:30+08:00	1034	2693	3727	424	4151	9065	45.79%	11.41%	13	13
15	花蓮縣富里鄉	2018-11-24T23:12:29+08:00	1034	2693	3727	424	4151	9065	45.79%	11.41%	13	13
15	花蓮縣富里鄉	2018-11-25T03:50:03+08:00	1034	2693	3727	424	4151	9065	45.79%	11.41%	13	13
15	花蓮縣富里鄉	2018-11-25T01:07:39+08:00	1034	2693	3727	424	4151	9065	45.79%	11.41%	13	13
15	花蓮縣富里鄉	2018-11-25T01:26:07+08:00	1034	2693	3727	424	4151	9065	45.79%	11.41%	13	13
15	花蓮縣富里鄉	2018-11-25T03:39:07+08:00	1034	2693	3727	424	4151	9065	45.79%	11.41%	13	13
15	花蓮縣富里鄉	2018-11-24T22:41:50+08:00	1034	2693	3727	424	4151	9065	45.79%	11.41%	13	13
15	花蓮縣富里鄉	2018-11-25T00:14:22+08:00	1034	2693	3727	424	4151	9065	45.79%	11.41%	13	13
15	花蓮縣富里鄉	2018-11-24T23:35:22+08:00	1034	2693	3727	424	4151	9065	45.79%	11.41%	13	13
15	花蓮縣富里鄉	2018-11-24T23:43:30+08:00	1034	2693	3727	424	4151	9065	45.79%	11.41%	13	13
15	臺南市新營區	2018-11-25T03:49:55+08:00	10841	20018	30859	1481	32340	64949	49.79%	16.69%	49	49
15	臺南市新營區	2018-11-24T22:41:41+08:00	9769	18005	27774	1345	29119	58484	49.79%	16.7%	45	49
15	臺南市新營區	2018-11-24T23:16:07+08:00	10841	20018	30859	1481	32340	64949	49.79%	16.69%	49	49
15	臺南市新營區	2018-11-25T03:56:18+08:00	10841	20018	30859	1481	32340	64949	49.79%	16.69%	49	49
15	臺南市新營區	2018-11-24T22:45:12+08:00	10004	18448	28452	1360	29812	59917	49.76%	16.7%	46	49
15	臺南市新營區	2018-11-24T23:43:21+08:00	10841	20018	30859	1481	32340	64949	49.79%	16.69%	49	49
15	臺南市新營區	2018-11-25T00:18:36+08:00	10841	20018	30859	1481	32340	64949	49.79%	16.69%	49	49
15	臺南市新營區	2018-11-24T23:51:40+08:00	10841	20018	30859	1481	32340	64949	49.79%	16.69%	49	49
15	臺南市新營區	2018-11-24T22:40:32+08:00	9769	18005	27774	1345	29119	58484	49.79%	16.7%	45	49
15	臺南市新營區	2018-11-25T01:25:57+08:00	10841	20018	30859	1481	32340	64949	49.79%	16.69%	49	49
15	臺南市新營區	2018-11-25T01:02:36+08:00	10841	20018	30859	1481	32340	64949	49.79%	16.69%	49	49
15	臺南市新營區	2018-11-24T22:30:14+08:00	9496	17483	26979	1312	28291	56889	49.73%	16.69%	44	49
15	臺南市新營區	2018-11-25T00:23:08+08:00	10841	20018	30859	1481	32340	64949	49.79%	16.69%	49	49
15	臺南市新營區	2018-11-25T00:57:42+08:00	10841	20018	30859	1481	32340	64949	49.79%	16.69%	49	49
15	臺南市新營區	2018-11-25T06:24:05+08:00	10841	20018	30859	1481	32340	64949	49.79%	16.69%	49	49
15	臺南市新營區	2018-11-24T23:27:22+08:00	10841	20018	30859	1481	32340	64949	49.79%	16.69%	49	49
15	臺南市新營區	2018-11-24T22:57:59+08:00	10277	18982	29259	1414	30673	61762	49.66%	16.64%	47	49
15	臺南市新營區	2018-11-24T23:19:57+08:00	10841	20018	30859	1481	32340	64949	49.79%	16.69%	49	49
15	臺南市新營區	2018-11-25T03:32:41+08:00	10841	20018	30859	1481	32340	64949	49.79%	16.69%	49	49
15	臺南市新營區	2018-11-24T23:08:41+08:00	10529	19507	30036	1448	31484	63200	49.82%	16.66%	48	49
15	臺南市新營區	2018-11-24T22:13:33+08:00	8184	15042	23226	1109	24335	48333	50.35%	16.93%	39	49
15	臺南市新營區	2018-11-25T01:17:58+08:00	10841	20018	30859	1481	32340	64949	49.79%	16.69%	49	49
15	臺南市新營區	2018-11-24T23:39:22+08:00	10841	20018	30859	1481	32340	64949	49.79%	16.69%	49	49
15	臺南市新營區	2018-11-25T01:12:49+08:00	10841	20018	30859	1481	32340	64949	49.79%	16.69%	49	49
15	臺南市新營區	2018-11-25T06:08:59+08:00	10841	20018	30859	1481	32340	64949	49.79%	16.69%	49	49
15	臺南市新營區	2018-11-24T23:31:17+08:00	10841	20018	30859	1481	32340	64949	49.79%	16.69%	49	49
15	臺南市新營區	2018-11-24T23:47:33+08:00	10841	20018	30859	1481	32340	64949	49.79%	16.69%	49	49
15	臺南市新營區	2018-11-24T23:05:09+08:00	10529	19507	30036	1448	31484	63200	49.82%	16.66%	48	49
15	臺南市新營區	2018-11-24T23:01:36+08:00	10529	19507	30036	1448	31484	63200	49.82%	16.66%	48	49
15	臺南市新營區	2018-11-25T04:02:57+08:00	10841	20018	30859	1481	32340	64949	49.79%	16.69%	49	49
15	臺南市新營區	2018-11-25T00:05:10+08:00	10841	20018	30859	1481	32340	64949	49.79%	16.69%	49	49
15	臺南市新營區	2018-11-25T06:19:02+08:00	10841	20018	30859	1481	32340	64949	49.79%	16.69%	49	49
15	臺南市新營區	2018-11-25T06:29:22+08:00	10841	20018	30859	1481	32340	64949	49.79%	16.69%	49	49
15	臺南市新營區	2018-11-24T22:54:30+08:00	10277	18982	29259	1414	30673	61762	49.66%	16.64%	47	49
15	臺南市新營區	2018-11-25T06:13:57+08:00	10841	20018	30859	1481	32340	64949	49.79%	16.69%	49	49
15	臺南市新營區	2018-11-24T22:50:53+08:00	10277	18982	29259	1414	30673	61762	49.66%	16.64%	47	49
15	臺南市新營區	2018-11-24T22:37:05+08:00	9769	18005	27774	1345	29119	58484	49.79%	16.7%	45	49
15	臺南市新營區	2018-11-24T22:26:41+08:00	9221	16937	26158	1282	27440	55027	49.87%	16.76%	43	49
15	臺南市新營區	2018-11-24T22:19:41+08:00	8623	15888	24511	1205	25716	51232	50.2%	16.83%	41	49
15	臺南市新營區	2018-11-25T03:38:59+08:00	10841	20018	30859	1481	32340	64949	49.79%	16.69%	49	49
15	臺南市新營區	2018-11-25T03:44:29+08:00	10841	20018	30859	1481	32340	64949	49.79%	16.69%	49	49
15	臺南市新營區	2018-11-24T22:23:18+08:00	8922	16444	25366	1258	26624	53097	50.14%	16.8%	42	49
15	臺南市新營區	2018-11-25T00:00:15+08:00	10841	20018	30859	1481	32340	64949	49.79%	16.69%	49	49
15	臺南市新營區	2018-11-24T23:23:43+08:00	10841	20018	30859	1481	32340	64949	49.79%	16.69%	49	49
15	臺南市新營區	2018-11-24T23:55:51+08:00	10841	20018	30859	1481	32340	64949	49.79%	16.69%	49	49
15	臺南市新營區	2018-11-24T23:35:15+08:00	10841	20018	30859	1481	32340	64949	49.79%	16.69%	49	49
15	臺南市新營區	2018-11-24T23:12:20+08:00	10841	20018	30859	1481	32340	64949	49.79%	16.69%	49	49
15	臺南市新營區	2018-11-25T00:14:14+08:00	10841	20018	30859	1481	32340	64949	49.79%	16.69%	49	49
15	臺南市新營區	2018-11-24T22:16:16+08:00	8374	15421	23795	1162	24957	49706	50.21%	16.85%	40	49
15	臺南市新營區	2018-11-25T00:09:39+08:00	10841	20018	30859	1481	32340	64949	49.79%	16.69%	49	49
15	臺南市新營區	2018-11-25T01:07:31+08:00	10841	20018	30859	1481	32340	64949	49.79%	16.69%	49	49
15	臺南市新營區	2018-11-24T22:33:42+08:00	9769	18005	27774	1345	29119	58484	49.79%	16.7%	45	49
15	屏東縣枋山鄉	2018-11-24T22:58:06+08:00	573	1229	1802	200	2002	3884	51.54%	14.75%	5	6
15	屏東縣枋山鄉	2018-11-25T03:56:26+08:00	707	1563	2270	220	2490	4856	51.28%	14.56%	6	6
15	屏東縣枋山鄉	2018-11-24T23:05:15+08:00	573	1229	1802	200	2002	3884	51.54%	14.75%	5	6
15	屏東縣枋山鄉	2018-11-25T01:18:08+08:00	707	1563	2270	220	2490	4856	51.28%	14.56%	6	6
15	屏東縣枋山鄉	2018-11-24T23:39:30+08:00	573	1229	1802	200	2002	3884	51.54%	14.75%	5	6
15	屏東縣枋山鄉	2018-11-24T22:41:48+08:00	407	871	1278	151	1429	2956	48.34%	13.77%	4	6
15	屏東縣枋山鄉	2018-11-25T06:29:29+08:00	707	1563	2270	220	2490	4856	51.28%	14.56%	6	6
15	屏東縣枋山鄉	2018-11-25T06:19:09+08:00	707	1563	2270	220	2490	4856	51.28%	14.56%	6	6
15	屏東縣枋山鄉	2018-11-24T23:43:28+08:00	707	1563	2270	220	2490	4856	51.28%	14.56%	6	6
15	屏東縣枋山鄉	2018-11-25T06:09:07+08:00	707	1563	2270	220	2490	4856	51.28%	14.56%	6	6
15	屏東縣枋山鄉	2018-11-24T23:51:47+08:00	707	1563	2270	220	2490	4856	51.28%	14.56%	6	6
15	屏東縣枋山鄉	2018-11-24T22:13:43+08:00	407	871	1278	151	1429	2956	48.34%	13.77%	4	6
15	屏東縣枋山鄉	2018-11-24T23:08:49+08:00	573	1229	1802	200	2002	3884	51.54%	14.75%	5	6
15	屏東縣枋山鄉	2018-11-24T22:51:01+08:00	573	1229	1802	200	2002	3884	51.54%	14.75%	5	6
15	屏東縣枋山鄉	2018-11-25T03:44:38+08:00	707	1563	2270	220	2490	4856	51.28%	14.56%	6	6
15	屏東縣枋山鄉	2018-11-25T00:23:15+08:00	707	1563	2270	220	2490	4856	51.28%	14.56%	6	6
15	屏東縣枋山鄉	2018-11-24T23:23:49+08:00	573	1229	1802	200	2002	3884	51.54%	14.75%	5	6
15	屏東縣枋山鄉	2018-11-24T22:33:49+08:00	407	871	1278	151	1429	2956	48.34%	13.77%	4	6
15	屏東縣枋山鄉	2018-11-24T22:37:12+08:00	407	871	1278	151	1429	2956	48.34%	13.77%	4	6
15	屏東縣枋山鄉	2018-11-24T23:16:14+08:00	573	1229	1802	200	2002	3884	51.54%	14.75%	5	6
15	屏東縣枋山鄉	2018-11-25T01:26:05+08:00	707	1563	2270	220	2490	4856	51.28%	14.56%	6	6
15	屏東縣枋山鄉	2018-11-24T22:16:23+08:00	407	871	1278	151	1429	2956	48.34%	13.77%	4	6
15	屏東縣枋山鄉	2018-11-25T00:14:21+08:00	707	1563	2270	220	2490	4856	51.28%	14.56%	6	6
15	屏東縣枋山鄉	2018-11-24T23:35:21+08:00	573	1229	1802	200	2002	3884	51.54%	14.75%	5	6
15	屏東縣枋山鄉	2018-11-24T22:45:19+08:00	407	871	1278	151	1429	2956	48.34%	13.77%	4	6
15	屏東縣枋山鄉	2018-11-24T22:54:36+08:00	573	1229	1802	200	2002	3884	51.54%	14.75%	5	6
15	屏東縣枋山鄉	2018-11-25T00:09:48+08:00	707	1563	2270	220	2490	4856	51.28%	14.56%	6	6
15	屏東縣枋山鄉	2018-11-24T23:01:44+08:00	573	1229	1802	200	2002	3884	51.54%	14.75%	5	6
15	屏東縣枋山鄉	2018-11-24T22:26:47+08:00	407	871	1278	151	1429	2956	48.34%	13.77%	4	6
15	屏東縣枋山鄉	2018-11-24T23:47:41+08:00	707	1563	2270	220	2490	4856	51.28%	14.56%	6	6
15	屏東縣枋山鄉	2018-11-25T01:12:57+08:00	707	1563	2270	220	2490	4856	51.28%	14.56%	6	6
15	屏東縣枋山鄉	2018-11-25T00:05:16+08:00	707	1563	2270	220	2490	4856	51.28%	14.56%	6	6
15	屏東縣枋山鄉	2018-11-25T00:57:49+08:00	707	1563	2270	220	2490	4856	51.28%	14.56%	6	6
15	屏東縣枋山鄉	2018-11-24T22:19:48+08:00	407	871	1278	151	1429	2956	48.34%	13.77%	4	6
15	屏東縣枋山鄉	2018-11-24T22:30:21+08:00	407	871	1278	151	1429	2956	48.34%	13.77%	4	6
15	屏東縣枋山鄉	2018-11-25T03:32:50+08:00	707	1563	2270	220	2490	4856	51.28%	14.56%	6	6
15	屏東縣枋山鄉	2018-11-25T04:03:04+08:00	707	1563	2270	220	2490	4856	51.28%	14.56%	6	6
15	屏東縣枋山鄉	2018-11-24T22:40:39+08:00	407	871	1278	151	1429	2956	48.34%	13.77%	4	6
15	屏東縣枋山鄉	2018-11-25T01:02:42+08:00	707	1563	2270	220	2490	4856	51.28%	14.56%	6	6
15	屏東縣枋山鄉	2018-11-25T06:14:03+08:00	707	1563	2270	220	2490	4856	51.28%	14.56%	6	6
15	屏東縣枋山鄉	2018-11-24T23:55:59+08:00	707	1563	2270	220	2490	4856	51.28%	14.56%	6	6
15	屏東縣枋山鄉	2018-11-25T06:24:12+08:00	707	1563	2270	220	2490	4856	51.28%	14.56%	6	6
15	屏東縣枋山鄉	2018-11-24T22:23:26+08:00	407	871	1278	151	1429	2956	48.34%	13.77%	4	6
15	屏東縣枋山鄉	2018-11-24T23:27:29+08:00	573	1229	1802	200	2002	3884	51.54%	14.75%	5	6
15	屏東縣枋山鄉	2018-11-25T00:00:22+08:00	707	1563	2270	220	2490	4856	51.28%	14.56%	6	6
15	屏東縣枋山鄉	2018-11-24T23:31:25+08:00	573	1229	1802	200	2002	3884	51.54%	14.75%	5	6
15	屏東縣枋山鄉	2018-11-24T23:20:04+08:00	573	1229	1802	200	2002	3884	51.54%	14.75%	5	6
15	屏東縣枋山鄉	2018-11-25T00:18:45+08:00	707	1563	2270	220	2490	4856	51.28%	14.56%	6	6
15	屏東縣枋山鄉	2018-11-25T01:07:38+08:00	707	1563	2270	220	2490	4856	51.28%	14.56%	6	6
15	屏東縣枋山鄉	2018-11-25T03:39:06+08:00	707	1563	2270	220	2490	4856	51.28%	14.56%	6	6
15	屏東縣枋山鄉	2018-11-25T03:50:02+08:00	707	1563	2270	220	2490	4856	51.28%	14.56%	6	6
15	屏東縣枋山鄉	2018-11-24T23:12:28+08:00	573	1229	1802	200	2002	3884	51.54%	14.75%	5	6
15	臺南市大內區	2018-11-24T22:41:41+08:00	1171	2546	3717	426	4143	8654	47.87%	13.53%	11	11
15	臺南市大內區	2018-11-25T00:18:37+08:00	1171	2546	3717	426	4143	8654	47.87%	13.53%	11	11
15	臺南市大內區	2018-11-24T22:45:13+08:00	1171	2546	3717	426	4143	8654	47.87%	13.53%	11	11
15	臺南市大內區	2018-11-24T23:16:07+08:00	1171	2546	3717	426	4143	8654	47.87%	13.53%	11	11
15	臺南市大內區	2018-11-25T03:56:18+08:00	1171	2546	3717	426	4143	8654	47.87%	13.53%	11	11
15	臺南市大內區	2018-11-24T23:51:40+08:00	1171	2546	3717	426	4143	8654	47.87%	13.53%	11	11
15	臺南市大內區	2018-11-24T22:40:32+08:00	1171	2546	3717	426	4143	8654	47.87%	13.53%	11	11
15	臺南市大內區	2018-11-25T01:02:36+08:00	1171	2546	3717	426	4143	8654	47.87%	13.53%	11	11
15	臺南市大內區	2018-11-24T22:19:42+08:00	1171	2546	3717	426	4143	8654	47.87%	13.53%	11	11
15	臺南市大內區	2018-11-25T01:25:58+08:00	1171	2546	3717	426	4143	8654	47.87%	13.53%	11	11
15	臺南市大內區	2018-11-24T22:30:15+08:00	1171	2546	3717	426	4143	8654	47.87%	13.53%	11	11
15	臺南市大內區	2018-11-25T00:23:09+08:00	1171	2546	3717	426	4143	8654	47.87%	13.53%	11	11
15	臺南市大內區	2018-11-25T00:57:42+08:00	1171	2546	3717	426	4143	8654	47.87%	13.53%	11	11
15	臺南市大內區	2018-11-25T06:24:05+08:00	1171	2546	3717	426	4143	8654	47.87%	13.53%	11	11
15	臺南市大內區	2018-11-25T00:00:16+08:00	1171	2546	3717	426	4143	8654	47.87%	13.53%	11	11
15	臺南市大內區	2018-11-25T01:17:59+08:00	1171	2546	3717	426	4143	8654	47.87%	13.53%	11	11
15	臺南市大內區	2018-11-24T22:57:59+08:00	1171	2546	3717	426	4143	8654	47.87%	13.53%	11	11
15	臺南市大內區	2018-11-24T23:19:57+08:00	1171	2546	3717	426	4143	8654	47.87%	13.53%	11	11
15	臺南市大內區	2018-11-24T23:55:52+08:00	1171	2546	3717	426	4143	8654	47.87%	13.53%	11	11
15	臺南市大內區	2018-11-24T22:13:33+08:00	1171	2546	3717	426	4143	8654	47.87%	13.53%	11	11
15	臺南市大內區	2018-11-24T23:27:23+08:00	1171	2546	3717	426	4143	8654	47.87%	13.53%	11	11
15	臺南市大內區	2018-11-24T23:39:22+08:00	1171	2546	3717	426	4143	8654	47.87%	13.53%	11	11
15	臺南市大內區	2018-11-25T01:12:49+08:00	1171	2546	3717	426	4143	8654	47.87%	13.53%	11	11
15	臺南市大內區	2018-11-25T06:08:59+08:00	1171	2546	3717	426	4143	8654	47.87%	13.53%	11	11
15	臺南市大內區	2018-11-24T23:31:17+08:00	1171	2546	3717	426	4143	8654	47.87%	13.53%	11	11
15	臺南市大內區	2018-11-24T23:47:34+08:00	1171	2546	3717	426	4143	8654	47.87%	13.53%	11	11
15	臺南市大內區	2018-11-24T23:05:09+08:00	1171	2546	3717	426	4143	8654	47.87%	13.53%	11	11
15	臺南市大內區	2018-11-24T23:01:36+08:00	1171	2546	3717	426	4143	8654	47.87%	13.53%	11	11
15	臺南市大內區	2018-11-25T04:02:57+08:00	1171	2546	3717	426	4143	8654	47.87%	13.53%	11	11
15	臺南市大內區	2018-11-25T00:05:10+08:00	1171	2546	3717	426	4143	8654	47.87%	13.53%	11	11
15	臺南市大內區	2018-11-25T06:19:02+08:00	1171	2546	3717	426	4143	8654	47.87%	13.53%	11	11
15	臺南市大內區	2018-11-25T06:29:22+08:00	1171	2546	3717	426	4143	8654	47.87%	13.53%	11	11
15	臺南市大內區	2018-11-25T03:49:56+08:00	1171	2546	3717	426	4143	8654	47.87%	13.53%	11	11
15	臺南市大內區	2018-11-24T22:54:30+08:00	1171	2546	3717	426	4143	8654	47.87%	13.53%	11	11
15	臺南市大內區	2018-11-24T22:50:54+08:00	1171	2546	3717	426	4143	8654	47.87%	13.53%	11	11
15	臺南市大內區	2018-11-25T06:13:57+08:00	1171	2546	3717	426	4143	8654	47.87%	13.53%	11	11
15	臺南市大內區	2018-11-24T22:37:05+08:00	1171	2546	3717	426	4143	8654	47.87%	13.53%	11	11
15	臺南市大內區	2018-11-24T23:43:22+08:00	1171	2546	3717	426	4143	8654	47.87%	13.53%	11	11
15	臺南市大內區	2018-11-25T00:09:40+08:00	1171	2546	3717	426	4143	8654	47.87%	13.53%	11	11
15	臺南市大內區	2018-11-24T22:26:41+08:00	1171	2546	3717	426	4143	8654	47.87%	13.53%	11	11
15	臺南市大內區	2018-11-25T03:38:59+08:00	1171	2546	3717	426	4143	8654	47.87%	13.53%	11	11
15	臺南市大內區	2018-11-25T03:44:29+08:00	1171	2546	3717	426	4143	8654	47.87%	13.53%	11	11
15	臺南市大內區	2018-11-25T03:32:42+08:00	1171	2546	3717	426	4143	8654	47.87%	13.53%	11	11
15	臺南市大內區	2018-11-24T23:08:42+08:00	1171	2546	3717	426	4143	8654	47.87%	13.53%	11	11
15	臺南市大內區	2018-11-24T22:23:19+08:00	1171	2546	3717	426	4143	8654	47.87%	13.53%	11	11
15	臺南市大內區	2018-11-24T23:23:43+08:00	1171	2546	3717	426	4143	8654	47.87%	13.53%	11	11
15	臺南市大內區	2018-11-25T00:14:15+08:00	1171	2546	3717	426	4143	8654	47.87%	13.53%	11	11
15	臺南市大內區	2018-11-24T23:35:15+08:00	1171	2546	3717	426	4143	8654	47.87%	13.53%	11	11
15	臺南市大內區	2018-11-24T22:33:43+08:00	1171	2546	3717	426	4143	8654	47.87%	13.53%	11	11
15	臺南市大內區	2018-11-24T23:12:21+08:00	1171	2546	3717	426	4143	8654	47.87%	13.53%	11	11
15	臺南市大內區	2018-11-24T22:16:16+08:00	1171	2546	3717	426	4143	8654	47.87%	13.53%	11	11
15	臺南市大內區	2018-11-25T01:07:31+08:00	1171	2546	3717	426	4143	8654	47.87%	13.53%	11	11
15	嘉義縣鹿草鄉	2018-11-25T01:18:06+08:00	1996	3726	5722	841	6563	13937	47.09%	14.32%	20	20
15	嘉義縣鹿草鄉	2018-11-25T06:29:28+08:00	1996	3726	5722	841	6563	13937	47.09%	14.32%	20	20
15	嘉義縣鹿草鄉	2018-11-24T23:43:27+08:00	1996	3726	5722	841	6563	13937	47.09%	14.32%	20	20
15	嘉義縣鹿草鄉	2018-11-24T22:54:35+08:00	1798	3317	5115	788	5903	12625	46.76%	14.24%	19	20
15	嘉義縣鹿草鄉	2018-11-24T23:05:14+08:00	1798	3317	5115	788	5903	12625	46.76%	14.24%	19	20
15	嘉義縣鹿草鄉	2018-11-25T06:19:07+08:00	1996	3726	5722	841	6563	13937	47.09%	14.32%	20	20
15	嘉義縣鹿草鄉	2018-11-25T00:05:15+08:00	1996	3726	5722	841	6563	13937	47.09%	14.32%	20	20
15	嘉義縣鹿草鄉	2018-11-24T22:41:47+08:00	1798	3317	5115	788	5903	12625	46.76%	14.24%	19	20
15	嘉義縣鹿草鄉	2018-11-24T23:51:46+08:00	1996	3726	5722	841	6563	13937	47.09%	14.32%	20	20
15	嘉義縣鹿草鄉	2018-11-25T06:09:06+08:00	1996	3726	5722	841	6563	13937	47.09%	14.32%	20	20
15	嘉義縣鹿草鄉	2018-11-25T01:02:41+08:00	1996	3726	5722	841	6563	13937	47.09%	14.32%	20	20
15	嘉義縣鹿草鄉	2018-11-25T00:23:14+08:00	1996	3726	5722	841	6563	13937	47.09%	14.32%	20	20
15	嘉義縣鹿草鄉	2018-11-24T23:23:48+08:00	1996	3726	5722	841	6563	13937	47.09%	14.32%	20	20
15	嘉義縣鹿草鄉	2018-11-25T06:24:10+08:00	1996	3726	5722	841	6563	13937	47.09%	14.32%	20	20
15	嘉義縣鹿草鄉	2018-11-25T00:00:21+08:00	1996	3726	5722	841	6563	13937	47.09%	14.32%	20	20
15	嘉義縣鹿草鄉	2018-11-24T22:23:25+08:00	1798	3317	5115	788	5903	12625	46.76%	14.24%	19	20
15	嘉義縣鹿草鄉	2018-11-24T22:51:00+08:00	1798	3317	5115	788	5903	12625	46.76%	14.24%	19	20
15	嘉義縣鹿草鄉	2018-11-25T03:32:49+08:00	1996	3726	5722	841	6563	13937	47.09%	14.32%	20	20
15	嘉義縣鹿草鄉	2018-11-25T03:44:37+08:00	1996	3726	5722	841	6563	13937	47.09%	14.32%	20	20
15	嘉義縣鹿草鄉	2018-11-24T23:08:48+08:00	1798	3317	5115	788	5903	12625	46.76%	14.24%	19	20
15	嘉義縣鹿草鄉	2018-11-24T22:16:22+08:00	1703	3061	4764	694	5458	11795	46.27%	14.44%	18	20
15	嘉義縣鹿草鄉	2018-11-25T01:26:04+08:00	1996	3726	5722	841	6563	13937	47.09%	14.32%	20	20
15	嘉義縣鹿草鄉	2018-11-24T23:16:13+08:00	1798	3317	5115	788	5903	12625	46.76%	14.24%	19	20
15	嘉義縣鹿草鄉	2018-11-24T23:35:20+08:00	1996	3726	5722	841	6563	13937	47.09%	14.32%	20	20
15	嘉義縣鹿草鄉	2018-11-25T00:14:20+08:00	1996	3726	5722	841	6563	13937	47.09%	14.32%	20	20
15	嘉義縣鹿草鄉	2018-11-25T03:39:05+08:00	1996	3726	5722	841	6563	13937	47.09%	14.32%	20	20
15	嘉義縣鹿草鄉	2018-11-24T22:33:48+08:00	1798	3317	5115	788	5903	12625	46.76%	14.24%	19	20
15	嘉義縣鹿草鄉	2018-11-25T03:50:01+08:00	1996	3726	5722	841	6563	13937	47.09%	14.32%	20	20
15	嘉義縣鹿草鄉	2018-11-25T01:12:56+08:00	1996	3726	5722	841	6563	13937	47.09%	14.32%	20	20
15	嘉義縣鹿草鄉	2018-11-24T23:47:40+08:00	1996	3726	5722	841	6563	13937	47.09%	14.32%	20	20
15	嘉義縣鹿草鄉	2018-11-24T22:58:05+08:00	1798	3317	5115	788	5903	12625	46.76%	14.24%	19	20
15	嘉義縣鹿草鄉	2018-11-25T00:09:46+08:00	1996	3726	5722	841	6563	13937	47.09%	14.32%	20	20
15	嘉義縣鹿草鄉	2018-11-25T03:56:25+08:00	1996	3726	5722	841	6563	13937	47.09%	14.32%	20	20
15	嘉義縣鹿草鄉	2018-11-24T22:45:18+08:00	1798	3317	5115	788	5903	12625	46.76%	14.24%	19	20
15	嘉義縣鹿草鄉	2018-11-24T22:26:46+08:00	1798	3317	5115	788	5903	12625	46.76%	14.24%	19	20
15	嘉義縣鹿草鄉	2018-11-24T23:01:42+08:00	1798	3317	5115	788	5903	12625	46.76%	14.24%	19	20
15	嘉義縣鹿草鄉	2018-11-24T22:13:41+08:00	1703	3061	4764	694	5458	11795	46.27%	14.44%	18	20
15	嘉義縣鹿草鄉	2018-11-25T04:03:03+08:00	1996	3726	5722	841	6563	13937	47.09%	14.32%	20	20
15	嘉義縣鹿草鄉	2018-11-25T00:57:48+08:00	1996	3726	5722	841	6563	13937	47.09%	14.32%	20	20
15	嘉義縣鹿草鄉	2018-11-24T22:19:47+08:00	1703	3061	4764	694	5458	11795	46.27%	14.44%	18	20
15	嘉義縣鹿草鄉	2018-11-24T22:40:37+08:00	1798	3317	5115	788	5903	12625	46.76%	14.24%	19	20
15	嘉義縣鹿草鄉	2018-11-24T22:30:20+08:00	1798	3317	5115	788	5903	12625	46.76%	14.24%	19	20
15	嘉義縣鹿草鄉	2018-11-24T23:27:28+08:00	1996	3726	5722	841	6563	13937	47.09%	14.32%	20	20
15	嘉義縣鹿草鄉	2018-11-24T23:55:57+08:00	1996	3726	5722	841	6563	13937	47.09%	14.32%	20	20
15	嘉義縣鹿草鄉	2018-11-25T06:14:02+08:00	1996	3726	5722	841	6563	13937	47.09%	14.32%	20	20
15	嘉義縣鹿草鄉	2018-11-25T00:18:43+08:00	1996	3726	5722	841	6563	13937	47.09%	14.32%	20	20
15	嘉義縣鹿草鄉	2018-11-24T23:20:03+08:00	1996	3726	5722	841	6563	13937	47.09%	14.32%	20	20
15	嘉義縣鹿草鄉	2018-11-25T01:07:37+08:00	1996	3726	5722	841	6563	13937	47.09%	14.32%	20	20
15	嘉義縣鹿草鄉	2018-11-24T23:12:27+08:00	1798	3317	5115	788	5903	12625	46.76%	14.24%	19	20
15	嘉義縣鹿草鄉	2018-11-24T22:37:11+08:00	1798	3317	5115	788	5903	12625	46.76%	14.24%	19	20
15	嘉義縣鹿草鄉	2018-11-24T23:39:29+08:00	1996	3726	5722	841	6563	13937	47.09%	14.32%	20	20
15	嘉義縣鹿草鄉	2018-11-24T23:31:23+08:00	1996	3726	5722	841	6563	13937	47.09%	14.32%	20	20
15	金門縣烏坵鄉	2018-11-25T03:56:28+08:00	38	125	163	2	165	567	29.1%	6.7%	2	2
15	金門縣烏坵鄉	2018-11-24T23:12:31+08:00	38	125	163	2	165	567	29.1%	6.7%	2	2
15	金門縣烏坵鄉	2018-11-24T23:47:44+08:00	38	125	163	2	165	567	29.1%	6.7%	2	2
15	金門縣烏坵鄉	2018-11-24T22:58:09+08:00	38	125	163	2	165	567	29.1%	6.7%	2	2
15	金門縣烏坵鄉	2018-11-24T23:56:01+08:00	38	125	163	2	165	567	29.1%	6.7%	2	2
15	金門縣烏坵鄉	2018-11-24T23:01:46+08:00	38	125	163	2	165	567	29.1%	6.7%	2	2
15	金門縣烏坵鄉	2018-11-25T03:32:53+08:00	38	125	163	2	165	567	29.1%	6.7%	2	2
15	金門縣烏坵鄉	2018-11-24T23:08:52+08:00	38	125	163	2	165	567	29.1%	6.7%	2	2
15	金門縣烏坵鄉	2018-11-24T23:51:49+08:00	38	125	163	2	165	567	29.1%	6.7%	2	2
15	金門縣烏坵鄉	2018-11-24T22:13:45+08:00	38	125	163	2	165	567	29.1%	6.7%	2	2
15	金門縣烏坵鄉	2018-11-25T03:44:41+08:00	38	125	163	2	165	567	29.1%	6.7%	2	2
15	金門縣烏坵鄉	2018-11-25T04:03:06+08:00	38	125	163	2	165	567	29.1%	6.7%	2	2
15	金門縣烏坵鄉	2018-11-24T23:27:31+08:00	38	125	163	2	165	567	29.1%	6.7%	2	2
15	金門縣烏坵鄉	2018-11-24T22:30:24+08:00	38	125	163	2	165	567	29.1%	6.7%	2	2
15	金門縣烏坵鄉	2018-11-24T22:19:50+08:00	38	125	163	2	165	567	29.1%	6.7%	2	2
15	金門縣烏坵鄉	2018-11-25T06:14:06+08:00	38	125	163	2	165	567	29.1%	6.7%	2	2
15	金門縣烏坵鄉	2018-11-24T22:37:14+08:00	38	125	163	2	165	567	29.1%	6.7%	2	2
15	金門縣烏坵鄉	2018-11-24T23:20:08+08:00	38	125	163	2	165	567	29.1%	6.7%	2	2
15	金門縣烏坵鄉	2018-11-24T23:31:27+08:00	38	125	163	2	165	567	29.1%	6.7%	2	2
15	金門縣烏坵鄉	2018-11-25T00:18:48+08:00	38	125	163	2	165	567	29.1%	6.7%	2	2
15	金門縣烏坵鄉	2018-11-25T06:29:32+08:00	38	125	163	2	165	567	29.1%	6.7%	2	2
15	金門縣烏坵鄉	2018-11-25T00:09:51+08:00	38	125	163	2	165	567	29.1%	6.7%	2	2
15	金門縣烏坵鄉	2018-11-24T22:45:21+08:00	38	125	163	2	165	567	29.1%	6.7%	2	2
15	金門縣烏坵鄉	2018-11-24T22:54:38+08:00	38	125	163	2	165	567	29.1%	6.7%	2	2
15	金門縣烏坵鄉	2018-11-24T22:33:51+08:00	38	125	163	2	165	567	29.1%	6.7%	2	2
15	金門縣烏坵鄉	2018-11-24T23:39:33+08:00	38	125	163	2	165	567	29.1%	6.7%	2	2
15	金門縣烏坵鄉	2018-11-24T22:26:49+08:00	38	125	163	2	165	567	29.1%	6.7%	2	2
15	金門縣烏坵鄉	2018-11-25T01:07:40+08:00	38	125	163	2	165	567	29.1%	6.7%	2	2
15	金門縣烏坵鄉	2018-11-25T01:12:59+08:00	38	125	163	2	165	567	29.1%	6.7%	2	2
15	金門縣烏坵鄉	2018-11-25T00:05:18+08:00	38	125	163	2	165	567	29.1%	6.7%	2	2
15	金門縣烏坵鄉	2018-11-24T23:05:17+08:00	38	125	163	2	165	567	29.1%	6.7%	2	2
15	金門縣烏坵鄉	2018-11-24T23:23:51+08:00	38	125	163	2	165	567	29.1%	6.7%	2	2
15	金門縣烏坵鄉	2018-11-24T22:23:29+08:00	38	125	163	2	165	567	29.1%	6.7%	2	2
15	金門縣烏坵鄉	2018-11-25T00:00:24+08:00	38	125	163	2	165	567	29.1%	6.7%	2	2
15	金門縣烏坵鄉	2018-11-25T01:02:45+08:00	38	125	163	2	165	567	29.1%	6.7%	2	2
15	金門縣烏坵鄉	2018-11-24T22:40:41+08:00	38	125	163	2	165	567	29.1%	6.7%	2	2
15	金門縣烏坵鄉	2018-11-25T00:57:52+08:00	38	125	163	2	165	567	29.1%	6.7%	2	2
15	金門縣烏坵鄉	2018-11-24T22:51:04+08:00	38	125	163	2	165	567	29.1%	6.7%	2	2
15	金門縣烏坵鄉	2018-11-25T06:09:10+08:00	38	125	163	2	165	567	29.1%	6.7%	2	2
15	金門縣烏坵鄉	2018-11-25T06:24:14+08:00	38	125	163	2	165	567	29.1%	6.7%	2	2
15	金門縣烏坵鄉	2018-11-25T00:23:18+08:00	38	125	163	2	165	567	29.1%	6.7%	2	2
15	金門縣烏坵鄉	2018-11-24T23:35:23+08:00	38	125	163	2	165	567	29.1%	6.7%	2	2
15	金門縣烏坵鄉	2018-11-25T00:14:24+08:00	38	125	163	2	165	567	29.1%	6.7%	2	2
15	金門縣烏坵鄉	2018-11-25T03:50:04+08:00	38	125	163	2	165	567	29.1%	6.7%	2	2
15	金門縣烏坵鄉	2018-11-24T22:16:26+08:00	38	125	163	2	165	567	29.1%	6.7%	2	2
15	金門縣烏坵鄉	2018-11-24T23:43:31+08:00	38	125	163	2	165	567	29.1%	6.7%	2	2
15	金門縣烏坵鄉	2018-11-25T01:18:11+08:00	38	125	163	2	165	567	29.1%	6.7%	2	2
15	金門縣烏坵鄉	2018-11-24T23:16:16+08:00	38	125	163	2	165	567	29.1%	6.7%	2	2
15	金門縣烏坵鄉	2018-11-25T06:19:11+08:00	38	125	163	2	165	567	29.1%	6.7%	2	2
15	金門縣烏坵鄉	2018-11-24T22:41:51+08:00	38	125	163	2	165	567	29.1%	6.7%	2	2
15	金門縣烏坵鄉	2018-11-25T03:39:08+08:00	38	125	163	2	165	567	29.1%	6.7%	2	2
15	金門縣烏坵鄉	2018-11-25T01:26:08+08:00	38	125	163	2	165	567	29.1%	6.7%	2	2
15	嘉義縣太保市	2018-11-25T01:18:06+08:00	5217	10385	15602	1236	16838	31568	53.34%	16.53%	33	33
15	嘉義縣太保市	2018-11-25T06:29:28+08:00	5217	10385	15602	1236	16838	31568	53.34%	16.53%	33	33
15	嘉義縣太保市	2018-11-25T01:12:55+08:00	5217	10385	15602	1236	16838	31568	53.34%	16.53%	33	33
15	嘉義縣太保市	2018-11-24T23:05:13+08:00	4468	8897	13365	1015	14380	27250	52.77%	16.4%	30	33
15	嘉義縣太保市	2018-11-25T06:19:07+08:00	5217	10385	15602	1236	16838	31568	53.34%	16.53%	33	33
15	嘉義縣太保市	2018-11-25T00:05:15+08:00	4989	10011	15000	1129	16129	30290	53.25%	16.47%	32	33
15	嘉義縣太保市	2018-11-24T22:54:34+08:00	4468	8897	13365	1015	14380	27250	52.77%	16.4%	30	33
15	嘉義縣太保市	2018-11-24T22:41:47+08:00	4220	8391	12611	983	13594	25677	52.94%	16.43%	29	33
15	嘉義縣太保市	2018-11-24T23:43:26+08:00	4752	9415	14167	1064	15231	28761	52.96%	16.52%	31	33
15	嘉義縣太保市	2018-11-24T22:50:59+08:00	4468	8897	13365	1015	14380	27250	52.77%	16.4%	30	33
15	嘉義縣太保市	2018-11-25T01:02:41+08:00	5217	10385	15602	1236	16838	31568	53.34%	16.53%	33	33
15	嘉義縣太保市	2018-11-25T00:23:14+08:00	4989	10011	15000	1129	16129	30290	53.25%	16.47%	32	33
15	嘉義縣太保市	2018-11-25T03:32:48+08:00	5217	10385	15602	1236	16838	31568	53.34%	16.53%	33	33
15	嘉義縣太保市	2018-11-25T06:24:10+08:00	5217	10385	15602	1236	16838	31568	53.34%	16.53%	33	33
15	嘉義縣太保市	2018-11-25T00:00:21+08:00	4989	10011	15000	1129	16129	30290	53.25%	16.47%	32	33
15	嘉義縣太保市	2018-11-24T22:23:25+08:00	4220	8391	12611	983	13594	25677	52.94%	16.43%	29	33
15	嘉義縣太保市	2018-11-25T03:44:37+08:00	5217	10385	15602	1236	16838	31568	53.34%	16.53%	33	33
15	嘉義縣太保市	2018-11-24T23:23:47+08:00	4468	8897	13365	1015	14380	27250	52.77%	16.4%	30	33
15	嘉義縣太保市	2018-11-24T23:08:48+08:00	4468	8897	13365	1015	14380	27250	52.77%	16.4%	30	33
15	嘉義縣太保市	2018-11-24T22:33:47+08:00	4220	8391	12611	983	13594	25677	52.94%	16.43%	29	33
15	嘉義縣太保市	2018-11-24T22:16:22+08:00	4220	8391	12611	983	13594	25677	52.94%	16.43%	29	33
15	嘉義縣太保市	2018-11-25T01:26:03+08:00	5217	10385	15602	1236	16838	31568	53.34%	16.53%	33	33
15	嘉義縣太保市	2018-11-25T03:39:04+08:00	5217	10385	15602	1236	16838	31568	53.34%	16.53%	33	33
15	嘉義縣太保市	2018-11-24T23:16:13+08:00	4468	8897	13365	1015	14380	27250	52.77%	16.4%	30	33
15	嘉義縣太保市	2018-11-25T00:14:20+08:00	4989	10011	15000	1129	16129	30290	53.25%	16.47%	32	33
15	嘉義縣太保市	2018-11-25T03:50:01+08:00	5217	10385	15602	1236	16838	31568	53.34%	16.53%	33	33
15	嘉義縣太保市	2018-11-24T23:35:19+08:00	4752	9415	14167	1064	15231	28761	52.96%	16.52%	31	33
15	嘉義縣太保市	2018-11-24T23:47:40+08:00	4752	9415	14167	1064	15231	28761	52.96%	16.52%	31	33
15	嘉義縣太保市	2018-11-24T22:45:17+08:00	4220	8391	12611	983	13594	25677	52.94%	16.43%	29	33
15	嘉義縣太保市	2018-11-24T22:58:05+08:00	4468	8897	13365	1015	14380	27250	52.77%	16.4%	30	33
15	嘉義縣太保市	2018-11-25T00:09:46+08:00	4989	10011	15000	1129	16129	30290	53.25%	16.47%	32	33
15	嘉義縣太保市	2018-11-25T03:56:24+08:00	5217	10385	15602	1236	16838	31568	53.34%	16.53%	33	33
15	嘉義縣太保市	2018-11-24T22:26:46+08:00	4220	8391	12611	983	13594	25677	52.94%	16.43%	29	33
15	嘉義縣太保市	2018-11-24T23:01:42+08:00	4468	8897	13365	1015	14380	27250	52.77%	16.4%	30	33
15	嘉義縣太保市	2018-11-25T00:57:47+08:00	5217	10385	15602	1236	16838	31568	53.34%	16.53%	33	33
15	嘉義縣太保市	2018-11-24T22:19:46+08:00	4220	8391	12611	983	13594	25677	52.94%	16.43%	29	33
15	嘉義縣太保市	2018-11-24T22:13:41+08:00	4220	8391	12611	983	13594	25677	52.94%	16.43%	29	33
15	嘉義縣太保市	2018-11-25T04:03:02+08:00	5217	10385	15602	1236	16838	31568	53.34%	16.53%	33	33
15	嘉義縣太保市	2018-11-24T22:40:37+08:00	4220	8391	12611	983	13594	25677	52.94%	16.43%	29	33
15	嘉義縣太保市	2018-11-24T23:51:45+08:00	4752	9415	14167	1064	15231	28761	52.96%	16.52%	31	33
15	嘉義縣太保市	2018-11-24T22:30:20+08:00	4220	8391	12611	983	13594	25677	52.94%	16.43%	29	33
15	嘉義縣太保市	2018-11-25T06:09:05+08:00	5217	10385	15602	1236	16838	31568	53.34%	16.53%	33	33
15	嘉義縣太保市	2018-11-24T23:55:57+08:00	4989	10011	15000	1129	16129	30290	53.25%	16.47%	32	33
15	嘉義縣太保市	2018-11-24T23:27:27+08:00	4752	9415	14167	1064	15231	28761	52.96%	16.52%	31	33
15	嘉義縣太保市	2018-11-25T06:14:02+08:00	5217	10385	15602	1236	16838	31568	53.34%	16.53%	33	33
15	嘉義縣太保市	2018-11-25T00:18:43+08:00	4989	10011	15000	1129	16129	30290	53.25%	16.47%	32	33
15	嘉義縣太保市	2018-11-24T23:12:27+08:00	4468	8897	13365	1015	14380	27250	52.77%	16.4%	30	33
15	嘉義縣太保市	2018-11-24T23:39:28+08:00	4752	9415	14167	1064	15231	28761	52.96%	16.52%	31	33
15	嘉義縣太保市	2018-11-24T22:37:11+08:00	4220	8391	12611	983	13594	25677	52.94%	16.43%	29	33
15	嘉義縣太保市	2018-11-24T23:31:23+08:00	4752	9415	14167	1064	15231	28761	52.96%	16.52%	31	33
15	嘉義縣太保市	2018-11-24T23:20:02+08:00	4468	8897	13365	1015	14380	27250	52.77%	16.4%	30	33
15	嘉義縣太保市	2018-11-25T01:07:36+08:00	5217	10385	15602	1236	16838	31568	53.34%	16.53%	33	33
15	高雄市杉林區	2018-11-25T01:18:01+08:00	1437	2898	4335	460	4795	10607	45.21%	13.55%	10	10
15	高雄市杉林區	2018-11-24T22:26:43+08:00	1437	2898	4335	460	4795	10607	45.21%	13.55%	10	10
15	高雄市杉林區	2018-11-25T00:09:42+08:00	1437	2898	4335	460	4795	10607	45.21%	13.55%	10	10
15	高雄市杉林區	2018-11-25T03:56:21+08:00	1437	2898	4335	460	4795	10607	45.21%	13.55%	10	10
15	高雄市杉林區	2018-11-25T01:12:52+08:00	1437	2898	4335	460	4795	10607	45.21%	13.55%	10	10
15	高雄市杉林區	2018-11-24T22:37:07+08:00	1437	2898	4335	460	4795	10607	45.21%	13.55%	10	10
15	高雄市杉林區	2018-11-24T22:54:32+08:00	1437	2898	4335	460	4795	10607	45.21%	13.55%	10	10
15	高雄市杉林區	2018-11-24T22:50:56+08:00	1437	2898	4335	460	4795	10607	45.21%	13.55%	10	10
15	高雄市杉林區	2018-11-25T00:18:39+08:00	1437	2898	4335	460	4795	10607	45.21%	13.55%	10	10
15	高雄市杉林區	2018-11-25T00:05:12+08:00	1437	2898	4335	460	4795	10607	45.21%	13.55%	10	10
15	高雄市杉林區	2018-11-24T23:16:09+08:00	1437	2898	4335	460	4795	10607	45.21%	13.55%	10	10
15	高雄市杉林區	2018-11-24T22:45:15+08:00	1437	2898	4335	460	4795	10607	45.21%	13.55%	10	10
15	高雄市杉林區	2018-11-25T01:02:38+08:00	1437	2898	4335	460	4795	10607	45.21%	13.55%	10	10
15	高雄市杉林區	2018-11-25T00:57:44+08:00	1437	2898	4335	460	4795	10607	45.21%	13.55%	10	10
15	高雄市杉林區	2018-11-24T22:40:34+08:00	1437	2898	4335	460	4795	10607	45.21%	13.55%	10	10
15	高雄市杉林區	2018-11-24T22:19:43+08:00	1437	2898	4335	460	4795	10607	45.21%	13.55%	10	10
15	高雄市杉林區	2018-11-24T23:55:54+08:00	1437	2898	4335	460	4795	10607	45.21%	13.55%	10	10
15	高雄市杉林區	2018-11-24T23:27:25+08:00	1437	2898	4335	460	4795	10607	45.21%	13.55%	10	10
15	高雄市杉林區	2018-11-24T23:19:59+08:00	1437	2898	4335	460	4795	10607	45.21%	13.55%	10	10
15	高雄市杉林區	2018-11-25T00:00:17+08:00	1437	2898	4335	460	4795	10607	45.21%	13.55%	10	10
15	高雄市杉林區	2018-11-25T01:07:33+08:00	1437	2898	4335	460	4795	10607	45.21%	13.55%	10	10
15	高雄市杉林區	2018-11-24T23:31:19+08:00	1437	2898	4335	460	4795	10607	45.21%	13.55%	10	10
15	高雄市杉林區	2018-11-24T23:39:25+08:00	1437	2898	4335	460	4795	10607	45.21%	13.55%	10	10
15	高雄市杉林區	2018-11-24T23:12:24+08:00	1437	2898	4335	460	4795	10607	45.21%	13.55%	10	10
15	高雄市杉林區	2018-11-24T23:01:38+08:00	1437	2898	4335	460	4795	10607	45.21%	13.55%	10	10
15	高雄市杉林區	2018-11-24T23:35:17+08:00	1437	2898	4335	460	4795	10607	45.21%	13.55%	10	10
15	高雄市杉林區	2018-11-25T04:02:59+08:00	1437	2898	4335	460	4795	10607	45.21%	13.55%	10	10
15	高雄市杉林區	2018-11-25T00:14:17+08:00	1437	2898	4335	460	4795	10607	45.21%	13.55%	10	10
15	高雄市杉林區	2018-11-24T23:43:23+08:00	1437	2898	4335	460	4795	10607	45.21%	13.55%	10	10
15	高雄市杉林區	2018-11-24T22:58:02+08:00	1437	2898	4335	460	4795	10607	45.21%	13.55%	10	10
15	高雄市杉林區	2018-11-25T03:49:58+08:00	1437	2898	4335	460	4795	10607	45.21%	13.55%	10	10
15	高雄市杉林區	2018-11-24T23:05:11+08:00	1437	2898	4335	460	4795	10607	45.21%	13.55%	10	10
15	高雄市杉林區	2018-11-25T06:13:59+08:00	1437	2898	4335	460	4795	10607	45.21%	13.55%	10	10
15	高雄市杉林區	2018-11-24T22:41:43+08:00	1437	2898	4335	460	4795	10607	45.21%	13.55%	10	10
15	高雄市杉林區	2018-11-25T06:19:04+08:00	1437	2898	4335	460	4795	10607	45.21%	13.55%	10	10
15	高雄市杉林區	2018-11-25T06:29:24+08:00	1437	2898	4335	460	4795	10607	45.21%	13.55%	10	10
15	高雄市杉林區	2018-11-25T06:24:07+08:00	1437	2898	4335	460	4795	10607	45.21%	13.55%	10	10
15	高雄市杉林區	2018-11-24T22:30:17+08:00	1437	2898	4335	460	4795	10607	45.21%	13.55%	10	10
15	高雄市杉林區	2018-11-24T23:51:42+08:00	1437	2898	4335	460	4795	10607	45.21%	13.55%	10	10
15	高雄市杉林區	2018-11-25T06:09:02+08:00	1437	2898	4335	460	4795	10607	45.21%	13.55%	10	10
15	高雄市杉林區	2018-11-24T23:23:45+08:00	1437	2898	4335	460	4795	10607	45.21%	13.55%	10	10
15	高雄市杉林區	2018-11-25T03:44:32+08:00	1437	2898	4335	460	4795	10607	45.21%	13.55%	10	10
15	高雄市杉林區	2018-11-24T23:08:44+08:00	1437	2898	4335	460	4795	10607	45.21%	13.55%	10	10
15	高雄市杉林區	2018-11-24T22:23:21+08:00	1437	2898	4335	460	4795	10607	45.21%	13.55%	10	10
15	高雄市杉林區	2018-11-25T03:32:44+08:00	1437	2898	4335	460	4795	10607	45.21%	13.55%	10	10
15	高雄市杉林區	2018-11-24T22:13:37+08:00	1437	2898	4335	460	4795	10607	45.21%	13.55%	10	10
15	高雄市杉林區	2018-11-25T00:23:11+08:00	1437	2898	4335	460	4795	10607	45.21%	13.55%	10	10
15	高雄市杉林區	2018-11-25T01:26:00+08:00	1437	2898	4335	460	4795	10607	45.21%	13.55%	10	10
15	高雄市杉林區	2018-11-24T23:47:36+08:00	1437	2898	4335	460	4795	10607	45.21%	13.55%	10	10
15	高雄市杉林區	2018-11-25T03:39:01+08:00	1437	2898	4335	460	4795	10607	45.21%	13.55%	10	10
15	高雄市杉林區	2018-11-24T22:33:45+08:00	1437	2898	4335	460	4795	10607	45.21%	13.55%	10	10
15	高雄市杉林區	2018-11-24T22:16:18+08:00	1437	2898	4335	460	4795	10607	45.21%	13.55%	10	10
15	高雄市路竹區	2018-11-25T01:18:01+08:00	7908	16072	23980	1964	25944	43850	59.17%	18.03%	41	41
15	高雄市路竹區	2018-11-24T22:58:01+08:00	7908	16072	23980	1964	25944	43850	59.17%	18.03%	41	41
15	高雄市路竹區	2018-11-24T22:26:43+08:00	7223	14570	21793	1795	23588	39854	59.19%	18.12%	38	41
15	高雄市路竹區	2018-11-25T00:09:42+08:00	7908	16072	23980	1964	25944	43850	59.17%	18.03%	41	41
15	高雄市路竹區	2018-11-24T22:37:07+08:00	7614	15486	23100	1912	25012	42213	59.25%	18.04%	40	41
15	高雄市路竹區	2018-11-25T00:18:39+08:00	7908	16072	23980	1964	25944	43850	59.17%	18.03%	41	41
15	高雄市路竹區	2018-11-24T22:45:14+08:00	7908	16072	23980	1964	25944	43850	59.17%	18.03%	41	41
15	高雄市路竹區	2018-11-25T03:56:20+08:00	7908	16072	23980	1964	25944	43850	59.17%	18.03%	41	41
15	高雄市路竹區	2018-11-25T00:05:12+08:00	7908	16072	23980	1964	25944	43850	59.17%	18.03%	41	41
15	高雄市路竹區	2018-11-24T23:16:09+08:00	7908	16072	23980	1964	25944	43850	59.17%	18.03%	41	41
15	高雄市路竹區	2018-11-25T01:02:38+08:00	7908	16072	23980	1964	25944	43850	59.17%	18.03%	41	41
15	高雄市路竹區	2018-11-25T00:57:44+08:00	7908	16072	23980	1964	25944	43850	59.17%	18.03%	41	41
15	高雄市路竹區	2018-11-24T22:40:34+08:00	7908	16072	23980	1964	25944	43850	59.17%	18.03%	41	41
15	高雄市路竹區	2018-11-25T06:09:01+08:00	7908	16072	23980	1964	25944	43850	59.17%	18.03%	41	41
15	高雄市路竹區	2018-11-24T22:19:43+08:00	7223	14570	21793	1795	23588	39854	59.19%	18.12%	38	41
15	高雄市路竹區	2018-11-24T23:55:53+08:00	7908	16072	23980	1964	25944	43850	59.17%	18.03%	41	41
15	高雄市路竹區	2018-11-25T03:44:31+08:00	7908	16072	23980	1964	25944	43850	59.17%	18.03%	41	41
15	高雄市路竹區	2018-11-24T23:19:59+08:00	7908	16072	23980	1964	25944	43850	59.17%	18.03%	41	41
15	高雄市路竹區	2018-11-25T00:00:17+08:00	7908	16072	23980	1964	25944	43850	59.17%	18.03%	41	41
15	高雄市路竹區	2018-11-24T23:27:24+08:00	7908	16072	23980	1964	25944	43850	59.17%	18.03%	41	41
15	高雄市路竹區	2018-11-25T01:07:33+08:00	7908	16072	23980	1964	25944	43850	59.17%	18.03%	41	41
15	高雄市路竹區	2018-11-24T23:31:19+08:00	7908	16072	23980	1964	25944	43850	59.17%	18.03%	41	41
15	高雄市路竹區	2018-11-24T23:12:23+08:00	7908	16072	23980	1964	25944	43850	59.17%	18.03%	41	41
15	高雄市路竹區	2018-11-24T23:39:24+08:00	7908	16072	23980	1964	25944	43850	59.17%	18.03%	41	41
15	高雄市路竹區	2018-11-24T23:01:38+08:00	7908	16072	23980	1964	25944	43850	59.17%	18.03%	41	41
15	高雄市路竹區	2018-11-24T23:35:17+08:00	7908	16072	23980	1964	25944	43850	59.17%	18.03%	41	41
15	高雄市路竹區	2018-11-25T04:02:59+08:00	7908	16072	23980	1964	25944	43850	59.17%	18.03%	41	41
15	高雄市路竹區	2018-11-25T00:14:17+08:00	7908	16072	23980	1964	25944	43850	59.17%	18.03%	41	41
15	高雄市路竹區	2018-11-24T23:43:23+08:00	7908	16072	23980	1964	25944	43850	59.17%	18.03%	41	41
15	高雄市路竹區	2018-11-25T01:12:51+08:00	7908	16072	23980	1964	25944	43850	59.17%	18.03%	41	41
15	高雄市路竹區	2018-11-24T22:54:31+08:00	7908	16072	23980	1964	25944	43850	59.17%	18.03%	41	41
15	高雄市路竹區	2018-11-24T22:50:55+08:00	7908	16072	23980	1964	25944	43850	59.17%	18.03%	41	41
15	高雄市路竹區	2018-11-25T06:13:59+08:00	7908	16072	23980	1964	25944	43850	59.17%	18.03%	41	41
15	高雄市路竹區	2018-11-24T22:41:43+08:00	7908	16072	23980	1964	25944	43850	59.17%	18.03%	41	41
15	高雄市路竹區	2018-11-25T03:49:57+08:00	7908	16072	23980	1964	25944	43850	59.17%	18.03%	41	41
15	高雄市路竹區	2018-11-24T23:05:10+08:00	7908	16072	23980	1964	25944	43850	59.17%	18.03%	41	41
15	高雄市路竹區	2018-11-25T06:19:04+08:00	7908	16072	23980	1964	25944	43850	59.17%	18.03%	41	41
15	高雄市路竹區	2018-11-25T06:29:24+08:00	7908	16072	23980	1964	25944	43850	59.17%	18.03%	41	41
15	高雄市路竹區	2018-11-25T06:24:07+08:00	7908	16072	23980	1964	25944	43850	59.17%	18.03%	41	41
15	高雄市路竹區	2018-11-24T22:30:16+08:00	7431	15030	22461	1854	24315	41031	59.26%	18.11%	39	41
15	高雄市路竹區	2018-11-24T23:51:42+08:00	7908	16072	23980	1964	25944	43850	59.17%	18.03%	41	41
15	高雄市路竹區	2018-11-24T22:13:36+08:00	6938	13925	20863	1741	22604	38317	58.99%	18.11%	37	41
15	高雄市路竹區	2018-11-24T23:08:44+08:00	7908	16072	23980	1964	25944	43850	59.17%	18.03%	41	41
15	高雄市路竹區	2018-11-24T22:23:21+08:00	7223	14570	21793	1795	23588	39854	59.19%	18.12%	38	41
15	高雄市路竹區	2018-11-25T03:32:44+08:00	7908	16072	23980	1964	25944	43850	59.17%	18.03%	41	41
15	高雄市路竹區	2018-11-24T23:23:44+08:00	7908	16072	23980	1964	25944	43850	59.17%	18.03%	41	41
15	高雄市路竹區	2018-11-25T00:23:11+08:00	7908	16072	23980	1964	25944	43850	59.17%	18.03%	41	41
15	高雄市路竹區	2018-11-24T22:33:44+08:00	7431	15030	22461	1854	24315	41031	59.26%	18.11%	39	41
15	高雄市路竹區	2018-11-25T01:26:00+08:00	7908	16072	23980	1964	25944	43850	59.17%	18.03%	41	41
15	高雄市路竹區	2018-11-24T23:47:36+08:00	7908	16072	23980	1964	25944	43850	59.17%	18.03%	41	41
15	高雄市路竹區	2018-11-25T03:39:01+08:00	7908	16072	23980	1964	25944	43850	59.17%	18.03%	41	41
15	高雄市路竹區	2018-11-24T22:16:18+08:00	6938	13925	20863	1741	22604	38317	58.99%	18.11%	37	41
15	澎湖縣湖西鄉	2018-11-25T03:56:28+08:00	1473	3640	5113	407	5520	12741	43.32%	11.56%	23	23
15	澎湖縣湖西鄉	2018-11-24T23:47:43+08:00	1473	3640	5113	407	5520	12741	43.32%	11.56%	23	23
15	澎湖縣湖西鄉	2018-11-24T22:58:09+08:00	1360	3369	4729	353	5082	11895	42.72%	11.43%	22	23
15	澎湖縣湖西鄉	2018-11-24T23:56:01+08:00	1473	3640	5113	407	5520	12741	43.32%	11.56%	23	23
15	澎湖縣湖西鄉	2018-11-24T23:01:46+08:00	1360	3369	4729	353	5082	11895	42.72%	11.43%	22	23
15	澎湖縣湖西鄉	2018-11-24T23:12:30+08:00	1473	3640	5113	407	5520	12741	43.32%	11.56%	23	23
15	澎湖縣湖西鄉	2018-11-24T23:27:30+08:00	1473	3640	5113	407	5520	12741	43.32%	11.56%	23	23
15	澎湖縣湖西鄉	2018-11-25T06:09:09+08:00	1473	3640	5113	407	5520	12741	43.32%	11.56%	23	23
15	澎湖縣湖西鄉	2018-11-24T22:13:45+08:00	1360	3369	4729	353	5082	11895	42.72%	11.43%	22	23
15	澎湖縣湖西鄉	2018-11-25T04:03:06+08:00	1473	3640	5113	407	5520	12741	43.32%	11.56%	23	23
15	澎湖縣湖西鄉	2018-11-24T23:51:48+08:00	1473	3640	5113	407	5520	12741	43.32%	11.56%	23	23
15	澎湖縣湖西鄉	2018-11-24T22:30:23+08:00	1360	3369	4729	353	5082	11895	42.72%	11.43%	22	23
15	澎湖縣湖西鄉	2018-11-25T03:32:52+08:00	1473	3640	5113	407	5520	12741	43.32%	11.56%	23	23
15	澎湖縣湖西鄉	2018-11-25T03:44:40+08:00	1473	3640	5113	407	5520	12741	43.32%	11.56%	23	23
15	澎湖縣湖西鄉	2018-11-25T00:57:51+08:00	1473	3640	5113	407	5520	12741	43.32%	11.56%	23	23
15	澎湖縣湖西鄉	2018-11-24T22:19:50+08:00	1360	3369	4729	353	5082	11895	42.72%	11.43%	22	23
15	澎湖縣湖西鄉	2018-11-24T22:16:25+08:00	1360	3369	4729	353	5082	11895	42.72%	11.43%	22	23
15	澎湖縣湖西鄉	2018-11-25T00:09:50+08:00	1473	3640	5113	407	5520	12741	43.32%	11.56%	23	23
15	澎湖縣湖西鄉	2018-11-25T00:18:47+08:00	1473	3640	5113	407	5520	12741	43.32%	11.56%	23	23
15	澎湖縣湖西鄉	2018-11-24T22:37:14+08:00	1360	3369	4729	353	5082	11895	42.72%	11.43%	22	23
15	澎湖縣湖西鄉	2018-11-24T23:20:08+08:00	1473	3640	5113	407	5520	12741	43.32%	11.56%	23	23
15	澎湖縣湖西鄉	2018-11-24T23:31:27+08:00	1473	3640	5113	407	5520	12741	43.32%	11.56%	23	23
15	澎湖縣湖西鄉	2018-11-24T22:45:21+08:00	1360	3369	4729	353	5082	11895	42.72%	11.43%	22	23
15	澎湖縣湖西鄉	2018-11-24T23:39:33+08:00	1473	3640	5113	407	5520	12741	43.32%	11.56%	23	23
15	澎湖縣湖西鄉	2018-11-24T23:05:16+08:00	1473	3640	5113	407	5520	12741	43.32%	11.56%	23	23
15	澎湖縣湖西鄉	2018-11-24T22:26:49+08:00	1360	3369	4729	353	5082	11895	42.72%	11.43%	22	23
15	澎湖縣湖西鄉	2018-11-25T01:07:40+08:00	1473	3640	5113	407	5520	12741	43.32%	11.56%	23	23
15	澎湖縣湖西鄉	2018-11-24T22:54:37+08:00	1360	3369	4729	353	5082	11895	42.72%	11.43%	22	23
15	澎湖縣湖西鄉	2018-11-24T22:33:50+08:00	1360	3369	4729	353	5082	11895	42.72%	11.43%	22	23
15	澎湖縣湖西鄉	2018-11-25T01:12:59+08:00	1473	3640	5113	407	5520	12741	43.32%	11.56%	23	23
15	澎湖縣湖西鄉	2018-11-25T00:05:18+08:00	1473	3640	5113	407	5520	12741	43.32%	11.56%	23	23
15	澎湖縣湖西鄉	2018-11-24T23:08:51+08:00	1473	3640	5113	407	5520	12741	43.32%	11.56%	23	23
15	澎湖縣湖西鄉	2018-11-24T23:23:51+08:00	1473	3640	5113	407	5520	12741	43.32%	11.56%	23	23
15	澎湖縣湖西鄉	2018-11-25T00:23:17+08:00	1473	3640	5113	407	5520	12741	43.32%	11.56%	23	23
15	澎湖縣湖西鄉	2018-11-25T00:00:24+08:00	1473	3640	5113	407	5520	12741	43.32%	11.56%	23	23
15	澎湖縣湖西鄉	2018-11-24T22:51:03+08:00	1360	3369	4729	353	5082	11895	42.72%	11.43%	22	23
15	澎湖縣湖西鄉	2018-11-24T22:23:28+08:00	1360	3369	4729	353	5082	11895	42.72%	11.43%	22	23
15	澎湖縣湖西鄉	2018-11-24T22:40:40+08:00	1360	3369	4729	353	5082	11895	42.72%	11.43%	22	23
15	澎湖縣湖西鄉	2018-11-25T06:24:13+08:00	1473	3640	5113	407	5520	12741	43.32%	11.56%	23	23
15	澎湖縣湖西鄉	2018-11-25T01:02:44+08:00	1473	3640	5113	407	5520	12741	43.32%	11.56%	23	23
15	澎湖縣湖西鄉	2018-11-25T06:14:05+08:00	1473	3640	5113	407	5520	12741	43.32%	11.56%	23	23
15	澎湖縣湖西鄉	2018-11-25T06:19:10+08:00	1473	3640	5113	407	5520	12741	43.32%	11.56%	23	23
15	澎湖縣湖西鄉	2018-11-25T00:14:23+08:00	1473	3640	5113	407	5520	12741	43.32%	11.56%	23	23
15	澎湖縣湖西鄉	2018-11-25T01:18:10+08:00	1473	3640	5113	407	5520	12741	43.32%	11.56%	23	23
15	澎湖縣湖西鄉	2018-11-25T03:50:04+08:00	1473	3640	5113	407	5520	12741	43.32%	11.56%	23	23
15	澎湖縣湖西鄉	2018-11-25T03:39:07+08:00	1473	3640	5113	407	5520	12741	43.32%	11.56%	23	23
15	澎湖縣湖西鄉	2018-11-24T22:41:50+08:00	1360	3369	4729	353	5082	11895	42.72%	11.43%	22	23
15	澎湖縣湖西鄉	2018-11-25T06:29:31+08:00	1473	3640	5113	407	5520	12741	43.32%	11.56%	23	23
15	澎湖縣湖西鄉	2018-11-24T23:16:16+08:00	1473	3640	5113	407	5520	12741	43.32%	11.56%	23	23
15	澎湖縣湖西鄉	2018-11-24T23:35:22+08:00	1473	3640	5113	407	5520	12741	43.32%	11.56%	23	23
15	澎湖縣湖西鄉	2018-11-24T23:43:30+08:00	1473	3640	5113	407	5520	12741	43.32%	11.56%	23	23
15	澎湖縣湖西鄉	2018-11-25T01:26:08+08:00	1473	3640	5113	407	5520	12741	43.32%	11.56%	23	23
15	苗栗縣苗栗市	2018-11-24T22:26:43+08:00	8266	18137	26403	1304	27707	48052	57.66%	17.2%	45	67
15	苗栗縣苗栗市	2018-11-25T03:56:21+08:00	12854	28018	40872	1971	42843	74249	57.7%	17.31%	67	67
15	苗栗縣苗栗市	2018-11-25T01:12:52+08:00	12854	28018	40872	1971	42843	74249	57.7%	17.31%	67	67
15	苗栗縣苗栗市	2018-11-24T22:54:32+08:00	10643	23590	34233	1661	35894	62056	57.84%	17.15%	57	67
15	苗栗縣苗栗市	2018-11-25T00:09:43+08:00	12854	28018	40872	1971	42843	74249	57.7%	17.31%	67	67
15	苗栗縣苗栗市	2018-11-25T00:05:12+08:00	12854	28018	40872	1971	42843	74249	57.7%	17.31%	67	67
15	苗栗縣苗栗市	2018-11-24T22:37:08+08:00	9242	20377	29619	1454	31073	53682	57.88%	17.22%	50	67
15	苗栗縣苗栗市	2018-11-24T22:45:15+08:00	9607	21236	30843	1496	32339	55989	57.76%	17.16%	52	67
15	苗栗縣苗栗市	2018-11-24T22:50:57+08:00	10006	22182	32188	1567	33755	58406	57.79%	17.13%	54	67
15	苗栗縣苗栗市	2018-11-25T01:02:38+08:00	12854	28018	40872	1971	42843	74249	57.7%	17.31%	67	67
15	苗栗縣苗栗市	2018-11-24T22:40:35+08:00	9398	20762	30160	1467	31627	54647	57.88%	17.2%	51	67
15	苗栗縣苗栗市	2018-11-25T04:03:00+08:00	12854	28018	40872	1971	42843	74249	57.7%	17.31%	67	67
15	苗栗縣苗栗市	2018-11-25T00:57:45+08:00	12854	28018	40872	1971	42843	74249	57.7%	17.31%	67	67
15	苗栗縣苗栗市	2018-11-24T22:19:44+08:00	7699	16841	24540	1243	25783	44857	57.48%	17.16%	42	67
15	苗栗縣苗栗市	2018-11-25T06:14:00+08:00	12854	28018	40872	1971	42843	74249	57.7%	17.31%	67	67
15	苗栗縣苗栗市	2018-11-25T00:00:18+08:00	12854	28018	40872	1971	42843	74249	57.7%	17.31%	67	67
15	苗栗縣苗栗市	2018-11-24T23:27:25+08:00	12854	28018	40872	1971	42843	74249	57.7%	17.31%	67	67
15	苗栗縣苗栗市	2018-11-24T23:55:55+08:00	12854	28018	40872	1971	42843	74249	57.7%	17.31%	67	67
15	苗栗縣苗栗市	2018-11-24T22:23:22+08:00	8098	17741	25839	1286	27125	47042	57.66%	17.21%	44	67
15	苗栗縣苗栗市	2018-11-24T23:01:39+08:00	10643	23590	34233	1661	35894	62056	57.84%	17.15%	57	67
15	苗栗縣苗栗市	2018-11-24T23:39:25+08:00	12854	28018	40872	1971	42843	74249	57.7%	17.31%	67	67
15	苗栗縣苗栗市	2018-11-24T23:20:00+08:00	12854	28018	40872	1971	42843	74249	57.7%	17.31%	67	67
15	苗栗縣苗栗市	2018-11-25T01:07:34+08:00	12854	28018	40872	1971	42843	74249	57.7%	17.31%	67	67
15	苗栗縣苗栗市	2018-11-24T23:12:24+08:00	12336	26630	38966	1866	40832	70701	57.75%	17.45%	64	67
15	苗栗縣苗栗市	2018-11-25T00:18:40+08:00	12854	28018	40872	1971	42843	74249	57.7%	17.31%	67	67
15	苗栗縣苗栗市	2018-11-25T03:39:02+08:00	12854	28018	40872	1971	42843	74249	57.7%	17.31%	67	67
15	苗栗縣苗栗市	2018-11-24T23:31:20+08:00	12854	28018	40872	1971	42843	74249	57.7%	17.31%	67	67
15	苗栗縣苗栗市	2018-11-24T23:35:17+08:00	12854	28018	40872	1971	42843	74249	57.7%	17.31%	67	67
15	苗栗縣苗栗市	2018-11-25T00:14:17+08:00	12854	28018	40872	1971	42843	74249	57.7%	17.31%	67	67
15	苗栗縣苗栗市	2018-11-24T23:43:24+08:00	12854	28018	40872	1971	42843	74249	57.7%	17.31%	67	67
15	苗栗縣苗栗市	2018-11-24T22:58:02+08:00	10643	23590	34233	1661	35894	62056	57.84%	17.15%	57	67
15	苗栗縣苗栗市	2018-11-25T03:49:58+08:00	12854	28018	40872	1971	42843	74249	57.7%	17.31%	67	67
15	苗栗縣苗栗市	2018-11-25T01:18:02+08:00	12854	28018	40872	1971	42843	74249	57.7%	17.31%	67	67
15	苗栗縣苗栗市	2018-11-25T06:29:25+08:00	12854	28018	40872	1971	42843	74249	57.7%	17.31%	67	67
15	苗栗縣苗栗市	2018-11-25T06:19:05+08:00	12854	28018	40872	1971	42843	74249	57.7%	17.31%	67	67
15	苗栗縣苗栗市	2018-11-24T23:05:11+08:00	11296	25047	36343	1759	38102	65949	57.77%	17.13%	60	67
15	苗栗縣苗栗市	2018-11-24T22:41:44+08:00	9398	20762	30160	1467	31627	54647	57.88%	17.2%	51	67
15	苗栗縣苗栗市	2018-11-24T23:51:43+08:00	12854	28018	40872	1971	42843	74249	57.7%	17.31%	67	67
15	苗栗縣苗栗市	2018-11-24T22:30:17+08:00	8540	18681	27221	1356	28577	49428	57.82%	17.28%	46	67
15	苗栗縣苗栗市	2018-11-25T06:24:08+08:00	12854	28018	40872	1971	42843	74249	57.7%	17.31%	67	67
15	苗栗縣苗栗市	2018-11-25T06:09:02+08:00	12854	28018	40872	1971	42843	74249	57.7%	17.31%	67	67
15	苗栗縣苗栗市	2018-11-24T23:23:45+08:00	12854	28018	40872	1971	42843	74249	57.7%	17.31%	67	67
15	苗栗縣苗栗市	2018-11-25T03:44:32+08:00	12854	28018	40872	1971	42843	74249	57.7%	17.31%	67	67
15	苗栗縣苗栗市	2018-11-25T03:32:45+08:00	12854	28018	40872	1971	42843	74249	57.7%	17.31%	67	67
15	苗栗縣苗栗市	2018-11-24T22:13:38+08:00	7318	15948	23266	1186	24452	42686	57.28%	17.14%	40	67
15	苗栗縣苗栗市	2018-11-24T23:08:45+08:00	11735	26032	37767	1808	39575	68511	57.76%	17.13%	62	67
15	苗栗縣苗栗市	2018-11-25T00:23:11+08:00	12854	28018	40872	1971	42843	74249	57.7%	17.31%	67	67
15	苗栗縣苗栗市	2018-11-24T23:16:10+08:00	12854	28018	40872	1971	42843	74249	57.7%	17.31%	67	67
15	苗栗縣苗栗市	2018-11-24T23:47:37+08:00	12854	28018	40872	1971	42843	74249	57.7%	17.31%	67	67
15	苗栗縣苗栗市	2018-11-24T22:16:19+08:00	7522	16359	23881	1212	25093	43738	57.37%	17.2%	41	67
15	苗栗縣苗栗市	2018-11-25T01:26:01+08:00	12854	28018	40872	1971	42843	74249	57.7%	17.31%	67	67
15	苗栗縣苗栗市	2018-11-24T22:33:45+08:00	9079	19977	29056	1425	30481	52635	57.91%	17.25%	49	67
15	苗栗縣南庄鄉	2018-11-24T22:26:44+08:00	1011	2406	3417	223	3640	7431	48.98%	13.61%	8	9
15	苗栗縣南庄鄉	2018-11-25T00:05:13+08:00	1189	2880	4069	270	4339	8784	49.4%	13.54%	9	9
15	苗栗縣南庄鄉	2018-11-24T23:05:12+08:00	1189	2880	4069	270	4339	8784	49.4%	13.54%	9	9
15	苗栗縣南庄鄉	2018-11-25T00:09:43+08:00	1189	2880	4069	270	4339	8784	49.4%	13.54%	9	9
15	苗栗縣南庄鄉	2018-11-24T22:37:08+08:00	1189	2880	4069	270	4339	8784	49.4%	13.54%	9	9
15	苗栗縣南庄鄉	2018-11-24T22:54:33+08:00	1189	2880	4069	270	4339	8784	49.4%	13.54%	9	9
15	苗栗縣南庄鄉	2018-11-24T22:50:57+08:00	1189	2880	4069	270	4339	8784	49.4%	13.54%	9	9
15	苗栗縣南庄鄉	2018-11-25T01:12:53+08:00	1189	2880	4069	270	4339	8784	49.4%	13.54%	9	9
15	苗栗縣南庄鄉	2018-11-24T22:40:35+08:00	1189	2880	4069	270	4339	8784	49.4%	13.54%	9	9
15	苗栗縣南庄鄉	2018-11-25T01:02:39+08:00	1189	2880	4069	270	4339	8784	49.4%	13.54%	9	9
15	苗栗縣南庄鄉	2018-11-25T04:03:00+08:00	1189	2880	4069	270	4339	8784	49.4%	13.54%	9	9
15	苗栗縣南庄鄉	2018-11-25T00:57:45+08:00	1189	2880	4069	270	4339	8784	49.4%	13.54%	9	9
15	苗栗縣南庄鄉	2018-11-24T22:19:44+08:00	1011	2406	3417	223	3640	7431	48.98%	13.61%	8	9
15	苗栗縣南庄鄉	2018-11-25T06:14:00+08:00	1189	2880	4069	270	4339	8784	49.4%	13.54%	9	9
15	苗栗縣南庄鄉	2018-11-24T23:23:46+08:00	1189	2880	4069	270	4339	8784	49.4%	13.54%	9	9
15	苗栗縣南庄鄉	2018-11-25T03:32:46+08:00	1189	2880	4069	270	4339	8784	49.4%	13.54%	9	9
15	苗栗縣南庄鄉	2018-11-24T23:55:55+08:00	1189	2880	4069	270	4339	8784	49.4%	13.54%	9	9
15	苗栗縣南庄鄉	2018-11-25T00:00:19+08:00	1189	2880	4069	270	4339	8784	49.4%	13.54%	9	9
15	苗栗縣南庄鄉	2018-11-25T00:23:12+08:00	1189	2880	4069	270	4339	8784	49.4%	13.54%	9	9
15	苗栗縣南庄鄉	2018-11-24T22:23:22+08:00	1011	2406	3417	223	3640	7431	48.98%	13.61%	8	9
15	苗栗縣南庄鄉	2018-11-24T23:01:39+08:00	1189	2880	4069	270	4339	8784	49.4%	13.54%	9	9
15	苗栗縣南庄鄉	2018-11-24T23:31:21+08:00	1189	2880	4069	270	4339	8784	49.4%	13.54%	9	9
15	苗栗縣南庄鄉	2018-11-24T23:20:00+08:00	1189	2880	4069	270	4339	8784	49.4%	13.54%	9	9
15	苗栗縣南庄鄉	2018-11-25T01:07:34+08:00	1189	2880	4069	270	4339	8784	49.4%	13.54%	9	9
15	苗栗縣南庄鄉	2018-11-24T23:35:18+08:00	1189	2880	4069	270	4339	8784	49.4%	13.54%	9	9
15	苗栗縣南庄鄉	2018-11-25T00:14:18+08:00	1189	2880	4069	270	4339	8784	49.4%	13.54%	9	9
15	苗栗縣南庄鄉	2018-11-24T23:12:25+08:00	1189	2880	4069	270	4339	8784	49.4%	13.54%	9	9
15	苗栗縣南庄鄉	2018-11-25T03:39:02+08:00	1189	2880	4069	270	4339	8784	49.4%	13.54%	9	9
15	苗栗縣南庄鄉	2018-11-24T22:33:46+08:00	1011	2406	3417	223	3640	7431	48.98%	13.61%	8	9
15	苗栗縣南庄鄉	2018-11-25T00:18:41+08:00	1189	2880	4069	270	4339	8784	49.4%	13.54%	9	9
15	苗栗縣南庄鄉	2018-11-24T23:43:24+08:00	1189	2880	4069	270	4339	8784	49.4%	13.54%	9	9
15	苗栗縣南庄鄉	2018-11-25T03:56:22+08:00	1189	2880	4069	270	4339	8784	49.4%	13.54%	9	9
15	苗栗縣南庄鄉	2018-11-25T06:29:25+08:00	1189	2880	4069	270	4339	8784	49.4%	13.54%	9	9
15	苗栗縣南庄鄉	2018-11-25T06:19:05+08:00	1189	2880	4069	270	4339	8784	49.4%	13.54%	9	9
15	苗栗縣南庄鄉	2018-11-24T22:45:16+08:00	1189	2880	4069	270	4339	8784	49.4%	13.54%	9	9
15	苗栗縣南庄鄉	2018-11-24T22:41:44+08:00	1189	2880	4069	270	4339	8784	49.4%	13.54%	9	9
15	苗栗縣南庄鄉	2018-11-25T01:18:03+08:00	1189	2880	4069	270	4339	8784	49.4%	13.54%	9	9
15	苗栗縣南庄鄉	2018-11-25T03:49:59+08:00	1189	2880	4069	270	4339	8784	49.4%	13.54%	9	9
15	苗栗縣南庄鄉	2018-11-24T22:58:03+08:00	1189	2880	4069	270	4339	8784	49.4%	13.54%	9	9
15	苗栗縣南庄鄉	2018-11-25T06:09:03+08:00	1189	2880	4069	270	4339	8784	49.4%	13.54%	9	9
15	苗栗縣南庄鄉	2018-11-24T23:51:43+08:00	1189	2880	4069	270	4339	8784	49.4%	13.54%	9	9
15	苗栗縣南庄鄉	2018-11-25T06:24:08+08:00	1189	2880	4069	270	4339	8784	49.4%	13.54%	9	9
15	苗栗縣南庄鄉	2018-11-24T22:30:18+08:00	1011	2406	3417	223	3640	7431	48.98%	13.61%	8	9
15	苗栗縣南庄鄉	2018-11-24T23:27:26+08:00	1189	2880	4069	270	4339	8784	49.4%	13.54%	9	9
15	苗栗縣南庄鄉	2018-11-24T23:08:45+08:00	1189	2880	4069	270	4339	8784	49.4%	13.54%	9	9
15	苗栗縣南庄鄉	2018-11-24T22:13:39+08:00	1011	2406	3417	223	3640	7431	48.98%	13.61%	8	9
15	苗栗縣南庄鄉	2018-11-25T03:44:33+08:00	1189	2880	4069	270	4339	8784	49.4%	13.54%	9	9
15	苗栗縣南庄鄉	2018-11-24T23:16:10+08:00	1189	2880	4069	270	4339	8784	49.4%	13.54%	9	9
15	苗栗縣南庄鄉	2018-11-24T23:47:37+08:00	1189	2880	4069	270	4339	8784	49.4%	13.54%	9	9
15	苗栗縣南庄鄉	2018-11-24T22:16:19+08:00	1011	2406	3417	223	3640	7431	48.98%	13.61%	8	9
15	苗栗縣南庄鄉	2018-11-24T23:39:26+08:00	1189	2880	4069	270	4339	8784	49.4%	13.54%	9	9
15	苗栗縣南庄鄉	2018-11-25T01:26:01+08:00	1189	2880	4069	270	4339	8784	49.4%	13.54%	9	9
15	高雄市鳳山區	2018-11-24T22:58:01+08:00	34613	69857	104470	6111	110581	185185	59.71%	18.69%	152	228
15	高雄市鳳山區	2018-11-24T22:45:14+08:00	31152	62710	93862	5483	99345	166542	59.65%	18.71%	138	228
15	高雄市鳳山區	2018-11-25T03:56:20+08:00	55770	113855	169625	9216	178841	300510	59.51%	18.56%	228	228
15	高雄市鳳山區	2018-11-24T22:26:42+08:00	25548	50859	76407	4563	80970	135788	59.63%	18.81%	116	228
15	高雄市鳳山區	2018-11-25T01:18:00+08:00	54191	110317	164508	8944	173452	291431	59.52%	18.59%	223	228
15	高雄市鳳山區	2018-11-24T23:16:09+08:00	38183	77104	115287	6694	121981	204356	59.69%	18.68%	167	228
15	高雄市鳳山區	2018-11-25T00:18:38+08:00	48618	99021	147639	8302	155941	261666	59.6%	18.58%	206	228
15	高雄市鳳山區	2018-11-24T22:37:06+08:00	29267	58588	87855	5218	93073	156199	59.59%	18.74%	131	228
15	高雄市鳳山區	2018-11-25T01:25:59+08:00	54571	111189	165760	8994	174754	293528	59.54%	18.59%	224	228
15	高雄市鳳山區	2018-11-25T00:57:43+08:00	52522	106553	159075	8715	167790	281439	59.62%	18.66%	218	228
15	高雄市鳳山區	2018-11-25T01:02:37+08:00	53234	107872	161106	8807	169913	285291	59.56%	18.66%	220	228
15	高雄市鳳山區	2018-11-24T22:40:33+08:00	30374	60837	91211	5334	96545	161908	59.63%	18.76%	135	228
15	高雄市鳳山區	2018-11-24T23:51:41+08:00	44495	89957	134452	7654	142106	237968	59.72%	18.7%	190	228
15	高雄市鳳山區	2018-11-25T06:09:01+08:00	55770	113855	169625	9216	178841	300510	59.51%	18.56%	228	228
15	高雄市鳳山區	2018-11-24T22:19:43+08:00	24315	48431	72746	4399	77145	129373	59.63%	18.79%	111	228
15	高雄市鳳山區	2018-11-24T23:55:53+08:00	44495	89957	134452	7654	142106	237968	59.72%	18.7%	190	228
15	高雄市鳳山區	2018-11-25T03:44:31+08:00	55461	113111	168572	9154	177726	298465	59.55%	18.58%	227	228
15	高雄市鳳山區	2018-11-25T00:00:17+08:00	44958	91131	136089	7744	143833	240964	59.69%	18.66%	192	228
15	高雄市鳳山區	2018-11-24T23:19:58+08:00	38725	78154	116879	6780	123659	207070	59.72%	18.7%	169	228
15	高雄市鳳山區	2018-11-24T23:27:24+08:00	39793	80367	120160	6986	127146	213270	59.62%	18.66%	173	228
15	高雄市鳳山區	2018-11-24T23:31:19+08:00	41529	83845	125374	7173	132547	222305	59.62%	18.68%	179	228
15	高雄市鳳山區	2018-11-24T23:01:37+08:00	35247	71227	106474	6258	112732	188885	59.68%	18.66%	155	228
15	高雄市鳳山區	2018-11-24T23:12:23+08:00	36975	74633	111608	6518	118126	197571	59.79%	18.71%	162	228
15	高雄市鳳山區	2018-11-25T04:02:58+08:00	55770	113855	169625	9216	178841	300510	59.51%	18.56%	228	228
15	高雄市鳳山區	2018-11-25T00:14:16+08:00	48382	98537	146919	8195	155114	260234	59.61%	18.59%	205	228
15	高雄市鳳山區	2018-11-24T23:35:16+08:00	42283	85540	127823	7330	135153	226459	59.68%	18.67%	182	228
15	高雄市鳳山區	2018-11-24T23:39:24+08:00	42283	85540	127823	7330	135153	226459	59.68%	18.67%	182	228
15	高雄市鳳山區	2018-11-25T01:07:32+08:00	53612	108765	162377	8858	171235	287546	59.55%	18.64%	221	228
15	高雄市鳳山區	2018-11-24T23:47:35+08:00	43991	88939	132930	7572	140502	235324	59.71%	18.69%	188	228
15	高雄市鳳山區	2018-11-24T23:43:23+08:00	42858	86672	129530	7432	136962	229444	59.69%	18.68%	184	228
15	高雄市鳳山區	2018-11-24T22:41:42+08:00	30374	60837	91211	5334	96545	161908	59.63%	18.76%	135	228
15	高雄市鳳山區	2018-11-25T01:12:51+08:00	53869	109675	163544	8920	172464	289719	59.53%	18.59%	222	228
15	高雄市鳳山區	2018-11-25T06:13:58+08:00	55770	113855	169625	9216	178841	300510	59.51%	18.56%	228	228
15	高雄市鳳山區	2018-11-24T22:54:31+08:00	34131	68896	103027	6029	109056	182721	59.68%	18.68%	150	228
15	高雄市鳳山區	2018-11-24T22:50:55+08:00	33457	67506	100963	5897	106860	179253	59.61%	18.66%	147	228
15	高雄市鳳山區	2018-11-25T00:09:41+08:00	47630	97025	144655	8066	152721	256105	59.63%	18.6%	202	228
15	高雄市鳳山區	2018-11-25T03:49:57+08:00	55770	113855	169625	9216	178841	300510	59.51%	18.56%	228	228
15	高雄市鳳山區	2018-11-24T23:05:10+08:00	36329	73330	109659	6422	116081	194227	59.77%	18.7%	159	228
15	高雄市鳳山區	2018-11-25T06:19:03+08:00	55770	113855	169625	9216	178841	300510	59.51%	18.56%	228	228
15	高雄市鳳山區	2018-11-25T06:29:24+08:00	55770	113855	169625	9216	178841	300510	59.51%	18.56%	228	228
15	高雄市鳳山區	2018-11-25T00:05:11+08:00	46441	94115	140556	7888	148444	248959	59.63%	18.65%	197	228
15	高雄市鳳山區	2018-11-25T06:24:06+08:00	55770	113855	169625	9216	178841	300510	59.51%	18.56%	228	228
15	高雄市鳳山區	2018-11-24T22:30:16+08:00	26362	52572	78934	4727	83661	140503	59.54%	18.76%	119	228
15	高雄市鳳山區	2018-11-24T22:13:36+08:00	23000	45286	68286	4092	72378	120945	59.84%	19.02%	105	228
15	高雄市鳳山區	2018-11-24T23:08:43+08:00	36822	74267	111089	6471	117560	196603	59.8%	18.73%	161	228
15	高雄市鳳山區	2018-11-24T22:23:20+08:00	24559	48825	73384	4421	77805	130594	59.58%	18.81%	112	228
15	高雄市鳳山區	2018-11-25T00:23:10+08:00	49276	100379	149655	8372	158027	265129	59.6%	18.59%	208	228
15	高雄市鳳山區	2018-11-25T03:32:43+08:00	55461	113111	168572	9154	177726	298465	59.55%	18.58%	227	228
15	高雄市鳳山區	2018-11-24T23:23:44+08:00	39492	79832	119324	6966	126290	211745	59.64%	18.65%	172	228
15	高雄市鳳山區	2018-11-24T22:33:44+08:00	28294	56706	85000	5057	90057	151363	59.5%	18.69%	127	228
15	高雄市鳳山區	2018-11-24T22:16:17+08:00	23985	47250	71235	4302	75537	126574	59.68%	18.95%	109	228
15	高雄市鳳山區	2018-11-25T03:39:01+08:00	55461	113111	168572	9154	177726	298465	59.55%	18.58%	227	228
15	高雄市鼓山區	2018-11-24T23:16:08+08:00	12796	25532	38328	2191	40519	68651	59.02%	18.64%	52	77
15	高雄市鼓山區	2018-11-25T03:56:19+08:00	22321	42999	65320	3097	68417	114979	59.5%	19.41%	77	77
15	高雄市鼓山區	2018-11-24T22:45:14+08:00	8931	18159	27090	1714	28804	49409	58.3%	18.08%	40	77
15	高雄市鼓山區	2018-11-24T22:58:00+08:00	10639	21425	32064	1912	33976	57897	58.68%	18.38%	45	77
15	高雄市鼓山區	2018-11-24T22:26:42+08:00	7645	15539	23184	1528	24712	42405	58.28%	18.03%	35	77
15	高雄市鼓山區	2018-11-25T01:18:00+08:00	21323	40971	62294	2975	65269	109881	59.4%	19.41%	74	77
15	高雄市鼓山區	2018-11-25T00:18:38+08:00	17635	34186	51821	2562	54383	91313	59.56%	19.31%	64	77
15	高雄市鼓山區	2018-11-24T22:37:06+08:00	8483	17129	25612	1656	27268	46775	58.3%	18.14%	38	77
15	高雄市鼓山區	2018-11-25T06:09:00+08:00	22321	42999	65320	3097	68417	114979	59.5%	19.41%	77	77
15	高雄市鼓山區	2018-11-25T01:25:59+08:00	21323	40971	62294	2975	65269	109881	59.4%	19.41%	74	77
15	高雄市鼓山區	2018-11-25T00:57:43+08:00	20556	39458	60014	2925	62939	106102	59.32%	19.37%	72	77
15	高雄市鼓山區	2018-11-24T22:19:42+08:00	6694	13722	20416	1391	21807	37461	58.21%	17.87%	32	77
15	高雄市鼓山區	2018-11-25T01:02:37+08:00	20556	39458	60014	2925	62939	106102	59.32%	19.37%	72	77
15	高雄市鼓山區	2018-11-24T22:40:33+08:00	8685	17587	26272	1692	27964	48016	58.24%	18.09%	39	77
15	高雄市鼓山區	2018-11-24T23:51:41+08:00	16543	32246	48789	2475	51264	85876	59.7%	19.26%	61	77
15	高雄市鼓山區	2018-11-24T22:13:35+08:00	5905	11947	17852	1281	19133	32776	58.38%	18.02%	29	77
15	高雄市鼓山區	2018-11-24T23:55:52+08:00	16543	32246	48789	2475	51264	85876	59.7%	19.26%	61	77
15	高雄市鼓山區	2018-11-25T00:00:17+08:00	16543	32246	48789	2475	51264	85876	59.7%	19.26%	61	77
15	高雄市鼓山區	2018-11-24T23:19:58+08:00	13345	26309	39654	2214	41868	70610	59.29%	18.9%	53	77
15	高雄市鼓山區	2018-11-24T23:27:24+08:00	14476	28492	42968	2311	45279	76191	59.43%	19%	56	77
15	高雄市鼓山區	2018-11-25T03:44:30+08:00	22321	42999	65320	3097	68417	114979	59.5%	19.41%	77	77
15	高雄市鼓山區	2018-11-24T23:01:37+08:00	11199	22508	33707	1989	35696	60779	58.73%	18.43%	47	77
15	高雄市鼓山區	2018-11-25T04:02:58+08:00	22321	42999	65320	3097	68417	114979	59.5%	19.41%	77	77
15	高雄市鼓山區	2018-11-25T00:14:16+08:00	17635	34186	51821	2562	54383	91313	59.56%	19.31%	64	77
15	高雄市鼓山區	2018-11-24T23:35:16+08:00	15237	30044	45281	2371	47652	80093	59.5%	19.02%	58	77
15	高雄市鼓山區	2018-11-24T23:12:22+08:00	12192	24391	36583	2124	38707	65666	58.95%	18.57%	50	77
15	高雄市鼓山區	2018-11-24T23:31:18+08:00	14476	28492	42968	2311	45279	76191	59.43%	19%	56	77
15	高雄市鼓山區	2018-11-24T23:39:23+08:00	15237	30044	45281	2371	47652	80093	59.5%	19.02%	58	77
15	高雄市鼓山區	2018-11-25T01:07:32+08:00	21323	40971	62294	2975	65269	109881	59.4%	19.41%	74	77
15	高雄市鼓山區	2018-11-24T23:47:35+08:00	16092	31508	47600	2445	50045	83878	59.66%	19.19%	60	77
15	高雄市鼓山區	2018-11-24T22:41:42+08:00	8685	17587	26272	1692	27964	48016	58.24%	18.09%	39	77
15	高雄市鼓山區	2018-11-25T06:13:58+08:00	22321	42999	65320	3097	68417	114979	59.5%	19.41%	77	77
15	高雄市鼓山區	2018-11-24T22:54:31+08:00	10158	20645	30803	1875	32678	55750	58.62%	18.22%	44	77
15	高雄市鼓山區	2018-11-24T22:50:55+08:00	9137	18614	27751	1766	29517	50615	58.32%	18.05%	41	77
15	高雄市鼓山區	2018-11-25T00:09:41+08:00	17635	34186	51821	2562	54383	91313	59.56%	19.31%	64	77
15	高雄市鼓山區	2018-11-25T01:12:50+08:00	21323	40971	62294	2975	65269	109881	59.4%	19.41%	74	77
15	高雄市鼓山區	2018-11-24T23:43:22+08:00	16092	31508	47600	2445	50045	83878	59.66%	19.19%	60	77
15	高雄市鼓山區	2018-11-25T06:29:23+08:00	22321	42999	65320	3097	68417	114979	59.5%	19.41%	77	77
15	高雄市鼓山區	2018-11-25T03:49:57+08:00	22321	42999	65320	3097	68417	114979	59.5%	19.41%	77	77
15	高雄市鼓山區	2018-11-24T23:05:10+08:00	11695	23484	35179	2089	37268	63304	58.87%	18.47%	49	77
15	高雄市鼓山區	2018-11-25T06:19:03+08:00	22321	42999	65320	3097	68417	114979	59.5%	19.41%	77	77
15	高雄市鼓山區	2018-11-25T00:05:11+08:00	17240	33537	50777	2544	53321	89426	59.63%	19.28%	63	77
15	高雄市鼓山區	2018-11-25T06:24:06+08:00	22321	42999	65320	3097	68417	114979	59.5%	19.41%	77	77
15	高雄市鼓山區	2018-11-24T22:30:16+08:00	8016	16214	24230	1558	25788	44265	58.26%	18.11%	36	77
15	高雄市鼓山區	2018-11-24T23:08:43+08:00	12192	24391	36583	2124	38707	65666	58.95%	18.57%	50	77
15	高雄市鼓山區	2018-11-24T22:23:20+08:00	6996	14392	21388	1429	22817	39206	58.2%	17.84%	33	77
15	高雄市鼓山區	2018-11-25T00:23:10+08:00	18001	34852	52853	2613	55466	93122	59.56%	19.33%	65	77
15	高雄市鼓山區	2018-11-25T03:32:43+08:00	22321	42999	65320	3097	68417	114979	59.5%	19.41%	77	77
15	高雄市鼓山區	2018-11-24T23:23:44+08:00	14126	27760	41886	2267	44153	74324	59.41%	19.01%	55	77
15	高雄市鼓山區	2018-11-24T22:33:44+08:00	8252	16738	24990	1581	26571	45417	58.5%	18.17%	37	77
15	高雄市鼓山區	2018-11-24T22:16:17+08:00	6306	12639	18945	1316	20261	34688	58.41%	18.18%	30	77
15	高雄市鼓山區	2018-11-25T03:39:00+08:00	22321	42999	65320	3097	68417	114979	59.5%	19.41%	77	77
15	南投縣名間鄉	2018-11-25T00:05:14+08:00	5405	13160	18565	1467	20032	33408	59.96%	16.18%	37	37
15	南投縣名間鄉	2018-11-25T06:19:06+08:00	5405	13160	18565	1467	20032	33408	59.96%	16.18%	37	37
15	南投縣名間鄉	2018-11-24T23:05:12+08:00	4859	11884	16743	1293	18036	30077	59.97%	16.16%	34	37
15	南投縣名間鄉	2018-11-25T00:09:45+08:00	5405	13160	18565	1467	20032	33408	59.96%	16.18%	37	37
15	南投縣名間鄉	2018-11-24T22:50:58+08:00	4534	11184	15718	1201	16919	28169	60.06%	16.1%	32	37
15	南投縣名間鄉	2018-11-24T22:41:46+08:00	4534	11184	15718	1201	16919	28169	60.06%	16.1%	32	37
15	南投縣名間鄉	2018-11-24T22:37:09+08:00	4534	11184	15718	1201	16919	28169	60.06%	16.1%	32	37
15	南投縣名間鄉	2018-11-25T06:29:27+08:00	5405	13160	18565	1467	20032	33408	59.96%	16.18%	37	37
15	南投縣名間鄉	2018-11-24T23:01:41+08:00	4859	11884	16743	1293	18036	30077	59.97%	16.16%	34	37
15	南投縣名間鄉	2018-11-24T22:26:45+08:00	3817	9397	13214	1022	14236	23777	59.87%	16.05%	28	37
15	南投縣名間鄉	2018-11-24T22:54:34+08:00	4859	11884	16743	1293	18036	30077	59.97%	16.16%	34	37
15	南投縣名間鄉	2018-11-25T01:12:54+08:00	5405	13160	18565	1467	20032	33408	59.96%	16.18%	37	37
15	南投縣名間鄉	2018-11-24T22:19:45+08:00	3817	9397	13214	1022	14236	23777	59.87%	16.05%	28	37
15	南投縣名間鄉	2018-11-25T04:03:01+08:00	5405	13160	18565	1467	20032	33408	59.96%	16.18%	37	37
15	南投縣名間鄉	2018-11-25T00:00:20+08:00	5405	13160	18565	1467	20032	33408	59.96%	16.18%	37	37
15	南投縣名間鄉	2018-11-25T00:23:13+08:00	5405	13160	18565	1467	20032	33408	59.96%	16.18%	37	37
15	南投縣名間鄉	2018-11-24T22:23:24+08:00	3817	9397	13214	1022	14236	23777	59.87%	16.05%	28	37
15	南投縣名間鄉	2018-11-25T01:02:40+08:00	5405	13160	18565	1467	20032	33408	59.96%	16.18%	37	37
15	南投縣名間鄉	2018-11-25T06:14:01+08:00	5405	13160	18565	1467	20032	33408	59.96%	16.18%	37	37
15	南投縣名間鄉	2018-11-25T03:32:47+08:00	5405	13160	18565	1467	20032	33408	59.96%	16.18%	37	37
15	南投縣名間鄉	2018-11-24T23:08:46+08:00	5020	12227	17247	1358	18605	31007	60%	16.19%	35	37
15	南投縣名間鄉	2018-11-24T23:23:47+08:00	5200	12667	17867	1408	19275	32134	59.98%	16.18%	36	37
15	南投縣名間鄉	2018-11-25T03:50:00+08:00	5405	13160	18565	1467	20032	33408	59.96%	16.18%	37	37
15	南投縣名間鄉	2018-11-25T03:39:03+08:00	5405	13160	18565	1467	20032	33408	59.96%	16.18%	37	37
15	南投縣名間鄉	2018-11-25T01:26:02+08:00	5405	13160	18565	1467	20032	33408	59.96%	16.18%	37	37
15	南投縣名間鄉	2018-11-24T23:20:01+08:00	5200	12667	17867	1408	19275	32134	59.98%	16.18%	36	37
15	南投縣名間鄉	2018-11-25T01:07:35+08:00	5405	13160	18565	1467	20032	33408	59.96%	16.18%	37	37
15	南投縣名間鄉	2018-11-24T22:33:46+08:00	4349	10686	15035	1158	16193	26908	60.18%	16.16%	31	37
15	南投縣名間鄉	2018-11-25T00:14:19+08:00	5405	13160	18565	1467	20032	33408	59.96%	16.18%	37	37
15	南投縣名間鄉	2018-11-24T23:16:12+08:00	5200	12667	17867	1408	19275	32134	59.98%	16.18%	36	37
15	南投縣名間鄉	2018-11-24T23:35:19+08:00	5405	13160	18565	1467	20032	33408	59.96%	16.18%	37	37
15	南投縣名間鄉	2018-11-24T22:45:16+08:00	4534	11184	15718	1201	16919	28169	60.06%	16.1%	32	37
15	南投縣名間鄉	2018-11-24T23:43:25+08:00	5405	13160	18565	1467	20032	33408	59.96%	16.18%	37	37
15	南投縣名間鄉	2018-11-25T03:56:23+08:00	5405	13160	18565	1467	20032	33408	59.96%	16.18%	37	37
15	南投縣名間鄉	2018-11-24T22:58:04+08:00	4859	11884	16743	1293	18036	30077	59.97%	16.16%	34	37
15	南投縣名間鄉	2018-11-25T01:18:04+08:00	5405	13160	18565	1467	20032	33408	59.96%	16.18%	37	37
15	南投縣名間鄉	2018-11-25T06:24:09+08:00	5405	13160	18565	1467	20032	33408	59.96%	16.18%	37	37
15	南投縣名間鄉	2018-11-25T06:09:04+08:00	5405	13160	18565	1467	20032	33408	59.96%	16.18%	37	37
15	南投縣名間鄉	2018-11-24T23:51:44+08:00	5405	13160	18565	1467	20032	33408	59.96%	16.18%	37	37
15	南投縣名間鄉	2018-11-24T22:40:36+08:00	4534	11184	15718	1201	16919	28169	60.06%	16.1%	32	37
15	南投縣名間鄉	2018-11-24T22:30:19+08:00	3817	9397	13214	1022	14236	23777	59.87%	16.05%	28	37
15	南投縣名間鄉	2018-11-24T22:13:40+08:00	3602	8997	12599	988	13587	22722	59.8%	15.85%	27	37
15	南投縣名間鄉	2018-11-25T00:57:46+08:00	5405	13160	18565	1467	20032	33408	59.96%	16.18%	37	37
15	南投縣名間鄉	2018-11-24T23:27:26+08:00	5200	12667	17867	1408	19275	32134	59.98%	16.18%	36	37
15	南投縣名間鄉	2018-11-25T03:44:35+08:00	5405	13160	18565	1467	20032	33408	59.96%	16.18%	37	37
15	南投縣名間鄉	2018-11-24T23:55:56+08:00	5405	13160	18565	1467	20032	33408	59.96%	16.18%	37	37
15	南投縣名間鄉	2018-11-24T23:47:39+08:00	5405	13160	18565	1467	20032	33408	59.96%	16.18%	37	37
15	南投縣名間鄉	2018-11-24T23:31:22+08:00	5405	13160	18565	1467	20032	33408	59.96%	16.18%	37	37
15	南投縣名間鄉	2018-11-24T22:16:21+08:00	3602	8997	12599	988	13587	22722	59.8%	15.85%	27	37
15	南投縣名間鄉	2018-11-25T00:18:42+08:00	5405	13160	18565	1467	20032	33408	59.96%	16.18%	37	37
15	南投縣名間鄉	2018-11-24T23:12:26+08:00	5200	12667	17867	1408	19275	32134	59.98%	16.18%	36	37
15	南投縣名間鄉	2018-11-24T23:39:27+08:00	5405	13160	18565	1467	20032	33408	59.96%	16.18%	37	37
15	雲林縣口湖鄉	2018-11-25T01:12:55+08:00	2990	7195	10185	1280	11465	24193	47.39%	12.36%	25	25
15	雲林縣口湖鄉	2018-11-25T06:29:27+08:00	2990	7195	10185	1280	11465	24193	47.39%	12.36%	25	25
15	雲林縣口湖鄉	2018-11-24T23:05:13+08:00	2990	7195	10185	1280	11465	24193	47.39%	12.36%	25	25
15	雲林縣口湖鄉	2018-11-25T06:19:07+08:00	2990	7195	10185	1280	11465	24193	47.39%	12.36%	25	25
15	雲林縣口湖鄉	2018-11-25T00:05:15+08:00	2990	7195	10185	1280	11465	24193	47.39%	12.36%	25	25
15	雲林縣口湖鄉	2018-11-24T22:26:45+08:00	2497	5998	8495	1029	9524	20147	47.27%	12.39%	22	25
15	雲林縣口湖鄉	2018-11-24T22:54:34+08:00	2799	6713	9512	1119	10631	22685	46.86%	12.34%	24	25
15	雲林縣口湖鄉	2018-11-24T22:41:47+08:00	2497	5998	8495	1029	9524	20147	47.27%	12.39%	22	25
15	雲林縣口湖鄉	2018-11-24T23:43:26+08:00	2990	7195	10185	1280	11465	24193	47.39%	12.36%	25	25
15	雲林縣口湖鄉	2018-11-24T22:50:59+08:00	2799	6713	9512	1119	10631	22685	46.86%	12.34%	24	25
15	雲林縣口湖鄉	2018-11-25T00:00:20+08:00	2990	7195	10185	1280	11465	24193	47.39%	12.36%	25	25
15	雲林縣口湖鄉	2018-11-25T01:02:41+08:00	2990	7195	10185	1280	11465	24193	47.39%	12.36%	25	25
15	雲林縣口湖鄉	2018-11-25T00:23:14+08:00	2990	7195	10185	1280	11465	24193	47.39%	12.36%	25	25
15	雲林縣口湖鄉	2018-11-25T03:32:48+08:00	2990	7195	10185	1280	11465	24193	47.39%	12.36%	25	25
15	雲林縣口湖鄉	2018-11-25T03:44:36+08:00	2990	7195	10185	1280	11465	24193	47.39%	12.36%	25	25
15	雲林縣口湖鄉	2018-11-24T23:08:47+08:00	2990	7195	10185	1280	11465	24193	47.39%	12.36%	25	25
15	雲林縣口湖鄉	2018-11-25T06:24:10+08:00	2990	7195	10185	1280	11465	24193	47.39%	12.36%	25	25
15	雲林縣口湖鄉	2018-11-24T22:23:25+08:00	2497	5998	8495	1029	9524	20147	47.27%	12.39%	22	25
15	雲林縣口湖鄉	2018-11-24T23:23:47+08:00	2990	7195	10185	1280	11465	24193	47.39%	12.36%	25	25
15	雲林縣口湖鄉	2018-11-25T03:50:00+08:00	2990	7195	10185	1280	11465	24193	47.39%	12.36%	25	25
15	雲林縣口湖鄉	2018-11-24T22:33:47+08:00	2497	5998	8495	1029	9524	20147	47.27%	12.39%	22	25
15	雲林縣口湖鄉	2018-11-24T22:16:22+08:00	2351	5663	8014	920	8934	18934	47.18%	12.42%	21	25
15	雲林縣口湖鄉	2018-11-25T01:26:03+08:00	2990	7195	10185	1280	11465	24193	47.39%	12.36%	25	25
15	雲林縣口湖鄉	2018-11-25T03:39:04+08:00	2990	7195	10185	1280	11465	24193	47.39%	12.36%	25	25
15	雲林縣口湖鄉	2018-11-24T23:16:13+08:00	2990	7195	10185	1280	11465	24193	47.39%	12.36%	25	25
15	雲林縣口湖鄉	2018-11-25T00:14:20+08:00	2990	7195	10185	1280	11465	24193	47.39%	12.36%	25	25
15	雲林縣口湖鄉	2018-11-24T23:35:19+08:00	2990	7195	10185	1280	11465	24193	47.39%	12.36%	25	25
15	雲林縣口湖鄉	2018-11-24T23:47:40+08:00	2990	7195	10185	1280	11465	24193	47.39%	12.36%	25	25
15	雲林縣口湖鄉	2018-11-24T22:45:17+08:00	2497	5998	8495	1029	9524	20147	47.27%	12.39%	22	25
15	雲林縣口湖鄉	2018-11-25T01:18:05+08:00	2990	7195	10185	1280	11465	24193	47.39%	12.36%	25	25
15	雲林縣口湖鄉	2018-11-24T22:58:05+08:00	2799	6713	9512	1119	10631	22685	46.86%	12.34%	24	25
15	雲林縣口湖鄉	2018-11-25T00:09:46+08:00	2990	7195	10185	1280	11465	24193	47.39%	12.36%	25	25
15	雲林縣口湖鄉	2018-11-25T03:56:24+08:00	2990	7195	10185	1280	11465	24193	47.39%	12.36%	25	25
15	雲林縣口湖鄉	2018-11-24T23:01:42+08:00	2990	7195	10185	1280	11465	24193	47.39%	12.36%	25	25
15	雲林縣口湖鄉	2018-11-25T00:57:47+08:00	2990	7195	10185	1280	11465	24193	47.39%	12.36%	25	25
15	雲林縣口湖鄉	2018-11-24T22:19:46+08:00	2497	5998	8495	1029	9524	20147	47.27%	12.39%	22	25
15	雲林縣口湖鄉	2018-11-24T22:13:41+08:00	2205	5280	7485	881	8366	17497	47.81%	12.6%	20	25
15	雲林縣口湖鄉	2018-11-25T04:03:02+08:00	2990	7195	10185	1280	11465	24193	47.39%	12.36%	25	25
15	雲林縣口湖鄉	2018-11-24T22:40:37+08:00	2497	5998	8495	1029	9524	20147	47.27%	12.39%	22	25
15	雲林縣口湖鄉	2018-11-24T23:51:45+08:00	2990	7195	10185	1280	11465	24193	47.39%	12.36%	25	25
15	雲林縣口湖鄉	2018-11-24T22:30:20+08:00	2497	5998	8495	1029	9524	20147	47.27%	12.39%	22	25
15	雲林縣口湖鄉	2018-11-25T06:09:05+08:00	2990	7195	10185	1280	11465	24193	47.39%	12.36%	25	25
15	雲林縣口湖鄉	2018-11-24T23:55:57+08:00	2990	7195	10185	1280	11465	24193	47.39%	12.36%	25	25
15	雲林縣口湖鄉	2018-11-24T23:27:27+08:00	2990	7195	10185	1280	11465	24193	47.39%	12.36%	25	25
15	雲林縣口湖鄉	2018-11-25T06:14:02+08:00	2990	7195	10185	1280	11465	24193	47.39%	12.36%	25	25
15	雲林縣口湖鄉	2018-11-25T00:18:43+08:00	2990	7195	10185	1280	11465	24193	47.39%	12.36%	25	25
15	雲林縣口湖鄉	2018-11-24T23:12:27+08:00	2990	7195	10185	1280	11465	24193	47.39%	12.36%	25	25
15	雲林縣口湖鄉	2018-11-24T23:39:28+08:00	2990	7195	10185	1280	11465	24193	47.39%	12.36%	25	25
15	雲林縣口湖鄉	2018-11-24T22:37:11+08:00	2497	5998	8495	1029	9524	20147	47.27%	12.39%	22	25
15	雲林縣口湖鄉	2018-11-24T23:31:23+08:00	2990	7195	10185	1280	11465	24193	47.39%	12.36%	25	25
15	雲林縣口湖鄉	2018-11-24T23:20:02+08:00	2990	7195	10185	1280	11465	24193	47.39%	12.36%	25	25
15	雲林縣口湖鄉	2018-11-25T01:07:36+08:00	2990	7195	10185	1280	11465	24193	47.39%	12.36%	25	25
15	雲林縣莿桐鄉	2018-11-25T00:05:14+08:00	4027	8252	12279	1291	13570	24570	55.23%	16.39%	22	22
15	雲林縣莿桐鄉	2018-11-25T06:19:06+08:00	4027	8252	12279	1291	13570	24570	55.23%	16.39%	22	22
15	雲林縣莿桐鄉	2018-11-25T00:09:45+08:00	4027	8252	12279	1291	13570	24570	55.23%	16.39%	22	22
15	雲林縣莿桐鄉	2018-11-25T01:12:55+08:00	4027	8252	12279	1291	13570	24570	55.23%	16.39%	22	22
15	雲林縣莿桐鄉	2018-11-24T22:41:46+08:00	3818	7799	11617	1193	12810	23298	54.98%	16.39%	21	22
15	雲林縣莿桐鄉	2018-11-25T06:29:27+08:00	4027	8252	12279	1291	13570	24570	55.23%	16.39%	22	22
15	雲林縣莿桐鄉	2018-11-24T23:05:13+08:00	4027	8252	12279	1291	13570	24570	55.23%	16.39%	22	22
15	雲林縣莿桐鄉	2018-11-24T22:26:45+08:00	3214	6420	9634	1002	10636	19169	55.49%	16.77%	18	22
15	雲林縣莿桐鄉	2018-11-24T22:54:34+08:00	4027	8252	12279	1291	13570	24570	55.23%	16.39%	22	22
15	雲林縣莿桐鄉	2018-11-24T23:43:26+08:00	4027	8252	12279	1291	13570	24570	55.23%	16.39%	22	22
15	雲林縣莿桐鄉	2018-11-24T22:50:59+08:00	4027	8252	12279	1291	13570	24570	55.23%	16.39%	22	22
15	雲林縣莿桐鄉	2018-11-25T00:00:20+08:00	4027	8252	12279	1291	13570	24570	55.23%	16.39%	22	22
15	雲林縣莿桐鄉	2018-11-25T00:23:13+08:00	4027	8252	12279	1291	13570	24570	55.23%	16.39%	22	22
15	雲林縣莿桐鄉	2018-11-25T03:32:48+08:00	4027	8252	12279	1291	13570	24570	55.23%	16.39%	22	22
15	雲林縣莿桐鄉	2018-11-25T03:44:36+08:00	4027	8252	12279	1291	13570	24570	55.23%	16.39%	22	22
15	雲林縣莿桐鄉	2018-11-24T23:08:47+08:00	4027	8252	12279	1291	13570	24570	55.23%	16.39%	22	22
15	雲林縣莿桐鄉	2018-11-24T22:23:24+08:00	2998	5961	8959	967	9926	17869	55.55%	16.78%	17	22
15	雲林縣莿桐鄉	2018-11-25T06:24:10+08:00	4027	8252	12279	1291	13570	24570	55.23%	16.39%	22	22
15	雲林縣莿桐鄉	2018-11-25T01:02:40+08:00	4027	8252	12279	1291	13570	24570	55.23%	16.39%	22	22
15	雲林縣莿桐鄉	2018-11-24T23:23:47+08:00	4027	8252	12279	1291	13570	24570	55.23%	16.39%	22	22
15	雲林縣莿桐鄉	2018-11-25T03:50:00+08:00	4027	8252	12279	1291	13570	24570	55.23%	16.39%	22	22
15	雲林縣莿桐鄉	2018-11-24T22:33:47+08:00	3614	7312	10926	1124	12050	21809	55.25%	16.57%	20	22
15	雲林縣莿桐鄉	2018-11-25T01:26:03+08:00	4027	8252	12279	1291	13570	24570	55.23%	16.39%	22	22
15	雲林縣莿桐鄉	2018-11-25T03:39:04+08:00	4027	8252	12279	1291	13570	24570	55.23%	16.39%	22	22
15	雲林縣莿桐鄉	2018-11-25T00:14:19+08:00	4027	8252	12279	1291	13570	24570	55.23%	16.39%	22	22
15	雲林縣莿桐鄉	2018-11-24T23:16:12+08:00	4027	8252	12279	1291	13570	24570	55.23%	16.39%	22	22
15	雲林縣莿桐鄉	2018-11-24T23:35:19+08:00	4027	8252	12279	1291	13570	24570	55.23%	16.39%	22	22
15	雲林縣莿桐鄉	2018-11-24T22:45:17+08:00	3818	7799	11617	1193	12810	23298	54.98%	16.39%	21	22
15	雲林縣莿桐鄉	2018-11-25T01:18:05+08:00	4027	8252	12279	1291	13570	24570	55.23%	16.39%	22	22
15	雲林縣莿桐鄉	2018-11-25T03:56:24+08:00	4027	8252	12279	1291	13570	24570	55.23%	16.39%	22	22
15	雲林縣莿桐鄉	2018-11-24T22:58:04+08:00	4027	8252	12279	1291	13570	24570	55.23%	16.39%	22	22
15	雲林縣莿桐鄉	2018-11-24T23:01:42+08:00	4027	8252	12279	1291	13570	24570	55.23%	16.39%	22	22
15	雲林縣莿桐鄉	2018-11-25T00:57:47+08:00	4027	8252	12279	1291	13570	24570	55.23%	16.39%	22	22
15	雲林縣莿桐鄉	2018-11-24T22:19:46+08:00	2803	5665	8468	908	9376	16884	55.53%	16.6%	16	22
15	雲林縣莿桐鄉	2018-11-24T22:13:41+08:00	2803	5665	8468	908	9376	16884	55.53%	16.6%	16	22
15	雲林縣莿桐鄉	2018-11-25T04:03:02+08:00	4027	8252	12279	1291	13570	24570	55.23%	16.39%	22	22
15	雲林縣莿桐鄉	2018-11-24T22:30:19+08:00	3614	7312	10926	1124	12050	21809	55.25%	16.57%	20	22
15	雲林縣莿桐鄉	2018-11-24T22:40:37+08:00	3818	7799	11617	1193	12810	23298	54.98%	16.39%	21	22
15	雲林縣莿桐鄉	2018-11-24T23:51:45+08:00	4027	8252	12279	1291	13570	24570	55.23%	16.39%	22	22
15	雲林縣莿桐鄉	2018-11-25T06:09:05+08:00	4027	8252	12279	1291	13570	24570	55.23%	16.39%	22	22
15	雲林縣莿桐鄉	2018-11-24T23:55:57+08:00	4027	8252	12279	1291	13570	24570	55.23%	16.39%	22	22
15	雲林縣莿桐鄉	2018-11-24T23:27:27+08:00	4027	8252	12279	1291	13570	24570	55.23%	16.39%	22	22
15	雲林縣莿桐鄉	2018-11-25T06:14:02+08:00	4027	8252	12279	1291	13570	24570	55.23%	16.39%	22	22
15	雲林縣莿桐鄉	2018-11-24T23:47:39+08:00	4027	8252	12279	1291	13570	24570	55.23%	16.39%	22	22
15	雲林縣莿桐鄉	2018-11-25T00:18:43+08:00	4027	8252	12279	1291	13570	24570	55.23%	16.39%	22	22
15	雲林縣莿桐鄉	2018-11-24T23:31:22+08:00	4027	8252	12279	1291	13570	24570	55.23%	16.39%	22	22
15	雲林縣莿桐鄉	2018-11-24T22:16:21+08:00	2803	5665	8468	908	9376	16884	55.53%	16.6%	16	22
15	雲林縣莿桐鄉	2018-11-24T23:39:28+08:00	4027	8252	12279	1291	13570	24570	55.23%	16.39%	22	22
15	雲林縣莿桐鄉	2018-11-24T22:37:10+08:00	3818	7799	11617	1193	12810	23298	54.98%	16.39%	21	22
15	雲林縣莿桐鄉	2018-11-24T23:12:26+08:00	4027	8252	12279	1291	13570	24570	55.23%	16.39%	22	22
15	雲林縣莿桐鄉	2018-11-24T23:20:02+08:00	4027	8252	12279	1291	13570	24570	55.23%	16.39%	22	22
15	雲林縣莿桐鄉	2018-11-25T01:07:36+08:00	4027	8252	12279	1291	13570	24570	55.23%	16.39%	22	22
15	臺南市仁德區	2018-11-24T23:16:08+08:00	9598	19153	28751	1870	30621	57586	53.17%	16.67%	44	49
15	臺南市仁德區	2018-11-25T03:56:19+08:00	10819	21560	32379	2074	34453	64632	53.31%	16.74%	49	49
15	臺南市仁德區	2018-11-25T00:18:37+08:00	10819	21560	32379	2074	34453	64632	53.31%	16.74%	49	49
15	臺南市仁德區	2018-11-24T22:45:13+08:00	6808	13521	20329	1305	21634	40911	52.88%	16.64%	33	49
15	臺南市仁德區	2018-11-24T22:58:00+08:00	8135	16141	24276	1588	25864	48809	52.99%	16.67%	38	49
15	臺南市仁德區	2018-11-24T22:26:42+08:00	5602	11190	16792	1118	17910	33870	52.88%	16.54%	28	49
15	臺南市仁德區	2018-11-24T22:37:06+08:00	6294	12605	18899	1219	20118	38085	52.82%	16.53%	31	49
15	臺南市仁德區	2018-11-25T06:09:00+08:00	10819	21560	32379	2074	34453	64632	53.31%	16.74%	49	49
15	臺南市仁德區	2018-11-25T00:57:43+08:00	10819	21560	32379	2074	34453	64632	53.31%	16.74%	49	49
15	臺南市仁德區	2018-11-24T22:19:42+08:00	5184	10368	15552	1043	16595	31325	52.98%	16.55%	26	49
15	臺南市仁德區	2018-11-25T01:25:58+08:00	10819	21560	32379	2074	34453	64632	53.31%	16.74%	49	49
15	臺南市仁德區	2018-11-24T22:30:15+08:00	5834	11681	17515	1163	18678	35200	53.06%	16.57%	29	49
15	臺南市仁德區	2018-11-25T01:02:37+08:00	10819	21560	32379	2074	34453	64632	53.31%	16.74%	49	49
15	臺南市仁德區	2018-11-24T22:40:33+08:00	6558	13042	19600	1273	20873	39576	52.74%	16.57%	32	49
15	臺南市仁德區	2018-11-24T23:51:41+08:00	10819	21560	32379	2074	34453	64632	53.31%	16.74%	49	49
15	臺南市仁德區	2018-11-25T00:23:09+08:00	10819	21560	32379	2074	34453	64632	53.31%	16.74%	49	49
15	臺南市仁德區	2018-11-25T06:24:05+08:00	10819	21560	32379	2074	34453	64632	53.31%	16.74%	49	49
15	臺南市仁德區	2018-11-25T00:00:16+08:00	10819	21560	32379	2074	34453	64632	53.31%	16.74%	49	49
15	臺南市仁德區	2018-11-25T01:17:59+08:00	10819	21560	32379	2074	34453	64632	53.31%	16.74%	49	49
15	臺南市仁德區	2018-11-24T23:55:52+08:00	10819	21560	32379	2074	34453	64632	53.31%	16.74%	49	49
15	臺南市仁德區	2018-11-24T23:19:58+08:00	9842	19665	29507	1947	31454	58959	53.35%	16.69%	45	49
15	臺南市仁德區	2018-11-24T22:13:34+08:00	4696	9469	14165	931	15096	28601	52.78%	16.42%	24	49
15	臺南市仁德區	2018-11-24T23:27:23+08:00	10328	20626	30954	2031	32985	61762	53.41%	16.72%	47	49
15	臺南市仁德區	2018-11-25T03:44:30+08:00	10819	21560	32379	2074	34453	64632	53.31%	16.74%	49	49
15	臺南市仁德區	2018-11-25T04:02:58+08:00	10819	21560	32379	2074	34453	64632	53.31%	16.74%	49	49
15	臺南市仁德區	2018-11-24T23:35:16+08:00	10819	21560	32379	2074	34453	64632	53.31%	16.74%	49	49
15	臺南市仁德區	2018-11-24T23:47:34+08:00	10819	21560	32379	2074	34453	64632	53.31%	16.74%	49	49
15	臺南市仁德區	2018-11-24T23:05:09+08:00	8718	17281	25999	1665	27664	51949	53.25%	16.78%	40	49
15	臺南市仁德區	2018-11-24T23:01:36+08:00	8411	16673	25084	1632	26716	50262	53.15%	16.73%	39	49
15	臺南市仁德區	2018-11-24T23:31:18+08:00	10819	21560	32379	2074	34453	64632	53.31%	16.74%	49	49
15	臺南市仁德區	2018-11-24T23:39:23+08:00	10819	21560	32379	2074	34453	64632	53.31%	16.74%	49	49
15	臺南市仁德區	2018-11-25T01:07:32+08:00	10819	21560	32379	2074	34453	64632	53.31%	16.74%	49	49
15	臺南市仁德區	2018-11-24T22:41:42+08:00	6558	13042	19600	1273	20873	39576	52.74%	16.57%	32	49
15	臺南市仁德區	2018-11-25T06:13:58+08:00	10819	21560	32379	2074	34453	64632	53.31%	16.74%	49	49
15	臺南市仁德區	2018-11-25T06:19:02+08:00	10819	21560	32379	2074	34453	64632	53.31%	16.74%	49	49
15	臺南市仁德區	2018-11-25T03:49:56+08:00	10819	21560	32379	2074	34453	64632	53.31%	16.74%	49	49
15	臺南市仁德區	2018-11-24T22:54:30+08:00	7832	15601	23433	1507	24940	47061	53%	16.64%	37	49
15	臺南市仁德區	2018-11-24T22:50:54+08:00	7410	14709	22119	1400	23519	44390	52.98%	16.69%	35	49
15	臺南市仁德區	2018-11-25T01:12:50+08:00	10819	21560	32379	2074	34453	64632	53.31%	16.74%	49	49
15	臺南市仁德區	2018-11-24T23:43:22+08:00	10819	21560	32379	2074	34453	64632	53.31%	16.74%	49	49
15	臺南市仁德區	2018-11-25T00:09:40+08:00	10819	21560	32379	2074	34453	64632	53.31%	16.74%	49	49
15	臺南市仁德區	2018-11-25T06:29:23+08:00	10819	21560	32379	2074	34453	64632	53.31%	16.74%	49	49
15	臺南市仁德區	2018-11-25T00:05:11+08:00	10819	21560	32379	2074	34453	64632	53.31%	16.74%	49	49
15	臺南市仁德區	2018-11-24T22:23:20+08:00	5400	10758	16158	1088	17246	32593	52.91%	16.57%	27	49
15	臺南市仁德區	2018-11-25T03:32:42+08:00	10819	21560	32379	2074	34453	64632	53.31%	16.74%	49	49
15	臺南市仁德區	2018-11-24T23:08:42+08:00	8718	17281	25999	1665	27664	51949	53.25%	16.78%	40	49
15	臺南市仁德區	2018-11-24T23:23:43+08:00	10082	20121	30203	1988	32191	60372	53.32%	16.7%	46	49
15	臺南市仁德區	2018-11-25T00:14:15+08:00	10819	21560	32379	2074	34453	64632	53.31%	16.74%	49	49
15	臺南市仁德區	2018-11-24T22:33:43+08:00	6078	12152	18230	1185	19415	36671	52.94%	16.57%	30	49
15	臺南市仁德區	2018-11-24T22:16:17+08:00	4937	9898	14835	992	15827	29919	52.9%	16.5%	25	49
15	臺南市仁德區	2018-11-25T03:39:00+08:00	10819	21560	32379	2074	34453	64632	53.31%	16.74%	49	49
15	臺南市仁德區	2018-11-24T23:12:21+08:00	8881	17707	26588	1717	28305	53259	53.15%	16.68%	41	49
15	屏東縣東港鎮	2018-11-24T22:58:06+08:00	6062	13078	19140	1842	20982	39495	53.13%	15.35%	38	38
15	屏東縣東港鎮	2018-11-25T06:19:08+08:00	6062	13078	19140	1842	20982	39495	53.13%	15.35%	38	38
15	屏東縣東港鎮	2018-11-25T06:29:28+08:00	6062	13078	19140	1842	20982	39495	53.13%	15.35%	38	38
15	屏東縣東港鎮	2018-11-24T23:43:27+08:00	6062	13078	19140	1842	20982	39495	53.13%	15.35%	38	38
15	屏東縣東港鎮	2018-11-24T22:54:35+08:00	6062	13078	19140	1842	20982	39495	53.13%	15.35%	38	38
15	屏東縣東港鎮	2018-11-24T22:41:48+08:00	6062	13078	19140	1842	20982	39495	53.13%	15.35%	38	38
15	屏東縣東港鎮	2018-11-24T23:05:14+08:00	6062	13078	19140	1842	20982	39495	53.13%	15.35%	38	38
15	屏東縣東港鎮	2018-11-25T01:18:07+08:00	6062	13078	19140	1842	20982	39495	53.13%	15.35%	38	38
15	屏東縣東港鎮	2018-11-25T00:05:15+08:00	6062	13078	19140	1842	20982	39495	53.13%	15.35%	38	38
15	屏東縣東港鎮	2018-11-24T22:13:42+08:00	5153	11107	16260	1473	17733	33419	53.06%	15.42%	33	38
15	屏東縣東港鎮	2018-11-24T23:51:46+08:00	6062	13078	19140	1842	20982	39495	53.13%	15.35%	38	38
15	屏東縣東港鎮	2018-11-25T06:09:06+08:00	6062	13078	19140	1842	20982	39495	53.13%	15.35%	38	38
15	屏東縣東港鎮	2018-11-25T01:02:41+08:00	6062	13078	19140	1842	20982	39495	53.13%	15.35%	38	38
15	屏東縣東港鎮	2018-11-25T00:23:14+08:00	6062	13078	19140	1842	20982	39495	53.13%	15.35%	38	38
15	屏東縣東港鎮	2018-11-25T06:24:11+08:00	6062	13078	19140	1842	20982	39495	53.13%	15.35%	38	38
15	屏東縣東港鎮	2018-11-24T23:23:48+08:00	6062	13078	19140	1842	20982	39495	53.13%	15.35%	38	38
15	屏東縣東港鎮	2018-11-25T00:00:21+08:00	6062	13078	19140	1842	20982	39495	53.13%	15.35%	38	38
15	屏東縣東港鎮	2018-11-24T22:51:00+08:00	6062	13078	19140	1842	20982	39495	53.13%	15.35%	38	38
15	屏東縣東港鎮	2018-11-25T03:32:49+08:00	6062	13078	19140	1842	20982	39495	53.13%	15.35%	38	38
15	屏東縣東港鎮	2018-11-25T03:44:37+08:00	6062	13078	19140	1842	20982	39495	53.13%	15.35%	38	38
15	屏東縣東港鎮	2018-11-24T23:08:48+08:00	6062	13078	19140	1842	20982	39495	53.13%	15.35%	38	38
15	屏東縣東港鎮	2018-11-24T22:16:22+08:00	5336	11530	16866	1557	18423	34623	53.21%	15.41%	34	38
15	屏東縣東港鎮	2018-11-25T01:26:04+08:00	6062	13078	19140	1842	20982	39495	53.13%	15.35%	38	38
15	屏東縣東港鎮	2018-11-24T23:16:13+08:00	6062	13078	19140	1842	20982	39495	53.13%	15.35%	38	38
15	屏東縣東港鎮	2018-11-24T23:35:20+08:00	6062	13078	19140	1842	20982	39495	53.13%	15.35%	38	38
15	屏東縣東港鎮	2018-11-25T00:14:20+08:00	6062	13078	19140	1842	20982	39495	53.13%	15.35%	38	38
15	屏東縣東港鎮	2018-11-25T03:39:05+08:00	6062	13078	19140	1842	20982	39495	53.13%	15.35%	38	38
15	屏東縣東港鎮	2018-11-24T22:33:48+08:00	6062	13078	19140	1842	20982	39495	53.13%	15.35%	38	38
15	屏東縣東港鎮	2018-11-25T03:50:01+08:00	6062	13078	19140	1842	20982	39495	53.13%	15.35%	38	38
15	屏東縣東港鎮	2018-11-25T01:12:56+08:00	6062	13078	19140	1842	20982	39495	53.13%	15.35%	38	38
15	屏東縣東港鎮	2018-11-24T23:47:40+08:00	6062	13078	19140	1842	20982	39495	53.13%	15.35%	38	38
15	屏東縣東港鎮	2018-11-24T23:01:43+08:00	6062	13078	19140	1842	20982	39495	53.13%	15.35%	38	38
15	屏東縣東港鎮	2018-11-25T03:56:25+08:00	6062	13078	19140	1842	20982	39495	53.13%	15.35%	38	38
15	屏東縣東港鎮	2018-11-24T22:45:18+08:00	6062	13078	19140	1842	20982	39495	53.13%	15.35%	38	38
15	屏東縣東港鎮	2018-11-25T00:09:47+08:00	6062	13078	19140	1842	20982	39495	53.13%	15.35%	38	38
15	屏東縣東港鎮	2018-11-24T22:26:46+08:00	5876	12721	18597	1759	20356	38401	53.01%	15.3%	37	38
15	屏東縣東港鎮	2018-11-24T22:30:21+08:00	5876	12721	18597	1759	20356	38401	53.01%	15.3%	37	38
15	屏東縣東港鎮	2018-11-24T22:40:38+08:00	6062	13078	19140	1842	20982	39495	53.13%	15.35%	38	38
15	屏東縣東港鎮	2018-11-25T04:03:03+08:00	6062	13078	19140	1842	20982	39495	53.13%	15.35%	38	38
15	屏東縣東港鎮	2018-11-25T00:57:48+08:00	6062	13078	19140	1842	20982	39495	53.13%	15.35%	38	38
15	屏東縣東港鎮	2018-11-24T22:19:47+08:00	5520	11880	17400	1658	19058	35730	53.34%	15.45%	35	38
15	屏東縣東港鎮	2018-11-24T23:27:28+08:00	6062	13078	19140	1842	20982	39495	53.13%	15.35%	38	38
15	屏東縣東港鎮	2018-11-25T06:14:03+08:00	6062	13078	19140	1842	20982	39495	53.13%	15.35%	38	38
15	屏東縣東港鎮	2018-11-24T22:23:26+08:00	5716	12348	18064	1719	19783	37047	53.4%	15.43%	36	38
15	屏東縣東港鎮	2018-11-24T23:55:58+08:00	6062	13078	19140	1842	20982	39495	53.13%	15.35%	38	38
15	屏東縣東港鎮	2018-11-25T00:18:44+08:00	6062	13078	19140	1842	20982	39495	53.13%	15.35%	38	38
15	屏東縣東港鎮	2018-11-24T23:20:03+08:00	6062	13078	19140	1842	20982	39495	53.13%	15.35%	38	38
15	屏東縣東港鎮	2018-11-25T01:07:37+08:00	6062	13078	19140	1842	20982	39495	53.13%	15.35%	38	38
15	屏東縣東港鎮	2018-11-24T22:37:11+08:00	6062	13078	19140	1842	20982	39495	53.13%	15.35%	38	38
15	屏東縣東港鎮	2018-11-24T23:39:29+08:00	6062	13078	19140	1842	20982	39495	53.13%	15.35%	38	38
15	屏東縣東港鎮	2018-11-24T23:12:28+08:00	6062	13078	19140	1842	20982	39495	53.13%	15.35%	38	38
15	屏東縣東港鎮	2018-11-24T23:31:24+08:00	6062	13078	19140	1842	20982	39495	53.13%	15.35%	38	38
15	臺南市中西區	2018-11-24T23:16:08+08:00	10112	17797	27909	1486	29395	52756	55.72%	19.17%	43	52
15	臺南市中西區	2018-11-25T03:56:19+08:00	12476	21937	34413	1793	36206	65261	55.48%	19.12%	52	52
15	臺南市中西區	2018-11-25T00:18:37+08:00	12243	21564	33807	1760	35567	64097	55.49%	19.1%	51	52
15	臺南市中西區	2018-11-24T22:45:14+08:00	7917	14066	21983	1235	23218	41932	55.37%	18.88%	35	52
15	臺南市中西區	2018-11-24T22:58:00+08:00	9199	16281	25480	1387	26867	48340	55.58%	19.03%	40	52
15	臺南市中西區	2018-11-24T22:26:42+08:00	6648	11660	18308	1032	19340	35190	54.96%	18.89%	29	52
15	臺南市中西區	2018-11-25T01:18:00+08:00	12476	21937	34413	1793	36206	65261	55.48%	19.12%	52	52
15	臺南市中西區	2018-11-24T22:37:06+08:00	7283	12881	20164	1148	21312	38616	55.19%	18.86%	32	52
15	臺南市中西區	2018-11-25T06:09:00+08:00	12476	21937	34413	1793	36206	65261	55.48%	19.12%	52	52
15	臺南市中西區	2018-11-25T01:25:59+08:00	12476	21937	34413	1793	36206	65261	55.48%	19.12%	52	52
15	臺南市中西區	2018-11-25T00:57:43+08:00	12476	21937	34413	1793	36206	65261	55.48%	19.12%	52	52
15	臺南市中西區	2018-11-24T22:19:42+08:00	6446	11265	17711	1001	18712	34022	55%	18.95%	28	52
15	臺南市中西區	2018-11-24T22:30:15+08:00	6869	12070	18939	1085	20024	36391	55.02%	18.88%	30	52
15	臺南市中西區	2018-11-25T01:02:37+08:00	12476	21937	34413	1793	36206	65261	55.48%	19.12%	52	52
15	臺南市中西區	2018-11-24T22:40:33+08:00	7536	13299	20835	1165	22000	39828	55.24%	18.92%	33	52
15	臺南市中西區	2018-11-24T23:51:41+08:00	11975	21005	32980	1721	34701	62502	55.52%	19.16%	50	52
15	臺南市中西區	2018-11-24T22:13:35+08:00	5989	10339	16328	931	17259	31042	55.6%	19.29%	26	52
15	臺南市中西區	2018-11-24T23:55:52+08:00	11975	21005	32980	1721	34701	62502	55.52%	19.16%	50	52
15	臺南市中西區	2018-11-25T00:00:17+08:00	12243	21564	33807	1760	35567	64097	55.49%	19.1%	51	52
15	臺南市中西區	2018-11-24T23:19:58+08:00	10365	18235	28600	1522	30122	54192	55.58%	19.13%	44	52
15	臺南市中西區	2018-11-24T23:27:24+08:00	10616	18615	29231	1559	30790	55326	55.65%	19.19%	45	52
15	臺南市中西區	2018-11-25T03:44:30+08:00	12476	21937	34413	1793	36206	65261	55.48%	19.12%	52	52
15	臺南市中西區	2018-11-24T23:01:37+08:00	9199	16281	25480	1387	26867	48340	55.58%	19.03%	40	52
15	臺南市中西區	2018-11-25T04:02:58+08:00	12476	21937	34413	1793	36206	65261	55.48%	19.12%	52	52
15	臺南市中西區	2018-11-25T00:14:16+08:00	12243	21564	33807	1760	35567	64097	55.49%	19.1%	51	52
15	臺南市中西區	2018-11-24T23:35:16+08:00	11481	20132	31613	1643	33256	59503	55.89%	19.29%	48	52
15	臺南市中西區	2018-11-24T23:12:22+08:00	9762	17241	27003	1456	28459	51096	55.7%	19.11%	42	52
15	臺南市中西區	2018-11-24T23:31:18+08:00	11239	19709	30948	1621	32569	58258	55.9%	19.29%	47	52
15	臺南市中西區	2018-11-24T23:39:23+08:00	11798	20674	32472	1679	34151	61248	55.76%	19.26%	49	52
15	臺南市中西區	2018-11-25T01:07:32+08:00	12476	21937	34413	1793	36206	65261	55.48%	19.12%	52	52
15	臺南市中西區	2018-11-24T23:47:35+08:00	11975	21005	32980	1721	34701	62502	55.52%	19.16%	50	52
15	臺南市中西區	2018-11-24T22:41:42+08:00	7536	13299	20835	1165	22000	39828	55.24%	18.92%	33	52
15	臺南市中西區	2018-11-25T06:13:58+08:00	12476	21937	34413	1793	36206	65261	55.48%	19.12%	52	52
15	臺南市中西區	2018-11-24T22:54:31+08:00	8950	15859	24809	1363	26172	47117	55.55%	19%	39	52
15	臺南市中西區	2018-11-24T22:50:55+08:00	8598	15343	23941	1328	25269	45534	55.49%	18.88%	38	52
15	臺南市中西區	2018-11-25T00:09:41+08:00	12243	21564	33807	1760	35567	64097	55.49%	19.1%	51	52
15	臺南市中西區	2018-11-25T01:12:50+08:00	12476	21937	34413	1793	36206	65261	55.48%	19.12%	52	52
15	臺南市中西區	2018-11-24T23:43:22+08:00	11975	21005	32980	1721	34701	62502	55.52%	19.16%	50	52
15	臺南市中西區	2018-11-25T06:29:23+08:00	12476	21937	34413	1793	36206	65261	55.48%	19.12%	52	52
15	臺南市中西區	2018-11-25T03:49:57+08:00	12476	21937	34413	1793	36206	65261	55.48%	19.12%	52	52
15	臺南市中西區	2018-11-24T23:05:10+08:00	9199	16281	25480	1387	26867	48340	55.58%	19.03%	40	52
15	臺南市中西區	2018-11-25T06:19:03+08:00	12476	21937	34413	1793	36206	65261	55.48%	19.12%	52	52
15	臺南市中西區	2018-11-25T00:05:11+08:00	12243	21564	33807	1760	35567	64097	55.49%	19.1%	51	52
15	臺南市中西區	2018-11-25T06:24:06+08:00	12476	21937	34413	1793	36206	65261	55.48%	19.12%	52	52
15	臺南市中西區	2018-11-24T23:08:43+08:00	9762	17241	27003	1456	28459	51096	55.7%	19.11%	42	52
15	臺南市中西區	2018-11-24T22:23:20+08:00	6648	11660	18308	1032	19340	35190	54.96%	18.89%	29	52
15	臺南市中西區	2018-11-25T00:23:10+08:00	12243	21564	33807	1760	35567	64097	55.49%	19.1%	51	52
15	臺南市中西區	2018-11-25T03:32:43+08:00	12476	21937	34413	1793	36206	65261	55.48%	19.12%	52	52
15	臺南市中西區	2018-11-24T23:23:44+08:00	10616	18615	29231	1559	30790	55326	55.65%	19.19%	45	52
15	臺南市中西區	2018-11-24T22:33:44+08:00	6869	12070	18939	1085	20024	36391	55.02%	18.88%	30	52
15	臺南市中西區	2018-11-24T22:16:17+08:00	6185	10785	16970	967	17937	32318	55.5%	19.14%	27	52
15	臺南市中西區	2018-11-25T03:39:00+08:00	12476	21937	34413	1793	36206	65261	55.48%	19.12%	52	52
15	屏東縣內埔鄉	2018-11-24T22:58:06+08:00	5823	12133	17956	1425	19381	40719	47.6%	14.3%	35	40
15	屏東縣內埔鄉	2018-11-25T06:19:08+08:00	6775	14248	21023	1649	22672	47558	47.67%	14.25%	40	40
15	屏東縣內埔鄉	2018-11-24T23:39:30+08:00	6182	12943	19125	1505	20630	43350	47.59%	14.26%	37	40
15	屏東縣內埔鄉	2018-11-24T22:54:35+08:00	5823	12133	17956	1425	19381	40719	47.6%	14.3%	35	40
15	屏東縣內埔鄉	2018-11-24T22:41:48+08:00	5258	10956	16214	1363	17577	36798	47.77%	14.29%	32	40
15	屏東縣內埔鄉	2018-11-24T23:05:14+08:00	5823	12133	17956	1425	19381	40719	47.6%	14.3%	35	40
15	屏東縣內埔鄉	2018-11-25T06:29:29+08:00	6775	14248	21023	1649	22672	47558	47.67%	14.25%	40	40
15	屏東縣內埔鄉	2018-11-25T01:18:07+08:00	6775	14248	21023	1649	22672	47558	47.67%	14.25%	40	40
15	屏東縣內埔鄉	2018-11-24T23:43:28+08:00	6182	12943	19125	1505	20630	43350	47.59%	14.26%	37	40
15	屏東縣內埔鄉	2018-11-25T06:09:07+08:00	6775	14248	21023	1649	22672	47558	47.67%	14.25%	40	40
15	屏東縣內埔鄉	2018-11-24T22:13:42+08:00	4261	8901	13162	1168	14330	29653	48.33%	14.37%	27	40
15	屏東縣內埔鄉	2018-11-24T23:51:46+08:00	6405	13428	19833	1563	21396	44835	47.72%	14.29%	38	40
15	屏東縣內埔鄉	2018-11-25T06:24:11+08:00	6775	14248	21023	1649	22672	47558	47.67%	14.25%	40	40
15	屏東縣內埔鄉	2018-11-24T23:08:49+08:00	5823	12133	17956	1425	19381	40719	47.6%	14.3%	35	40
15	屏東縣內埔鄉	2018-11-25T03:44:38+08:00	6775	14248	21023	1649	22672	47558	47.67%	14.25%	40	40
15	屏東縣內埔鄉	2018-11-25T00:23:15+08:00	6405	13428	19833	1563	21396	44835	47.72%	14.29%	38	40
15	屏東縣內埔鄉	2018-11-24T22:51:00+08:00	5622	11661	17283	1391	18674	39471	47.31%	14.24%	34	40
15	屏東縣內埔鄉	2018-11-24T23:23:49+08:00	6018	12527	18545	1469	20014	41997	47.66%	14.33%	36	40
15	屏東縣內埔鄉	2018-11-25T03:32:49+08:00	6775	14248	21023	1649	22672	47558	47.67%	14.25%	40	40
15	屏東縣內埔鄉	2018-11-24T22:37:12+08:00	5258	10956	16214	1363	17577	36798	47.77%	14.29%	32	40
15	屏東縣內埔鄉	2018-11-24T23:16:14+08:00	5823	12133	17956	1425	19381	40719	47.6%	14.3%	35	40
15	屏東縣內埔鄉	2018-11-24T23:35:20+08:00	6018	12527	18545	1469	20014	41997	47.66%	14.33%	36	40
15	屏東縣內埔鄉	2018-11-25T01:26:05+08:00	6775	14248	21023	1649	22672	47558	47.67%	14.25%	40	40
15	屏東縣內埔鄉	2018-11-25T03:39:05+08:00	6775	14248	21023	1649	22672	47558	47.67%	14.25%	40	40
15	屏東縣內埔鄉	2018-11-24T22:33:48+08:00	5084	10553	15637	1336	16973	35273	48.12%	14.41%	31	40
15	屏東縣內埔鄉	2018-11-24T22:16:23+08:00	4539	9376	13915	1212	15127	31222	48.45%	14.54%	28	40
15	屏東縣內埔鄉	2018-11-25T00:14:21+08:00	6405	13428	19833	1563	21396	44835	47.72%	14.29%	38	40
15	屏東縣內埔鄉	2018-11-25T01:12:56+08:00	6775	14248	21023	1649	22672	47558	47.67%	14.25%	40	40
15	屏東縣內埔鄉	2018-11-24T23:01:43+08:00	5823	12133	17956	1425	19381	40719	47.6%	14.3%	35	40
15	屏東縣內埔鄉	2018-11-24T22:26:47+08:00	4675	9723	14398	1242	15640	32438	48.22%	14.41%	29	40
15	屏東縣內埔鄉	2018-11-25T03:56:25+08:00	6775	14248	21023	1649	22672	47558	47.67%	14.25%	40	40
15	屏東縣內埔鄉	2018-11-24T23:47:41+08:00	6405	13428	19833	1563	21396	44835	47.72%	14.29%	38	40
15	屏東縣內埔鄉	2018-11-24T22:45:18+08:00	5622	11661	17283	1391	18674	39471	47.31%	14.24%	34	40
15	屏東縣內埔鄉	2018-11-25T00:09:47+08:00	6405	13428	19833	1563	21396	44835	47.72%	14.29%	38	40
15	屏東縣內埔鄉	2018-11-25T00:05:16+08:00	6405	13428	19833	1563	21396	44835	47.72%	14.29%	38	40
15	屏東縣內埔鄉	2018-11-24T22:19:48+08:00	4539	9376	13915	1212	15127	31222	48.45%	14.54%	28	40
15	屏東縣內埔鄉	2018-11-24T22:30:21+08:00	4822	10078	14900	1285	16185	33668	48.07%	14.32%	30	40
15	屏東縣內埔鄉	2018-11-24T22:40:38+08:00	5258	10956	16214	1363	17577	36798	47.77%	14.29%	32	40
15	屏東縣內埔鄉	2018-11-25T04:03:03+08:00	6775	14248	21023	1649	22672	47558	47.67%	14.25%	40	40
15	屏東縣內埔鄉	2018-11-25T00:57:48+08:00	6546	13808	20354	1579	21933	46039	47.64%	14.22%	39	40
15	屏東縣內埔鄉	2018-11-24T23:27:28+08:00	6018	12527	18545	1469	20014	41997	47.66%	14.33%	36	40
15	屏東縣內埔鄉	2018-11-25T01:02:42+08:00	6775	14248	21023	1649	22672	47558	47.67%	14.25%	40	40
15	屏東縣內埔鄉	2018-11-25T06:14:03+08:00	6775	14248	21023	1649	22672	47558	47.67%	14.25%	40	40
15	屏東縣內埔鄉	2018-11-24T22:23:26+08:00	4675	9723	14398	1242	15640	32438	48.22%	14.41%	29	40
15	屏東縣內埔鄉	2018-11-24T23:55:58+08:00	6405	13428	19833	1563	21396	44835	47.72%	14.29%	38	40
15	屏東縣內埔鄉	2018-11-25T00:00:22+08:00	6405	13428	19833	1563	21396	44835	47.72%	14.29%	38	40
15	屏東縣內埔鄉	2018-11-25T00:18:44+08:00	6405	13428	19833	1563	21396	44835	47.72%	14.29%	38	40
15	屏東縣內埔鄉	2018-11-24T23:20:03+08:00	5823	12133	17956	1425	19381	40719	47.6%	14.3%	35	40
15	屏東縣內埔鄉	2018-11-25T01:07:38+08:00	6775	14248	21023	1649	22672	47558	47.67%	14.25%	40	40
15	屏東縣內埔鄉	2018-11-25T03:50:02+08:00	6775	14248	21023	1649	22672	47558	47.67%	14.25%	40	40
15	屏東縣內埔鄉	2018-11-24T23:12:28+08:00	5823	12133	17956	1425	19381	40719	47.6%	14.3%	35	40
15	屏東縣內埔鄉	2018-11-24T23:31:24+08:00	6018	12527	18545	1469	20014	41997	47.66%	14.33%	36	40
15	桃園市新屋區	2018-11-25T03:56:17+08:00	6408	15202	21610	1394	23004	41461	55.48%	15.46%	30	30
15	桃園市新屋區	2018-11-24T23:16:06+08:00	5803	13874	19677	1272	20949	37573	55.76%	15.44%	28	30
15	桃園市新屋區	2018-11-25T06:29:21+08:00	6408	15202	21610	1394	23004	41461	55.48%	15.46%	30	30
15	桃園市新屋區	2018-11-25T06:19:01+08:00	6408	15202	21610	1394	23004	41461	55.48%	15.46%	30	30
15	桃園市新屋區	2018-11-24T23:43:20+08:00	6408	15202	21610	1394	23004	41461	55.48%	15.46%	30	30
15	桃園市新屋區	2018-11-25T03:49:54+08:00	6408	15202	21610	1394	23004	41461	55.48%	15.46%	30	30
15	桃園市新屋區	2018-11-24T22:45:12+08:00	5803	13874	19677	1272	20949	37573	55.76%	15.44%	28	30
15	桃園市新屋區	2018-11-24T22:30:13+08:00	4917	11775	16692	1115	17807	32117	55.44%	15.31%	25	30
15	桃園市新屋區	2018-11-25T06:24:04+08:00	6408	15202	21610	1394	23004	41461	55.48%	15.46%	30	30
15	桃園市新屋區	2018-11-25T03:32:38+08:00	6408	15202	21610	1394	23004	41461	55.48%	15.46%	30	30
15	桃園市新屋區	2018-11-25T01:25:56+08:00	6408	15202	21610	1394	23004	41461	55.48%	15.46%	30	30
15	桃園市新屋區	2018-11-25T00:23:07+08:00	6408	15202	21610	1394	23004	41461	55.48%	15.46%	30	30
15	桃園市新屋區	2018-11-24T23:51:39+08:00	6408	15202	21610	1394	23004	41461	55.48%	15.46%	30	30
15	桃園市新屋區	2018-11-24T23:27:22+08:00	5803	13874	19677	1272	20949	37573	55.76%	15.44%	28	30
15	桃園市新屋區	2018-11-24T22:13:32+08:00	4678	11282	15960	1066	17026	30846	55.2%	15.17%	24	30
15	桃園市新屋區	2018-11-25T01:17:57+08:00	6408	15202	21610	1394	23004	41461	55.48%	15.46%	30	30
15	桃園市新屋區	2018-11-24T23:08:40+08:00	5803	13874	19677	1272	20949	37573	55.76%	15.44%	28	30
15	桃園市新屋區	2018-11-24T22:57:58+08:00	5803	13874	19677	1272	20949	37573	55.76%	15.44%	28	30
15	桃園市新屋區	2018-11-25T06:08:57+08:00	6408	15202	21610	1394	23004	41461	55.48%	15.46%	30	30
15	桃園市新屋區	2018-11-24T22:54:29+08:00	5803	13874	19677	1272	20949	37573	55.76%	15.44%	28	30
15	桃園市新屋區	2018-11-25T01:12:47+08:00	6408	15202	21610	1394	23004	41461	55.48%	15.46%	30	30
15	桃園市新屋區	2018-11-24T22:16:14+08:00	4678	11282	15960	1066	17026	30846	55.2%	15.17%	24	30
15	桃園市新屋區	2018-11-25T04:02:56+08:00	6408	15202	21610	1394	23004	41461	55.48%	15.46%	30	30
15	桃園市新屋區	2018-11-24T22:33:41+08:00	4917	11775	16692	1115	17807	32117	55.44%	15.31%	25	30
15	桃園市新屋區	2018-11-24T23:05:08+08:00	5803	13874	19677	1272	20949	37573	55.76%	15.44%	28	30
15	桃園市新屋區	2018-11-24T23:47:32+08:00	6408	15202	21610	1394	23004	41461	55.48%	15.46%	30	30
15	桃園市新屋區	2018-11-24T22:41:39+08:00	5486	13095	18581	1230	19811	35581	55.68%	15.42%	27	30
15	桃園市新屋區	2018-11-25T00:05:09+08:00	6408	15202	21610	1394	23004	41461	55.48%	15.46%	30	30
15	桃園市新屋區	2018-11-24T22:37:04+08:00	5256	12557	17813	1178	18991	34212	55.51%	15.36%	26	30
15	桃園市新屋區	2018-11-24T22:50:52+08:00	5803	13874	19677	1272	20949	37573	55.76%	15.44%	28	30
15	桃園市新屋區	2018-11-25T06:13:56+08:00	6408	15202	21610	1394	23004	41461	55.48%	15.46%	30	30
15	桃園市新屋區	2018-11-24T22:26:40+08:00	4917	11775	16692	1115	17807	32117	55.44%	15.31%	25	30
15	桃園市新屋區	2018-11-25T00:18:35+08:00	6408	15202	21610	1394	23004	41461	55.48%	15.46%	30	30
15	桃園市新屋區	2018-11-24T22:40:31+08:00	5486	13095	18581	1230	19811	35581	55.68%	15.42%	27	30
15	桃園市新屋區	2018-11-25T03:44:27+08:00	6408	15202	21610	1394	23004	41461	55.48%	15.46%	30	30
15	桃園市新屋區	2018-11-25T00:57:41+08:00	6408	15202	21610	1394	23004	41461	55.48%	15.46%	30	30
15	桃園市新屋區	2018-11-24T22:19:40+08:00	4678	11282	15960	1066	17026	30846	55.2%	15.17%	24	30
15	桃園市新屋區	2018-11-25T01:02:34+08:00	6408	15202	21610	1394	23004	41461	55.48%	15.46%	30	30
15	桃園市新屋區	2018-11-25T03:38:58+08:00	6408	15202	21610	1394	23004	41461	55.48%	15.46%	30	30
15	桃園市新屋區	2018-11-24T23:23:42+08:00	5803	13874	19677	1272	20949	37573	55.76%	15.44%	28	30
15	桃園市新屋區	2018-11-24T23:55:50+08:00	6408	15202	21610	1394	23004	41461	55.48%	15.46%	30	30
15	桃園市新屋區	2018-11-24T22:23:17+08:00	4917	11775	16692	1115	17807	32117	55.44%	15.31%	25	30
15	桃園市新屋區	2018-11-24T23:19:55+08:00	5803	13874	19677	1272	20949	37573	55.76%	15.44%	28	30
15	桃園市新屋區	2018-11-25T00:00:14+08:00	6408	15202	21610	1394	23004	41461	55.48%	15.46%	30	30
15	桃園市新屋區	2018-11-25T01:07:30+08:00	6408	15202	21610	1394	23004	41461	55.48%	15.46%	30	30
15	桃園市新屋區	2018-11-25T00:09:38+08:00	6408	15202	21610	1394	23004	41461	55.48%	15.46%	30	30
15	桃園市新屋區	2018-11-24T23:35:14+08:00	6408	15202	21610	1394	23004	41461	55.48%	15.46%	30	30
15	桃園市新屋區	2018-11-25T00:14:13+08:00	6408	15202	21610	1394	23004	41461	55.48%	15.46%	30	30
15	桃園市新屋區	2018-11-24T23:01:35+08:00	5803	13874	19677	1272	20949	37573	55.76%	15.44%	28	30
15	桃園市新屋區	2018-11-24T23:12:19+08:00	5803	13874	19677	1272	20949	37573	55.76%	15.44%	28	30
15	桃園市新屋區	2018-11-24T23:31:15+08:00	6068	14425	20493	1319	21812	39429	55.32%	15.39%	29	30
15	桃園市新屋區	2018-11-24T23:39:20+08:00	6408	15202	21610	1394	23004	41461	55.48%	15.46%	30	30
15	桃園市桃園區	2018-11-24T23:16:06+08:00	30313	52750	83063	3675	86738	168875	51.36%	17.95%	109	216
15	桃園市桃園區	2018-11-24T23:43:20+08:00	40638	71323	111961	4984	116945	229113	51.04%	17.74%	143	216
15	桃園市桃園區	2018-11-25T06:13:55+08:00	63229	111711	174940	7703	182643	359790	50.76%	17.57%	216	216
15	桃園市桃園區	2018-11-25T06:19:00+08:00	63229	111711	174940	7703	182643	359790	50.76%	17.57%	216	216
15	桃園市桃園區	2018-11-25T06:29:20+08:00	63229	111711	174940	7703	182643	359790	50.76%	17.57%	216	216
15	桃園市桃園區	2018-11-25T03:49:54+08:00	63229	111711	174940	7703	182643	359790	50.76%	17.57%	216	216
15	桃園市桃園區	2018-11-25T03:56:16+08:00	63229	111711	174940	7703	182643	359790	50.76%	17.57%	216	216
15	桃園市桃園區	2018-11-25T01:07:29+08:00	60056	105821	165877	7358	173235	340679	50.85%	17.63%	206	216
15	桃園市桃園區	2018-11-24T22:30:13+08:00	18469	31496	49965	2317	52282	101447	51.54%	18.21%	68	216
15	桃園市桃園區	2018-11-25T06:24:03+08:00	63229	111711	174940	7703	182643	359790	50.76%	17.57%	216	216
15	桃園市桃園區	2018-11-25T03:32:38+08:00	63229	111711	174940	7703	182643	359790	50.76%	17.57%	216	216
15	桃園市桃園區	2018-11-25T01:25:56+08:00	61626	108779	170405	7554	177959	350187	50.82%	17.6%	211	216
15	桃園市桃園區	2018-11-25T00:23:07+08:00	51117	90250	141367	6230	147597	290422	50.82%	17.6%	178	216
15	桃園市桃園區	2018-11-24T23:51:39+08:00	42333	74337	116670	5181	121851	238962	50.99%	17.72%	149	216
15	桃園市桃園區	2018-11-24T23:23:41+08:00	32660	56985	89645	3974	93619	182391	51.33%	17.91%	116	216
15	桃園市桃園區	2018-11-25T01:17:57+08:00	61014	107644	168658	7487	176145	346456	50.84%	17.61%	209	216
15	桃園市桃園區	2018-11-24T23:08:40+08:00	27903	48431	76334	3411	79745	155026	51.44%	18%	101	216
15	桃園市桃園區	2018-11-24T22:57:58+08:00	26002	44994	70996	3182	74178	144099	51.48%	18.04%	94	216
15	桃園市桃園區	2018-11-25T06:08:57+08:00	63229	111711	174940	7703	182643	359790	50.76%	17.57%	216	216
15	桃園市桃園區	2018-11-25T01:12:47+08:00	60703	107014	167717	7438	175155	344461	50.85%	17.62%	208	216
15	桃園市桃園區	2018-11-24T22:16:14+08:00	16502	27955	44457	2063	46520	90684	51.3%	18.2%	61	216
15	桃園市桃園區	2018-11-25T00:05:08+08:00	45605	80325	125930	5552	131482	258523	50.86%	17.64%	160	216
15	桃園市桃園區	2018-11-24T23:05:07+08:00	27059	46909	73968	3308	77276	150089	51.49%	18.03%	98	216
15	桃園市桃園區	2018-11-24T22:54:28+08:00	25309	43863	69172	3123	72295	140587	51.42%	18%	92	216
15	桃園市桃園區	2018-11-24T22:33:41+08:00	19216	32843	52059	2410	54469	105697	51.53%	18.18%	71	216
15	桃園市桃園區	2018-11-24T23:47:32+08:00	41465	72801	114266	5080	119346	233909	51.02%	17.73%	146	216
15	桃園市桃園區	2018-11-24T22:41:39+08:00	20718	35615	56333	2574	58907	114332	51.52%	18.12%	76	216
15	桃園市桃園區	2018-11-24T22:37:04+08:00	19751	33905	53656	2464	56120	108869	51.55%	18.14%	73	216
15	桃園市桃園區	2018-11-25T00:18:34+08:00	49848	88175	138023	6075	144098	283460	50.84%	17.59%	174	216
15	桃園市桃園區	2018-11-24T22:50:52+08:00	23245	40230	63475	2881	66356	128678	51.57%	18.06%	85	216
15	桃園市桃園區	2018-11-24T22:26:40+08:00	17920	30418	48338	2244	50582	98139	51.54%	18.26%	66	216
15	桃園市桃園區	2018-11-24T22:45:11+08:00	21473	37126	58599	2666	61265	118933	51.51%	18.05%	79	216
15	桃園市桃園區	2018-11-25T00:57:40+08:00	58514	103055	161569	7189	168758	331739	50.87%	17.64%	201	216
15	桃園市桃園區	2018-11-25T03:44:27+08:00	63229	111711	174940	7703	182643	359790	50.76%	17.57%	216	216
15	桃園市桃園區	2018-11-24T22:19:40+08:00	17372	29426	46798	2151	48949	95231	51.4%	18.24%	64	216
15	桃園市桃園區	2018-11-25T01:02:34+08:00	59120	104056	163176	7236	170412	334898	50.88%	17.65%	203	216
15	桃園市桃園區	2018-11-24T22:40:30+08:00	20718	35615	56333	2574	58907	114332	51.52%	18.12%	76	216
15	桃園市桃園區	2018-11-25T03:38:58+08:00	63229	111711	174940	7703	182643	359790	50.76%	17.57%	216	216
15	桃園市桃園區	2018-11-24T22:13:31+08:00	14739	24985	39724	1855	41579	81630	50.94%	18.06%	55	216
15	桃園市桃園區	2018-11-24T23:27:21+08:00	33563	58545	92108	4090	96198	187556	51.29%	17.89%	119	216
15	桃園市桃園區	2018-11-24T23:55:50+08:00	43453	76452	119905	5343	125248	245585	51%	17.69%	153	216
15	桃園市桃園區	2018-11-24T22:23:17+08:00	17639	29949	47588	2198	49786	96786	51.44%	18.22%	65	216
15	桃園市桃園區	2018-11-24T23:19:55+08:00	31620	55129	86749	3843	90592	176115	51.44%	17.95%	113	216
15	桃園市桃園區	2018-11-25T00:00:14+08:00	44240	77975	122215	5442	127657	251059	50.85%	17.62%	156	216
15	桃園市桃園區	2018-11-25T04:02:55+08:00	63229	111711	174940	7703	182643	359790	50.76%	17.57%	216	216
15	桃園市桃園區	2018-11-25T00:09:38+08:00	47091	83054	130145	5748	135893	267371	50.83%	17.61%	165	216
15	桃園市桃園區	2018-11-24T23:01:34+08:00	26768	46298	73066	3266	76332	148346	51.46%	18.04%	97	216
15	桃園市桃園區	2018-11-24T23:35:13+08:00	37079	64720	101799	4563	106362	207511	51.26%	17.87%	131	216
15	桃園市桃園區	2018-11-25T00:14:13+08:00	48212	85201	133413	5897	139310	274135	50.82%	17.59%	169	216
15	桃園市桃園區	2018-11-24T23:12:19+08:00	28434	49405	77839	3459	81298	158492	51.29%	17.94%	103	216
15	桃園市桃園區	2018-11-24T23:31:15+08:00	35902	62744	98646	4438	103084	201072	51.27%	17.86%	127	216
15	桃園市桃園區	2018-11-24T23:39:20+08:00	38666	67589	106255	4718	110973	216848	51.18%	17.83%	136	216
15	臺中市豐原區	2018-11-25T03:56:17+08:00	25365	52434	77799	4495	82294	136658	60.22%	18.56%	88	88
15	臺中市豐原區	2018-11-24T23:16:06+08:00	21095	43377	64472	3794	68266	113549	60.12%	18.58%	75	88
15	臺中市豐原區	2018-11-25T06:29:21+08:00	25365	52434	77799	4495	82294	136658	60.22%	18.56%	88	88
15	臺中市豐原區	2018-11-25T03:49:55+08:00	25365	52434	77799	4495	82294	136658	60.22%	18.56%	88	88
15	臺中市豐原區	2018-11-25T06:19:01+08:00	25365	52434	77799	4495	82294	136658	60.22%	18.56%	88	88
15	臺中市豐原區	2018-11-24T22:45:12+08:00	17801	36221	54022	3209	57231	95077	60.19%	18.72%	64	88
15	臺中市豐原區	2018-11-24T23:43:21+08:00	22312	45871	68183	4002	72185	119940	60.18%	18.6%	79	88
15	臺中市豐原區	2018-11-24T22:41:40+08:00	17633	35875	53508	3159	56667	94094	60.22%	18.74%	63	88
15	臺中市豐原區	2018-11-25T01:25:57+08:00	25365	52434	77799	4495	82294	136658	60.22%	18.56%	88	88
15	臺中市豐原區	2018-11-24T22:30:14+08:00	15694	31886	47580	2830	50410	84040	59.98%	18.67%	56	88
15	臺中市豐原區	2018-11-25T06:24:04+08:00	25365	52434	77799	4495	82294	136658	60.22%	18.56%	88	88
15	臺中市豐原區	2018-11-25T00:23:07+08:00	24684	50976	75660	4373	80033	132796	60.27%	18.59%	86	88
15	臺中市豐原區	2018-11-25T03:32:39+08:00	25365	52434	77799	4495	82294	136658	60.22%	18.56%	88	88
15	臺中市豐原區	2018-11-24T23:51:39+08:00	23054	47398	70452	4108	74560	123831	60.21%	18.62%	81	88
15	臺中市豐原區	2018-11-24T23:27:22+08:00	21435	44110	65545	3867	69412	115563	60.06%	18.55%	76	88
15	臺中市豐原區	2018-11-24T22:13:32+08:00	13661	27423	41084	2495	43579	72570	60.05%	18.82%	49	88
15	臺中市豐原區	2018-11-25T01:17:57+08:00	25365	52434	77799	4495	82294	136658	60.22%	18.56%	88	88
15	臺中市豐原區	2018-11-24T23:08:41+08:00	20524	42013	62537	3651	66188	110005	60.17%	18.66%	73	88
15	臺中市豐原區	2018-11-24T22:57:58+08:00	20207	41285	61492	3605	65097	108138	60.2%	18.69%	72	88
15	臺中市豐原區	2018-11-24T23:19:56+08:00	21095	43377	64472	3794	68266	113549	60.12%	18.58%	75	88
15	臺中市豐原區	2018-11-24T22:54:29+08:00	19927	40745	60672	3557	64229	106720	60.18%	18.67%	71	88
15	臺中市豐原區	2018-11-24T23:47:33+08:00	22312	45871	68183	4002	72185	119940	60.18%	18.6%	79	88
15	臺中市豐原區	2018-11-25T04:02:56+08:00	25365	52434	77799	4495	82294	136658	60.22%	18.56%	88	88
15	臺中市豐原區	2018-11-25T06:08:58+08:00	25365	52434	77799	4495	82294	136658	60.22%	18.56%	88	88
15	臺中市豐原區	2018-11-24T22:16:15+08:00	13980	28116	42096	2567	44663	74328	60.09%	18.81%	50	88
15	臺中市豐原區	2018-11-24T23:31:16+08:00	21435	44110	65545	3867	69412	115563	60.06%	18.55%	76	88
15	臺中市豐原區	2018-11-25T01:12:48+08:00	25365	52434	77799	4495	82294	136658	60.22%	18.56%	88	88
15	臺中市豐原區	2018-11-24T23:05:08+08:00	20207	41285	61492	3605	65097	108138	60.2%	18.69%	72	88
15	臺中市豐原區	2018-11-25T00:05:09+08:00	24044	49590	73634	4280	77914	129479	60.18%	18.57%	84	88
15	臺中市豐原區	2018-11-24T22:37:04+08:00	16950	34398	51348	3040	54388	90420	60.15%	18.75%	60	88
15	臺中市豐原區	2018-11-24T22:50:52+08:00	19041	38771	57812	3430	61242	101655	60.24%	18.73%	68	88
15	臺中市豐原區	2018-11-25T06:13:56+08:00	25365	52434	77799	4495	82294	136658	60.22%	18.56%	88	88
15	臺中市豐原區	2018-11-24T22:26:40+08:00	15187	30654	45841	2759	48600	80845	60.12%	18.79%	54	88
15	臺中市豐原區	2018-11-25T00:18:35+08:00	24684	50976	75660	4373	80033	132796	60.27%	18.59%	86	88
15	臺中市豐原區	2018-11-24T22:19:41+08:00	13980	28116	42096	2567	44663	74328	60.09%	18.81%	50	88
15	臺中市豐原區	2018-11-25T03:38:59+08:00	25365	52434	77799	4495	82294	136658	60.22%	18.56%	88	88
15	臺中市豐原區	2018-11-24T22:40:31+08:00	17633	35875	53508	3159	56667	94094	60.22%	18.74%	63	88
15	臺中市豐原區	2018-11-25T01:02:35+08:00	25365	52434	77799	4495	82294	136658	60.22%	18.56%	88	88
15	臺中市豐原區	2018-11-25T00:57:41+08:00	25365	52434	77799	4495	82294	136658	60.22%	18.56%	88	88
15	臺中市豐原區	2018-11-25T03:44:28+08:00	25365	52434	77799	4495	82294	136658	60.22%	18.56%	88	88
15	臺中市豐原區	2018-11-24T23:23:42+08:00	21435	44110	65545	3867	69412	115563	60.06%	18.55%	76	88
15	臺中市豐原區	2018-11-24T22:23:18+08:00	14460	29184	43644	2664	46308	76889	60.23%	18.81%	52	88
15	臺中市豐原區	2018-11-25T00:00:15+08:00	23054	47398	70452	4108	74560	123831	60.21%	18.62%	81	88
15	臺中市豐原區	2018-11-24T23:55:51+08:00	23054	47398	70452	4108	74560	123831	60.21%	18.62%	81	88
15	臺中市豐原區	2018-11-24T23:39:21+08:00	22067	45288	67355	3940	71295	118534	60.15%	18.62%	78	88
15	臺中市豐原區	2018-11-25T01:07:30+08:00	25365	52434	77799	4495	82294	136658	60.22%	18.56%	88	88
15	臺中市豐原區	2018-11-24T23:12:20+08:00	20819	42707	63526	3728	67254	111828	60.14%	18.62%	74	88
15	臺中市豐原區	2018-11-24T23:35:14+08:00	21435	44110	65545	3867	69412	115563	60.06%	18.55%	76	88
15	臺中市豐原區	2018-11-25T00:14:14+08:00	24384	50338	74722	4321	79043	131250	60.22%	18.58%	85	88
15	臺中市豐原區	2018-11-24T23:01:35+08:00	20207	41285	61492	3605	65097	108138	60.2%	18.69%	72	88
15	臺中市豐原區	2018-11-25T00:09:39+08:00	24384	50338	74722	4321	79043	131250	60.22%	18.58%	85	88
15	臺中市豐原區	2018-11-24T22:33:42+08:00	16950	34398	51348	3040	54388	90420	60.15%	18.75%	60	88
15	臺中市新社區	2018-11-25T03:56:17+08:00	2984	7517	10501	684	11185	20860	53.62%	14.3%	23	23
15	臺中市新社區	2018-11-25T06:29:21+08:00	2984	7517	10501	684	11185	20860	53.62%	14.3%	23	23
15	臺中市新社區	2018-11-25T03:49:55+08:00	2984	7517	10501	684	11185	20860	53.62%	14.3%	23	23
15	臺中市新社區	2018-11-25T06:19:01+08:00	2984	7517	10501	684	11185	20860	53.62%	14.3%	23	23
15	臺中市新社區	2018-11-24T23:16:07+08:00	2984	7517	10501	684	11185	20860	53.62%	14.3%	23	23
15	臺中市新社區	2018-11-24T22:45:12+08:00	2984	7517	10501	684	11185	20860	53.62%	14.3%	23	23
15	臺中市新社區	2018-11-24T23:43:21+08:00	2984	7517	10501	684	11185	20860	53.62%	14.3%	23	23
15	臺中市新社區	2018-11-24T22:41:40+08:00	2984	7517	10501	684	11185	20860	53.62%	14.3%	23	23
15	臺中市新社區	2018-11-25T00:18:36+08:00	2984	7517	10501	684	11185	20860	53.62%	14.3%	23	23
15	臺中市新社區	2018-11-25T01:25:57+08:00	2984	7517	10501	684	11185	20860	53.62%	14.3%	23	23
15	臺中市新社區	2018-11-24T22:30:14+08:00	2984	7517	10501	684	11185	20860	53.62%	14.3%	23	23
15	臺中市新社區	2018-11-25T06:24:04+08:00	2984	7517	10501	684	11185	20860	53.62%	14.3%	23	23
15	臺中市新社區	2018-11-25T00:23:08+08:00	2984	7517	10501	684	11185	20860	53.62%	14.3%	23	23
15	臺中市新社區	2018-11-25T03:32:39+08:00	2984	7517	10501	684	11185	20860	53.62%	14.3%	23	23
15	臺中市新社區	2018-11-24T23:51:39+08:00	2984	7517	10501	684	11185	20860	53.62%	14.3%	23	23
15	臺中市新社區	2018-11-24T23:27:22+08:00	2984	7517	10501	684	11185	20860	53.62%	14.3%	23	23
15	臺中市新社區	2018-11-24T22:57:59+08:00	2984	7517	10501	684	11185	20860	53.62%	14.3%	23	23
15	臺中市新社區	2018-11-24T23:08:41+08:00	2984	7517	10501	684	11185	20860	53.62%	14.3%	23	23
15	臺中市新社區	2018-11-24T22:13:33+08:00	2984	7517	10501	684	11185	20860	53.62%	14.3%	23	23
15	臺中市新社區	2018-11-24T23:19:56+08:00	2984	7517	10501	684	11185	20860	53.62%	14.3%	23	23
15	臺中市新社區	2018-11-25T01:17:58+08:00	2984	7517	10501	684	11185	20860	53.62%	14.3%	23	23
15	臺中市新社區	2018-11-24T22:54:29+08:00	2984	7517	10501	684	11185	20860	53.62%	14.3%	23	23
15	臺中市新社區	2018-11-24T23:47:33+08:00	2984	7517	10501	684	11185	20860	53.62%	14.3%	23	23
15	臺中市新社區	2018-11-25T04:02:56+08:00	2984	7517	10501	684	11185	20860	53.62%	14.3%	23	23
15	臺中市新社區	2018-11-25T06:08:58+08:00	2984	7517	10501	684	11185	20860	53.62%	14.3%	23	23
15	臺中市新社區	2018-11-24T22:16:15+08:00	2984	7517	10501	684	11185	20860	53.62%	14.3%	23	23
15	臺中市新社區	2018-11-24T23:31:16+08:00	2984	7517	10501	684	11185	20860	53.62%	14.3%	23	23
15	臺中市新社區	2018-11-25T01:12:48+08:00	2984	7517	10501	684	11185	20860	53.62%	14.3%	23	23
15	臺中市新社區	2018-11-24T23:05:08+08:00	2984	7517	10501	684	11185	20860	53.62%	14.3%	23	23
15	臺中市新社區	2018-11-25T00:05:09+08:00	2984	7517	10501	684	11185	20860	53.62%	14.3%	23	23
15	臺中市新社區	2018-11-25T06:13:56+08:00	2984	7517	10501	684	11185	20860	53.62%	14.3%	23	23
15	臺中市新社區	2018-11-24T22:26:40+08:00	2984	7517	10501	684	11185	20860	53.62%	14.3%	23	23
15	臺中市新社區	2018-11-24T22:50:53+08:00	2984	7517	10501	684	11185	20860	53.62%	14.3%	23	23
15	臺中市新社區	2018-11-24T22:37:05+08:00	2984	7517	10501	684	11185	20860	53.62%	14.3%	23	23
15	臺中市新社區	2018-11-24T22:19:41+08:00	2984	7517	10501	684	11185	20860	53.62%	14.3%	23	23
15	臺中市新社區	2018-11-25T03:38:59+08:00	2984	7517	10501	684	11185	20860	53.62%	14.3%	23	23
15	臺中市新社區	2018-11-24T22:40:31+08:00	2984	7517	10501	684	11185	20860	53.62%	14.3%	23	23
15	臺中市新社區	2018-11-25T01:02:35+08:00	2984	7517	10501	684	11185	20860	53.62%	14.3%	23	23
15	臺中市新社區	2018-11-25T00:57:41+08:00	2984	7517	10501	684	11185	20860	53.62%	14.3%	23	23
15	臺中市新社區	2018-11-25T03:44:28+08:00	2984	7517	10501	684	11185	20860	53.62%	14.3%	23	23
15	臺中市新社區	2018-11-24T23:23:42+08:00	2984	7517	10501	684	11185	20860	53.62%	14.3%	23	23
15	臺中市新社區	2018-11-24T22:23:18+08:00	2984	7517	10501	684	11185	20860	53.62%	14.3%	23	23
15	臺中市新社區	2018-11-25T00:00:15+08:00	2984	7517	10501	684	11185	20860	53.62%	14.3%	23	23
15	臺中市新社區	2018-11-24T23:55:51+08:00	2984	7517	10501	684	11185	20860	53.62%	14.3%	23	23
15	臺中市新社區	2018-11-24T23:39:21+08:00	2984	7517	10501	684	11185	20860	53.62%	14.3%	23	23
15	臺中市新社區	2018-11-25T01:07:30+08:00	2984	7517	10501	684	11185	20860	53.62%	14.3%	23	23
15	臺中市新社區	2018-11-24T23:12:20+08:00	2984	7517	10501	684	11185	20860	53.62%	14.3%	23	23
15	臺中市新社區	2018-11-24T23:35:14+08:00	2984	7517	10501	684	11185	20860	53.62%	14.3%	23	23
15	臺中市新社區	2018-11-25T00:14:14+08:00	2984	7517	10501	684	11185	20860	53.62%	14.3%	23	23
15	臺中市新社區	2018-11-24T23:01:35+08:00	2984	7517	10501	684	11185	20860	53.62%	14.3%	23	23
15	臺中市新社區	2018-11-25T00:09:39+08:00	2984	7517	10501	684	11185	20860	53.62%	14.3%	23	23
15	臺中市新社區	2018-11-24T22:33:42+08:00	2984	7517	10501	684	11185	20860	53.62%	14.3%	23	23
15	嘉義縣六腳鄉	2018-11-25T01:18:06+08:00	2568	5282	7850	873	8723	20821	41.9%	12.33%	30	30
15	嘉義縣六腳鄉	2018-11-25T06:29:28+08:00	2568	5282	7850	873	8723	20821	41.9%	12.33%	30	30
15	嘉義縣六腳鄉	2018-11-24T23:43:27+08:00	2568	5282	7850	873	8723	20821	41.9%	12.33%	30	30
15	嘉義縣六腳鄉	2018-11-25T01:12:55+08:00	2568	5282	7850	873	8723	20821	41.9%	12.33%	30	30
15	嘉義縣六腳鄉	2018-11-24T22:54:35+08:00	2568	5282	7850	873	8723	20821	41.9%	12.33%	30	30
15	嘉義縣六腳鄉	2018-11-24T23:05:14+08:00	2568	5282	7850	873	8723	20821	41.9%	12.33%	30	30
15	嘉義縣六腳鄉	2018-11-25T06:19:07+08:00	2568	5282	7850	873	8723	20821	41.9%	12.33%	30	30
15	嘉義縣六腳鄉	2018-11-25T00:05:15+08:00	2568	5282	7850	873	8723	20821	41.9%	12.33%	30	30
15	嘉義縣六腳鄉	2018-11-24T22:41:47+08:00	2427	5002	7429	829	8258	19621	42.09%	12.37%	29	30
15	嘉義縣六腳鄉	2018-11-24T23:51:46+08:00	2568	5282	7850	873	8723	20821	41.9%	12.33%	30	30
15	嘉義縣六腳鄉	2018-11-25T06:09:06+08:00	2568	5282	7850	873	8723	20821	41.9%	12.33%	30	30
15	嘉義縣六腳鄉	2018-11-25T01:02:41+08:00	2568	5282	7850	873	8723	20821	41.9%	12.33%	30	30
15	嘉義縣六腳鄉	2018-11-25T00:23:14+08:00	2568	5282	7850	873	8723	20821	41.9%	12.33%	30	30
15	嘉義縣六腳鄉	2018-11-25T03:32:48+08:00	2568	5282	7850	873	8723	20821	41.9%	12.33%	30	30
15	嘉義縣六腳鄉	2018-11-24T23:23:48+08:00	2568	5282	7850	873	8723	20821	41.9%	12.33%	30	30
15	嘉義縣六腳鄉	2018-11-25T06:24:10+08:00	2568	5282	7850	873	8723	20821	41.9%	12.33%	30	30
15	嘉義縣六腳鄉	2018-11-25T00:00:21+08:00	2568	5282	7850	873	8723	20821	41.9%	12.33%	30	30
15	嘉義縣六腳鄉	2018-11-24T22:23:25+08:00	2427	5002	7429	829	8258	19621	42.09%	12.37%	29	30
15	嘉義縣六腳鄉	2018-11-24T22:51:00+08:00	2427	5002	7429	829	8258	19621	42.09%	12.37%	29	30
15	嘉義縣六腳鄉	2018-11-25T03:44:37+08:00	2568	5282	7850	873	8723	20821	41.9%	12.33%	30	30
15	嘉義縣六腳鄉	2018-11-24T23:08:48+08:00	2568	5282	7850	873	8723	20821	41.9%	12.33%	30	30
15	嘉義縣六腳鄉	2018-11-24T22:16:22+08:00	2427	5002	7429	829	8258	19621	42.09%	12.37%	29	30
15	嘉義縣六腳鄉	2018-11-25T03:39:04+08:00	2568	5282	7850	873	8723	20821	41.9%	12.33%	30	30
15	嘉義縣六腳鄉	2018-11-25T01:26:04+08:00	2568	5282	7850	873	8723	20821	41.9%	12.33%	30	30
15	嘉義縣六腳鄉	2018-11-24T23:16:13+08:00	2568	5282	7850	873	8723	20821	41.9%	12.33%	30	30
15	嘉義縣六腳鄉	2018-11-24T23:35:20+08:00	2568	5282	7850	873	8723	20821	41.9%	12.33%	30	30
15	嘉義縣六腳鄉	2018-11-25T00:14:20+08:00	2568	5282	7850	873	8723	20821	41.9%	12.33%	30	30
15	嘉義縣六腳鄉	2018-11-24T22:33:48+08:00	2427	5002	7429	829	8258	19621	42.09%	12.37%	29	30
15	嘉義縣六腳鄉	2018-11-25T03:50:01+08:00	2568	5282	7850	873	8723	20821	41.9%	12.33%	30	30
15	嘉義縣六腳鄉	2018-11-24T23:47:40+08:00	2568	5282	7850	873	8723	20821	41.9%	12.33%	30	30
15	嘉義縣六腳鄉	2018-11-24T22:58:05+08:00	2568	5282	7850	873	8723	20821	41.9%	12.33%	30	30
15	嘉義縣六腳鄉	2018-11-25T00:09:46+08:00	2568	5282	7850	873	8723	20821	41.9%	12.33%	30	30
15	嘉義縣六腳鄉	2018-11-24T22:45:18+08:00	2427	5002	7429	829	8258	19621	42.09%	12.37%	29	30
15	嘉義縣六腳鄉	2018-11-25T03:56:24+08:00	2568	5282	7850	873	8723	20821	41.9%	12.33%	30	30
15	嘉義縣六腳鄉	2018-11-24T22:26:46+08:00	2427	5002	7429	829	8258	19621	42.09%	12.37%	29	30
15	嘉義縣六腳鄉	2018-11-24T23:01:42+08:00	2568	5282	7850	873	8723	20821	41.9%	12.33%	30	30
15	嘉義縣六腳鄉	2018-11-24T22:13:41+08:00	2427	5002	7429	829	8258	19621	42.09%	12.37%	29	30
15	嘉義縣六腳鄉	2018-11-25T04:03:02+08:00	2568	5282	7850	873	8723	20821	41.9%	12.33%	30	30
15	嘉義縣六腳鄉	2018-11-25T00:57:48+08:00	2568	5282	7850	873	8723	20821	41.9%	12.33%	30	30
15	嘉義縣六腳鄉	2018-11-24T22:19:47+08:00	2427	5002	7429	829	8258	19621	42.09%	12.37%	29	30
15	嘉義縣六腳鄉	2018-11-24T22:40:37+08:00	2427	5002	7429	829	8258	19621	42.09%	12.37%	29	30
15	嘉義縣六腳鄉	2018-11-24T22:30:20+08:00	2427	5002	7429	829	8258	19621	42.09%	12.37%	29	30
15	嘉義縣六腳鄉	2018-11-24T23:27:28+08:00	2568	5282	7850	873	8723	20821	41.9%	12.33%	30	30
15	嘉義縣六腳鄉	2018-11-24T23:55:57+08:00	2568	5282	7850	873	8723	20821	41.9%	12.33%	30	30
15	嘉義縣六腳鄉	2018-11-25T06:14:02+08:00	2568	5282	7850	873	8723	20821	41.9%	12.33%	30	30
15	嘉義縣六腳鄉	2018-11-25T00:18:43+08:00	2568	5282	7850	873	8723	20821	41.9%	12.33%	30	30
15	嘉義縣六腳鄉	2018-11-25T01:07:37+08:00	2568	5282	7850	873	8723	20821	41.9%	12.33%	30	30
15	嘉義縣六腳鄉	2018-11-24T23:12:27+08:00	2568	5282	7850	873	8723	20821	41.9%	12.33%	30	30
15	嘉義縣六腳鄉	2018-11-24T22:37:11+08:00	2427	5002	7429	829	8258	19621	42.09%	12.37%	29	30
15	嘉義縣六腳鄉	2018-11-24T23:39:29+08:00	2568	5282	7850	873	8723	20821	41.9%	12.33%	30	30
15	嘉義縣六腳鄉	2018-11-24T23:31:23+08:00	2568	5282	7850	873	8723	20821	41.9%	12.33%	30	30
15	嘉義縣六腳鄉	2018-11-24T23:20:02+08:00	2568	5282	7850	873	8723	20821	41.9%	12.33%	30	30
15	宜蘭縣頭城鎮	2018-11-25T03:56:26+08:00	4332	8342	12674	1159	13833	25135	55.03%	17.23%	32	32
15	宜蘭縣頭城鎮	2018-11-24T23:05:15+08:00	4332	8342	12674	1159	13833	25135	55.03%	17.23%	32	32
15	宜蘭縣頭城鎮	2018-11-25T01:18:08+08:00	4332	8342	12674	1159	13833	25135	55.03%	17.23%	32	32
15	宜蘭縣頭城鎮	2018-11-24T23:43:29+08:00	4332	8342	12674	1159	13833	25135	55.03%	17.23%	32	32
15	宜蘭縣頭城鎮	2018-11-25T06:19:09+08:00	4332	8342	12674	1159	13833	25135	55.03%	17.23%	32	32
15	宜蘭縣頭城鎮	2018-11-24T22:58:07+08:00	4332	8342	12674	1159	13833	25135	55.03%	17.23%	32	32
15	宜蘭縣頭城鎮	2018-11-24T22:41:49+08:00	4332	8342	12674	1159	13833	25135	55.03%	17.23%	32	32
15	宜蘭縣頭城鎮	2018-11-24T23:39:31+08:00	4332	8342	12674	1159	13833	25135	55.03%	17.23%	32	32
15	宜蘭縣頭城鎮	2018-11-24T23:47:42+08:00	4332	8342	12674	1159	13833	25135	55.03%	17.23%	32	32
15	宜蘭縣頭城鎮	2018-11-24T22:30:22+08:00	4332	8342	12674	1159	13833	25135	55.03%	17.23%	32	32
15	宜蘭縣頭城鎮	2018-11-24T23:51:47+08:00	4332	8342	12674	1159	13833	25135	55.03%	17.23%	32	32
15	宜蘭縣頭城鎮	2018-11-25T06:09:08+08:00	4332	8342	12674	1159	13833	25135	55.03%	17.23%	32	32
15	宜蘭縣頭城鎮	2018-11-24T22:13:43+08:00	4332	8342	12674	1159	13833	25135	55.03%	17.23%	32	32
15	宜蘭縣頭城鎮	2018-11-25T03:44:39+08:00	4332	8342	12674	1159	13833	25135	55.03%	17.23%	32	32
15	宜蘭縣頭城鎮	2018-11-24T23:23:49+08:00	4332	8342	12674	1159	13833	25135	55.03%	17.23%	32	32
15	宜蘭縣頭城鎮	2018-11-24T22:33:49+08:00	4332	8342	12674	1159	13833	25135	55.03%	17.23%	32	32
15	宜蘭縣頭城鎮	2018-11-24T23:16:14+08:00	4332	8342	12674	1159	13833	25135	55.03%	17.23%	32	32
15	宜蘭縣頭城鎮	2018-11-24T22:37:13+08:00	4332	8342	12674	1159	13833	25135	55.03%	17.23%	32	32
15	宜蘭縣頭城鎮	2018-11-24T22:16:24+08:00	4332	8342	12674	1159	13833	25135	55.03%	17.23%	32	32
15	宜蘭縣頭城鎮	2018-11-24T23:35:21+08:00	4332	8342	12674	1159	13833	25135	55.03%	17.23%	32	32
15	宜蘭縣頭城鎮	2018-11-24T22:45:19+08:00	4332	8342	12674	1159	13833	25135	55.03%	17.23%	32	32
15	宜蘭縣頭城鎮	2018-11-24T22:54:36+08:00	4332	8342	12674	1159	13833	25135	55.03%	17.23%	32	32
15	宜蘭縣頭城鎮	2018-11-25T00:09:48+08:00	4332	8342	12674	1159	13833	25135	55.03%	17.23%	32	32
15	宜蘭縣頭城鎮	2018-11-24T23:01:44+08:00	4332	8342	12674	1159	13833	25135	55.03%	17.23%	32	32
15	宜蘭縣頭城鎮	2018-11-24T22:26:47+08:00	4332	8342	12674	1159	13833	25135	55.03%	17.23%	32	32
15	宜蘭縣頭城鎮	2018-11-25T00:05:17+08:00	4332	8342	12674	1159	13833	25135	55.03%	17.23%	32	32
15	宜蘭縣頭城鎮	2018-11-25T01:12:57+08:00	4332	8342	12674	1159	13833	25135	55.03%	17.23%	32	32
15	宜蘭縣頭城鎮	2018-11-25T00:57:49+08:00	4332	8342	12674	1159	13833	25135	55.03%	17.23%	32	32
15	宜蘭縣頭城鎮	2018-11-24T22:19:48+08:00	4332	8342	12674	1159	13833	25135	55.03%	17.23%	32	32
15	宜蘭縣頭城鎮	2018-11-25T04:03:04+08:00	4332	8342	12674	1159	13833	25135	55.03%	17.23%	32	32
15	宜蘭縣頭城鎮	2018-11-24T22:40:39+08:00	4332	8342	12674	1159	13833	25135	55.03%	17.23%	32	32
15	宜蘭縣頭城鎮	2018-11-25T03:32:51+08:00	4332	8342	12674	1159	13833	25135	55.03%	17.23%	32	32
15	宜蘭縣頭城鎮	2018-11-24T23:08:50+08:00	4332	8342	12674	1159	13833	25135	55.03%	17.23%	32	32
15	宜蘭縣頭城鎮	2018-11-24T22:23:27+08:00	4332	8342	12674	1159	13833	25135	55.03%	17.23%	32	32
15	宜蘭縣頭城鎮	2018-11-24T22:51:02+08:00	4332	8342	12674	1159	13833	25135	55.03%	17.23%	32	32
15	宜蘭縣頭城鎮	2018-11-25T06:14:04+08:00	4332	8342	12674	1159	13833	25135	55.03%	17.23%	32	32
15	宜蘭縣頭城鎮	2018-11-24T23:55:59+08:00	4332	8342	12674	1159	13833	25135	55.03%	17.23%	32	32
15	宜蘭縣頭城鎮	2018-11-25T06:24:12+08:00	4332	8342	12674	1159	13833	25135	55.03%	17.23%	32	32
15	宜蘭縣頭城鎮	2018-11-24T23:27:29+08:00	4332	8342	12674	1159	13833	25135	55.03%	17.23%	32	32
15	宜蘭縣頭城鎮	2018-11-25T00:00:22+08:00	4332	8342	12674	1159	13833	25135	55.03%	17.23%	32	32
15	宜蘭縣頭城鎮	2018-11-25T00:23:16+08:00	4332	8342	12674	1159	13833	25135	55.03%	17.23%	32	32
15	宜蘭縣頭城鎮	2018-11-25T01:02:43+08:00	4332	8342	12674	1159	13833	25135	55.03%	17.23%	32	32
15	宜蘭縣頭城鎮	2018-11-25T06:29:30+08:00	4332	8342	12674	1159	13833	25135	55.03%	17.23%	32	32
15	宜蘭縣頭城鎮	2018-11-24T23:12:29+08:00	4332	8342	12674	1159	13833	25135	55.03%	17.23%	32	32
15	宜蘭縣頭城鎮	2018-11-24T23:31:25+08:00	4332	8342	12674	1159	13833	25135	55.03%	17.23%	32	32
15	宜蘭縣頭城鎮	2018-11-24T23:20:04+08:00	4332	8342	12674	1159	13833	25135	55.03%	17.23%	32	32
15	宜蘭縣頭城鎮	2018-11-25T00:14:22+08:00	4332	8342	12674	1159	13833	25135	55.03%	17.23%	32	32
15	宜蘭縣頭城鎮	2018-11-25T00:18:45+08:00	4332	8342	12674	1159	13833	25135	55.03%	17.23%	32	32
15	宜蘭縣頭城鎮	2018-11-25T01:07:38+08:00	4332	8342	12674	1159	13833	25135	55.03%	17.23%	32	32
15	宜蘭縣頭城鎮	2018-11-25T03:39:06+08:00	4332	8342	12674	1159	13833	25135	55.03%	17.23%	32	32
15	宜蘭縣頭城鎮	2018-11-25T01:26:06+08:00	4332	8342	12674	1159	13833	25135	55.03%	17.23%	32	32
15	宜蘭縣頭城鎮	2018-11-25T03:50:02+08:00	4332	8342	12674	1159	13833	25135	55.03%	17.23%	32	32
15	嘉義縣阿里山鄉	2018-11-24T22:58:06+08:00	430	1610	2040	134	2174	4691	46.34%	9.17%	13	13
15	嘉義縣阿里山鄉	2018-11-25T06:19:08+08:00	430	1610	2040	134	2174	4691	46.34%	9.17%	13	13
15	嘉義縣阿里山鄉	2018-11-25T01:18:06+08:00	430	1610	2040	134	2174	4691	46.34%	9.17%	13	13
15	嘉義縣阿里山鄉	2018-11-25T06:29:28+08:00	430	1610	2040	134	2174	4691	46.34%	9.17%	13	13
15	嘉義縣阿里山鄉	2018-11-24T23:43:27+08:00	430	1610	2040	134	2174	4691	46.34%	9.17%	13	13
15	嘉義縣阿里山鄉	2018-11-24T22:54:35+08:00	430	1610	2040	134	2174	4691	46.34%	9.17%	13	13
15	嘉義縣阿里山鄉	2018-11-24T23:05:14+08:00	430	1610	2040	134	2174	4691	46.34%	9.17%	13	13
15	嘉義縣阿里山鄉	2018-11-25T00:05:15+08:00	430	1610	2040	134	2174	4691	46.34%	9.17%	13	13
15	嘉義縣阿里山鄉	2018-11-24T22:41:47+08:00	430	1610	2040	134	2174	4691	46.34%	9.17%	13	13
15	嘉義縣阿里山鄉	2018-11-24T22:13:42+08:00	270	1082	1352	97	1449	3184	45.51%	8.48%	10	13
15	嘉義縣阿里山鄉	2018-11-24T23:51:46+08:00	430	1610	2040	134	2174	4691	46.34%	9.17%	13	13
15	嘉義縣阿里山鄉	2018-11-25T06:09:06+08:00	430	1610	2040	134	2174	4691	46.34%	9.17%	13	13
15	嘉義縣阿里山鄉	2018-11-25T01:02:41+08:00	430	1610	2040	134	2174	4691	46.34%	9.17%	13	13
15	嘉義縣阿里山鄉	2018-11-25T00:23:14+08:00	430	1610	2040	134	2174	4691	46.34%	9.17%	13	13
15	嘉義縣阿里山鄉	2018-11-25T06:24:11+08:00	430	1610	2040	134	2174	4691	46.34%	9.17%	13	13
15	嘉義縣阿里山鄉	2018-11-24T23:23:48+08:00	430	1610	2040	134	2174	4691	46.34%	9.17%	13	13
15	嘉義縣阿里山鄉	2018-11-25T00:00:21+08:00	430	1610	2040	134	2174	4691	46.34%	9.17%	13	13
15	嘉義縣阿里山鄉	2018-11-24T22:23:25+08:00	270	1082	1352	97	1449	3184	45.51%	8.48%	10	13
15	嘉義縣阿里山鄉	2018-11-24T22:51:00+08:00	430	1610	2040	134	2174	4691	46.34%	9.17%	13	13
15	嘉義縣阿里山鄉	2018-11-25T03:32:49+08:00	430	1610	2040	134	2174	4691	46.34%	9.17%	13	13
15	嘉義縣阿里山鄉	2018-11-25T03:44:37+08:00	430	1610	2040	134	2174	4691	46.34%	9.17%	13	13
15	嘉義縣阿里山鄉	2018-11-24T23:08:48+08:00	430	1610	2040	134	2174	4691	46.34%	9.17%	13	13
15	嘉義縣阿里山鄉	2018-11-24T22:16:22+08:00	270	1082	1352	97	1449	3184	45.51%	8.48%	10	13
15	嘉義縣阿里山鄉	2018-11-25T01:26:04+08:00	430	1610	2040	134	2174	4691	46.34%	9.17%	13	13
15	嘉義縣阿里山鄉	2018-11-24T23:16:13+08:00	430	1610	2040	134	2174	4691	46.34%	9.17%	13	13
15	嘉義縣阿里山鄉	2018-11-24T23:35:20+08:00	430	1610	2040	134	2174	4691	46.34%	9.17%	13	13
15	嘉義縣阿里山鄉	2018-11-25T00:14:20+08:00	430	1610	2040	134	2174	4691	46.34%	9.17%	13	13
15	嘉義縣阿里山鄉	2018-11-25T03:39:05+08:00	430	1610	2040	134	2174	4691	46.34%	9.17%	13	13
15	嘉義縣阿里山鄉	2018-11-24T22:33:48+08:00	320	1276	1596	122	1718	3721	46.17%	8.6%	12	13
15	嘉義縣阿里山鄉	2018-11-25T03:50:01+08:00	430	1610	2040	134	2174	4691	46.34%	9.17%	13	13
15	嘉義縣阿里山鄉	2018-11-25T01:12:56+08:00	430	1610	2040	134	2174	4691	46.34%	9.17%	13	13
15	嘉義縣阿里山鄉	2018-11-24T23:47:40+08:00	430	1610	2040	134	2174	4691	46.34%	9.17%	13	13
15	嘉義縣阿里山鄉	2018-11-24T23:01:43+08:00	430	1610	2040	134	2174	4691	46.34%	9.17%	13	13
15	嘉義縣阿里山鄉	2018-11-25T00:09:46+08:00	430	1610	2040	134	2174	4691	46.34%	9.17%	13	13
15	嘉義縣阿里山鄉	2018-11-25T03:56:25+08:00	430	1610	2040	134	2174	4691	46.34%	9.17%	13	13
15	嘉義縣阿里山鄉	2018-11-24T22:45:18+08:00	430	1610	2040	134	2174	4691	46.34%	9.17%	13	13
15	嘉義縣阿里山鄉	2018-11-24T22:26:46+08:00	270	1082	1352	97	1449	3184	45.51%	8.48%	10	13
15	嘉義縣阿里山鄉	2018-11-24T22:40:38+08:00	430	1610	2040	134	2174	4691	46.34%	9.17%	13	13
15	嘉義縣阿里山鄉	2018-11-25T04:03:03+08:00	430	1610	2040	134	2174	4691	46.34%	9.17%	13	13
15	嘉義縣阿里山鄉	2018-11-25T00:57:48+08:00	430	1610	2040	134	2174	4691	46.34%	9.17%	13	13
15	嘉義縣阿里山鄉	2018-11-24T22:19:47+08:00	270	1082	1352	97	1449	3184	45.51%	8.48%	10	13
15	嘉義縣阿里山鄉	2018-11-24T22:30:20+08:00	296	1195	1491	116	1607	3430	46.85%	8.63%	11	13
15	嘉義縣阿里山鄉	2018-11-24T23:27:28+08:00	430	1610	2040	134	2174	4691	46.34%	9.17%	13	13
15	嘉義縣阿里山鄉	2018-11-24T23:55:58+08:00	430	1610	2040	134	2174	4691	46.34%	9.17%	13	13
15	嘉義縣阿里山鄉	2018-11-25T06:14:02+08:00	430	1610	2040	134	2174	4691	46.34%	9.17%	13	13
15	嘉義縣阿里山鄉	2018-11-25T00:18:44+08:00	430	1610	2040	134	2174	4691	46.34%	9.17%	13	13
15	嘉義縣阿里山鄉	2018-11-24T23:20:03+08:00	430	1610	2040	134	2174	4691	46.34%	9.17%	13	13
15	嘉義縣阿里山鄉	2018-11-25T01:07:37+08:00	430	1610	2040	134	2174	4691	46.34%	9.17%	13	13
15	嘉義縣阿里山鄉	2018-11-24T23:12:27+08:00	430	1610	2040	134	2174	4691	46.34%	9.17%	13	13
15	嘉義縣阿里山鄉	2018-11-24T22:37:11+08:00	430	1610	2040	134	2174	4691	46.34%	9.17%	13	13
15	嘉義縣阿里山鄉	2018-11-24T23:39:29+08:00	430	1610	2040	134	2174	4691	46.34%	9.17%	13	13
15	嘉義縣阿里山鄉	2018-11-24T23:31:24+08:00	430	1610	2040	134	2174	4691	46.34%	9.17%	13	13
15	臺中市霧峰區	2018-11-25T03:49:55+08:00	9513	21777	31290	2297	33587	55225	60.82%	17.23%	43	43
15	臺中市霧峰區	2018-11-25T06:19:01+08:00	9513	21777	31290	2297	33587	55225	60.82%	17.23%	43	43
15	臺中市霧峰區	2018-11-24T23:16:07+08:00	9244	21145	30389	2234	32623	53652	60.8%	17.23%	42	43
15	臺中市霧峰區	2018-11-25T03:56:18+08:00	9513	21777	31290	2297	33587	55225	60.82%	17.23%	43	43
15	臺中市霧峰區	2018-11-24T22:45:12+08:00	9045	20659	29704	2188	31892	52385	60.88%	17.27%	41	43
15	臺中市霧峰區	2018-11-24T23:43:21+08:00	9513	21777	31290	2297	33587	55225	60.82%	17.23%	43	43
15	臺中市霧峰區	2018-11-24T22:41:40+08:00	9045	20659	29704	2188	31892	52385	60.88%	17.27%	41	43
15	臺中市霧峰區	2018-11-25T00:18:36+08:00	9513	21777	31290	2297	33587	55225	60.82%	17.23%	43	43
15	臺中市霧峰區	2018-11-24T23:51:40+08:00	9513	21777	31290	2297	33587	55225	60.82%	17.23%	43	43
15	臺中市霧峰區	2018-11-24T22:40:32+08:00	9045	20659	29704	2188	31892	52385	60.88%	17.27%	41	43
15	臺中市霧峰區	2018-11-25T01:25:57+08:00	9513	21777	31290	2297	33587	55225	60.82%	17.23%	43	43
15	臺中市霧峰區	2018-11-24T22:30:14+08:00	8092	18537	26629	1983	28612	47092	60.76%	17.18%	37	43
15	臺中市霧峰區	2018-11-25T06:24:04+08:00	9513	21777	31290	2297	33587	55225	60.82%	17.23%	43	43
15	臺中市霧峰區	2018-11-25T00:23:08+08:00	9513	21777	31290	2297	33587	55225	60.82%	17.23%	43	43
15	臺中市霧峰區	2018-11-25T00:57:42+08:00	9513	21777	31290	2297	33587	55225	60.82%	17.23%	43	43
15	臺中市霧峰區	2018-11-24T23:27:22+08:00	9513	21777	31290	2297	33587	55225	60.82%	17.23%	43	43
15	臺中市霧峰區	2018-11-24T22:57:59+08:00	9045	20659	29704	2188	31892	52385	60.88%	17.27%	41	43
15	臺中市霧峰區	2018-11-25T03:32:41+08:00	9513	21777	31290	2297	33587	55225	60.82%	17.23%	43	43
15	臺中市霧峰區	2018-11-24T23:08:41+08:00	9244	21145	30389	2234	32623	53652	60.8%	17.23%	42	43
15	臺中市霧峰區	2018-11-24T22:13:33+08:00	7205	16696	23901	1805	25706	42271	60.81%	17.04%	34	43
15	臺中市霧峰區	2018-11-24T23:19:56+08:00	9513	21777	31290	2297	33587	55225	60.82%	17.23%	43	43
15	臺中市霧峰區	2018-11-25T01:17:58+08:00	9513	21777	31290	2297	33587	55225	60.82%	17.23%	43	43
15	臺中市霧峰區	2018-11-24T22:54:29+08:00	9045	20659	29704	2188	31892	52385	60.88%	17.27%	41	43
15	臺中市霧峰區	2018-11-24T23:47:33+08:00	9513	21777	31290	2297	33587	55225	60.82%	17.23%	43	43
15	臺中市霧峰區	2018-11-25T06:08:58+08:00	9513	21777	31290	2297	33587	55225	60.82%	17.23%	43	43
15	臺中市霧峰區	2018-11-24T22:16:15+08:00	7205	16696	23901	1805	25706	42271	60.81%	17.04%	34	43
15	臺中市霧峰區	2018-11-24T23:31:16+08:00	9513	21777	31290	2297	33587	55225	60.82%	17.23%	43	43
15	臺中市霧峰區	2018-11-25T01:12:48+08:00	9513	21777	31290	2297	33587	55225	60.82%	17.23%	43	43
15	臺中市霧峰區	2018-11-24T23:05:08+08:00	9244	21145	30389	2234	32623	53652	60.8%	17.23%	42	43
15	臺中市霧峰區	2018-11-25T04:02:57+08:00	9513	21777	31290	2297	33587	55225	60.82%	17.23%	43	43
15	臺中市霧峰區	2018-11-25T00:05:09+08:00	9513	21777	31290	2297	33587	55225	60.82%	17.23%	43	43
15	臺中市霧峰區	2018-11-25T06:29:22+08:00	9513	21777	31290	2297	33587	55225	60.82%	17.23%	43	43
15	臺中市霧峰區	2018-11-25T06:13:57+08:00	9513	21777	31290	2297	33587	55225	60.82%	17.23%	43	43
15	臺中市霧峰區	2018-11-24T22:50:53+08:00	9045	20659	29704	2188	31892	52385	60.88%	17.27%	41	43
15	臺中市霧峰區	2018-11-24T22:37:05+08:00	8826	20236	29062	2140	31202	51391	60.71%	17.17%	40	43
15	臺中市霧峰區	2018-11-24T22:26:41+08:00	7501	17292	24793	1870	26663	43931	60.69%	17.07%	35	43
15	臺中市霧峰區	2018-11-24T22:19:41+08:00	7205	16696	23901	1805	25706	42271	60.81%	17.04%	34	43
15	臺中市霧峰區	2018-11-25T03:38:59+08:00	9513	21777	31290	2297	33587	55225	60.82%	17.23%	43	43
15	臺中市霧峰區	2018-11-25T03:44:29+08:00	9513	21777	31290	2297	33587	55225	60.82%	17.23%	43	43
15	臺中市霧峰區	2018-11-25T01:02:35+08:00	9513	21777	31290	2297	33587	55225	60.82%	17.23%	43	43
15	臺中市霧峰區	2018-11-24T23:23:42+08:00	9513	21777	31290	2297	33587	55225	60.82%	17.23%	43	43
15	臺中市霧峰區	2018-11-24T22:23:18+08:00	7205	16696	23901	1805	25706	42271	60.81%	17.04%	34	43
15	臺中市霧峰區	2018-11-25T00:00:15+08:00	9513	21777	31290	2297	33587	55225	60.82%	17.23%	43	43
15	臺中市霧峰區	2018-11-24T23:55:51+08:00	9513	21777	31290	2297	33587	55225	60.82%	17.23%	43	43
15	臺中市霧峰區	2018-11-24T23:35:15+08:00	9513	21777	31290	2297	33587	55225	60.82%	17.23%	43	43
15	臺中市霧峰區	2018-11-24T23:39:21+08:00	9513	21777	31290	2297	33587	55225	60.82%	17.23%	43	43
15	臺中市霧峰區	2018-11-24T23:12:20+08:00	9244	21145	30389	2234	32623	53652	60.8%	17.23%	42	43
15	臺中市霧峰區	2018-11-25T00:14:14+08:00	9513	21777	31290	2297	33587	55225	60.82%	17.23%	43	43
15	臺中市霧峰區	2018-11-24T23:01:35+08:00	9244	21145	30389	2234	32623	53652	60.8%	17.23%	42	43
15	臺中市霧峰區	2018-11-25T00:09:39+08:00	9513	21777	31290	2297	33587	55225	60.82%	17.23%	43	43
15	臺中市霧峰區	2018-11-25T01:07:31+08:00	9513	21777	31290	2297	33587	55225	60.82%	17.23%	43	43
15	臺中市霧峰區	2018-11-24T22:33:42+08:00	8574	19746	28320	2099	30419	50025	60.81%	17.14%	39	43
15	花蓮縣瑞穗鄉	2018-11-24T23:56:00+08:00	901	2772	3673	375	4048	8414	48.11%	10.71%	11	13
15	花蓮縣瑞穗鄉	2018-11-24T22:58:08+08:00	694	2106	2800	314	3114	6187	50.33%	11.22%	8	13
15	花蓮縣瑞穗鄉	2018-11-24T23:43:29+08:00	789	2437	3226	348	3574	7601	47.02%	10.38%	10	13
15	花蓮縣瑞穗鄉	2018-11-25T01:18:09+08:00	1037	3135	4172	446	4618	9416	49.04%	11.01%	12	13
15	花蓮縣瑞穗鄉	2018-11-25T03:56:27+08:00	1135	3451	4586	509	5095	10279	49.57%	11.04%	13	13
15	花蓮縣瑞穗鄉	2018-11-24T23:47:42+08:00	789	2437	3226	348	3574	7601	47.02%	10.38%	10	13
15	花蓮縣瑞穗鄉	2018-11-24T22:30:22+08:00	694	2106	2800	314	3114	6187	50.33%	11.22%	8	13
15	花蓮縣瑞穗鄉	2018-11-24T23:27:30+08:00	733	2257	2990	324	3314	7055	46.97%	10.39%	9	13
15	花蓮縣瑞穗鄉	2018-11-24T23:51:48+08:00	901	2772	3673	375	4048	8414	48.11%	10.71%	11	13
15	花蓮縣瑞穗鄉	2018-11-25T06:09:08+08:00	1135	3451	4586	509	5095	10279	49.57%	11.04%	13	13
15	花蓮縣瑞穗鄉	2018-11-24T22:13:44+08:00	581	1723	2304	253	2557	5212	49.06%	11.15%	7	13
15	花蓮縣瑞穗鄉	2018-11-25T00:57:50+08:00	901	2772	3673	375	4048	8414	48.11%	10.71%	11	13
15	花蓮縣瑞穗鄉	2018-11-25T03:44:39+08:00	1135	3451	4586	509	5095	10279	49.57%	11.04%	13	13
15	花蓮縣瑞穗鄉	2018-11-24T23:31:26+08:00	733	2257	2990	324	3314	7055	46.97%	10.39%	9	13
15	花蓮縣瑞穗鄉	2018-11-24T22:37:13+08:00	694	2106	2800	314	3114	6187	50.33%	11.22%	8	13
15	花蓮縣瑞穗鄉	2018-11-24T22:16:24+08:00	581	1723	2304	253	2557	5212	49.06%	11.15%	7	13
15	花蓮縣瑞穗鄉	2018-11-24T23:20:06+08:00	733	2257	2990	324	3314	7055	46.97%	10.39%	9	13
15	花蓮縣瑞穗鄉	2018-11-25T00:18:46+08:00	901	2772	3673	375	4048	8414	48.11%	10.71%	11	13
15	花蓮縣瑞穗鄉	2018-11-24T23:16:15+08:00	733	2257	2990	324	3314	7055	46.97%	10.39%	9	13
15	花蓮縣瑞穗鄉	2018-11-25T01:12:58+08:00	1037	3135	4172	446	4618	9416	49.04%	11.01%	12	13
15	花蓮縣瑞穗鄉	2018-11-25T00:05:17+08:00	901	2772	3673	375	4048	8414	48.11%	10.71%	11	13
15	花蓮縣瑞穗鄉	2018-11-24T23:05:16+08:00	694	2106	2800	314	3114	6187	50.33%	11.22%	8	13
15	花蓮縣瑞穗鄉	2018-11-24T23:39:32+08:00	733	2257	2990	324	3314	7055	46.97%	10.39%	9	13
15	花蓮縣瑞穗鄉	2018-11-24T22:54:37+08:00	694	2106	2800	314	3114	6187	50.33%	11.22%	8	13
15	花蓮縣瑞穗鄉	2018-11-24T22:33:50+08:00	694	2106	2800	314	3114	6187	50.33%	11.22%	8	13
15	花蓮縣瑞穗鄉	2018-11-24T22:45:20+08:00	694	2106	2800	314	3114	6187	50.33%	11.22%	8	13
15	花蓮縣瑞穗鄉	2018-11-24T22:26:48+08:00	694	2106	2800	314	3114	6187	50.33%	11.22%	8	13
15	花蓮縣瑞穗鄉	2018-11-24T23:01:45+08:00	694	2106	2800	314	3114	6187	50.33%	11.22%	8	13
15	花蓮縣瑞穗鄉	2018-11-25T00:09:49+08:00	901	2772	3673	375	4048	8414	48.11%	10.71%	11	13
15	花蓮縣瑞穗鄉	2018-11-25T04:03:05+08:00	1135	3451	4586	509	5095	10279	49.57%	11.04%	13	13
15	花蓮縣瑞穗鄉	2018-11-24T23:23:50+08:00	733	2257	2990	324	3314	7055	46.97%	10.39%	9	13
15	花蓮縣瑞穗鄉	2018-11-24T22:19:49+08:00	694	2106	2800	314	3114	6187	50.33%	11.22%	8	13
15	花蓮縣瑞穗鄉	2018-11-24T22:40:39+08:00	694	2106	2800	314	3114	6187	50.33%	11.22%	8	13
15	花蓮縣瑞穗鄉	2018-11-25T03:32:51+08:00	1135	3451	4586	509	5095	10279	49.57%	11.04%	13	13
15	花蓮縣瑞穗鄉	2018-11-24T23:08:50+08:00	733	2257	2990	324	3314	7055	46.97%	10.39%	9	13
15	花蓮縣瑞穗鄉	2018-11-25T06:14:04+08:00	1135	3451	4586	509	5095	10279	49.57%	11.04%	13	13
15	花蓮縣瑞穗鄉	2018-11-25T00:00:23+08:00	901	2772	3673	375	4048	8414	48.11%	10.71%	11	13
15	花蓮縣瑞穗鄉	2018-11-24T22:51:03+08:00	694	2106	2800	314	3114	6187	50.33%	11.22%	8	13
15	花蓮縣瑞穗鄉	2018-11-24T22:23:28+08:00	694	2106	2800	314	3114	6187	50.33%	11.22%	8	13
15	花蓮縣瑞穗鄉	2018-11-25T06:24:13+08:00	1135	3451	4586	509	5095	10279	49.57%	11.04%	13	13
15	花蓮縣瑞穗鄉	2018-11-25T00:23:16+08:00	901	2772	3673	375	4048	8414	48.11%	10.71%	11	13
15	花蓮縣瑞穗鄉	2018-11-25T01:02:43+08:00	901	2772	3673	375	4048	8414	48.11%	10.71%	11	13
15	花蓮縣瑞穗鄉	2018-11-25T06:19:10+08:00	1135	3451	4586	509	5095	10279	49.57%	11.04%	13	13
15	花蓮縣瑞穗鄉	2018-11-25T06:29:30+08:00	1135	3451	4586	509	5095	10279	49.57%	11.04%	13	13
15	花蓮縣瑞穗鄉	2018-11-24T23:12:29+08:00	733	2257	2990	324	3314	7055	46.97%	10.39%	9	13
15	花蓮縣瑞穗鄉	2018-11-25T03:50:03+08:00	1135	3451	4586	509	5095	10279	49.57%	11.04%	13	13
15	花蓮縣瑞穗鄉	2018-11-25T01:07:39+08:00	1037	3135	4172	446	4618	9416	49.04%	11.01%	12	13
15	花蓮縣瑞穗鄉	2018-11-25T01:26:07+08:00	1037	3135	4172	446	4618	9416	49.04%	11.01%	12	13
15	花蓮縣瑞穗鄉	2018-11-25T03:39:07+08:00	1135	3451	4586	509	5095	10279	49.57%	11.04%	13	13
15	花蓮縣瑞穗鄉	2018-11-24T22:41:50+08:00	694	2106	2800	314	3114	6187	50.33%	11.22%	8	13
15	花蓮縣瑞穗鄉	2018-11-25T00:14:22+08:00	901	2772	3673	375	4048	8414	48.11%	10.71%	11	13
15	花蓮縣瑞穗鄉	2018-11-24T23:35:22+08:00	733	2257	2990	324	3314	7055	46.97%	10.39%	9	13
15	臺東縣池上鄉	2018-11-24T23:56:00+08:00	894	2075	2969	336	3305	7162	46.15%	12.48%	12	12
15	臺東縣池上鄉	2018-11-24T22:58:08+08:00	894	2075	2969	336	3305	7162	46.15%	12.48%	12	12
15	臺東縣池上鄉	2018-11-24T23:47:43+08:00	894	2075	2969	336	3305	7162	46.15%	12.48%	12	12
15	臺東縣池上鄉	2018-11-25T03:56:27+08:00	894	2075	2969	336	3305	7162	46.15%	12.48%	12	12
15	臺東縣池上鄉	2018-11-24T23:12:30+08:00	894	2075	2969	336	3305	7162	46.15%	12.48%	12	12
15	臺東縣池上鄉	2018-11-24T23:27:30+08:00	894	2075	2969	336	3305	7162	46.15%	12.48%	12	12
15	臺東縣池上鄉	2018-11-25T06:09:09+08:00	894	2075	2969	336	3305	7162	46.15%	12.48%	12	12
15	臺東縣池上鄉	2018-11-24T23:51:48+08:00	894	2075	2969	336	3305	7162	46.15%	12.48%	12	12
15	臺東縣池上鄉	2018-11-24T22:30:23+08:00	793	1823	2616	277	2893	6306	45.88%	12.58%	11	12
15	臺東縣池上鄉	2018-11-25T03:32:52+08:00	894	2075	2969	336	3305	7162	46.15%	12.48%	12	12
15	臺東縣池上鄉	2018-11-24T22:13:44+08:00	793	1823	2616	277	2893	6306	45.88%	12.58%	11	12
15	臺東縣池上鄉	2018-11-25T03:44:40+08:00	894	2075	2969	336	3305	7162	46.15%	12.48%	12	12
15	臺東縣池上鄉	2018-11-25T00:57:51+08:00	894	2075	2969	336	3305	7162	46.15%	12.48%	12	12
15	臺東縣池上鄉	2018-11-24T22:16:25+08:00	793	1823	2616	277	2893	6306	45.88%	12.58%	11	12
15	臺東縣池上鄉	2018-11-24T23:31:26+08:00	894	2075	2969	336	3305	7162	46.15%	12.48%	12	12
15	臺東縣池上鄉	2018-11-25T00:09:50+08:00	894	2075	2969	336	3305	7162	46.15%	12.48%	12	12
15	臺東縣池上鄉	2018-11-25T00:18:47+08:00	894	2075	2969	336	3305	7162	46.15%	12.48%	12	12
15	臺東縣池上鄉	2018-11-24T23:20:08+08:00	894	2075	2969	336	3305	7162	46.15%	12.48%	12	12
15	臺東縣池上鄉	2018-11-24T22:37:13+08:00	793	1823	2616	277	2893	6306	45.88%	12.58%	11	12
15	臺東縣池上鄉	2018-11-24T23:16:15+08:00	894	2075	2969	336	3305	7162	46.15%	12.48%	12	12
15	臺東縣池上鄉	2018-11-25T01:12:58+08:00	894	2075	2969	336	3305	7162	46.15%	12.48%	12	12
15	臺東縣池上鄉	2018-11-25T00:05:17+08:00	894	2075	2969	336	3305	7162	46.15%	12.48%	12	12
15	臺東縣池上鄉	2018-11-24T23:05:16+08:00	894	2075	2969	336	3305	7162	46.15%	12.48%	12	12
15	臺東縣池上鄉	2018-11-24T23:39:32+08:00	894	2075	2969	336	3305	7162	46.15%	12.48%	12	12
15	臺東縣池上鄉	2018-11-24T22:54:37+08:00	894	2075	2969	336	3305	7162	46.15%	12.48%	12	12
15	臺東縣池上鄉	2018-11-24T22:33:50+08:00	793	1823	2616	277	2893	6306	45.88%	12.58%	11	12
15	臺東縣池上鄉	2018-11-24T22:45:20+08:00	793	1823	2616	277	2893	6306	45.88%	12.58%	11	12
15	臺東縣池上鄉	2018-11-24T22:26:48+08:00	793	1823	2616	277	2893	6306	45.88%	12.58%	11	12
15	臺東縣池上鄉	2018-11-24T23:01:45+08:00	894	2075	2969	336	3305	7162	46.15%	12.48%	12	12
15	臺東縣池上鄉	2018-11-25T04:03:05+08:00	894	2075	2969	336	3305	7162	46.15%	12.48%	12	12
15	臺東縣池上鄉	2018-11-24T23:08:51+08:00	894	2075	2969	336	3305	7162	46.15%	12.48%	12	12
15	臺東縣池上鄉	2018-11-24T23:23:50+08:00	894	2075	2969	336	3305	7162	46.15%	12.48%	12	12
15	臺東縣池上鄉	2018-11-24T22:19:49+08:00	793	1823	2616	277	2893	6306	45.88%	12.58%	11	12
15	臺東縣池上鄉	2018-11-25T00:23:17+08:00	894	2075	2969	336	3305	7162	46.15%	12.48%	12	12
15	臺東縣池上鄉	2018-11-25T00:00:23+08:00	894	2075	2969	336	3305	7162	46.15%	12.48%	12	12
15	臺東縣池上鄉	2018-11-24T22:51:03+08:00	793	1823	2616	277	2893	6306	45.88%	12.58%	11	12
15	臺東縣池上鄉	2018-11-24T22:23:28+08:00	793	1823	2616	277	2893	6306	45.88%	12.58%	11	12
15	臺東縣池上鄉	2018-11-24T22:40:40+08:00	793	1823	2616	277	2893	6306	45.88%	12.58%	11	12
15	臺東縣池上鄉	2018-11-25T06:24:13+08:00	894	2075	2969	336	3305	7162	46.15%	12.48%	12	12
15	臺東縣池上鄉	2018-11-25T01:02:44+08:00	894	2075	2969	336	3305	7162	46.15%	12.48%	12	12
15	臺東縣池上鄉	2018-11-25T06:14:05+08:00	894	2075	2969	336	3305	7162	46.15%	12.48%	12	12
15	臺東縣池上鄉	2018-11-25T06:19:10+08:00	894	2075	2969	336	3305	7162	46.15%	12.48%	12	12
15	臺東縣池上鄉	2018-11-25T00:14:23+08:00	894	2075	2969	336	3305	7162	46.15%	12.48%	12	12
15	臺東縣池上鄉	2018-11-25T01:18:10+08:00	894	2075	2969	336	3305	7162	46.15%	12.48%	12	12
15	臺東縣池上鄉	2018-11-25T03:50:03+08:00	894	2075	2969	336	3305	7162	46.15%	12.48%	12	12
15	臺東縣池上鄉	2018-11-25T01:07:39+08:00	894	2075	2969	336	3305	7162	46.15%	12.48%	12	12
15	臺東縣池上鄉	2018-11-25T01:26:07+08:00	894	2075	2969	336	3305	7162	46.15%	12.48%	12	12
15	臺東縣池上鄉	2018-11-25T03:39:07+08:00	894	2075	2969	336	3305	7162	46.15%	12.48%	12	12
15	臺東縣池上鄉	2018-11-24T22:41:50+08:00	793	1823	2616	277	2893	6306	45.88%	12.58%	11	12
15	臺東縣池上鄉	2018-11-25T06:29:31+08:00	894	2075	2969	336	3305	7162	46.15%	12.48%	12	12
15	臺東縣池上鄉	2018-11-24T23:35:22+08:00	894	2075	2969	336	3305	7162	46.15%	12.48%	12	12
15	臺東縣池上鄉	2018-11-24T23:43:30+08:00	894	2075	2969	336	3305	7162	46.15%	12.48%	12	12
15	臺東縣蘭嶼鄉	2018-11-25T03:56:28+08:00	452	1032	1484	117	1601	4181	38.29%	10.81%	4	4
15	臺東縣蘭嶼鄉	2018-11-24T22:58:08+08:00	83	275	358	27	385	943	40.83%	8.8%	1	4
15	臺東縣蘭嶼鄉	2018-11-24T23:47:43+08:00	83	275	358	27	385	943	40.83%	8.8%	1	4
15	臺東縣蘭嶼鄉	2018-11-24T23:56:01+08:00	205	541	746	47	793	2183	36.33%	9.39%	2	4
15	臺東縣蘭嶼鄉	2018-11-24T23:01:46+08:00	83	275	358	27	385	943	40.83%	8.8%	1	4
15	臺東縣蘭嶼鄉	2018-11-24T23:12:30+08:00	83	275	358	27	385	943	40.83%	8.8%	1	4
15	臺東縣蘭嶼鄉	2018-11-24T23:27:30+08:00	83	275	358	27	385	943	40.83%	8.8%	1	4
15	臺東縣蘭嶼鄉	2018-11-25T06:09:09+08:00	452	1032	1484	117	1601	4181	38.29%	10.81%	4	4
15	臺東縣蘭嶼鄉	2018-11-24T22:13:45+08:00	83	275	358	27	385	943	40.83%	8.8%	1	4
15	臺東縣蘭嶼鄉	2018-11-25T04:03:06+08:00	452	1032	1484	117	1601	4181	38.29%	10.81%	4	4
15	臺東縣蘭嶼鄉	2018-11-24T23:51:48+08:00	83	275	358	27	385	943	40.83%	8.8%	1	4
15	臺東縣蘭嶼鄉	2018-11-24T22:30:23+08:00	83	275	358	27	385	943	40.83%	8.8%	1	4
15	臺東縣蘭嶼鄉	2018-11-25T03:32:52+08:00	452	1032	1484	117	1601	4181	38.29%	10.81%	4	4
15	臺東縣蘭嶼鄉	2018-11-25T03:44:40+08:00	452	1032	1484	117	1601	4181	38.29%	10.81%	4	4
15	臺東縣蘭嶼鄉	2018-11-25T00:57:51+08:00	452	1032	1484	117	1601	4181	38.29%	10.81%	4	4
15	臺東縣蘭嶼鄉	2018-11-24T22:19:50+08:00	83	275	358	27	385	943	40.83%	8.8%	1	4
15	臺東縣蘭嶼鄉	2018-11-24T22:16:25+08:00	83	275	358	27	385	943	40.83%	8.8%	1	4
15	臺東縣蘭嶼鄉	2018-11-25T00:09:50+08:00	306	690	996	76	1072	2943	36.43%	10.4%	3	4
15	臺東縣蘭嶼鄉	2018-11-25T00:18:47+08:00	452	1032	1484	117	1601	4181	38.29%	10.81%	4	4
15	臺東縣蘭嶼鄉	2018-11-24T22:37:14+08:00	83	275	358	27	385	943	40.83%	8.8%	1	4
15	臺東縣蘭嶼鄉	2018-11-24T23:20:08+08:00	83	275	358	27	385	943	40.83%	8.8%	1	4
15	臺東縣蘭嶼鄉	2018-11-24T23:31:27+08:00	83	275	358	27	385	943	40.83%	8.8%	1	4
15	臺東縣蘭嶼鄉	2018-11-24T22:45:21+08:00	83	275	358	27	385	943	40.83%	8.8%	1	4
15	臺東縣蘭嶼鄉	2018-11-25T01:12:58+08:00	452	1032	1484	117	1601	4181	38.29%	10.81%	4	4
15	臺東縣蘭嶼鄉	2018-11-24T23:05:16+08:00	83	275	358	27	385	943	40.83%	8.8%	1	4
15	臺東縣蘭嶼鄉	2018-11-24T22:26:49+08:00	83	275	358	27	385	943	40.83%	8.8%	1	4
15	臺東縣蘭嶼鄉	2018-11-25T01:07:40+08:00	452	1032	1484	117	1601	4181	38.29%	10.81%	4	4
15	臺東縣蘭嶼鄉	2018-11-24T23:39:32+08:00	83	275	358	27	385	943	40.83%	8.8%	1	4
15	臺東縣蘭嶼鄉	2018-11-24T22:54:37+08:00	83	275	358	27	385	943	40.83%	8.8%	1	4
15	臺東縣蘭嶼鄉	2018-11-24T22:33:50+08:00	83	275	358	27	385	943	40.83%	8.8%	1	4
15	臺東縣蘭嶼鄉	2018-11-25T00:05:18+08:00	306	690	996	76	1072	2943	36.43%	10.4%	3	4
15	臺東縣蘭嶼鄉	2018-11-24T23:08:51+08:00	83	275	358	27	385	943	40.83%	8.8%	1	4
15	臺東縣蘭嶼鄉	2018-11-24T23:23:51+08:00	83	275	358	27	385	943	40.83%	8.8%	1	4
15	臺東縣蘭嶼鄉	2018-11-25T00:23:17+08:00	452	1032	1484	117	1601	4181	38.29%	10.81%	4	4
15	臺東縣蘭嶼鄉	2018-11-25T00:00:24+08:00	306	690	996	76	1072	2943	36.43%	10.4%	3	4
15	臺東縣蘭嶼鄉	2018-11-24T22:51:03+08:00	83	275	358	27	385	943	40.83%	8.8%	1	4
15	臺東縣蘭嶼鄉	2018-11-24T22:23:28+08:00	83	275	358	27	385	943	40.83%	8.8%	1	4
15	臺東縣蘭嶼鄉	2018-11-24T22:40:40+08:00	83	275	358	27	385	943	40.83%	8.8%	1	4
15	臺東縣蘭嶼鄉	2018-11-25T06:24:13+08:00	452	1032	1484	117	1601	4181	38.29%	10.81%	4	4
15	臺東縣蘭嶼鄉	2018-11-25T01:02:44+08:00	452	1032	1484	117	1601	4181	38.29%	10.81%	4	4
15	臺東縣蘭嶼鄉	2018-11-25T06:14:05+08:00	452	1032	1484	117	1601	4181	38.29%	10.81%	4	4
15	臺東縣蘭嶼鄉	2018-11-25T06:19:10+08:00	452	1032	1484	117	1601	4181	38.29%	10.81%	4	4
15	臺東縣蘭嶼鄉	2018-11-25T00:14:23+08:00	306	690	996	76	1072	2943	36.43%	10.4%	3	4
15	臺東縣蘭嶼鄉	2018-11-25T01:18:10+08:00	452	1032	1484	117	1601	4181	38.29%	10.81%	4	4
15	臺東縣蘭嶼鄉	2018-11-25T03:50:04+08:00	452	1032	1484	117	1601	4181	38.29%	10.81%	4	4
15	臺東縣蘭嶼鄉	2018-11-25T03:39:07+08:00	452	1032	1484	117	1601	4181	38.29%	10.81%	4	4
15	臺東縣蘭嶼鄉	2018-11-24T22:41:50+08:00	83	275	358	27	385	943	40.83%	8.8%	1	4
15	臺東縣蘭嶼鄉	2018-11-25T06:29:31+08:00	452	1032	1484	117	1601	4181	38.29%	10.81%	4	4
15	臺東縣蘭嶼鄉	2018-11-24T23:16:16+08:00	83	275	358	27	385	943	40.83%	8.8%	1	4
15	臺東縣蘭嶼鄉	2018-11-24T23:35:22+08:00	83	275	358	27	385	943	40.83%	8.8%	1	4
15	臺東縣蘭嶼鄉	2018-11-24T23:43:30+08:00	83	275	358	27	385	943	40.83%	8.8%	1	4
15	臺東縣蘭嶼鄉	2018-11-25T01:26:08+08:00	452	1032	1484	117	1601	4181	38.29%	10.81%	4	4
15	臺南市新化區	2018-11-24T23:16:08+08:00	6530	12063	18593	1427	20020	37296	53.68%	17.51%	37	37
15	臺南市新化區	2018-11-24T22:41:41+08:00	6530	12063	18593	1427	20020	37296	53.68%	17.51%	37	37
15	臺南市新化區	2018-11-25T00:18:37+08:00	6530	12063	18593	1427	20020	37296	53.68%	17.51%	37	37
15	臺南市新化區	2018-11-24T22:45:13+08:00	6530	12063	18593	1427	20020	37296	53.68%	17.51%	37	37
15	臺南市新化區	2018-11-25T03:56:18+08:00	6530	12063	18593	1427	20020	37296	53.68%	17.51%	37	37
15	臺南市新化區	2018-11-24T22:58:00+08:00	6530	12063	18593	1427	20020	37296	53.68%	17.51%	37	37
15	臺南市新化區	2018-11-24T22:40:32+08:00	6530	12063	18593	1427	20020	37296	53.68%	17.51%	37	37
15	臺南市新化區	2018-11-25T01:02:36+08:00	6530	12063	18593	1427	20020	37296	53.68%	17.51%	37	37
15	臺南市新化區	2018-11-24T22:19:42+08:00	6530	12063	18593	1427	20020	37296	53.68%	17.51%	37	37
15	臺南市新化區	2018-11-25T01:25:58+08:00	6530	12063	18593	1427	20020	37296	53.68%	17.51%	37	37
15	臺南市新化區	2018-11-24T22:30:15+08:00	6530	12063	18593	1427	20020	37296	53.68%	17.51%	37	37
15	臺南市新化區	2018-11-24T23:51:41+08:00	6530	12063	18593	1427	20020	37296	53.68%	17.51%	37	37
15	臺南市新化區	2018-11-25T00:23:09+08:00	6530	12063	18593	1427	20020	37296	53.68%	17.51%	37	37
15	臺南市新化區	2018-11-25T00:57:42+08:00	6530	12063	18593	1427	20020	37296	53.68%	17.51%	37	37
15	臺南市新化區	2018-11-25T06:24:05+08:00	6530	12063	18593	1427	20020	37296	53.68%	17.51%	37	37
15	臺南市新化區	2018-11-25T00:00:16+08:00	6530	12063	18593	1427	20020	37296	53.68%	17.51%	37	37
15	臺南市新化區	2018-11-25T01:17:59+08:00	6530	12063	18593	1427	20020	37296	53.68%	17.51%	37	37
15	臺南市新化區	2018-11-24T23:19:57+08:00	6530	12063	18593	1427	20020	37296	53.68%	17.51%	37	37
15	臺南市新化區	2018-11-24T23:55:52+08:00	6530	12063	18593	1427	20020	37296	53.68%	17.51%	37	37
15	臺南市新化區	2018-11-24T22:13:34+08:00	6194	11524	17718	1385	19103	35734	53.46%	17.33%	36	37
15	臺南市新化區	2018-11-24T23:27:23+08:00	6530	12063	18593	1427	20020	37296	53.68%	17.51%	37	37
15	臺南市新化區	2018-11-24T23:39:22+08:00	6530	12063	18593	1427	20020	37296	53.68%	17.51%	37	37
15	臺南市新化區	2018-11-25T01:12:49+08:00	6530	12063	18593	1427	20020	37296	53.68%	17.51%	37	37
15	臺南市新化區	2018-11-25T06:08:59+08:00	6530	12063	18593	1427	20020	37296	53.68%	17.51%	37	37
15	臺南市新化區	2018-11-24T23:31:17+08:00	6530	12063	18593	1427	20020	37296	53.68%	17.51%	37	37
15	臺南市新化區	2018-11-24T23:47:34+08:00	6530	12063	18593	1427	20020	37296	53.68%	17.51%	37	37
15	臺南市新化區	2018-11-24T23:05:09+08:00	6530	12063	18593	1427	20020	37296	53.68%	17.51%	37	37
15	臺南市新化區	2018-11-24T23:01:36+08:00	6530	12063	18593	1427	20020	37296	53.68%	17.51%	37	37
15	臺南市新化區	2018-11-25T04:02:57+08:00	6530	12063	18593	1427	20020	37296	53.68%	17.51%	37	37
15	臺南市新化區	2018-11-25T00:05:10+08:00	6530	12063	18593	1427	20020	37296	53.68%	17.51%	37	37
15	臺南市新化區	2018-11-25T06:19:02+08:00	6530	12063	18593	1427	20020	37296	53.68%	17.51%	37	37
15	臺南市新化區	2018-11-25T06:29:22+08:00	6530	12063	18593	1427	20020	37296	53.68%	17.51%	37	37
15	臺南市新化區	2018-11-25T03:49:56+08:00	6530	12063	18593	1427	20020	37296	53.68%	17.51%	37	37
15	臺南市新化區	2018-11-24T22:54:30+08:00	6530	12063	18593	1427	20020	37296	53.68%	17.51%	37	37
15	臺南市新化區	2018-11-24T22:50:54+08:00	6530	12063	18593	1427	20020	37296	53.68%	17.51%	37	37
15	臺南市新化區	2018-11-25T06:13:57+08:00	6530	12063	18593	1427	20020	37296	53.68%	17.51%	37	37
15	臺南市新化區	2018-11-24T22:37:05+08:00	6530	12063	18593	1427	20020	37296	53.68%	17.51%	37	37
15	臺南市新化區	2018-11-24T23:43:22+08:00	6530	12063	18593	1427	20020	37296	53.68%	17.51%	37	37
15	臺南市新化區	2018-11-25T00:09:40+08:00	6530	12063	18593	1427	20020	37296	53.68%	17.51%	37	37
15	臺南市新化區	2018-11-24T22:26:41+08:00	6530	12063	18593	1427	20020	37296	53.68%	17.51%	37	37
15	臺南市新化區	2018-11-25T03:44:29+08:00	6530	12063	18593	1427	20020	37296	53.68%	17.51%	37	37
15	臺南市新化區	2018-11-25T03:32:42+08:00	6530	12063	18593	1427	20020	37296	53.68%	17.51%	37	37
15	臺南市新化區	2018-11-24T23:08:42+08:00	6530	12063	18593	1427	20020	37296	53.68%	17.51%	37	37
15	臺南市新化區	2018-11-24T22:23:19+08:00	6530	12063	18593	1427	20020	37296	53.68%	17.51%	37	37
15	臺南市新化區	2018-11-24T23:23:43+08:00	6530	12063	18593	1427	20020	37296	53.68%	17.51%	37	37
15	臺南市新化區	2018-11-25T00:14:15+08:00	6530	12063	18593	1427	20020	37296	53.68%	17.51%	37	37
15	臺南市新化區	2018-11-24T23:35:15+08:00	6530	12063	18593	1427	20020	37296	53.68%	17.51%	37	37
15	臺南市新化區	2018-11-24T22:33:43+08:00	6530	12063	18593	1427	20020	37296	53.68%	17.51%	37	37
15	臺南市新化區	2018-11-25T03:39:00+08:00	6530	12063	18593	1427	20020	37296	53.68%	17.51%	37	37
15	臺南市新化區	2018-11-24T23:12:21+08:00	6530	12063	18593	1427	20020	37296	53.68%	17.51%	37	37
15	臺南市新化區	2018-11-24T22:16:16+08:00	6530	12063	18593	1427	20020	37296	53.68%	17.51%	37	37
15	臺南市新化區	2018-11-25T01:07:31+08:00	6530	12063	18593	1427	20020	37296	53.68%	17.51%	37	37
15	臺南市下營區	2018-11-24T22:41:41+08:00	3091	5832	8923	913	9836	20947	46.96%	14.76%	19	19
15	臺南市下營區	2018-11-24T22:45:13+08:00	3091	5832	8923	913	9836	20947	46.96%	14.76%	19	19
15	臺南市下營區	2018-11-24T23:16:07+08:00	3091	5832	8923	913	9836	20947	46.96%	14.76%	19	19
15	臺南市下營區	2018-11-25T03:56:18+08:00	3091	5832	8923	913	9836	20947	46.96%	14.76%	19	19
15	臺南市下營區	2018-11-24T23:43:21+08:00	3091	5832	8923	913	9836	20947	46.96%	14.76%	19	19
15	臺南市下營區	2018-11-25T00:18:36+08:00	3091	5832	8923	913	9836	20947	46.96%	14.76%	19	19
15	臺南市下營區	2018-11-24T23:51:40+08:00	3091	5832	8923	913	9836	20947	46.96%	14.76%	19	19
15	臺南市下營區	2018-11-24T22:40:32+08:00	3091	5832	8923	913	9836	20947	46.96%	14.76%	19	19
15	臺南市下營區	2018-11-25T01:02:36+08:00	3091	5832	8923	913	9836	20947	46.96%	14.76%	19	19
15	臺南市下營區	2018-11-24T22:30:14+08:00	3091	5832	8923	913	9836	20947	46.96%	14.76%	19	19
15	臺南市下營區	2018-11-25T01:25:58+08:00	3091	5832	8923	913	9836	20947	46.96%	14.76%	19	19
15	臺南市下營區	2018-11-25T00:23:09+08:00	3091	5832	8923	913	9836	20947	46.96%	14.76%	19	19
15	臺南市下營區	2018-11-25T00:57:42+08:00	3091	5832	8923	913	9836	20947	46.96%	14.76%	19	19
15	臺南市下營區	2018-11-25T06:24:05+08:00	3091	5832	8923	913	9836	20947	46.96%	14.76%	19	19
15	臺南市下營區	2018-11-25T00:00:16+08:00	3091	5832	8923	913	9836	20947	46.96%	14.76%	19	19
15	臺南市下營區	2018-11-25T01:17:59+08:00	3091	5832	8923	913	9836	20947	46.96%	14.76%	19	19
15	臺南市下營區	2018-11-24T22:57:59+08:00	3091	5832	8923	913	9836	20947	46.96%	14.76%	19	19
15	臺南市下營區	2018-11-24T23:19:57+08:00	3091	5832	8923	913	9836	20947	46.96%	14.76%	19	19
15	臺南市下營區	2018-11-25T03:32:41+08:00	3091	5832	8923	913	9836	20947	46.96%	14.76%	19	19
15	臺南市下營區	2018-11-24T23:55:52+08:00	3091	5832	8923	913	9836	20947	46.96%	14.76%	19	19
15	臺南市下營區	2018-11-24T22:13:33+08:00	3091	5832	8923	913	9836	20947	46.96%	14.76%	19	19
15	臺南市下營區	2018-11-24T23:27:23+08:00	3091	5832	8923	913	9836	20947	46.96%	14.76%	19	19
15	臺南市下營區	2018-11-24T23:39:22+08:00	3091	5832	8923	913	9836	20947	46.96%	14.76%	19	19
15	臺南市下營區	2018-11-25T01:12:49+08:00	3091	5832	8923	913	9836	20947	46.96%	14.76%	19	19
15	臺南市下營區	2018-11-25T06:08:59+08:00	3091	5832	8923	913	9836	20947	46.96%	14.76%	19	19
15	臺南市下營區	2018-11-24T23:31:17+08:00	3091	5832	8923	913	9836	20947	46.96%	14.76%	19	19
15	臺南市下營區	2018-11-24T23:47:34+08:00	3091	5832	8923	913	9836	20947	46.96%	14.76%	19	19
15	臺南市下營區	2018-11-24T23:05:09+08:00	3091	5832	8923	913	9836	20947	46.96%	14.76%	19	19
15	臺南市下營區	2018-11-24T23:01:36+08:00	3091	5832	8923	913	9836	20947	46.96%	14.76%	19	19
15	臺南市下營區	2018-11-25T04:02:57+08:00	3091	5832	8923	913	9836	20947	46.96%	14.76%	19	19
15	臺南市下營區	2018-11-25T00:05:10+08:00	3091	5832	8923	913	9836	20947	46.96%	14.76%	19	19
15	臺南市下營區	2018-11-25T06:19:02+08:00	3091	5832	8923	913	9836	20947	46.96%	14.76%	19	19
15	臺南市下營區	2018-11-25T06:29:22+08:00	3091	5832	8923	913	9836	20947	46.96%	14.76%	19	19
15	臺南市下營區	2018-11-25T03:49:56+08:00	3091	5832	8923	913	9836	20947	46.96%	14.76%	19	19
15	臺南市下營區	2018-11-24T22:54:30+08:00	3091	5832	8923	913	9836	20947	46.96%	14.76%	19	19
15	臺南市下營區	2018-11-25T06:13:57+08:00	3091	5832	8923	913	9836	20947	46.96%	14.76%	19	19
15	臺南市下營區	2018-11-24T22:50:53+08:00	3091	5832	8923	913	9836	20947	46.96%	14.76%	19	19
15	臺南市下營區	2018-11-24T22:37:05+08:00	3091	5832	8923	913	9836	20947	46.96%	14.76%	19	19
15	臺南市下營區	2018-11-25T00:09:40+08:00	3091	5832	8923	913	9836	20947	46.96%	14.76%	19	19
15	臺南市下營區	2018-11-24T22:26:41+08:00	3091	5832	8923	913	9836	20947	46.96%	14.76%	19	19
15	臺南市下營區	2018-11-24T22:19:41+08:00	3091	5832	8923	913	9836	20947	46.96%	14.76%	19	19
15	臺南市下營區	2018-11-25T03:38:59+08:00	3091	5832	8923	913	9836	20947	46.96%	14.76%	19	19
15	臺南市下營區	2018-11-25T03:44:29+08:00	3091	5832	8923	913	9836	20947	46.96%	14.76%	19	19
15	臺南市下營區	2018-11-24T23:08:42+08:00	3091	5832	8923	913	9836	20947	46.96%	14.76%	19	19
15	臺南市下營區	2018-11-24T22:23:19+08:00	3091	5832	8923	913	9836	20947	46.96%	14.76%	19	19
15	臺南市下營區	2018-11-24T23:23:43+08:00	3091	5832	8923	913	9836	20947	46.96%	14.76%	19	19
15	臺南市下營區	2018-11-25T00:14:15+08:00	3091	5832	8923	913	9836	20947	46.96%	14.76%	19	19
15	臺南市下營區	2018-11-24T23:35:15+08:00	3091	5832	8923	913	9836	20947	46.96%	14.76%	19	19
15	臺南市下營區	2018-11-24T22:33:43+08:00	3091	5832	8923	913	9836	20947	46.96%	14.76%	19	19
15	臺南市下營區	2018-11-24T23:12:21+08:00	3091	5832	8923	913	9836	20947	46.96%	14.76%	19	19
15	臺南市下營區	2018-11-24T22:16:16+08:00	3091	5832	8923	913	9836	20947	46.96%	14.76%	19	19
15	臺南市下營區	2018-11-25T01:07:31+08:00	3091	5832	8923	913	9836	20947	46.96%	14.76%	19	19
15	南投縣鹿谷鄉	2018-11-25T00:05:14+08:00	2276	5778	8054	566	8620	15941	54.07%	14.28%	21	21
15	南投縣鹿谷鄉	2018-11-25T06:19:06+08:00	2276	5778	8054	566	8620	15941	54.07%	14.28%	21	21
15	南投縣鹿谷鄉	2018-11-24T23:05:12+08:00	2276	5778	8054	566	8620	15941	54.07%	14.28%	21	21
15	南投縣鹿谷鄉	2018-11-25T00:09:45+08:00	2276	5778	8054	566	8620	15941	54.07%	14.28%	21	21
15	南投縣鹿谷鄉	2018-11-24T22:50:58+08:00	2276	5778	8054	566	8620	15941	54.07%	14.28%	21	21
15	南投縣鹿谷鄉	2018-11-24T22:41:46+08:00	2276	5778	8054	566	8620	15941	54.07%	14.28%	21	21
15	南投縣鹿谷鄉	2018-11-24T22:37:09+08:00	2276	5778	8054	566	8620	15941	54.07%	14.28%	21	21
15	南投縣鹿谷鄉	2018-11-25T06:29:27+08:00	2276	5778	8054	566	8620	15941	54.07%	14.28%	21	21
15	南投縣鹿谷鄉	2018-11-24T23:01:41+08:00	2276	5778	8054	566	8620	15941	54.07%	14.28%	21	21
15	南投縣鹿谷鄉	2018-11-24T22:26:45+08:00	2276	5778	8054	566	8620	15941	54.07%	14.28%	21	21
15	南投縣鹿谷鄉	2018-11-24T22:54:34+08:00	2276	5778	8054	566	8620	15941	54.07%	14.28%	21	21
15	南投縣鹿谷鄉	2018-11-25T01:12:54+08:00	2276	5778	8054	566	8620	15941	54.07%	14.28%	21	21
15	南投縣鹿谷鄉	2018-11-24T22:19:45+08:00	2276	5778	8054	566	8620	15941	54.07%	14.28%	21	21
15	南投縣鹿谷鄉	2018-11-25T04:03:01+08:00	2276	5778	8054	566	8620	15941	54.07%	14.28%	21	21
15	南投縣鹿谷鄉	2018-11-25T00:00:20+08:00	2276	5778	8054	566	8620	15941	54.07%	14.28%	21	21
15	南投縣鹿谷鄉	2018-11-25T00:23:13+08:00	2276	5778	8054	566	8620	15941	54.07%	14.28%	21	21
15	南投縣鹿谷鄉	2018-11-24T22:23:24+08:00	2276	5778	8054	566	8620	15941	54.07%	14.28%	21	21
15	南投縣鹿谷鄉	2018-11-25T01:02:40+08:00	2276	5778	8054	566	8620	15941	54.07%	14.28%	21	21
15	南投縣鹿谷鄉	2018-11-25T06:14:01+08:00	2276	5778	8054	566	8620	15941	54.07%	14.28%	21	21
15	南投縣鹿谷鄉	2018-11-25T03:32:47+08:00	2276	5778	8054	566	8620	15941	54.07%	14.28%	21	21
15	南投縣鹿谷鄉	2018-11-24T23:08:46+08:00	2276	5778	8054	566	8620	15941	54.07%	14.28%	21	21
15	南投縣鹿谷鄉	2018-11-24T23:23:47+08:00	2276	5778	8054	566	8620	15941	54.07%	14.28%	21	21
15	南投縣鹿谷鄉	2018-11-25T03:50:00+08:00	2276	5778	8054	566	8620	15941	54.07%	14.28%	21	21
15	南投縣鹿谷鄉	2018-11-24T22:33:47+08:00	2276	5778	8054	566	8620	15941	54.07%	14.28%	21	21
15	南投縣鹿谷鄉	2018-11-25T03:39:03+08:00	2276	5778	8054	566	8620	15941	54.07%	14.28%	21	21
15	南投縣鹿谷鄉	2018-11-25T01:26:02+08:00	2276	5778	8054	566	8620	15941	54.07%	14.28%	21	21
15	南投縣鹿谷鄉	2018-11-24T23:20:01+08:00	2276	5778	8054	566	8620	15941	54.07%	14.28%	21	21
15	南投縣鹿谷鄉	2018-11-25T01:07:35+08:00	2276	5778	8054	566	8620	15941	54.07%	14.28%	21	21
15	南投縣鹿谷鄉	2018-11-25T00:14:19+08:00	2276	5778	8054	566	8620	15941	54.07%	14.28%	21	21
15	南投縣鹿谷鄉	2018-11-24T23:16:12+08:00	2276	5778	8054	566	8620	15941	54.07%	14.28%	21	21
15	南投縣鹿谷鄉	2018-11-24T23:35:19+08:00	2276	5778	8054	566	8620	15941	54.07%	14.28%	21	21
15	南投縣鹿谷鄉	2018-11-24T22:45:16+08:00	2276	5778	8054	566	8620	15941	54.07%	14.28%	21	21
15	南投縣鹿谷鄉	2018-11-24T23:43:25+08:00	2276	5778	8054	566	8620	15941	54.07%	14.28%	21	21
15	南投縣鹿谷鄉	2018-11-25T03:56:23+08:00	2276	5778	8054	566	8620	15941	54.07%	14.28%	21	21
15	南投縣鹿谷鄉	2018-11-24T22:58:04+08:00	2276	5778	8054	566	8620	15941	54.07%	14.28%	21	21
15	南投縣鹿谷鄉	2018-11-25T01:18:04+08:00	2276	5778	8054	566	8620	15941	54.07%	14.28%	21	21
15	南投縣鹿谷鄉	2018-11-25T06:24:09+08:00	2276	5778	8054	566	8620	15941	54.07%	14.28%	21	21
15	南投縣鹿谷鄉	2018-11-25T06:09:04+08:00	2276	5778	8054	566	8620	15941	54.07%	14.28%	21	21
15	南投縣鹿谷鄉	2018-11-24T23:51:44+08:00	2276	5778	8054	566	8620	15941	54.07%	14.28%	21	21
15	南投縣鹿谷鄉	2018-11-24T22:40:36+08:00	2276	5778	8054	566	8620	15941	54.07%	14.28%	21	21
15	南投縣鹿谷鄉	2018-11-24T22:30:19+08:00	2276	5778	8054	566	8620	15941	54.07%	14.28%	21	21
15	南投縣鹿谷鄉	2018-11-24T22:13:40+08:00	2276	5778	8054	566	8620	15941	54.07%	14.28%	21	21
15	南投縣鹿谷鄉	2018-11-25T00:57:46+08:00	2276	5778	8054	566	8620	15941	54.07%	14.28%	21	21
15	南投縣鹿谷鄉	2018-11-24T23:27:26+08:00	2276	5778	8054	566	8620	15941	54.07%	14.28%	21	21
15	南投縣鹿谷鄉	2018-11-25T03:44:35+08:00	2276	5778	8054	566	8620	15941	54.07%	14.28%	21	21
15	南投縣鹿谷鄉	2018-11-24T23:55:56+08:00	2276	5778	8054	566	8620	15941	54.07%	14.28%	21	21
15	南投縣鹿谷鄉	2018-11-24T23:47:39+08:00	2276	5778	8054	566	8620	15941	54.07%	14.28%	21	21
15	南投縣鹿谷鄉	2018-11-24T23:31:22+08:00	2276	5778	8054	566	8620	15941	54.07%	14.28%	21	21
15	南投縣鹿谷鄉	2018-11-24T22:16:21+08:00	2276	5778	8054	566	8620	15941	54.07%	14.28%	21	21
15	南投縣鹿谷鄉	2018-11-25T00:18:42+08:00	2276	5778	8054	566	8620	15941	54.07%	14.28%	21	21
15	南投縣鹿谷鄉	2018-11-24T23:12:26+08:00	2276	5778	8054	566	8620	15941	54.07%	14.28%	21	21
15	南投縣鹿谷鄉	2018-11-24T23:39:27+08:00	2276	5778	8054	566	8620	15941	54.07%	14.28%	21	21
15	雲林縣大埤鄉	2018-11-25T00:05:14+08:00	2538	5310	7848	671	8519	16509	51.6%	15.37%	18	18
15	雲林縣大埤鄉	2018-11-25T06:19:06+08:00	2538	5310	7848	671	8519	16509	51.6%	15.37%	18	18
15	雲林縣大埤鄉	2018-11-25T00:09:45+08:00	2538	5310	7848	671	8519	16509	51.6%	15.37%	18	18
15	雲林縣大埤鄉	2018-11-25T01:12:55+08:00	2538	5310	7848	671	8519	16509	51.6%	15.37%	18	18
15	雲林縣大埤鄉	2018-11-24T22:41:46+08:00	2538	5310	7848	671	8519	16509	51.6%	15.37%	18	18
15	雲林縣大埤鄉	2018-11-25T06:29:27+08:00	2538	5310	7848	671	8519	16509	51.6%	15.37%	18	18
15	雲林縣大埤鄉	2018-11-24T23:05:13+08:00	2538	5310	7848	671	8519	16509	51.6%	15.37%	18	18
15	雲林縣大埤鄉	2018-11-24T22:26:45+08:00	2342	4874	7216	615	7831	15079	51.93%	15.53%	17	18
15	雲林縣大埤鄉	2018-11-24T22:54:34+08:00	2538	5310	7848	671	8519	16509	51.6%	15.37%	18	18
15	雲林縣大埤鄉	2018-11-24T23:43:26+08:00	2538	5310	7848	671	8519	16509	51.6%	15.37%	18	18
15	雲林縣大埤鄉	2018-11-24T22:50:59+08:00	2538	5310	7848	671	8519	16509	51.6%	15.37%	18	18
15	雲林縣大埤鄉	2018-11-25T00:00:20+08:00	2538	5310	7848	671	8519	16509	51.6%	15.37%	18	18
15	雲林縣大埤鄉	2018-11-25T00:23:13+08:00	2538	5310	7848	671	8519	16509	51.6%	15.37%	18	18
15	雲林縣大埤鄉	2018-11-25T03:44:36+08:00	2538	5310	7848	671	8519	16509	51.6%	15.37%	18	18
15	雲林縣大埤鄉	2018-11-24T23:08:47+08:00	2538	5310	7848	671	8519	16509	51.6%	15.37%	18	18
15	雲林縣大埤鄉	2018-11-24T22:23:24+08:00	2208	4642	6850	592	7442	14131	52.66%	15.63%	16	18
15	雲林縣大埤鄉	2018-11-25T06:24:10+08:00	2538	5310	7848	671	8519	16509	51.6%	15.37%	18	18
15	雲林縣大埤鄉	2018-11-25T01:02:40+08:00	2538	5310	7848	671	8519	16509	51.6%	15.37%	18	18
15	雲林縣大埤鄉	2018-11-25T06:14:01+08:00	2538	5310	7848	671	8519	16509	51.6%	15.37%	18	18
15	雲林縣大埤鄉	2018-11-25T03:32:47+08:00	2538	5310	7848	671	8519	16509	51.6%	15.37%	18	18
15	雲林縣大埤鄉	2018-11-24T23:23:47+08:00	2538	5310	7848	671	8519	16509	51.6%	15.37%	18	18
15	雲林縣大埤鄉	2018-11-25T03:50:00+08:00	2538	5310	7848	671	8519	16509	51.6%	15.37%	18	18
15	雲林縣大埤鄉	2018-11-24T22:33:47+08:00	2342	4874	7216	615	7831	15079	51.93%	15.53%	17	18
15	雲林縣大埤鄉	2018-11-25T01:26:03+08:00	2538	5310	7848	671	8519	16509	51.6%	15.37%	18	18
15	雲林縣大埤鄉	2018-11-25T03:39:04+08:00	2538	5310	7848	671	8519	16509	51.6%	15.37%	18	18
15	雲林縣大埤鄉	2018-11-25T00:14:19+08:00	2538	5310	7848	671	8519	16509	51.6%	15.37%	18	18
15	雲林縣大埤鄉	2018-11-24T23:16:12+08:00	2538	5310	7848	671	8519	16509	51.6%	15.37%	18	18
15	雲林縣大埤鄉	2018-11-24T23:35:19+08:00	2538	5310	7848	671	8519	16509	51.6%	15.37%	18	18
15	雲林縣大埤鄉	2018-11-24T22:45:17+08:00	2538	5310	7848	671	8519	16509	51.6%	15.37%	18	18
15	雲林縣大埤鄉	2018-11-25T01:18:05+08:00	2538	5310	7848	671	8519	16509	51.6%	15.37%	18	18
15	雲林縣大埤鄉	2018-11-25T03:56:24+08:00	2538	5310	7848	671	8519	16509	51.6%	15.37%	18	18
15	雲林縣大埤鄉	2018-11-24T22:58:04+08:00	2538	5310	7848	671	8519	16509	51.6%	15.37%	18	18
15	雲林縣大埤鄉	2018-11-24T23:01:42+08:00	2538	5310	7848	671	8519	16509	51.6%	15.37%	18	18
15	雲林縣大埤鄉	2018-11-25T00:57:47+08:00	2538	5310	7848	671	8519	16509	51.6%	15.37%	18	18
15	雲林縣大埤鄉	2018-11-24T22:19:46+08:00	2208	4642	6850	592	7442	14131	52.66%	15.63%	16	18
15	雲林縣大埤鄉	2018-11-25T04:03:02+08:00	2538	5310	7848	671	8519	16509	51.6%	15.37%	18	18
15	雲林縣大埤鄉	2018-11-24T22:30:19+08:00	2342	4874	7216	615	7831	15079	51.93%	15.53%	17	18
15	雲林縣大埤鄉	2018-11-24T22:13:40+08:00	2208	4642	6850	592	7442	14131	52.66%	15.63%	16	18
15	雲林縣大埤鄉	2018-11-24T22:40:37+08:00	2538	5310	7848	671	8519	16509	51.6%	15.37%	18	18
15	雲林縣大埤鄉	2018-11-24T23:51:45+08:00	2538	5310	7848	671	8519	16509	51.6%	15.37%	18	18
15	雲林縣大埤鄉	2018-11-25T06:09:05+08:00	2538	5310	7848	671	8519	16509	51.6%	15.37%	18	18
15	雲林縣大埤鄉	2018-11-24T23:55:57+08:00	2538	5310	7848	671	8519	16509	51.6%	15.37%	18	18
15	雲林縣大埤鄉	2018-11-24T23:27:27+08:00	2538	5310	7848	671	8519	16509	51.6%	15.37%	18	18
15	雲林縣大埤鄉	2018-11-24T23:47:39+08:00	2538	5310	7848	671	8519	16509	51.6%	15.37%	18	18
15	雲林縣大埤鄉	2018-11-24T23:31:22+08:00	2538	5310	7848	671	8519	16509	51.6%	15.37%	18	18
15	雲林縣大埤鄉	2018-11-24T22:16:21+08:00	2208	4642	6850	592	7442	14131	52.66%	15.63%	16	18
15	雲林縣大埤鄉	2018-11-24T23:39:28+08:00	2538	5310	7848	671	8519	16509	51.6%	15.37%	18	18
15	雲林縣大埤鄉	2018-11-25T00:18:42+08:00	2538	5310	7848	671	8519	16509	51.6%	15.37%	18	18
15	雲林縣大埤鄉	2018-11-24T22:37:10+08:00	2538	5310	7848	671	8519	16509	51.6%	15.37%	18	18
15	雲林縣大埤鄉	2018-11-24T23:12:26+08:00	2538	5310	7848	671	8519	16509	51.6%	15.37%	18	18
15	雲林縣大埤鄉	2018-11-24T23:20:02+08:00	2538	5310	7848	671	8519	16509	51.6%	15.37%	18	18
15	雲林縣大埤鄉	2018-11-25T01:07:36+08:00	2538	5310	7848	671	8519	16509	51.6%	15.37%	18	18
15	雲林縣四湖鄉	2018-11-25T01:12:55+08:00	2192	5251	7443	829	8272	20983	39.42%	10.45%	25	25
15	雲林縣四湖鄉	2018-11-25T06:29:27+08:00	2192	5251	7443	829	8272	20983	39.42%	10.45%	25	25
15	雲林縣四湖鄉	2018-11-24T23:05:13+08:00	2192	5251	7443	829	8272	20983	39.42%	10.45%	25	25
15	雲林縣四湖鄉	2018-11-25T06:19:07+08:00	2192	5251	7443	829	8272	20983	39.42%	10.45%	25	25
15	雲林縣四湖鄉	2018-11-25T00:05:15+08:00	2192	5251	7443	829	8272	20983	39.42%	10.45%	25	25
15	雲林縣四湖鄉	2018-11-24T22:26:45+08:00	2192	5251	7443	829	8272	20983	39.42%	10.45%	25	25
15	雲林縣四湖鄉	2018-11-24T22:54:34+08:00	2192	5251	7443	829	8272	20983	39.42%	10.45%	25	25
15	雲林縣四湖鄉	2018-11-24T22:41:47+08:00	2192	5251	7443	829	8272	20983	39.42%	10.45%	25	25
15	雲林縣四湖鄉	2018-11-24T23:43:26+08:00	2192	5251	7443	829	8272	20983	39.42%	10.45%	25	25
15	雲林縣四湖鄉	2018-11-24T22:50:59+08:00	2192	5251	7443	829	8272	20983	39.42%	10.45%	25	25
15	雲林縣四湖鄉	2018-11-25T00:00:20+08:00	2192	5251	7443	829	8272	20983	39.42%	10.45%	25	25
15	雲林縣四湖鄉	2018-11-25T01:02:41+08:00	2192	5251	7443	829	8272	20983	39.42%	10.45%	25	25
15	雲林縣四湖鄉	2018-11-25T00:23:14+08:00	2192	5251	7443	829	8272	20983	39.42%	10.45%	25	25
15	雲林縣四湖鄉	2018-11-25T03:32:48+08:00	2192	5251	7443	829	8272	20983	39.42%	10.45%	25	25
15	雲林縣四湖鄉	2018-11-25T03:44:36+08:00	2192	5251	7443	829	8272	20983	39.42%	10.45%	25	25
15	雲林縣四湖鄉	2018-11-24T23:08:47+08:00	2192	5251	7443	829	8272	20983	39.42%	10.45%	25	25
15	雲林縣四湖鄉	2018-11-25T06:24:10+08:00	2192	5251	7443	829	8272	20983	39.42%	10.45%	25	25
15	雲林縣四湖鄉	2018-11-24T22:23:25+08:00	2192	5251	7443	829	8272	20983	39.42%	10.45%	25	25
15	雲林縣四湖鄉	2018-11-24T23:23:47+08:00	2192	5251	7443	829	8272	20983	39.42%	10.45%	25	25
15	雲林縣四湖鄉	2018-11-25T03:50:00+08:00	2192	5251	7443	829	8272	20983	39.42%	10.45%	25	25
15	雲林縣四湖鄉	2018-11-24T22:33:47+08:00	2192	5251	7443	829	8272	20983	39.42%	10.45%	25	25
15	雲林縣四湖鄉	2018-11-24T22:16:22+08:00	2192	5251	7443	829	8272	20983	39.42%	10.45%	25	25
15	雲林縣四湖鄉	2018-11-25T01:26:03+08:00	2192	5251	7443	829	8272	20983	39.42%	10.45%	25	25
15	雲林縣四湖鄉	2018-11-25T03:39:04+08:00	2192	5251	7443	829	8272	20983	39.42%	10.45%	25	25
15	雲林縣四湖鄉	2018-11-25T00:14:20+08:00	2192	5251	7443	829	8272	20983	39.42%	10.45%	25	25
15	雲林縣四湖鄉	2018-11-24T23:16:12+08:00	2192	5251	7443	829	8272	20983	39.42%	10.45%	25	25
15	雲林縣四湖鄉	2018-11-24T23:35:19+08:00	2192	5251	7443	829	8272	20983	39.42%	10.45%	25	25
15	雲林縣四湖鄉	2018-11-24T22:45:17+08:00	2192	5251	7443	829	8272	20983	39.42%	10.45%	25	25
15	雲林縣四湖鄉	2018-11-25T01:18:05+08:00	2192	5251	7443	829	8272	20983	39.42%	10.45%	25	25
15	雲林縣四湖鄉	2018-11-24T22:58:05+08:00	2192	5251	7443	829	8272	20983	39.42%	10.45%	25	25
15	雲林縣四湖鄉	2018-11-25T00:09:46+08:00	2192	5251	7443	829	8272	20983	39.42%	10.45%	25	25
15	雲林縣四湖鄉	2018-11-25T03:56:24+08:00	2192	5251	7443	829	8272	20983	39.42%	10.45%	25	25
15	雲林縣四湖鄉	2018-11-24T23:01:42+08:00	2192	5251	7443	829	8272	20983	39.42%	10.45%	25	25
15	雲林縣四湖鄉	2018-11-25T00:57:47+08:00	2192	5251	7443	829	8272	20983	39.42%	10.45%	25	25
15	雲林縣四湖鄉	2018-11-24T22:19:46+08:00	2192	5251	7443	829	8272	20983	39.42%	10.45%	25	25
15	雲林縣四湖鄉	2018-11-24T22:13:41+08:00	2192	5251	7443	829	8272	20983	39.42%	10.45%	25	25
15	雲林縣四湖鄉	2018-11-25T04:03:02+08:00	2192	5251	7443	829	8272	20983	39.42%	10.45%	25	25
15	雲林縣四湖鄉	2018-11-24T22:40:37+08:00	2192	5251	7443	829	8272	20983	39.42%	10.45%	25	25
15	雲林縣四湖鄉	2018-11-24T23:51:45+08:00	2192	5251	7443	829	8272	20983	39.42%	10.45%	25	25
15	雲林縣四湖鄉	2018-11-24T22:30:20+08:00	2192	5251	7443	829	8272	20983	39.42%	10.45%	25	25
15	雲林縣四湖鄉	2018-11-25T06:09:05+08:00	2192	5251	7443	829	8272	20983	39.42%	10.45%	25	25
15	雲林縣四湖鄉	2018-11-24T23:55:57+08:00	2192	5251	7443	829	8272	20983	39.42%	10.45%	25	25
15	雲林縣四湖鄉	2018-11-24T23:27:27+08:00	2192	5251	7443	829	8272	20983	39.42%	10.45%	25	25
15	雲林縣四湖鄉	2018-11-25T06:14:02+08:00	2192	5251	7443	829	8272	20983	39.42%	10.45%	25	25
15	雲林縣四湖鄉	2018-11-24T23:47:39+08:00	2192	5251	7443	829	8272	20983	39.42%	10.45%	25	25
15	雲林縣四湖鄉	2018-11-25T00:18:43+08:00	2192	5251	7443	829	8272	20983	39.42%	10.45%	25	25
15	雲林縣四湖鄉	2018-11-24T23:12:27+08:00	2192	5251	7443	829	8272	20983	39.42%	10.45%	25	25
15	雲林縣四湖鄉	2018-11-24T23:39:28+08:00	2192	5251	7443	829	8272	20983	39.42%	10.45%	25	25
15	雲林縣四湖鄉	2018-11-24T22:37:11+08:00	2192	5251	7443	829	8272	20983	39.42%	10.45%	25	25
15	雲林縣四湖鄉	2018-11-24T23:31:23+08:00	2192	5251	7443	829	8272	20983	39.42%	10.45%	25	25
15	雲林縣四湖鄉	2018-11-24T23:20:02+08:00	2192	5251	7443	829	8272	20983	39.42%	10.45%	25	25
15	雲林縣四湖鄉	2018-11-25T01:07:36+08:00	2192	5251	7443	829	8272	20983	39.42%	10.45%	25	25
15	澎湖縣白沙鄉	2018-11-25T03:56:28+08:00	947	2395	3342	309	3651	8625	42.33%	10.98%	15	15
15	澎湖縣白沙鄉	2018-11-24T23:47:43+08:00	947	2395	3342	309	3651	8625	42.33%	10.98%	15	15
15	澎湖縣白沙鄉	2018-11-24T22:58:09+08:00	609	1582	2191	174	2365	5491	43.07%	11.09%	13	15
15	澎湖縣白沙鄉	2018-11-24T23:56:01+08:00	947	2395	3342	309	3651	8625	42.33%	10.98%	15	15
15	澎湖縣白沙鄉	2018-11-24T23:01:46+08:00	609	1582	2191	174	2365	5491	43.07%	11.09%	13	15
15	澎湖縣白沙鄉	2018-11-24T23:12:30+08:00	609	1582	2191	174	2365	5491	43.07%	11.09%	13	15
15	澎湖縣白沙鄉	2018-11-25T06:09:09+08:00	947	2395	3342	309	3651	8625	42.33%	10.98%	15	15
15	澎湖縣白沙鄉	2018-11-24T23:51:49+08:00	947	2395	3342	309	3651	8625	42.33%	10.98%	15	15
15	澎湖縣白沙鄉	2018-11-24T22:13:45+08:00	523	1412	1935	144	2079	4717	44.07%	11.09%	12	15
15	澎湖縣白沙鄉	2018-11-25T04:03:06+08:00	947	2395	3342	309	3651	8625	42.33%	10.98%	15	15
15	澎湖縣白沙鄉	2018-11-24T23:27:31+08:00	947	2395	3342	309	3651	8625	42.33%	10.98%	15	15
15	澎湖縣白沙鄉	2018-11-24T22:30:23+08:00	523	1412	1935	144	2079	4717	44.07%	11.09%	12	15
15	澎湖縣白沙鄉	2018-11-25T03:32:52+08:00	947	2395	3342	309	3651	8625	42.33%	10.98%	15	15
15	澎湖縣白沙鄉	2018-11-25T03:44:40+08:00	947	2395	3342	309	3651	8625	42.33%	10.98%	15	15
15	澎湖縣白沙鄉	2018-11-25T00:57:51+08:00	947	2395	3342	309	3651	8625	42.33%	10.98%	15	15
15	澎湖縣白沙鄉	2018-11-24T22:19:50+08:00	523	1412	1935	144	2079	4717	44.07%	11.09%	12	15
15	澎湖縣白沙鄉	2018-11-24T22:16:25+08:00	523	1412	1935	144	2079	4717	44.07%	11.09%	12	15
15	澎湖縣白沙鄉	2018-11-25T00:09:50+08:00	947	2395	3342	309	3651	8625	42.33%	10.98%	15	15
15	澎湖縣白沙鄉	2018-11-25T00:18:47+08:00	947	2395	3342	309	3651	8625	42.33%	10.98%	15	15
15	澎湖縣白沙鄉	2018-11-24T22:37:14+08:00	609	1582	2191	174	2365	5491	43.07%	11.09%	13	15
15	澎湖縣白沙鄉	2018-11-24T23:20:08+08:00	809	2119	2928	222	3150	7196	43.77%	11.24%	14	15
15	澎湖縣白沙鄉	2018-11-24T23:31:27+08:00	947	2395	3342	309	3651	8625	42.33%	10.98%	15	15
15	澎湖縣白沙鄉	2018-11-24T22:45:21+08:00	609	1582	2191	174	2365	5491	43.07%	11.09%	13	15
15	澎湖縣白沙鄉	2018-11-24T23:39:33+08:00	947	2395	3342	309	3651	8625	42.33%	10.98%	15	15
15	澎湖縣白沙鄉	2018-11-24T23:05:16+08:00	609	1582	2191	174	2365	5491	43.07%	11.09%	13	15
15	澎湖縣白沙鄉	2018-11-24T22:26:49+08:00	523	1412	1935	144	2079	4717	44.07%	11.09%	12	15
15	澎湖縣白沙鄉	2018-11-25T01:07:40+08:00	947	2395	3342	309	3651	8625	42.33%	10.98%	15	15
15	澎湖縣白沙鄉	2018-11-24T22:54:37+08:00	609	1582	2191	174	2365	5491	43.07%	11.09%	13	15
15	澎湖縣白沙鄉	2018-11-24T22:33:50+08:00	609	1582	2191	174	2365	5491	43.07%	11.09%	13	15
15	澎湖縣白沙鄉	2018-11-25T01:12:59+08:00	947	2395	3342	309	3651	8625	42.33%	10.98%	15	15
15	澎湖縣白沙鄉	2018-11-25T00:05:18+08:00	947	2395	3342	309	3651	8625	42.33%	10.98%	15	15
15	澎湖縣白沙鄉	2018-11-24T23:08:51+08:00	609	1582	2191	174	2365	5491	43.07%	11.09%	13	15
15	澎湖縣白沙鄉	2018-11-24T23:23:51+08:00	947	2395	3342	309	3651	8625	42.33%	10.98%	15	15
15	澎湖縣白沙鄉	2018-11-25T00:23:17+08:00	947	2395	3342	309	3651	8625	42.33%	10.98%	15	15
15	澎湖縣白沙鄉	2018-11-25T00:00:24+08:00	947	2395	3342	309	3651	8625	42.33%	10.98%	15	15
15	澎湖縣白沙鄉	2018-11-24T22:51:03+08:00	609	1582	2191	174	2365	5491	43.07%	11.09%	13	15
15	澎湖縣白沙鄉	2018-11-24T22:23:28+08:00	523	1412	1935	144	2079	4717	44.07%	11.09%	12	15
15	澎湖縣白沙鄉	2018-11-24T22:40:40+08:00	609	1582	2191	174	2365	5491	43.07%	11.09%	13	15
15	澎湖縣白沙鄉	2018-11-25T06:24:13+08:00	947	2395	3342	309	3651	8625	42.33%	10.98%	15	15
15	澎湖縣白沙鄉	2018-11-25T01:02:44+08:00	947	2395	3342	309	3651	8625	42.33%	10.98%	15	15
15	澎湖縣白沙鄉	2018-11-25T06:14:05+08:00	947	2395	3342	309	3651	8625	42.33%	10.98%	15	15
15	澎湖縣白沙鄉	2018-11-25T06:19:10+08:00	947	2395	3342	309	3651	8625	42.33%	10.98%	15	15
15	澎湖縣白沙鄉	2018-11-25T00:14:23+08:00	947	2395	3342	309	3651	8625	42.33%	10.98%	15	15
15	澎湖縣白沙鄉	2018-11-25T01:18:10+08:00	947	2395	3342	309	3651	8625	42.33%	10.98%	15	15
15	澎湖縣白沙鄉	2018-11-25T03:50:04+08:00	947	2395	3342	309	3651	8625	42.33%	10.98%	15	15
15	澎湖縣白沙鄉	2018-11-24T23:43:31+08:00	947	2395	3342	309	3651	8625	42.33%	10.98%	15	15
15	澎湖縣白沙鄉	2018-11-25T06:29:31+08:00	947	2395	3342	309	3651	8625	42.33%	10.98%	15	15
15	澎湖縣白沙鄉	2018-11-24T23:16:16+08:00	809	2119	2928	222	3150	7196	43.77%	11.24%	14	15
15	澎湖縣白沙鄉	2018-11-24T23:35:22+08:00	947	2395	3342	309	3651	8625	42.33%	10.98%	15	15
15	澎湖縣白沙鄉	2018-11-24T22:41:51+08:00	609	1582	2191	174	2365	5491	43.07%	11.09%	13	15
15	澎湖縣白沙鄉	2018-11-25T03:39:08+08:00	947	2395	3342	309	3651	8625	42.33%	10.98%	15	15
15	澎湖縣白沙鄉	2018-11-25T01:26:08+08:00	947	2395	3342	309	3651	8625	42.33%	10.98%	15	15
15	高雄市左營區	2018-11-25T03:56:19+08:00	30605	63666	94271	3966	98237	161367	60.88%	18.97%	103	103
15	高雄市左營區	2018-11-24T22:45:14+08:00	8708	19003	27711	1424	29135	47503	61.33%	18.33%	40	103
15	高雄市左營區	2018-11-24T22:58:00+08:00	11842	25234	37076	1710	38786	63473	61.11%	18.66%	49	103
15	高雄市左營區	2018-11-24T22:26:42+08:00	6836	15037	21873	1200	23073	37846	60.97%	18.06%	34	103
15	高雄市左營區	2018-11-25T01:18:00+08:00	28223	59039	87262	3651	90913	148311	61.3%	19.03%	96	103
15	高雄市左營區	2018-11-24T23:16:09+08:00	14054	29681	43735	1980	45715	74802	61.11%	18.79%	56	103
15	高雄市左營區	2018-11-25T00:18:38+08:00	23137	49285	72422	3088	75510	123276	61.25%	18.77%	83	103
15	高雄市左營區	2018-11-24T22:37:06+08:00	8383	18390	26773	1387	28160	45965	61.26%	18.24%	39	103
15	高雄市左營區	2018-11-25T06:09:00+08:00	30605	63666	94271	3966	98237	161367	60.88%	18.97%	103	103
15	高雄市左營區	2018-11-25T01:25:59+08:00	28778	60243	89021	3782	92803	152564	60.83%	18.86%	98	103
15	高雄市左營區	2018-11-25T00:57:43+08:00	27341	57449	84790	3562	88352	144087	61.32%	18.98%	94	103
15	高雄市左營區	2018-11-24T22:19:42+08:00	6067	12920	18987	1063	20050	32992	60.77%	18.39%	31	103
15	高雄市左營區	2018-11-25T01:02:37+08:00	27341	57449	84790	3562	88352	144087	61.32%	18.98%	94	103
15	高雄市左營區	2018-11-24T22:40:33+08:00	8708	19003	27711	1424	29135	47503	61.33%	18.33%	40	103
15	高雄市左營區	2018-11-24T23:51:41+08:00	20088	42798	62886	2692	65578	107147	61.2%	18.75%	74	103
15	高雄市左營區	2018-11-24T23:55:53+08:00	20713	44321	65034	2756	67790	110915	61.12%	18.67%	76	103
15	高雄市左營區	2018-11-24T22:13:35+08:00	5578	11712	17290	999	18289	29804	61.36%	18.72%	29	103
15	高雄市左營區	2018-11-25T00:00:17+08:00	21681	46379	68060	2889	70949	115851	61.24%	18.71%	79	103
15	高雄市左營區	2018-11-24T23:19:58+08:00	14054	29681	43735	1980	45715	74802	61.11%	18.79%	56	103
15	高雄市左營區	2018-11-24T23:27:24+08:00	15120	32082	47202	2067	49269	80413	61.27%	18.8%	59	103
15	高雄市左營區	2018-11-25T03:44:30+08:00	30605	63666	94271	3966	98237	161367	60.88%	18.97%	103	103
15	高雄市左營區	2018-11-24T23:01:37+08:00	12541	26559	39100	1782	40882	67038	60.98%	18.71%	51	103
15	高雄市左營區	2018-11-25T04:02:58+08:00	30605	63666	94271	3966	98237	161367	60.88%	18.97%	103	103
15	高雄市左營區	2018-11-25T00:14:16+08:00	22426	47947	70373	2976	73349	119702	61.28%	18.73%	81	103
15	高雄市左營區	2018-11-24T23:35:16+08:00	16301	34634	50935	2225	53160	86847	61.21%	18.77%	63	103
15	高雄市左營區	2018-11-24T23:12:22+08:00	13338	28262	41600	1908	43508	71295	61.03%	18.71%	54	103
15	高雄市左營區	2018-11-24T23:31:18+08:00	15957	34031	49988	2204	52192	85346	61.15%	18.7%	62	103
15	高雄市左營區	2018-11-24T23:39:23+08:00	16498	35230	51728	2242	53970	88206	61.19%	18.7%	64	103
15	高雄市左營區	2018-11-25T01:07:32+08:00	27341	57449	84790	3562	88352	144087	61.32%	18.98%	94	103
15	高雄市左營區	2018-11-24T23:47:35+08:00	18527	39328	57855	2494	60349	98487	61.28%	18.81%	69	103
15	高雄市左營區	2018-11-24T22:41:42+08:00	8708	19003	27711	1424	29135	47503	61.33%	18.33%	40	103
15	高雄市左營區	2018-11-25T06:13:58+08:00	30605	63666	94271	3966	98237	161367	60.88%	18.97%	103	103
15	高雄市左營區	2018-11-24T22:54:31+08:00	11095	23726	34821	1657	36478	59692	61.11%	18.59%	47	103
15	高雄市左營區	2018-11-24T22:50:55+08:00	9695	20959	30654	1546	32200	52487	61.35%	18.47%	43	103
15	高雄市左營區	2018-11-25T00:09:41+08:00	22018	47150	69168	2925	72093	117684	61.26%	18.71%	80	103
15	高雄市左營區	2018-11-25T01:12:50+08:00	27341	57449	84790	3562	88352	144087	61.32%	18.98%	94	103
15	高雄市左營區	2018-11-24T23:43:22+08:00	18163	38536	56699	2458	59157	96514	61.29%	18.82%	68	103
15	高雄市左營區	2018-11-25T06:29:23+08:00	30605	63666	94271	3966	98237	161367	60.88%	18.97%	103	103
15	高雄市左營區	2018-11-25T03:49:57+08:00	30605	63666	94271	3966	98237	161367	60.88%	18.97%	103	103
15	高雄市左營區	2018-11-24T23:05:10+08:00	12907	27295	40202	1803	42005	68904	60.96%	18.73%	52	103
15	高雄市左營區	2018-11-25T06:19:03+08:00	30605	63666	94271	3966	98237	161367	60.88%	18.97%	103	103
15	高雄市左營區	2018-11-25T00:05:11+08:00	21681	46379	68060	2889	70949	115851	61.24%	18.71%	79	103
15	高雄市左營區	2018-11-25T06:24:06+08:00	30605	63666	94271	3966	98237	161367	60.88%	18.97%	103	103
15	高雄市左營區	2018-11-24T22:30:16+08:00	6836	15037	21873	1200	23073	37846	60.97%	18.06%	34	103
15	高雄市左營區	2018-11-24T23:08:43+08:00	13338	28262	41600	1908	43508	71295	61.03%	18.71%	54	103
15	高雄市左營區	2018-11-24T22:23:20+08:00	6661	14367	21028	1166	22194	36444	60.9%	18.28%	33	103
15	高雄市左營區	2018-11-25T00:23:10+08:00	23137	49285	72422	3088	75510	123276	61.25%	18.77%	83	103
15	高雄市左營區	2018-11-25T03:32:43+08:00	30605	63666	94271	3966	98237	161367	60.88%	18.97%	103	103
15	高雄市左營區	2018-11-24T23:23:44+08:00	15120	32082	47202	2067	49269	80413	61.27%	18.8%	59	103
15	高雄市左營區	2018-11-24T22:33:44+08:00	7617	17023	24640	1311	25951	42679	60.81%	17.85%	37	103
15	高雄市左營區	2018-11-24T22:16:17+08:00	6067	12920	18987	1063	20050	32992	60.77%	18.39%	31	103
15	高雄市左營區	2018-11-25T03:39:00+08:00	30605	63666	94271	3966	98237	161367	60.88%	18.97%	103	103
15	高雄市林園區	2018-11-25T01:18:01+08:00	10174	20560	30734	2234	32968	59129	55.76%	17.21%	51	51
15	高雄市林園區	2018-11-24T22:58:01+08:00	9351	18946	28297	2125	30422	54368	55.96%	17.2%	48	51
15	高雄市林園區	2018-11-24T22:37:07+08:00	9351	18946	28297	2125	30422	54368	55.96%	17.2%	48	51
15	高雄市林園區	2018-11-24T22:45:14+08:00	9351	18946	28297	2125	30422	54368	55.96%	17.2%	48	51
15	高雄市林園區	2018-11-25T03:56:20+08:00	10174	20560	30734	2234	32968	59129	55.76%	17.21%	51	51
15	高雄市林園區	2018-11-24T22:26:42+08:00	8690	17593	26283	1966	28249	50140	56.34%	17.33%	45	51
15	高雄市林園區	2018-11-24T23:16:09+08:00	9901	19977	29878	2201	32079	57644	55.65%	17.18%	50	51
15	高雄市林園區	2018-11-25T00:18:38+08:00	10174	20560	30734	2234	32968	59129	55.76%	17.21%	51	51
15	高雄市林園區	2018-11-25T01:25:59+08:00	10174	20560	30734	2234	32968	59129	55.76%	17.21%	51	51
15	高雄市林園區	2018-11-25T00:57:43+08:00	10174	20560	30734	2234	32968	59129	55.76%	17.21%	51	51
15	高雄市林園區	2018-11-25T01:02:37+08:00	10174	20560	30734	2234	32968	59129	55.76%	17.21%	51	51
15	高雄市林園區	2018-11-24T22:40:33+08:00	9351	18946	28297	2125	30422	54368	55.96%	17.2%	48	51
15	高雄市林園區	2018-11-24T23:51:41+08:00	10174	20560	30734	2234	32968	59129	55.76%	17.21%	51	51
15	高雄市林園區	2018-11-25T06:09:01+08:00	10174	20560	30734	2234	32968	59129	55.76%	17.21%	51	51
15	高雄市林園區	2018-11-24T22:19:43+08:00	8690	17593	26283	1966	28249	50140	56.34%	17.33%	45	51
15	高雄市林園區	2018-11-24T23:55:53+08:00	10174	20560	30734	2234	32968	59129	55.76%	17.21%	51	51
15	高雄市林園區	2018-11-25T03:44:31+08:00	10174	20560	30734	2234	32968	59129	55.76%	17.21%	51	51
15	高雄市林園區	2018-11-25T00:00:17+08:00	10174	20560	30734	2234	32968	59129	55.76%	17.21%	51	51
15	高雄市林園區	2018-11-24T23:19:58+08:00	9901	19977	29878	2201	32079	57644	55.65%	17.18%	50	51
15	高雄市林園區	2018-11-24T23:27:24+08:00	9901	19977	29878	2201	32079	57644	55.65%	17.18%	50	51
15	高雄市林園區	2018-11-25T01:07:33+08:00	10174	20560	30734	2234	32968	59129	55.76%	17.21%	51	51
15	高雄市林園區	2018-11-24T23:31:19+08:00	9901	19977	29878	2201	32079	57644	55.65%	17.18%	50	51
15	高雄市林園區	2018-11-24T23:01:37+08:00	9901	19977	29878	2201	32079	57644	55.65%	17.18%	50	51
15	高雄市林園區	2018-11-24T23:12:23+08:00	9901	19977	29878	2201	32079	57644	55.65%	17.18%	50	51
15	高雄市林園區	2018-11-25T04:02:58+08:00	10174	20560	30734	2234	32968	59129	55.76%	17.21%	51	51
15	高雄市林園區	2018-11-25T00:14:16+08:00	10174	20560	30734	2234	32968	59129	55.76%	17.21%	51	51
15	高雄市林園區	2018-11-24T23:35:16+08:00	9901	19977	29878	2201	32079	57644	55.65%	17.18%	50	51
15	高雄市林園區	2018-11-24T23:39:24+08:00	9901	19977	29878	2201	32079	57644	55.65%	17.18%	50	51
15	高雄市林園區	2018-11-24T23:47:35+08:00	9901	19977	29878	2201	32079	57644	55.65%	17.18%	50	51
15	高雄市林園區	2018-11-24T23:43:23+08:00	9901	19977	29878	2201	32079	57644	55.65%	17.18%	50	51
15	高雄市林園區	2018-11-25T01:12:51+08:00	10174	20560	30734	2234	32968	59129	55.76%	17.21%	51	51
15	高雄市林園區	2018-11-25T06:13:58+08:00	10174	20560	30734	2234	32968	59129	55.76%	17.21%	51	51
15	高雄市林園區	2018-11-24T22:54:31+08:00	9351	18946	28297	2125	30422	54368	55.96%	17.2%	48	51
15	高雄市林園區	2018-11-24T22:50:55+08:00	9351	18946	28297	2125	30422	54368	55.96%	17.2%	48	51
15	高雄市林園區	2018-11-25T00:09:41+08:00	10174	20560	30734	2234	32968	59129	55.76%	17.21%	51	51
15	高雄市林園區	2018-11-24T22:41:43+08:00	9351	18946	28297	2125	30422	54368	55.96%	17.2%	48	51
15	高雄市林園區	2018-11-25T03:49:57+08:00	10174	20560	30734	2234	32968	59129	55.76%	17.21%	51	51
15	高雄市林園區	2018-11-24T23:05:10+08:00	9901	19977	29878	2201	32079	57644	55.65%	17.18%	50	51
15	高雄市林園區	2018-11-25T06:19:03+08:00	10174	20560	30734	2234	32968	59129	55.76%	17.21%	51	51
15	高雄市林園區	2018-11-25T06:29:24+08:00	10174	20560	30734	2234	32968	59129	55.76%	17.21%	51	51
15	高雄市林園區	2018-11-25T00:05:11+08:00	10174	20560	30734	2234	32968	59129	55.76%	17.21%	51	51
15	高雄市林園區	2018-11-25T06:24:06+08:00	10174	20560	30734	2234	32968	59129	55.76%	17.21%	51	51
15	高雄市林園區	2018-11-24T22:30:16+08:00	8690	17593	26283	1966	28249	50140	56.34%	17.33%	45	51
15	高雄市林園區	2018-11-24T22:13:36+08:00	8690	17593	26283	1966	28249	50140	56.34%	17.33%	45	51
15	高雄市林園區	2018-11-24T23:08:43+08:00	9901	19977	29878	2201	32079	57644	55.65%	17.18%	50	51
15	高雄市林園區	2018-11-24T22:23:20+08:00	8690	17593	26283	1966	28249	50140	56.34%	17.33%	45	51
15	高雄市林園區	2018-11-25T00:23:10+08:00	10174	20560	30734	2234	32968	59129	55.76%	17.21%	51	51
15	高雄市林園區	2018-11-25T03:32:43+08:00	10174	20560	30734	2234	32968	59129	55.76%	17.21%	51	51
15	高雄市林園區	2018-11-24T23:23:44+08:00	9901	19977	29878	2201	32079	57644	55.65%	17.18%	50	51
15	高雄市林園區	2018-11-24T22:33:44+08:00	9128	18479	27607	2059	29666	52988	55.99%	17.23%	47	51
15	高雄市林園區	2018-11-24T22:16:17+08:00	8690	17593	26283	1966	28249	50140	56.34%	17.33%	45	51
15	高雄市林園區	2018-11-25T03:39:01+08:00	10174	20560	30734	2234	32968	59129	55.76%	17.21%	51	51
15	苗栗縣銅鑼鄉	2018-11-24T22:26:44+08:00	2346	5800	8146	502	8648	15424	56.07%	15.21%	16	16
15	苗栗縣銅鑼鄉	2018-11-25T00:05:13+08:00	2346	5800	8146	502	8648	15424	56.07%	15.21%	16	16
15	苗栗縣銅鑼鄉	2018-11-25T00:09:43+08:00	2346	5800	8146	502	8648	15424	56.07%	15.21%	16	16
15	苗栗縣銅鑼鄉	2018-11-24T22:37:08+08:00	2346	5800	8146	502	8648	15424	56.07%	15.21%	16	16
15	苗栗縣銅鑼鄉	2018-11-24T22:54:33+08:00	2346	5800	8146	502	8648	15424	56.07%	15.21%	16	16
15	苗栗縣銅鑼鄉	2018-11-24T22:50:57+08:00	2346	5800	8146	502	8648	15424	56.07%	15.21%	16	16
15	苗栗縣銅鑼鄉	2018-11-25T01:12:53+08:00	2346	5800	8146	502	8648	15424	56.07%	15.21%	16	16
15	苗栗縣銅鑼鄉	2018-11-24T22:40:35+08:00	2346	5800	8146	502	8648	15424	56.07%	15.21%	16	16
15	苗栗縣銅鑼鄉	2018-11-25T01:02:39+08:00	2346	5800	8146	502	8648	15424	56.07%	15.21%	16	16
15	苗栗縣銅鑼鄉	2018-11-25T04:03:00+08:00	2346	5800	8146	502	8648	15424	56.07%	15.21%	16	16
15	苗栗縣銅鑼鄉	2018-11-25T00:57:45+08:00	2346	5800	8146	502	8648	15424	56.07%	15.21%	16	16
15	苗栗縣銅鑼鄉	2018-11-24T22:19:44+08:00	2346	5800	8146	502	8648	15424	56.07%	15.21%	16	16
15	苗栗縣銅鑼鄉	2018-11-25T06:14:00+08:00	2346	5800	8146	502	8648	15424	56.07%	15.21%	16	16
15	苗栗縣銅鑼鄉	2018-11-25T00:00:18+08:00	2346	5800	8146	502	8648	15424	56.07%	15.21%	16	16
15	苗栗縣銅鑼鄉	2018-11-24T23:23:46+08:00	2346	5800	8146	502	8648	15424	56.07%	15.21%	16	16
15	苗栗縣銅鑼鄉	2018-11-24T23:27:25+08:00	2346	5800	8146	502	8648	15424	56.07%	15.21%	16	16
15	苗栗縣銅鑼鄉	2018-11-24T23:55:55+08:00	2346	5800	8146	502	8648	15424	56.07%	15.21%	16	16
15	苗栗縣銅鑼鄉	2018-11-25T00:23:12+08:00	2346	5800	8146	502	8648	15424	56.07%	15.21%	16	16
15	苗栗縣銅鑼鄉	2018-11-24T22:23:22+08:00	2346	5800	8146	502	8648	15424	56.07%	15.21%	16	16
15	苗栗縣銅鑼鄉	2018-11-24T23:01:39+08:00	2346	5800	8146	502	8648	15424	56.07%	15.21%	16	16
15	苗栗縣銅鑼鄉	2018-11-24T23:31:21+08:00	2346	5800	8146	502	8648	15424	56.07%	15.21%	16	16
15	苗栗縣銅鑼鄉	2018-11-24T23:20:00+08:00	2346	5800	8146	502	8648	15424	56.07%	15.21%	16	16
15	苗栗縣銅鑼鄉	2018-11-25T01:07:34+08:00	2346	5800	8146	502	8648	15424	56.07%	15.21%	16	16
15	苗栗縣銅鑼鄉	2018-11-24T23:35:18+08:00	2346	5800	8146	502	8648	15424	56.07%	15.21%	16	16
15	苗栗縣銅鑼鄉	2018-11-25T00:14:18+08:00	2346	5800	8146	502	8648	15424	56.07%	15.21%	16	16
15	苗栗縣銅鑼鄉	2018-11-24T23:12:25+08:00	2346	5800	8146	502	8648	15424	56.07%	15.21%	16	16
15	苗栗縣銅鑼鄉	2018-11-25T03:39:02+08:00	2346	5800	8146	502	8648	15424	56.07%	15.21%	16	16
15	苗栗縣銅鑼鄉	2018-11-24T22:33:46+08:00	2346	5800	8146	502	8648	15424	56.07%	15.21%	16	16
15	苗栗縣銅鑼鄉	2018-11-25T00:18:41+08:00	2346	5800	8146	502	8648	15424	56.07%	15.21%	16	16
15	苗栗縣銅鑼鄉	2018-11-24T23:43:24+08:00	2346	5800	8146	502	8648	15424	56.07%	15.21%	16	16
15	苗栗縣銅鑼鄉	2018-11-25T03:56:22+08:00	2346	5800	8146	502	8648	15424	56.07%	15.21%	16	16
15	苗栗縣銅鑼鄉	2018-11-25T06:29:25+08:00	2346	5800	8146	502	8648	15424	56.07%	15.21%	16	16
15	苗栗縣銅鑼鄉	2018-11-25T06:19:05+08:00	2346	5800	8146	502	8648	15424	56.07%	15.21%	16	16
15	苗栗縣銅鑼鄉	2018-11-24T23:05:11+08:00	2346	5800	8146	502	8648	15424	56.07%	15.21%	16	16
15	苗栗縣銅鑼鄉	2018-11-24T22:45:16+08:00	2346	5800	8146	502	8648	15424	56.07%	15.21%	16	16
15	苗栗縣銅鑼鄉	2018-11-24T22:41:44+08:00	2346	5800	8146	502	8648	15424	56.07%	15.21%	16	16
15	苗栗縣銅鑼鄉	2018-11-25T01:18:03+08:00	2346	5800	8146	502	8648	15424	56.07%	15.21%	16	16
15	苗栗縣銅鑼鄉	2018-11-25T03:49:59+08:00	2346	5800	8146	502	8648	15424	56.07%	15.21%	16	16
15	苗栗縣銅鑼鄉	2018-11-24T22:58:03+08:00	2346	5800	8146	502	8648	15424	56.07%	15.21%	16	16
15	苗栗縣銅鑼鄉	2018-11-25T06:09:03+08:00	2346	5800	8146	502	8648	15424	56.07%	15.21%	16	16
15	苗栗縣銅鑼鄉	2018-11-24T23:51:43+08:00	2346	5800	8146	502	8648	15424	56.07%	15.21%	16	16
15	苗栗縣銅鑼鄉	2018-11-25T06:24:08+08:00	2346	5800	8146	502	8648	15424	56.07%	15.21%	16	16
15	苗栗縣銅鑼鄉	2018-11-24T22:30:18+08:00	2346	5800	8146	502	8648	15424	56.07%	15.21%	16	16
15	苗栗縣銅鑼鄉	2018-11-25T03:32:45+08:00	2346	5800	8146	502	8648	15424	56.07%	15.21%	16	16
15	苗栗縣銅鑼鄉	2018-11-24T22:13:38+08:00	2346	5800	8146	502	8648	15424	56.07%	15.21%	16	16
15	苗栗縣銅鑼鄉	2018-11-24T23:08:45+08:00	2346	5800	8146	502	8648	15424	56.07%	15.21%	16	16
15	苗栗縣銅鑼鄉	2018-11-25T03:44:33+08:00	2346	5800	8146	502	8648	15424	56.07%	15.21%	16	16
15	苗栗縣銅鑼鄉	2018-11-24T23:16:10+08:00	2346	5800	8146	502	8648	15424	56.07%	15.21%	16	16
15	苗栗縣銅鑼鄉	2018-11-24T23:47:37+08:00	2346	5800	8146	502	8648	15424	56.07%	15.21%	16	16
15	苗栗縣銅鑼鄉	2018-11-24T22:16:19+08:00	2346	5800	8146	502	8648	15424	56.07%	15.21%	16	16
15	苗栗縣銅鑼鄉	2018-11-24T23:39:26+08:00	2346	5800	8146	502	8648	15424	56.07%	15.21%	16	16
15	苗栗縣銅鑼鄉	2018-11-25T01:26:01+08:00	2346	5800	8146	502	8648	15424	56.07%	15.21%	16	16
15	苗栗縣	2018-11-24T22:26:43+08:00	55403	128419	183822	12016	195838	344287	56.88%	16.09%	373	470
15	苗栗縣	2018-11-25T03:56:21+08:00	74809	172173	246982	15638	262620	461580	56.9%	16.21%	470	470
15	苗栗縣	2018-11-25T01:12:52+08:00	74809	172173	246982	15638	262620	461580	56.9%	16.21%	470	470
15	苗栗縣	2018-11-24T22:54:32+08:00	65331	151360	216691	13917	230608	405067	56.93%	16.13%	425	470
15	苗栗縣	2018-11-25T00:09:43+08:00	74533	171688	246221	15616	261837	460092	56.91%	16.2%	469	470
15	苗栗縣	2018-11-25T00:05:12+08:00	74329	171248	245577	15557	261134	458997	56.89%	16.19%	468	470
15	苗栗縣	2018-11-24T22:37:08+08:00	59797	138594	198391	12855	211246	370890	56.96%	16.12%	396	470
15	苗栗縣	2018-11-24T22:45:15+08:00	62013	143695	205708	13216	218924	384725	56.9%	16.12%	408	470
15	苗栗縣	2018-11-24T22:50:57+08:00	63607	147448	211055	13551	224606	394417	56.95%	16.13%	416	470
15	苗栗縣	2018-11-25T01:02:38+08:00	74809	172173	246982	15638	262620	461580	56.9%	16.21%	470	470
15	苗栗縣	2018-11-24T22:40:35+08:00	60817	140969	201786	13010	214796	377216	56.94%	16.12%	402	470
15	苗栗縣	2018-11-25T04:03:00+08:00	74809	172173	246982	15638	262620	461580	56.9%	16.21%	470	470
15	苗栗縣	2018-11-25T00:57:45+08:00	74533	171688	246221	15616	261837	460092	56.91%	16.2%	469	470
15	苗栗縣	2018-11-24T22:19:44+08:00	53022	122914	175936	11623	187559	329931	56.85%	16.07%	360	470
15	苗栗縣	2018-11-25T06:14:00+08:00	74809	172173	246982	15638	262620	461580	56.9%	16.21%	470	470
15	苗栗縣	2018-11-25T00:00:18+08:00	74329	171248	245577	15557	261134	458997	56.89%	16.19%	468	470
15	苗栗縣	2018-11-24T23:55:54+08:00	74329	171248	245577	15557	261134	458997	56.89%	16.19%	468	470
15	苗栗縣	2018-11-24T23:27:25+08:00	72975	168410	241385	15373	256758	451125	56.92%	16.18%	462	470
15	苗栗縣	2018-11-24T22:23:22+08:00	54253	125836	180089	11855	191944	337366	56.89%	16.08%	367	470
15	苗栗縣	2018-11-24T23:01:39+08:00	66971	155206	222177	14213	236390	415343	56.91%	16.12%	433	470
15	苗栗縣	2018-11-24T23:39:25+08:00	73719	169940	243659	15465	259124	455445	56.89%	16.19%	465	470
15	苗栗縣	2018-11-24T23:20:00+08:00	72776	167913	240689	15334	256023	449939	56.9%	16.17%	461	470
15	苗栗縣	2018-11-25T01:07:34+08:00	74809	172173	246982	15638	262620	461580	56.9%	16.21%	470	470
15	苗栗縣	2018-11-24T23:12:24+08:00	70349	161902	232251	14812	247063	433786	56.96%	16.22%	449	470
15	苗栗縣	2018-11-25T00:18:40+08:00	74533	171688	246221	15616	261837	460092	56.91%	16.2%	469	470
15	苗栗縣	2018-11-25T03:39:02+08:00	74809	172173	246982	15638	262620	461580	56.9%	16.21%	470	470
15	苗栗縣	2018-11-24T23:31:20+08:00	73233	168900	242133	15407	257540	452669	56.89%	16.18%	463	470
15	苗栗縣	2018-11-24T23:35:17+08:00	73719	169940	243659	15465	259124	455445	56.89%	16.19%	465	470
15	苗栗縣	2018-11-25T00:14:17+08:00	74533	171688	246221	15616	261837	460092	56.91%	16.2%	469	470
15	苗栗縣	2018-11-24T23:43:24+08:00	73960	170445	244405	15499	259904	456783	56.9%	16.19%	466	470
15	苗栗縣	2018-11-24T22:58:02+08:00	66498	154173	220671	14136	234807	412610	56.91%	16.12%	431	470
15	苗栗縣	2018-11-25T03:49:58+08:00	74809	172173	246982	15638	262620	461580	56.9%	16.21%	470	470
15	苗栗縣	2018-11-25T01:18:02+08:00	74809	172173	246982	15638	262620	461580	56.9%	16.21%	470	470
15	苗栗縣	2018-11-25T06:29:25+08:00	74809	172173	246982	15638	262620	461580	56.9%	16.21%	470	470
15	苗栗縣	2018-11-25T06:19:05+08:00	74809	172173	246982	15638	262620	461580	56.9%	16.21%	470	470
15	苗栗縣	2018-11-24T23:05:11+08:00	68052	157633	225685	14414	240099	421720	56.93%	16.14%	438	470
15	苗栗縣	2018-11-24T22:41:44+08:00	60817	140969	201786	13010	214796	377216	56.94%	16.12%	402	470
15	苗栗縣	2018-11-24T23:51:43+08:00	74139	170805	244944	15528	260472	457856	56.89%	16.19%	467	470
15	苗栗縣	2018-11-24T22:30:17+08:00	56920	131698	188618	12275	200893	353273	56.87%	16.11%	381	470
15	苗栗縣	2018-11-25T06:24:08+08:00	74809	172173	246982	15638	262620	461580	56.9%	16.21%	470	470
15	苗栗縣	2018-11-25T06:09:02+08:00	74809	172173	246982	15638	262620	461580	56.9%	16.21%	470	470
15	苗栗縣	2018-11-24T23:23:45+08:00	72776	167913	240689	15334	256023	449939	56.9%	16.17%	461	470
15	苗栗縣	2018-11-25T03:44:32+08:00	74809	172173	246982	15638	262620	461580	56.9%	16.21%	470	470
15	苗栗縣	2018-11-25T03:32:45+08:00	74809	172173	246982	15638	262620	461580	56.9%	16.21%	470	470
15	苗栗縣	2018-11-24T22:13:38+08:00	50649	117533	168182	11197	179379	315963	56.77%	16.03%	348	470
15	苗栗縣	2018-11-24T23:08:45+08:00	69245	160235	229480	14647	244127	428693	56.95%	16.15%	444	470
15	苗栗縣	2018-11-25T00:23:11+08:00	74533	171688	246221	15616	261837	460092	56.91%	16.2%	469	470
15	苗栗縣	2018-11-24T23:16:10+08:00	72068	166222	238290	15216	253506	445397	56.92%	16.18%	458	470
15	苗栗縣	2018-11-24T23:47:37+08:00	73960	170445	244405	15499	259904	456783	56.9%	16.19%	466	470
15	苗栗縣	2018-11-24T22:16:19+08:00	52174	120988	173162	11437	184599	324943	56.81%	16.06%	355	470
15	苗栗縣	2018-11-25T01:26:01+08:00	74809	172173	246982	15638	262620	461580	56.9%	16.21%	470	470
15	苗栗縣	2018-11-24T22:33:45+08:00	58643	135831	194474	12652	207126	363581	56.97%	16.13%	390	470
15	桃園市	2018-11-24T23:16:06+08:00	199335	404255	603590	31244	634834	1223037	51.91%	16.3%	814	1
15	桃園市	2018-11-24T23:43:20+08:00	229956	464427	694383	35470	729853	1406959	51.87%	16.34%	921	1
15	桃園市	2018-11-25T06:13:55+08:00	295646	590939	886585	43820	930405	1801823	51.64%	16.41%	142	1
15	桃園市	2018-11-25T06:19:00+08:00	295646	590939	886585	43820	930405	1801823	51.64%	16.41%	142	1
15	桃園市	2018-11-25T06:29:20+08:00	295646	590939	886585	43820	930405	1801823	51.64%	16.41%	142	1
15	桃園市	2018-11-25T03:49:54+08:00	295646	590939	886585	43820	930405	1801823	51.64%	16.41%	142	1
15	桃園市	2018-11-25T03:56:16+08:00	295646	590939	886585	43820	930405	1801823	51.64%	16.41%	142	1
15	桃園市	2018-11-25T01:07:29+08:00	281551	562981	844532	42069	886601	1715221	51.69%	16.41%	095	1
15	桃園市	2018-11-24T22:30:13+08:00	139948	282860	422808	22756	445564	856632	52.01%	16.34%	590	1
15	桃園市	2018-11-25T06:24:03+08:00	295646	590939	886585	43820	930405	1801823	51.64%	16.41%	142	1
15	桃園市	2018-11-25T03:32:38+08:00	295646	590939	886585	43820	930405	1801823	51.64%	16.41%	142	1
15	桃園市	2018-11-25T01:25:56+08:00	286912	573315	860227	42707	902934	1746909	51.69%	16.42%	113	1
15	桃園市	2018-11-25T00:23:07+08:00	260943	525007	785950	39300	825250	1595692	51.72%	16.35%	027	1
15	桃園市	2018-11-24T23:51:39+08:00	235493	475834	711327	36183	747510	1441427	51.86%	16.34%	941	1
15	桃園市	2018-11-24T23:23:41+08:00	206641	418606	625247	32221	657468	1266842	51.9%	16.31%	839	1
15	桃園市	2018-11-25T01:17:57+08:00	285168	569534	854702	42447	897149	1735748	51.69%	16.43%	106	1
15	桃園市	2018-11-24T22:57:57+08:00	180486	365577	546063	28562	574625	1105116	52%	16.33%	742	1
15	桃園市	2018-11-24T23:08:40+08:00	190233	386551	576784	30058	606842	1167779	51.97%	16.29%	781	1
15	桃園市	2018-11-25T06:08:57+08:00	295646	590939	886585	43820	930405	1801823	51.64%	16.41%	142	1
15	桃園市	2018-11-25T01:12:47+08:00	284095	567956	852051	42327	894378	1730365	51.69%	16.42%	103	1
15	桃園市	2018-11-24T22:16:14+08:00	124012	250334	374346	20199	394545	757740	52.07%	16.37%	528	1
15	桃園市	2018-11-25T00:05:08+08:00	247791	499774	747565	37601	785166	1516673	51.77%	16.34%	983	1
15	桃園市	2018-11-24T23:05:07+08:00	188221	382409	570630	29802	600432	1155354	51.97%	16.29%	773	1
15	桃園市	2018-11-24T22:54:28+08:00	175429	355354	530783	27878	558661	1074928	51.97%	16.32%	724	1
15	桃園市	2018-11-24T22:33:41+08:00	145799	294698	440497	23640	464137	892885	51.98%	16.33%	613	1
15	桃園市	2018-11-24T23:47:32+08:00	232907	470684	703591	35891	739482	1425419	51.88%	16.34%	932	1
15	桃園市	2018-11-24T22:41:39+08:00	154383	312881	467264	25006	492270	946994	51.98%	16.3%	646	1
15	桃園市	2018-11-24T22:37:04+08:00	150833	305500	456333	24550	480883	925151	51.98%	16.3%	633	1
15	桃園市	2018-11-25T00:18:34+08:00	259620	522979	782599	39159	821758	1588583	51.73%	16.34%	023	1
15	桃園市	2018-11-24T22:50:52+08:00	165786	336316	502102	26555	528657	1017727	51.94%	16.29%	688	1
15	桃園市	2018-11-24T22:45:11+08:00	158226	320903	479129	25451	504580	971301	51.95%	16.29%	660	1
15	桃園市	2018-11-25T00:57:40+08:00	277899	555556	833455	41531	874986	1691820	51.72%	16.43%	082	1
15	桃園市	2018-11-25T03:44:27+08:00	295646	590939	886585	43820	930405	1801823	51.64%	16.41%	142	1
15	桃園市	2018-11-24T22:19:40+08:00	128155	258633	386788	20813	407601	782573	52.08%	16.38%	545	1
15	桃園市	2018-11-25T01:02:34+08:00	279099	557733	836832	41688	878520	1699212	51.7%	16.43%	086	1
15	桃園市	2018-11-24T22:40:30+08:00	154383	312881	467264	25006	492270	946994	51.98%	16.3%	646	1
15	桃園市	2018-11-25T03:38:58+08:00	295646	590939	886585	43820	930405	1801823	51.64%	16.41%	142	1
15	桃園市	2018-11-24T22:13:31+08:00	119735	241732	361467	19551	381018	732886	51.99%	16.34%	511	1
15	桃園市	2018-11-24T23:27:21+08:00	209913	425171	635084	32711	667795	1287048	51.89%	16.31%	851	1
15	桃園市	2018-11-24T23:55:50+08:00	240298	485135	725433	36731	762164	1470466	51.83%	16.34%	957	1
15	桃園市	2018-11-24T22:23:17+08:00	132275	266898	399173	21500	420673	807990	52.06%	16.37%	561	1
15	桃園市	2018-11-24T23:19:55+08:00	203650	412907	616557	31882	648439	1248631	51.93%	16.31%	829	1
15	桃園市	2018-11-25T00:00:14+08:00	243197	491059	734256	37122	771378	1489763	51.78%	16.32%	967	1
15	桃園市	2018-11-25T04:02:55+08:00	295646	590939	886585	43820	930405	1801823	51.64%	16.41%	142	1
15	桃園市	2018-11-24T22:26:39+08:00	136724	276290	413014	22288	435302	836172	52.06%	16.35%	578	1
15	桃園市	2018-11-25T00:09:38+08:00	252289	508473	760762	38238	799000	1544120	51.74%	16.34%	998	1
15	桃園市	2018-11-24T23:01:34+08:00	184923	375030	559953	29225	589178	1133522	51.98%	16.31%	760	1
15	桃園市	2018-11-24T23:35:13+08:00	219669	443540	663209	34064	697273	1343641	51.89%	16.35%	883	1
15	桃園市	2018-11-25T00:14:13+08:00	254584	512926	767510	38518	806028	1557603	51.75%	16.34%	006	1
15	桃園市	2018-11-24T23:12:19+08:00	192638	391340	583978	30352	614330	1183215	51.92%	16.28%	790	1
15	桃園市	2018-11-24T23:31:15+08:00	215787	436728	652515	33530	686045	1322177	51.89%	16.32%	871	1
15	桃園市	2018-11-24T23:39:20+08:00	224138	452819	676957	34620	711577	1371645	51.88%	16.34%	899	1
15	桃園市平鎮區	2018-11-24T23:16:06+08:00	24291	51555	75846	3311	79157	147912	53.52%	16.42%	103	125
15	桃園市平鎮區	2018-11-25T06:29:21+08:00	29969	63734	93703	4046	97749	183560	53.25%	16.33%	125	125
15	桃園市平鎮區	2018-11-25T06:19:01+08:00	29969	63734	93703	4046	97749	183560	53.25%	16.33%	125	125
15	桃園市平鎮區	2018-11-24T23:43:20+08:00	27095	57380	84475	3677	88152	164986	53.43%	16.42%	114	125
15	桃園市平鎮區	2018-11-25T03:49:54+08:00	29969	63734	93703	4046	97749	183560	53.25%	16.33%	125	125
15	桃園市平鎮區	2018-11-25T03:56:16+08:00	29969	63734	93703	4046	97749	183560	53.25%	16.33%	125	125
15	桃園市平鎮區	2018-11-24T22:45:12+08:00	20086	42633	62719	2708	65427	122144	53.57%	16.44%	86	125
15	桃園市平鎮區	2018-11-24T22:30:13+08:00	18018	38047	56065	2405	58470	108437	53.92%	16.62%	78	125
15	桃園市平鎮區	2018-11-25T06:24:04+08:00	29969	63734	93703	4046	97749	183560	53.25%	16.33%	125	125
15	桃園市平鎮區	2018-11-25T03:32:38+08:00	29969	63734	93703	4046	97749	183560	53.25%	16.33%	125	125
15	桃園市平鎮區	2018-11-25T01:25:56+08:00	29969	63734	93703	4046	97749	183560	53.25%	16.33%	125	125
15	桃園市平鎮區	2018-11-25T00:23:07+08:00	28660	60795	89455	3886	93341	175079	53.31%	16.37%	120	125
15	桃園市平鎮區	2018-11-24T23:51:39+08:00	27095	57380	84475	3677	88152	164986	53.43%	16.42%	114	125
15	桃園市平鎮區	2018-11-24T22:13:32+08:00	16267	34187	50454	2188	52642	97668	53.9%	16.66%	71	125
15	桃園市平鎮區	2018-11-25T01:17:57+08:00	29969	63734	93703	4046	97749	183560	53.25%	16.33%	125	125
15	桃園市平鎮區	2018-11-24T23:08:40+08:00	23588	50120	73708	3213	76921	143819	53.48%	16.4%	100	125
15	桃園市平鎮區	2018-11-24T22:57:58+08:00	22910	48406	71316	3097	74413	139160	53.47%	16.46%	97	125
15	桃園市平鎮區	2018-11-25T06:08:57+08:00	29969	63734	93703	4046	97749	183560	53.25%	16.33%	125	125
15	桃園市平鎮區	2018-11-24T22:54:29+08:00	22316	47248	69564	3038	72602	135718	53.49%	16.44%	95	125
15	桃園市平鎮區	2018-11-25T01:12:47+08:00	29969	63734	93703	4046	97749	183560	53.25%	16.33%	125	125
15	桃園市平鎮區	2018-11-24T22:16:14+08:00	16644	35035	51679	2261	53940	99914	53.99%	16.66%	73	125
15	桃園市平鎮區	2018-11-24T23:05:07+08:00	23588	50120	73708	3213	76921	143819	53.48%	16.4%	100	125
15	桃園市平鎮區	2018-11-25T04:02:56+08:00	29969	63734	93703	4046	97749	183560	53.25%	16.33%	125	125
15	桃園市平鎮區	2018-11-24T22:33:41+08:00	18733	39557	58290	2496	60786	113018	53.78%	16.58%	81	125
15	桃園市平鎮區	2018-11-24T23:47:32+08:00	27095	57380	84475	3677	88152	164986	53.43%	16.42%	114	125
15	桃園市平鎮區	2018-11-24T22:41:39+08:00	19762	42008	61770	2675	64445	120093	53.66%	16.46%	85	125
15	桃園市平鎮區	2018-11-25T00:05:09+08:00	27964	59103	87067	3790	90857	169841	53.5%	16.46%	117	125
15	桃園市平鎮區	2018-11-24T22:37:04+08:00	19503	41246	60749	2637	63386	118162	53.64%	16.51%	84	125
15	桃園市平鎮區	2018-11-24T22:50:52+08:00	21459	45318	66777	2882	69659	130222	53.49%	16.48%	91	125
15	桃園市平鎮區	2018-11-25T06:13:56+08:00	29969	63734	93703	4046	97749	183560	53.25%	16.33%	125	125
15	桃園市平鎮區	2018-11-24T22:26:40+08:00	17782	37427	55209	2387	57596	106881	53.89%	16.64%	77	125
15	桃園市平鎮區	2018-11-25T00:18:35+08:00	28660	60795	89455	3886	93341	175079	53.31%	16.37%	120	125
15	桃園市平鎮區	2018-11-24T22:40:31+08:00	19762	42008	61770	2675	64445	120093	53.66%	16.46%	85	125
15	桃園市平鎮區	2018-11-25T03:44:27+08:00	29969	63734	93703	4046	97749	183560	53.25%	16.33%	125	125
15	桃園市平鎮區	2018-11-25T00:57:41+08:00	29969	63734	93703	4046	97749	183560	53.25%	16.33%	125	125
15	桃園市平鎮區	2018-11-24T22:19:40+08:00	16980	35636	52616	2291	54907	101535	54.08%	16.72%	74	125
15	桃園市平鎮區	2018-11-25T01:02:34+08:00	29969	63734	93703	4046	97749	183560	53.25%	16.33%	125	125
15	桃園市平鎮區	2018-11-25T03:38:58+08:00	29969	63734	93703	4046	97749	183560	53.25%	16.33%	125	125
15	桃園市平鎮區	2018-11-24T23:23:42+08:00	25214	53574	78788	3442	82230	153734	53.49%	16.4%	107	125
15	桃園市平鎮區	2018-11-24T23:27:21+08:00	25645	54608	80253	3505	83758	156769	53.43%	16.36%	109	125
15	桃園市平鎮區	2018-11-24T23:55:50+08:00	27430	58003	85433	3705	89138	166696	53.47%	16.46%	115	125
15	桃園市平鎮區	2018-11-24T22:23:17+08:00	17510	36805	54315	2371	56686	104887	54.04%	16.69%	76	125
15	桃園市平鎮區	2018-11-24T23:19:55+08:00	24826	52700	77526	3413	80939	151129	53.56%	16.43%	105	125
15	桃園市平鎮區	2018-11-25T00:00:14+08:00	27673	58542	86215	3764	89979	168286	53.47%	16.44%	116	125
15	桃園市平鎮區	2018-11-25T01:07:30+08:00	29969	63734	93703	4046	97749	183560	53.25%	16.33%	125	125
15	桃園市平鎮區	2018-11-25T00:09:38+08:00	28406	60234	88640	3863	92503	173362	53.36%	16.39%	119	125
15	桃園市平鎮區	2018-11-24T23:35:14+08:00	26394	55740	82134	3565	85699	160442	53.41%	16.45%	111	125
15	桃園市平鎮區	2018-11-25T00:14:13+08:00	28406	60234	88640	3863	92503	173362	53.36%	16.39%	119	125
15	桃園市平鎮區	2018-11-24T23:01:35+08:00	23344	49530	72874	3171	76045	142183	53.48%	16.42%	99	125
15	桃園市平鎮區	2018-11-24T23:12:19+08:00	23588	50120	73708	3213	76921	143819	53.48%	16.4%	100	125
15	桃園市平鎮區	2018-11-24T23:31:15+08:00	26394	55740	82134	3565	85699	160442	53.41%	16.45%	111	125
15	桃園市平鎮區	2018-11-24T23:39:20+08:00	26879	56893	83772	3628	87400	163601	53.42%	16.43%	113	125
15	臺中市大雅區	2018-11-25T03:56:17+08:00	13441	28615	42056	2356	44412	77189	57.54%	17.41%	46	46
15	臺中市大雅區	2018-11-25T06:29:21+08:00	13441	28615	42056	2356	44412	77189	57.54%	17.41%	46	46
15	臺中市大雅區	2018-11-25T03:49:55+08:00	13441	28615	42056	2356	44412	77189	57.54%	17.41%	46	46
15	臺中市大雅區	2018-11-25T06:19:01+08:00	13441	28615	42056	2356	44412	77189	57.54%	17.41%	46	46
15	臺中市大雅區	2018-11-24T23:16:07+08:00	12745	26716	39461	2201	41662	72439	57.51%	17.59%	43	46
15	臺中市大雅區	2018-11-24T22:45:12+08:00	11792	24737	36529	2052	38581	66960	57.62%	17.61%	40	46
15	臺中市大雅區	2018-11-24T23:43:21+08:00	13441	28615	42056	2356	44412	77189	57.54%	17.41%	46	46
15	臺中市大雅區	2018-11-24T22:41:40+08:00	11792	24737	36529	2052	38581	66960	57.62%	17.61%	40	46
15	臺中市大雅區	2018-11-25T00:18:36+08:00	13441	28615	42056	2356	44412	77189	57.54%	17.41%	46	46
15	臺中市大雅區	2018-11-25T01:25:57+08:00	13441	28615	42056	2356	44412	77189	57.54%	17.41%	46	46
15	臺中市大雅區	2018-11-24T22:30:14+08:00	11165	23348	34513	1922	36435	63160	57.69%	17.68%	38	46
15	臺中市大雅區	2018-11-25T06:24:04+08:00	13441	28615	42056	2356	44412	77189	57.54%	17.41%	46	46
15	臺中市大雅區	2018-11-25T00:23:08+08:00	13441	28615	42056	2356	44412	77189	57.54%	17.41%	46	46
15	臺中市大雅區	2018-11-25T03:32:39+08:00	13441	28615	42056	2356	44412	77189	57.54%	17.41%	46	46
15	臺中市大雅區	2018-11-24T23:51:39+08:00	13441	28615	42056	2356	44412	77189	57.54%	17.41%	46	46
15	臺中市大雅區	2018-11-24T23:27:22+08:00	12976	27345	40321	2273	42594	74074	57.5%	17.52%	44	46
15	臺中市大雅區	2018-11-24T22:13:32+08:00	9115	18839	27954	1583	29537	50873	58.06%	17.92%	31	46
15	臺中市大雅區	2018-11-24T22:57:59+08:00	11792	24737	36529	2052	38581	66960	57.62%	17.61%	40	46
15	臺中市大雅區	2018-11-24T23:08:41+08:00	12451	26050	38501	2162	40663	70871	57.38%	17.57%	42	46
15	臺中市大雅區	2018-11-24T23:19:56+08:00	12745	26716	39461	2201	41662	72439	57.51%	17.59%	43	46
15	臺中市大雅區	2018-11-25T01:17:58+08:00	13441	28615	42056	2356	44412	77189	57.54%	17.41%	46	46
15	臺中市大雅區	2018-11-24T22:54:29+08:00	11792	24737	36529	2052	38581	66960	57.62%	17.61%	40	46
15	臺中市大雅區	2018-11-24T23:47:33+08:00	13441	28615	42056	2356	44412	77189	57.54%	17.41%	46	46
15	臺中市大雅區	2018-11-25T04:02:56+08:00	13441	28615	42056	2356	44412	77189	57.54%	17.41%	46	46
15	臺中市大雅區	2018-11-25T06:08:58+08:00	13441	28615	42056	2356	44412	77189	57.54%	17.41%	46	46
15	臺中市大雅區	2018-11-24T22:16:15+08:00	9401	19417	28818	1622	30440	52752	57.7%	17.82%	32	46
15	臺中市大雅區	2018-11-24T23:31:16+08:00	13193	28062	41255	2334	43589	75807	57.5%	17.4%	45	46
15	臺中市大雅區	2018-11-25T01:12:48+08:00	13441	28615	42056	2356	44412	77189	57.54%	17.41%	46	46
15	臺中市大雅區	2018-11-24T23:05:08+08:00	12451	26050	38501	2162	40663	70871	57.38%	17.57%	42	46
15	臺中市大雅區	2018-11-25T00:05:09+08:00	13441	28615	42056	2356	44412	77189	57.54%	17.41%	46	46
15	臺中市大雅區	2018-11-25T06:13:56+08:00	13441	28615	42056	2356	44412	77189	57.54%	17.41%	46	46
15	臺中市大雅區	2018-11-24T22:26:40+08:00	10552	22045	32597	1830	34427	59740	57.63%	17.66%	36	46
15	臺中市大雅區	2018-11-24T22:50:53+08:00	11792	24737	36529	2052	38581	66960	57.62%	17.61%	40	46
15	臺中市大雅區	2018-11-24T22:37:05+08:00	11792	24737	36529	2052	38581	66960	57.62%	17.61%	40	46
15	臺中市大雅區	2018-11-24T22:19:41+08:00	9663	20014	29677	1689	31366	54399	57.66%	17.76%	33	46
15	臺中市大雅區	2018-11-25T03:38:59+08:00	13441	28615	42056	2356	44412	77189	57.54%	17.41%	46	46
15	臺中市大雅區	2018-11-24T22:40:31+08:00	11792	24737	36529	2052	38581	66960	57.62%	17.61%	40	46
15	臺中市大雅區	2018-11-25T01:02:35+08:00	13441	28615	42056	2356	44412	77189	57.54%	17.41%	46	46
15	臺中市大雅區	2018-11-25T00:57:41+08:00	13441	28615	42056	2356	44412	77189	57.54%	17.41%	46	46
15	臺中市大雅區	2018-11-25T03:44:28+08:00	13441	28615	42056	2356	44412	77189	57.54%	17.41%	46	46
15	臺中市大雅區	2018-11-24T23:23:42+08:00	12976	27345	40321	2273	42594	74074	57.5%	17.52%	44	46
15	臺中市大雅區	2018-11-24T22:23:18+08:00	9954	20758	30712	1723	32435	56362	57.55%	17.66%	34	46
15	臺中市大雅區	2018-11-25T00:00:15+08:00	13441	28615	42056	2356	44412	77189	57.54%	17.41%	46	46
15	臺中市大雅區	2018-11-24T23:55:51+08:00	13441	28615	42056	2356	44412	77189	57.54%	17.41%	46	46
15	臺中市大雅區	2018-11-24T23:39:21+08:00	13193	28062	41255	2334	43589	75807	57.5%	17.4%	45	46
15	臺中市大雅區	2018-11-25T01:07:30+08:00	13441	28615	42056	2356	44412	77189	57.54%	17.41%	46	46
15	臺中市大雅區	2018-11-24T23:12:20+08:00	12451	26050	38501	2162	40663	70871	57.38%	17.57%	42	46
15	臺中市大雅區	2018-11-24T23:35:14+08:00	13193	28062	41255	2334	43589	75807	57.5%	17.4%	45	46
15	臺中市大雅區	2018-11-25T00:14:14+08:00	13441	28615	42056	2356	44412	77189	57.54%	17.41%	46	46
15	臺中市大雅區	2018-11-24T23:01:35+08:00	12145	25446	37591	2096	39687	68973	57.54%	17.61%	41	46
15	臺中市大雅區	2018-11-25T00:09:39+08:00	13441	28615	42056	2356	44412	77189	57.54%	17.41%	46	46
15	臺中市大雅區	2018-11-24T22:33:42+08:00	11492	24040	35532	2004	37536	65144	57.62%	17.64%	39	46
15	臺中市北屯區	2018-11-25T03:56:17+08:00	41689	83227	124916	5529	130445	227720	57.28%	18.31%	137	137
15	臺中市北屯區	2018-11-24T23:16:06+08:00	33437	66496	99933	4577	104510	180576	57.88%	18.52%	111	137
15	臺中市北屯區	2018-11-25T06:29:21+08:00	41689	83227	124916	5529	130445	227720	57.28%	18.31%	137	137
15	臺中市北屯區	2018-11-25T03:49:55+08:00	41689	83227	124916	5529	130445	227720	57.28%	18.31%	137	137
15	臺中市北屯區	2018-11-25T06:19:01+08:00	41689	83227	124916	5529	130445	227720	57.28%	18.31%	137	137
15	臺中市北屯區	2018-11-24T22:45:12+08:00	29327	57929	87256	3970	91226	157404	57.96%	18.63%	97	137
15	臺中市北屯區	2018-11-24T23:43:21+08:00	36158	71704	107862	4882	112744	195649	57.63%	18.48%	119	137
15	臺中市北屯區	2018-11-24T22:41:40+08:00	28421	55966	84387	3835	88222	151863	58.09%	18.71%	94	137
15	臺中市北屯區	2018-11-25T01:25:57+08:00	40395	80670	121065	5367	126432	220525	57.33%	18.32%	133	137
15	臺中市北屯區	2018-11-24T22:30:13+08:00	26799	52802	79601	3601	83202	143257	58.08%	18.71%	89	137
15	臺中市北屯區	2018-11-25T06:24:04+08:00	41689	83227	124916	5529	130445	227720	57.28%	18.31%	137	137
15	臺中市北屯區	2018-11-25T00:23:07+08:00	39746	79211	118957	5319	124276	216322	57.45%	18.37%	131	137
15	臺中市北屯區	2018-11-25T03:32:39+08:00	41689	83227	124916	5529	130445	227720	57.28%	18.31%	137	137
15	臺中市北屯區	2018-11-24T23:51:39+08:00	36710	72837	109547	4929	114476	198735	57.6%	18.47%	121	137
15	臺中市北屯區	2018-11-24T23:27:22+08:00	34865	69150	104015	4718	108733	188439	57.7%	18.5%	115	137
15	臺中市北屯區	2018-11-24T22:13:32+08:00	23049	44887	67936	3111	71047	122857	57.83%	18.76%	77	137
15	臺中市北屯區	2018-11-25T01:17:57+08:00	40395	80670	121065	5367	126432	220525	57.33%	18.32%	133	137
15	臺中市北屯區	2018-11-24T23:08:41+08:00	32465	64656	97121	4444	101565	175315	57.93%	18.52%	108	137
15	臺中市北屯區	2018-11-24T22:57:58+08:00	31010	61451	92461	4190	96651	166780	57.95%	18.59%	103	137
15	臺中市北屯區	2018-11-24T23:19:56+08:00	33437	66496	99933	4577	104510	180576	57.88%	18.52%	111	137
15	臺中市北屯區	2018-11-24T22:54:29+08:00	31010	61451	92461	4190	96651	166780	57.95%	18.59%	103	137
15	臺中市北屯區	2018-11-25T04:02:56+08:00	41689	83227	124916	5529	130445	227720	57.28%	18.31%	137	137
15	臺中市北屯區	2018-11-25T06:08:58+08:00	41689	83227	124916	5529	130445	227720	57.28%	18.31%	137	137
15	臺中市北屯區	2018-11-24T22:16:15+08:00	23396	45528	68924	3141	72065	124354	57.95%	18.81%	78	137
15	臺中市北屯區	2018-11-24T23:31:16+08:00	35542	70445	105987	4811	110798	192179	57.65%	18.49%	117	137
15	臺中市北屯區	2018-11-25T01:12:48+08:00	40395	80670	121065	5367	126432	220525	57.33%	18.32%	133	137
15	臺中市北屯區	2018-11-24T23:05:08+08:00	31650	62791	94441	4283	98724	170461	57.92%	18.57%	105	137
15	臺中市北屯區	2018-11-24T23:47:32+08:00	36412	72225	108637	4916	113553	196966	57.65%	18.49%	120	137
15	臺中市北屯區	2018-11-25T00:05:09+08:00	38503	76590	115093	5141	120234	209192	57.48%	18.41%	127	137
15	臺中市北屯區	2018-11-24T22:37:04+08:00	27711	54515	82226	3756	85982	148199	58.02%	18.7%	92	137
15	臺中市北屯區	2018-11-24T22:50:52+08:00	30400	60241	90641	4112	94753	163505	57.95%	18.59%	101	137
15	臺中市北屯區	2018-11-25T06:13:56+08:00	41689	83227	124916	5529	130445	227720	57.28%	18.31%	137	137
15	臺中市北屯區	2018-11-24T22:26:40+08:00	25896	50619	76515	3481	79996	138070	57.94%	18.76%	86	137
15	臺中市北屯區	2018-11-25T00:18:35+08:00	39746	79211	118957	5319	124276	216322	57.45%	18.37%	131	137
15	臺中市北屯區	2018-11-24T22:40:31+08:00	28421	55966	84387	3835	88222	151863	58.09%	18.71%	94	137
15	臺中市北屯區	2018-11-25T01:02:35+08:00	40124	79826	119950	5319	125269	218374	57.36%	18.37%	132	137
15	臺中市北屯區	2018-11-25T00:57:41+08:00	40124	79826	119950	5319	125269	218374	57.36%	18.37%	132	137
15	臺中市北屯區	2018-11-24T22:19:40+08:00	24362	47433	71795	3285	75080	129437	58.01%	18.82%	81	137
15	臺中市北屯區	2018-11-25T03:38:58+08:00	41689	83227	124916	5529	130445	227720	57.28%	18.31%	137	137
15	臺中市北屯區	2018-11-25T03:44:28+08:00	41689	83227	124916	5529	130445	227720	57.28%	18.31%	137	137
15	臺中市北屯區	2018-11-24T23:23:42+08:00	34209	67852	102061	4635	106696	184855	57.72%	18.51%	113	137
15	臺中市北屯區	2018-11-24T22:23:18+08:00	25896	50619	76515	3481	79996	138070	57.94%	18.76%	86	137
15	臺中市北屯區	2018-11-25T00:00:15+08:00	37215	73910	111125	5011	116136	201782	57.56%	18.44%	123	137
15	臺中市北屯區	2018-11-24T23:55:51+08:00	36937	73337	110274	4970	115244	200107	57.59%	18.46%	122	137
15	臺中市北屯區	2018-11-24T23:39:21+08:00	35861	71105	106966	4860	111826	194054	57.63%	18.48%	118	137
15	臺中市北屯區	2018-11-25T01:07:30+08:00	40124	79826	119950	5319	125269	218374	57.36%	18.37%	132	137
15	臺中市北屯區	2018-11-24T23:12:20+08:00	32465	64656	97121	4444	101565	175315	57.93%	18.52%	108	137
15	臺中市北屯區	2018-11-24T23:35:14+08:00	35542	70445	105987	4811	110798	192179	57.65%	18.49%	117	137
15	臺中市北屯區	2018-11-25T00:14:14+08:00	38861	77342	116203	5186	121389	211066	57.51%	18.41%	128	137
15	臺中市北屯區	2018-11-24T23:01:35+08:00	31390	62198	93588	4230	97818	168820	57.94%	18.59%	104	137
15	臺中市北屯區	2018-11-25T00:09:39+08:00	38861	77342	116203	5186	121389	211066	57.51%	18.41%	128	137
15	臺中市北屯區	2018-11-24T22:33:42+08:00	27477	53954	81431	3710	85141	146640	58.06%	18.74%	91	137
15	屏東縣萬巒鄉	2018-11-24T22:58:06+08:00	2813	5417	8230	920	9150	17945	50.99%	15.68%	18	18
15	屏東縣萬巒鄉	2018-11-25T06:19:08+08:00	2813	5417	8230	920	9150	17945	50.99%	15.68%	18	18
15	屏東縣萬巒鄉	2018-11-24T23:43:27+08:00	2813	5417	8230	920	9150	17945	50.99%	15.68%	18	18
15	屏東縣萬巒鄉	2018-11-24T23:39:30+08:00	2813	5417	8230	920	9150	17945	50.99%	15.68%	18	18
15	屏東縣萬巒鄉	2018-11-24T22:54:35+08:00	2813	5417	8230	920	9150	17945	50.99%	15.68%	18	18
15	屏東縣萬巒鄉	2018-11-24T22:41:48+08:00	2813	5417	8230	920	9150	17945	50.99%	15.68%	18	18
15	屏東縣萬巒鄉	2018-11-24T23:05:14+08:00	2813	5417	8230	920	9150	17945	50.99%	15.68%	18	18
15	屏東縣萬巒鄉	2018-11-25T06:29:29+08:00	2813	5417	8230	920	9150	17945	50.99%	15.68%	18	18
15	屏東縣萬巒鄉	2018-11-25T01:18:07+08:00	2813	5417	8230	920	9150	17945	50.99%	15.68%	18	18
15	屏東縣萬巒鄉	2018-11-25T06:09:07+08:00	2813	5417	8230	920	9150	17945	50.99%	15.68%	18	18
15	屏東縣萬巒鄉	2018-11-24T22:13:42+08:00	2384	4669	7053	822	7875	15069	52.26%	15.82%	16	18
15	屏東縣萬巒鄉	2018-11-24T23:51:46+08:00	2813	5417	8230	920	9150	17945	50.99%	15.68%	18	18
15	屏東縣萬巒鄉	2018-11-25T06:24:11+08:00	2813	5417	8230	920	9150	17945	50.99%	15.68%	18	18
15	屏東縣萬巒鄉	2018-11-24T23:08:49+08:00	2813	5417	8230	920	9150	17945	50.99%	15.68%	18	18
15	屏東縣萬巒鄉	2018-11-24T23:23:48+08:00	2813	5417	8230	920	9150	17945	50.99%	15.68%	18	18
15	屏東縣萬巒鄉	2018-11-25T03:44:38+08:00	2813	5417	8230	920	9150	17945	50.99%	15.68%	18	18
15	屏東縣萬巒鄉	2018-11-25T00:23:15+08:00	2813	5417	8230	920	9150	17945	50.99%	15.68%	18	18
15	屏東縣萬巒鄉	2018-11-24T22:51:00+08:00	2813	5417	8230	920	9150	17945	50.99%	15.68%	18	18
15	屏東縣萬巒鄉	2018-11-25T03:32:49+08:00	2813	5417	8230	920	9150	17945	50.99%	15.68%	18	18
15	屏東縣萬巒鄉	2018-11-24T22:37:12+08:00	2813	5417	8230	920	9150	17945	50.99%	15.68%	18	18
15	屏東縣萬巒鄉	2018-11-24T23:16:14+08:00	2813	5417	8230	920	9150	17945	50.99%	15.68%	18	18
15	屏東縣萬巒鄉	2018-11-24T23:35:20+08:00	2813	5417	8230	920	9150	17945	50.99%	15.68%	18	18
15	屏東縣萬巒鄉	2018-11-25T01:26:05+08:00	2813	5417	8230	920	9150	17945	50.99%	15.68%	18	18
15	屏東縣萬巒鄉	2018-11-25T03:39:05+08:00	2813	5417	8230	920	9150	17945	50.99%	15.68%	18	18
15	屏東縣萬巒鄉	2018-11-24T22:33:48+08:00	2813	5417	8230	920	9150	17945	50.99%	15.68%	18	18
15	屏東縣萬巒鄉	2018-11-24T22:16:23+08:00	2384	4669	7053	822	7875	15069	52.26%	15.82%	16	18
15	屏東縣萬巒鄉	2018-11-25T00:14:21+08:00	2813	5417	8230	920	9150	17945	50.99%	15.68%	18	18
15	屏東縣萬巒鄉	2018-11-25T01:12:56+08:00	2813	5417	8230	920	9150	17945	50.99%	15.68%	18	18
15	屏東縣萬巒鄉	2018-11-24T23:01:43+08:00	2813	5417	8230	920	9150	17945	50.99%	15.68%	18	18
15	屏東縣萬巒鄉	2018-11-24T22:26:47+08:00	2613	5095	7708	896	8604	16717	51.47%	15.63%	17	18
15	屏東縣萬巒鄉	2018-11-25T03:56:25+08:00	2813	5417	8230	920	9150	17945	50.99%	15.68%	18	18
15	屏東縣萬巒鄉	2018-11-24T23:47:41+08:00	2813	5417	8230	920	9150	17945	50.99%	15.68%	18	18
15	屏東縣萬巒鄉	2018-11-24T22:45:18+08:00	2813	5417	8230	920	9150	17945	50.99%	15.68%	18	18
15	屏東縣萬巒鄉	2018-11-25T00:09:47+08:00	2813	5417	8230	920	9150	17945	50.99%	15.68%	18	18
15	屏東縣萬巒鄉	2018-11-25T00:05:16+08:00	2813	5417	8230	920	9150	17945	50.99%	15.68%	18	18
15	屏東縣萬巒鄉	2018-11-24T22:30:21+08:00	2613	5095	7708	896	8604	16717	51.47%	15.63%	17	18
15	屏東縣萬巒鄉	2018-11-24T22:40:38+08:00	2813	5417	8230	920	9150	17945	50.99%	15.68%	18	18
15	屏東縣萬巒鄉	2018-11-25T04:03:03+08:00	2813	5417	8230	920	9150	17945	50.99%	15.68%	18	18
15	屏東縣萬巒鄉	2018-11-25T00:57:48+08:00	2813	5417	8230	920	9150	17945	50.99%	15.68%	18	18
15	屏東縣萬巒鄉	2018-11-24T22:19:47+08:00	2384	4669	7053	822	7875	15069	52.26%	15.82%	16	18
15	屏東縣萬巒鄉	2018-11-24T23:27:28+08:00	2813	5417	8230	920	9150	17945	50.99%	15.68%	18	18
15	屏東縣萬巒鄉	2018-11-25T01:02:42+08:00	2813	5417	8230	920	9150	17945	50.99%	15.68%	18	18
15	屏東縣萬巒鄉	2018-11-25T06:14:03+08:00	2813	5417	8230	920	9150	17945	50.99%	15.68%	18	18
15	屏東縣萬巒鄉	2018-11-24T22:23:26+08:00	2613	5095	7708	896	8604	16717	51.47%	15.63%	17	18
15	屏東縣萬巒鄉	2018-11-24T23:55:58+08:00	2813	5417	8230	920	9150	17945	50.99%	15.68%	18	18
15	屏東縣萬巒鄉	2018-11-25T00:00:22+08:00	2813	5417	8230	920	9150	17945	50.99%	15.68%	18	18
15	屏東縣萬巒鄉	2018-11-25T00:18:44+08:00	2813	5417	8230	920	9150	17945	50.99%	15.68%	18	18
15	屏東縣萬巒鄉	2018-11-24T23:20:03+08:00	2813	5417	8230	920	9150	17945	50.99%	15.68%	18	18
15	屏東縣萬巒鄉	2018-11-25T01:07:37+08:00	2813	5417	8230	920	9150	17945	50.99%	15.68%	18	18
15	屏東縣萬巒鄉	2018-11-25T03:50:02+08:00	2813	5417	8230	920	9150	17945	50.99%	15.68%	18	18
15	屏東縣萬巒鄉	2018-11-24T23:12:28+08:00	2813	5417	8230	920	9150	17945	50.99%	15.68%	18	18
15	屏東縣萬巒鄉	2018-11-24T23:31:24+08:00	2813	5417	8230	920	9150	17945	50.99%	15.68%	18	18
15	臺南市安平區	2018-11-24T23:16:08+08:00	6000	10657	16657	553	17210	33258	51.75%	18.04%	20	32
15	臺南市安平區	2018-11-25T03:56:19+08:00	9779	17393	27172	1048	28220	55379	50.96%	17.66%	32	32
15	臺南市安平區	2018-11-25T00:18:37+08:00	9090	16147	25237	945	26182	51152	51.18%	17.77%	30	32
15	臺南市安平區	2018-11-24T22:45:14+08:00	4053	7191	11244	381	11625	22140	52.51%	18.31%	14	32
15	臺南市安平區	2018-11-24T22:58:00+08:00	4973	9009	13982	496	14478	27871	51.95%	17.84%	17	32
15	臺南市安平區	2018-11-24T22:26:42+08:00	3111	5440	8551	288	8839	16783	52.67%	18.54%	11	32
15	臺南市安平區	2018-11-25T01:18:00+08:00	9779	17393	27172	1048	28220	55379	50.96%	17.66%	32	32
15	臺南市安平區	2018-11-24T22:37:06+08:00	3437	6038	9475	334	9809	18536	52.92%	18.54%	12	32
15	臺南市安平區	2018-11-25T06:09:00+08:00	9779	17393	27172	1048	28220	55379	50.96%	17.66%	32	32
15	臺南市安平區	2018-11-25T01:25:59+08:00	9779	17393	27172	1048	28220	55379	50.96%	17.66%	32	32
15	臺南市安平區	2018-11-25T00:57:43+08:00	9779	17393	27172	1048	28220	55379	50.96%	17.66%	32	32
15	臺南市安平區	2018-11-24T22:19:42+08:00	2782	4810	7592	249	7841	14940	52.48%	18.62%	10	32
15	臺南市安平區	2018-11-24T22:30:15+08:00	3437	6038	9475	334	9809	18536	52.92%	18.54%	12	32
15	臺南市安平區	2018-11-25T01:02:37+08:00	9779	17393	27172	1048	28220	55379	50.96%	17.66%	32	32
15	臺南市安平區	2018-11-24T22:40:33+08:00	3792	6667	10459	367	10826	20690	52.32%	18.33%	13	32
15	臺南市安平區	2018-11-24T23:51:41+08:00	7597	13432	21029	733	21762	42329	51.41%	17.95%	25	32
15	臺南市安平區	2018-11-25T00:00:16+08:00	7873	13947	21820	757	22577	44057	51.24%	17.87%	26	32
15	臺南市安平區	2018-11-24T22:13:35+08:00	2451	4310	6761	208	6969	13254	52.58%	18.49%	9	32
15	臺南市安平區	2018-11-24T23:55:52+08:00	7597	13432	21029	733	21762	42329	51.41%	17.95%	25	32
15	臺南市安平區	2018-11-24T23:19:58+08:00	6349	11202	17551	585	18136	34933	51.92%	18.17%	21	32
15	臺南市安平區	2018-11-24T23:27:24+08:00	6691	11862	18553	612	19165	37040	51.74%	18.06%	22	32
15	臺南市安平區	2018-11-25T03:44:30+08:00	9779	17393	27172	1048	28220	55379	50.96%	17.66%	32	32
15	臺南市安平區	2018-11-24T23:01:37+08:00	5374	9705	15079	522	15601	30003	52%	17.91%	18	32
15	臺南市安平區	2018-11-25T04:02:58+08:00	9779	17393	27172	1048	28220	55379	50.96%	17.66%	32	32
15	臺南市安平區	2018-11-25T00:14:16+08:00	8461	15044	23505	863	24368	47681	51.11%	17.75%	28	32
15	臺南市安平區	2018-11-24T23:35:16+08:00	7335	12973	20308	706	21014	40575	51.79%	18.08%	24	32
15	臺南市安平區	2018-11-24T23:12:22+08:00	5702	10173	15875	536	16411	31656	51.84%	18.01%	19	32
15	臺南市安平區	2018-11-24T23:31:18+08:00	7001	12453	19454	658	20112	38795	51.84%	18.05%	23	32
15	臺南市安平區	2018-11-24T23:39:23+08:00	7335	12973	20308	706	21014	40575	51.79%	18.08%	24	32
15	臺南市安平區	2018-11-25T01:07:32+08:00	9779	17393	27172	1048	28220	55379	50.96%	17.66%	32	32
15	臺南市安平區	2018-11-24T23:47:35+08:00	7335	12973	20308	706	21014	40575	51.79%	18.08%	24	32
15	臺南市安平區	2018-11-24T22:41:42+08:00	3792	6667	10459	367	10826	20690	52.32%	18.33%	13	32
15	臺南市安平區	2018-11-25T06:13:58+08:00	9779	17393	27172	1048	28220	55379	50.96%	17.66%	32	32
15	臺南市安平區	2018-11-24T22:54:31+08:00	4802	8578	13380	473	13853	26546	52.18%	18.09%	16	32
15	臺南市安平區	2018-11-24T22:50:55+08:00	4053	7191	11244	381	11625	22140	52.51%	18.31%	14	32
15	臺南市安平區	2018-11-25T00:09:41+08:00	8461	15044	23505	863	24368	47681	51.11%	17.75%	28	32
15	臺南市安平區	2018-11-25T01:12:50+08:00	9779	17393	27172	1048	28220	55379	50.96%	17.66%	32	32
15	臺南市安平區	2018-11-24T23:43:22+08:00	7335	12973	20308	706	21014	40575	51.79%	18.08%	24	32
15	臺南市安平區	2018-11-25T06:29:23+08:00	9779	17393	27172	1048	28220	55379	50.96%	17.66%	32	32
15	臺南市安平區	2018-11-25T03:49:57+08:00	9779	17393	27172	1048	28220	55379	50.96%	17.66%	32	32
15	臺南市安平區	2018-11-24T23:05:10+08:00	5374	9705	15079	522	15601	30003	52%	17.91%	18	32
15	臺南市安平區	2018-11-25T06:19:03+08:00	9779	17393	27172	1048	28220	55379	50.96%	17.66%	32	32
15	臺南市安平區	2018-11-25T00:05:11+08:00	7873	13947	21820	757	22577	44057	51.24%	17.87%	26	32
15	臺南市安平區	2018-11-25T06:24:06+08:00	9779	17393	27172	1048	28220	55379	50.96%	17.66%	32	32
15	臺南市安平區	2018-11-24T23:08:43+08:00	5702	10173	15875	536	16411	31656	51.84%	18.01%	19	32
15	臺南市安平區	2018-11-24T22:23:20+08:00	3111	5440	8551	288	8839	16783	52.67%	18.54%	11	32
15	臺南市安平區	2018-11-25T00:23:10+08:00	9090	16147	25237	945	26182	51152	51.18%	17.77%	30	32
15	臺南市安平區	2018-11-25T03:32:43+08:00	9779	17393	27172	1048	28220	55379	50.96%	17.66%	32	32
15	臺南市安平區	2018-11-24T23:23:44+08:00	6349	11202	17551	585	18136	34933	51.92%	18.17%	21	32
15	臺南市安平區	2018-11-24T22:33:44+08:00	3437	6038	9475	334	9809	18536	52.92%	18.54%	12	32
15	臺南市安平區	2018-11-24T22:16:17+08:00	2451	4310	6761	208	6969	13254	52.58%	18.49%	9	32
15	臺南市安平區	2018-11-25T03:39:00+08:00	9779	17393	27172	1048	28220	55379	50.96%	17.66%	32	32
15	屏東縣潮州鎮	2018-11-24T22:58:06+08:00	5955	12514	18469	1280	19749	37686	52.4%	15.8%	34	40
15	屏東縣潮州鎮	2018-11-25T06:19:08+08:00	7197	15460	22657	1559	24216	46444	52.14%	15.5%	40	40
15	屏東縣潮州鎮	2018-11-25T06:29:28+08:00	7197	15460	22657	1559	24216	46444	52.14%	15.5%	40	40
15	屏東縣潮州鎮	2018-11-24T23:43:27+08:00	6939	14951	21890	1514	23404	44813	52.23%	15.48%	39	40
15	屏東縣潮州鎮	2018-11-24T22:54:35+08:00	5541	11607	17148	1206	18354	35033	52.39%	15.82%	32	40
15	屏東縣潮州鎮	2018-11-24T22:41:48+08:00	4725	9795	14520	1007	15527	29522	52.59%	16.01%	28	40
15	屏東縣潮州鎮	2018-11-24T23:05:14+08:00	5955	12514	18469	1280	19749	37686	52.4%	15.8%	34	40
15	屏東縣潮州鎮	2018-11-25T01:18:07+08:00	7197	15460	22657	1559	24216	46444	52.14%	15.5%	40	40
15	屏東縣潮州鎮	2018-11-25T00:05:15+08:00	7197	15460	22657	1559	24216	46444	52.14%	15.5%	40	40
15	屏東縣潮州鎮	2018-11-24T22:13:42+08:00	3001	6276	9277	702	9979	18735	53.26%	16.02%	20	40
15	屏東縣潮州鎮	2018-11-24T23:51:46+08:00	6939	14951	21890	1514	23404	44813	52.23%	15.48%	39	40
15	屏東縣潮州鎮	2018-11-25T06:09:06+08:00	7197	15460	22657	1559	24216	46444	52.14%	15.5%	40	40
15	屏東縣潮州鎮	2018-11-25T01:02:41+08:00	7197	15460	22657	1559	24216	46444	52.14%	15.5%	40	40
15	屏東縣潮州鎮	2018-11-25T00:23:14+08:00	7197	15460	22657	1559	24216	46444	52.14%	15.5%	40	40
15	屏東縣潮州鎮	2018-11-25T06:24:11+08:00	7197	15460	22657	1559	24216	46444	52.14%	15.5%	40	40
15	屏東縣潮州鎮	2018-11-24T23:23:48+08:00	6681	14379	21060	1475	22535	43069	52.32%	15.51%	38	40
15	屏東縣潮州鎮	2018-11-25T00:00:21+08:00	6939	14951	21890	1514	23404	44813	52.23%	15.48%	39	40
15	屏東縣潮州鎮	2018-11-24T22:23:25+08:00	3437	7209	10646	789	11435	21470	53.26%	16.01%	22	40
15	屏東縣潮州鎮	2018-11-24T22:51:00+08:00	5541	11607	17148	1206	18354	35033	52.39%	15.82%	32	40
15	屏東縣潮州鎮	2018-11-25T03:32:49+08:00	7197	15460	22657	1559	24216	46444	52.14%	15.5%	40	40
15	屏東縣潮州鎮	2018-11-25T03:44:37+08:00	7197	15460	22657	1559	24216	46444	52.14%	15.5%	40	40
15	屏東縣潮州鎮	2018-11-24T23:08:48+08:00	5955	12514	18469	1280	19749	37686	52.4%	15.8%	34	40
15	屏東縣潮州鎮	2018-11-24T22:16:22+08:00	3197	6721	9918	748	10666	20031	53.25%	15.96%	21	40
15	屏東縣潮州鎮	2018-11-25T01:26:04+08:00	7197	15460	22657	1559	24216	46444	52.14%	15.5%	40	40
15	屏東縣潮州鎮	2018-11-24T23:16:13+08:00	6309	13498	19807	1348	21155	40515	52.22%	15.57%	36	40
15	屏東縣潮州鎮	2018-11-24T23:35:20+08:00	6939	14951	21890	1514	23404	44813	52.23%	15.48%	39	40
15	屏東縣潮州鎮	2018-11-25T00:14:20+08:00	7197	15460	22657	1559	24216	46444	52.14%	15.5%	40	40
15	屏東縣潮州鎮	2018-11-25T03:39:05+08:00	7197	15460	22657	1559	24216	46444	52.14%	15.5%	40	40
15	屏東縣潮州鎮	2018-11-24T22:33:48+08:00	4097	8516	12613	914	13527	25547	52.95%	16.04%	25	40
15	屏東縣潮州鎮	2018-11-25T03:50:01+08:00	7197	15460	22657	1559	24216	46444	52.14%	15.5%	40	40
15	屏東縣潮州鎮	2018-11-25T01:12:56+08:00	7197	15460	22657	1559	24216	46444	52.14%	15.5%	40	40
15	屏東縣潮州鎮	2018-11-24T23:47:40+08:00	6939	14951	21890	1514	23404	44813	52.23%	15.48%	39	40
15	屏東縣潮州鎮	2018-11-24T23:01:43+08:00	5955	12514	18469	1280	19749	37686	52.4%	15.8%	34	40
15	屏東縣潮州鎮	2018-11-25T00:09:46+08:00	7197	15460	22657	1559	24216	46444	52.14%	15.5%	40	40
15	屏東縣潮州鎮	2018-11-25T03:56:25+08:00	7197	15460	22657	1559	24216	46444	52.14%	15.5%	40	40
15	屏東縣潮州鎮	2018-11-24T22:45:18+08:00	5099	10628	15727	1105	16832	31931	52.71%	15.97%	30	40
15	屏東縣潮州鎮	2018-11-24T22:26:46+08:00	3437	7209	10646	789	11435	21470	53.26%	16.01%	22	40
15	屏東縣潮州鎮	2018-11-24T22:30:21+08:00	3696	7766	11462	810	12272	23104	53.12%	16%	23	40
15	屏東縣潮州鎮	2018-11-24T22:40:38+08:00	4725	9795	14520	1007	15527	29522	52.59%	16.01%	28	40
15	屏東縣潮州鎮	2018-11-25T04:03:03+08:00	7197	15460	22657	1559	24216	46444	52.14%	15.5%	40	40
15	屏東縣潮州鎮	2018-11-25T00:57:48+08:00	7197	15460	22657	1559	24216	46444	52.14%	15.5%	40	40
15	屏東縣潮州鎮	2018-11-24T22:19:47+08:00	3197	6721	9918	748	10666	20031	53.25%	15.96%	21	40
15	屏東縣潮州鎮	2018-11-24T23:27:28+08:00	6681	14379	21060	1475	22535	43069	52.32%	15.51%	38	40
15	屏東縣潮州鎮	2018-11-25T06:14:03+08:00	7197	15460	22657	1559	24216	46444	52.14%	15.5%	40	40
15	屏東縣潮州鎮	2018-11-24T23:55:58+08:00	6939	14951	21890	1514	23404	44813	52.23%	15.48%	39	40
15	屏東縣潮州鎮	2018-11-25T00:18:44+08:00	7197	15460	22657	1559	24216	46444	52.14%	15.5%	40	40
15	屏東縣潮州鎮	2018-11-24T23:20:03+08:00	6549	14075	20624	1421	22045	42173	52.27%	15.53%	37	40
15	屏東縣潮州鎮	2018-11-25T01:07:37+08:00	7197	15460	22657	1559	24216	46444	52.14%	15.5%	40	40
15	屏東縣潮州鎮	2018-11-24T22:37:11+08:00	4510	9437	13947	992	14939	28267	52.85%	15.96%	27	40
15	屏東縣潮州鎮	2018-11-24T23:39:29+08:00	6939	14951	21890	1514	23404	44813	52.23%	15.48%	39	40
15	屏東縣潮州鎮	2018-11-24T23:12:28+08:00	5955	12514	18469	1280	19749	37686	52.4%	15.8%	34	40
15	屏東縣潮州鎮	2018-11-24T23:31:24+08:00	6939	14951	21890	1514	23404	44813	52.23%	15.48%	39	40
15	臺南市左鎮區	2018-11-24T23:16:08+08:00	501	1245	1746	232	1978	4418	44.77%	11.34%	10	10
15	臺南市左鎮區	2018-11-25T03:56:19+08:00	501	1245	1746	232	1978	4418	44.77%	11.34%	10	10
15	臺南市左鎮區	2018-11-25T00:18:37+08:00	501	1245	1746	232	1978	4418	44.77%	11.34%	10	10
15	臺南市左鎮區	2018-11-24T22:45:13+08:00	501	1245	1746	232	1978	4418	44.77%	11.34%	10	10
15	臺南市左鎮區	2018-11-24T22:58:00+08:00	501	1245	1746	232	1978	4418	44.77%	11.34%	10	10
15	臺南市左鎮區	2018-11-24T22:26:42+08:00	501	1245	1746	232	1978	4418	44.77%	11.34%	10	10
15	臺南市左鎮區	2018-11-24T22:37:06+08:00	501	1245	1746	232	1978	4418	44.77%	11.34%	10	10
15	臺南市左鎮區	2018-11-25T06:09:00+08:00	501	1245	1746	232	1978	4418	44.77%	11.34%	10	10
15	臺南市左鎮區	2018-11-24T22:40:32+08:00	501	1245	1746	232	1978	4418	44.77%	11.34%	10	10
15	臺南市左鎮區	2018-11-25T01:02:36+08:00	501	1245	1746	232	1978	4418	44.77%	11.34%	10	10
15	臺南市左鎮區	2018-11-25T00:57:43+08:00	501	1245	1746	232	1978	4418	44.77%	11.34%	10	10
15	臺南市左鎮區	2018-11-24T22:19:42+08:00	501	1245	1746	232	1978	4418	44.77%	11.34%	10	10
15	臺南市左鎮區	2018-11-25T01:25:58+08:00	501	1245	1746	232	1978	4418	44.77%	11.34%	10	10
15	臺南市左鎮區	2018-11-24T22:30:15+08:00	501	1245	1746	232	1978	4418	44.77%	11.34%	10	10
15	臺南市左鎮區	2018-11-24T23:51:41+08:00	501	1245	1746	232	1978	4418	44.77%	11.34%	10	10
15	臺南市左鎮區	2018-11-25T00:23:09+08:00	501	1245	1746	232	1978	4418	44.77%	11.34%	10	10
15	臺南市左鎮區	2018-11-25T06:24:05+08:00	501	1245	1746	232	1978	4418	44.77%	11.34%	10	10
15	臺南市左鎮區	2018-11-25T00:00:16+08:00	501	1245	1746	232	1978	4418	44.77%	11.34%	10	10
15	臺南市左鎮區	2018-11-25T01:17:59+08:00	501	1245	1746	232	1978	4418	44.77%	11.34%	10	10
15	臺南市左鎮區	2018-11-24T23:19:57+08:00	501	1245	1746	232	1978	4418	44.77%	11.34%	10	10
15	臺南市左鎮區	2018-11-24T23:55:52+08:00	501	1245	1746	232	1978	4418	44.77%	11.34%	10	10
15	臺南市左鎮區	2018-11-24T22:13:34+08:00	501	1245	1746	232	1978	4418	44.77%	11.34%	10	10
15	臺南市左鎮區	2018-11-24T23:27:23+08:00	501	1245	1746	232	1978	4418	44.77%	11.34%	10	10
15	臺南市左鎮區	2018-11-25T03:44:30+08:00	501	1245	1746	232	1978	4418	44.77%	11.34%	10	10
15	臺南市左鎮區	2018-11-25T04:02:58+08:00	501	1245	1746	232	1978	4418	44.77%	11.34%	10	10
15	臺南市左鎮區	2018-11-24T23:35:16+08:00	501	1245	1746	232	1978	4418	44.77%	11.34%	10	10
15	臺南市左鎮區	2018-11-24T23:47:34+08:00	501	1245	1746	232	1978	4418	44.77%	11.34%	10	10
15	臺南市左鎮區	2018-11-24T23:05:09+08:00	501	1245	1746	232	1978	4418	44.77%	11.34%	10	10
15	臺南市左鎮區	2018-11-24T23:01:36+08:00	501	1245	1746	232	1978	4418	44.77%	11.34%	10	10
15	臺南市左鎮區	2018-11-24T23:31:18+08:00	501	1245	1746	232	1978	4418	44.77%	11.34%	10	10
15	臺南市左鎮區	2018-11-24T23:39:23+08:00	501	1245	1746	232	1978	4418	44.77%	11.34%	10	10
15	臺南市左鎮區	2018-11-25T01:07:32+08:00	501	1245	1746	232	1978	4418	44.77%	11.34%	10	10
15	臺南市左鎮區	2018-11-24T22:41:42+08:00	501	1245	1746	232	1978	4418	44.77%	11.34%	10	10
15	臺南市左鎮區	2018-11-25T06:13:58+08:00	501	1245	1746	232	1978	4418	44.77%	11.34%	10	10
15	臺南市左鎮區	2018-11-25T06:19:02+08:00	501	1245	1746	232	1978	4418	44.77%	11.34%	10	10
15	臺南市左鎮區	2018-11-25T03:49:56+08:00	501	1245	1746	232	1978	4418	44.77%	11.34%	10	10
15	臺南市左鎮區	2018-11-24T22:54:30+08:00	501	1245	1746	232	1978	4418	44.77%	11.34%	10	10
15	臺南市左鎮區	2018-11-24T22:50:54+08:00	501	1245	1746	232	1978	4418	44.77%	11.34%	10	10
15	臺南市左鎮區	2018-11-25T01:12:50+08:00	501	1245	1746	232	1978	4418	44.77%	11.34%	10	10
15	臺南市左鎮區	2018-11-24T23:43:22+08:00	501	1245	1746	232	1978	4418	44.77%	11.34%	10	10
15	臺南市左鎮區	2018-11-25T00:09:40+08:00	501	1245	1746	232	1978	4418	44.77%	11.34%	10	10
15	臺南市左鎮區	2018-11-25T06:29:23+08:00	501	1245	1746	232	1978	4418	44.77%	11.34%	10	10
15	臺南市左鎮區	2018-11-25T00:05:11+08:00	501	1245	1746	232	1978	4418	44.77%	11.34%	10	10
15	臺南市左鎮區	2018-11-25T03:32:42+08:00	501	1245	1746	232	1978	4418	44.77%	11.34%	10	10
15	臺南市左鎮區	2018-11-24T23:08:42+08:00	501	1245	1746	232	1978	4418	44.77%	11.34%	10	10
15	臺南市左鎮區	2018-11-24T22:23:19+08:00	501	1245	1746	232	1978	4418	44.77%	11.34%	10	10
15	臺南市左鎮區	2018-11-24T23:23:43+08:00	501	1245	1746	232	1978	4418	44.77%	11.34%	10	10
15	臺南市左鎮區	2018-11-25T00:14:15+08:00	501	1245	1746	232	1978	4418	44.77%	11.34%	10	10
15	臺南市左鎮區	2018-11-24T22:33:43+08:00	501	1245	1746	232	1978	4418	44.77%	11.34%	10	10
15	臺南市左鎮區	2018-11-25T03:39:00+08:00	501	1245	1746	232	1978	4418	44.77%	11.34%	10	10
15	臺南市左鎮區	2018-11-24T23:12:21+08:00	501	1245	1746	232	1978	4418	44.77%	11.34%	10	10
15	臺南市左鎮區	2018-11-24T22:16:16+08:00	501	1245	1746	232	1978	4418	44.77%	11.34%	10	10
15	嘉義縣東石鄉	2018-11-25T01:18:06+08:00	2179	5707	7886	985	8871	21915	40.48%	9.94%	27	27
15	嘉義縣東石鄉	2018-11-25T06:29:28+08:00	2179	5707	7886	985	8871	21915	40.48%	9.94%	27	27
15	嘉義縣東石鄉	2018-11-24T23:43:27+08:00	2179	5707	7886	985	8871	21915	40.48%	9.94%	27	27
15	嘉義縣東石鄉	2018-11-25T01:12:55+08:00	2179	5707	7886	985	8871	21915	40.48%	9.94%	27	27
15	嘉義縣東石鄉	2018-11-24T22:54:35+08:00	2179	5707	7886	985	8871	21915	40.48%	9.94%	27	27
15	嘉義縣東石鄉	2018-11-24T23:05:14+08:00	2179	5707	7886	985	8871	21915	40.48%	9.94%	27	27
15	嘉義縣東石鄉	2018-11-25T06:19:07+08:00	2179	5707	7886	985	8871	21915	40.48%	9.94%	27	27
15	嘉義縣東石鄉	2018-11-25T00:05:15+08:00	2179	5707	7886	985	8871	21915	40.48%	9.94%	27	27
15	嘉義縣東石鄉	2018-11-24T22:41:47+08:00	2179	5707	7886	985	8871	21915	40.48%	9.94%	27	27
15	嘉義縣東石鄉	2018-11-24T23:51:46+08:00	2179	5707	7886	985	8871	21915	40.48%	9.94%	27	27
15	嘉義縣東石鄉	2018-11-25T06:09:06+08:00	2179	5707	7886	985	8871	21915	40.48%	9.94%	27	27
15	嘉義縣東石鄉	2018-11-25T01:02:41+08:00	2179	5707	7886	985	8871	21915	40.48%	9.94%	27	27
15	嘉義縣東石鄉	2018-11-25T00:23:14+08:00	2179	5707	7886	985	8871	21915	40.48%	9.94%	27	27
15	嘉義縣東石鄉	2018-11-25T03:32:48+08:00	2179	5707	7886	985	8871	21915	40.48%	9.94%	27	27
15	嘉義縣東石鄉	2018-11-24T23:23:48+08:00	2179	5707	7886	985	8871	21915	40.48%	9.94%	27	27
15	嘉義縣東石鄉	2018-11-25T06:24:10+08:00	2179	5707	7886	985	8871	21915	40.48%	9.94%	27	27
15	嘉義縣東石鄉	2018-11-25T00:00:21+08:00	2179	5707	7886	985	8871	21915	40.48%	9.94%	27	27
15	嘉義縣東石鄉	2018-11-24T22:23:25+08:00	2179	5707	7886	985	8871	21915	40.48%	9.94%	27	27
15	嘉義縣東石鄉	2018-11-24T22:51:00+08:00	2179	5707	7886	985	8871	21915	40.48%	9.94%	27	27
15	嘉義縣東石鄉	2018-11-25T03:44:37+08:00	2179	5707	7886	985	8871	21915	40.48%	9.94%	27	27
15	嘉義縣東石鄉	2018-11-24T23:08:48+08:00	2179	5707	7886	985	8871	21915	40.48%	9.94%	27	27
15	嘉義縣東石鄉	2018-11-24T22:16:22+08:00	2061	5459	7520	935	8455	21014	40.24%	9.81%	26	27
15	嘉義縣東石鄉	2018-11-25T01:26:04+08:00	2179	5707	7886	985	8871	21915	40.48%	9.94%	27	27
15	嘉義縣東石鄉	2018-11-24T23:16:13+08:00	2179	5707	7886	985	8871	21915	40.48%	9.94%	27	27
15	嘉義縣東石鄉	2018-11-24T23:35:20+08:00	2179	5707	7886	985	8871	21915	40.48%	9.94%	27	27
15	嘉義縣東石鄉	2018-11-25T00:14:20+08:00	2179	5707	7886	985	8871	21915	40.48%	9.94%	27	27
15	嘉義縣東石鄉	2018-11-25T03:39:05+08:00	2179	5707	7886	985	8871	21915	40.48%	9.94%	27	27
15	嘉義縣東石鄉	2018-11-24T22:33:48+08:00	2179	5707	7886	985	8871	21915	40.48%	9.94%	27	27
15	嘉義縣東石鄉	2018-11-25T03:50:01+08:00	2179	5707	7886	985	8871	21915	40.48%	9.94%	27	27
15	嘉義縣東石鄉	2018-11-24T23:47:40+08:00	2179	5707	7886	985	8871	21915	40.48%	9.94%	27	27
15	嘉義縣東石鄉	2018-11-24T22:58:05+08:00	2179	5707	7886	985	8871	21915	40.48%	9.94%	27	27
15	嘉義縣東石鄉	2018-11-25T00:09:46+08:00	2179	5707	7886	985	8871	21915	40.48%	9.94%	27	27
15	嘉義縣東石鄉	2018-11-24T22:45:18+08:00	2179	5707	7886	985	8871	21915	40.48%	9.94%	27	27
15	嘉義縣東石鄉	2018-11-25T03:56:24+08:00	2179	5707	7886	985	8871	21915	40.48%	9.94%	27	27
15	嘉義縣東石鄉	2018-11-24T22:26:46+08:00	2179	5707	7886	985	8871	21915	40.48%	9.94%	27	27
15	嘉義縣東石鄉	2018-11-24T23:01:42+08:00	2179	5707	7886	985	8871	21915	40.48%	9.94%	27	27
15	嘉義縣東石鄉	2018-11-24T22:13:41+08:00	2061	5459	7520	935	8455	21014	40.24%	9.81%	26	27
15	嘉義縣東石鄉	2018-11-25T04:03:02+08:00	2179	5707	7886	985	8871	21915	40.48%	9.94%	27	27
15	嘉義縣東石鄉	2018-11-25T00:57:48+08:00	2179	5707	7886	985	8871	21915	40.48%	9.94%	27	27
15	嘉義縣東石鄉	2018-11-24T22:19:47+08:00	2179	5707	7886	985	8871	21915	40.48%	9.94%	27	27
15	嘉義縣東石鄉	2018-11-24T22:40:37+08:00	2179	5707	7886	985	8871	21915	40.48%	9.94%	27	27
15	嘉義縣東石鄉	2018-11-24T22:30:20+08:00	2179	5707	7886	985	8871	21915	40.48%	9.94%	27	27
15	嘉義縣東石鄉	2018-11-24T23:27:28+08:00	2179	5707	7886	985	8871	21915	40.48%	9.94%	27	27
15	嘉義縣東石鄉	2018-11-24T23:55:57+08:00	2179	5707	7886	985	8871	21915	40.48%	9.94%	27	27
15	嘉義縣東石鄉	2018-11-25T06:14:02+08:00	2179	5707	7886	985	8871	21915	40.48%	9.94%	27	27
15	嘉義縣東石鄉	2018-11-25T00:18:43+08:00	2179	5707	7886	985	8871	21915	40.48%	9.94%	27	27
15	嘉義縣東石鄉	2018-11-25T01:07:37+08:00	2179	5707	7886	985	8871	21915	40.48%	9.94%	27	27
15	嘉義縣東石鄉	2018-11-24T23:12:27+08:00	2179	5707	7886	985	8871	21915	40.48%	9.94%	27	27
15	嘉義縣東石鄉	2018-11-24T22:37:11+08:00	2179	5707	7886	985	8871	21915	40.48%	9.94%	27	27
15	嘉義縣東石鄉	2018-11-24T23:39:29+08:00	2179	5707	7886	985	8871	21915	40.48%	9.94%	27	27
15	嘉義縣東石鄉	2018-11-24T23:31:23+08:00	2179	5707	7886	985	8871	21915	40.48%	9.94%	27	27
15	嘉義縣東石鄉	2018-11-24T23:20:02+08:00	2179	5707	7886	985	8871	21915	40.48%	9.94%	27	27
15	宜蘭縣礁溪鄉	2018-11-25T03:56:26+08:00	5360	10197	15557	1238	16795	31084	54.03%	17.24%	32	32
15	宜蘭縣礁溪鄉	2018-11-24T23:05:15+08:00	5197	9873	15070	1209	16279	29952	54.35%	17.35%	31	32
15	宜蘭縣礁溪鄉	2018-11-25T01:18:08+08:00	5360	10197	15557	1238	16795	31084	54.03%	17.24%	32	32
15	宜蘭縣礁溪鄉	2018-11-24T23:43:29+08:00	5360	10197	15557	1238	16795	31084	54.03%	17.24%	32	32
15	宜蘭縣礁溪鄉	2018-11-25T06:19:09+08:00	5360	10197	15557	1238	16795	31084	54.03%	17.24%	32	32
15	宜蘭縣礁溪鄉	2018-11-24T22:58:07+08:00	4896	9279	14175	1147	15322	28327	54.09%	17.28%	29	32
15	宜蘭縣礁溪鄉	2018-11-24T22:41:49+08:00	4677	8799	13476	1074	14550	27013	53.86%	17.31%	28	32
15	宜蘭縣礁溪鄉	2018-11-24T23:39:31+08:00	5360	10197	15557	1238	16795	31084	54.03%	17.24%	32	32
15	宜蘭縣礁溪鄉	2018-11-24T23:47:42+08:00	5360	10197	15557	1238	16795	31084	54.03%	17.24%	32	32
15	宜蘭縣礁溪鄉	2018-11-24T22:30:22+08:00	4501	8472	12973	1034	14007	25891	54.1%	17.38%	27	32
15	宜蘭縣礁溪鄉	2018-11-24T23:51:47+08:00	5360	10197	15557	1238	16795	31084	54.03%	17.24%	32	32
15	宜蘭縣礁溪鄉	2018-11-25T06:09:08+08:00	5360	10197	15557	1238	16795	31084	54.03%	17.24%	32	32
15	宜蘭縣礁溪鄉	2018-11-24T22:13:43+08:00	4077	7627	11704	973	12677	23572	53.78%	17.3%	25	32
15	宜蘭縣礁溪鄉	2018-11-25T03:44:39+08:00	5360	10197	15557	1238	16795	31084	54.03%	17.24%	32	32
15	宜蘭縣礁溪鄉	2018-11-24T23:23:49+08:00	5360	10197	15557	1238	16795	31084	54.03%	17.24%	32	32
15	宜蘭縣礁溪鄉	2018-11-24T22:33:49+08:00	4677	8799	13476	1074	14550	27013	53.86%	17.31%	28	32
15	宜蘭縣礁溪鄉	2018-11-24T23:16:14+08:00	5360	10197	15557	1238	16795	31084	54.03%	17.24%	32	32
15	宜蘭縣礁溪鄉	2018-11-24T22:37:13+08:00	4677	8799	13476	1074	14550	27013	53.86%	17.31%	28	32
15	宜蘭縣礁溪鄉	2018-11-24T22:16:24+08:00	4269	8102	12371	1014	13385	24766	54.05%	17.24%	26	32
15	宜蘭縣礁溪鄉	2018-11-24T23:35:21+08:00	5360	10197	15557	1238	16795	31084	54.03%	17.24%	32	32
15	宜蘭縣礁溪鄉	2018-11-24T22:45:19+08:00	4677	8799	13476	1074	14550	27013	53.86%	17.31%	28	32
15	宜蘭縣礁溪鄉	2018-11-24T22:54:36+08:00	4896	9279	14175	1147	15322	28327	54.09%	17.28%	29	32
15	宜蘭縣礁溪鄉	2018-11-25T00:09:48+08:00	5360	10197	15557	1238	16795	31084	54.03%	17.24%	32	32
15	宜蘭縣礁溪鄉	2018-11-24T23:01:44+08:00	5127	9713	14840	1203	16043	29534	54.32%	17.36%	30	32
15	宜蘭縣礁溪鄉	2018-11-24T22:26:47+08:00	4501	8472	12973	1034	14007	25891	54.1%	17.38%	27	32
15	宜蘭縣礁溪鄉	2018-11-25T00:05:17+08:00	5360	10197	15557	1238	16795	31084	54.03%	17.24%	32	32
15	宜蘭縣礁溪鄉	2018-11-25T01:12:57+08:00	5360	10197	15557	1238	16795	31084	54.03%	17.24%	32	32
15	宜蘭縣礁溪鄉	2018-11-25T00:57:49+08:00	5360	10197	15557	1238	16795	31084	54.03%	17.24%	32	32
15	宜蘭縣礁溪鄉	2018-11-24T22:19:48+08:00	4269	8102	12371	1014	13385	24766	54.05%	17.24%	26	32
15	宜蘭縣礁溪鄉	2018-11-25T04:03:04+08:00	5360	10197	15557	1238	16795	31084	54.03%	17.24%	32	32
15	宜蘭縣礁溪鄉	2018-11-24T22:40:39+08:00	4677	8799	13476	1074	14550	27013	53.86%	17.31%	28	32
15	宜蘭縣礁溪鄉	2018-11-25T03:32:51+08:00	5360	10197	15557	1238	16795	31084	54.03%	17.24%	32	32
15	宜蘭縣礁溪鄉	2018-11-24T23:08:50+08:00	5197	9873	15070	1209	16279	29952	54.35%	17.35%	31	32
15	宜蘭縣礁溪鄉	2018-11-24T22:23:27+08:00	4269	8102	12371	1014	13385	24766	54.05%	17.24%	26	32
15	宜蘭縣礁溪鄉	2018-11-24T22:51:02+08:00	4896	9279	14175	1147	15322	28327	54.09%	17.28%	29	32
15	宜蘭縣礁溪鄉	2018-11-25T06:14:04+08:00	5360	10197	15557	1238	16795	31084	54.03%	17.24%	32	32
15	宜蘭縣礁溪鄉	2018-11-24T23:55:59+08:00	5360	10197	15557	1238	16795	31084	54.03%	17.24%	32	32
15	宜蘭縣礁溪鄉	2018-11-25T06:24:12+08:00	5360	10197	15557	1238	16795	31084	54.03%	17.24%	32	32
15	宜蘭縣礁溪鄉	2018-11-24T23:27:29+08:00	5360	10197	15557	1238	16795	31084	54.03%	17.24%	32	32
15	宜蘭縣礁溪鄉	2018-11-25T00:00:22+08:00	5360	10197	15557	1238	16795	31084	54.03%	17.24%	32	32
15	宜蘭縣礁溪鄉	2018-11-25T00:23:16+08:00	5360	10197	15557	1238	16795	31084	54.03%	17.24%	32	32
15	宜蘭縣礁溪鄉	2018-11-25T01:02:43+08:00	5360	10197	15557	1238	16795	31084	54.03%	17.24%	32	32
15	宜蘭縣礁溪鄉	2018-11-25T06:29:30+08:00	5360	10197	15557	1238	16795	31084	54.03%	17.24%	32	32
15	宜蘭縣礁溪鄉	2018-11-24T23:12:29+08:00	5197	9873	15070	1209	16279	29952	54.35%	17.35%	31	32
15	宜蘭縣礁溪鄉	2018-11-24T23:31:25+08:00	5360	10197	15557	1238	16795	31084	54.03%	17.24%	32	32
15	宜蘭縣礁溪鄉	2018-11-24T23:20:04+08:00	5360	10197	15557	1238	16795	31084	54.03%	17.24%	32	32
15	宜蘭縣礁溪鄉	2018-11-25T00:14:22+08:00	5360	10197	15557	1238	16795	31084	54.03%	17.24%	32	32
15	宜蘭縣礁溪鄉	2018-11-25T00:18:45+08:00	5360	10197	15557	1238	16795	31084	54.03%	17.24%	32	32
15	宜蘭縣礁溪鄉	2018-11-25T01:07:38+08:00	5360	10197	15557	1238	16795	31084	54.03%	17.24%	32	32
15	宜蘭縣礁溪鄉	2018-11-25T03:39:06+08:00	5360	10197	15557	1238	16795	31084	54.03%	17.24%	32	32
15	宜蘭縣礁溪鄉	2018-11-25T01:26:06+08:00	5360	10197	15557	1238	16795	31084	54.03%	17.24%	32	32
15	宜蘭縣礁溪鄉	2018-11-25T03:50:02+08:00	5360	10197	15557	1238	16795	31084	54.03%	17.24%	32	32
15	臺南市六甲區	2018-11-24T22:41:41+08:00	3197	5234	8431	830	9261	19144	48.38%	16.7%	19	19
15	臺南市六甲區	2018-11-24T22:45:13+08:00	3197	5234	8431	830	9261	19144	48.38%	16.7%	19	19
15	臺南市六甲區	2018-11-24T23:16:07+08:00	3197	5234	8431	830	9261	19144	48.38%	16.7%	19	19
15	臺南市六甲區	2018-11-25T03:56:18+08:00	3197	5234	8431	830	9261	19144	48.38%	16.7%	19	19
15	臺南市六甲區	2018-11-24T23:43:21+08:00	3197	5234	8431	830	9261	19144	48.38%	16.7%	19	19
15	臺南市六甲區	2018-11-25T00:18:36+08:00	3197	5234	8431	830	9261	19144	48.38%	16.7%	19	19
15	臺南市六甲區	2018-11-24T23:51:40+08:00	3197	5234	8431	830	9261	19144	48.38%	16.7%	19	19
15	臺南市六甲區	2018-11-24T22:40:32+08:00	3197	5234	8431	830	9261	19144	48.38%	16.7%	19	19
15	臺南市六甲區	2018-11-25T01:02:36+08:00	3197	5234	8431	830	9261	19144	48.38%	16.7%	19	19
15	臺南市六甲區	2018-11-25T01:25:58+08:00	3197	5234	8431	830	9261	19144	48.38%	16.7%	19	19
15	臺南市六甲區	2018-11-24T22:30:15+08:00	3197	5234	8431	830	9261	19144	48.38%	16.7%	19	19
15	臺南市六甲區	2018-11-25T00:23:09+08:00	3197	5234	8431	830	9261	19144	48.38%	16.7%	19	19
15	臺南市六甲區	2018-11-25T00:57:42+08:00	3197	5234	8431	830	9261	19144	48.38%	16.7%	19	19
15	臺南市六甲區	2018-11-25T06:24:05+08:00	3197	5234	8431	830	9261	19144	48.38%	16.7%	19	19
15	臺南市六甲區	2018-11-25T00:00:16+08:00	3197	5234	8431	830	9261	19144	48.38%	16.7%	19	19
15	臺南市六甲區	2018-11-25T01:17:59+08:00	3197	5234	8431	830	9261	19144	48.38%	16.7%	19	19
15	臺南市六甲區	2018-11-24T22:57:59+08:00	3197	5234	8431	830	9261	19144	48.38%	16.7%	19	19
15	臺南市六甲區	2018-11-24T23:19:57+08:00	3197	5234	8431	830	9261	19144	48.38%	16.7%	19	19
15	臺南市六甲區	2018-11-25T03:32:41+08:00	3197	5234	8431	830	9261	19144	48.38%	16.7%	19	19
15	臺南市六甲區	2018-11-24T23:55:52+08:00	3197	5234	8431	830	9261	19144	48.38%	16.7%	19	19
15	臺南市六甲區	2018-11-24T22:13:33+08:00	3197	5234	8431	830	9261	19144	48.38%	16.7%	19	19
15	臺南市六甲區	2018-11-24T23:27:23+08:00	3197	5234	8431	830	9261	19144	48.38%	16.7%	19	19
15	臺南市六甲區	2018-11-24T23:39:22+08:00	3197	5234	8431	830	9261	19144	48.38%	16.7%	19	19
15	臺南市六甲區	2018-11-25T01:12:49+08:00	3197	5234	8431	830	9261	19144	48.38%	16.7%	19	19
15	臺南市六甲區	2018-11-25T06:08:59+08:00	3197	5234	8431	830	9261	19144	48.38%	16.7%	19	19
15	臺南市六甲區	2018-11-24T23:31:17+08:00	3197	5234	8431	830	9261	19144	48.38%	16.7%	19	19
15	臺南市六甲區	2018-11-24T23:47:34+08:00	3197	5234	8431	830	9261	19144	48.38%	16.7%	19	19
15	臺南市六甲區	2018-11-24T23:05:09+08:00	3197	5234	8431	830	9261	19144	48.38%	16.7%	19	19
15	臺南市六甲區	2018-11-24T23:01:36+08:00	3197	5234	8431	830	9261	19144	48.38%	16.7%	19	19
15	臺南市六甲區	2018-11-25T04:02:57+08:00	3197	5234	8431	830	9261	19144	48.38%	16.7%	19	19
15	臺南市六甲區	2018-11-25T00:05:10+08:00	3197	5234	8431	830	9261	19144	48.38%	16.7%	19	19
15	臺南市六甲區	2018-11-25T06:19:02+08:00	3197	5234	8431	830	9261	19144	48.38%	16.7%	19	19
15	臺南市六甲區	2018-11-25T06:29:22+08:00	3197	5234	8431	830	9261	19144	48.38%	16.7%	19	19
15	臺南市六甲區	2018-11-25T03:49:56+08:00	3197	5234	8431	830	9261	19144	48.38%	16.7%	19	19
15	臺南市六甲區	2018-11-24T22:54:30+08:00	3197	5234	8431	830	9261	19144	48.38%	16.7%	19	19
15	臺南市六甲區	2018-11-25T06:13:57+08:00	3197	5234	8431	830	9261	19144	48.38%	16.7%	19	19
15	臺南市六甲區	2018-11-24T22:50:53+08:00	3197	5234	8431	830	9261	19144	48.38%	16.7%	19	19
15	臺南市六甲區	2018-11-24T22:37:05+08:00	3197	5234	8431	830	9261	19144	48.38%	16.7%	19	19
15	臺南市六甲區	2018-11-25T00:09:40+08:00	3197	5234	8431	830	9261	19144	48.38%	16.7%	19	19
15	臺南市六甲區	2018-11-24T22:26:41+08:00	3197	5234	8431	830	9261	19144	48.38%	16.7%	19	19
15	臺南市六甲區	2018-11-24T22:19:41+08:00	3197	5234	8431	830	9261	19144	48.38%	16.7%	19	19
15	臺南市六甲區	2018-11-25T03:38:59+08:00	3197	5234	8431	830	9261	19144	48.38%	16.7%	19	19
15	臺南市六甲區	2018-11-25T03:44:29+08:00	3197	5234	8431	830	9261	19144	48.38%	16.7%	19	19
15	臺南市六甲區	2018-11-24T23:08:42+08:00	3197	5234	8431	830	9261	19144	48.38%	16.7%	19	19
15	臺南市六甲區	2018-11-24T22:23:19+08:00	3197	5234	8431	830	9261	19144	48.38%	16.7%	19	19
15	臺南市六甲區	2018-11-24T23:23:43+08:00	3197	5234	8431	830	9261	19144	48.38%	16.7%	19	19
15	臺南市六甲區	2018-11-25T00:14:15+08:00	3197	5234	8431	830	9261	19144	48.38%	16.7%	19	19
15	臺南市六甲區	2018-11-24T23:35:15+08:00	3197	5234	8431	830	9261	19144	48.38%	16.7%	19	19
15	臺南市六甲區	2018-11-24T22:33:43+08:00	3197	5234	8431	830	9261	19144	48.38%	16.7%	19	19
15	臺南市六甲區	2018-11-24T23:12:21+08:00	3197	5234	8431	830	9261	19144	48.38%	16.7%	19	19
15	臺南市六甲區	2018-11-24T22:16:16+08:00	3197	5234	8431	830	9261	19144	48.38%	16.7%	19	19
15	臺南市六甲區	2018-11-25T01:07:31+08:00	3197	5234	8431	830	9261	19144	48.38%	16.7%	19	19
15	臺南市善化區	2018-11-24T23:16:08+08:00	6780	11465	18245	1222	19467	38164	51.01%	17.77%	28	29
15	臺南市善化區	2018-11-24T22:41:41+08:00	6780	11465	18245	1222	19467	38164	51.01%	17.77%	28	29
15	臺南市善化區	2018-11-25T00:18:37+08:00	7092	12087	19179	1284	20463	39950	51.22%	17.75%	29	29
15	臺南市善化區	2018-11-24T22:45:13+08:00	6780	11465	18245	1222	19467	38164	51.01%	17.77%	28	29
15	臺南市善化區	2018-11-25T03:56:18+08:00	7092	12087	19179	1284	20463	39950	51.22%	17.75%	29	29
15	臺南市善化區	2018-11-24T22:58:00+08:00	6780	11465	18245	1222	19467	38164	51.01%	17.77%	28	29
15	臺南市善化區	2018-11-24T22:37:06+08:00	6517	11076	17593	1175	18768	36918	50.84%	17.65%	27	29
15	臺南市善化區	2018-11-24T22:40:32+08:00	6780	11465	18245	1222	19467	38164	51.01%	17.77%	28	29
15	臺南市善化區	2018-11-25T01:02:36+08:00	7092	12087	19179	1284	20463	39950	51.22%	17.75%	29	29
15	臺南市善化區	2018-11-24T22:19:42+08:00	5882	10045	15927	1068	16995	33526	50.69%	17.54%	25	29
15	臺南市善化區	2018-11-25T01:25:58+08:00	7092	12087	19179	1284	20463	39950	51.22%	17.75%	29	29
15	臺南市善化區	2018-11-24T22:30:15+08:00	6179	10502	16681	1135	17816	35100	50.76%	17.6%	26	29
15	臺南市善化區	2018-11-24T23:51:41+08:00	7092	12087	19179	1284	20463	39950	51.22%	17.75%	29	29
15	臺南市善化區	2018-11-25T00:23:09+08:00	7092	12087	19179	1284	20463	39950	51.22%	17.75%	29	29
15	臺南市善化區	2018-11-25T00:57:42+08:00	7092	12087	19179	1284	20463	39950	51.22%	17.75%	29	29
15	臺南市善化區	2018-11-25T06:24:05+08:00	7092	12087	19179	1284	20463	39950	51.22%	17.75%	29	29
15	臺南市善化區	2018-11-25T00:00:16+08:00	7092	12087	19179	1284	20463	39950	51.22%	17.75%	29	29
15	臺南市善化區	2018-11-25T01:17:59+08:00	7092	12087	19179	1284	20463	39950	51.22%	17.75%	29	29
15	臺南市善化區	2018-11-24T23:19:57+08:00	6780	11465	18245	1222	19467	38164	51.01%	17.77%	28	29
15	臺南市善化區	2018-11-24T23:55:52+08:00	7092	12087	19179	1284	20463	39950	51.22%	17.75%	29	29
15	臺南市善化區	2018-11-24T22:13:34+08:00	5712	9709	15421	1053	16474	32394	50.86%	17.63%	24	29
15	臺南市善化區	2018-11-24T23:27:23+08:00	6780	11465	18245	1222	19467	38164	51.01%	17.77%	28	29
15	臺南市善化區	2018-11-24T23:39:22+08:00	6780	11465	18245	1222	19467	38164	51.01%	17.77%	28	29
15	臺南市善化區	2018-11-25T01:12:49+08:00	7092	12087	19179	1284	20463	39950	51.22%	17.75%	29	29
15	臺南市善化區	2018-11-25T06:08:59+08:00	7092	12087	19179	1284	20463	39950	51.22%	17.75%	29	29
15	臺南市善化區	2018-11-24T23:31:17+08:00	6780	11465	18245	1222	19467	38164	51.01%	17.77%	28	29
15	臺南市善化區	2018-11-24T23:47:34+08:00	7092	12087	19179	1284	20463	39950	51.22%	17.75%	29	29
15	臺南市善化區	2018-11-24T23:05:09+08:00	6780	11465	18245	1222	19467	38164	51.01%	17.77%	28	29
15	臺南市善化區	2018-11-24T23:01:36+08:00	6780	11465	18245	1222	19467	38164	51.01%	17.77%	28	29
15	臺南市善化區	2018-11-25T04:02:57+08:00	7092	12087	19179	1284	20463	39950	51.22%	17.75%	29	29
15	臺南市善化區	2018-11-25T00:05:10+08:00	7092	12087	19179	1284	20463	39950	51.22%	17.75%	29	29
15	臺南市善化區	2018-11-25T06:19:02+08:00	7092	12087	19179	1284	20463	39950	51.22%	17.75%	29	29
15	臺南市善化區	2018-11-25T06:29:22+08:00	7092	12087	19179	1284	20463	39950	51.22%	17.75%	29	29
15	臺南市善化區	2018-11-25T03:49:56+08:00	7092	12087	19179	1284	20463	39950	51.22%	17.75%	29	29
15	臺南市善化區	2018-11-24T22:54:30+08:00	6780	11465	18245	1222	19467	38164	51.01%	17.77%	28	29
15	臺南市善化區	2018-11-24T22:50:54+08:00	6780	11465	18245	1222	19467	38164	51.01%	17.77%	28	29
15	臺南市善化區	2018-11-25T06:13:57+08:00	7092	12087	19179	1284	20463	39950	51.22%	17.75%	29	29
15	臺南市善化區	2018-11-24T23:43:22+08:00	7092	12087	19179	1284	20463	39950	51.22%	17.75%	29	29
15	臺南市善化區	2018-11-25T00:09:40+08:00	7092	12087	19179	1284	20463	39950	51.22%	17.75%	29	29
15	臺南市善化區	2018-11-24T22:26:41+08:00	5882	10045	15927	1068	16995	33526	50.69%	17.54%	25	29
15	臺南市善化區	2018-11-25T03:44:29+08:00	7092	12087	19179	1284	20463	39950	51.22%	17.75%	29	29
15	臺南市善化區	2018-11-25T03:32:42+08:00	7092	12087	19179	1284	20463	39950	51.22%	17.75%	29	29
15	臺南市善化區	2018-11-24T23:08:42+08:00	6780	11465	18245	1222	19467	38164	51.01%	17.77%	28	29
15	臺南市善化區	2018-11-24T22:23:19+08:00	5882	10045	15927	1068	16995	33526	50.69%	17.54%	25	29
15	臺南市善化區	2018-11-24T23:23:43+08:00	6780	11465	18245	1222	19467	38164	51.01%	17.77%	28	29
15	臺南市善化區	2018-11-25T00:14:15+08:00	7092	12087	19179	1284	20463	39950	51.22%	17.75%	29	29
15	臺南市善化區	2018-11-24T23:35:15+08:00	6780	11465	18245	1222	19467	38164	51.01%	17.77%	28	29
15	臺南市善化區	2018-11-24T22:33:43+08:00	6517	11076	17593	1175	18768	36918	50.84%	17.65%	27	29
15	臺南市善化區	2018-11-25T03:39:00+08:00	7092	12087	19179	1284	20463	39950	51.22%	17.75%	29	29
15	臺南市善化區	2018-11-24T23:12:21+08:00	6780	11465	18245	1222	19467	38164	51.01%	17.77%	28	29
15	臺南市善化區	2018-11-24T22:16:16+08:00	5712	9709	15421	1053	16474	32394	50.86%	17.63%	24	29
15	臺南市善化區	2018-11-25T01:07:31+08:00	7092	12087	19179	1284	20463	39950	51.22%	17.75%	29	29
15	花蓮縣豐濱鄉	2018-11-24T23:56:00+08:00	453	1007	1460	196	1656	3678	45.02%	12.32%	6	7
15	花蓮縣豐濱鄉	2018-11-24T22:58:08+08:00	453	1007	1460	196	1656	3678	45.02%	12.32%	6	7
15	花蓮縣豐濱鄉	2018-11-24T23:43:29+08:00	453	1007	1460	196	1656	3678	45.02%	12.32%	6	7
15	花蓮縣豐濱鄉	2018-11-25T01:18:09+08:00	453	1007	1460	196	1656	3678	45.02%	12.32%	6	7
15	花蓮縣豐濱鄉	2018-11-25T03:56:27+08:00	520	1207	1727	271	1998	4395	45.46%	11.83%	7	7
15	花蓮縣豐濱鄉	2018-11-24T23:39:31+08:00	453	1007	1460	196	1656	3678	45.02%	12.32%	6	7
15	花蓮縣豐濱鄉	2018-11-24T23:47:42+08:00	453	1007	1460	196	1656	3678	45.02%	12.32%	6	7
15	花蓮縣豐濱鄉	2018-11-24T22:30:22+08:00	287	648	935	88	1023	2396	42.7%	11.98%	4	7
15	花蓮縣豐濱鄉	2018-11-24T23:27:30+08:00	453	1007	1460	196	1656	3678	45.02%	12.32%	6	7
15	花蓮縣豐濱鄉	2018-11-24T23:51:48+08:00	453	1007	1460	196	1656	3678	45.02%	12.32%	6	7
15	花蓮縣豐濱鄉	2018-11-25T06:09:08+08:00	520	1207	1727	271	1998	4395	45.46%	11.83%	7	7
15	花蓮縣豐濱鄉	2018-11-24T22:13:44+08:00	287	648	935	88	1023	2396	42.7%	11.98%	4	7
15	花蓮縣豐濱鄉	2018-11-25T00:57:50+08:00	453	1007	1460	196	1656	3678	45.02%	12.32%	6	7
15	花蓮縣豐濱鄉	2018-11-25T03:44:39+08:00	520	1207	1727	271	1998	4395	45.46%	11.83%	7	7
15	花蓮縣豐濱鄉	2018-11-24T23:31:26+08:00	453	1007	1460	196	1656	3678	45.02%	12.32%	6	7
15	花蓮縣豐濱鄉	2018-11-24T22:37:13+08:00	287	648	935	88	1023	2396	42.7%	11.98%	4	7
15	花蓮縣豐濱鄉	2018-11-24T22:16:24+08:00	287	648	935	88	1023	2396	42.7%	11.98%	4	7
15	花蓮縣豐濱鄉	2018-11-24T23:20:06+08:00	453	1007	1460	196	1656	3678	45.02%	12.32%	6	7
15	花蓮縣豐濱鄉	2018-11-25T00:18:46+08:00	453	1007	1460	196	1656	3678	45.02%	12.32%	6	7
15	花蓮縣豐濱鄉	2018-11-24T23:16:15+08:00	453	1007	1460	196	1656	3678	45.02%	12.32%	6	7
15	花蓮縣豐濱鄉	2018-11-25T01:12:58+08:00	453	1007	1460	196	1656	3678	45.02%	12.32%	6	7
15	花蓮縣豐濱鄉	2018-11-25T00:05:17+08:00	453	1007	1460	196	1656	3678	45.02%	12.32%	6	7
15	花蓮縣豐濱鄉	2018-11-24T23:05:16+08:00	453	1007	1460	196	1656	3678	45.02%	12.32%	6	7
15	花蓮縣豐濱鄉	2018-11-24T22:54:37+08:00	453	1007	1460	196	1656	3678	45.02%	12.32%	6	7
15	花蓮縣豐濱鄉	2018-11-24T22:33:50+08:00	287	648	935	88	1023	2396	42.7%	11.98%	4	7
15	花蓮縣豐濱鄉	2018-11-24T22:45:20+08:00	287	648	935	88	1023	2396	42.7%	11.98%	4	7
15	花蓮縣豐濱鄉	2018-11-24T22:26:48+08:00	287	648	935	88	1023	2396	42.7%	11.98%	4	7
15	花蓮縣豐濱鄉	2018-11-24T23:01:45+08:00	453	1007	1460	196	1656	3678	45.02%	12.32%	6	7
15	花蓮縣豐濱鄉	2018-11-25T00:09:49+08:00	453	1007	1460	196	1656	3678	45.02%	12.32%	6	7
15	花蓮縣豐濱鄉	2018-11-25T04:03:05+08:00	520	1207	1727	271	1998	4395	45.46%	11.83%	7	7
15	花蓮縣豐濱鄉	2018-11-24T23:23:50+08:00	453	1007	1460	196	1656	3678	45.02%	12.32%	6	7
15	花蓮縣豐濱鄉	2018-11-24T22:19:49+08:00	287	648	935	88	1023	2396	42.7%	11.98%	4	7
15	花蓮縣豐濱鄉	2018-11-24T22:40:39+08:00	287	648	935	88	1023	2396	42.7%	11.98%	4	7
15	花蓮縣豐濱鄉	2018-11-25T03:32:51+08:00	520	1207	1727	271	1998	4395	45.46%	11.83%	7	7
15	花蓮縣豐濱鄉	2018-11-24T23:08:50+08:00	453	1007	1460	196	1656	3678	45.02%	12.32%	6	7
15	花蓮縣豐濱鄉	2018-11-24T22:23:27+08:00	287	648	935	88	1023	2396	42.7%	11.98%	4	7
15	花蓮縣豐濱鄉	2018-11-24T22:51:02+08:00	453	1007	1460	196	1656	3678	45.02%	12.32%	6	7
15	花蓮縣豐濱鄉	2018-11-25T06:14:04+08:00	520	1207	1727	271	1998	4395	45.46%	11.83%	7	7
15	花蓮縣豐濱鄉	2018-11-25T00:00:23+08:00	453	1007	1460	196	1656	3678	45.02%	12.32%	6	7
15	花蓮縣豐濱鄉	2018-11-25T06:24:13+08:00	520	1207	1727	271	1998	4395	45.46%	11.83%	7	7
15	花蓮縣豐濱鄉	2018-11-25T00:23:16+08:00	453	1007	1460	196	1656	3678	45.02%	12.32%	6	7
15	花蓮縣豐濱鄉	2018-11-25T01:02:43+08:00	453	1007	1460	196	1656	3678	45.02%	12.32%	6	7
15	花蓮縣豐濱鄉	2018-11-25T06:19:10+08:00	520	1207	1727	271	1998	4395	45.46%	11.83%	7	7
15	花蓮縣豐濱鄉	2018-11-25T06:29:30+08:00	520	1207	1727	271	1998	4395	45.46%	11.83%	7	7
15	花蓮縣豐濱鄉	2018-11-24T23:12:29+08:00	453	1007	1460	196	1656	3678	45.02%	12.32%	6	7
15	花蓮縣豐濱鄉	2018-11-25T03:50:03+08:00	520	1207	1727	271	1998	4395	45.46%	11.83%	7	7
15	花蓮縣豐濱鄉	2018-11-25T01:07:39+08:00	453	1007	1460	196	1656	3678	45.02%	12.32%	6	7
15	花蓮縣豐濱鄉	2018-11-25T01:26:07+08:00	453	1007	1460	196	1656	3678	45.02%	12.32%	6	7
15	花蓮縣豐濱鄉	2018-11-25T03:39:07+08:00	520	1207	1727	271	1998	4395	45.46%	11.83%	7	7
15	花蓮縣豐濱鄉	2018-11-24T22:41:50+08:00	287	648	935	88	1023	2396	42.7%	11.98%	4	7
15	花蓮縣豐濱鄉	2018-11-25T00:14:22+08:00	453	1007	1460	196	1656	3678	45.02%	12.32%	6	7
15	花蓮縣豐濱鄉	2018-11-24T23:35:22+08:00	453	1007	1460	196	1656	3678	45.02%	12.32%	6	7
15	臺中市太平區	2018-11-25T03:49:55+08:00	25949	55823	81772	4731	86503	157926	54.77%	16.43%	93	93
15	臺中市太平區	2018-11-25T06:19:01+08:00	25949	55823	81772	4731	86503	157926	54.77%	16.43%	93	93
15	臺中市太平區	2018-11-24T22:41:41+08:00	19527	42066	61593	3534	65127	118511	54.95%	16.48%	72	93
15	臺中市太平區	2018-11-24T23:16:07+08:00	21562	46615	68177	3915	72092	130756	55.13%	16.49%	79	93
15	臺中市太平區	2018-11-25T03:56:18+08:00	25949	55823	81772	4731	86503	157926	54.77%	16.43%	93	93
15	臺中市太平區	2018-11-24T22:45:12+08:00	19527	42066	61593	3534	65127	118511	54.95%	16.48%	72	93
15	臺中市太平區	2018-11-24T23:43:21+08:00	23674	51087	74761	4346	79107	143522	55.12%	16.5%	86	93
15	臺中市太平區	2018-11-25T00:18:36+08:00	24945	53859	78804	4561	83365	151606	54.99%	16.45%	90	93
15	臺中市太平區	2018-11-24T23:51:40+08:00	23674	51087	74761	4346	79107	143522	55.12%	16.5%	86	93
15	臺中市太平區	2018-11-24T22:40:32+08:00	19527	42066	61593	3534	65127	118511	54.95%	16.48%	72	93
15	臺中市太平區	2018-11-25T01:25:57+08:00	25949	55823	81772	4731	86503	157926	54.77%	16.43%	93	93
15	臺中市太平區	2018-11-24T22:30:14+08:00	18274	39656	57930	3368	61298	111949	54.76%	16.32%	68	93
15	臺中市太平區	2018-11-25T06:24:04+08:00	25949	55823	81772	4731	86503	157926	54.77%	16.43%	93	93
15	臺中市太平區	2018-11-25T00:23:08+08:00	24945	53859	78804	4561	83365	151606	54.99%	16.45%	90	93
15	臺中市太平區	2018-11-25T00:57:42+08:00	25949	55823	81772	4731	86503	157926	54.77%	16.43%	93	93
15	臺中市太平區	2018-11-24T23:27:22+08:00	22220	47902	70122	4031	74153	134186	55.26%	16.56%	81	93
15	臺中市太平區	2018-11-24T22:57:59+08:00	20434	43982	64416	3697	68113	123765	55.03%	16.51%	75	93
15	臺中市太平區	2018-11-25T03:32:41+08:00	25949	55823	81772	4731	86503	157926	54.77%	16.43%	93	93
15	臺中市太平區	2018-11-24T23:08:41+08:00	20889	45123	66012	3757	69769	127004	54.93%	16.45%	77	93
15	臺中市太平區	2018-11-24T22:13:33+08:00	15394	33520	48914	2928	51842	94654	54.77%	16.26%	59	93
15	臺中市太平區	2018-11-24T23:19:56+08:00	21562	46615	68177	3915	72092	130756	55.13%	16.49%	79	93
15	臺中市太平區	2018-11-25T01:17:58+08:00	25949	55823	81772	4731	86503	157926	54.77%	16.43%	93	93
15	臺中市太平區	2018-11-25T01:12:49+08:00	25949	55823	81772	4731	86503	157926	54.77%	16.43%	93	93
15	臺中市太平區	2018-11-24T22:54:29+08:00	20110	43313	63423	3654	67077	121937	55.01%	16.49%	74	93
15	臺中市太平區	2018-11-24T23:47:33+08:00	23674	51087	74761	4346	79107	143522	55.12%	16.5%	86	93
15	臺中市太平區	2018-11-24T23:05:09+08:00	20667	44577	65244	3739	68983	125445	54.99%	16.47%	76	93
15	臺中市太平區	2018-11-25T06:08:58+08:00	25949	55823	81772	4731	86503	157926	54.77%	16.43%	93	93
15	臺中市太平區	2018-11-24T22:16:15+08:00	15914	34620	50534	2998	53532	97847	54.71%	16.26%	61	93
15	臺中市太平區	2018-11-24T23:31:16+08:00	22843	49242	72085	4154	76239	138149	55.19%	16.54%	83	93
15	臺中市太平區	2018-11-25T04:02:57+08:00	25949	55823	81772	4731	86503	157926	54.77%	16.43%	93	93
15	臺中市太平區	2018-11-25T00:05:10+08:00	24007	51799	75806	4412	80218	145648	55.08%	16.48%	87	93
15	臺中市太平區	2018-11-25T06:29:22+08:00	25949	55823	81772	4731	86503	157926	54.77%	16.43%	93	93
15	臺中市太平區	2018-11-25T06:13:57+08:00	25949	55823	81772	4731	86503	157926	54.77%	16.43%	93	93
15	臺中市太平區	2018-11-24T22:50:53+08:00	20110	43313	63423	3654	67077	121937	55.01%	16.49%	74	93
15	臺中市太平區	2018-11-24T22:37:05+08:00	19527	42066	61593	3534	65127	118511	54.95%	16.48%	72	93
15	臺中市太平區	2018-11-24T22:26:41+08:00	17535	38037	55572	3256	58828	107554	54.7%	16.3%	66	93
15	臺中市太平區	2018-11-24T22:19:41+08:00	16583	35982	52565	3070	55635	101797	54.65%	16.29%	63	93
15	臺中市太平區	2018-11-25T03:38:59+08:00	25949	55823	81772	4731	86503	157926	54.77%	16.43%	93	93
15	臺中市太平區	2018-11-25T03:44:29+08:00	25949	55823	81772	4731	86503	157926	54.77%	16.43%	93	93
15	臺中市太平區	2018-11-25T01:02:35+08:00	25949	55823	81772	4731	86503	157926	54.77%	16.43%	93	93
15	臺中市太平區	2018-11-24T23:23:42+08:00	21880	47332	69212	4011	73223	132703	55.18%	16.49%	80	93
15	臺中市太平區	2018-11-24T22:23:18+08:00	16929	36767	53696	3139	56835	103872	54.72%	16.3%	64	93
15	臺中市太平區	2018-11-25T00:00:15+08:00	24007	51799	75806	4412	80218	145648	55.08%	16.48%	87	93
15	臺中市太平區	2018-11-24T23:55:51+08:00	23674	51087	74761	4346	79107	143522	55.12%	16.5%	86	93
15	臺中市太平區	2018-11-24T23:35:15+08:00	23120	49830	72950	4223	77173	140170	55.06%	16.49%	84	93
15	臺中市太平區	2018-11-24T23:39:21+08:00	23442	50570	74012	4298	78310	142080	55.12%	16.5%	85	93
15	臺中市太平區	2018-11-24T23:12:20+08:00	21151	45747	66898	3835	70733	128586	55.01%	16.45%	78	93
15	臺中市太平區	2018-11-25T00:14:14+08:00	24312	52552	76864	4474	81338	147696	55.07%	16.46%	88	93
15	臺中市太平區	2018-11-24T23:01:35+08:00	20667	44577	65244	3739	68983	125445	54.99%	16.47%	76	93
15	臺中市太平區	2018-11-25T00:09:39+08:00	24007	51799	75806	4412	80218	145648	55.08%	16.48%	87	93
15	臺中市太平區	2018-11-25T01:07:31+08:00	25949	55823	81772	4731	86503	157926	54.77%	16.43%	93	93
15	臺中市太平區	2018-11-24T22:33:42+08:00	19200	41414	60614	3477	64091	116635	54.95%	16.46%	71	93
15	臺東縣東河鄉	2018-11-25T03:56:28+08:00	831	2088	2919	420	3339	7635	43.73%	10.88%	11	11
15	臺東縣東河鄉	2018-11-24T23:56:00+08:00	831	2088	2919	420	3339	7635	43.73%	10.88%	11	11
15	臺東縣東河鄉	2018-11-24T22:58:08+08:00	645	1653	2298	307	2605	6439	40.46%	10.02%	10	11
15	臺東縣東河鄉	2018-11-24T23:47:43+08:00	831	2088	2919	420	3339	7635	43.73%	10.88%	11	11
15	臺東縣東河鄉	2018-11-24T23:12:30+08:00	831	2088	2919	420	3339	7635	43.73%	10.88%	11	11
15	臺東縣東河鄉	2018-11-24T23:27:30+08:00	831	2088	2919	420	3339	7635	43.73%	10.88%	11	11
15	臺東縣東河鄉	2018-11-25T06:09:09+08:00	831	2088	2919	420	3339	7635	43.73%	10.88%	11	11
15	臺東縣東河鄉	2018-11-24T23:51:48+08:00	831	2088	2919	420	3339	7635	43.73%	10.88%	11	11
15	臺東縣東河鄉	2018-11-24T22:30:23+08:00	645	1653	2298	307	2605	6439	40.46%	10.02%	10	11
15	臺東縣東河鄉	2018-11-25T03:32:52+08:00	831	2088	2919	420	3339	7635	43.73%	10.88%	11	11
15	臺東縣東河鄉	2018-11-24T22:13:44+08:00	645	1653	2298	307	2605	6439	40.46%	10.02%	10	11
15	臺東縣東河鄉	2018-11-25T03:44:40+08:00	831	2088	2919	420	3339	7635	43.73%	10.88%	11	11
15	臺東縣東河鄉	2018-11-25T00:57:51+08:00	831	2088	2919	420	3339	7635	43.73%	10.88%	11	11
15	臺東縣東河鄉	2018-11-24T22:16:25+08:00	645	1653	2298	307	2605	6439	40.46%	10.02%	10	11
15	臺東縣東河鄉	2018-11-25T00:09:50+08:00	831	2088	2919	420	3339	7635	43.73%	10.88%	11	11
15	臺東縣東河鄉	2018-11-25T00:18:47+08:00	831	2088	2919	420	3339	7635	43.73%	10.88%	11	11
15	臺東縣東河鄉	2018-11-24T23:20:08+08:00	831	2088	2919	420	3339	7635	43.73%	10.88%	11	11
15	臺東縣東河鄉	2018-11-24T22:37:13+08:00	645	1653	2298	307	2605	6439	40.46%	10.02%	10	11
15	臺東縣東河鄉	2018-11-24T23:31:27+08:00	831	2088	2919	420	3339	7635	43.73%	10.88%	11	11
15	臺東縣東河鄉	2018-11-24T23:16:15+08:00	831	2088	2919	420	3339	7635	43.73%	10.88%	11	11
15	臺東縣東河鄉	2018-11-25T01:12:58+08:00	831	2088	2919	420	3339	7635	43.73%	10.88%	11	11
15	臺東縣東河鄉	2018-11-25T00:05:17+08:00	831	2088	2919	420	3339	7635	43.73%	10.88%	11	11
15	臺東縣東河鄉	2018-11-24T23:05:16+08:00	831	2088	2919	420	3339	7635	43.73%	10.88%	11	11
15	臺東縣東河鄉	2018-11-24T23:39:32+08:00	831	2088	2919	420	3339	7635	43.73%	10.88%	11	11
15	臺東縣東河鄉	2018-11-24T22:54:37+08:00	645	1653	2298	307	2605	6439	40.46%	10.02%	10	11
15	臺東縣東河鄉	2018-11-24T22:33:50+08:00	645	1653	2298	307	2605	6439	40.46%	10.02%	10	11
15	臺東縣東河鄉	2018-11-24T22:45:20+08:00	645	1653	2298	307	2605	6439	40.46%	10.02%	10	11
15	臺東縣東河鄉	2018-11-24T22:26:48+08:00	645	1653	2298	307	2605	6439	40.46%	10.02%	10	11
15	臺東縣東河鄉	2018-11-24T23:01:45+08:00	645	1653	2298	307	2605	6439	40.46%	10.02%	10	11
15	臺東縣東河鄉	2018-11-25T04:03:05+08:00	831	2088	2919	420	3339	7635	43.73%	10.88%	11	11
15	臺東縣東河鄉	2018-11-24T23:08:51+08:00	831	2088	2919	420	3339	7635	43.73%	10.88%	11	11
15	臺東縣東河鄉	2018-11-24T23:23:50+08:00	831	2088	2919	420	3339	7635	43.73%	10.88%	11	11
15	臺東縣東河鄉	2018-11-24T22:19:49+08:00	645	1653	2298	307	2605	6439	40.46%	10.02%	10	11
15	臺東縣東河鄉	2018-11-25T00:23:17+08:00	831	2088	2919	420	3339	7635	43.73%	10.88%	11	11
15	臺東縣東河鄉	2018-11-25T00:00:23+08:00	831	2088	2919	420	3339	7635	43.73%	10.88%	11	11
15	臺東縣東河鄉	2018-11-24T22:51:03+08:00	645	1653	2298	307	2605	6439	40.46%	10.02%	10	11
15	臺東縣東河鄉	2018-11-24T22:23:28+08:00	645	1653	2298	307	2605	6439	40.46%	10.02%	10	11
15	臺東縣東河鄉	2018-11-24T22:40:40+08:00	645	1653	2298	307	2605	6439	40.46%	10.02%	10	11
15	臺東縣東河鄉	2018-11-25T06:24:13+08:00	831	2088	2919	420	3339	7635	43.73%	10.88%	11	11
15	臺東縣東河鄉	2018-11-25T01:02:44+08:00	831	2088	2919	420	3339	7635	43.73%	10.88%	11	11
15	臺東縣東河鄉	2018-11-25T06:14:05+08:00	831	2088	2919	420	3339	7635	43.73%	10.88%	11	11
15	臺東縣東河鄉	2018-11-25T06:19:10+08:00	831	2088	2919	420	3339	7635	43.73%	10.88%	11	11
15	臺東縣東河鄉	2018-11-25T00:14:23+08:00	831	2088	2919	420	3339	7635	43.73%	10.88%	11	11
15	臺東縣東河鄉	2018-11-25T01:18:10+08:00	831	2088	2919	420	3339	7635	43.73%	10.88%	11	11
15	臺東縣東河鄉	2018-11-25T03:50:03+08:00	831	2088	2919	420	3339	7635	43.73%	10.88%	11	11
15	臺東縣東河鄉	2018-11-25T01:07:39+08:00	831	2088	2919	420	3339	7635	43.73%	10.88%	11	11
15	臺東縣東河鄉	2018-11-25T01:26:07+08:00	831	2088	2919	420	3339	7635	43.73%	10.88%	11	11
15	臺東縣東河鄉	2018-11-25T03:39:07+08:00	831	2088	2919	420	3339	7635	43.73%	10.88%	11	11
15	臺東縣東河鄉	2018-11-24T22:41:50+08:00	645	1653	2298	307	2605	6439	40.46%	10.02%	10	11
15	臺東縣東河鄉	2018-11-25T06:29:31+08:00	831	2088	2919	420	3339	7635	43.73%	10.88%	11	11
15	臺東縣東河鄉	2018-11-24T23:35:22+08:00	831	2088	2919	420	3339	7635	43.73%	10.88%	11	11
15	臺東縣東河鄉	2018-11-24T23:43:30+08:00	831	2088	2919	420	3339	7635	43.73%	10.88%	11	11
15	臺北市大安區	2018-11-25T06:29:19+08:00	54598	85851	140449	5548	145997	252645	57.79%	21.61%	188	188
15	臺北市大安區	2018-11-25T01:07:28+08:00	41373	64728	106101	4106	110207	190629	57.81%	21.7%	144	188
15	臺北市大安區	2018-11-25T06:13:55+08:00	54598	85851	140449	5548	145997	252645	57.79%	21.61%	188	188
15	臺北市大安區	2018-11-24T22:50:51+08:00	15106	23975	39081	1498	40579	71922	56.42%	21%	57	188
15	臺北市大安區	2018-11-25T06:19:00+08:00	54598	85851	140449	5548	145997	252645	57.79%	21.61%	188	188
15	臺北市大安區	2018-11-25T03:49:53+08:00	54598	85851	140449	5548	145997	252645	57.79%	21.61%	188	188
15	臺北市大安區	2018-11-24T22:50:50+08:00	15106	23975	39081	1498	40579	71922	56.42%	21%	57	188
15	臺北市大安區	2018-11-25T06:13:54+08:00	54598	85851	140449	5548	145997	252645	57.79%	21.61%	188	188
15	臺北市大安區	2018-11-24T23:43:19+08:00	29055	45183	74238	2867	77105	134376	57.38%	21.62%	103	188
15	臺北市大安區	2018-11-24T22:13:29+08:00	9262	14476	23738	909	24647	44080	55.91%	21.01%	36	188
15	臺北市大安區	2018-11-25T06:24:03+08:00	54598	85851	140449	5548	145997	252645	57.79%	21.61%	188	188
15	臺北市大安區	2018-11-24T23:08:39+08:00	20090	31351	51441	1964	53405	93517	57.11%	21.48%	73	188
15	臺北市大安區	2018-11-25T00:23:06+08:00	36330	56755	93085	3602	96687	167725	57.65%	21.66%	127	188
15	臺北市大安區	2018-11-24T22:30:12+08:00	11924	18590	30514	1154	31668	56032	56.52%	21.28%	45	188
15	臺北市大安區	2018-11-24T23:08:38+08:00	20090	31351	51441	1964	53405	93517	57.11%	21.48%	73	188
15	臺北市大安區	2018-11-24T23:55:49+08:00	30926	48145	79071	3038	82109	142746	57.52%	21.67%	109	188
15	臺北市大安區	2018-11-25T03:32:37+08:00	54387	85469	139856	5524	145380	251501	57.8%	21.62%	187	188
15	臺北市大安區	2018-11-25T06:24:02+08:00	54598	85851	140449	5548	145997	252645	57.79%	21.61%	188	188
15	臺北市大安區	2018-11-24T23:51:37+08:00	29978	46681	76659	2946	79605	138589	57.44%	21.63%	106	188
15	臺北市大安區	2018-11-24T23:23:41+08:00	23543	36698	60241	2310	62551	109161	57.3%	21.57%	85	188
15	臺北市大安區	2018-11-24T22:23:15+08:00	11101	17254	28355	1092	29447	52208	56.4%	21.26%	42	188
15	臺北市大安區	2018-11-24T22:40:29+08:00	13401	21084	34485	1294	35779	63403	56.43%	21.14%	50	188
15	臺北市大安區	2018-11-24T22:57:57+08:00	17594	27660	45254	1721	46975	82696	56.8%	21.28%	65	188
15	臺北市大安區	2018-11-25T06:18:59+08:00	54598	85851	140449	5548	145997	252645	57.79%	21.61%	188	188
15	臺北市大安區	2018-11-24T22:57:56+08:00	17594	27660	45254	1721	46975	82696	56.8%	21.28%	65	188
15	臺北市大安區	2018-11-25T01:17:56+08:00	42274	66417	108691	4180	112871	194913	57.91%	21.69%	147	188
15	臺北市大安區	2018-11-24T23:23:40+08:00	23543	36698	60241	2310	62551	109161	57.3%	21.57%	85	188
15	臺北市大安區	2018-11-24T22:33:40+08:00	13116	20657	33773	1272	35045	62007	56.52%	21.15%	49	188
15	臺北市大安區	2018-11-24T22:54:27+08:00	15694	24847	40541	1551	42092	74336	56.62%	21.11%	59	188
15	臺北市大安區	2018-11-24T22:16:13+08:00	9920	15463	25383	968	26351	47018	56.04%	21.1%	38	188
15	臺北市大安區	2018-11-25T00:14:11+08:00	34504	53929	88433	3419	91852	159530	57.58%	21.63%	121	188
15	臺北市大安區	2018-11-24T23:05:07+08:00	18829	29485	48314	1823	50137	87972	56.99%	21.4%	69	188
15	臺北市大安區	2018-11-24T22:41:38+08:00	13401	21084	34485	1294	35779	63403	56.43%	21.14%	50	188
15	臺北市大安區	2018-11-24T22:54:28+08:00	15694	24847	40541	1551	42092	74336	56.62%	21.11%	59	188
15	臺北市大安區	2018-11-25T01:12:46+08:00	42274	66417	108691	4180	112871	194913	57.91%	21.69%	147	188
15	臺北市大安區	2018-11-25T06:08:56+08:00	54598	85851	140449	5548	145997	252645	57.79%	21.61%	188	188
15	臺北市大安區	2018-11-24T22:41:37+08:00	13401	21084	34485	1294	35779	63403	56.43%	21.14%	50	188
15	臺北市大安區	2018-11-25T00:05:07+08:00	32151	50092	82243	3180	85423	148303	57.6%	21.68%	113	188
15	臺北市大安區	2018-11-24T23:05:06+08:00	18829	29485	48314	1823	50137	87972	56.99%	21.4%	69	188
15	臺北市大安區	2018-11-25T00:18:33+08:00	35770	55874	91644	3533	95177	165230	57.6%	21.65%	125	188
15	臺北市大安區	2018-11-24T22:37:03+08:00	13401	21084	34485	1294	35779	63403	56.43%	21.14%	50	188
15	臺北市大安區	2018-11-24T22:45:10+08:00	13606	21422	35028	1323	36351	64402	56.44%	21.13%	51	188
15	臺北市大安區	2018-11-24T23:16:05+08:00	22259	34513	56772	2159	58931	103020	57.2%	21.61%	80	188
15	臺北市大安區	2018-11-24T22:45:11+08:00	13606	21422	35028	1323	36351	64402	56.44%	21.13%	51	188
15	臺北市大安區	2018-11-24T22:37:02+08:00	13401	21084	34485	1294	35779	63403	56.43%	21.14%	50	188
15	臺北市大安區	2018-11-25T03:56:15+08:00	54598	85851	140449	5548	145997	252645	57.79%	21.61%	188	188
15	臺北市大安區	2018-11-25T03:38:57+08:00	54598	85851	140449	5548	145997	252645	57.79%	21.61%	188	188
15	臺北市大安區	2018-11-25T03:44:26+08:00	54598	85851	140449	5548	145997	252645	57.79%	21.61%	188	188
15	臺北市大安區	2018-11-24T22:30:11+08:00	11924	18590	30514	1154	31668	56032	56.52%	21.28%	45	188
15	臺北市大安區	2018-11-25T01:02:33+08:00	41121	64257	105378	4067	109445	189301	57.82%	21.72%	143	188
15	臺北市大安區	2018-11-24T22:40:30+08:00	13401	21084	34485	1294	35779	63403	56.43%	21.14%	50	188
15	臺北市大安區	2018-11-25T01:25:55+08:00	42543	66830	109373	4201	113574	196222	57.88%	21.68%	148	188
15	臺北市大安區	2018-11-24T22:23:16+08:00	11101	17254	28355	1092	29447	52208	56.4%	21.26%	42	188
15	臺北市大安區	2018-11-24T23:19:54+08:00	22801	35516	58317	2228	60545	105620	57.32%	21.59%	82	188
15	臺北市大安區	2018-11-25T00:57:39+08:00	41121	64257	105378	4067	109445	189301	57.82%	21.72%	143	188
15	臺北市大安區	2018-11-24T23:27:21+08:00	25601	39929	65530	2536	68066	118947	57.22%	21.52%	92	188
15	臺北市大安區	2018-11-25T01:17:55+08:00	42274	66417	108691	4180	112871	194913	57.91%	21.69%	147	188
15	臺北市大安區	2018-11-24T22:19:39+08:00	10779	16820	27599	1068	28667	50880	56.34%	21.19%	41	188
15	臺北市大安區	2018-11-24T23:27:20+08:00	25601	39929	65530	2536	68066	118947	57.22%	21.52%	92	188
15	臺北市大安區	2018-11-24T22:13:30+08:00	9262	14476	23738	909	24647	44080	55.91%	21.01%	36	188
15	臺北市大安區	2018-11-25T00:00:13+08:00	32151	50092	82243	3180	85423	148303	57.6%	21.68%	113	188
15	臺北市大安區	2018-11-25T00:14:12+08:00	34504	53929	88433	3419	91852	159530	57.58%	21.63%	121	188
15	臺北市大安區	2018-11-25T04:02:55+08:00	54598	85851	140449	5548	145997	252645	57.79%	21.61%	188	188
15	臺北市大安區	2018-11-25T00:09:36+08:00	32151	50092	82243	3180	85423	148303	57.6%	21.68%	113	188
15	臺北市大安區	2018-11-24T23:39:19+08:00	27688	43203	70891	2742	73633	128498	57.3%	21.55%	99	188
15	臺北市大安區	2018-11-24T22:26:39+08:00	11717	18185	29902	1138	31040	54903	56.54%	21.34%	44	188
15	臺北市大安區	2018-11-24T23:12:18+08:00	20386	31813	52199	1992	54191	94946	57.08%	21.47%	74	188
15	臺北市大安區	2018-11-24T23:31:14+08:00	27147	42353	69500	2694	72194	126062	57.27%	21.53%	97	188
15	臺北市大安區	2018-11-24T23:01:33+08:00	18279	28639	46918	1774	48692	85460	56.98%	21.39%	67	188
15	臺北市大安區	2018-11-24T23:47:31+08:00	29684	46227	75911	2928	78839	137304	57.42%	21.62%	105	188
15	臺北市大安區	2018-11-24T23:35:13+08:00	27688	43203	70891	2742	73633	128498	57.3%	21.55%	99	188
15	臺北市大安區	2018-11-25T04:02:54+08:00	54598	85851	140449	5548	145997	252645	57.79%	21.61%	188	188
15	臺北市大安區	2018-11-25T00:09:37+08:00	32151	50092	82243	3180	85423	148303	57.6%	21.68%	113	188
15	臺北市大安區	2018-11-24T23:39:18+08:00	27688	43203	70891	2742	73633	128498	57.3%	21.55%	99	188
15	臺北市大安區	2018-11-25T06:08:55+08:00	54598	85851	140449	5548	145997	252645	57.79%	21.61%	188	188
15	桃園市龍潭區	2018-11-24T23:16:06+08:00	11166	25750	36916	1965	38881	73572	52.85%	15.18%	48	64
15	桃園市龍潭區	2018-11-25T06:19:01+08:00	15518	36190	51708	2635	54343	101574	53.5%	15.28%	64	64
15	桃園市龍潭區	2018-11-24T23:43:20+08:00	12852	29802	42654	2248	44902	84428	53.18%	15.22%	54	64
15	桃園市龍潭區	2018-11-25T06:29:20+08:00	15518	36190	51708	2635	54343	101574	53.5%	15.28%	64	64
15	桃園市龍潭區	2018-11-25T03:49:54+08:00	15518	36190	51708	2635	54343	101574	53.5%	15.28%	64	64
15	桃園市龍潭區	2018-11-25T03:56:16+08:00	15518	36190	51708	2635	54343	101574	53.5%	15.28%	64	64
15	桃園市龍潭區	2018-11-24T22:45:12+08:00	8813	20177	28990	1581	30571	57557	53.11%	15.31%	39	64
15	桃園市龍潭區	2018-11-24T22:30:13+08:00	7536	17132	24668	1339	26007	48794	53.3%	15.44%	34	64
15	桃園市龍潭區	2018-11-25T06:24:03+08:00	15518	36190	51708	2635	54343	101574	53.5%	15.28%	64	64
15	桃園市龍潭區	2018-11-25T03:32:38+08:00	15518	36190	51708	2635	54343	101574	53.5%	15.28%	64	64
15	桃園市龍潭區	2018-11-25T01:25:56+08:00	14978	34673	49651	2569	52220	97911	53.33%	15.3%	62	64
15	桃園市龍潭區	2018-11-25T00:23:07+08:00	14167	32763	46930	2468	49398	92636	53.32%	15.29%	59	64
15	桃園市龍潭區	2018-11-24T23:51:39+08:00	13119	30501	43620	2294	45914	86093	53.33%	15.24%	55	64
15	桃園市龍潭區	2018-11-24T22:13:32+08:00	7536	17132	24668	1339	26007	48794	53.3%	15.44%	34	64
15	桃園市龍潭區	2018-11-25T01:17:57+08:00	14978	34673	49651	2569	52220	97911	53.33%	15.3%	62	64
15	桃園市龍潭區	2018-11-24T23:08:40+08:00	11166	25750	36916	1965	38881	73572	52.85%	15.18%	48	64
15	桃園市龍潭區	2018-11-24T22:57:58+08:00	10430	24105	34535	1829	36364	68749	52.89%	15.17%	45	64
15	桃園市龍潭區	2018-11-25T06:08:57+08:00	15518	36190	51708	2635	54343	101574	53.5%	15.28%	64	64
15	桃園市龍潭區	2018-11-24T22:54:29+08:00	10133	23529	33662	1753	35415	66661	53.13%	15.2%	44	64
15	桃園市龍潭區	2018-11-25T01:12:47+08:00	14978	34673	49651	2569	52220	97911	53.33%	15.3%	62	64
15	桃園市龍潭區	2018-11-24T22:16:14+08:00	7536	17132	24668	1339	26007	48794	53.3%	15.44%	34	64
15	桃園市龍潭區	2018-11-24T23:05:07+08:00	11166	25750	36916	1965	38881	73572	52.85%	15.18%	48	64
15	桃園市龍潭區	2018-11-25T04:02:56+08:00	15518	36190	51708	2635	54343	101574	53.5%	15.28%	64	64
15	桃園市龍潭區	2018-11-24T22:33:41+08:00	7990	18225	26215	1458	27673	51817	53.41%	15.42%	36	64
15	桃園市龍潭區	2018-11-24T23:47:32+08:00	13119	30501	43620	2294	45914	86093	53.33%	15.24%	55	64
15	桃園市龍潭區	2018-11-24T22:41:39+08:00	8482	19401	27883	1554	29437	55462	53.08%	15.29%	38	64
15	桃園市龍潭區	2018-11-25T00:05:09+08:00	13916	32099	46015	2415	48430	90844	53.31%	15.32%	58	64
15	桃園市龍潭區	2018-11-24T22:37:04+08:00	8252	18902	27154	1514	28668	53898	53.19%	15.31%	37	64
15	桃園市龍潭區	2018-11-24T22:50:52+08:00	9332	21385	30717	1640	32357	60938	53.1%	15.31%	41	64
15	桃園市龍潭區	2018-11-25T06:13:56+08:00	15518	36190	51708	2635	54343	101574	53.5%	15.28%	64	64
15	桃園市龍潭區	2018-11-24T22:26:40+08:00	7536	17132	24668	1339	26007	48794	53.3%	15.44%	34	64
15	桃園市龍潭區	2018-11-25T00:18:35+08:00	14167	32763	46930	2468	49398	92636	53.32%	15.29%	59	64
15	桃園市龍潭區	2018-11-24T22:40:31+08:00	8482	19401	27883	1554	29437	55462	53.08%	15.29%	38	64
15	桃園市龍潭區	2018-11-25T03:44:27+08:00	15518	36190	51708	2635	54343	101574	53.5%	15.28%	64	64
15	桃園市龍潭區	2018-11-25T00:57:41+08:00	14455	33437	47892	2503	50395	94333	53.42%	15.32%	60	64
15	桃園市龍潭區	2018-11-24T22:19:40+08:00	7536	17132	24668	1339	26007	48794	53.3%	15.44%	34	64
15	桃園市龍潭區	2018-11-25T01:02:34+08:00	14455	33437	47892	2503	50395	94333	53.42%	15.32%	60	64
15	桃園市龍潭區	2018-11-25T03:38:58+08:00	15518	36190	51708	2635	54343	101574	53.5%	15.28%	64	64
15	桃園市龍潭區	2018-11-24T23:23:42+08:00	11503	26465	37968	2025	39993	75481	52.98%	15.24%	49	64
15	桃園市龍潭區	2018-11-24T23:27:21+08:00	11503	26465	37968	2025	39993	75481	52.98%	15.24%	49	64
15	桃園市龍潭區	2018-11-24T23:55:50+08:00	13369	31142	44511	2339	46850	87814	53.35%	15.22%	56	64
15	桃園市龍潭區	2018-11-24T22:23:17+08:00	7536	17132	24668	1339	26007	48794	53.3%	15.44%	34	64
15	桃園市龍潭區	2018-11-24T23:19:55+08:00	11503	26465	37968	2025	39993	75481	52.98%	15.24%	49	64
15	桃園市龍潭區	2018-11-25T00:00:14+08:00	13369	31142	44511	2339	46850	87814	53.35%	15.22%	56	64
15	桃園市龍潭區	2018-11-25T01:07:30+08:00	14978	34673	49651	2569	52220	97911	53.33%	15.3%	62	64
15	桃園市龍潭區	2018-11-25T00:09:38+08:00	14167	32763	46930	2468	49398	92636	53.32%	15.29%	59	64
15	桃園市龍潭區	2018-11-24T23:35:14+08:00	12090	27946	40036	2152	42188	79470	53.09%	15.21%	51	64
15	桃園市龍潭區	2018-11-25T00:14:13+08:00	14167	32763	46930	2468	49398	92636	53.32%	15.29%	59	64
15	桃園市龍潭區	2018-11-24T23:01:35+08:00	10874	25179	36053	1928	37981	71816	52.89%	15.14%	47	64
15	桃園市龍潭區	2018-11-24T23:12:19+08:00	11166	25750	36916	1965	38881	73572	52.85%	15.18%	48	64
15	桃園市龍潭區	2018-11-24T23:31:15+08:00	11800	27194	38994	2077	41071	77483	53.01%	15.23%	50	64
15	桃園市龍潭區	2018-11-24T23:39:20+08:00	12388	28707	41095	2198	43293	81494	53.12%	15.2%	52	64
15	臺中市中區	2018-11-25T03:56:17+08:00	2487	5268	7755	485	8240	14696	56.07%	16.92%	12	12
15	臺中市中區	2018-11-24T23:16:06+08:00	2487	5268	7755	485	8240	14696	56.07%	16.92%	12	12
15	臺中市中區	2018-11-25T06:29:21+08:00	2487	5268	7755	485	8240	14696	56.07%	16.92%	12	12
15	臺中市中區	2018-11-25T03:49:55+08:00	2487	5268	7755	485	8240	14696	56.07%	16.92%	12	12
15	臺中市中區	2018-11-25T06:19:01+08:00	2487	5268	7755	485	8240	14696	56.07%	16.92%	12	12
15	臺中市中區	2018-11-24T23:43:20+08:00	2487	5268	7755	485	8240	14696	56.07%	16.92%	12	12
15	臺中市中區	2018-11-24T22:45:12+08:00	2487	5268	7755	485	8240	14696	56.07%	16.92%	12	12
15	臺中市中區	2018-11-24T22:30:13+08:00	2143	4666	6809	406	7215	13044	55.31%	16.43%	11	12
15	臺中市中區	2018-11-25T06:24:04+08:00	2487	5268	7755	485	8240	14696	56.07%	16.92%	12	12
15	臺中市中區	2018-11-25T03:32:38+08:00	2487	5268	7755	485	8240	14696	56.07%	16.92%	12	12
15	臺中市中區	2018-11-25T01:25:56+08:00	2487	5268	7755	485	8240	14696	56.07%	16.92%	12	12
15	臺中市中區	2018-11-25T00:23:07+08:00	2487	5268	7755	485	8240	14696	56.07%	16.92%	12	12
15	臺中市中區	2018-11-24T23:51:39+08:00	2487	5268	7755	485	8240	14696	56.07%	16.92%	12	12
15	臺中市中區	2018-11-24T23:27:22+08:00	2487	5268	7755	485	8240	14696	56.07%	16.92%	12	12
15	臺中市中區	2018-11-24T22:13:32+08:00	2143	4666	6809	406	7215	13044	55.31%	16.43%	11	12
15	臺中市中區	2018-11-25T01:17:57+08:00	2487	5268	7755	485	8240	14696	56.07%	16.92%	12	12
15	臺中市中區	2018-11-24T23:08:40+08:00	2487	5268	7755	485	8240	14696	56.07%	16.92%	12	12
15	臺中市中區	2018-11-24T22:57:58+08:00	2487	5268	7755	485	8240	14696	56.07%	16.92%	12	12
15	臺中市中區	2018-11-25T06:08:57+08:00	2487	5268	7755	485	8240	14696	56.07%	16.92%	12	12
15	臺中市中區	2018-11-24T22:54:29+08:00	2487	5268	7755	485	8240	14696	56.07%	16.92%	12	12
15	臺中市中區	2018-11-24T22:16:14+08:00	2143	4666	6809	406	7215	13044	55.31%	16.43%	11	12
15	臺中市中區	2018-11-25T04:02:56+08:00	2487	5268	7755	485	8240	14696	56.07%	16.92%	12	12
15	臺中市中區	2018-11-25T01:12:48+08:00	2487	5268	7755	485	8240	14696	56.07%	16.92%	12	12
15	臺中市中區	2018-11-24T22:33:41+08:00	2487	5268	7755	485	8240	14696	56.07%	16.92%	12	12
15	臺中市中區	2018-11-24T23:05:08+08:00	2487	5268	7755	485	8240	14696	56.07%	16.92%	12	12
15	臺中市中區	2018-11-24T23:47:32+08:00	2487	5268	7755	485	8240	14696	56.07%	16.92%	12	12
15	臺中市中區	2018-11-24T22:41:39+08:00	2487	5268	7755	485	8240	14696	56.07%	16.92%	12	12
15	臺中市中區	2018-11-25T00:05:09+08:00	2487	5268	7755	485	8240	14696	56.07%	16.92%	12	12
15	臺中市中區	2018-11-24T22:37:04+08:00	2487	5268	7755	485	8240	14696	56.07%	16.92%	12	12
15	臺中市中區	2018-11-24T22:50:52+08:00	2487	5268	7755	485	8240	14696	56.07%	16.92%	12	12
15	臺中市中區	2018-11-25T06:13:56+08:00	2487	5268	7755	485	8240	14696	56.07%	16.92%	12	12
15	臺中市中區	2018-11-24T22:26:40+08:00	2143	4666	6809	406	7215	13044	55.31%	16.43%	11	12
15	臺中市中區	2018-11-25T00:18:35+08:00	2487	5268	7755	485	8240	14696	56.07%	16.92%	12	12
15	臺中市中區	2018-11-24T22:40:31+08:00	2487	5268	7755	485	8240	14696	56.07%	16.92%	12	12
15	臺中市中區	2018-11-25T01:02:35+08:00	2487	5268	7755	485	8240	14696	56.07%	16.92%	12	12
15	臺中市中區	2018-11-25T00:57:41+08:00	2487	5268	7755	485	8240	14696	56.07%	16.92%	12	12
15	臺中市中區	2018-11-24T22:19:40+08:00	2143	4666	6809	406	7215	13044	55.31%	16.43%	11	12
15	臺中市中區	2018-11-25T03:38:58+08:00	2487	5268	7755	485	8240	14696	56.07%	16.92%	12	12
15	臺中市中區	2018-11-25T03:44:28+08:00	2487	5268	7755	485	8240	14696	56.07%	16.92%	12	12
15	臺中市中區	2018-11-24T23:23:42+08:00	2487	5268	7755	485	8240	14696	56.07%	16.92%	12	12
15	臺中市中區	2018-11-24T22:23:17+08:00	2143	4666	6809	406	7215	13044	55.31%	16.43%	11	12
15	臺中市中區	2018-11-24T23:19:55+08:00	2487	5268	7755	485	8240	14696	56.07%	16.92%	12	12
15	臺中市中區	2018-11-24T23:55:51+08:00	2487	5268	7755	485	8240	14696	56.07%	16.92%	12	12
15	臺中市中區	2018-11-25T00:00:14+08:00	2487	5268	7755	485	8240	14696	56.07%	16.92%	12	12
15	臺中市中區	2018-11-24T23:39:21+08:00	2487	5268	7755	485	8240	14696	56.07%	16.92%	12	12
15	臺中市中區	2018-11-25T01:07:30+08:00	2487	5268	7755	485	8240	14696	56.07%	16.92%	12	12
15	臺中市中區	2018-11-25T00:09:38+08:00	2487	5268	7755	485	8240	14696	56.07%	16.92%	12	12
15	臺中市中區	2018-11-24T23:35:14+08:00	2487	5268	7755	485	8240	14696	56.07%	16.92%	12	12
15	臺中市中區	2018-11-25T00:14:13+08:00	2487	5268	7755	485	8240	14696	56.07%	16.92%	12	12
15	臺中市中區	2018-11-24T23:01:35+08:00	2487	5268	7755	485	8240	14696	56.07%	16.92%	12	12
15	臺中市中區	2018-11-24T23:12:19+08:00	2487	5268	7755	485	8240	14696	56.07%	16.92%	12	12
15	臺中市中區	2018-11-24T23:31:15+08:00	2487	5268	7755	485	8240	14696	56.07%	16.92%	12	12
15	臺中市大甲區	2018-11-25T03:56:17+08:00	10769	23336	34105	2368	36473	63069	57.83%	17.07%	54	54
15	臺中市大甲區	2018-11-25T06:29:21+08:00	10769	23336	34105	2368	36473	63069	57.83%	17.07%	54	54
15	臺中市大甲區	2018-11-25T03:49:55+08:00	10769	23336	34105	2368	36473	63069	57.83%	17.07%	54	54
15	臺中市大甲區	2018-11-25T06:19:01+08:00	10769	23336	34105	2368	36473	63069	57.83%	17.07%	54	54
15	臺中市大甲區	2018-11-24T23:16:07+08:00	10769	23336	34105	2368	36473	63069	57.83%	17.07%	54	54
15	臺中市大甲區	2018-11-24T22:45:12+08:00	9876	22247	32123	2275	34398	59537	57.78%	16.59%	52	54
15	臺中市大甲區	2018-11-24T23:43:21+08:00	10769	23336	34105	2368	36473	63069	57.83%	17.07%	54	54
15	臺中市大甲區	2018-11-24T22:41:40+08:00	9876	22247	32123	2275	34398	59537	57.78%	16.59%	52	54
15	臺中市大甲區	2018-11-25T01:25:57+08:00	10769	23336	34105	2368	36473	63069	57.83%	17.07%	54	54
15	臺中市大甲區	2018-11-24T22:30:14+08:00	9876	22247	32123	2275	34398	59537	57.78%	16.59%	52	54
15	臺中市大甲區	2018-11-25T06:24:04+08:00	10769	23336	34105	2368	36473	63069	57.83%	17.07%	54	54
15	臺中市大甲區	2018-11-25T00:23:07+08:00	10769	23336	34105	2368	36473	63069	57.83%	17.07%	54	54
15	臺中市大甲區	2018-11-25T03:32:39+08:00	10769	23336	34105	2368	36473	63069	57.83%	17.07%	54	54
15	臺中市大甲區	2018-11-24T23:51:39+08:00	10769	23336	34105	2368	36473	63069	57.83%	17.07%	54	54
15	臺中市大甲區	2018-11-24T23:27:22+08:00	10769	23336	34105	2368	36473	63069	57.83%	17.07%	54	54
15	臺中市大甲區	2018-11-24T22:13:32+08:00	9664	21772	31436	2235	33671	58370	57.69%	16.56%	51	54
15	臺中市大甲區	2018-11-24T23:08:41+08:00	10769	23336	34105	2368	36473	63069	57.83%	17.07%	54	54
15	臺中市大甲區	2018-11-24T22:57:58+08:00	10147	22870	33017	2331	35348	61135	57.82%	16.6%	53	54
15	臺中市大甲區	2018-11-24T23:19:56+08:00	10769	23336	34105	2368	36473	63069	57.83%	17.07%	54	54
15	臺中市大甲區	2018-11-25T01:17:58+08:00	10769	23336	34105	2368	36473	63069	57.83%	17.07%	54	54
15	臺中市大甲區	2018-11-24T22:54:29+08:00	10147	22870	33017	2331	35348	61135	57.82%	16.6%	53	54
15	臺中市大甲區	2018-11-24T23:47:33+08:00	10769	23336	34105	2368	36473	63069	57.83%	17.07%	54	54
15	臺中市大甲區	2018-11-25T04:02:56+08:00	10769	23336	34105	2368	36473	63069	57.83%	17.07%	54	54
15	臺中市大甲區	2018-11-25T06:08:58+08:00	10769	23336	34105	2368	36473	63069	57.83%	17.07%	54	54
15	臺中市大甲區	2018-11-24T22:16:15+08:00	9664	21772	31436	2235	33671	58370	57.69%	16.56%	51	54
15	臺中市大甲區	2018-11-24T23:31:16+08:00	10769	23336	34105	2368	36473	63069	57.83%	17.07%	54	54
15	臺中市大甲區	2018-11-25T01:12:48+08:00	10769	23336	34105	2368	36473	63069	57.83%	17.07%	54	54
15	臺中市大甲區	2018-11-24T23:05:08+08:00	10769	23336	34105	2368	36473	63069	57.83%	17.07%	54	54
15	臺中市大甲區	2018-11-25T00:05:09+08:00	10769	23336	34105	2368	36473	63069	57.83%	17.07%	54	54
15	臺中市大甲區	2018-11-24T22:37:04+08:00	9876	22247	32123	2275	34398	59537	57.78%	16.59%	52	54
15	臺中市大甲區	2018-11-24T22:50:52+08:00	9876	22247	32123	2275	34398	59537	57.78%	16.59%	52	54
15	臺中市大甲區	2018-11-25T06:13:56+08:00	10769	23336	34105	2368	36473	63069	57.83%	17.07%	54	54
15	臺中市大甲區	2018-11-24T22:26:40+08:00	9876	22247	32123	2275	34398	59537	57.78%	16.59%	52	54
15	臺中市大甲區	2018-11-25T00:18:35+08:00	10769	23336	34105	2368	36473	63069	57.83%	17.07%	54	54
15	臺中市大甲區	2018-11-24T22:19:41+08:00	9664	21772	31436	2235	33671	58370	57.69%	16.56%	51	54
15	臺中市大甲區	2018-11-25T03:38:59+08:00	10769	23336	34105	2368	36473	63069	57.83%	17.07%	54	54
15	臺中市大甲區	2018-11-24T22:40:31+08:00	9876	22247	32123	2275	34398	59537	57.78%	16.59%	52	54
15	臺中市大甲區	2018-11-25T01:02:35+08:00	10769	23336	34105	2368	36473	63069	57.83%	17.07%	54	54
15	臺中市大甲區	2018-11-25T00:57:41+08:00	10769	23336	34105	2368	36473	63069	57.83%	17.07%	54	54
15	臺中市大甲區	2018-11-25T03:44:28+08:00	10769	23336	34105	2368	36473	63069	57.83%	17.07%	54	54
15	臺中市大甲區	2018-11-24T23:23:42+08:00	10769	23336	34105	2368	36473	63069	57.83%	17.07%	54	54
15	臺中市大甲區	2018-11-24T22:23:18+08:00	9876	22247	32123	2275	34398	59537	57.78%	16.59%	52	54
15	臺中市大甲區	2018-11-25T00:00:15+08:00	10769	23336	34105	2368	36473	63069	57.83%	17.07%	54	54
15	臺中市大甲區	2018-11-24T23:55:51+08:00	10769	23336	34105	2368	36473	63069	57.83%	17.07%	54	54
15	臺中市大甲區	2018-11-24T23:39:21+08:00	10769	23336	34105	2368	36473	63069	57.83%	17.07%	54	54
15	臺中市大甲區	2018-11-25T01:07:30+08:00	10769	23336	34105	2368	36473	63069	57.83%	17.07%	54	54
15	臺中市大甲區	2018-11-24T23:12:20+08:00	10769	23336	34105	2368	36473	63069	57.83%	17.07%	54	54
15	臺中市大甲區	2018-11-24T23:35:14+08:00	10769	23336	34105	2368	36473	63069	57.83%	17.07%	54	54
15	臺中市大甲區	2018-11-25T00:14:14+08:00	10769	23336	34105	2368	36473	63069	57.83%	17.07%	54	54
15	臺中市大甲區	2018-11-24T23:01:35+08:00	10147	22870	33017	2331	35348	61135	57.82%	16.6%	53	54
15	臺中市大甲區	2018-11-25T00:09:39+08:00	10769	23336	34105	2368	36473	63069	57.83%	17.07%	54	54
15	臺中市大甲區	2018-11-24T22:33:42+08:00	9876	22247	32123	2275	34398	59537	57.78%	16.59%	52	54
15	雲林縣二崙鄉	2018-11-25T00:05:14+08:00	3275	6738	10013	1146	11159	23367	47.76%	14.02%	23	23
15	雲林縣二崙鄉	2018-11-25T00:09:45+08:00	3275	6738	10013	1146	11159	23367	47.76%	14.02%	23	23
15	雲林縣二崙鄉	2018-11-25T01:12:55+08:00	3275	6738	10013	1146	11159	23367	47.76%	14.02%	23	23
15	雲林縣二崙鄉	2018-11-24T22:41:46+08:00	3140	6425	9565	1092	10657	22518	47.33%	13.94%	22	23
15	雲林縣二崙鄉	2018-11-25T06:29:27+08:00	3275	6738	10013	1146	11159	23367	47.76%	14.02%	23	23
15	雲林縣二崙鄉	2018-11-24T23:05:13+08:00	3275	6738	10013	1146	11159	23367	47.76%	14.02%	23	23
15	雲林縣二崙鄉	2018-11-25T06:19:07+08:00	3275	6738	10013	1146	11159	23367	47.76%	14.02%	23	23
15	雲林縣二崙鄉	2018-11-24T22:26:45+08:00	2990	6137	9127	1025	10152	21500	47.22%	13.91%	21	23
15	雲林縣二崙鄉	2018-11-24T22:54:34+08:00	3275	6738	10013	1146	11159	23367	47.76%	14.02%	23	23
15	雲林縣二崙鄉	2018-11-24T23:43:26+08:00	3275	6738	10013	1146	11159	23367	47.76%	14.02%	23	23
15	雲林縣二崙鄉	2018-11-24T22:50:59+08:00	3275	6738	10013	1146	11159	23367	47.76%	14.02%	23	23
15	雲林縣二崙鄉	2018-11-25T00:00:20+08:00	3275	6738	10013	1146	11159	23367	47.76%	14.02%	23	23
15	雲林縣二崙鄉	2018-11-25T00:23:13+08:00	3275	6738	10013	1146	11159	23367	47.76%	14.02%	23	23
15	雲林縣二崙鄉	2018-11-25T03:32:48+08:00	3275	6738	10013	1146	11159	23367	47.76%	14.02%	23	23
15	雲林縣二崙鄉	2018-11-25T03:44:36+08:00	3275	6738	10013	1146	11159	23367	47.76%	14.02%	23	23
15	雲林縣二崙鄉	2018-11-24T23:08:47+08:00	3275	6738	10013	1146	11159	23367	47.76%	14.02%	23	23
15	雲林縣二崙鄉	2018-11-24T22:23:24+08:00	2796	5760	8556	962	9518	20339	46.8%	13.75%	20	23
15	雲林縣二崙鄉	2018-11-25T06:24:10+08:00	3275	6738	10013	1146	11159	23367	47.76%	14.02%	23	23
15	雲林縣二崙鄉	2018-11-25T01:02:40+08:00	3275	6738	10013	1146	11159	23367	47.76%	14.02%	23	23
15	雲林縣二崙鄉	2018-11-24T23:23:47+08:00	3275	6738	10013	1146	11159	23367	47.76%	14.02%	23	23
15	雲林縣二崙鄉	2018-11-25T03:50:00+08:00	3275	6738	10013	1146	11159	23367	47.76%	14.02%	23	23
15	雲林縣二崙鄉	2018-11-24T22:33:47+08:00	3140	6425	9565	1092	10657	22518	47.33%	13.94%	22	23
15	雲林縣二崙鄉	2018-11-25T01:26:03+08:00	3275	6738	10013	1146	11159	23367	47.76%	14.02%	23	23
15	雲林縣二崙鄉	2018-11-25T03:39:04+08:00	3275	6738	10013	1146	11159	23367	47.76%	14.02%	23	23
15	雲林縣二崙鄉	2018-11-25T00:14:19+08:00	3275	6738	10013	1146	11159	23367	47.76%	14.02%	23	23
15	雲林縣二崙鄉	2018-11-24T23:16:12+08:00	3275	6738	10013	1146	11159	23367	47.76%	14.02%	23	23
15	雲林縣二崙鄉	2018-11-24T23:35:19+08:00	3275	6738	10013	1146	11159	23367	47.76%	14.02%	23	23
15	雲林縣二崙鄉	2018-11-24T22:45:17+08:00	3140	6425	9565	1092	10657	22518	47.33%	13.94%	22	23
15	雲林縣二崙鄉	2018-11-25T01:18:05+08:00	3275	6738	10013	1146	11159	23367	47.76%	14.02%	23	23
15	雲林縣二崙鄉	2018-11-25T03:56:24+08:00	3275	6738	10013	1146	11159	23367	47.76%	14.02%	23	23
15	雲林縣二崙鄉	2018-11-24T22:58:04+08:00	3275	6738	10013	1146	11159	23367	47.76%	14.02%	23	23
15	雲林縣二崙鄉	2018-11-24T23:01:42+08:00	3275	6738	10013	1146	11159	23367	47.76%	14.02%	23	23
15	雲林縣二崙鄉	2018-11-25T00:57:47+08:00	3275	6738	10013	1146	11159	23367	47.76%	14.02%	23	23
15	雲林縣二崙鄉	2018-11-24T22:19:46+08:00	2546	5285	7831	894	8725	18601	46.91%	13.69%	19	23
15	雲林縣二崙鄉	2018-11-24T22:13:41+08:00	2546	5285	7831	894	8725	18601	46.91%	13.69%	19	23
15	雲林縣二崙鄉	2018-11-25T04:03:02+08:00	3275	6738	10013	1146	11159	23367	47.76%	14.02%	23	23
15	雲林縣二崙鄉	2018-11-24T22:30:19+08:00	2990	6137	9127	1025	10152	21500	47.22%	13.91%	21	23
15	雲林縣二崙鄉	2018-11-24T22:40:37+08:00	3140	6425	9565	1092	10657	22518	47.33%	13.94%	22	23
15	雲林縣二崙鄉	2018-11-24T23:51:45+08:00	3275	6738	10013	1146	11159	23367	47.76%	14.02%	23	23
15	雲林縣二崙鄉	2018-11-25T06:09:05+08:00	3275	6738	10013	1146	11159	23367	47.76%	14.02%	23	23
15	雲林縣二崙鄉	2018-11-24T23:55:57+08:00	3275	6738	10013	1146	11159	23367	47.76%	14.02%	23	23
15	雲林縣二崙鄉	2018-11-24T23:27:27+08:00	3275	6738	10013	1146	11159	23367	47.76%	14.02%	23	23
15	雲林縣二崙鄉	2018-11-25T06:14:02+08:00	3275	6738	10013	1146	11159	23367	47.76%	14.02%	23	23
15	雲林縣二崙鄉	2018-11-24T23:47:39+08:00	3275	6738	10013	1146	11159	23367	47.76%	14.02%	23	23
15	雲林縣二崙鄉	2018-11-25T00:18:43+08:00	3275	6738	10013	1146	11159	23367	47.76%	14.02%	23	23
15	雲林縣二崙鄉	2018-11-24T22:16:21+08:00	2546	5285	7831	894	8725	18601	46.91%	13.69%	19	23
15	雲林縣二崙鄉	2018-11-24T23:12:27+08:00	3275	6738	10013	1146	11159	23367	47.76%	14.02%	23	23
15	雲林縣二崙鄉	2018-11-24T23:39:28+08:00	3275	6738	10013	1146	11159	23367	47.76%	14.02%	23	23
15	雲林縣二崙鄉	2018-11-24T22:37:10+08:00	3140	6425	9565	1092	10657	22518	47.33%	13.94%	22	23
15	雲林縣二崙鄉	2018-11-24T23:31:23+08:00	3275	6738	10013	1146	11159	23367	47.76%	14.02%	23	23
15	雲林縣二崙鄉	2018-11-24T23:20:02+08:00	3275	6738	10013	1146	11159	23367	47.76%	14.02%	23	23
15	雲林縣二崙鄉	2018-11-25T01:07:36+08:00	3275	6738	10013	1146	11159	23367	47.76%	14.02%	23	23
15	雲林縣斗六市	2018-11-25T00:05:14+08:00	12526	27179	39705	2017	41722	72164	57.82%	17.36%	58	69
15	雲林縣斗六市	2018-11-25T06:19:06+08:00	15497	33537	49034	2528	51562	89761	57.44%	17.26%	69	69
15	雲林縣斗六市	2018-11-25T00:09:45+08:00	12939	28137	41076	2129	43205	74719	57.82%	17.32%	60	69
15	雲林縣斗六市	2018-11-24T22:41:46+08:00	8534	18684	27218	1418	28636	49607	57.73%	17.2%	42	69
15	雲林縣斗六市	2018-11-24T22:37:09+08:00	8534	18684	27218	1418	28636	49607	57.73%	17.2%	42	69
15	雲林縣斗六市	2018-11-25T06:29:27+08:00	15497	33537	49034	2528	51562	89761	57.44%	17.26%	69	69
15	雲林縣斗六市	2018-11-24T23:05:13+08:00	10029	21731	31760	1618	33378	57736	57.81%	17.37%	48	69
15	雲林縣斗六市	2018-11-24T23:01:41+08:00	9874	21322	31196	1587	32783	56549	57.97%	17.46%	47	69
15	雲林縣斗六市	2018-11-24T22:26:45+08:00	7437	16263	23700	1252	24952	43203	57.76%	17.21%	38	69
15	雲林縣斗六市	2018-11-24T22:54:34+08:00	9265	20213	29478	1510	30988	53588	57.83%	17.29%	45	69
15	雲林縣斗六市	2018-11-25T01:12:54+08:00	15497	33537	49034	2528	51562	89761	57.44%	17.26%	69	69
15	雲林縣斗六市	2018-11-24T23:43:26+08:00	12230	26419	38649	1961	40610	70114	57.92%	17.44%	56	69
15	雲林縣斗六市	2018-11-24T22:50:59+08:00	9265	20213	29478	1510	30988	53588	57.83%	17.29%	45	69
15	雲林縣斗六市	2018-11-25T00:00:20+08:00	12361	26808	39169	1995	41164	71237	57.78%	17.35%	57	69
15	雲林縣斗六市	2018-11-25T00:23:13+08:00	14050	30646	44696	2356	47052	81661	57.62%	17.21%	64	69
15	雲林縣斗六市	2018-11-25T03:44:36+08:00	15497	33537	49034	2528	51562	89761	57.44%	17.26%	69	69
15	雲林縣斗六市	2018-11-24T23:08:47+08:00	10286	22283	32569	1646	34215	59090	57.9%	17.41%	49	69
15	雲林縣斗六市	2018-11-24T22:23:24+08:00	7437	16263	23700	1252	24952	43203	57.76%	17.21%	38	69
15	雲林縣斗六市	2018-11-25T01:02:40+08:00	15497	33537	49034	2528	51562	89761	57.44%	17.26%	69	69
15	雲林縣斗六市	2018-11-25T06:14:01+08:00	15497	33537	49034	2528	51562	89761	57.44%	17.26%	69	69
15	雲林縣斗六市	2018-11-25T03:32:47+08:00	15497	33537	49034	2528	51562	89761	57.44%	17.26%	69	69
15	雲林縣斗六市	2018-11-24T23:23:47+08:00	11119	24021	35140	1785	36925	63940	57.75%	17.39%	52	69
15	雲林縣斗六市	2018-11-25T03:50:00+08:00	15497	33537	49034	2528	51562	89761	57.44%	17.26%	69	69
15	雲林縣斗六市	2018-11-24T22:33:47+08:00	8287	18134	26421	1397	27818	48019	57.93%	17.26%	41	69
15	雲林縣斗六市	2018-11-25T03:39:03+08:00	15497	33537	49034	2528	51562	89761	57.44%	17.26%	69	69
15	雲林縣斗六市	2018-11-25T01:26:02+08:00	15497	33537	49034	2528	51562	89761	57.44%	17.26%	69	69
15	雲林縣斗六市	2018-11-24T23:20:01+08:00	10837	23533	34370	1746	36116	62522	57.77%	17.33%	51	69
15	雲林縣斗六市	2018-11-25T00:14:19+08:00	12939	28137	41076	2129	43205	74719	57.82%	17.32%	60	69
15	雲林縣斗六市	2018-11-24T23:16:12+08:00	10635	23041	33676	1714	35390	61261	57.77%	17.36%	50	69
15	雲林縣斗六市	2018-11-24T23:35:19+08:00	12026	26021	38047	1905	39952	69003	57.9%	17.43%	55	69
15	雲林縣斗六市	2018-11-24T22:45:17+08:00	8774	19174	27948	1457	29405	51077	57.57%	17.18%	43	69
15	雲林縣斗六市	2018-11-25T01:18:05+08:00	15497	33537	49034	2528	51562	89761	57.44%	17.26%	69	69
15	雲林縣斗六市	2018-11-25T03:56:23+08:00	15497	33537	49034	2528	51562	89761	57.44%	17.26%	69	69
15	雲林縣斗六市	2018-11-24T22:58:04+08:00	9617	20877	30494	1559	32053	55335	57.93%	17.38%	46	69
15	雲林縣斗六市	2018-11-25T00:57:47+08:00	15497	33537	49034	2528	51562	89761	57.44%	17.26%	69	69
15	雲林縣斗六市	2018-11-24T22:19:46+08:00	7273	15839	23112	1220	24332	42057	57.85%	17.29%	37	69
15	雲林縣斗六市	2018-11-25T06:24:09+08:00	15497	33537	49034	2528	51562	89761	57.44%	17.26%	69	69
15	雲林縣斗六市	2018-11-25T04:03:02+08:00	15497	33537	49034	2528	51562	89761	57.44%	17.26%	69	69
15	雲林縣斗六市	2018-11-25T06:09:04+08:00	15497	33537	49034	2528	51562	89761	57.44%	17.26%	69	69
15	雲林縣斗六市	2018-11-24T22:40:36+08:00	8534	18684	27218	1418	28636	49607	57.73%	17.2%	42	69
15	雲林縣斗六市	2018-11-24T22:30:19+08:00	7437	16263	23700	1252	24952	43203	57.76%	17.21%	38	69
15	雲林縣斗六市	2018-11-24T22:13:40+08:00	7066	15450	22516	1198	23714	40960	57.9%	17.25%	36	69
15	雲林縣斗六市	2018-11-24T23:51:45+08:00	12230	26419	38649	1961	40610	70114	57.92%	17.44%	56	69
15	雲林縣斗六市	2018-11-24T23:27:27+08:00	11384	24571	35955	1810	37765	65352	57.79%	17.42%	53	69
15	雲林縣斗六市	2018-11-24T23:55:56+08:00	12230	26419	38649	1961	40610	70114	57.92%	17.44%	56	69
15	雲林縣斗六市	2018-11-24T23:47:39+08:00	12230	26419	38649	1961	40610	70114	57.92%	17.44%	56	69
15	雲林縣斗六市	2018-11-24T23:31:22+08:00	12026	26021	38047	1905	39952	69003	57.9%	17.43%	55	69
15	雲林縣斗六市	2018-11-24T22:16:21+08:00	7273	15839	23112	1220	24332	42057	57.85%	17.29%	37	69
15	雲林縣斗六市	2018-11-25T00:18:42+08:00	13839	30161	44000	2325	46325	80468	57.57%	17.2%	63	69
15	雲林縣斗六市	2018-11-24T23:12:26+08:00	10286	22283	32569	1646	34215	59090	57.9%	17.41%	49	69
15	雲林縣斗六市	2018-11-24T23:39:27+08:00	12230	26419	38649	1961	40610	70114	57.92%	17.44%	56	69
15	雲林縣斗六市	2018-11-25T01:07:36+08:00	15497	33537	49034	2528	51562	89761	57.44%	17.26%	69	69
15	新竹縣新豐鄉	2018-11-24T22:26:43+08:00	3329	7708	11037	535	11572	20815	55.59%	15.99%	19	39
15	新竹縣新豐鄉	2018-11-25T00:09:42+08:00	6888	16177	23065	1176	24241	43265	56.03%	15.92%	37	39
15	新竹縣新豐鄉	2018-11-25T03:56:21+08:00	7296	17099	24395	1239	25634	45790	55.98%	15.93%	39	39
15	新竹縣新豐鄉	2018-11-25T01:12:52+08:00	7296	17099	24395	1239	25634	45790	55.98%	15.93%	39	39
15	新竹縣新豐鄉	2018-11-24T22:54:32+08:00	4628	10558	15186	784	15970	28724	55.6%	16.11%	26	39
15	新竹縣新豐鄉	2018-11-24T22:50:56+08:00	4628	10558	15186	784	15970	28724	55.6%	16.11%	26	39
15	新竹縣新豐鄉	2018-11-25T00:05:12+08:00	6635	15648	22283	1146	23429	41822	56.02%	15.86%	36	39
15	新竹縣新豐鄉	2018-11-24T22:37:08+08:00	4304	9756	14060	722	14782	26444	55.9%	16.28%	24	39
15	新竹縣新豐鄉	2018-11-24T22:45:15+08:00	4445	10149	14594	765	15359	27507	55.84%	16.16%	25	39
15	新竹縣新豐鄉	2018-11-25T01:02:38+08:00	7296	17099	24395	1239	25634	45790	55.98%	15.93%	39	39
15	新竹縣新豐鄉	2018-11-24T22:40:34+08:00	4445	10149	14594	765	15359	27507	55.84%	16.16%	25	39
15	新竹縣新豐鄉	2018-11-25T04:03:00+08:00	7296	17099	24395	1239	25634	45790	55.98%	15.93%	39	39
15	新竹縣新豐鄉	2018-11-25T00:57:45+08:00	7296	17099	24395	1239	25634	45790	55.98%	15.93%	39	39
15	新竹縣新豐鄉	2018-11-24T22:19:44+08:00	3329	7708	11037	535	11572	20815	55.59%	15.99%	19	39
15	新竹縣新豐鄉	2018-11-25T00:00:18+08:00	6428	15079	21507	1120	22627	40366	56.05%	15.92%	35	39
15	新竹縣新豐鄉	2018-11-24T23:55:54+08:00	6428	15079	21507	1120	22627	40366	56.05%	15.92%	35	39
15	新竹縣新豐鄉	2018-11-24T23:27:25+08:00	6315	14459	20774	1081	21855	38880	56.21%	16.24%	34	39
15	新竹縣新豐鄉	2018-11-24T22:23:22+08:00	3329	7708	11037	535	11572	20815	55.59%	15.99%	19	39
15	新竹縣新豐鄉	2018-11-24T23:01:39+08:00	4960	11399	16359	881	17240	31010	55.59%	15.99%	28	39
15	新竹縣新豐鄉	2018-11-25T01:07:33+08:00	7296	17099	24395	1239	25634	45790	55.98%	15.93%	39	39
15	新竹縣新豐鄉	2018-11-24T23:39:25+08:00	6315	14459	20774	1081	21855	38880	56.21%	16.24%	34	39
15	新竹縣新豐鄉	2018-11-24T23:20:00+08:00	5864	13414	19278	1049	20327	36307	55.99%	16.15%	32	39
15	新竹縣新豐鄉	2018-11-24T23:12:24+08:00	5350	12243	17593	981	18574	33343	55.71%	16.05%	30	39
15	新竹縣新豐鄉	2018-11-25T00:18:40+08:00	7055	16551	23606	1219	24825	44345	55.98%	15.91%	38	39
15	新竹縣新豐鄉	2018-11-25T03:39:02+08:00	7296	17099	24395	1239	25634	45790	55.98%	15.93%	39	39
15	新竹縣新豐鄉	2018-11-24T23:31:20+08:00	6315	14459	20774	1081	21855	38880	56.21%	16.24%	34	39
15	新竹縣新豐鄉	2018-11-24T23:35:17+08:00	6315	14459	20774	1081	21855	38880	56.21%	16.24%	34	39
15	新竹縣新豐鄉	2018-11-25T00:14:17+08:00	7055	16551	23606	1219	24825	44345	55.98%	15.91%	38	39
15	新竹縣新豐鄉	2018-11-24T23:43:24+08:00	6315	14459	20774	1081	21855	38880	56.21%	16.24%	34	39
15	新竹縣新豐鄉	2018-11-24T22:58:02+08:00	4765	10918	15683	847	16530	29753	55.56%	16.02%	27	39
15	新竹縣新豐鄉	2018-11-25T03:49:58+08:00	7296	17099	24395	1239	25634	45790	55.98%	15.93%	39	39
15	新竹縣新豐鄉	2018-11-25T01:18:02+08:00	7296	17099	24395	1239	25634	45790	55.98%	15.93%	39	39
15	新竹縣新豐鄉	2018-11-25T06:29:25+08:00	7296	17099	24395	1239	25634	45790	55.98%	15.93%	39	39
15	新竹縣新豐鄉	2018-11-24T23:05:11+08:00	5130	11850	16980	929	17909	32077	55.83%	15.99%	29	39
15	新竹縣新豐鄉	2018-11-25T06:13:59+08:00	7296	17099	24395	1239	25634	45790	55.98%	15.93%	39	39
15	新竹縣新豐鄉	2018-11-24T22:41:44+08:00	4445	10149	14594	765	15359	27507	55.84%	16.16%	25	39
15	新竹縣新豐鄉	2018-11-25T06:19:04+08:00	7296	17099	24395	1239	25634	45790	55.98%	15.93%	39	39
15	新竹縣新豐鄉	2018-11-24T22:30:17+08:00	3585	8241	11826	590	12416	22292	55.7%	16.08%	20	39
15	新竹縣新豐鄉	2018-11-25T06:24:08+08:00	7296	17099	24395	1239	25634	45790	55.98%	15.93%	39	39
15	新竹縣新豐鄉	2018-11-24T23:51:42+08:00	6428	15079	21507	1120	22627	40366	56.05%	15.92%	35	39
15	新竹縣新豐鄉	2018-11-25T06:09:02+08:00	7296	17099	24395	1239	25634	45790	55.98%	15.93%	39	39
15	新竹縣新豐鄉	2018-11-24T23:23:45+08:00	6315	14459	20774	1081	21855	38880	56.21%	16.24%	34	39
15	新竹縣新豐鄉	2018-11-25T03:44:32+08:00	7296	17099	24395	1239	25634	45790	55.98%	15.93%	39	39
15	新竹縣新豐鄉	2018-11-25T03:32:45+08:00	7296	17099	24395	1239	25634	45790	55.98%	15.93%	39	39
15	新竹縣新豐鄉	2018-11-24T22:13:38+08:00	2964	6878	9842	479	10321	18457	55.92%	16.06%	17	39
15	新竹縣新豐鄉	2018-11-24T23:08:45+08:00	5130	11850	16980	929	17909	32077	55.83%	15.99%	29	39
15	新竹縣新豐鄉	2018-11-25T00:23:11+08:00	7055	16551	23606	1219	24825	44345	55.98%	15.91%	38	39
15	新竹縣新豐鄉	2018-11-24T23:16:10+08:00	5559	12787	18346	1015	19361	34645	55.88%	16.05%	31	39
15	新竹縣新豐鄉	2018-11-24T23:47:37+08:00	6315	14459	20774	1081	21855	38880	56.21%	16.24%	34	39
15	新竹縣新豐鄉	2018-11-24T22:16:19+08:00	3174	7317	10491	511	11002	19726	55.77%	16.09%	18	39
15	新竹縣新豐鄉	2018-11-25T01:26:00+08:00	7296	17099	24395	1239	25634	45790	55.98%	15.93%	39	39
15	新竹縣新豐鄉	2018-11-24T22:33:45+08:00	4132	9388	13520	687	14207	25441	55.84%	16.24%	23	39
15	基隆市中山區	2018-11-24T23:47:44+08:00	6575	12686	19261	1081	20342	39910	50.97%	16.47%	34	35
15	基隆市中山區	2018-11-24T22:58:09+08:00	6231	12155	18386	1052	19438	38033	51.11%	16.38%	33	35
15	基隆市中山區	2018-11-25T03:56:29+08:00	6929	13362	20291	1097	21388	41856	51.1%	16.55%	35	35
15	基隆市中山區	2018-11-24T23:01:46+08:00	6231	12155	18386	1052	19438	38033	51.11%	16.38%	33	35
15	基隆市中山區	2018-11-25T03:32:53+08:00	6929	13362	20291	1097	21388	41856	51.1%	16.55%	35	35
15	基隆市中山區	2018-11-24T23:08:52+08:00	6231	12155	18386	1052	19438	38033	51.11%	16.38%	33	35
15	基隆市中山區	2018-11-24T23:51:49+08:00	6929	13362	20291	1097	21388	41856	51.1%	16.55%	35	35
15	基隆市中山區	2018-11-25T03:44:41+08:00	6929	13362	20291	1097	21388	41856	51.1%	16.55%	35	35
15	基隆市中山區	2018-11-25T04:03:06+08:00	6929	13362	20291	1097	21388	41856	51.1%	16.55%	35	35
15	基隆市中山區	2018-11-24T23:27:31+08:00	6575	12686	19261	1081	20342	39910	50.97%	16.47%	34	35
15	基隆市中山區	2018-11-24T22:30:24+08:00	5874	11421	17295	1024	18319	35945	50.96%	16.34%	32	35
15	基隆市中山區	2018-11-24T22:19:51+08:00	5431	10570	16001	914	16915	33197	50.95%	16.36%	30	35
15	基隆市中山區	2018-11-25T06:14:06+08:00	6929	13362	20291	1097	21388	41856	51.1%	16.55%	35	35
15	基隆市中山區	2018-11-24T23:20:09+08:00	6231	12155	18386	1052	19438	38033	51.11%	16.38%	33	35
15	基隆市中山區	2018-11-24T23:31:28+08:00	6575	12686	19261	1081	20342	39910	50.97%	16.47%	34	35
15	基隆市中山區	2018-11-24T22:37:15+08:00	5874	11421	17295	1024	18319	35945	50.96%	16.34%	32	35
15	基隆市中山區	2018-11-25T00:18:48+08:00	6929	13362	20291	1097	21388	41856	51.1%	16.55%	35	35
15	基隆市中山區	2018-11-25T06:29:32+08:00	6929	13362	20291	1097	21388	41856	51.1%	16.55%	35	35
15	基隆市中山區	2018-11-24T22:45:21+08:00	5874	11421	17295	1024	18319	35945	50.96%	16.34%	32	35
15	基隆市中山區	2018-11-24T22:54:38+08:00	6231	12155	18386	1052	19438	38033	51.11%	16.38%	33	35
15	基隆市中山區	2018-11-24T23:12:32+08:00	6231	12155	18386	1052	19438	38033	51.11%	16.38%	33	35
15	基隆市中山區	2018-11-24T22:33:51+08:00	5874	11421	17295	1024	18319	35945	50.96%	16.34%	32	35
15	基隆市中山區	2018-11-24T23:39:34+08:00	6575	12686	19261	1081	20342	39910	50.97%	16.47%	34	35
15	基隆市中山區	2018-11-25T00:05:19+08:00	6929	13362	20291	1097	21388	41856	51.1%	16.55%	35	35
15	基隆市中山區	2018-11-24T22:26:49+08:00	5874	11421	17295	1024	18319	35945	50.96%	16.34%	32	35
15	基隆市中山區	2018-11-25T01:07:41+08:00	6929	13362	20291	1097	21388	41856	51.1%	16.55%	35	35
15	基隆市中山區	2018-11-24T23:05:17+08:00	6231	12155	18386	1052	19438	38033	51.11%	16.38%	33	35
15	基隆市中山區	2018-11-24T23:56:02+08:00	6929	13362	20291	1097	21388	41856	51.1%	16.55%	35	35
15	基隆市中山區	2018-11-24T22:13:46+08:00	4861	9423	14284	786	15070	29617	50.88%	16.41%	28	35
15	基隆市中山區	2018-11-24T23:23:51+08:00	6231	12155	18386	1052	19438	38033	51.11%	16.38%	33	35
15	基隆市中山區	2018-11-24T22:23:29+08:00	5662	11050	16712	952	17664	34765	50.81%	16.29%	31	35
15	基隆市中山區	2018-11-25T01:02:45+08:00	6929	13362	20291	1097	21388	41856	51.1%	16.55%	35	35
15	基隆市中山區	2018-11-24T22:40:41+08:00	5874	11421	17295	1024	18319	35945	50.96%	16.34%	32	35
15	基隆市中山區	2018-11-25T00:57:52+08:00	6929	13362	20291	1097	21388	41856	51.1%	16.55%	35	35
15	基隆市中山區	2018-11-24T22:51:04+08:00	6231	12155	18386	1052	19438	38033	51.11%	16.38%	33	35
15	基隆市中山區	2018-11-25T06:09:10+08:00	6929	13362	20291	1097	21388	41856	51.1%	16.55%	35	35
15	基隆市中山區	2018-11-25T01:13:00+08:00	6929	13362	20291	1097	21388	41856	51.1%	16.55%	35	35
15	基隆市中山區	2018-11-25T06:24:14+08:00	6929	13362	20291	1097	21388	41856	51.1%	16.55%	35	35
15	基隆市中山區	2018-11-25T00:23:18+08:00	6929	13362	20291	1097	21388	41856	51.1%	16.55%	35	35
15	基隆市中山區	2018-11-25T00:00:25+08:00	6929	13362	20291	1097	21388	41856	51.1%	16.55%	35	35
15	基隆市中山區	2018-11-24T23:35:23+08:00	6575	12686	19261	1081	20342	39910	50.97%	16.47%	34	35
15	基隆市中山區	2018-11-25T00:14:24+08:00	6929	13362	20291	1097	21388	41856	51.1%	16.55%	35	35
15	基隆市中山區	2018-11-25T01:26:09+08:00	6929	13362	20291	1097	21388	41856	51.1%	16.55%	35	35
15	基隆市中山區	2018-11-25T03:50:04+08:00	6929	13362	20291	1097	21388	41856	51.1%	16.55%	35	35
15	基隆市中山區	2018-11-24T22:16:26+08:00	5182	10022	15204	851	16055	31555	50.88%	16.42%	29	35
15	基隆市中山區	2018-11-24T23:43:31+08:00	6575	12686	19261	1081	20342	39910	50.97%	16.47%	34	35
15	基隆市中山區	2018-11-25T01:18:11+08:00	6929	13362	20291	1097	21388	41856	51.1%	16.55%	35	35
15	基隆市中山區	2018-11-24T23:16:16+08:00	6231	12155	18386	1052	19438	38033	51.11%	16.38%	33	35
15	基隆市中山區	2018-11-25T00:09:52+08:00	6929	13362	20291	1097	21388	41856	51.1%	16.55%	35	35
15	基隆市中山區	2018-11-25T06:19:11+08:00	6929	13362	20291	1097	21388	41856	51.1%	16.55%	35	35
15	基隆市中山區	2018-11-24T22:41:51+08:00	5874	11421	17295	1024	18319	35945	50.96%	16.34%	32	35
15	基隆市中山區	2018-11-25T03:39:08+08:00	6929	13362	20291	1097	21388	41856	51.1%	16.55%	35	35
15	苗栗縣公館鄉	2018-11-24T22:26:44+08:00	3984	9472	13456	1055	14511	24514	59.19%	16.25%	25	28
15	苗栗縣公館鄉	2018-11-25T00:05:13+08:00	4595	10963	15558	1176	16734	28318	59.09%	16.23%	28	28
15	苗栗縣公館鄉	2018-11-25T00:09:43+08:00	4595	10963	15558	1176	16734	28318	59.09%	16.23%	28	28
15	苗栗縣公館鄉	2018-11-24T22:37:08+08:00	4423	10526	14949	1134	16083	27086	59.38%	16.33%	27	28
15	苗栗縣公館鄉	2018-11-24T22:54:33+08:00	4423	10526	14949	1134	16083	27086	59.38%	16.33%	27	28
15	苗栗縣公館鄉	2018-11-24T22:50:57+08:00	4423	10526	14949	1134	16083	27086	59.38%	16.33%	27	28
15	苗栗縣公館鄉	2018-11-25T01:12:53+08:00	4595	10963	15558	1176	16734	28318	59.09%	16.23%	28	28
15	苗栗縣公館鄉	2018-11-24T22:40:35+08:00	4423	10526	14949	1134	16083	27086	59.38%	16.33%	27	28
15	苗栗縣公館鄉	2018-11-25T01:02:39+08:00	4595	10963	15558	1176	16734	28318	59.09%	16.23%	28	28
15	苗栗縣公館鄉	2018-11-25T04:03:00+08:00	4595	10963	15558	1176	16734	28318	59.09%	16.23%	28	28
15	苗栗縣公館鄉	2018-11-25T00:57:45+08:00	4595	10963	15558	1176	16734	28318	59.09%	16.23%	28	28
15	苗栗縣公館鄉	2018-11-24T22:19:44+08:00	3984	9472	13456	1055	14511	24514	59.19%	16.25%	25	28
15	苗栗縣公館鄉	2018-11-25T06:14:00+08:00	4595	10963	15558	1176	16734	28318	59.09%	16.23%	28	28
15	苗栗縣公館鄉	2018-11-25T00:00:18+08:00	4595	10963	15558	1176	16734	28318	59.09%	16.23%	28	28
15	苗栗縣公館鄉	2018-11-24T23:23:46+08:00	4595	10963	15558	1176	16734	28318	59.09%	16.23%	28	28
15	苗栗縣公館鄉	2018-11-24T23:27:25+08:00	4595	10963	15558	1176	16734	28318	59.09%	16.23%	28	28
15	苗栗縣公館鄉	2018-11-24T23:55:55+08:00	4595	10963	15558	1176	16734	28318	59.09%	16.23%	28	28
15	苗栗縣公館鄉	2018-11-25T00:23:12+08:00	4595	10963	15558	1176	16734	28318	59.09%	16.23%	28	28
15	苗栗縣公館鄉	2018-11-24T22:23:22+08:00	3984	9472	13456	1055	14511	24514	59.19%	16.25%	25	28
15	苗栗縣公館鄉	2018-11-24T23:01:39+08:00	4595	10963	15558	1176	16734	28318	59.09%	16.23%	28	28
15	苗栗縣公館鄉	2018-11-24T23:20:00+08:00	4595	10963	15558	1176	16734	28318	59.09%	16.23%	28	28
15	苗栗縣公館鄉	2018-11-25T01:07:34+08:00	4595	10963	15558	1176	16734	28318	59.09%	16.23%	28	28
15	苗栗縣公館鄉	2018-11-24T23:35:18+08:00	4595	10963	15558	1176	16734	28318	59.09%	16.23%	28	28
15	苗栗縣公館鄉	2018-11-25T00:14:18+08:00	4595	10963	15558	1176	16734	28318	59.09%	16.23%	28	28
15	苗栗縣公館鄉	2018-11-24T23:12:25+08:00	4595	10963	15558	1176	16734	28318	59.09%	16.23%	28	28
15	苗栗縣公館鄉	2018-11-25T03:39:02+08:00	4595	10963	15558	1176	16734	28318	59.09%	16.23%	28	28
15	苗栗縣公館鄉	2018-11-24T22:33:46+08:00	4193	10000	14193	1094	15287	25764	59.33%	16.27%	26	28
15	苗栗縣公館鄉	2018-11-24T23:31:20+08:00	4595	10963	15558	1176	16734	28318	59.09%	16.23%	28	28
15	苗栗縣公館鄉	2018-11-25T00:18:41+08:00	4595	10963	15558	1176	16734	28318	59.09%	16.23%	28	28
15	苗栗縣公館鄉	2018-11-24T23:43:24+08:00	4595	10963	15558	1176	16734	28318	59.09%	16.23%	28	28
15	苗栗縣公館鄉	2018-11-25T03:56:22+08:00	4595	10963	15558	1176	16734	28318	59.09%	16.23%	28	28
15	苗栗縣公館鄉	2018-11-25T06:29:25+08:00	4595	10963	15558	1176	16734	28318	59.09%	16.23%	28	28
15	苗栗縣公館鄉	2018-11-25T06:19:05+08:00	4595	10963	15558	1176	16734	28318	59.09%	16.23%	28	28
15	苗栗縣公館鄉	2018-11-24T23:05:11+08:00	4595	10963	15558	1176	16734	28318	59.09%	16.23%	28	28
15	苗栗縣公館鄉	2018-11-24T22:45:16+08:00	4423	10526	14949	1134	16083	27086	59.38%	16.33%	27	28
15	苗栗縣公館鄉	2018-11-24T22:41:44+08:00	4423	10526	14949	1134	16083	27086	59.38%	16.33%	27	28
15	苗栗縣公館鄉	2018-11-25T01:18:03+08:00	4595	10963	15558	1176	16734	28318	59.09%	16.23%	28	28
15	苗栗縣公館鄉	2018-11-25T03:49:59+08:00	4595	10963	15558	1176	16734	28318	59.09%	16.23%	28	28
15	苗栗縣公館鄉	2018-11-24T22:58:03+08:00	4595	10963	15558	1176	16734	28318	59.09%	16.23%	28	28
15	苗栗縣公館鄉	2018-11-25T06:09:03+08:00	4595	10963	15558	1176	16734	28318	59.09%	16.23%	28	28
15	苗栗縣公館鄉	2018-11-24T23:51:43+08:00	4595	10963	15558	1176	16734	28318	59.09%	16.23%	28	28
15	苗栗縣公館鄉	2018-11-25T06:24:08+08:00	4595	10963	15558	1176	16734	28318	59.09%	16.23%	28	28
15	苗栗縣公館鄉	2018-11-24T22:30:18+08:00	3984	9472	13456	1055	14511	24514	59.19%	16.25%	25	28
15	苗栗縣公館鄉	2018-11-25T03:32:45+08:00	4595	10963	15558	1176	16734	28318	59.09%	16.23%	28	28
15	苗栗縣公館鄉	2018-11-24T22:13:38+08:00	3984	9472	13456	1055	14511	24514	59.19%	16.25%	25	28
15	苗栗縣公館鄉	2018-11-24T23:08:45+08:00	4595	10963	15558	1176	16734	28318	59.09%	16.23%	28	28
15	苗栗縣公館鄉	2018-11-25T03:44:33+08:00	4595	10963	15558	1176	16734	28318	59.09%	16.23%	28	28
15	苗栗縣公館鄉	2018-11-24T23:16:10+08:00	4595	10963	15558	1176	16734	28318	59.09%	16.23%	28	28
15	苗栗縣公館鄉	2018-11-24T23:47:37+08:00	4595	10963	15558	1176	16734	28318	59.09%	16.23%	28	28
15	苗栗縣公館鄉	2018-11-24T22:16:19+08:00	3984	9472	13456	1055	14511	24514	59.19%	16.25%	25	28
15	苗栗縣公館鄉	2018-11-24T23:39:26+08:00	4595	10963	15558	1176	16734	28318	59.09%	16.23%	28	28
15	苗栗縣公館鄉	2018-11-25T01:26:01+08:00	4595	10963	15558	1176	16734	28318	59.09%	16.23%	28	28
15	臺南市官田區	2018-11-24T22:41:41+08:00	3068	5351	8419	669	9088	18675	48.66%	16.43%	20	20
15	臺南市官田區	2018-11-24T22:45:13+08:00	3068	5351	8419	669	9088	18675	48.66%	16.43%	20	20
15	臺南市官田區	2018-11-24T23:16:07+08:00	3068	5351	8419	669	9088	18675	48.66%	16.43%	20	20
15	臺南市官田區	2018-11-25T03:56:18+08:00	3068	5351	8419	669	9088	18675	48.66%	16.43%	20	20
15	臺南市官田區	2018-11-25T00:18:36+08:00	3068	5351	8419	669	9088	18675	48.66%	16.43%	20	20
15	臺南市官田區	2018-11-24T23:51:40+08:00	3068	5351	8419	669	9088	18675	48.66%	16.43%	20	20
15	臺南市官田區	2018-11-24T22:40:32+08:00	3068	5351	8419	669	9088	18675	48.66%	16.43%	20	20
15	臺南市官田區	2018-11-25T01:02:36+08:00	3068	5351	8419	669	9088	18675	48.66%	16.43%	20	20
15	臺南市官田區	2018-11-25T01:25:58+08:00	3068	5351	8419	669	9088	18675	48.66%	16.43%	20	20
15	臺南市官田區	2018-11-24T22:30:15+08:00	3068	5351	8419	669	9088	18675	48.66%	16.43%	20	20
15	臺南市官田區	2018-11-25T00:23:09+08:00	3068	5351	8419	669	9088	18675	48.66%	16.43%	20	20
15	臺南市官田區	2018-11-25T00:57:42+08:00	3068	5351	8419	669	9088	18675	48.66%	16.43%	20	20
15	臺南市官田區	2018-11-25T06:24:05+08:00	3068	5351	8419	669	9088	18675	48.66%	16.43%	20	20
15	臺南市官田區	2018-11-25T00:00:16+08:00	3068	5351	8419	669	9088	18675	48.66%	16.43%	20	20
15	臺南市官田區	2018-11-25T01:17:59+08:00	3068	5351	8419	669	9088	18675	48.66%	16.43%	20	20
15	臺南市官田區	2018-11-24T22:57:59+08:00	3068	5351	8419	669	9088	18675	48.66%	16.43%	20	20
15	臺南市官田區	2018-11-24T23:19:57+08:00	3068	5351	8419	669	9088	18675	48.66%	16.43%	20	20
15	臺南市官田區	2018-11-25T03:32:41+08:00	3068	5351	8419	669	9088	18675	48.66%	16.43%	20	20
15	臺南市官田區	2018-11-24T23:55:52+08:00	3068	5351	8419	669	9088	18675	48.66%	16.43%	20	20
15	臺南市官田區	2018-11-24T22:13:33+08:00	3068	5351	8419	669	9088	18675	48.66%	16.43%	20	20
15	臺南市官田區	2018-11-24T23:27:23+08:00	3068	5351	8419	669	9088	18675	48.66%	16.43%	20	20
15	臺南市官田區	2018-11-24T23:39:22+08:00	3068	5351	8419	669	9088	18675	48.66%	16.43%	20	20
15	臺南市官田區	2018-11-25T01:12:49+08:00	3068	5351	8419	669	9088	18675	48.66%	16.43%	20	20
15	臺南市官田區	2018-11-25T06:08:59+08:00	3068	5351	8419	669	9088	18675	48.66%	16.43%	20	20
15	臺南市官田區	2018-11-24T23:31:17+08:00	3068	5351	8419	669	9088	18675	48.66%	16.43%	20	20
15	臺南市官田區	2018-11-24T23:47:34+08:00	3068	5351	8419	669	9088	18675	48.66%	16.43%	20	20
15	臺南市官田區	2018-11-24T23:05:09+08:00	3068	5351	8419	669	9088	18675	48.66%	16.43%	20	20
15	臺南市官田區	2018-11-24T23:01:36+08:00	3068	5351	8419	669	9088	18675	48.66%	16.43%	20	20
15	臺南市官田區	2018-11-25T04:02:57+08:00	3068	5351	8419	669	9088	18675	48.66%	16.43%	20	20
15	臺南市官田區	2018-11-25T00:05:10+08:00	3068	5351	8419	669	9088	18675	48.66%	16.43%	20	20
15	臺南市官田區	2018-11-25T06:19:02+08:00	3068	5351	8419	669	9088	18675	48.66%	16.43%	20	20
15	臺南市官田區	2018-11-25T06:29:22+08:00	3068	5351	8419	669	9088	18675	48.66%	16.43%	20	20
15	臺南市官田區	2018-11-25T03:49:56+08:00	3068	5351	8419	669	9088	18675	48.66%	16.43%	20	20
15	臺南市官田區	2018-11-24T22:54:30+08:00	3068	5351	8419	669	9088	18675	48.66%	16.43%	20	20
15	臺南市官田區	2018-11-24T22:50:54+08:00	3068	5351	8419	669	9088	18675	48.66%	16.43%	20	20
15	臺南市官田區	2018-11-25T06:13:57+08:00	3068	5351	8419	669	9088	18675	48.66%	16.43%	20	20
15	臺南市官田區	2018-11-24T22:37:05+08:00	3068	5351	8419	669	9088	18675	48.66%	16.43%	20	20
15	臺南市官田區	2018-11-24T23:43:22+08:00	3068	5351	8419	669	9088	18675	48.66%	16.43%	20	20
15	臺南市官田區	2018-11-25T00:09:40+08:00	3068	5351	8419	669	9088	18675	48.66%	16.43%	20	20
15	臺南市官田區	2018-11-24T22:26:41+08:00	3068	5351	8419	669	9088	18675	48.66%	16.43%	20	20
15	臺南市官田區	2018-11-24T22:19:41+08:00	3068	5351	8419	669	9088	18675	48.66%	16.43%	20	20
15	臺南市官田區	2018-11-25T03:38:59+08:00	3068	5351	8419	669	9088	18675	48.66%	16.43%	20	20
15	臺南市官田區	2018-11-25T03:44:29+08:00	3068	5351	8419	669	9088	18675	48.66%	16.43%	20	20
15	臺南市官田區	2018-11-24T23:08:42+08:00	3068	5351	8419	669	9088	18675	48.66%	16.43%	20	20
15	臺南市官田區	2018-11-24T22:23:19+08:00	3068	5351	8419	669	9088	18675	48.66%	16.43%	20	20
15	臺南市官田區	2018-11-24T23:23:43+08:00	3068	5351	8419	669	9088	18675	48.66%	16.43%	20	20
15	臺南市官田區	2018-11-25T00:14:15+08:00	3068	5351	8419	669	9088	18675	48.66%	16.43%	20	20
15	臺南市官田區	2018-11-24T23:35:15+08:00	3068	5351	8419	669	9088	18675	48.66%	16.43%	20	20
15	臺南市官田區	2018-11-24T22:33:43+08:00	3068	5351	8419	669	9088	18675	48.66%	16.43%	20	20
15	臺南市官田區	2018-11-24T23:12:21+08:00	3068	5351	8419	669	9088	18675	48.66%	16.43%	20	20
15	臺南市官田區	2018-11-24T22:16:16+08:00	3068	5351	8419	669	9088	18675	48.66%	16.43%	20	20
15	臺南市官田區	2018-11-25T01:07:31+08:00	3068	5351	8419	669	9088	18675	48.66%	16.43%	20	20
15	屏東縣滿州鄉	2018-11-24T22:58:06+08:00	971	1913	2884	197	3081	7206	42.76%	13.47%	8	8
15	屏東縣滿州鄉	2018-11-25T03:56:26+08:00	971	1913	2884	197	3081	7206	42.76%	13.47%	8	8
15	屏東縣滿州鄉	2018-11-24T23:05:15+08:00	971	1913	2884	197	3081	7206	42.76%	13.47%	8	8
15	屏東縣滿州鄉	2018-11-25T01:18:08+08:00	971	1913	2884	197	3081	7206	42.76%	13.47%	8	8
15	屏東縣滿州鄉	2018-11-24T23:39:30+08:00	971	1913	2884	197	3081	7206	42.76%	13.47%	8	8
15	屏東縣滿州鄉	2018-11-24T22:41:48+08:00	971	1913	2884	197	3081	7206	42.76%	13.47%	8	8
15	屏東縣滿州鄉	2018-11-25T06:29:29+08:00	971	1913	2884	197	3081	7206	42.76%	13.47%	8	8
15	屏東縣滿州鄉	2018-11-25T06:19:09+08:00	971	1913	2884	197	3081	7206	42.76%	13.47%	8	8
15	屏東縣滿州鄉	2018-11-24T23:43:28+08:00	971	1913	2884	197	3081	7206	42.76%	13.47%	8	8
15	屏東縣滿州鄉	2018-11-25T06:09:07+08:00	971	1913	2884	197	3081	7206	42.76%	13.47%	8	8
15	屏東縣滿州鄉	2018-11-24T23:51:47+08:00	971	1913	2884	197	3081	7206	42.76%	13.47%	8	8
15	屏東縣滿州鄉	2018-11-24T22:13:43+08:00	971	1913	2884	197	3081	7206	42.76%	13.47%	8	8
15	屏東縣滿州鄉	2018-11-24T23:08:49+08:00	971	1913	2884	197	3081	7206	42.76%	13.47%	8	8
15	屏東縣滿州鄉	2018-11-24T22:51:01+08:00	971	1913	2884	197	3081	7206	42.76%	13.47%	8	8
15	屏東縣滿州鄉	2018-11-25T03:44:38+08:00	971	1913	2884	197	3081	7206	42.76%	13.47%	8	8
15	屏東縣滿州鄉	2018-11-25T00:23:15+08:00	971	1913	2884	197	3081	7206	42.76%	13.47%	8	8
15	屏東縣滿州鄉	2018-11-24T23:23:49+08:00	971	1913	2884	197	3081	7206	42.76%	13.47%	8	8
15	屏東縣滿州鄉	2018-11-24T22:33:49+08:00	971	1913	2884	197	3081	7206	42.76%	13.47%	8	8
15	屏東縣滿州鄉	2018-11-24T22:37:12+08:00	971	1913	2884	197	3081	7206	42.76%	13.47%	8	8
15	屏東縣滿州鄉	2018-11-24T23:16:14+08:00	971	1913	2884	197	3081	7206	42.76%	13.47%	8	8
15	屏東縣滿州鄉	2018-11-25T01:26:05+08:00	971	1913	2884	197	3081	7206	42.76%	13.47%	8	8
15	屏東縣滿州鄉	2018-11-24T22:16:23+08:00	971	1913	2884	197	3081	7206	42.76%	13.47%	8	8
15	屏東縣滿州鄉	2018-11-25T00:14:21+08:00	971	1913	2884	197	3081	7206	42.76%	13.47%	8	8
15	屏東縣滿州鄉	2018-11-24T23:35:21+08:00	971	1913	2884	197	3081	7206	42.76%	13.47%	8	8
15	屏東縣滿州鄉	2018-11-24T22:45:19+08:00	971	1913	2884	197	3081	7206	42.76%	13.47%	8	8
15	屏東縣滿州鄉	2018-11-24T22:54:36+08:00	971	1913	2884	197	3081	7206	42.76%	13.47%	8	8
15	屏東縣滿州鄉	2018-11-25T00:09:48+08:00	971	1913	2884	197	3081	7206	42.76%	13.47%	8	8
15	屏東縣滿州鄉	2018-11-24T23:01:44+08:00	971	1913	2884	197	3081	7206	42.76%	13.47%	8	8
15	屏東縣滿州鄉	2018-11-24T22:26:47+08:00	971	1913	2884	197	3081	7206	42.76%	13.47%	8	8
15	屏東縣滿州鄉	2018-11-24T23:47:41+08:00	971	1913	2884	197	3081	7206	42.76%	13.47%	8	8
15	屏東縣滿州鄉	2018-11-25T01:12:57+08:00	971	1913	2884	197	3081	7206	42.76%	13.47%	8	8
15	屏東縣滿州鄉	2018-11-25T00:05:16+08:00	971	1913	2884	197	3081	7206	42.76%	13.47%	8	8
15	屏東縣滿州鄉	2018-11-25T00:57:49+08:00	971	1913	2884	197	3081	7206	42.76%	13.47%	8	8
15	屏東縣滿州鄉	2018-11-24T22:19:48+08:00	971	1913	2884	197	3081	7206	42.76%	13.47%	8	8
15	屏東縣滿州鄉	2018-11-24T22:30:21+08:00	971	1913	2884	197	3081	7206	42.76%	13.47%	8	8
15	屏東縣滿州鄉	2018-11-25T03:32:50+08:00	971	1913	2884	197	3081	7206	42.76%	13.47%	8	8
15	屏東縣滿州鄉	2018-11-25T04:03:04+08:00	971	1913	2884	197	3081	7206	42.76%	13.47%	8	8
15	屏東縣滿州鄉	2018-11-24T22:40:39+08:00	971	1913	2884	197	3081	7206	42.76%	13.47%	8	8
15	屏東縣滿州鄉	2018-11-25T01:02:42+08:00	971	1913	2884	197	3081	7206	42.76%	13.47%	8	8
15	屏東縣滿州鄉	2018-11-25T06:14:03+08:00	971	1913	2884	197	3081	7206	42.76%	13.47%	8	8
15	屏東縣滿州鄉	2018-11-24T23:55:59+08:00	971	1913	2884	197	3081	7206	42.76%	13.47%	8	8
15	屏東縣滿州鄉	2018-11-25T06:24:12+08:00	971	1913	2884	197	3081	7206	42.76%	13.47%	8	8
15	屏東縣滿州鄉	2018-11-24T22:23:26+08:00	971	1913	2884	197	3081	7206	42.76%	13.47%	8	8
15	屏東縣滿州鄉	2018-11-24T23:27:29+08:00	971	1913	2884	197	3081	7206	42.76%	13.47%	8	8
15	屏東縣滿州鄉	2018-11-25T00:00:22+08:00	971	1913	2884	197	3081	7206	42.76%	13.47%	8	8
15	屏東縣滿州鄉	2018-11-24T23:31:25+08:00	971	1913	2884	197	3081	7206	42.76%	13.47%	8	8
15	屏東縣滿州鄉	2018-11-24T23:20:04+08:00	971	1913	2884	197	3081	7206	42.76%	13.47%	8	8
15	屏東縣滿州鄉	2018-11-25T00:18:45+08:00	971	1913	2884	197	3081	7206	42.76%	13.47%	8	8
15	屏東縣滿州鄉	2018-11-25T01:07:38+08:00	971	1913	2884	197	3081	7206	42.76%	13.47%	8	8
15	屏東縣滿州鄉	2018-11-25T03:39:06+08:00	971	1913	2884	197	3081	7206	42.76%	13.47%	8	8
15	屏東縣滿州鄉	2018-11-25T03:50:02+08:00	971	1913	2884	197	3081	7206	42.76%	13.47%	8	8
15	屏東縣滿州鄉	2018-11-24T23:12:28+08:00	971	1913	2884	197	3081	7206	42.76%	13.47%	8	8
15	臺南市	2018-11-25T03:49:55+08:00	270957	502776	773733	45753	819486	1594821	51.38%	16.99%	322	1
15	臺南市	2018-11-24T22:41:41+08:00	215832	401700	617532	38017	655549	1285282	51%	16.79%	136	1
15	臺南市	2018-11-24T23:16:07+08:00	244616	454640	699256	41999	741255	1447179	51.22%	16.9%	238	1
15	臺南市	2018-11-25T03:56:18+08:00	270957	502776	773733	45753	819486	1594821	51.38%	16.99%	322	1
15	臺南市	2018-11-24T22:45:12+08:00	219676	408887	628563	38548	667111	1307006	51.04%	16.81%	151	1
15	臺南市	2018-11-24T23:43:21+08:00	259514	481508	741022	44125	785147	1528980	51.35%	16.97%	286	1
15	臺南市	2018-11-25T00:18:36+08:00	266446	494891	761337	45129	806466	1569560	51.38%	16.98%	309	1
15	臺南市	2018-11-24T23:51:40+08:00	261399	485174	746573	44362	790935	1539927	51.36%	16.97%	292	1
15	臺南市	2018-11-24T22:40:32+08:00	215832	401700	617532	38017	655549	1285282	51%	16.79%	136	1
15	臺南市	2018-11-25T01:25:57+08:00	270870	502563	773433	45730	819163	1593720	51.4%	17%	321	1
15	臺南市	2018-11-25T01:02:36+08:00	270542	501984	772526	45693	818219	1592458	51.38%	16.99%	321	1
15	臺南市	2018-11-24T22:30:14+08:00	204395	381497	585892	36505	622397	1222218	50.92%	16.72%	095	1
15	臺南市	2018-11-25T00:23:08+08:00	266796	495534	762330	45199	807529	1571627	51.38%	16.98%	310	1
15	臺南市	2018-11-25T00:57:42+08:00	270226	501373	771599	45651	817250	1590343	51.39%	16.99%	320	1
15	臺南市	2018-11-25T06:24:05+08:00	270957	502776	773733	45753	819486	1594821	51.38%	16.99%	322	1
15	臺南市	2018-11-24T23:27:22+08:00	251174	466208	717382	42856	760238	1482236	51.29%	16.95%	259	1
15	臺南市	2018-11-24T22:57:59+08:00	231925	431453	663378	40298	703676	1375505	51.16%	16.86%	193	1
15	臺南市	2018-11-24T23:19:57+08:00	247698	460161	707859	42388	750247	1463726	51.26%	16.92%	248	1
15	臺南市	2018-11-25T03:32:41+08:00	270957	502776	773733	45753	819486	1594821	51.38%	16.99%	322	1
15	臺南市	2018-11-24T23:08:41+08:00	238779	444394	683173	41149	724322	1414199	51.22%	16.88%	218	1
15	臺南市	2018-11-24T22:13:33+08:00	185586	347222	532808	33791	566599	1114060	50.86%	16.66%	024	1
15	臺南市	2018-11-25T01:17:58+08:00	270957	502776	773733	45734	819467	1594821	51.38%	16.99%	322	1
15	臺南市	2018-11-24T23:39:22+08:00	258299	479258	737557	43962	781519	1522001	51.35%	16.97%	282	1
15	臺南市	2018-11-25T01:12:49+08:00	270542	501984	772526	45693	818219	1592458	51.38%	16.99%	321	1
15	臺南市	2018-11-25T06:08:59+08:00	270957	502776	773733	45753	819486	1594821	51.38%	16.99%	322	1
15	臺南市	2018-11-24T23:31:17+08:00	254819	472974	727793	43425	771218	1502562	51.33%	16.96%	271	1
15	臺南市	2018-11-24T23:47:33+08:00	260257	483056	743313	44198	787511	1533235	51.36%	16.97%	288	1
15	臺南市	2018-11-24T23:05:09+08:00	236100	439732	675832	40862	716694	1400334	51.18%	16.86%	209	1
15	臺南市	2018-11-24T23:01:36+08:00	234873	437388	672261	40696	712957	1393025	51.18%	16.86%	205	1
15	臺南市	2018-11-25T04:02:57+08:00	270957	502776	773733	45753	819486	1594821	51.38%	16.99%	322	1
15	臺南市	2018-11-25T00:05:10+08:00	264345	491001	755346	44806	800152	1557709	51.37%	16.97%	302	1
15	臺南市	2018-11-25T06:19:02+08:00	270957	502776	773733	45753	819486	1594821	51.38%	16.99%	322	1
15	臺南市	2018-11-25T06:29:22+08:00	270957	502776	773733	45753	819486	1594821	51.38%	16.99%	322	1
15	臺南市	2018-11-24T22:54:30+08:00	229963	428093	658056	40026	698082	1365168	51.14%	16.85%	186	1
15	臺南市	2018-11-25T06:13:57+08:00	270957	502776	773733	45753	819486	1594821	51.38%	16.99%	322	1
15	臺南市	2018-11-24T22:50:53+08:00	224093	417429	641522	39267	680789	1332461	51.09%	16.82%	167	1
15	臺南市	2018-11-24T22:37:05+08:00	212018	395182	607200	37546	644746	1264911	50.97%	16.76%	124	1
15	臺南市	2018-11-24T22:26:41+08:00	200854	374975	575829	35937	611766	1201950	50.9%	16.71%	082	1
15	臺南市	2018-11-24T22:19:41+08:00	193902	362507	556409	35062	591471	1161467	50.92%	16.69%	056	1
15	臺南市	2018-11-25T03:38:59+08:00	270957	502776	773733	45753	819486	1594821	51.38%	16.99%	322	1
15	臺南市	2018-11-25T03:44:29+08:00	270957	502776	773733	45753	819486	1594821	51.38%	16.99%	322	1
15	臺南市	2018-11-24T22:23:18+08:00	199006	371609	570615	35691	606306	1190936	50.91%	16.71%	074	1
15	臺南市	2018-11-25T00:00:15+08:00	262859	488075	750934	44534	795468	1549104	51.35%	16.97%	297	1
15	臺南市	2018-11-24T23:23:43+08:00	249180	462714	711894	42557	754451	1471395	51.27%	16.93%	253	1
15	臺南市	2018-11-24T23:55:51+08:00	262059	486507	748566	44452	793018	1544227	51.35%	16.97%	294	1
15	臺南市	2018-11-24T23:35:15+08:00	257070	476887	733957	43791	777748	1514957	51.34%	16.97%	278	1
15	臺南市	2018-11-24T23:12:20+08:00	241063	448211	689274	41453	730727	1426307	51.23%	16.9%	226	1
15	臺南市	2018-11-25T00:14:14+08:00	265520	493215	758735	45019	803754	1564534	51.37%	16.97%	306	1
15	臺南市	2018-11-24T22:16:16+08:00	190023	355188	545211	34545	579756	1138364	50.93%	16.69%	041	1
15	臺南市	2018-11-25T00:09:39+08:00	264957	492289	757246	44935	802181	1561484	51.37%	16.97%	304	1
15	臺南市	2018-11-25T01:07:31+08:00	270542	501984	772526	45693	818219	1592458	51.38%	16.99%	321	1
15	臺南市	2018-11-24T22:33:42+08:00	206430	385003	591433	36804	628237	1233457	50.93%	16.74%	102	1
15	花蓮縣秀林鄉	2018-11-24T23:56:00+08:00	609	1591	2200	132	2332	4617	50.51%	13.19%	7	14
15	花蓮縣秀林鄉	2018-11-24T22:58:08+08:00	215	491	706	42	748	1503	49.77%	14.3%	4	14
15	花蓮縣秀林鄉	2018-11-25T01:18:09+08:00	957	2377	3334	251	3585	6881	52.1%	13.91%	9	14
15	花蓮縣秀林鄉	2018-11-25T03:56:27+08:00	1694	4326	6020	415	6435	12562	51.23%	13.49%	14	14
15	花蓮縣秀林鄉	2018-11-24T23:47:42+08:00	609	1591	2200	132	2332	4617	50.51%	13.19%	7	14
15	花蓮縣秀林鄉	2018-11-24T23:27:30+08:00	609	1591	2200	132	2332	4617	50.51%	13.19%	7	14
15	花蓮縣秀林鄉	2018-11-24T23:51:48+08:00	609	1591	2200	132	2332	4617	50.51%	13.19%	7	14
15	花蓮縣秀林鄉	2018-11-25T06:09:08+08:00	1694	4326	6020	415	6435	12562	51.23%	13.49%	14	14
15	花蓮縣秀林鄉	2018-11-24T22:30:23+08:00	215	491	706	42	748	1503	49.77%	14.3%	4	14
15	花蓮縣秀林鄉	2018-11-24T22:13:44+08:00	215	491	706	42	748	1503	49.77%	14.3%	4	14
15	花蓮縣秀林鄉	2018-11-25T03:44:40+08:00	1694	4326	6020	415	6435	12562	51.23%	13.49%	14	14
15	花蓮縣秀林鄉	2018-11-25T00:57:50+08:00	957	2377	3334	251	3585	6881	52.1%	13.91%	9	14
15	花蓮縣秀林鄉	2018-11-24T22:16:25+08:00	215	491	706	42	748	1503	49.77%	14.3%	4	14
15	花蓮縣秀林鄉	2018-11-24T23:31:26+08:00	609	1591	2200	132	2332	4617	50.51%	13.19%	7	14
15	花蓮縣秀林鄉	2018-11-24T22:37:13+08:00	215	491	706	42	748	1503	49.77%	14.3%	4	14
15	花蓮縣秀林鄉	2018-11-24T23:20:06+08:00	455	1182	1637	94	1731	3630	47.69%	12.53%	6	14
15	花蓮縣秀林鄉	2018-11-25T00:18:46+08:00	791	2028	2819	214	3033	5756	52.69%	13.74%	8	14
15	花蓮縣秀林鄉	2018-11-24T23:16:15+08:00	328	764	1092	63	1155	2257	51.17%	14.53%	5	14
15	花蓮縣秀林鄉	2018-11-25T01:12:58+08:00	957	2377	3334	251	3585	6881	52.1%	13.91%	9	14
15	花蓮縣秀林鄉	2018-11-25T00:05:17+08:00	609	1591	2200	132	2332	4617	50.51%	13.19%	7	14
15	花蓮縣秀林鄉	2018-11-24T23:05:16+08:00	215	491	706	42	748	1503	49.77%	14.3%	4	14
15	花蓮縣秀林鄉	2018-11-24T23:39:32+08:00	609	1591	2200	132	2332	4617	50.51%	13.19%	7	14
15	花蓮縣秀林鄉	2018-11-24T22:54:37+08:00	215	491	706	42	748	1503	49.77%	14.3%	4	14
15	花蓮縣秀林鄉	2018-11-24T22:33:50+08:00	215	491	706	42	748	1503	49.77%	14.3%	4	14
15	花蓮縣秀林鄉	2018-11-24T22:45:20+08:00	215	491	706	42	748	1503	49.77%	14.3%	4	14
15	花蓮縣秀林鄉	2018-11-24T22:26:48+08:00	215	491	706	42	748	1503	49.77%	14.3%	4	14
15	花蓮縣秀林鄉	2018-11-24T23:01:45+08:00	215	491	706	42	748	1503	49.77%	14.3%	4	14
15	花蓮縣秀林鄉	2018-11-25T00:09:49+08:00	609	1591	2200	132	2332	4617	50.51%	13.19%	7	14
15	花蓮縣秀林鄉	2018-11-25T04:03:05+08:00	1694	4326	6020	415	6435	12562	51.23%	13.49%	14	14
15	花蓮縣秀林鄉	2018-11-24T23:23:50+08:00	609	1591	2200	132	2332	4617	50.51%	13.19%	7	14
15	花蓮縣秀林鄉	2018-11-24T22:19:49+08:00	215	491	706	42	748	1503	49.77%	14.3%	4	14
15	花蓮縣秀林鄉	2018-11-25T03:32:51+08:00	1694	4326	6020	415	6435	12562	51.23%	13.49%	14	14
15	花蓮縣秀林鄉	2018-11-24T23:08:50+08:00	215	491	706	42	748	1503	49.77%	14.3%	4	14
15	花蓮縣秀林鄉	2018-11-25T06:14:04+08:00	1694	4326	6020	415	6435	12562	51.23%	13.49%	14	14
15	花蓮縣秀林鄉	2018-11-25T00:00:23+08:00	609	1591	2200	132	2332	4617	50.51%	13.19%	7	14
15	花蓮縣秀林鄉	2018-11-24T22:51:03+08:00	215	491	706	42	748	1503	49.77%	14.3%	4	14
15	花蓮縣秀林鄉	2018-11-24T22:23:28+08:00	215	491	706	42	748	1503	49.77%	14.3%	4	14
15	花蓮縣秀林鄉	2018-11-24T22:40:40+08:00	215	491	706	42	748	1503	49.77%	14.3%	4	14
15	花蓮縣秀林鄉	2018-11-25T06:24:13+08:00	1694	4326	6020	415	6435	12562	51.23%	13.49%	14	14
15	花蓮縣秀林鄉	2018-11-25T01:02:44+08:00	957	2377	3334	251	3585	6881	52.1%	13.91%	9	14
15	花蓮縣秀林鄉	2018-11-25T00:23:16+08:00	791	2028	2819	214	3033	5756	52.69%	13.74%	8	14
15	花蓮縣秀林鄉	2018-11-25T06:19:10+08:00	1694	4326	6020	415	6435	12562	51.23%	13.49%	14	14
15	花蓮縣秀林鄉	2018-11-25T06:29:30+08:00	1694	4326	6020	415	6435	12562	51.23%	13.49%	14	14
15	花蓮縣秀林鄉	2018-11-24T23:12:29+08:00	215	491	706	42	748	1503	49.77%	14.3%	4	14
15	花蓮縣秀林鄉	2018-11-25T03:50:03+08:00	1694	4326	6020	415	6435	12562	51.23%	13.49%	14	14
15	花蓮縣秀林鄉	2018-11-25T01:07:39+08:00	957	2377	3334	251	3585	6881	52.1%	13.91%	9	14
15	花蓮縣秀林鄉	2018-11-25T01:26:07+08:00	957	2377	3334	251	3585	6881	52.1%	13.91%	9	14
15	花蓮縣秀林鄉	2018-11-25T03:39:07+08:00	1694	4326	6020	415	6435	12562	51.23%	13.49%	14	14
15	花蓮縣秀林鄉	2018-11-24T22:41:50+08:00	215	491	706	42	748	1503	49.77%	14.3%	4	14
15	花蓮縣秀林鄉	2018-11-25T00:14:22+08:00	609	1591	2200	132	2332	4617	50.51%	13.19%	7	14
15	花蓮縣秀林鄉	2018-11-24T23:35:22+08:00	609	1591	2200	132	2332	4617	50.51%	13.19%	7	14
15	花蓮縣秀林鄉	2018-11-24T23:43:30+08:00	609	1591	2200	132	2332	4617	50.51%	13.19%	7	14
15	花蓮縣花蓮市	2018-11-24T23:56:00+08:00	8536	20200	28736	1424	30160	55541	54.3%	15.37%	58	81
15	花蓮縣花蓮市	2018-11-24T23:05:15+08:00	4892	11853	16745	795	17540	32306	54.29%	15.14%	37	81
15	花蓮縣花蓮市	2018-11-24T23:43:29+08:00	7944	18711	26655	1315	27970	51503	54.31%	15.42%	54	81
15	花蓮縣花蓮市	2018-11-25T01:18:09+08:00	12125	28494	40619	1930	42549	78222	54.4%	15.5%	76	81
15	花蓮縣花蓮市	2018-11-25T03:56:27+08:00	13072	30596	43668	2054	45722	84807	53.91%	15.41%	81	81
15	花蓮縣花蓮市	2018-11-25T06:19:09+08:00	13072	30596	43668	2054	45722	84807	53.91%	15.41%	81	81
15	花蓮縣花蓮市	2018-11-24T22:58:07+08:00	4375	10692	15067	708	15775	29162	54.09%	15%	34	81
15	花蓮縣花蓮市	2018-11-24T22:41:49+08:00	3167	7748	10915	522	11437	20883	54.77%	15.17%	27	81
15	花蓮縣花蓮市	2018-11-24T23:39:31+08:00	7574	17807	25381	1238	26619	49227	54.07%	15.39%	52	81
15	花蓮縣花蓮市	2018-11-24T23:47:42+08:00	8253	19370	27623	1369	28992	53393	54.3%	15.46%	56	81
15	花蓮縣花蓮市	2018-11-24T22:30:22+08:00	2868	7034	9902	478	10380	18953	54.77%	15.13%	25	81
15	花蓮縣花蓮市	2018-11-24T23:51:47+08:00	8536	20200	28736	1424	30160	55541	54.3%	15.37%	58	81
15	花蓮縣花蓮市	2018-11-25T06:09:08+08:00	13072	30596	43668	2054	45722	84807	53.91%	15.41%	81	81
15	花蓮縣花蓮市	2018-11-24T22:13:43+08:00	2744	6763	9507	458	9965	18238	54.64%	15.05%	24	81
15	花蓮縣花蓮市	2018-11-25T00:57:50+08:00	11708	27566	39274	1844	41118	75560	54.42%	15.49%	74	81
15	花蓮縣花蓮市	2018-11-25T03:44:39+08:00	13072	30596	43668	2054	45722	84807	53.91%	15.41%	81	81
15	花蓮縣花蓮市	2018-11-24T23:31:26+08:00	6533	15340	21873	1069	22942	42105	54.49%	15.52%	46	81
15	花蓮縣花蓮市	2018-11-24T22:33:49+08:00	3167	7748	10915	522	11437	20883	54.77%	15.17%	27	81
15	花蓮縣花蓮市	2018-11-24T22:37:13+08:00	3167	7748	10915	522	11437	20883	54.77%	15.17%	27	81
15	花蓮縣花蓮市	2018-11-24T22:16:24+08:00	2744	6763	9507	458	9965	18238	54.64%	15.05%	24	81
15	花蓮縣花蓮市	2018-11-25T00:18:46+08:00	9918	23312	33230	1586	34816	64009	54.39%	15.49%	65	81
15	花蓮縣花蓮市	2018-11-24T23:35:21+08:00	7015	16565	23580	1154	24734	45648	54.18%	15.37%	49	81
15	花蓮縣花蓮市	2018-11-24T23:16:15+08:00	5504	13162	18666	906	19572	36110	54.2%	15.24%	41	81
15	花蓮縣花蓮市	2018-11-24T22:45:19+08:00	3692	9110	12802	605	13407	24607	54.48%	15%	30	81
15	花蓮縣花蓮市	2018-11-24T22:54:36+08:00	4375	10692	15067	708	15775	29162	54.09%	15%	34	81
15	花蓮縣花蓮市	2018-11-25T00:05:17+08:00	8907	21077	29984	1464	31448	57960	54.26%	15.37%	60	81
15	花蓮縣花蓮市	2018-11-25T01:12:57+08:00	12125	28494	40619	1930	42549	78222	54.4%	15.5%	76	81
15	花蓮縣花蓮市	2018-11-24T22:26:48+08:00	2868	7034	9902	478	10380	18953	54.77%	15.13%	25	81
15	花蓮縣花蓮市	2018-11-24T23:01:45+08:00	4576	11141	15717	734	16451	30429	54.06%	15.04%	35	81
15	花蓮縣花蓮市	2018-11-25T00:09:49+08:00	9105	21549	30654	1488	32142	59339	54.17%	15.34%	61	81
15	花蓮縣花蓮市	2018-11-25T04:03:05+08:00	13072	30596	43668	2054	45722	84807	53.91%	15.41%	81	81
15	花蓮縣花蓮市	2018-11-24T23:23:50+08:00	5705	13663	19368	942	20310	37359	54.36%	15.27%	42	81
15	花蓮縣花蓮市	2018-11-24T22:19:49+08:00	2868	7034	9902	478	10380	18953	54.77%	15.13%	25	81
15	花蓮縣花蓮市	2018-11-24T22:40:39+08:00	3167	7748	10915	522	11437	20883	54.77%	15.17%	27	81
15	花蓮縣花蓮市	2018-11-25T03:32:51+08:00	13072	30596	43668	2054	45722	84807	53.91%	15.41%	81	81
15	花蓮縣花蓮市	2018-11-24T23:08:50+08:00	5047	12203	17250	819	18069	33231	54.37%	15.19%	38	81
15	花蓮縣花蓮市	2018-11-24T22:23:27+08:00	2868	7034	9902	478	10380	18953	54.77%	15.13%	25	81
15	花蓮縣花蓮市	2018-11-24T22:51:02+08:00	4230	10311	14541	687	15228	28207	53.99%	15%	33	81
15	花蓮縣花蓮市	2018-11-25T06:14:04+08:00	13072	30596	43668	2054	45722	84807	53.91%	15.41%	81	81
15	花蓮縣花蓮市	2018-11-25T00:00:23+08:00	8536	20200	28736	1424	30160	55541	54.3%	15.37%	58	81
15	花蓮縣花蓮市	2018-11-25T06:24:12+08:00	13072	30596	43668	2054	45722	84807	53.91%	15.41%	81	81
15	花蓮縣花蓮市	2018-11-24T23:27:29+08:00	6230	14973	21203	1042	22245	40877	54.42%	15.24%	45	81
15	花蓮縣花蓮市	2018-11-25T00:23:16+08:00	10120	23754	33874	1608	35482	65444	54.22%	15.46%	66	81
15	花蓮縣花蓮市	2018-11-25T01:02:43+08:00	11921	28057	39978	1890	41868	76891	54.45%	15.5%	75	81
15	花蓮縣花蓮市	2018-11-25T06:29:30+08:00	13072	30596	43668	2054	45722	84807	53.91%	15.41%	81	81
15	花蓮縣花蓮市	2018-11-24T23:12:29+08:00	5428	12986	18414	897	19311	35641	54.18%	15.23%	40	81
15	花蓮縣花蓮市	2018-11-25T03:50:03+08:00	13072	30596	43668	2054	45722	84807	53.91%	15.41%	81	81
15	花蓮縣花蓮市	2018-11-25T01:07:39+08:00	12301	28919	41220	1945	43165	79385	54.37%	15.5%	77	81
15	花蓮縣花蓮市	2018-11-25T01:26:07+08:00	12681	29821	42502	2004	44506	82106	54.21%	15.44%	79	81
15	花蓮縣花蓮市	2018-11-25T00:14:22+08:00	9542	22440	31982	1528	33510	61730	54.28%	15.46%	63	81
15	花蓮縣花蓮市	2018-11-25T03:39:06+08:00	13072	30596	43668	2054	45722	84807	53.91%	15.41%	81	81
15	花蓮縣花蓮市	2018-11-24T23:20:05+08:00	5504	13162	18666	906	19572	36110	54.2%	15.24%	41	81
15	高雄市湖內區	2018-11-25T01:18:01+08:00	4289	9148	13437	942	14379	25729	55.89%	16.67%	24	24
15	高雄市湖內區	2018-11-24T22:58:01+08:00	4289	9148	13437	942	14379	25729	55.89%	16.67%	24	24
15	高雄市湖內區	2018-11-24T22:26:43+08:00	4089	8743	12832	905	13737	24712	55.59%	16.55%	23	24
15	高雄市湖內區	2018-11-25T00:09:42+08:00	4289	9148	13437	942	14379	25729	55.89%	16.67%	24	24
15	高雄市湖內區	2018-11-24T22:37:07+08:00	4089	8743	12832	905	13737	24712	55.59%	16.55%	23	24
15	高雄市湖內區	2018-11-24T22:50:56+08:00	4289	9148	13437	942	14379	25729	55.89%	16.67%	24	24
15	高雄市湖內區	2018-11-25T00:18:39+08:00	4289	9148	13437	942	14379	25729	55.89%	16.67%	24	24
15	高雄市湖內區	2018-11-24T22:45:14+08:00	4289	9148	13437	942	14379	25729	55.89%	16.67%	24	24
15	高雄市湖內區	2018-11-25T03:56:20+08:00	4289	9148	13437	942	14379	25729	55.89%	16.67%	24	24
15	高雄市湖內區	2018-11-25T00:05:12+08:00	4289	9148	13437	942	14379	25729	55.89%	16.67%	24	24
15	高雄市湖內區	2018-11-24T23:16:09+08:00	4289	9148	13437	942	14379	25729	55.89%	16.67%	24	24
15	高雄市湖內區	2018-11-25T01:02:38+08:00	4289	9148	13437	942	14379	25729	55.89%	16.67%	24	24
15	高雄市湖內區	2018-11-25T00:57:44+08:00	4289	9148	13437	942	14379	25729	55.89%	16.67%	24	24
15	高雄市湖內區	2018-11-24T22:40:34+08:00	4289	9148	13437	942	14379	25729	55.89%	16.67%	24	24
15	高雄市湖內區	2018-11-25T06:09:01+08:00	4289	9148	13437	942	14379	25729	55.89%	16.67%	24	24
15	高雄市湖內區	2018-11-24T22:19:43+08:00	4089	8743	12832	905	13737	24712	55.59%	16.55%	23	24
15	高雄市湖內區	2018-11-24T23:55:53+08:00	4289	9148	13437	942	14379	25729	55.89%	16.67%	24	24
15	高雄市湖內區	2018-11-25T03:44:31+08:00	4289	9148	13437	942	14379	25729	55.89%	16.67%	24	24
15	高雄市湖內區	2018-11-24T23:19:59+08:00	4289	9148	13437	942	14379	25729	55.89%	16.67%	24	24
15	高雄市湖內區	2018-11-25T00:00:17+08:00	4289	9148	13437	942	14379	25729	55.89%	16.67%	24	24
15	高雄市湖內區	2018-11-24T23:27:24+08:00	4289	9148	13437	942	14379	25729	55.89%	16.67%	24	24
15	高雄市湖內區	2018-11-25T01:07:33+08:00	4289	9148	13437	942	14379	25729	55.89%	16.67%	24	24
15	高雄市湖內區	2018-11-24T23:31:19+08:00	4289	9148	13437	942	14379	25729	55.89%	16.67%	24	24
15	高雄市湖內區	2018-11-24T23:12:23+08:00	4289	9148	13437	942	14379	25729	55.89%	16.67%	24	24
15	高雄市湖內區	2018-11-24T23:39:24+08:00	4289	9148	13437	942	14379	25729	55.89%	16.67%	24	24
15	高雄市湖內區	2018-11-24T23:01:38+08:00	4289	9148	13437	942	14379	25729	55.89%	16.67%	24	24
15	高雄市湖內區	2018-11-24T23:35:17+08:00	4289	9148	13437	942	14379	25729	55.89%	16.67%	24	24
15	高雄市湖內區	2018-11-25T04:02:59+08:00	4289	9148	13437	942	14379	25729	55.89%	16.67%	24	24
15	高雄市湖內區	2018-11-25T00:14:17+08:00	4289	9148	13437	942	14379	25729	55.89%	16.67%	24	24
15	高雄市湖內區	2018-11-24T23:43:23+08:00	4289	9148	13437	942	14379	25729	55.89%	16.67%	24	24
15	高雄市湖內區	2018-11-25T01:12:51+08:00	4289	9148	13437	942	14379	25729	55.89%	16.67%	24	24
15	高雄市湖內區	2018-11-24T22:54:31+08:00	4289	9148	13437	942	14379	25729	55.89%	16.67%	24	24
15	高雄市湖內區	2018-11-25T06:13:59+08:00	4289	9148	13437	942	14379	25729	55.89%	16.67%	24	24
15	高雄市湖內區	2018-11-24T22:41:43+08:00	4289	9148	13437	942	14379	25729	55.89%	16.67%	24	24
15	高雄市湖內區	2018-11-25T03:49:57+08:00	4289	9148	13437	942	14379	25729	55.89%	16.67%	24	24
15	高雄市湖內區	2018-11-24T23:05:10+08:00	4289	9148	13437	942	14379	25729	55.89%	16.67%	24	24
15	高雄市湖內區	2018-11-25T06:19:04+08:00	4289	9148	13437	942	14379	25729	55.89%	16.67%	24	24
15	高雄市湖內區	2018-11-25T06:29:24+08:00	4289	9148	13437	942	14379	25729	55.89%	16.67%	24	24
15	高雄市湖內區	2018-11-25T06:24:07+08:00	4289	9148	13437	942	14379	25729	55.89%	16.67%	24	24
15	高雄市湖內區	2018-11-24T22:30:16+08:00	4089	8743	12832	905	13737	24712	55.59%	16.55%	23	24
15	高雄市湖內區	2018-11-24T23:51:42+08:00	4289	9148	13437	942	14379	25729	55.89%	16.67%	24	24
15	高雄市湖內區	2018-11-24T22:13:36+08:00	4089	8743	12832	905	13737	24712	55.59%	16.55%	23	24
15	高雄市湖內區	2018-11-24T23:08:44+08:00	4289	9148	13437	942	14379	25729	55.89%	16.67%	24	24
15	高雄市湖內區	2018-11-24T22:23:21+08:00	4089	8743	12832	905	13737	24712	55.59%	16.55%	23	24
15	高雄市湖內區	2018-11-25T03:32:44+08:00	4289	9148	13437	942	14379	25729	55.89%	16.67%	24	24
15	高雄市湖內區	2018-11-24T23:23:44+08:00	4289	9148	13437	942	14379	25729	55.89%	16.67%	24	24
15	高雄市湖內區	2018-11-25T00:23:11+08:00	4289	9148	13437	942	14379	25729	55.89%	16.67%	24	24
15	高雄市湖內區	2018-11-25T01:26:00+08:00	4289	9148	13437	942	14379	25729	55.89%	16.67%	24	24
15	高雄市湖內區	2018-11-24T23:47:36+08:00	4289	9148	13437	942	14379	25729	55.89%	16.67%	24	24
15	高雄市湖內區	2018-11-25T03:39:01+08:00	4289	9148	13437	942	14379	25729	55.89%	16.67%	24	24
15	高雄市湖內區	2018-11-24T22:33:45+08:00	4089	8743	12832	905	13737	24712	55.59%	16.55%	23	24
15	高雄市湖內區	2018-11-24T22:16:18+08:00	4089	8743	12832	905	13737	24712	55.59%	16.55%	23	24
15	高雄市內門區	2018-11-24T22:26:43+08:00	1695	3965	5660	645	6305	13002	48.49%	13.04%	18	18
15	高雄市內門區	2018-11-25T00:09:42+08:00	1695	3965	5660	645	6305	13002	48.49%	13.04%	18	18
15	高雄市內門區	2018-11-25T03:56:21+08:00	1695	3965	5660	645	6305	13002	48.49%	13.04%	18	18
15	高雄市內門區	2018-11-25T01:12:52+08:00	1695	3965	5660	645	6305	13002	48.49%	13.04%	18	18
15	高雄市內門區	2018-11-24T22:37:07+08:00	1695	3965	5660	645	6305	13002	48.49%	13.04%	18	18
15	高雄市內門區	2018-11-24T22:54:32+08:00	1695	3965	5660	645	6305	13002	48.49%	13.04%	18	18
15	高雄市內門區	2018-11-24T22:50:56+08:00	1695	3965	5660	645	6305	13002	48.49%	13.04%	18	18
15	高雄市內門區	2018-11-25T00:18:39+08:00	1695	3965	5660	645	6305	13002	48.49%	13.04%	18	18
15	高雄市內門區	2018-11-25T00:05:12+08:00	1695	3965	5660	645	6305	13002	48.49%	13.04%	18	18
15	高雄市內門區	2018-11-24T23:16:09+08:00	1695	3965	5660	645	6305	13002	48.49%	13.04%	18	18
15	高雄市內門區	2018-11-24T22:45:15+08:00	1695	3965	5660	645	6305	13002	48.49%	13.04%	18	18
15	高雄市內門區	2018-11-25T01:02:38+08:00	1695	3965	5660	645	6305	13002	48.49%	13.04%	18	18
15	高雄市內門區	2018-11-25T00:57:44+08:00	1695	3965	5660	645	6305	13002	48.49%	13.04%	18	18
15	高雄市內門區	2018-11-24T22:40:34+08:00	1695	3965	5660	645	6305	13002	48.49%	13.04%	18	18
15	高雄市內門區	2018-11-24T22:19:43+08:00	1416	3433	4849	501	5350	11280	47.43%	12.55%	17	18
15	高雄市內門區	2018-11-25T00:00:18+08:00	1695	3965	5660	645	6305	13002	48.49%	13.04%	18	18
15	高雄市內門區	2018-11-24T23:55:54+08:00	1695	3965	5660	645	6305	13002	48.49%	13.04%	18	18
15	高雄市內門區	2018-11-24T23:27:25+08:00	1695	3965	5660	645	6305	13002	48.49%	13.04%	18	18
15	高雄市內門區	2018-11-24T23:19:59+08:00	1695	3965	5660	645	6305	13002	48.49%	13.04%	18	18
15	高雄市內門區	2018-11-25T01:07:33+08:00	1695	3965	5660	645	6305	13002	48.49%	13.04%	18	18
15	高雄市內門區	2018-11-24T23:31:19+08:00	1695	3965	5660	645	6305	13002	48.49%	13.04%	18	18
15	高雄市內門區	2018-11-24T23:39:25+08:00	1695	3965	5660	645	6305	13002	48.49%	13.04%	18	18
15	高雄市內門區	2018-11-24T23:12:24+08:00	1695	3965	5660	645	6305	13002	48.49%	13.04%	18	18
15	高雄市內門區	2018-11-24T23:01:38+08:00	1695	3965	5660	645	6305	13002	48.49%	13.04%	18	18
15	高雄市內門區	2018-11-24T23:35:17+08:00	1695	3965	5660	645	6305	13002	48.49%	13.04%	18	18
15	高雄市內門區	2018-11-25T04:02:59+08:00	1695	3965	5660	645	6305	13002	48.49%	13.04%	18	18
15	高雄市內門區	2018-11-25T00:14:17+08:00	1695	3965	5660	645	6305	13002	48.49%	13.04%	18	18
15	高雄市內門區	2018-11-24T23:43:23+08:00	1695	3965	5660	645	6305	13002	48.49%	13.04%	18	18
15	高雄市內門區	2018-11-24T22:58:02+08:00	1695	3965	5660	645	6305	13002	48.49%	13.04%	18	18
15	高雄市內門區	2018-11-25T03:49:58+08:00	1695	3965	5660	645	6305	13002	48.49%	13.04%	18	18
15	高雄市內門區	2018-11-25T01:18:02+08:00	1695	3965	5660	645	6305	13002	48.49%	13.04%	18	18
15	高雄市內門區	2018-11-24T23:05:11+08:00	1695	3965	5660	645	6305	13002	48.49%	13.04%	18	18
15	高雄市內門區	2018-11-25T06:13:59+08:00	1695	3965	5660	645	6305	13002	48.49%	13.04%	18	18
15	高雄市內門區	2018-11-24T22:41:43+08:00	1695	3965	5660	645	6305	13002	48.49%	13.04%	18	18
15	高雄市內門區	2018-11-25T06:19:04+08:00	1695	3965	5660	645	6305	13002	48.49%	13.04%	18	18
15	高雄市內門區	2018-11-25T06:29:24+08:00	1695	3965	5660	645	6305	13002	48.49%	13.04%	18	18
15	高雄市內門區	2018-11-25T06:24:07+08:00	1695	3965	5660	645	6305	13002	48.49%	13.04%	18	18
15	高雄市內門區	2018-11-24T22:30:17+08:00	1695	3965	5660	645	6305	13002	48.49%	13.04%	18	18
15	高雄市內門區	2018-11-24T23:51:42+08:00	1695	3965	5660	645	6305	13002	48.49%	13.04%	18	18
15	高雄市內門區	2018-11-25T06:09:02+08:00	1695	3965	5660	645	6305	13002	48.49%	13.04%	18	18
15	高雄市內門區	2018-11-24T23:23:45+08:00	1695	3965	5660	645	6305	13002	48.49%	13.04%	18	18
15	高雄市內門區	2018-11-25T03:44:32+08:00	1695	3965	5660	645	6305	13002	48.49%	13.04%	18	18
15	高雄市內門區	2018-11-24T23:08:44+08:00	1695	3965	5660	645	6305	13002	48.49%	13.04%	18	18
15	高雄市內門區	2018-11-24T22:23:21+08:00	1695	3965	5660	645	6305	13002	48.49%	13.04%	18	18
15	高雄市內門區	2018-11-25T03:32:44+08:00	1695	3965	5660	645	6305	13002	48.49%	13.04%	18	18
15	高雄市內門區	2018-11-24T22:13:37+08:00	1416	3433	4849	501	5350	11280	47.43%	12.55%	17	18
15	高雄市內門區	2018-11-25T00:23:11+08:00	1695	3965	5660	645	6305	13002	48.49%	13.04%	18	18
15	高雄市內門區	2018-11-25T01:26:00+08:00	1695	3965	5660	645	6305	13002	48.49%	13.04%	18	18
15	高雄市內門區	2018-11-24T23:47:36+08:00	1695	3965	5660	645	6305	13002	48.49%	13.04%	18	18
15	高雄市內門區	2018-11-25T03:39:01+08:00	1695	3965	5660	645	6305	13002	48.49%	13.04%	18	18
15	高雄市內門區	2018-11-24T22:33:45+08:00	1695	3965	5660	645	6305	13002	48.49%	13.04%	18	18
15	高雄市內門區	2018-11-24T22:16:18+08:00	1416	3433	4849	501	5350	11280	47.43%	12.55%	17	18
15	嘉義縣	2018-11-25T01:18:06+08:00	64314	137602	201916	19683	221599	438075	50.58%	14.68%	483	486
15	嘉義縣	2018-11-25T06:29:28+08:00	65100	139182	204282	19875	224157	442775	50.63%	14.7%	486	486
15	嘉義縣	2018-11-25T01:12:55+08:00	64314	137602	201916	19683	221599	438075	50.58%	14.68%	483	486
15	嘉義縣	2018-11-24T23:05:13+08:00	50372	108031	158403	15933	174336	348014	50.09%	14.47%	422	486
15	嘉義縣	2018-11-25T06:19:07+08:00	65100	139182	204282	19875	224157	442775	50.63%	14.7%	486	486
15	嘉義縣	2018-11-25T00:05:15+08:00	60035	128549	188584	18463	207047	410318	50.46%	14.63%	464	486
15	嘉義縣	2018-11-24T22:54:34+08:00	48774	104570	153344	15456	168800	337069	50.08%	14.47%	414	486
15	嘉義縣	2018-11-24T22:41:47+08:00	45468	97450	142918	14571	157489	314787	50.03%	14.44%	397	486
15	嘉義縣	2018-11-24T23:43:26+08:00	57688	123480	181168	17871	199039	394980	50.39%	14.61%	453	486
15	嘉義縣	2018-11-24T22:50:59+08:00	46844	100332	147176	14982	162158	323980	50.05%	14.46%	405	486
15	嘉義縣	2018-11-25T00:00:20+08:00	58838	125988	184826	18153	202979	402478	50.43%	14.62%	459	486
15	嘉義縣	2018-11-25T01:02:41+08:00	63743	136344	200087	19573	219660	434403	50.57%	14.67%	481	486
15	嘉義縣	2018-11-25T00:23:14+08:00	62122	133202	195324	18992	214316	424129	50.53%	14.65%	473	486
15	嘉義縣	2018-11-25T03:32:48+08:00	65100	139182	204282	19875	224157	442775	50.63%	14.7%	486	486
15	嘉義縣	2018-11-25T06:24:10+08:00	65100	139182	204282	19875	224157	442775	50.63%	14.7%	486	486
15	嘉義縣	2018-11-24T22:23:25+08:00	41522	88747	130269	13317	143586	287316	49.97%	14.45%	371	486
15	嘉義縣	2018-11-25T03:44:37+08:00	65100	139182	204282	19875	224157	442775	50.63%	14.7%	486	486
15	嘉義縣	2018-11-24T23:23:47+08:00	53216	114397	167613	16742	184355	366857	50.25%	14.51%	435	486
15	嘉義縣	2018-11-24T23:08:48+08:00	50616	108578	159194	15989	175183	349414	50.14%	14.49%	423	486
15	嘉義縣	2018-11-25T03:50:00+08:00	65100	139182	204282	19875	224157	442775	50.63%	14.7%	486	486
15	嘉義縣	2018-11-24T22:33:47+08:00	44733	95693	140426	14368	154794	309219	50.06%	14.47%	392	486
15	嘉義縣	2018-11-24T22:16:22+08:00	39625	84632	124257	12593	136850	274218	49.91%	14.45%	359	486
15	嘉義縣	2018-11-25T01:26:03+08:00	64554	138175	202729	19720	222449	439687	50.59%	14.68%	484	486
15	嘉義縣	2018-11-25T03:39:04+08:00	65100	139182	204282	19875	224157	442775	50.63%	14.7%	486	486
15	嘉義縣	2018-11-24T23:16:13+08:00	52175	112094	164269	16426	180695	360071	50.18%	14.49%	430	486
15	嘉義縣	2018-11-25T00:14:20+08:00	61231	131198	192429	18766	211195	418117	50.51%	14.64%	469	486
15	嘉義縣	2018-11-24T23:35:19+08:00	55954	119845	175799	17409	193208	384042	50.31%	14.57%	446	486
15	嘉義縣	2018-11-24T23:47:40+08:00	57926	123921	181847	17916	199763	396403	50.39%	14.61%	454	486
15	嘉義縣	2018-11-24T22:45:17+08:00	45736	97943	143679	14707	158386	316389	50.06%	14.46%	399	486
15	嘉義縣	2018-11-24T22:58:05+08:00	49268	105604	154872	15604	170476	340386	50.08%	14.47%	416	486
15	嘉義縣	2018-11-25T00:09:46+08:00	60919	130559	191478	18699	210177	416294	50.49%	14.63%	468	486
15	嘉義縣	2018-11-25T03:56:24+08:00	65100	139182	204282	19875	224157	442775	50.63%	14.7%	486	486
15	嘉義縣	2018-11-24T22:26:46+08:00	42485	90748	133233	13623	146856	293493	50.04%	14.48%	378	486
15	嘉義縣	2018-11-24T23:01:42+08:00	49757	106699	156456	15738	172194	343577	50.12%	14.48%	419	486
15	嘉義縣	2018-11-25T00:57:47+08:00	63561	135935	199496	19472	218968	433201	50.55%	14.67%	480	486
15	嘉義縣	2018-11-24T22:19:46+08:00	40406	86333	126739	12829	139568	279562	49.92%	14.45%	364	486
15	嘉義縣	2018-11-24T22:13:41+08:00	38829	82874	121703	12376	134079	268591	49.92%	14.46%	354	486
15	嘉義縣	2018-11-25T04:03:02+08:00	65100	139182	204282	19875	224157	442775	50.63%	14.7%	486	486
15	嘉義縣	2018-11-24T22:40:37+08:00	45468	97450	142918	14571	157489	314787	50.03%	14.44%	397	486
15	嘉義縣	2018-11-24T23:51:45+08:00	58390	124878	183268	18042	201310	399468	50.39%	14.62%	457	486
15	嘉義縣	2018-11-24T22:30:20+08:00	43290	92507	135797	13918	149715	298821	50.1%	14.49%	383	486
15	嘉義縣	2018-11-25T06:09:05+08:00	65100	139182	204282	19875	224157	442775	50.63%	14.7%	486	486
15	嘉義縣	2018-11-24T23:55:57+08:00	58627	125474	184101	18107	202208	400997	50.43%	14.62%	458	486
15	嘉義縣	2018-11-24T23:27:27+08:00	55127	118183	173310	17253	190563	378840	50.3%	14.55%	442	486
15	嘉義縣	2018-11-25T06:14:02+08:00	65100	139182	204282	19875	224157	442775	50.63%	14.7%	486	486
15	嘉義縣	2018-11-25T00:18:43+08:00	61842	132606	194448	18922	213370	422197	50.54%	14.65%	472	486
15	嘉義縣	2018-11-24T23:12:27+08:00	51284	109891	161175	16170	177345	353735	50.13%	14.5%	426	486
15	嘉義縣	2018-11-24T23:39:28+08:00	57182	122382	179564	17759	197323	391945	50.34%	14.59%	451	486
15	嘉義縣	2018-11-24T22:37:11+08:00	45271	96997	142268	14504	156772	313126	50.07%	14.46%	395	486
15	嘉義縣	2018-11-24T23:31:23+08:00	55622	119250	174872	17363	192235	382094	50.31%	14.56%	445	486
15	嘉義縣	2018-11-24T23:20:02+08:00	52801	113433	166234	16618	182852	364294	50.19%	14.49%	433	486
15	嘉義縣	2018-11-25T01:07:36+08:00	64314	137602	201916	19683	221599	438075	50.58%	14.68%	483	486
15	嘉義縣義竹鄉	2018-11-25T01:18:06+08:00	2458	5021	7479	910	8389	16647	50.39%	14.77%	26	26
15	嘉義縣義竹鄉	2018-11-25T06:29:28+08:00	2458	5021	7479	910	8389	16647	50.39%	14.77%	26	26
15	嘉義縣義竹鄉	2018-11-24T23:43:27+08:00	2458	5021	7479	910	8389	16647	50.39%	14.77%	26	26
15	嘉義縣義竹鄉	2018-11-25T01:12:55+08:00	2458	5021	7479	910	8389	16647	50.39%	14.77%	26	26
15	嘉義縣義竹鄉	2018-11-24T22:54:35+08:00	2458	5021	7479	910	8389	16647	50.39%	14.77%	26	26
15	嘉義縣義竹鄉	2018-11-24T23:05:14+08:00	2458	5021	7479	910	8389	16647	50.39%	14.77%	26	26
15	嘉義縣義竹鄉	2018-11-25T06:19:07+08:00	2458	5021	7479	910	8389	16647	50.39%	14.77%	26	26
15	嘉義縣義竹鄉	2018-11-25T00:05:15+08:00	2458	5021	7479	910	8389	16647	50.39%	14.77%	26	26
15	嘉義縣義竹鄉	2018-11-24T22:41:47+08:00	2458	5021	7479	910	8389	16647	50.39%	14.77%	26	26
15	嘉義縣義竹鄉	2018-11-24T23:51:46+08:00	2458	5021	7479	910	8389	16647	50.39%	14.77%	26	26
15	嘉義縣義竹鄉	2018-11-25T06:09:06+08:00	2458	5021	7479	910	8389	16647	50.39%	14.77%	26	26
15	嘉義縣義竹鄉	2018-11-25T01:02:41+08:00	2458	5021	7479	910	8389	16647	50.39%	14.77%	26	26
15	嘉義縣義竹鄉	2018-11-25T00:23:14+08:00	2458	5021	7479	910	8389	16647	50.39%	14.77%	26	26
15	嘉義縣義竹鄉	2018-11-24T23:23:48+08:00	2458	5021	7479	910	8389	16647	50.39%	14.77%	26	26
15	嘉義縣義竹鄉	2018-11-25T06:24:10+08:00	2458	5021	7479	910	8389	16647	50.39%	14.77%	26	26
15	嘉義縣義竹鄉	2018-11-25T00:00:21+08:00	2458	5021	7479	910	8389	16647	50.39%	14.77%	26	26
15	嘉義縣義竹鄉	2018-11-24T22:23:25+08:00	2458	5021	7479	910	8389	16647	50.39%	14.77%	26	26
15	嘉義縣義竹鄉	2018-11-24T22:51:00+08:00	2458	5021	7479	910	8389	16647	50.39%	14.77%	26	26
15	嘉義縣義竹鄉	2018-11-25T03:32:49+08:00	2458	5021	7479	910	8389	16647	50.39%	14.77%	26	26
15	嘉義縣義竹鄉	2018-11-25T03:44:37+08:00	2458	5021	7479	910	8389	16647	50.39%	14.77%	26	26
15	嘉義縣義竹鄉	2018-11-24T23:08:48+08:00	2458	5021	7479	910	8389	16647	50.39%	14.77%	26	26
15	嘉義縣義竹鄉	2018-11-24T22:16:22+08:00	2102	4245	6347	812	7159	14275	50.15%	14.73%	24	26
15	嘉義縣義竹鄉	2018-11-25T01:26:04+08:00	2458	5021	7479	910	8389	16647	50.39%	14.77%	26	26
15	嘉義縣義竹鄉	2018-11-24T23:16:13+08:00	2458	5021	7479	910	8389	16647	50.39%	14.77%	26	26
15	嘉義縣義竹鄉	2018-11-24T23:35:20+08:00	2458	5021	7479	910	8389	16647	50.39%	14.77%	26	26
15	嘉義縣義竹鄉	2018-11-25T00:14:20+08:00	2458	5021	7479	910	8389	16647	50.39%	14.77%	26	26
15	嘉義縣義竹鄉	2018-11-25T03:39:05+08:00	2458	5021	7479	910	8389	16647	50.39%	14.77%	26	26
15	嘉義縣義竹鄉	2018-11-24T22:33:48+08:00	2458	5021	7479	910	8389	16647	50.39%	14.77%	26	26
15	嘉義縣義竹鄉	2018-11-25T03:50:01+08:00	2458	5021	7479	910	8389	16647	50.39%	14.77%	26	26
15	嘉義縣義竹鄉	2018-11-24T23:47:40+08:00	2458	5021	7479	910	8389	16647	50.39%	14.77%	26	26
15	嘉義縣義竹鄉	2018-11-24T22:58:05+08:00	2458	5021	7479	910	8389	16647	50.39%	14.77%	26	26
15	嘉義縣義竹鄉	2018-11-25T00:09:46+08:00	2458	5021	7479	910	8389	16647	50.39%	14.77%	26	26
15	嘉義縣義竹鄉	2018-11-24T22:45:18+08:00	2458	5021	7479	910	8389	16647	50.39%	14.77%	26	26
15	嘉義縣義竹鄉	2018-11-25T03:56:24+08:00	2458	5021	7479	910	8389	16647	50.39%	14.77%	26	26
15	嘉義縣義竹鄉	2018-11-24T22:26:46+08:00	2458	5021	7479	910	8389	16647	50.39%	14.77%	26	26
15	嘉義縣義竹鄉	2018-11-24T23:01:42+08:00	2458	5021	7479	910	8389	16647	50.39%	14.77%	26	26
15	嘉義縣義竹鄉	2018-11-24T22:13:41+08:00	2102	4245	6347	812	7159	14275	50.15%	14.73%	24	26
15	嘉義縣義竹鄉	2018-11-25T04:03:03+08:00	2458	5021	7479	910	8389	16647	50.39%	14.77%	26	26
15	嘉義縣義竹鄉	2018-11-25T00:57:48+08:00	2458	5021	7479	910	8389	16647	50.39%	14.77%	26	26
15	嘉義縣義竹鄉	2018-11-24T22:19:47+08:00	2102	4245	6347	812	7159	14275	50.15%	14.73%	24	26
15	嘉義縣義竹鄉	2018-11-24T22:40:37+08:00	2458	5021	7479	910	8389	16647	50.39%	14.77%	26	26
15	嘉義縣義竹鄉	2018-11-24T22:30:20+08:00	2458	5021	7479	910	8389	16647	50.39%	14.77%	26	26
15	嘉義縣義竹鄉	2018-11-24T23:27:28+08:00	2458	5021	7479	910	8389	16647	50.39%	14.77%	26	26
15	嘉義縣義竹鄉	2018-11-24T23:55:57+08:00	2458	5021	7479	910	8389	16647	50.39%	14.77%	26	26
15	嘉義縣義竹鄉	2018-11-25T06:14:02+08:00	2458	5021	7479	910	8389	16647	50.39%	14.77%	26	26
15	嘉義縣義竹鄉	2018-11-25T00:18:43+08:00	2458	5021	7479	910	8389	16647	50.39%	14.77%	26	26
15	嘉義縣義竹鄉	2018-11-24T23:20:03+08:00	2458	5021	7479	910	8389	16647	50.39%	14.77%	26	26
15	嘉義縣義竹鄉	2018-11-25T01:07:37+08:00	2458	5021	7479	910	8389	16647	50.39%	14.77%	26	26
15	嘉義縣義竹鄉	2018-11-24T23:12:27+08:00	2458	5021	7479	910	8389	16647	50.39%	14.77%	26	26
15	嘉義縣義竹鄉	2018-11-24T22:37:11+08:00	2458	5021	7479	910	8389	16647	50.39%	14.77%	26	26
15	嘉義縣義竹鄉	2018-11-24T23:39:29+08:00	2458	5021	7479	910	8389	16647	50.39%	14.77%	26	26
15	嘉義縣義竹鄉	2018-11-24T23:31:23+08:00	2458	5021	7479	910	8389	16647	50.39%	14.77%	26	26
15	新竹市香山區	2018-11-24T23:01:47+08:00	8438	16445	24883	1438	26321	46506	56.6%	18.14%	41	55
15	新竹市香山區	2018-11-24T23:47:44+08:00	11302	22551	33853	1939	35792	63269	56.57%	17.86%	54	55
15	新竹市香山區	2018-11-25T03:56:29+08:00	11553	23040	34593	1975	36568	64896	56.35%	17.8%	55	55
15	新竹市香山區	2018-11-24T23:08:52+08:00	8993	17562	26555	1520	28075	49716	56.47%	18.09%	43	55
15	新竹市香山區	2018-11-25T03:32:54+08:00	11553	23040	34593	1975	36568	64896	56.35%	17.8%	55	55
15	新竹市香山區	2018-11-24T23:51:49+08:00	11553	23040	34593	1975	36568	64896	56.35%	17.8%	55	55
15	新竹市香山區	2018-11-24T23:23:52+08:00	10746	21372	32118	1849	33967	59892	56.71%	17.94%	51	55
15	新竹市香山區	2018-11-24T23:27:31+08:00	10903	21757	32660	1884	34544	61115	56.52%	17.84%	52	55
15	新竹市香山區	2018-11-24T22:30:24+08:00	6502	12973	19475	1121	20596	36932	55.77%	17.61%	32	55
15	新竹市香山區	2018-11-25T04:03:07+08:00	11553	23040	34593	1975	36568	64896	56.35%	17.8%	55	55
15	新竹市香山區	2018-11-24T22:19:51+08:00	6502	12973	19475	1121	20596	36932	55.77%	17.61%	32	55
15	新竹市香山區	2018-11-25T06:14:06+08:00	11553	23040	34593	1975	36568	64896	56.35%	17.8%	55	55
15	新竹市香山區	2018-11-24T23:20:09+08:00	10486	20770	31256	1807	33063	58428	56.59%	17.95%	50	55
15	新竹市香山區	2018-11-24T23:31:28+08:00	10903	21757	32660	1884	34544	61115	56.52%	17.84%	52	55
15	新竹市香山區	2018-11-24T23:43:32+08:00	11302	22551	33853	1939	35792	63269	56.57%	17.86%	54	55
15	新竹市香山區	2018-11-24T22:37:15+08:00	7161	14060	21221	1207	22428	40009	56.06%	17.9%	35	55
15	新竹市香山區	2018-11-24T22:26:50+08:00	6502	12973	19475	1121	20596	36932	55.77%	17.61%	32	55
15	新竹市香山區	2018-11-25T01:18:12+08:00	11553	23040	34593	1975	36568	64896	56.35%	17.8%	55	55
15	新竹市香山區	2018-11-25T00:18:48+08:00	11553	23040	34593	1975	36568	64896	56.35%	17.8%	55	55
15	新竹市香山區	2018-11-25T06:29:32+08:00	11553	23040	34593	1975	36568	64896	56.35%	17.8%	55	55
15	新竹市香山區	2018-11-24T22:45:21+08:00	7392	14463	21855	1263	23118	41032	56.34%	18.02%	36	55
15	新竹市香山區	2018-11-24T22:54:38+08:00	8255	16041	24296	1395	25691	45420	56.56%	18.17%	40	55
15	新竹市香山區	2018-11-24T23:12:32+08:00	9517	18762	28279	1628	29907	53136	56.28%	17.91%	46	55
15	新竹市香山區	2018-11-24T22:33:51+08:00	6755	13339	20094	1135	21229	37908	56%	17.82%	33	55
15	新竹市香山區	2018-11-24T23:39:34+08:00	11302	22551	33853	1939	35792	63269	56.57%	17.86%	54	55
15	新竹市香山區	2018-11-25T00:05:19+08:00	11553	23040	34593	1975	36568	64896	56.35%	17.8%	55	55
15	新竹市香山區	2018-11-25T01:07:41+08:00	11553	23040	34593	1975	36568	64896	56.35%	17.8%	55	55
15	新竹市香山區	2018-11-24T23:05:17+08:00	8438	16445	24883	1438	26321	46506	56.6%	18.14%	41	55
15	新竹市香山區	2018-11-24T23:56:02+08:00	11553	23040	34593	1975	36568	64896	56.35%	17.8%	55	55
15	新竹市香山區	2018-11-24T22:13:46+08:00	6346	12642	18988	1092	20080	36042	55.71%	17.61%	31	55
15	新竹市香山區	2018-11-25T03:44:42+08:00	11553	23040	34593	1975	36568	64896	56.35%	17.8%	55	55
15	新竹市香山區	2018-11-24T22:23:29+08:00	6502	12973	19475	1121	20596	36932	55.77%	17.61%	32	55
15	新竹市香山區	2018-11-25T06:09:11+08:00	11553	23040	34593	1975	36568	64896	56.35%	17.8%	55	55
15	新竹市香山區	2018-11-25T01:02:45+08:00	11553	23040	34593	1975	36568	64896	56.35%	17.8%	55	55
15	新竹市香山區	2018-11-24T22:40:41+08:00	7392	14463	21855	1263	23118	41032	56.34%	18.02%	36	55
15	新竹市香山區	2018-11-25T00:57:52+08:00	11553	23040	34593	1975	36568	64896	56.35%	17.8%	55	55
15	新竹市香山區	2018-11-24T22:51:04+08:00	7749	15161	22910	1324	24234	42895	56.5%	18.07%	38	55
15	新竹市香山區	2018-11-25T01:13:00+08:00	11553	23040	34593	1975	36568	64896	56.35%	17.8%	55	55
15	新竹市香山區	2018-11-25T06:24:14+08:00	11553	23040	34593	1975	36568	64896	56.35%	17.8%	55	55
15	新竹市香山區	2018-11-25T00:23:18+08:00	11553	23040	34593	1975	36568	64896	56.35%	17.8%	55	55
15	新竹市香山區	2018-11-25T00:00:25+08:00	11553	23040	34593	1975	36568	64896	56.35%	17.8%	55	55
15	新竹市香山區	2018-11-24T23:35:23+08:00	10903	21757	32660	1884	34544	61115	56.52%	17.84%	52	55
15	新竹市香山區	2018-11-24T23:16:17+08:00	10037	19854	29891	1726	31617	55940	56.52%	17.94%	48	55
15	新竹市香山區	2018-11-25T00:14:24+08:00	11553	23040	34593	1975	36568	64896	56.35%	17.8%	55	55
15	新竹市香山區	2018-11-24T22:58:10+08:00	8255	16041	24296	1395	25691	45420	56.56%	18.17%	40	55
15	新竹市香山區	2018-11-25T01:26:09+08:00	11553	23040	34593	1975	36568	64896	56.35%	17.8%	55	55
15	新竹市香山區	2018-11-25T03:39:09+08:00	11553	23040	34593	1975	36568	64896	56.35%	17.8%	55	55
15	新竹市香山區	2018-11-24T22:16:26+08:00	6502	12973	19475	1121	20596	36932	55.77%	17.61%	32	55
15	新竹市香山區	2018-11-25T00:09:52+08:00	11553	23040	34593	1975	36568	64896	56.35%	17.8%	55	55
15	新竹市香山區	2018-11-25T06:19:11+08:00	11553	23040	34593	1975	36568	64896	56.35%	17.8%	55	55
15	新竹市香山區	2018-11-24T22:41:51+08:00	7392	14463	21855	1263	23118	41032	56.34%	18.02%	36	55
15	新竹市香山區	2018-11-25T03:50:05+08:00	11553	23040	34593	1975	36568	64896	56.35%	17.8%	55	55
15	嘉義市東區	2018-11-24T23:01:47+08:00	14952	27541	42493	2024	44517	80722	55.15%	18.52%	68	81
15	嘉義市東區	2018-11-24T23:47:44+08:00	17445	32036	49481	2497	51978	95609	54.37%	18.25%	78	81
15	嘉義市東區	2018-11-24T22:45:22+08:00	14294	26240	40534	1927	42461	77110	55.07%	18.54%	65	81
15	嘉義市東區	2018-11-25T03:56:29+08:00	18474	33619	52093	2560	54653	100647	54.3%	18.36%	81	81
15	嘉義市東區	2018-11-24T23:08:52+08:00	15154	27844	42998	2060	45058	81702	55.15%	18.55%	69	81
15	嘉義市東區	2018-11-25T03:32:54+08:00	18474	33619	52093	2560	54653	100647	54.3%	18.36%	81	81
15	嘉義市東區	2018-11-24T23:51:49+08:00	17200	31471	48671	2445	51116	94042	54.35%	18.29%	77	81
15	嘉義市東區	2018-11-24T23:23:52+08:00	16310	29904	46214	2314	48528	89278	54.36%	18.27%	74	81
15	嘉義市東區	2018-11-24T22:23:30+08:00	12307	22538	34845	1650	36495	65692	55.55%	18.73%	57	81
15	嘉義市東區	2018-11-24T22:30:24+08:00	12828	23447	36275	1740	38015	68753	55.29%	18.66%	59	81
15	嘉義市東區	2018-11-25T04:03:07+08:00	18474	33619	52093	2560	54653	100647	54.3%	18.36%	81	81
15	嘉義市東區	2018-11-24T22:19:51+08:00	12307	22538	34845	1650	36495	65692	55.55%	18.73%	57	81
15	嘉義市東區	2018-11-25T06:14:06+08:00	18474	33619	52093	2560	54653	100647	54.3%	18.36%	81	81
15	嘉義市東區	2018-11-24T23:20:09+08:00	16130	29445	45575	2274	47849	87849	54.47%	18.36%	73	81
15	嘉義市東區	2018-11-24T23:31:28+08:00	16609	30480	47089	2354	49443	90830	54.43%	18.29%	75	81
15	嘉義市東區	2018-11-24T23:43:32+08:00	17445	32036	49481	2497	51978	95609	54.37%	18.25%	78	81
15	嘉義市東區	2018-11-24T22:37:15+08:00	13597	25043	38640	1857	40497	73325	55.23%	18.54%	62	81
15	嘉義市東區	2018-11-24T22:41:52+08:00	13801	25389	39190	1882	41072	74405	55.2%	18.55%	63	81
15	嘉義市東區	2018-11-24T22:26:50+08:00	12556	22956	35512	1721	37233	66930	55.63%	18.76%	58	81
15	嘉義市東區	2018-11-25T01:18:12+08:00	18474	33619	52093	2560	54653	100647	54.3%	18.36%	81	81
15	嘉義市東區	2018-11-25T00:18:48+08:00	18474	33619	52093	2560	54653	100647	54.3%	18.36%	81	81
15	嘉義市東區	2018-11-25T06:29:32+08:00	18474	33619	52093	2560	54653	100647	54.3%	18.36%	81	81
15	嘉義市東區	2018-11-24T22:54:38+08:00	14682	27039	41721	1998	43719	79294	55.14%	18.52%	67	81
15	嘉義市東區	2018-11-24T23:12:32+08:00	15415	28293	43708	2099	45807	83097	55.12%	18.55%	70	81
15	嘉義市東區	2018-11-24T22:33:51+08:00	13107	24052	37159	1787	38946	70324	55.38%	18.64%	60	81
15	嘉義市東區	2018-11-24T23:39:34+08:00	17212	31579	48791	2478	51269	94343	54.34%	18.24%	77	81
15	嘉義市東區	2018-11-25T00:05:19+08:00	18237	33231	51468	2540	54008	99243	54.42%	18.38%	80	81
15	嘉義市東區	2018-11-25T01:07:41+08:00	18474	33619	52093	2560	54653	100647	54.3%	18.36%	81	81
15	嘉義市東區	2018-11-24T23:05:17+08:00	15154	27844	42998	2060	45058	81702	55.15%	18.55%	69	81
15	嘉義市東區	2018-11-24T23:56:02+08:00	17200	31471	48671	2445	51116	94042	54.35%	18.29%	77	81
15	嘉義市東區	2018-11-24T22:13:46+08:00	11541	21107	32648	1540	34188	61477	55.61%	18.77%	54	81
15	嘉義市東區	2018-11-25T03:44:42+08:00	18474	33619	52093	2560	54653	100647	54.3%	18.36%	81	81
15	嘉義市東區	2018-11-24T23:27:32+08:00	16609	30480	47089	2354	49443	90830	54.43%	18.29%	75	81
15	嘉義市東區	2018-11-25T06:09:11+08:00	18474	33619	52093	2560	54653	100647	54.3%	18.36%	81	81
15	嘉義市東區	2018-11-24T22:51:05+08:00	14294	26240	40534	1927	42461	77110	55.07%	18.54%	65	81
15	嘉義市東區	2018-11-25T01:02:45+08:00	18474	33619	52093	2560	54653	100647	54.3%	18.36%	81	81
15	嘉義市東區	2018-11-24T22:40:41+08:00	13801	25389	39190	1882	41072	74405	55.2%	18.55%	63	81
15	嘉義市東區	2018-11-25T00:57:52+08:00	18474	33619	52093	2560	54653	100647	54.3%	18.36%	81	81
15	嘉義市東區	2018-11-25T01:13:00+08:00	18474	33619	52093	2560	54653	100647	54.3%	18.36%	81	81
15	嘉義市東區	2018-11-25T06:24:14+08:00	18474	33619	52093	2560	54653	100647	54.3%	18.36%	81	81
15	嘉義市東區	2018-11-25T00:23:18+08:00	18474	33619	52093	2560	54653	100647	54.3%	18.36%	81	81
15	嘉義市東區	2018-11-25T00:00:25+08:00	17445	32036	49481	2497	51978	95609	54.37%	18.25%	78	81
15	嘉義市東區	2018-11-24T23:35:23+08:00	16889	31020	47909	2416	50325	92512	54.4%	18.26%	76	81
15	嘉義市東區	2018-11-24T23:16:17+08:00	15731	28821	44552	2145	46697	84655	55.16%	18.58%	71	81
15	嘉義市東區	2018-11-24T22:58:10+08:00	14952	27541	42493	2024	44517	80722	55.15%	18.52%	68	81
15	嘉義市東區	2018-11-25T01:26:09+08:00	18474	33619	52093	2560	54653	100647	54.3%	18.36%	81	81
15	嘉義市東區	2018-11-25T03:39:09+08:00	18474	33619	52093	2560	54653	100647	54.3%	18.36%	81	81
15	嘉義市東區	2018-11-25T00:14:25+08:00	18474	33619	52093	2560	54653	100647	54.3%	18.36%	81	81
15	嘉義市東區	2018-11-25T00:09:52+08:00	18474	33619	52093	2560	54653	100647	54.3%	18.36%	81	81
15	嘉義市東區	2018-11-25T06:19:11+08:00	18474	33619	52093	2560	54653	100647	54.3%	18.36%	81	81
15	嘉義市東區	2018-11-25T03:50:05+08:00	18474	33619	52093	2560	54653	100647	54.3%	18.36%	81	81
15	嘉義市東區	2018-11-24T22:16:27+08:00	12045	22018	34063	1624	35687	64272	55.52%	18.74%	56	81
15	屏東縣佳冬鄉	2018-11-24T22:58:06+08:00	2520	4918	7438	988	8426	17063	49.38%	14.77%	16	16
15	屏東縣佳冬鄉	2018-11-25T06:19:08+08:00	2520	4918	7438	988	8426	17063	49.38%	14.77%	16	16
15	屏東縣佳冬鄉	2018-11-25T03:56:26+08:00	2520	4918	7438	988	8426	17063	49.38%	14.77%	16	16
15	屏東縣佳冬鄉	2018-11-24T23:05:15+08:00	2520	4918	7438	988	8426	17063	49.38%	14.77%	16	16
15	屏東縣佳冬鄉	2018-11-24T23:39:30+08:00	2520	4918	7438	988	8426	17063	49.38%	14.77%	16	16
15	屏東縣佳冬鄉	2018-11-24T22:41:48+08:00	2520	4918	7438	988	8426	17063	49.38%	14.77%	16	16
15	屏東縣佳冬鄉	2018-11-25T06:29:29+08:00	2520	4918	7438	988	8426	17063	49.38%	14.77%	16	16
15	屏東縣佳冬鄉	2018-11-25T01:18:07+08:00	2520	4918	7438	988	8426	17063	49.38%	14.77%	16	16
15	屏東縣佳冬鄉	2018-11-24T23:43:28+08:00	2520	4918	7438	988	8426	17063	49.38%	14.77%	16	16
15	屏東縣佳冬鄉	2018-11-25T06:09:07+08:00	2520	4918	7438	988	8426	17063	49.38%	14.77%	16	16
15	屏東縣佳冬鄉	2018-11-24T23:51:47+08:00	2520	4918	7438	988	8426	17063	49.38%	14.77%	16	16
15	屏東縣佳冬鄉	2018-11-24T22:13:42+08:00	2351	4553	6904	921	7825	15703	49.83%	14.97%	15	16
15	屏東縣佳冬鄉	2018-11-25T06:24:11+08:00	2520	4918	7438	988	8426	17063	49.38%	14.77%	16	16
15	屏東縣佳冬鄉	2018-11-24T23:08:49+08:00	2520	4918	7438	988	8426	17063	49.38%	14.77%	16	16
15	屏東縣佳冬鄉	2018-11-24T22:51:01+08:00	2520	4918	7438	988	8426	17063	49.38%	14.77%	16	16
15	屏東縣佳冬鄉	2018-11-25T03:44:38+08:00	2520	4918	7438	988	8426	17063	49.38%	14.77%	16	16
15	屏東縣佳冬鄉	2018-11-25T00:23:15+08:00	2520	4918	7438	988	8426	17063	49.38%	14.77%	16	16
15	屏東縣佳冬鄉	2018-11-24T23:23:49+08:00	2520	4918	7438	988	8426	17063	49.38%	14.77%	16	16
15	屏東縣佳冬鄉	2018-11-24T22:33:49+08:00	2520	4918	7438	988	8426	17063	49.38%	14.77%	16	16
15	屏東縣佳冬鄉	2018-11-24T22:37:12+08:00	2520	4918	7438	988	8426	17063	49.38%	14.77%	16	16
15	屏東縣佳冬鄉	2018-11-24T23:16:14+08:00	2520	4918	7438	988	8426	17063	49.38%	14.77%	16	16
15	屏東縣佳冬鄉	2018-11-25T01:26:05+08:00	2520	4918	7438	988	8426	17063	49.38%	14.77%	16	16
15	屏東縣佳冬鄉	2018-11-24T22:16:23+08:00	2351	4553	6904	921	7825	15703	49.83%	14.97%	15	16
15	屏東縣佳冬鄉	2018-11-25T00:14:21+08:00	2520	4918	7438	988	8426	17063	49.38%	14.77%	16	16
15	屏東縣佳冬鄉	2018-11-24T23:35:21+08:00	2520	4918	7438	988	8426	17063	49.38%	14.77%	16	16
15	屏東縣佳冬鄉	2018-11-24T22:45:19+08:00	2520	4918	7438	988	8426	17063	49.38%	14.77%	16	16
15	屏東縣佳冬鄉	2018-11-24T22:54:36+08:00	2520	4918	7438	988	8426	17063	49.38%	14.77%	16	16
15	屏東縣佳冬鄉	2018-11-25T00:09:48+08:00	2520	4918	7438	988	8426	17063	49.38%	14.77%	16	16
15	屏東縣佳冬鄉	2018-11-24T23:01:44+08:00	2520	4918	7438	988	8426	17063	49.38%	14.77%	16	16
15	屏東縣佳冬鄉	2018-11-24T22:26:47+08:00	2351	4553	6904	921	7825	15703	49.83%	14.97%	15	16
15	屏東縣佳冬鄉	2018-11-24T23:47:41+08:00	2520	4918	7438	988	8426	17063	49.38%	14.77%	16	16
15	屏東縣佳冬鄉	2018-11-25T01:12:57+08:00	2520	4918	7438	988	8426	17063	49.38%	14.77%	16	16
15	屏東縣佳冬鄉	2018-11-25T00:05:16+08:00	2520	4918	7438	988	8426	17063	49.38%	14.77%	16	16
15	屏東縣佳冬鄉	2018-11-25T00:57:49+08:00	2520	4918	7438	988	8426	17063	49.38%	14.77%	16	16
15	屏東縣佳冬鄉	2018-11-24T22:19:48+08:00	2351	4553	6904	921	7825	15703	49.83%	14.97%	15	16
15	屏東縣佳冬鄉	2018-11-24T22:30:21+08:00	2351	4553	6904	921	7825	15703	49.83%	14.97%	15	16
15	屏東縣佳冬鄉	2018-11-25T03:32:50+08:00	2520	4918	7438	988	8426	17063	49.38%	14.77%	16	16
15	屏東縣佳冬鄉	2018-11-24T22:40:38+08:00	2520	4918	7438	988	8426	17063	49.38%	14.77%	16	16
15	屏東縣佳冬鄉	2018-11-25T04:03:04+08:00	2520	4918	7438	988	8426	17063	49.38%	14.77%	16	16
15	屏東縣佳冬鄉	2018-11-25T01:02:42+08:00	2520	4918	7438	988	8426	17063	49.38%	14.77%	16	16
15	屏東縣佳冬鄉	2018-11-25T06:14:03+08:00	2520	4918	7438	988	8426	17063	49.38%	14.77%	16	16
15	屏東縣佳冬鄉	2018-11-24T23:55:59+08:00	2520	4918	7438	988	8426	17063	49.38%	14.77%	16	16
15	屏東縣佳冬鄉	2018-11-24T22:23:26+08:00	2351	4553	6904	921	7825	15703	49.83%	14.97%	15	16
15	屏東縣佳冬鄉	2018-11-24T23:27:29+08:00	2520	4918	7438	988	8426	17063	49.38%	14.77%	16	16
15	屏東縣佳冬鄉	2018-11-25T00:00:22+08:00	2520	4918	7438	988	8426	17063	49.38%	14.77%	16	16
15	屏東縣佳冬鄉	2018-11-24T23:31:25+08:00	2520	4918	7438	988	8426	17063	49.38%	14.77%	16	16
15	屏東縣佳冬鄉	2018-11-24T23:20:04+08:00	2520	4918	7438	988	8426	17063	49.38%	14.77%	16	16
15	屏東縣佳冬鄉	2018-11-25T00:18:45+08:00	2520	4918	7438	988	8426	17063	49.38%	14.77%	16	16
15	屏東縣佳冬鄉	2018-11-25T01:07:38+08:00	2520	4918	7438	988	8426	17063	49.38%	14.77%	16	16
15	屏東縣佳冬鄉	2018-11-25T03:39:06+08:00	2520	4918	7438	988	8426	17063	49.38%	14.77%	16	16
15	屏東縣佳冬鄉	2018-11-25T03:50:02+08:00	2520	4918	7438	988	8426	17063	49.38%	14.77%	16	16
15	屏東縣佳冬鄉	2018-11-24T23:12:28+08:00	2520	4918	7438	988	8426	17063	49.38%	14.77%	16	16
15	臺南市後壁區	2018-11-24T22:41:41+08:00	2975	5775	8750	867	9617	20841	46.14%	14.27%	29	29
15	臺南市後壁區	2018-11-24T22:45:13+08:00	2975	5775	8750	867	9617	20841	46.14%	14.27%	29	29
15	臺南市後壁區	2018-11-24T23:16:07+08:00	2975	5775	8750	867	9617	20841	46.14%	14.27%	29	29
15	臺南市後壁區	2018-11-25T03:56:18+08:00	2975	5775	8750	867	9617	20841	46.14%	14.27%	29	29
15	臺南市後壁區	2018-11-24T23:43:21+08:00	2975	5775	8750	867	9617	20841	46.14%	14.27%	29	29
15	臺南市後壁區	2018-11-25T00:18:36+08:00	2975	5775	8750	867	9617	20841	46.14%	14.27%	29	29
15	臺南市後壁區	2018-11-24T23:51:40+08:00	2975	5775	8750	867	9617	20841	46.14%	14.27%	29	29
15	臺南市後壁區	2018-11-24T22:40:32+08:00	2975	5775	8750	867	9617	20841	46.14%	14.27%	29	29
15	臺南市後壁區	2018-11-25T01:25:57+08:00	2975	5775	8750	867	9617	20841	46.14%	14.27%	29	29
15	臺南市後壁區	2018-11-25T01:02:36+08:00	2975	5775	8750	867	9617	20841	46.14%	14.27%	29	29
15	臺南市後壁區	2018-11-24T22:30:14+08:00	2975	5775	8750	867	9617	20841	46.14%	14.27%	29	29
15	臺南市後壁區	2018-11-25T00:23:09+08:00	2975	5775	8750	867	9617	20841	46.14%	14.27%	29	29
15	臺南市後壁區	2018-11-25T00:57:42+08:00	2975	5775	8750	867	9617	20841	46.14%	14.27%	29	29
15	臺南市後壁區	2018-11-25T06:24:05+08:00	2975	5775	8750	867	9617	20841	46.14%	14.27%	29	29
15	臺南市後壁區	2018-11-24T22:57:59+08:00	2975	5775	8750	867	9617	20841	46.14%	14.27%	29	29
15	臺南市後壁區	2018-11-24T23:19:57+08:00	2975	5775	8750	867	9617	20841	46.14%	14.27%	29	29
15	臺南市後壁區	2018-11-25T03:32:41+08:00	2975	5775	8750	867	9617	20841	46.14%	14.27%	29	29
15	臺南市後壁區	2018-11-24T22:13:33+08:00	2975	5775	8750	867	9617	20841	46.14%	14.27%	29	29
15	臺南市後壁區	2018-11-24T23:27:23+08:00	2975	5775	8750	867	9617	20841	46.14%	14.27%	29	29
15	臺南市後壁區	2018-11-25T01:17:58+08:00	2975	5775	8750	867	9617	20841	46.14%	14.27%	29	29
15	臺南市後壁區	2018-11-24T23:39:22+08:00	2975	5775	8750	867	9617	20841	46.14%	14.27%	29	29
15	臺南市後壁區	2018-11-25T01:12:49+08:00	2975	5775	8750	867	9617	20841	46.14%	14.27%	29	29
15	臺南市後壁區	2018-11-25T06:08:59+08:00	2975	5775	8750	867	9617	20841	46.14%	14.27%	29	29
15	臺南市後壁區	2018-11-24T23:31:17+08:00	2975	5775	8750	867	9617	20841	46.14%	14.27%	29	29
15	臺南市後壁區	2018-11-24T23:47:34+08:00	2975	5775	8750	867	9617	20841	46.14%	14.27%	29	29
15	臺南市後壁區	2018-11-24T23:05:09+08:00	2975	5775	8750	867	9617	20841	46.14%	14.27%	29	29
15	臺南市後壁區	2018-11-24T23:01:36+08:00	2975	5775	8750	867	9617	20841	46.14%	14.27%	29	29
15	臺南市後壁區	2018-11-25T04:02:57+08:00	2975	5775	8750	867	9617	20841	46.14%	14.27%	29	29
15	臺南市後壁區	2018-11-25T00:05:10+08:00	2975	5775	8750	867	9617	20841	46.14%	14.27%	29	29
15	臺南市後壁區	2018-11-25T06:19:02+08:00	2975	5775	8750	867	9617	20841	46.14%	14.27%	29	29
15	臺南市後壁區	2018-11-25T06:29:22+08:00	2975	5775	8750	867	9617	20841	46.14%	14.27%	29	29
15	臺南市後壁區	2018-11-25T03:49:56+08:00	2975	5775	8750	867	9617	20841	46.14%	14.27%	29	29
15	臺南市後壁區	2018-11-24T22:54:30+08:00	2975	5775	8750	867	9617	20841	46.14%	14.27%	29	29
15	臺南市後壁區	2018-11-25T06:13:57+08:00	2975	5775	8750	867	9617	20841	46.14%	14.27%	29	29
15	臺南市後壁區	2018-11-24T22:50:53+08:00	2975	5775	8750	867	9617	20841	46.14%	14.27%	29	29
15	臺南市後壁區	2018-11-24T22:37:05+08:00	2975	5775	8750	867	9617	20841	46.14%	14.27%	29	29
15	臺南市後壁區	2018-11-24T22:26:41+08:00	2975	5775	8750	867	9617	20841	46.14%	14.27%	29	29
15	臺南市後壁區	2018-11-24T22:19:41+08:00	2975	5775	8750	867	9617	20841	46.14%	14.27%	29	29
15	臺南市後壁區	2018-11-25T03:38:59+08:00	2975	5775	8750	867	9617	20841	46.14%	14.27%	29	29
15	臺南市後壁區	2018-11-25T03:44:29+08:00	2975	5775	8750	867	9617	20841	46.14%	14.27%	29	29
15	臺南市後壁區	2018-11-25T00:00:15+08:00	2975	5775	8750	867	9617	20841	46.14%	14.27%	29	29
15	臺南市後壁區	2018-11-24T23:08:42+08:00	2975	5775	8750	867	9617	20841	46.14%	14.27%	29	29
15	臺南市後壁區	2018-11-24T22:23:19+08:00	2975	5775	8750	867	9617	20841	46.14%	14.27%	29	29
15	臺南市後壁區	2018-11-24T23:23:43+08:00	2975	5775	8750	867	9617	20841	46.14%	14.27%	29	29
15	臺南市後壁區	2018-11-24T23:55:51+08:00	2975	5775	8750	867	9617	20841	46.14%	14.27%	29	29
15	臺南市後壁區	2018-11-25T00:14:15+08:00	2975	5775	8750	867	9617	20841	46.14%	14.27%	29	29
15	臺南市後壁區	2018-11-24T23:35:15+08:00	2975	5775	8750	867	9617	20841	46.14%	14.27%	29	29
15	臺南市後壁區	2018-11-24T22:33:43+08:00	2975	5775	8750	867	9617	20841	46.14%	14.27%	29	29
15	臺南市後壁區	2018-11-24T23:12:20+08:00	2975	5775	8750	867	9617	20841	46.14%	14.27%	29	29
15	臺南市後壁區	2018-11-24T22:16:16+08:00	2975	5775	8750	867	9617	20841	46.14%	14.27%	29	29
15	臺南市後壁區	2018-11-25T00:09:39+08:00	2975	5775	8750	867	9617	20841	46.14%	14.27%	29	29
15	臺南市後壁區	2018-11-25T01:07:31+08:00	2975	5775	8750	867	9617	20841	46.14%	14.27%	29	29
15	屏東縣春日鄉	2018-11-25T03:56:26+08:00	440	877	1317	43	1360	3923	34.67%	11.22%	6	6
15	屏東縣春日鄉	2018-11-24T23:05:15+08:00	440	877	1317	43	1360	3923	34.67%	11.22%	6	6
15	屏東縣春日鄉	2018-11-25T01:18:08+08:00	440	877	1317	43	1360	3923	34.67%	11.22%	6	6
15	屏東縣春日鄉	2018-11-24T23:39:30+08:00	440	877	1317	43	1360	3923	34.67%	11.22%	6	6
15	屏東縣春日鄉	2018-11-25T06:29:29+08:00	440	877	1317	43	1360	3923	34.67%	11.22%	6	6
15	屏東縣春日鄉	2018-11-25T06:19:09+08:00	440	877	1317	43	1360	3923	34.67%	11.22%	6	6
15	屏東縣春日鄉	2018-11-24T22:58:07+08:00	440	877	1317	43	1360	3923	34.67%	11.22%	6	6
15	屏東縣春日鄉	2018-11-24T22:41:49+08:00	440	877	1317	43	1360	3923	34.67%	11.22%	6	6
15	屏東縣春日鄉	2018-11-24T23:43:28+08:00	440	877	1317	43	1360	3923	34.67%	11.22%	6	6
15	屏東縣春日鄉	2018-11-25T06:09:07+08:00	440	877	1317	43	1360	3923	34.67%	11.22%	6	6
15	屏東縣春日鄉	2018-11-24T22:30:22+08:00	440	877	1317	43	1360	3923	34.67%	11.22%	6	6
15	屏東縣春日鄉	2018-11-24T23:51:47+08:00	440	877	1317	43	1360	3923	34.67%	11.22%	6	6
15	屏東縣春日鄉	2018-11-24T22:13:43+08:00	440	877	1317	43	1360	3923	34.67%	11.22%	6	6
15	屏東縣春日鄉	2018-11-24T23:08:49+08:00	440	877	1317	43	1360	3923	34.67%	11.22%	6	6
15	屏東縣春日鄉	2018-11-25T03:44:38+08:00	440	877	1317	43	1360	3923	34.67%	11.22%	6	6
15	屏東縣春日鄉	2018-11-25T00:23:15+08:00	440	877	1317	43	1360	3923	34.67%	11.22%	6	6
15	屏東縣春日鄉	2018-11-24T23:23:49+08:00	440	877	1317	43	1360	3923	34.67%	11.22%	6	6
15	屏東縣春日鄉	2018-11-24T22:33:49+08:00	440	877	1317	43	1360	3923	34.67%	11.22%	6	6
15	屏東縣春日鄉	2018-11-24T22:37:12+08:00	440	877	1317	43	1360	3923	34.67%	11.22%	6	6
15	屏東縣春日鄉	2018-11-24T23:16:14+08:00	440	877	1317	43	1360	3923	34.67%	11.22%	6	6
15	屏東縣春日鄉	2018-11-24T22:16:24+08:00	440	877	1317	43	1360	3923	34.67%	11.22%	6	6
15	屏東縣春日鄉	2018-11-25T00:14:21+08:00	440	877	1317	43	1360	3923	34.67%	11.22%	6	6
15	屏東縣春日鄉	2018-11-24T23:35:21+08:00	440	877	1317	43	1360	3923	34.67%	11.22%	6	6
15	屏東縣春日鄉	2018-11-24T22:45:19+08:00	440	877	1317	43	1360	3923	34.67%	11.22%	6	6
15	屏東縣春日鄉	2018-11-24T22:54:36+08:00	440	877	1317	43	1360	3923	34.67%	11.22%	6	6
15	屏東縣春日鄉	2018-11-25T00:09:48+08:00	440	877	1317	43	1360	3923	34.67%	11.22%	6	6
15	屏東縣春日鄉	2018-11-24T23:01:44+08:00	440	877	1317	43	1360	3923	34.67%	11.22%	6	6
15	屏東縣春日鄉	2018-11-24T22:26:47+08:00	440	877	1317	43	1360	3923	34.67%	11.22%	6	6
15	屏東縣春日鄉	2018-11-24T23:47:41+08:00	440	877	1317	43	1360	3923	34.67%	11.22%	6	6
15	屏東縣春日鄉	2018-11-25T01:12:57+08:00	440	877	1317	43	1360	3923	34.67%	11.22%	6	6
15	屏東縣春日鄉	2018-11-25T00:05:16+08:00	440	877	1317	43	1360	3923	34.67%	11.22%	6	6
15	屏東縣春日鄉	2018-11-25T00:57:49+08:00	440	877	1317	43	1360	3923	34.67%	11.22%	6	6
15	屏東縣春日鄉	2018-11-24T22:19:48+08:00	440	877	1317	43	1360	3923	34.67%	11.22%	6	6
15	屏東縣春日鄉	2018-11-25T03:32:50+08:00	440	877	1317	43	1360	3923	34.67%	11.22%	6	6
15	屏東縣春日鄉	2018-11-25T04:03:04+08:00	440	877	1317	43	1360	3923	34.67%	11.22%	6	6
15	屏東縣春日鄉	2018-11-24T22:40:39+08:00	440	877	1317	43	1360	3923	34.67%	11.22%	6	6
15	屏東縣春日鄉	2018-11-24T22:23:27+08:00	440	877	1317	43	1360	3923	34.67%	11.22%	6	6
15	屏東縣春日鄉	2018-11-24T22:51:02+08:00	440	877	1317	43	1360	3923	34.67%	11.22%	6	6
15	屏東縣春日鄉	2018-11-25T06:14:04+08:00	440	877	1317	43	1360	3923	34.67%	11.22%	6	6
15	屏東縣春日鄉	2018-11-24T23:55:59+08:00	440	877	1317	43	1360	3923	34.67%	11.22%	6	6
15	屏東縣春日鄉	2018-11-25T06:24:12+08:00	440	877	1317	43	1360	3923	34.67%	11.22%	6	6
15	屏東縣春日鄉	2018-11-24T23:27:29+08:00	440	877	1317	43	1360	3923	34.67%	11.22%	6	6
15	屏東縣春日鄉	2018-11-25T00:00:22+08:00	440	877	1317	43	1360	3923	34.67%	11.22%	6	6
15	屏東縣春日鄉	2018-11-25T01:02:43+08:00	440	877	1317	43	1360	3923	34.67%	11.22%	6	6
15	屏東縣春日鄉	2018-11-24T23:12:29+08:00	440	877	1317	43	1360	3923	34.67%	11.22%	6	6
15	屏東縣春日鄉	2018-11-24T23:31:25+08:00	440	877	1317	43	1360	3923	34.67%	11.22%	6	6
15	屏東縣春日鄉	2018-11-24T23:20:04+08:00	440	877	1317	43	1360	3923	34.67%	11.22%	6	6
15	屏東縣春日鄉	2018-11-25T00:18:45+08:00	440	877	1317	43	1360	3923	34.67%	11.22%	6	6
15	屏東縣春日鄉	2018-11-25T01:07:38+08:00	440	877	1317	43	1360	3923	34.67%	11.22%	6	6
15	屏東縣春日鄉	2018-11-25T03:39:06+08:00	440	877	1317	43	1360	3923	34.67%	11.22%	6	6
15	屏東縣春日鄉	2018-11-25T01:26:06+08:00	440	877	1317	43	1360	3923	34.67%	11.22%	6	6
15	屏東縣春日鄉	2018-11-25T03:50:02+08:00	440	877	1317	43	1360	3923	34.67%	11.22%	6	6
15	臺南市七股區	2018-11-24T23:16:08+08:00	2723	5757	8480	620	9100	19950	45.61%	13.65%	24	24
15	臺南市七股區	2018-11-24T22:41:41+08:00	2544	5334	7878	549	8427	18775	44.88%	13.55%	23	24
15	臺南市七股區	2018-11-25T00:18:37+08:00	2723	5757	8480	620	9100	19950	45.61%	13.65%	24	24
15	臺南市七股區	2018-11-24T22:45:13+08:00	2723	5757	8480	620	9100	19950	45.61%	13.65%	24	24
15	臺南市七股區	2018-11-25T03:56:18+08:00	2723	5757	8480	620	9100	19950	45.61%	13.65%	24	24
15	臺南市七股區	2018-11-24T22:58:00+08:00	2723	5757	8480	620	9100	19950	45.61%	13.65%	24	24
15	臺南市七股區	2018-11-24T23:51:40+08:00	2723	5757	8480	620	9100	19950	45.61%	13.65%	24	24
15	臺南市七股區	2018-11-24T22:40:32+08:00	2544	5334	7878	549	8427	18775	44.88%	13.55%	23	24
15	臺南市七股區	2018-11-25T01:02:36+08:00	2723	5757	8480	620	9100	19950	45.61%	13.65%	24	24
15	臺南市七股區	2018-11-24T22:19:42+08:00	2302	4867	7169	523	7692	17117	44.94%	13.45%	22	24
15	臺南市七股區	2018-11-25T01:25:58+08:00	2723	5757	8480	620	9100	19950	45.61%	13.65%	24	24
15	臺南市七股區	2018-11-24T22:30:15+08:00	2544	5334	7878	549	8427	18775	44.88%	13.55%	23	24
15	臺南市七股區	2018-11-25T00:23:09+08:00	2723	5757	8480	620	9100	19950	45.61%	13.65%	24	24
15	臺南市七股區	2018-11-25T00:57:42+08:00	2723	5757	8480	620	9100	19950	45.61%	13.65%	24	24
15	臺南市七股區	2018-11-25T06:24:05+08:00	2723	5757	8480	620	9100	19950	45.61%	13.65%	24	24
15	臺南市七股區	2018-11-25T00:00:16+08:00	2723	5757	8480	620	9100	19950	45.61%	13.65%	24	24
15	臺南市七股區	2018-11-25T01:17:59+08:00	2723	5757	8480	620	9100	19950	45.61%	13.65%	24	24
15	臺南市七股區	2018-11-24T23:19:57+08:00	2723	5757	8480	620	9100	19950	45.61%	13.65%	24	24
15	臺南市七股區	2018-11-24T23:55:52+08:00	2723	5757	8480	620	9100	19950	45.61%	13.65%	24	24
15	臺南市七股區	2018-11-24T22:13:34+08:00	2302	4867	7169	523	7692	17117	44.94%	13.45%	22	24
15	臺南市七股區	2018-11-24T23:27:23+08:00	2723	5757	8480	620	9100	19950	45.61%	13.65%	24	24
15	臺南市七股區	2018-11-24T23:39:22+08:00	2723	5757	8480	620	9100	19950	45.61%	13.65%	24	24
15	臺南市七股區	2018-11-25T01:12:49+08:00	2723	5757	8480	620	9100	19950	45.61%	13.65%	24	24
15	臺南市七股區	2018-11-25T06:08:59+08:00	2723	5757	8480	620	9100	19950	45.61%	13.65%	24	24
15	臺南市七股區	2018-11-24T23:31:17+08:00	2723	5757	8480	620	9100	19950	45.61%	13.65%	24	24
15	臺南市七股區	2018-11-24T23:47:34+08:00	2723	5757	8480	620	9100	19950	45.61%	13.65%	24	24
15	臺南市七股區	2018-11-24T23:05:09+08:00	2723	5757	8480	620	9100	19950	45.61%	13.65%	24	24
15	臺南市七股區	2018-11-24T23:01:36+08:00	2723	5757	8480	620	9100	19950	45.61%	13.65%	24	24
15	臺南市七股區	2018-11-25T04:02:57+08:00	2723	5757	8480	620	9100	19950	45.61%	13.65%	24	24
15	臺南市七股區	2018-11-25T00:05:10+08:00	2723	5757	8480	620	9100	19950	45.61%	13.65%	24	24
15	臺南市七股區	2018-11-25T06:19:02+08:00	2723	5757	8480	620	9100	19950	45.61%	13.65%	24	24
15	臺南市七股區	2018-11-25T06:29:22+08:00	2723	5757	8480	620	9100	19950	45.61%	13.65%	24	24
15	臺南市七股區	2018-11-25T03:49:56+08:00	2723	5757	8480	620	9100	19950	45.61%	13.65%	24	24
15	臺南市七股區	2018-11-24T22:54:30+08:00	2723	5757	8480	620	9100	19950	45.61%	13.65%	24	24
15	臺南市七股區	2018-11-24T22:50:54+08:00	2723	5757	8480	620	9100	19950	45.61%	13.65%	24	24
15	臺南市七股區	2018-11-25T06:13:57+08:00	2723	5757	8480	620	9100	19950	45.61%	13.65%	24	24
15	臺南市七股區	2018-11-24T22:37:05+08:00	2544	5334	7878	549	8427	18775	44.88%	13.55%	23	24
15	臺南市七股區	2018-11-24T23:43:22+08:00	2723	5757	8480	620	9100	19950	45.61%	13.65%	24	24
15	臺南市七股區	2018-11-25T00:09:40+08:00	2723	5757	8480	620	9100	19950	45.61%	13.65%	24	24
15	臺南市七股區	2018-11-24T22:26:41+08:00	2544	5334	7878	549	8427	18775	44.88%	13.55%	23	24
15	臺南市七股區	2018-11-25T03:44:29+08:00	2723	5757	8480	620	9100	19950	45.61%	13.65%	24	24
15	臺南市七股區	2018-11-25T03:32:42+08:00	2723	5757	8480	620	9100	19950	45.61%	13.65%	24	24
15	臺南市七股區	2018-11-24T23:08:42+08:00	2723	5757	8480	620	9100	19950	45.61%	13.65%	24	24
15	臺南市七股區	2018-11-24T22:23:19+08:00	2544	5334	7878	549	8427	18775	44.88%	13.55%	23	24
15	臺南市七股區	2018-11-24T23:23:43+08:00	2723	5757	8480	620	9100	19950	45.61%	13.65%	24	24
15	臺南市七股區	2018-11-25T00:14:15+08:00	2723	5757	8480	620	9100	19950	45.61%	13.65%	24	24
15	臺南市七股區	2018-11-24T23:35:15+08:00	2723	5757	8480	620	9100	19950	45.61%	13.65%	24	24
15	臺南市七股區	2018-11-24T22:33:43+08:00	2544	5334	7878	549	8427	18775	44.88%	13.55%	23	24
15	臺南市七股區	2018-11-25T03:39:00+08:00	2723	5757	8480	620	9100	19950	45.61%	13.65%	24	24
15	臺南市七股區	2018-11-24T23:12:21+08:00	2723	5757	8480	620	9100	19950	45.61%	13.65%	24	24
15	臺南市七股區	2018-11-24T22:16:16+08:00	2302	4867	7169	523	7692	17117	44.94%	13.45%	22	24
15	臺南市七股區	2018-11-25T01:07:31+08:00	2723	5757	8480	620	9100	19950	45.61%	13.65%	24	24
15	花蓮縣新城鄉	2018-11-24T23:56:00+08:00	2253	5603	7856	549	8405	15424	54.49%	14.61%	18	19
15	花蓮縣新城鄉	2018-11-24T23:05:15+08:00	1920	4777	6697	491	7188	13160	54.62%	14.59%	16	19
15	花蓮縣新城鄉	2018-11-24T23:43:29+08:00	2253	5603	7856	549	8405	15424	54.49%	14.61%	18	19
15	花蓮縣新城鄉	2018-11-25T01:18:09+08:00	2473	6193	8666	586	9252	17029	54.33%	14.52%	19	19
15	花蓮縣新城鄉	2018-11-25T03:56:27+08:00	2473	6193	8666	586	9252	17029	54.33%	14.52%	19	19
15	花蓮縣新城鄉	2018-11-25T06:19:09+08:00	2473	6193	8666	586	9252	17029	54.33%	14.52%	19	19
15	花蓮縣新城鄉	2018-11-24T22:58:07+08:00	1920	4777	6697	491	7188	13160	54.62%	14.59%	16	19
15	花蓮縣新城鄉	2018-11-24T22:41:49+08:00	1602	3859	5461	389	5850	10634	55.01%	15.06%	14	19
15	花蓮縣新城鄉	2018-11-24T23:39:31+08:00	2253	5603	7856	549	8405	15424	54.49%	14.61%	18	19
15	花蓮縣新城鄉	2018-11-24T23:47:42+08:00	2253	5603	7856	549	8405	15424	54.49%	14.61%	18	19
15	花蓮縣新城鄉	2018-11-24T22:30:22+08:00	1490	3666	5156	339	5495	10044	54.71%	14.83%	13	19
15	花蓮縣新城鄉	2018-11-24T23:51:47+08:00	2253	5603	7856	549	8405	15424	54.49%	14.61%	18	19
15	花蓮縣新城鄉	2018-11-24T23:27:30+08:00	2096	5223	7319	526	7845	14354	54.65%	14.6%	17	19
15	花蓮縣新城鄉	2018-11-25T06:09:08+08:00	2473	6193	8666	586	9252	17029	54.33%	14.52%	19	19
15	花蓮縣新城鄉	2018-11-24T22:13:44+08:00	1395	3334	4729	317	5046	9159	55.09%	15.23%	12	19
15	花蓮縣新城鄉	2018-11-25T00:57:50+08:00	2473	6193	8666	586	9252	17029	54.33%	14.52%	19	19
15	花蓮縣新城鄉	2018-11-25T03:44:39+08:00	2473	6193	8666	586	9252	17029	54.33%	14.52%	19	19
15	花蓮縣新城鄉	2018-11-24T23:31:26+08:00	2253	5603	7856	549	8405	15424	54.49%	14.61%	18	19
15	花蓮縣新城鄉	2018-11-24T22:37:13+08:00	1602	3859	5461	389	5850	10634	55.01%	15.06%	14	19
15	花蓮縣新城鄉	2018-11-24T22:16:24+08:00	1395	3334	4729	317	5046	9159	55.09%	15.23%	12	19
15	花蓮縣新城鄉	2018-11-25T00:18:46+08:00	2253	5603	7856	549	8405	15424	54.49%	14.61%	18	19
15	花蓮縣新城鄉	2018-11-24T23:16:15+08:00	1920	4777	6697	491	7188	13160	54.62%	14.59%	16	19
15	花蓮縣新城鄉	2018-11-24T22:54:36+08:00	1920	4777	6697	491	7188	13160	54.62%	14.59%	16	19
15	花蓮縣新城鄉	2018-11-25T01:12:58+08:00	2473	6193	8666	586	9252	17029	54.33%	14.52%	19	19
15	花蓮縣新城鄉	2018-11-25T00:05:17+08:00	2253	5603	7856	549	8405	15424	54.49%	14.61%	18	19
15	花蓮縣新城鄉	2018-11-24T22:33:50+08:00	1602	3859	5461	389	5850	10634	55.01%	15.06%	14	19
15	花蓮縣新城鄉	2018-11-24T22:45:20+08:00	1602	3859	5461	389	5850	10634	55.01%	15.06%	14	19
15	花蓮縣新城鄉	2018-11-24T22:26:48+08:00	1490	3666	5156	339	5495	10044	54.71%	14.83%	13	19
15	花蓮縣新城鄉	2018-11-24T23:01:45+08:00	1920	4777	6697	491	7188	13160	54.62%	14.59%	16	19
15	花蓮縣新城鄉	2018-11-25T00:09:49+08:00	2253	5603	7856	549	8405	15424	54.49%	14.61%	18	19
15	花蓮縣新城鄉	2018-11-25T04:03:05+08:00	2473	6193	8666	586	9252	17029	54.33%	14.52%	19	19
15	花蓮縣新城鄉	2018-11-24T23:23:50+08:00	2096	5223	7319	526	7845	14354	54.65%	14.6%	17	19
15	花蓮縣新城鄉	2018-11-24T22:19:49+08:00	1395	3334	4729	317	5046	9159	55.09%	15.23%	12	19
15	花蓮縣新城鄉	2018-11-24T22:40:39+08:00	1602	3859	5461	389	5850	10634	55.01%	15.06%	14	19
15	花蓮縣新城鄉	2018-11-25T03:32:51+08:00	2473	6193	8666	586	9252	17029	54.33%	14.52%	19	19
15	花蓮縣新城鄉	2018-11-24T23:08:50+08:00	1920	4777	6697	491	7188	13160	54.62%	14.59%	16	19
15	花蓮縣新城鄉	2018-11-24T22:23:27+08:00	1490	3666	5156	339	5495	10044	54.71%	14.83%	13	19
15	花蓮縣新城鄉	2018-11-24T22:51:02+08:00	1753	4254	6007	437	6444	11797	54.62%	14.86%	15	19
15	花蓮縣新城鄉	2018-11-25T06:14:04+08:00	2473	6193	8666	586	9252	17029	54.33%	14.52%	19	19
15	花蓮縣新城鄉	2018-11-25T00:00:23+08:00	2253	5603	7856	549	8405	15424	54.49%	14.61%	18	19
15	花蓮縣新城鄉	2018-11-25T06:24:12+08:00	2473	6193	8666	586	9252	17029	54.33%	14.52%	19	19
15	花蓮縣新城鄉	2018-11-25T00:23:16+08:00	2253	5603	7856	549	8405	15424	54.49%	14.61%	18	19
15	花蓮縣新城鄉	2018-11-25T01:02:43+08:00	2473	6193	8666	586	9252	17029	54.33%	14.52%	19	19
15	花蓮縣新城鄉	2018-11-25T06:29:30+08:00	2473	6193	8666	586	9252	17029	54.33%	14.52%	19	19
15	花蓮縣新城鄉	2018-11-24T23:12:29+08:00	1920	4777	6697	491	7188	13160	54.62%	14.59%	16	19
15	花蓮縣新城鄉	2018-11-25T03:50:03+08:00	2473	6193	8666	586	9252	17029	54.33%	14.52%	19	19
15	花蓮縣新城鄉	2018-11-25T01:07:39+08:00	2473	6193	8666	586	9252	17029	54.33%	14.52%	19	19
15	花蓮縣新城鄉	2018-11-25T01:26:07+08:00	2473	6193	8666	586	9252	17029	54.33%	14.52%	19	19
15	花蓮縣新城鄉	2018-11-25T03:39:07+08:00	2473	6193	8666	586	9252	17029	54.33%	14.52%	19	19
15	花蓮縣新城鄉	2018-11-25T00:14:22+08:00	2253	5603	7856	549	8405	15424	54.49%	14.61%	18	19
15	花蓮縣新城鄉	2018-11-24T23:35:22+08:00	2253	5603	7856	549	8405	15424	54.49%	14.61%	18	19
15	花蓮縣新城鄉	2018-11-24T23:20:05+08:00	2096	5223	7319	526	7845	14354	54.65%	14.6%	17	19
15	高雄市旗山區	2018-11-25T01:18:01+08:00	5654	10819	16473	1483	17956	31996	56.12%	17.67%	35	35
15	高雄市旗山區	2018-11-24T22:58:01+08:00	5654	10819	16473	1483	17956	31996	56.12%	17.67%	35	35
15	高雄市旗山區	2018-11-24T22:26:43+08:00	5447	10334	15781	1417	17198	30667	56.08%	17.76%	34	35
15	高雄市旗山區	2018-11-25T00:09:42+08:00	5654	10819	16473	1483	17956	31996	56.12%	17.67%	35	35
15	高雄市旗山區	2018-11-25T01:12:52+08:00	5654	10819	16473	1483	17956	31996	56.12%	17.67%	35	35
15	高雄市旗山區	2018-11-24T22:37:07+08:00	5654	10819	16473	1483	17956	31996	56.12%	17.67%	35	35
15	高雄市旗山區	2018-11-24T22:54:32+08:00	5654	10819	16473	1483	17956	31996	56.12%	17.67%	35	35
15	高雄市旗山區	2018-11-24T22:50:56+08:00	5654	10819	16473	1483	17956	31996	56.12%	17.67%	35	35
15	高雄市旗山區	2018-11-25T00:18:39+08:00	5654	10819	16473	1483	17956	31996	56.12%	17.67%	35	35
15	高雄市旗山區	2018-11-24T22:45:14+08:00	5654	10819	16473	1483	17956	31996	56.12%	17.67%	35	35
15	高雄市旗山區	2018-11-25T03:56:20+08:00	5654	10819	16473	1483	17956	31996	56.12%	17.67%	35	35
15	高雄市旗山區	2018-11-25T00:05:12+08:00	5654	10819	16473	1483	17956	31996	56.12%	17.67%	35	35
15	高雄市旗山區	2018-11-24T23:16:09+08:00	5654	10819	16473	1483	17956	31996	56.12%	17.67%	35	35
15	高雄市旗山區	2018-11-25T01:02:38+08:00	5654	10819	16473	1483	17956	31996	56.12%	17.67%	35	35
15	高雄市旗山區	2018-11-25T00:57:44+08:00	5654	10819	16473	1483	17956	31996	56.12%	17.67%	35	35
15	高雄市旗山區	2018-11-24T22:40:34+08:00	5654	10819	16473	1483	17956	31996	56.12%	17.67%	35	35
15	高雄市旗山區	2018-11-25T06:09:01+08:00	5654	10819	16473	1483	17956	31996	56.12%	17.67%	35	35
15	高雄市旗山區	2018-11-24T22:19:43+08:00	5447	10334	15781	1417	17198	30667	56.08%	17.76%	34	35
15	高雄市旗山區	2018-11-24T23:55:54+08:00	5654	10819	16473	1483	17956	31996	56.12%	17.67%	35	35
15	高雄市旗山區	2018-11-25T03:44:31+08:00	5654	10819	16473	1483	17956	31996	56.12%	17.67%	35	35
15	高雄市旗山區	2018-11-24T23:19:59+08:00	5654	10819	16473	1483	17956	31996	56.12%	17.67%	35	35
15	高雄市旗山區	2018-11-25T00:00:17+08:00	5654	10819	16473	1483	17956	31996	56.12%	17.67%	35	35
15	高雄市旗山區	2018-11-24T23:27:24+08:00	5654	10819	16473	1483	17956	31996	56.12%	17.67%	35	35
15	高雄市旗山區	2018-11-25T01:07:33+08:00	5654	10819	16473	1483	17956	31996	56.12%	17.67%	35	35
15	高雄市旗山區	2018-11-24T23:31:19+08:00	5654	10819	16473	1483	17956	31996	56.12%	17.67%	35	35
15	高雄市旗山區	2018-11-24T23:12:24+08:00	5654	10819	16473	1483	17956	31996	56.12%	17.67%	35	35
15	高雄市旗山區	2018-11-24T23:39:24+08:00	5654	10819	16473	1483	17956	31996	56.12%	17.67%	35	35
15	高雄市旗山區	2018-11-24T23:01:38+08:00	5654	10819	16473	1483	17956	31996	56.12%	17.67%	35	35
15	高雄市旗山區	2018-11-24T23:35:17+08:00	5654	10819	16473	1483	17956	31996	56.12%	17.67%	35	35
15	高雄市旗山區	2018-11-25T04:02:59+08:00	5654	10819	16473	1483	17956	31996	56.12%	17.67%	35	35
15	高雄市旗山區	2018-11-25T00:14:17+08:00	5654	10819	16473	1483	17956	31996	56.12%	17.67%	35	35
15	高雄市旗山區	2018-11-24T23:43:23+08:00	5654	10819	16473	1483	17956	31996	56.12%	17.67%	35	35
15	高雄市旗山區	2018-11-25T03:49:58+08:00	5654	10819	16473	1483	17956	31996	56.12%	17.67%	35	35
15	高雄市旗山區	2018-11-24T23:05:11+08:00	5654	10819	16473	1483	17956	31996	56.12%	17.67%	35	35
15	高雄市旗山區	2018-11-25T06:13:59+08:00	5654	10819	16473	1483	17956	31996	56.12%	17.67%	35	35
15	高雄市旗山區	2018-11-24T22:41:43+08:00	5654	10819	16473	1483	17956	31996	56.12%	17.67%	35	35
15	高雄市旗山區	2018-11-25T06:19:04+08:00	5654	10819	16473	1483	17956	31996	56.12%	17.67%	35	35
15	高雄市旗山區	2018-11-25T06:29:24+08:00	5654	10819	16473	1483	17956	31996	56.12%	17.67%	35	35
15	高雄市旗山區	2018-11-25T06:24:07+08:00	5654	10819	16473	1483	17956	31996	56.12%	17.67%	35	35
15	高雄市旗山區	2018-11-24T22:30:17+08:00	5654	10819	16473	1483	17956	31996	56.12%	17.67%	35	35
15	高雄市旗山區	2018-11-24T23:51:42+08:00	5654	10819	16473	1483	17956	31996	56.12%	17.67%	35	35
15	高雄市旗山區	2018-11-24T23:23:45+08:00	5654	10819	16473	1483	17956	31996	56.12%	17.67%	35	35
15	高雄市旗山區	2018-11-24T23:08:44+08:00	5654	10819	16473	1483	17956	31996	56.12%	17.67%	35	35
15	高雄市旗山區	2018-11-24T22:23:21+08:00	5447	10334	15781	1417	17198	30667	56.08%	17.76%	34	35
15	高雄市旗山區	2018-11-25T03:32:44+08:00	5654	10819	16473	1483	17956	31996	56.12%	17.67%	35	35
15	高雄市旗山區	2018-11-24T22:13:37+08:00	5342	10051	15393	1406	16799	29779	56.41%	17.94%	33	35
15	高雄市旗山區	2018-11-25T00:23:11+08:00	5654	10819	16473	1483	17956	31996	56.12%	17.67%	35	35
15	高雄市旗山區	2018-11-25T01:26:00+08:00	5654	10819	16473	1483	17956	31996	56.12%	17.67%	35	35
15	高雄市旗山區	2018-11-24T23:47:36+08:00	5654	10819	16473	1483	17956	31996	56.12%	17.67%	35	35
15	高雄市旗山區	2018-11-25T03:39:01+08:00	5654	10819	16473	1483	17956	31996	56.12%	17.67%	35	35
15	高雄市旗山區	2018-11-24T22:33:45+08:00	5654	10819	16473	1483	17956	31996	56.12%	17.67%	35	35
15	高雄市旗山區	2018-11-24T22:16:18+08:00	5342	10051	15393	1406	16799	29779	56.41%	17.94%	33	35
15	高雄市橋頭區	2018-11-25T01:18:01+08:00	6321	12345	18666	1594	20260	32565	62.21%	19.41%	31	31
15	高雄市橋頭區	2018-11-24T22:58:01+08:00	6113	11945	18058	1562	19620	31474	62.34%	19.42%	30	31
15	高雄市橋頭區	2018-11-25T00:09:42+08:00	6321	12345	18666	1594	20260	32565	62.21%	19.41%	31	31
15	高雄市橋頭區	2018-11-24T22:37:07+08:00	5812	11448	17260	1538	18798	30208	62.23%	19.24%	29	31
15	高雄市橋頭區	2018-11-25T00:18:39+08:00	6321	12345	18666	1594	20260	32565	62.21%	19.41%	31	31
15	高雄市橋頭區	2018-11-24T22:45:14+08:00	5812	11448	17260	1538	18798	30208	62.23%	19.24%	29	31
15	高雄市橋頭區	2018-11-25T03:56:20+08:00	6321	12345	18666	1594	20260	32565	62.21%	19.41%	31	31
15	高雄市橋頭區	2018-11-24T22:26:42+08:00	5568	10979	16547	1465	18012	28964	62.19%	19.22%	28	31
15	高雄市橋頭區	2018-11-24T23:16:09+08:00	6113	11945	18058	1562	19620	31474	62.34%	19.42%	30	31
15	高雄市橋頭區	2018-11-25T01:25:59+08:00	6321	12345	18666	1594	20260	32565	62.21%	19.41%	31	31
15	高雄市橋頭區	2018-11-25T00:57:44+08:00	6321	12345	18666	1594	20260	32565	62.21%	19.41%	31	31
15	高雄市橋頭區	2018-11-25T01:02:37+08:00	6321	12345	18666	1594	20260	32565	62.21%	19.41%	31	31
15	高雄市橋頭區	2018-11-24T22:40:34+08:00	5812	11448	17260	1538	18798	30208	62.23%	19.24%	29	31
15	高雄市橋頭區	2018-11-25T06:09:01+08:00	6321	12345	18666	1594	20260	32565	62.21%	19.41%	31	31
15	高雄市橋頭區	2018-11-24T22:19:43+08:00	5356	10455	15811	1393	17204	27709	62.09%	19.33%	27	31
15	高雄市橋頭區	2018-11-24T23:55:53+08:00	6113	11945	18058	1562	19620	31474	62.34%	19.42%	30	31
15	高雄市橋頭區	2018-11-25T03:44:31+08:00	6321	12345	18666	1594	20260	32565	62.21%	19.41%	31	31
15	高雄市橋頭區	2018-11-24T23:19:59+08:00	6113	11945	18058	1562	19620	31474	62.34%	19.42%	30	31
15	高雄市橋頭區	2018-11-25T00:00:17+08:00	6321	12345	18666	1594	20260	32565	62.21%	19.41%	31	31
15	高雄市橋頭區	2018-11-24T23:27:24+08:00	6113	11945	18058	1562	19620	31474	62.34%	19.42%	30	31
15	高雄市橋頭區	2018-11-25T01:07:33+08:00	6321	12345	18666	1594	20260	32565	62.21%	19.41%	31	31
15	高雄市橋頭區	2018-11-24T23:31:19+08:00	6113	11945	18058	1562	19620	31474	62.34%	19.42%	30	31
15	高雄市橋頭區	2018-11-24T23:12:23+08:00	6113	11945	18058	1562	19620	31474	62.34%	19.42%	30	31
15	高雄市橋頭區	2018-11-25T00:14:16+08:00	6321	12345	18666	1594	20260	32565	62.21%	19.41%	31	31
15	高雄市橋頭區	2018-11-24T23:35:16+08:00	6113	11945	18058	1562	19620	31474	62.34%	19.42%	30	31
15	高雄市橋頭區	2018-11-24T23:39:24+08:00	6113	11945	18058	1562	19620	31474	62.34%	19.42%	30	31
15	高雄市橋頭區	2018-11-24T23:01:38+08:00	6113	11945	18058	1562	19620	31474	62.34%	19.42%	30	31
15	高雄市橋頭區	2018-11-25T04:02:59+08:00	6321	12345	18666	1594	20260	32565	62.21%	19.41%	31	31
15	高雄市橋頭區	2018-11-24T23:43:23+08:00	6113	11945	18058	1562	19620	31474	62.34%	19.42%	30	31
15	高雄市橋頭區	2018-11-25T01:12:51+08:00	6321	12345	18666	1594	20260	32565	62.21%	19.41%	31	31
15	高雄市橋頭區	2018-11-24T22:54:31+08:00	6113	11945	18058	1562	19620	31474	62.34%	19.42%	30	31
15	高雄市橋頭區	2018-11-24T22:50:55+08:00	6113	11945	18058	1562	19620	31474	62.34%	19.42%	30	31
15	高雄市橋頭區	2018-11-25T06:13:59+08:00	6321	12345	18666	1594	20260	32565	62.21%	19.41%	31	31
15	高雄市橋頭區	2018-11-24T22:41:43+08:00	5812	11448	17260	1538	18798	30208	62.23%	19.24%	29	31
15	高雄市橋頭區	2018-11-25T03:49:57+08:00	6321	12345	18666	1594	20260	32565	62.21%	19.41%	31	31
15	高雄市橋頭區	2018-11-24T23:05:10+08:00	6113	11945	18058	1562	19620	31474	62.34%	19.42%	30	31
15	高雄市橋頭區	2018-11-25T06:19:03+08:00	6321	12345	18666	1594	20260	32565	62.21%	19.41%	31	31
15	高雄市橋頭區	2018-11-25T06:29:24+08:00	6321	12345	18666	1594	20260	32565	62.21%	19.41%	31	31
15	高雄市橋頭區	2018-11-25T00:05:11+08:00	6321	12345	18666	1594	20260	32565	62.21%	19.41%	31	31
15	高雄市橋頭區	2018-11-25T06:24:06+08:00	6321	12345	18666	1594	20260	32565	62.21%	19.41%	31	31
15	高雄市橋頭區	2018-11-24T22:30:16+08:00	5568	10979	16547	1465	18012	28964	62.19%	19.22%	28	31
15	高雄市橋頭區	2018-11-24T23:51:42+08:00	6113	11945	18058	1562	19620	31474	62.34%	19.42%	30	31
15	高雄市橋頭區	2018-11-24T22:13:36+08:00	5356	10455	15811	1393	17204	27709	62.09%	19.33%	27	31
15	高雄市橋頭區	2018-11-24T23:08:44+08:00	6113	11945	18058	1562	19620	31474	62.34%	19.42%	30	31
15	高雄市橋頭區	2018-11-25T00:23:10+08:00	6321	12345	18666	1594	20260	32565	62.21%	19.41%	31	31
15	高雄市橋頭區	2018-11-24T22:23:21+08:00	5568	10979	16547	1465	18012	28964	62.19%	19.22%	28	31
15	高雄市橋頭區	2018-11-25T03:32:44+08:00	6321	12345	18666	1594	20260	32565	62.21%	19.41%	31	31
15	高雄市橋頭區	2018-11-24T23:23:44+08:00	6113	11945	18058	1562	19620	31474	62.34%	19.42%	30	31
15	高雄市橋頭區	2018-11-24T22:33:44+08:00	5812	11448	17260	1538	18798	30208	62.23%	19.24%	29	31
15	高雄市橋頭區	2018-11-24T23:47:36+08:00	6113	11945	18058	1562	19620	31474	62.34%	19.42%	30	31
15	高雄市橋頭區	2018-11-25T03:39:01+08:00	6321	12345	18666	1594	20260	32565	62.21%	19.41%	31	31
15	高雄市橋頭區	2018-11-24T22:16:18+08:00	5356	10455	15811	1393	17204	27709	62.09%	19.33%	27	31
15	金門縣金沙鎮	2018-11-25T03:56:28+08:00	1258	4967	6225	347	6572	18560	35.41%	6.78%	13	13
15	金門縣金沙鎮	2018-11-24T23:47:43+08:00	1258	4967	6225	347	6572	18560	35.41%	6.78%	13	13
15	金門縣金沙鎮	2018-11-24T22:58:09+08:00	1258	4967	6225	347	6572	18560	35.41%	6.78%	13	13
15	金門縣金沙鎮	2018-11-24T23:56:01+08:00	1258	4967	6225	347	6572	18560	35.41%	6.78%	13	13
15	金門縣金沙鎮	2018-11-24T23:01:46+08:00	1258	4967	6225	347	6572	18560	35.41%	6.78%	13	13
15	金門縣金沙鎮	2018-11-24T23:12:30+08:00	1258	4967	6225	347	6572	18560	35.41%	6.78%	13	13
15	金門縣金沙鎮	2018-11-25T03:32:53+08:00	1258	4967	6225	347	6572	18560	35.41%	6.78%	13	13
15	金門縣金沙鎮	2018-11-24T23:08:52+08:00	1258	4967	6225	347	6572	18560	35.41%	6.78%	13	13
15	金門縣金沙鎮	2018-11-24T23:51:49+08:00	1258	4967	6225	347	6572	18560	35.41%	6.78%	13	13
15	金門縣金沙鎮	2018-11-24T22:13:45+08:00	1021	3983	5004	285	5289	15033	35.18%	6.79%	11	13
15	金門縣金沙鎮	2018-11-25T03:44:41+08:00	1258	4967	6225	347	6572	18560	35.41%	6.78%	13	13
15	金門縣金沙鎮	2018-11-25T04:03:06+08:00	1258	4967	6225	347	6572	18560	35.41%	6.78%	13	13
15	金門縣金沙鎮	2018-11-24T23:27:31+08:00	1258	4967	6225	347	6572	18560	35.41%	6.78%	13	13
15	金門縣金沙鎮	2018-11-24T22:30:24+08:00	1021	3983	5004	285	5289	15033	35.18%	6.79%	11	13
15	金門縣金沙鎮	2018-11-25T00:57:51+08:00	1258	4967	6225	347	6572	18560	35.41%	6.78%	13	13
15	金門縣金沙鎮	2018-11-24T22:19:50+08:00	1021	3983	5004	285	5289	15033	35.18%	6.79%	11	13
15	金門縣金沙鎮	2018-11-25T00:09:50+08:00	1258	4967	6225	347	6572	18560	35.41%	6.78%	13	13
15	金門縣金沙鎮	2018-11-25T00:18:47+08:00	1258	4967	6225	347	6572	18560	35.41%	6.78%	13	13
15	金門縣金沙鎮	2018-11-24T22:37:14+08:00	1021	3983	5004	285	5289	15033	35.18%	6.79%	11	13
15	金門縣金沙鎮	2018-11-24T23:20:08+08:00	1258	4967	6225	347	6572	18560	35.41%	6.78%	13	13
15	金門縣金沙鎮	2018-11-24T23:31:27+08:00	1258	4967	6225	347	6572	18560	35.41%	6.78%	13	13
15	金門縣金沙鎮	2018-11-24T22:45:21+08:00	1133	4499	5632	315	5947	17036	34.91%	6.65%	12	13
15	金門縣金沙鎮	2018-11-24T22:54:38+08:00	1258	4967	6225	347	6572	18560	35.41%	6.78%	13	13
15	金門縣金沙鎮	2018-11-24T22:33:51+08:00	1021	3983	5004	285	5289	15033	35.18%	6.79%	11	13
15	金門縣金沙鎮	2018-11-24T23:39:33+08:00	1258	4967	6225	347	6572	18560	35.41%	6.78%	13	13
15	金門縣金沙鎮	2018-11-24T22:26:49+08:00	1021	3983	5004	285	5289	15033	35.18%	6.79%	11	13
15	金門縣金沙鎮	2018-11-25T01:07:40+08:00	1258	4967	6225	347	6572	18560	35.41%	6.78%	13	13
15	金門縣金沙鎮	2018-11-25T01:12:59+08:00	1258	4967	6225	347	6572	18560	35.41%	6.78%	13	13
15	金門縣金沙鎮	2018-11-25T00:05:18+08:00	1258	4967	6225	347	6572	18560	35.41%	6.78%	13	13
15	金門縣金沙鎮	2018-11-24T23:05:17+08:00	1258	4967	6225	347	6572	18560	35.41%	6.78%	13	13
15	金門縣金沙鎮	2018-11-24T23:23:51+08:00	1258	4967	6225	347	6572	18560	35.41%	6.78%	13	13
15	金門縣金沙鎮	2018-11-24T22:23:29+08:00	1021	3983	5004	285	5289	15033	35.18%	6.79%	11	13
15	金門縣金沙鎮	2018-11-25T00:23:17+08:00	1258	4967	6225	347	6572	18560	35.41%	6.78%	13	13
15	金門縣金沙鎮	2018-11-25T00:00:24+08:00	1258	4967	6225	347	6572	18560	35.41%	6.78%	13	13
15	金門縣金沙鎮	2018-11-25T01:02:45+08:00	1258	4967	6225	347	6572	18560	35.41%	6.78%	13	13
15	金門縣金沙鎮	2018-11-24T22:51:04+08:00	1258	4967	6225	347	6572	18560	35.41%	6.78%	13	13
15	金門縣金沙鎮	2018-11-25T06:09:10+08:00	1258	4967	6225	347	6572	18560	35.41%	6.78%	13	13
15	金門縣金沙鎮	2018-11-25T06:24:14+08:00	1258	4967	6225	347	6572	18560	35.41%	6.78%	13	13
15	金門縣金沙鎮	2018-11-24T22:40:40+08:00	1133	4499	5632	315	5947	17036	34.91%	6.65%	12	13
15	金門縣金沙鎮	2018-11-25T06:14:05+08:00	1258	4967	6225	347	6572	18560	35.41%	6.78%	13	13
15	金門縣金沙鎮	2018-11-24T23:35:23+08:00	1258	4967	6225	347	6572	18560	35.41%	6.78%	13	13
15	金門縣金沙鎮	2018-11-25T00:14:24+08:00	1258	4967	6225	347	6572	18560	35.41%	6.78%	13	13
15	金門縣金沙鎮	2018-11-25T03:50:04+08:00	1258	4967	6225	347	6572	18560	35.41%	6.78%	13	13
15	金門縣金沙鎮	2018-11-24T22:16:26+08:00	1021	3983	5004	285	5289	15033	35.18%	6.79%	11	13
15	金門縣金沙鎮	2018-11-24T23:43:31+08:00	1258	4967	6225	347	6572	18560	35.41%	6.78%	13	13
15	金門縣金沙鎮	2018-11-25T01:18:11+08:00	1258	4967	6225	347	6572	18560	35.41%	6.78%	13	13
15	金門縣金沙鎮	2018-11-25T06:29:31+08:00	1258	4967	6225	347	6572	18560	35.41%	6.78%	13	13
15	金門縣金沙鎮	2018-11-24T23:16:16+08:00	1258	4967	6225	347	6572	18560	35.41%	6.78%	13	13
15	金門縣金沙鎮	2018-11-25T06:19:11+08:00	1258	4967	6225	347	6572	18560	35.41%	6.78%	13	13
15	金門縣金沙鎮	2018-11-24T22:41:51+08:00	1133	4499	5632	315	5947	17036	34.91%	6.65%	12	13
15	金門縣金沙鎮	2018-11-25T03:39:08+08:00	1258	4967	6225	347	6572	18560	35.41%	6.78%	13	13
15	金門縣金沙鎮	2018-11-25T01:26:08+08:00	1258	4967	6225	347	6572	18560	35.41%	6.78%	13	13
15	嘉義縣梅山鄉	2018-11-25T01:18:06+08:00	2612	5888	8500	875	9375	17083	54.88%	15.29%	22	22
15	嘉義縣梅山鄉	2018-11-25T06:29:28+08:00	2612	5888	8500	875	9375	17083	54.88%	15.29%	22	22
15	嘉義縣梅山鄉	2018-11-24T23:43:27+08:00	2612	5888	8500	875	9375	17083	54.88%	15.29%	22	22
15	嘉義縣梅山鄉	2018-11-24T22:54:35+08:00	2612	5888	8500	875	9375	17083	54.88%	15.29%	22	22
15	嘉義縣梅山鄉	2018-11-24T23:05:14+08:00	2612	5888	8500	875	9375	17083	54.88%	15.29%	22	22
15	嘉義縣梅山鄉	2018-11-25T06:19:07+08:00	2612	5888	8500	875	9375	17083	54.88%	15.29%	22	22
15	嘉義縣梅山鄉	2018-11-25T00:05:15+08:00	2612	5888	8500	875	9375	17083	54.88%	15.29%	22	22
15	嘉義縣梅山鄉	2018-11-24T22:41:47+08:00	2612	5888	8500	875	9375	17083	54.88%	15.29%	22	22
15	嘉義縣梅山鄉	2018-11-24T22:13:42+08:00	1745	3938	5683	645	6328	11610	54.5%	15.03%	17	22
15	嘉義縣梅山鄉	2018-11-24T23:51:46+08:00	2612	5888	8500	875	9375	17083	54.88%	15.29%	22	22
15	嘉義縣梅山鄉	2018-11-25T06:09:06+08:00	2612	5888	8500	875	9375	17083	54.88%	15.29%	22	22
15	嘉義縣梅山鄉	2018-11-25T01:02:41+08:00	2612	5888	8500	875	9375	17083	54.88%	15.29%	22	22
15	嘉義縣梅山鄉	2018-11-25T00:23:14+08:00	2612	5888	8500	875	9375	17083	54.88%	15.29%	22	22
15	嘉義縣梅山鄉	2018-11-25T06:24:11+08:00	2612	5888	8500	875	9375	17083	54.88%	15.29%	22	22
15	嘉義縣梅山鄉	2018-11-24T23:23:48+08:00	2612	5888	8500	875	9375	17083	54.88%	15.29%	22	22
15	嘉義縣梅山鄉	2018-11-25T00:00:21+08:00	2612	5888	8500	875	9375	17083	54.88%	15.29%	22	22
15	嘉義縣梅山鄉	2018-11-24T22:23:25+08:00	2057	4660	6717	739	7456	13634	54.69%	15.09%	19	22
15	嘉義縣梅山鄉	2018-11-24T22:51:00+08:00	2612	5888	8500	875	9375	17083	54.88%	15.29%	22	22
15	嘉義縣梅山鄉	2018-11-25T03:32:49+08:00	2612	5888	8500	875	9375	17083	54.88%	15.29%	22	22
15	嘉義縣梅山鄉	2018-11-25T03:44:37+08:00	2612	5888	8500	875	9375	17083	54.88%	15.29%	22	22
15	嘉義縣梅山鄉	2018-11-24T23:08:48+08:00	2612	5888	8500	875	9375	17083	54.88%	15.29%	22	22
15	嘉義縣梅山鄉	2018-11-24T22:16:22+08:00	1834	4177	6011	677	6688	12246	54.61%	14.98%	18	22
15	嘉義縣梅山鄉	2018-11-25T01:26:04+08:00	2612	5888	8500	875	9375	17083	54.88%	15.29%	22	22
15	嘉義縣梅山鄉	2018-11-24T23:16:13+08:00	2612	5888	8500	875	9375	17083	54.88%	15.29%	22	22
15	嘉義縣梅山鄉	2018-11-24T23:35:20+08:00	2612	5888	8500	875	9375	17083	54.88%	15.29%	22	22
15	嘉義縣梅山鄉	2018-11-25T00:14:20+08:00	2612	5888	8500	875	9375	17083	54.88%	15.29%	22	22
15	嘉義縣梅山鄉	2018-11-25T03:39:05+08:00	2612	5888	8500	875	9375	17083	54.88%	15.29%	22	22
15	嘉義縣梅山鄉	2018-11-24T22:33:48+08:00	2542	5689	8231	836	9067	16650	54.46%	15.27%	21	22
15	嘉義縣梅山鄉	2018-11-25T03:50:01+08:00	2612	5888	8500	875	9375	17083	54.88%	15.29%	22	22
15	嘉義縣梅山鄉	2018-11-25T01:12:56+08:00	2612	5888	8500	875	9375	17083	54.88%	15.29%	22	22
15	嘉義縣梅山鄉	2018-11-24T23:47:40+08:00	2612	5888	8500	875	9375	17083	54.88%	15.29%	22	22
15	嘉義縣梅山鄉	2018-11-24T23:01:43+08:00	2612	5888	8500	875	9375	17083	54.88%	15.29%	22	22
15	嘉義縣梅山鄉	2018-11-24T22:58:05+08:00	2612	5888	8500	875	9375	17083	54.88%	15.29%	22	22
15	嘉義縣梅山鄉	2018-11-25T00:09:46+08:00	2612	5888	8500	875	9375	17083	54.88%	15.29%	22	22
15	嘉義縣梅山鄉	2018-11-25T03:56:25+08:00	2612	5888	8500	875	9375	17083	54.88%	15.29%	22	22
15	嘉義縣梅山鄉	2018-11-24T22:45:18+08:00	2612	5888	8500	875	9375	17083	54.88%	15.29%	22	22
15	嘉義縣梅山鄉	2018-11-24T22:26:46+08:00	2247	5066	7313	782	8095	14823	54.61%	15.16%	20	22
15	嘉義縣梅山鄉	2018-11-24T22:40:38+08:00	2612	5888	8500	875	9375	17083	54.88%	15.29%	22	22
15	嘉義縣梅山鄉	2018-11-25T04:03:03+08:00	2612	5888	8500	875	9375	17083	54.88%	15.29%	22	22
15	嘉義縣梅山鄉	2018-11-25T00:57:48+08:00	2612	5888	8500	875	9375	17083	54.88%	15.29%	22	22
15	嘉義縣梅山鄉	2018-11-24T22:19:47+08:00	2057	4660	6717	739	7456	13634	54.69%	15.09%	19	22
15	嘉義縣梅山鄉	2018-11-24T22:30:20+08:00	2247	5066	7313	782	8095	14823	54.61%	15.16%	20	22
15	嘉義縣梅山鄉	2018-11-24T23:27:28+08:00	2612	5888	8500	875	9375	17083	54.88%	15.29%	22	22
15	嘉義縣梅山鄉	2018-11-24T23:55:58+08:00	2612	5888	8500	875	9375	17083	54.88%	15.29%	22	22
15	嘉義縣梅山鄉	2018-11-25T06:14:02+08:00	2612	5888	8500	875	9375	17083	54.88%	15.29%	22	22
15	嘉義縣梅山鄉	2018-11-25T00:18:44+08:00	2612	5888	8500	875	9375	17083	54.88%	15.29%	22	22
15	嘉義縣梅山鄉	2018-11-24T23:20:03+08:00	2612	5888	8500	875	9375	17083	54.88%	15.29%	22	22
15	嘉義縣梅山鄉	2018-11-25T01:07:37+08:00	2612	5888	8500	875	9375	17083	54.88%	15.29%	22	22
15	嘉義縣梅山鄉	2018-11-24T23:12:27+08:00	2612	5888	8500	875	9375	17083	54.88%	15.29%	22	22
15	嘉義縣梅山鄉	2018-11-24T22:37:11+08:00	2542	5689	8231	836	9067	16650	54.46%	15.27%	21	22
15	嘉義縣梅山鄉	2018-11-24T23:39:29+08:00	2612	5888	8500	875	9375	17083	54.88%	15.29%	22	22
15	嘉義縣梅山鄉	2018-11-24T23:31:24+08:00	2612	5888	8500	875	9375	17083	54.88%	15.29%	22	22
15	宜蘭縣五結鄉	2018-11-24T23:05:15+08:00	5500	10134	15634	1125	16759	31080	53.92%	17.7%	30	33
15	宜蘭縣五結鄉	2018-11-25T01:18:08+08:00	6188	11329	17517	1217	18734	34892	53.69%	17.73%	33	33
15	宜蘭縣五結鄉	2018-11-24T23:43:29+08:00	6188	11329	17517	1217	18734	34892	53.69%	17.73%	33	33
15	宜蘭縣五結鄉	2018-11-25T03:56:27+08:00	6188	11329	17517	1217	18734	34892	53.69%	17.73%	33	33
15	宜蘭縣五結鄉	2018-11-25T06:19:09+08:00	6188	11329	17517	1217	18734	34892	53.69%	17.73%	33	33
15	宜蘭縣五結鄉	2018-11-24T22:58:07+08:00	5336	9770	15106	1086	16192	30014	53.95%	17.78%	29	33
15	宜蘭縣五結鄉	2018-11-24T22:41:49+08:00	4917	8925	13842	992	14834	27441	54.06%	17.92%	27	33
15	宜蘭縣五結鄉	2018-11-24T23:39:31+08:00	6188	11329	17517	1217	18734	34892	53.69%	17.73%	33	33
15	宜蘭縣五結鄉	2018-11-24T23:47:42+08:00	6188	11329	17517	1217	18734	34892	53.69%	17.73%	33	33
15	宜蘭縣五結鄉	2018-11-24T22:30:22+08:00	4446	8093	12539	920	13459	24898	54.06%	17.86%	25	33
15	宜蘭縣五結鄉	2018-11-24T23:51:47+08:00	6188	11329	17517	1217	18734	34892	53.69%	17.73%	33	33
15	宜蘭縣五結鄉	2018-11-25T06:09:08+08:00	6188	11329	17517	1217	18734	34892	53.69%	17.73%	33	33
15	宜蘭縣五結鄉	2018-11-24T22:13:43+08:00	3903	7087	10990	808	11798	21782	54.16%	17.92%	23	33
15	宜蘭縣五結鄉	2018-11-25T00:57:50+08:00	6188	11329	17517	1217	18734	34892	53.69%	17.73%	33	33
15	宜蘭縣五結鄉	2018-11-25T03:44:39+08:00	6188	11329	17517	1217	18734	34892	53.69%	17.73%	33	33
15	宜蘭縣五結鄉	2018-11-24T23:23:49+08:00	5970	10933	16903	1181	18084	33586	53.84%	17.78%	32	33
15	宜蘭縣五結鄉	2018-11-24T22:33:49+08:00	4662	8478	13140	961	14101	26118	53.99%	17.85%	26	33
15	宜蘭縣五結鄉	2018-11-24T22:37:13+08:00	4917	8925	13842	992	14834	27441	54.06%	17.92%	27	33
15	宜蘭縣五結鄉	2018-11-24T22:16:24+08:00	4167	7589	11756	879	12635	23332	54.15%	17.86%	24	33
15	宜蘭縣五結鄉	2018-11-25T00:18:46+08:00	6188	11329	17517	1217	18734	34892	53.69%	17.73%	33	33
15	宜蘭縣五結鄉	2018-11-24T23:35:21+08:00	5970	10933	16903	1181	18084	33586	53.84%	17.78%	32	33
15	宜蘭縣五結鄉	2018-11-24T23:16:15+08:00	5730	10500	16230	1157	17387	32270	53.88%	17.76%	31	33
15	宜蘭縣五結鄉	2018-11-24T22:45:19+08:00	4917	8925	13842	992	14834	27441	54.06%	17.92%	27	33
15	宜蘭縣五結鄉	2018-11-24T22:54:36+08:00	5336	9770	15106	1086	16192	30014	53.95%	17.78%	29	33
15	宜蘭縣五結鄉	2018-11-24T23:01:44+08:00	5336	9770	15106	1086	16192	30014	53.95%	17.78%	29	33
15	宜蘭縣五結鄉	2018-11-24T22:26:47+08:00	4446	8093	12539	920	13459	24898	54.06%	17.86%	25	33
15	宜蘭縣五結鄉	2018-11-25T00:05:17+08:00	6188	11329	17517	1217	18734	34892	53.69%	17.73%	33	33
15	宜蘭縣五結鄉	2018-11-25T01:12:57+08:00	6188	11329	17517	1217	18734	34892	53.69%	17.73%	33	33
15	宜蘭縣五結鄉	2018-11-25T00:09:49+08:00	6188	11329	17517	1217	18734	34892	53.69%	17.73%	33	33
15	宜蘭縣五結鄉	2018-11-24T22:19:49+08:00	4446	8093	12539	920	13459	24898	54.06%	17.86%	25	33
15	宜蘭縣五結鄉	2018-11-25T04:03:04+08:00	6188	11329	17517	1217	18734	34892	53.69%	17.73%	33	33
15	宜蘭縣五結鄉	2018-11-24T22:40:39+08:00	4917	8925	13842	992	14834	27441	54.06%	17.92%	27	33
15	宜蘭縣五結鄉	2018-11-25T03:32:51+08:00	6188	11329	17517	1217	18734	34892	53.69%	17.73%	33	33
15	宜蘭縣五結鄉	2018-11-24T23:08:50+08:00	5730	10500	16230	1157	17387	32270	53.88%	17.76%	31	33
15	宜蘭縣五結鄉	2018-11-24T22:23:27+08:00	4446	8093	12539	920	13459	24898	54.06%	17.86%	25	33
15	宜蘭縣五結鄉	2018-11-24T22:51:02+08:00	5173	9363	14536	1048	15584	28954	53.82%	17.87%	28	33
15	宜蘭縣五結鄉	2018-11-25T06:14:04+08:00	6188	11329	17517	1217	18734	34892	53.69%	17.73%	33	33
15	宜蘭縣五結鄉	2018-11-24T23:55:59+08:00	6188	11329	17517	1217	18734	34892	53.69%	17.73%	33	33
15	宜蘭縣五結鄉	2018-11-25T06:24:12+08:00	6188	11329	17517	1217	18734	34892	53.69%	17.73%	33	33
15	宜蘭縣五結鄉	2018-11-24T23:27:29+08:00	5970	10933	16903	1181	18084	33586	53.84%	17.78%	32	33
15	宜蘭縣五結鄉	2018-11-25T00:00:22+08:00	6188	11329	17517	1217	18734	34892	53.69%	17.73%	33	33
15	宜蘭縣五結鄉	2018-11-25T00:23:16+08:00	6188	11329	17517	1217	18734	34892	53.69%	17.73%	33	33
15	宜蘭縣五結鄉	2018-11-25T01:02:43+08:00	6188	11329	17517	1217	18734	34892	53.69%	17.73%	33	33
15	宜蘭縣五結鄉	2018-11-25T06:29:30+08:00	6188	11329	17517	1217	18734	34892	53.69%	17.73%	33	33
15	宜蘭縣五結鄉	2018-11-24T23:12:29+08:00	5730	10500	16230	1157	17387	32270	53.88%	17.76%	31	33
15	宜蘭縣五結鄉	2018-11-24T23:31:25+08:00	5970	10933	16903	1181	18084	33586	53.84%	17.78%	32	33
15	宜蘭縣五結鄉	2018-11-25T03:50:03+08:00	6188	11329	17517	1217	18734	34892	53.69%	17.73%	33	33
15	宜蘭縣五結鄉	2018-11-25T01:07:39+08:00	6188	11329	17517	1217	18734	34892	53.69%	17.73%	33	33
15	宜蘭縣五結鄉	2018-11-25T00:14:22+08:00	6188	11329	17517	1217	18734	34892	53.69%	17.73%	33	33
15	宜蘭縣五結鄉	2018-11-25T03:39:06+08:00	6188	11329	17517	1217	18734	34892	53.69%	17.73%	33	33
15	宜蘭縣五結鄉	2018-11-25T01:26:06+08:00	6188	11329	17517	1217	18734	34892	53.69%	17.73%	33	33
15	宜蘭縣五結鄉	2018-11-24T23:20:05+08:00	5970	10933	16903	1181	18084	33586	53.84%	17.78%	32	33
15	嘉義縣民雄鄉	2018-11-25T01:18:06+08:00	9542	18888	28430	2610	31040	57977	53.54%	16.46%	43	45
15	嘉義縣民雄鄉	2018-11-25T06:29:28+08:00	10079	19984	30063	2724	32787	61209	53.57%	16.47%	45	45
15	嘉義縣民雄鄉	2018-11-24T23:43:27+08:00	6506	12496	19002	1781	20783	38865	53.47%	16.74%	31	45
15	嘉義縣民雄鄉	2018-11-25T01:12:55+08:00	9542	18888	28430	2610	31040	57977	53.54%	16.46%	43	45
15	嘉義縣民雄鄉	2018-11-24T23:05:13+08:00	4116	7807	11923	1131	13054	24721	52.81%	16.65%	21	45
15	嘉義縣民雄鄉	2018-11-25T06:19:07+08:00	10079	19984	30063	2724	32787	61209	53.57%	16.47%	45	45
15	嘉義縣民雄鄉	2018-11-25T00:05:15+08:00	7483	14457	21940	2032	23972	44558	53.8%	16.79%	35	45
15	嘉義縣民雄鄉	2018-11-24T22:54:34+08:00	3640	6801	10441	1009	11450	21703	52.76%	16.77%	19	45
15	嘉義縣民雄鄉	2018-11-24T22:41:47+08:00	3136	5685	8821	894	9715	18453	52.65%	16.99%	17	45
15	嘉義縣民雄鄉	2018-11-24T22:50:59+08:00	3136	5685	8821	894	9715	18453	52.65%	16.99%	17	45
15	嘉義縣民雄鄉	2018-11-25T01:02:41+08:00	8971	17630	26601	2500	29101	54305	53.59%	16.52%	41	45
15	嘉義縣民雄鄉	2018-11-25T00:23:14+08:00	8052	15771	23823	2215	26038	48437	53.76%	16.62%	37	45
15	嘉義縣民雄鄉	2018-11-25T03:32:48+08:00	10079	19984	30063	2724	32787	61209	53.57%	16.47%	45	45
15	嘉義縣民雄鄉	2018-11-24T23:23:48+08:00	4794	9213	14007	1303	15310	28938	52.91%	16.57%	24	45
15	嘉義縣民雄鄉	2018-11-25T06:24:10+08:00	10079	19984	30063	2724	32787	61209	53.57%	16.47%	45	45
15	嘉義縣民雄鄉	2018-11-25T00:00:21+08:00	6981	13379	20360	1880	22240	41555	53.52%	16.8%	33	45
15	嘉義縣民雄鄉	2018-11-24T22:23:25+08:00	2357	4116	6473	600	7073	13486	52.45%	17.48%	13	45
15	嘉義縣民雄鄉	2018-11-25T03:44:37+08:00	10079	19984	30063	2724	32787	61209	53.57%	16.47%	45	45
15	嘉義縣民雄鄉	2018-11-24T23:08:48+08:00	4116	7807	11923	1131	13054	24721	52.81%	16.65%	21	45
15	嘉義縣民雄鄉	2018-11-24T22:33:47+08:00	3136	5685	8821	894	9715	18453	52.65%	16.99%	17	45
15	嘉義縣民雄鄉	2018-11-24T22:16:22+08:00	1924	3273	5197	461	5658	11077	51.08%	17.37%	11	45
15	嘉義縣民雄鄉	2018-11-25T03:39:04+08:00	10079	19984	30063	2724	32787	61209	53.57%	16.47%	45	45
15	嘉義縣民雄鄉	2018-11-25T01:26:04+08:00	9782	19461	29243	2647	31890	59589	53.52%	16.42%	44	45
15	嘉義縣民雄鄉	2018-11-24T23:16:13+08:00	4366	8283	12649	1164	13813	26027	53.07%	16.77%	22	45
15	嘉義縣民雄鄉	2018-11-24T23:35:20+08:00	5791	11091	16882	1610	18492	34658	53.36%	16.71%	28	45
15	嘉義縣民雄鄉	2018-11-25T00:14:20+08:00	8052	15771	23823	2215	26038	48437	53.76%	16.62%	37	45
15	嘉義縣民雄鄉	2018-11-25T03:50:01+08:00	10079	19984	30063	2724	32787	61209	53.57%	16.47%	45	45
15	嘉義縣民雄鄉	2018-11-24T23:47:40+08:00	6744	12937	19681	1826	21507	40288	53.38%	16.74%	32	45
15	嘉義縣民雄鄉	2018-11-24T22:45:17+08:00	3136	5685	8821	894	9715	18453	52.65%	16.99%	17	45
15	嘉義縣民雄鄉	2018-11-24T22:58:05+08:00	3904	7273	11177	1082	12259	23138	52.98%	16.87%	20	45
15	嘉義縣民雄鄉	2018-11-25T00:09:46+08:00	8052	15771	23823	2215	26038	48437	53.76%	16.62%	37	45
15	嘉義縣民雄鄉	2018-11-25T03:56:24+08:00	10079	19984	30063	2724	32787	61209	53.57%	16.47%	45	45
15	嘉義縣民雄鄉	2018-11-24T22:26:46+08:00	2546	4456	7002	652	7654	14586	52.47%	17.46%	14	45
15	嘉義縣民雄鄉	2018-11-24T23:01:42+08:00	4116	7807	11923	1131	13054	24721	52.81%	16.65%	21	45
15	嘉義縣民雄鄉	2018-11-24T22:19:46+08:00	2170	3758	5928	528	6456	12431	51.93%	17.46%	12	45
15	嘉義縣民雄鄉	2018-11-24T22:13:41+08:00	1709	2751	4460	401	4861	9357	51.95%	18.26%	10	45
15	嘉義縣民雄鄉	2018-11-25T04:03:02+08:00	10079	19984	30063	2724	32787	61209	53.57%	16.47%	45	45
15	嘉義縣民雄鄉	2018-11-25T00:57:48+08:00	8789	17221	26010	2399	28409	53103	53.5%	16.55%	40	45
15	嘉義縣民雄鄉	2018-11-24T22:40:37+08:00	3136	5685	8821	894	9715	18453	52.65%	16.99%	17	45
15	嘉義縣民雄鄉	2018-11-24T23:51:45+08:00	6981	13379	20360	1880	22240	41555	53.52%	16.8%	33	45
15	嘉義縣民雄鄉	2018-11-24T22:30:20+08:00	2780	5009	7789	780	8569	16215	52.85%	17.14%	15	45
15	嘉義縣民雄鄉	2018-11-25T06:09:05+08:00	10079	19984	30063	2724	32787	61209	53.57%	16.47%	45	45
15	嘉義縣民雄鄉	2018-11-24T23:55:57+08:00	6981	13379	20360	1880	22240	41555	53.52%	16.8%	33	45
15	嘉義縣民雄鄉	2018-11-24T23:27:27+08:00	5128	9799	14927	1369	16296	30656	53.16%	16.73%	25	45
15	嘉義縣民雄鄉	2018-11-25T06:14:02+08:00	10079	19984	30063	2724	32787	61209	53.57%	16.47%	45	45
15	嘉義縣民雄鄉	2018-11-25T00:18:43+08:00	8052	15771	23823	2215	26038	48437	53.76%	16.62%	37	45
15	嘉義縣民雄鄉	2018-11-25T01:07:37+08:00	9542	18888	28430	2610	31040	57977	53.54%	16.46%	43	45
15	嘉義縣民雄鄉	2018-11-24T23:12:27+08:00	4366	8283	12649	1164	13813	26027	53.07%	16.77%	22	45
15	嘉義縣民雄鄉	2018-11-24T23:39:28+08:00	6315	12120	18435	1734	20169	37825	53.32%	16.7%	30	45
15	嘉義縣民雄鄉	2018-11-24T22:37:11+08:00	3136	5685	8821	894	9715	18453	52.65%	16.99%	17	45
15	嘉義縣民雄鄉	2018-11-24T23:31:23+08:00	5791	11091	16882	1610	18492	34658	53.36%	16.71%	28	45
15	嘉義縣民雄鄉	2018-11-24T23:20:02+08:00	4794	9213	14007	1303	15310	28938	52.91%	16.57%	24	45
15	臺中市梧棲區	2018-11-25T03:56:17+08:00	7915	17312	25227	1665	26892	47040	57.17%	16.83%	36	36
15	臺中市梧棲區	2018-11-25T06:29:21+08:00	7915	17312	25227	1665	26892	47040	57.17%	16.83%	36	36
15	臺中市梧棲區	2018-11-25T03:49:55+08:00	7915	17312	25227	1665	26892	47040	57.17%	16.83%	36	36
15	臺中市梧棲區	2018-11-25T06:19:01+08:00	7915	17312	25227	1665	26892	47040	57.17%	16.83%	36	36
15	臺中市梧棲區	2018-11-24T23:16:07+08:00	7915	17312	25227	1665	26892	47040	57.17%	16.83%	36	36
15	臺中市梧棲區	2018-11-24T22:45:12+08:00	7516	16344	23860	1592	25452	44455	57.25%	16.91%	34	36
15	臺中市梧棲區	2018-11-24T23:43:21+08:00	7915	17312	25227	1665	26892	47040	57.17%	16.83%	36	36
15	臺中市梧棲區	2018-11-24T22:41:40+08:00	7516	16344	23860	1592	25452	44455	57.25%	16.91%	34	36
15	臺中市梧棲區	2018-11-25T01:25:57+08:00	7915	17312	25227	1665	26892	47040	57.17%	16.83%	36	36
15	臺中市梧棲區	2018-11-24T22:30:14+08:00	7516	16344	23860	1592	25452	44455	57.25%	16.91%	34	36
15	臺中市梧棲區	2018-11-25T06:24:04+08:00	7915	17312	25227	1665	26892	47040	57.17%	16.83%	36	36
15	臺中市梧棲區	2018-11-25T00:23:08+08:00	7915	17312	25227	1665	26892	47040	57.17%	16.83%	36	36
15	臺中市梧棲區	2018-11-25T03:32:39+08:00	7915	17312	25227	1665	26892	47040	57.17%	16.83%	36	36
15	臺中市梧棲區	2018-11-24T23:51:39+08:00	7915	17312	25227	1665	26892	47040	57.17%	16.83%	36	36
15	臺中市梧棲區	2018-11-24T23:27:22+08:00	7915	17312	25227	1665	26892	47040	57.17%	16.83%	36	36
15	臺中市梧棲區	2018-11-24T22:13:32+08:00	6731	14613	21344	1452	22796	39518	57.69%	17.03%	31	36
15	臺中市梧棲區	2018-11-24T22:57:59+08:00	7694	16772	24466	1626	26092	45590	57.23%	16.88%	35	36
15	臺中市梧棲區	2018-11-24T23:08:41+08:00	7915	17312	25227	1665	26892	47040	57.17%	16.83%	36	36
15	臺中市梧棲區	2018-11-24T23:19:56+08:00	7915	17312	25227	1665	26892	47040	57.17%	16.83%	36	36
15	臺中市梧棲區	2018-11-25T01:17:58+08:00	7915	17312	25227	1665	26892	47040	57.17%	16.83%	36	36
15	臺中市梧棲區	2018-11-24T22:54:29+08:00	7694	16772	24466	1626	26092	45590	57.23%	16.88%	35	36
15	臺中市梧棲區	2018-11-24T23:47:33+08:00	7915	17312	25227	1665	26892	47040	57.17%	16.83%	36	36
15	臺中市梧棲區	2018-11-25T04:02:56+08:00	7915	17312	25227	1665	26892	47040	57.17%	16.83%	36	36
15	臺中市梧棲區	2018-11-25T06:08:58+08:00	7915	17312	25227	1665	26892	47040	57.17%	16.83%	36	36
15	臺中市梧棲區	2018-11-24T22:16:15+08:00	6935	15123	22058	1496	23554	40917	57.57%	16.95%	32	36
15	臺中市梧棲區	2018-11-24T23:31:16+08:00	7915	17312	25227	1665	26892	47040	57.17%	16.83%	36	36
15	臺中市梧棲區	2018-11-25T01:12:48+08:00	7915	17312	25227	1665	26892	47040	57.17%	16.83%	36	36
15	臺中市梧棲區	2018-11-24T23:05:08+08:00	7694	16772	24466	1626	26092	45590	57.23%	16.88%	35	36
15	臺中市梧棲區	2018-11-25T00:05:09+08:00	7915	17312	25227	1665	26892	47040	57.17%	16.83%	36	36
15	臺中市梧棲區	2018-11-24T22:37:04+08:00	7516	16344	23860	1592	25452	44455	57.25%	16.91%	34	36
15	臺中市梧棲區	2018-11-25T06:13:56+08:00	7915	17312	25227	1665	26892	47040	57.17%	16.83%	36	36
15	臺中市梧棲區	2018-11-24T22:26:40+08:00	7516	16344	23860	1592	25452	44455	57.25%	16.91%	34	36
15	臺中市梧棲區	2018-11-24T22:50:53+08:00	7516	16344	23860	1592	25452	44455	57.25%	16.91%	34	36
15	臺中市梧棲區	2018-11-25T00:18:35+08:00	7915	17312	25227	1665	26892	47040	57.17%	16.83%	36	36
15	臺中市梧棲區	2018-11-24T22:19:41+08:00	6935	15123	22058	1496	23554	40917	57.57%	16.95%	32	36
15	臺中市梧棲區	2018-11-25T03:38:59+08:00	7915	17312	25227	1665	26892	47040	57.17%	16.83%	36	36
15	臺中市梧棲區	2018-11-24T22:40:31+08:00	7516	16344	23860	1592	25452	44455	57.25%	16.91%	34	36
15	臺中市梧棲區	2018-11-25T01:02:35+08:00	7915	17312	25227	1665	26892	47040	57.17%	16.83%	36	36
15	臺中市梧棲區	2018-11-25T00:57:41+08:00	7915	17312	25227	1665	26892	47040	57.17%	16.83%	36	36
15	臺中市梧棲區	2018-11-25T03:44:28+08:00	7915	17312	25227	1665	26892	47040	57.17%	16.83%	36	36
15	臺中市梧棲區	2018-11-24T23:23:42+08:00	7915	17312	25227	1665	26892	47040	57.17%	16.83%	36	36
15	臺中市梧棲區	2018-11-24T22:23:18+08:00	7222	15735	22957	1550	24507	42713	57.38%	16.91%	33	36
15	臺中市梧棲區	2018-11-25T00:00:15+08:00	7915	17312	25227	1665	26892	47040	57.17%	16.83%	36	36
15	臺中市梧棲區	2018-11-24T23:55:51+08:00	7915	17312	25227	1665	26892	47040	57.17%	16.83%	36	36
15	臺中市梧棲區	2018-11-24T23:39:21+08:00	7915	17312	25227	1665	26892	47040	57.17%	16.83%	36	36
15	臺中市梧棲區	2018-11-25T01:07:30+08:00	7915	17312	25227	1665	26892	47040	57.17%	16.83%	36	36
15	臺中市梧棲區	2018-11-24T23:12:20+08:00	7915	17312	25227	1665	26892	47040	57.17%	16.83%	36	36
15	臺中市梧棲區	2018-11-24T23:35:14+08:00	7915	17312	25227	1665	26892	47040	57.17%	16.83%	36	36
15	臺中市梧棲區	2018-11-25T00:14:14+08:00	7915	17312	25227	1665	26892	47040	57.17%	16.83%	36	36
15	臺中市梧棲區	2018-11-24T23:01:35+08:00	7694	16772	24466	1626	26092	45590	57.23%	16.88%	35	36
15	臺中市梧棲區	2018-11-25T00:09:39+08:00	7915	17312	25227	1665	26892	47040	57.17%	16.83%	36	36
15	臺中市梧棲區	2018-11-24T22:33:42+08:00	7516	16344	23860	1592	25452	44455	57.25%	16.91%	34	36
15	臺中市西區	2018-11-25T03:56:17+08:00	19150	34098	53248	2543	55791	95040	58.7%	20.15%	66	66
15	臺中市西區	2018-11-24T23:16:06+08:00	18216	32417	50633	2413	53046	90338	58.72%	20.16%	63	66
15	臺中市西區	2018-11-25T06:29:21+08:00	19150	34098	53248	2543	55791	95040	58.7%	20.15%	66	66
15	臺中市西區	2018-11-25T03:49:55+08:00	19150	34098	53248	2543	55791	95040	58.7%	20.15%	66	66
15	臺中市西區	2018-11-25T06:19:01+08:00	19150	34098	53248	2543	55791	95040	58.7%	20.15%	66	66
15	臺中市西區	2018-11-24T22:45:12+08:00	16651	29647	46298	2235	48533	82608	58.75%	20.16%	58	66
15	臺中市西區	2018-11-24T23:43:21+08:00	18520	32972	51492	2448	53940	91768	58.78%	20.18%	64	66
15	臺中市西區	2018-11-25T01:25:57+08:00	19150	34098	53248	2543	55791	95040	58.7%	20.15%	66	66
15	臺中市西區	2018-11-24T22:30:13+08:00	14863	26540	41403	2026	43429	73791	58.85%	20.14%	53	66
15	臺中市西區	2018-11-25T06:24:04+08:00	19150	34098	53248	2543	55791	95040	58.7%	20.15%	66	66
15	臺中市西區	2018-11-25T03:32:38+08:00	19150	34098	53248	2543	55791	95040	58.7%	20.15%	66	66
15	臺中市西區	2018-11-25T00:23:07+08:00	19150	34098	53248	2543	55791	95040	58.7%	20.15%	66	66
15	臺中市西區	2018-11-24T23:51:39+08:00	18834	33600	52434	2500	54934	93586	58.7%	20.12%	65	66
15	臺中市西區	2018-11-24T23:27:22+08:00	18520	32972	51492	2448	53940	91768	58.78%	20.18%	64	66
15	臺中市西區	2018-11-24T22:13:32+08:00	12240	21764	34004	1675	35679	60607	58.87%	20.2%	44	66
15	臺中市西區	2018-11-25T01:17:57+08:00	19150	34098	53248	2543	55791	95040	58.7%	20.15%	66	66
15	臺中市西區	2018-11-24T23:08:40+08:00	17888	31816	49704	2376	52080	88725	58.7%	20.16%	62	66
15	臺中市西區	2018-11-24T22:57:58+08:00	17311	30754	48065	2296	50361	85649	58.8%	20.21%	60	66
15	臺中市西區	2018-11-24T23:19:56+08:00	18216	32417	50633	2413	53046	90338	58.72%	20.16%	63	66
15	臺中市西區	2018-11-25T06:08:57+08:00	19150	34098	53248	2543	55791	95040	58.7%	20.15%	66	66
15	臺中市西區	2018-11-24T22:54:29+08:00	17311	30754	48065	2296	50361	85649	58.8%	20.21%	60	66
15	臺中市西區	2018-11-25T04:02:56+08:00	19150	34098	53248	2543	55791	95040	58.7%	20.15%	66	66
15	臺中市西區	2018-11-24T22:16:15+08:00	12532	22279	34811	1718	36529	62006	58.91%	20.21%	45	66
15	臺中市西區	2018-11-24T23:31:16+08:00	18520	32972	51492	2448	53940	91768	58.78%	20.18%	64	66
15	臺中市西區	2018-11-25T01:12:48+08:00	19150	34098	53248	2543	55791	95040	58.7%	20.15%	66	66
15	臺中市西區	2018-11-24T23:05:08+08:00	17888	31816	49704	2376	52080	88725	58.7%	20.16%	62	66
15	臺中市西區	2018-11-24T23:47:32+08:00	18834	33600	52434	2500	54934	93586	58.7%	20.12%	65	66
15	臺中市西區	2018-11-24T22:41:39+08:00	15980	28343	44323	2156	46479	79092	58.77%	20.2%	56	66
15	臺中市西區	2018-11-25T00:05:09+08:00	19150	34098	53248	2543	55791	95040	58.7%	20.15%	66	66
15	臺中市西區	2018-11-24T22:37:04+08:00	15980	28343	44323	2156	46479	79092	58.77%	20.2%	56	66
15	臺中市西區	2018-11-24T22:50:52+08:00	16978	30252	47230	2264	49494	84144	58.82%	20.18%	59	66
15	臺中市西區	2018-11-25T06:13:56+08:00	19150	34098	53248	2543	55791	95040	58.7%	20.15%	66	66
15	臺中市西區	2018-11-24T22:26:40+08:00	14301	25482	39783	1961	41744	70952	58.83%	20.16%	51	66
15	臺中市西區	2018-11-25T00:18:35+08:00	19150	34098	53248	2543	55791	95040	58.7%	20.15%	66	66
15	臺中市西區	2018-11-24T22:40:31+08:00	15980	28343	44323	2156	46479	79092	58.77%	20.2%	56	66
15	臺中市西區	2018-11-25T01:02:35+08:00	19150	34098	53248	2543	55791	95040	58.7%	20.15%	66	66
15	臺中市西區	2018-11-25T00:57:41+08:00	19150	34098	53248	2543	55791	95040	58.7%	20.15%	66	66
15	臺中市西區	2018-11-24T22:19:40+08:00	13677	24390	38067	1892	39959	68046	58.72%	20.1%	49	66
15	臺中市西區	2018-11-25T03:38:58+08:00	19150	34098	53248	2543	55791	95040	58.7%	20.15%	66	66
15	臺中市西區	2018-11-25T03:44:28+08:00	19150	34098	53248	2543	55791	95040	58.7%	20.15%	66	66
15	臺中市西區	2018-11-24T23:23:42+08:00	18216	32417	50633	2413	53046	90338	58.72%	20.16%	63	66
15	臺中市西區	2018-11-24T22:23:17+08:00	14037	25036	39073	1935	41008	69777	58.77%	20.12%	50	66
15	臺中市西區	2018-11-24T23:55:51+08:00	18834	33600	52434	2500	54934	93586	58.7%	20.12%	65	66
15	臺中市西區	2018-11-25T00:00:14+08:00	18834	33600	52434	2500	54934	93586	58.7%	20.12%	65	66
15	臺中市西區	2018-11-24T23:39:21+08:00	18520	32972	51492	2448	53940	91768	58.78%	20.18%	64	66
15	臺中市西區	2018-11-25T01:07:30+08:00	19150	34098	53248	2543	55791	95040	58.7%	20.15%	66	66
15	臺中市西區	2018-11-25T00:09:38+08:00	19150	34098	53248	2543	55791	95040	58.7%	20.15%	66	66
15	臺中市西區	2018-11-24T23:35:14+08:00	18520	32972	51492	2448	53940	91768	58.78%	20.18%	64	66
15	臺中市西區	2018-11-25T00:14:14+08:00	19150	34098	53248	2543	55791	95040	58.7%	20.15%	66	66
15	臺中市西區	2018-11-24T23:01:35+08:00	17311	30754	48065	2296	50361	85649	58.8%	20.21%	60	66
15	臺中市西區	2018-11-24T23:12:19+08:00	17888	31816	49704	2376	52080	88725	58.7%	20.16%	62	66
15	臺中市西區	2018-11-24T22:33:42+08:00	15603	27704	43307	2122	45429	77140	58.89%	20.23%	55	66
15	臺北市大同區	2018-11-25T06:29:19+08:00	24094	34885	58979	3537	62516	107557	58.12%	22.4%	82	82
15	臺北市大同區	2018-11-25T01:07:28+08:00	23447	34057	57504	3440	60944	104675	58.22%	22.4%	80	82
15	臺北市大同區	2018-11-25T06:13:55+08:00	24094	34885	58979	3537	62516	107557	58.12%	22.4%	82	82
15	臺北市大同區	2018-11-24T22:50:51+08:00	15704	23085	38789	2337	41126	70796	58.09%	22.18%	55	82
15	臺北市大同區	2018-11-25T06:19:00+08:00	24094	34885	58979	3537	62516	107557	58.12%	22.4%	82	82
15	臺北市大同區	2018-11-25T03:49:53+08:00	24094	34885	58979	3537	62516	107557	58.12%	22.4%	82	82
15	臺北市大同區	2018-11-24T22:50:50+08:00	15704	23085	38789	2337	41126	70796	58.09%	22.18%	55	82
15	臺北市大同區	2018-11-25T06:13:54+08:00	24094	34885	58979	3537	62516	107557	58.12%	22.4%	82	82
15	臺北市大同區	2018-11-24T23:43:19+08:00	19629	28664	48293	2909	51202	87914	58.24%	22.33%	68	82
15	臺北市大同區	2018-11-24T22:13:29+08:00	11783	17098	28881	1831	30712	51748	59.35%	22.77%	42	82
15	臺北市大同區	2018-11-25T06:24:03+08:00	24094	34885	58979	3537	62516	107557	58.12%	22.4%	82	82
15	臺北市大同區	2018-11-24T23:08:39+08:00	17833	26049	43882	2628	46510	79840	58.25%	22.34%	62	82
15	臺北市大同區	2018-11-25T00:23:06+08:00	21846	31637	53483	3185	56668	97669	58.02%	22.37%	75	82
15	臺北市大同區	2018-11-24T22:30:12+08:00	13049	19029	32078	1956	34034	57520	59.17%	22.69%	46	82
15	臺北市大同區	2018-11-24T23:08:38+08:00	17833	26049	43882	2628	46510	79840	58.25%	22.34%	62	82
15	臺北市大同區	2018-11-24T23:55:49+08:00	20261	29548	49809	2984	52793	90555	58.3%	22.37%	70	82
15	臺北市大同區	2018-11-25T03:32:37+08:00	24094	34885	58979	3537	62516	107557	58.12%	22.4%	82	82
15	臺北市大同區	2018-11-25T06:24:02+08:00	24094	34885	58979	3537	62516	107557	58.12%	22.4%	82	82
15	臺北市大同區	2018-11-24T23:51:37+08:00	19629	28664	48293	2909	51202	87914	58.24%	22.33%	68	82
15	臺北市大同區	2018-11-24T23:23:41+08:00	18729	27364	46093	2753	48846	83940	58.19%	22.31%	65	82
15	臺北市大同區	2018-11-24T22:23:15+08:00	12430	18018	30448	1890	32338	54534	59.3%	22.79%	44	82
15	臺北市大同區	2018-11-24T22:40:29+08:00	14129	20806	34935	2106	37041	62578	59.19%	22.58%	50	82
15	臺北市大同區	2018-11-24T22:57:57+08:00	16586	24350	40936	2494	43430	74669	58.16%	22.21%	58	82
15	臺北市大同區	2018-11-24T23:51:38+08:00	19629	28664	48293	2909	51202	87914	58.24%	22.33%	68	82
15	臺北市大同區	2018-11-25T06:18:59+08:00	24094	34885	58979	3537	62516	107557	58.12%	22.4%	82	82
15	臺北市大同區	2018-11-25T01:17:56+08:00	23447	34057	57504	3440	60944	104675	58.22%	22.4%	80	82
15	臺北市大同區	2018-11-24T23:23:40+08:00	18729	27364	46093	2753	48846	83940	58.19%	22.31%	65	82
15	臺北市大同區	2018-11-24T22:33:40+08:00	13334	19476	32810	2008	34818	58776	59.24%	22.69%	47	82
15	臺北市大同區	2018-11-24T22:16:13+08:00	11783	17098	28881	1831	30712	51748	59.35%	22.77%	42	82
15	臺北市大同區	2018-11-25T00:14:11+08:00	20535	29971	50506	3020	53526	91831	58.29%	22.36%	71	82
15	臺北市大同區	2018-11-24T23:05:07+08:00	17833	26049	43882	2628	46510	79840	58.25%	22.34%	62	82
15	臺北市大同區	2018-11-24T22:41:38+08:00	14129	20806	34935	2106	37041	62578	59.19%	22.58%	50	82
15	臺北市大同區	2018-11-24T22:54:28+08:00	16586	24350	40936	2494	43430	74669	58.16%	22.21%	58	82
15	臺北市大同區	2018-11-25T01:12:46+08:00	23447	34057	57504	3440	60944	104675	58.22%	22.4%	80	82
15	臺北市大同區	2018-11-25T06:08:56+08:00	24094	34885	58979	3537	62516	107557	58.12%	22.4%	82	82
15	臺北市大同區	2018-11-24T22:41:37+08:00	14129	20806	34935	2106	37041	62578	59.19%	22.58%	50	82
15	臺北市大同區	2018-11-25T00:05:07+08:00	20535	29971	50506	3020	53526	91831	58.29%	22.36%	71	82
15	臺北市大同區	2018-11-24T23:05:06+08:00	17833	26049	43882	2628	46510	79840	58.25%	22.34%	62	82
15	臺北市大同區	2018-11-25T00:18:33+08:00	21142	30785	51927	3085	55012	94626	58.14%	22.34%	73	82
15	臺北市大同區	2018-11-24T22:37:03+08:00	13582	19953	33535	2027	35562	60140	59.13%	22.58%	48	82
15	臺北市大同區	2018-11-24T22:45:10+08:00	14391	21310	35701	2172	37873	65037	58.23%	22.13%	51	82
15	臺北市大同區	2018-11-24T23:16:05+08:00	18729	27364	46093	2753	48846	83940	58.19%	22.31%	65	82
15	臺北市大同區	2018-11-24T22:45:11+08:00	14391	21310	35701	2172	37873	65037	58.23%	22.13%	51	82
15	臺北市大同區	2018-11-25T03:56:15+08:00	24094	34885	58979	3537	62516	107557	58.12%	22.4%	82	82
15	臺北市大同區	2018-11-25T03:38:57+08:00	24094	34885	58979	3537	62516	107557	58.12%	22.4%	82	82
15	臺北市大同區	2018-11-25T03:44:26+08:00	24094	34885	58979	3537	62516	107557	58.12%	22.4%	82	82
15	臺北市大同區	2018-11-24T22:30:11+08:00	13049	19029	32078	1956	34034	57520	59.17%	22.69%	46	82
15	臺北市大同區	2018-11-25T01:02:33+08:00	23447	34057	57504	3440	60944	104675	58.22%	22.4%	80	82
15	臺北市大同區	2018-11-24T22:40:30+08:00	14129	20806	34935	2106	37041	62578	59.19%	22.58%	50	82
15	臺北市大同區	2018-11-25T01:25:55+08:00	24094	34885	58979	3537	62516	107557	58.12%	22.4%	82	82
15	臺北市大同區	2018-11-24T22:23:16+08:00	12430	18018	30448	1890	32338	54534	59.3%	22.79%	44	82
15	臺北市大同區	2018-11-24T23:19:54+08:00	18729	27364	46093	2753	48846	83940	58.19%	22.31%	65	82
15	臺北市大同區	2018-11-25T00:57:39+08:00	23447	34057	57504	3440	60944	104675	58.22%	22.4%	80	82
15	臺北市大同區	2018-11-24T23:27:21+08:00	19000	27798	46798	2799	49597	85269	58.17%	22.28%	66	82
15	臺北市大同區	2018-11-25T01:17:55+08:00	23447	34057	57504	3440	60944	104675	58.22%	22.4%	80	82
15	臺北市大同區	2018-11-24T22:19:39+08:00	12111	17577	29688	1868	31556	53210	59.3%	22.76%	43	82
15	臺北市大同區	2018-11-24T23:27:20+08:00	19000	27798	46798	2799	49597	85269	58.17%	22.28%	66	82
15	臺北市大同區	2018-11-24T22:13:30+08:00	11783	17098	28881	1831	30712	51748	59.35%	22.77%	42	82
15	臺北市大同區	2018-11-25T00:00:13+08:00	20535	29971	50506	3020	53526	91831	58.29%	22.36%	71	82
15	臺北市大同區	2018-11-25T00:14:12+08:00	20535	29971	50506	3020	53526	91831	58.29%	22.36%	71	82
15	臺北市大同區	2018-11-25T04:02:55+08:00	24094	34885	58979	3537	62516	107557	58.12%	22.4%	82	82
15	臺北市大同區	2018-11-24T23:39:19+08:00	19321	28267	47588	2861	50449	86653	58.22%	22.3%	67	82
15	臺北市大同區	2018-11-24T22:26:39+08:00	12430	18018	30448	1890	32338	54534	59.3%	22.79%	44	82
15	臺北市大同區	2018-11-24T23:12:18+08:00	17833	26049	43882	2628	46510	79840	58.25%	22.34%	62	82
15	臺北市大同區	2018-11-24T23:31:14+08:00	19000	27798	46798	2799	49597	85269	58.17%	22.28%	66	82
15	臺北市大同區	2018-11-24T23:01:33+08:00	16889	24777	41666	2536	44202	75947	58.2%	22.24%	59	82
15	臺北市大同區	2018-11-24T23:01:34+08:00	16889	24777	41666	2536	44202	75947	58.2%	22.24%	59	82
15	臺北市大同區	2018-11-24T23:47:31+08:00	19629	28664	48293	2909	51202	87914	58.24%	22.33%	68	82
15	臺北市大同區	2018-11-24T23:35:13+08:00	19000	27798	46798	2799	49597	85269	58.17%	22.28%	66	82
15	臺北市大同區	2018-11-25T04:02:54+08:00	24094	34885	58979	3537	62516	107557	58.12%	22.4%	82	82
15	臺北市大同區	2018-11-25T00:09:37+08:00	20535	29971	50506	3020	53526	91831	58.29%	22.36%	71	82
15	臺北市大同區	2018-11-25T06:08:55+08:00	24094	34885	58979	3537	62516	107557	58.12%	22.4%	82	82
15	雲林縣西螺鎮	2018-11-25T00:05:14+08:00	6128	12384	18512	1819	20331	38142	53.3%	16.07%	34	34
15	雲林縣西螺鎮	2018-11-25T06:19:06+08:00	6128	12384	18512	1819	20331	38142	53.3%	16.07%	34	34
15	雲林縣西螺鎮	2018-11-25T00:09:45+08:00	6128	12384	18512	1819	20331	38142	53.3%	16.07%	34	34
15	雲林縣西螺鎮	2018-11-24T22:41:46+08:00	4249	8607	12856	1274	14130	26032	54.28%	16.32%	25	34
15	雲林縣西螺鎮	2018-11-25T06:29:27+08:00	6128	12384	18512	1819	20331	38142	53.3%	16.07%	34	34
15	雲林縣西螺鎮	2018-11-24T23:05:13+08:00	5358	10875	16233	1554	17787	33342	53.35%	16.07%	30	34
15	雲林縣西螺鎮	2018-11-24T22:26:45+08:00	3562	7299	10861	1102	11963	21912	54.6%	16.26%	22	34
15	雲林縣西螺鎮	2018-11-24T22:54:34+08:00	5057	10275	15332	1502	16834	31601	53.27%	16%	29	34
15	雲林縣西螺鎮	2018-11-25T01:12:54+08:00	6128	12384	18512	1819	20331	38142	53.3%	16.07%	34	34
15	雲林縣西螺鎮	2018-11-24T23:43:26+08:00	6128	12384	18512	1819	20331	38142	53.3%	16.07%	34	34
15	雲林縣西螺鎮	2018-11-24T22:50:59+08:00	4440	8967	13407	1325	14732	27336	53.89%	16.24%	26	34
15	雲林縣西螺鎮	2018-11-25T00:00:20+08:00	6128	12384	18512	1819	20331	38142	53.3%	16.07%	34	34
15	雲林縣西螺鎮	2018-11-25T00:23:13+08:00	6128	12384	18512	1819	20331	38142	53.3%	16.07%	34	34
15	雲林縣西螺鎮	2018-11-25T03:44:36+08:00	6128	12384	18512	1819	20331	38142	53.3%	16.07%	34	34
15	雲林縣西螺鎮	2018-11-24T23:08:47+08:00	5358	10875	16233	1554	17787	33342	53.35%	16.07%	30	34
15	雲林縣西螺鎮	2018-11-24T22:23:24+08:00	3306	6701	10007	1066	11073	20287	54.58%	16.3%	21	34
15	雲林縣西螺鎮	2018-11-25T01:02:40+08:00	6128	12384	18512	1819	20331	38142	53.3%	16.07%	34	34
15	雲林縣西螺鎮	2018-11-25T06:14:01+08:00	6128	12384	18512	1819	20331	38142	53.3%	16.07%	34	34
15	雲林縣西螺鎮	2018-11-25T03:32:47+08:00	6128	12384	18512	1819	20331	38142	53.3%	16.07%	34	34
15	雲林縣西螺鎮	2018-11-24T23:23:47+08:00	5752	11554	17306	1707	19013	35698	53.26%	16.11%	32	34
15	雲林縣西螺鎮	2018-11-25T03:50:00+08:00	6128	12384	18512	1819	20331	38142	53.3%	16.07%	34	34
15	雲林縣西螺鎮	2018-11-24T22:33:47+08:00	3727	7625	11352	1157	12509	22926	54.56%	16.26%	23	34
15	雲林縣西螺鎮	2018-11-25T03:39:03+08:00	6128	12384	18512	1819	20331	38142	53.3%	16.07%	34	34
15	雲林縣西螺鎮	2018-11-25T01:26:02+08:00	6128	12384	18512	1819	20331	38142	53.3%	16.07%	34	34
15	雲林縣西螺鎮	2018-11-25T00:14:19+08:00	6128	12384	18512	1819	20331	38142	53.3%	16.07%	34	34
15	雲林縣西螺鎮	2018-11-24T23:16:12+08:00	5534	11172	16706	1621	18327	34325	53.39%	16.12%	31	34
15	雲林縣西螺鎮	2018-11-24T23:35:19+08:00	5873	11831	17704	1751	19455	36564	53.21%	16.06%	33	34
15	雲林縣西螺鎮	2018-11-24T22:45:17+08:00	4440	8967	13407	1325	14732	27336	53.89%	16.24%	26	34
15	雲林縣西螺鎮	2018-11-25T01:18:05+08:00	6128	12384	18512	1819	20331	38142	53.3%	16.07%	34	34
15	雲林縣西螺鎮	2018-11-25T03:56:23+08:00	6128	12384	18512	1819	20331	38142	53.3%	16.07%	34	34
15	雲林縣西螺鎮	2018-11-24T22:58:04+08:00	5057	10275	15332	1502	16834	31601	53.27%	16%	29	34
15	雲林縣西螺鎮	2018-11-24T23:01:42+08:00	5358	10875	16233	1554	17787	33342	53.35%	16.07%	30	34
15	雲林縣西螺鎮	2018-11-25T00:57:47+08:00	6128	12384	18512	1819	20331	38142	53.3%	16.07%	34	34
15	雲林縣西螺鎮	2018-11-24T22:19:46+08:00	3094	6235	9329	843	10172	18773	54.18%	16.48%	20	34
15	雲林縣西螺鎮	2018-11-25T06:24:09+08:00	6128	12384	18512	1819	20331	38142	53.3%	16.07%	34	34
15	雲林縣西螺鎮	2018-11-25T04:03:02+08:00	6128	12384	18512	1819	20331	38142	53.3%	16.07%	34	34
15	雲林縣西螺鎮	2018-11-24T22:30:19+08:00	3727	7625	11352	1157	12509	22926	54.56%	16.26%	23	34
15	雲林縣西螺鎮	2018-11-24T22:13:40+08:00	2514	5159	7673	645	8318	15261	54.5%	16.47%	17	34
15	雲林縣西螺鎮	2018-11-24T22:40:37+08:00	4249	8607	12856	1274	14130	26032	54.28%	16.32%	25	34
15	雲林縣西螺鎮	2018-11-24T23:51:45+08:00	6128	12384	18512	1819	20331	38142	53.3%	16.07%	34	34
15	雲林縣西螺鎮	2018-11-25T06:09:05+08:00	6128	12384	18512	1819	20331	38142	53.3%	16.07%	34	34
15	雲林縣西螺鎮	2018-11-24T23:27:27+08:00	5873	11831	17704	1751	19455	36564	53.21%	16.06%	33	34
15	雲林縣西螺鎮	2018-11-24T23:55:56+08:00	6128	12384	18512	1819	20331	38142	53.3%	16.07%	34	34
15	雲林縣西螺鎮	2018-11-24T23:47:39+08:00	6128	12384	18512	1819	20331	38142	53.3%	16.07%	34	34
15	雲林縣西螺鎮	2018-11-24T23:31:22+08:00	5873	11831	17704	1751	19455	36564	53.21%	16.06%	33	34
15	雲林縣西螺鎮	2018-11-24T22:16:21+08:00	2686	5451	8137	698	8835	16232	54.43%	16.55%	18	34
15	雲林縣西螺鎮	2018-11-25T00:18:42+08:00	6128	12384	18512	1819	20331	38142	53.3%	16.07%	34	34
15	雲林縣西螺鎮	2018-11-24T22:37:10+08:00	3975	8118	12093	1213	13306	24442	54.44%	16.26%	24	34
15	雲林縣西螺鎮	2018-11-24T23:12:26+08:00	5358	10875	16233	1554	17787	33342	53.35%	16.07%	30	34
15	雲林縣西螺鎮	2018-11-24T23:39:27+08:00	6128	12384	18512	1819	20331	38142	53.3%	16.07%	34	34
15	雲林縣西螺鎮	2018-11-24T23:20:02+08:00	5534	11172	16706	1621	18327	34325	53.39%	16.12%	31	34
15	雲林縣西螺鎮	2018-11-25T01:07:36+08:00	6128	12384	18512	1819	20331	38142	53.3%	16.07%	34	34
15	雲林縣東勢鄉	2018-11-25T00:05:14+08:00	1761	4200	5961	625	6586	13239	49.75%	13.3%	15	15
15	雲林縣東勢鄉	2018-11-25T00:09:45+08:00	1761	4200	5961	625	6586	13239	49.75%	13.3%	15	15
15	雲林縣東勢鄉	2018-11-25T01:12:55+08:00	1761	4200	5961	625	6586	13239	49.75%	13.3%	15	15
15	雲林縣東勢鄉	2018-11-25T06:29:27+08:00	1761	4200	5961	625	6586	13239	49.75%	13.3%	15	15
15	雲林縣東勢鄉	2018-11-24T23:05:13+08:00	1761	4200	5961	625	6586	13239	49.75%	13.3%	15	15
15	雲林縣東勢鄉	2018-11-25T06:19:07+08:00	1761	4200	5961	625	6586	13239	49.75%	13.3%	15	15
15	雲林縣東勢鄉	2018-11-24T22:26:45+08:00	1394	3269	4663	536	5199	10684	48.66%	13.05%	13	15
15	雲林縣東勢鄉	2018-11-24T22:54:34+08:00	1761	4200	5961	625	6586	13239	49.75%	13.3%	15	15
15	雲林縣東勢鄉	2018-11-24T22:41:47+08:00	1524	3608	5132	580	5712	11706	48.8%	13.02%	14	15
15	雲林縣東勢鄉	2018-11-24T23:43:26+08:00	1761	4200	5961	625	6586	13239	49.75%	13.3%	15	15
15	雲林縣東勢鄉	2018-11-24T22:50:59+08:00	1524	3608	5132	580	5712	11706	48.8%	13.02%	14	15
15	雲林縣東勢鄉	2018-11-25T00:00:20+08:00	1761	4200	5961	625	6586	13239	49.75%	13.3%	15	15
15	雲林縣東勢鄉	2018-11-25T00:23:13+08:00	1761	4200	5961	625	6586	13239	49.75%	13.3%	15	15
15	雲林縣東勢鄉	2018-11-25T03:32:48+08:00	1761	4200	5961	625	6586	13239	49.75%	13.3%	15	15
15	雲林縣東勢鄉	2018-11-25T03:44:36+08:00	1761	4200	5961	625	6586	13239	49.75%	13.3%	15	15
15	雲林縣東勢鄉	2018-11-24T23:08:47+08:00	1761	4200	5961	625	6586	13239	49.75%	13.3%	15	15
15	雲林縣東勢鄉	2018-11-24T22:23:24+08:00	1394	3269	4663	536	5199	10684	48.66%	13.05%	13	15
15	雲林縣東勢鄉	2018-11-25T06:24:10+08:00	1761	4200	5961	625	6586	13239	49.75%	13.3%	15	15
15	雲林縣東勢鄉	2018-11-25T01:02:40+08:00	1761	4200	5961	625	6586	13239	49.75%	13.3%	15	15
15	雲林縣東勢鄉	2018-11-24T23:23:47+08:00	1761	4200	5961	625	6586	13239	49.75%	13.3%	15	15
15	雲林縣東勢鄉	2018-11-25T03:50:00+08:00	1761	4200	5961	625	6586	13239	49.75%	13.3%	15	15
15	雲林縣東勢鄉	2018-11-24T22:33:47+08:00	1524	3608	5132	580	5712	11706	48.8%	13.02%	14	15
15	雲林縣東勢鄉	2018-11-25T01:26:03+08:00	1761	4200	5961	625	6586	13239	49.75%	13.3%	15	15
15	雲林縣東勢鄉	2018-11-25T03:39:04+08:00	1761	4200	5961	625	6586	13239	49.75%	13.3%	15	15
15	雲林縣東勢鄉	2018-11-25T00:14:19+08:00	1761	4200	5961	625	6586	13239	49.75%	13.3%	15	15
15	雲林縣東勢鄉	2018-11-24T23:16:12+08:00	1761	4200	5961	625	6586	13239	49.75%	13.3%	15	15
15	雲林縣東勢鄉	2018-11-24T23:35:19+08:00	1761	4200	5961	625	6586	13239	49.75%	13.3%	15	15
15	雲林縣東勢鄉	2018-11-24T22:45:17+08:00	1524	3608	5132	580	5712	11706	48.8%	13.02%	14	15
15	雲林縣東勢鄉	2018-11-25T01:18:05+08:00	1761	4200	5961	625	6586	13239	49.75%	13.3%	15	15
15	雲林縣東勢鄉	2018-11-25T03:56:24+08:00	1761	4200	5961	625	6586	13239	49.75%	13.3%	15	15
15	雲林縣東勢鄉	2018-11-24T22:58:04+08:00	1761	4200	5961	625	6586	13239	49.75%	13.3%	15	15
15	雲林縣東勢鄉	2018-11-24T23:01:42+08:00	1761	4200	5961	625	6586	13239	49.75%	13.3%	15	15
15	雲林縣東勢鄉	2018-11-25T00:57:47+08:00	1761	4200	5961	625	6586	13239	49.75%	13.3%	15	15
15	雲林縣東勢鄉	2018-11-24T22:19:46+08:00	1394	3269	4663	536	5199	10684	48.66%	13.05%	13	15
15	雲林縣東勢鄉	2018-11-24T22:13:41+08:00	1394	3269	4663	536	5199	10684	48.66%	13.05%	13	15
15	雲林縣東勢鄉	2018-11-25T04:03:02+08:00	1761	4200	5961	625	6586	13239	49.75%	13.3%	15	15
15	雲林縣東勢鄉	2018-11-24T22:40:37+08:00	1524	3608	5132	580	5712	11706	48.8%	13.02%	14	15
15	雲林縣東勢鄉	2018-11-24T23:51:45+08:00	1761	4200	5961	625	6586	13239	49.75%	13.3%	15	15
15	雲林縣東勢鄉	2018-11-24T22:30:20+08:00	1524	3608	5132	580	5712	11706	48.8%	13.02%	14	15
15	雲林縣東勢鄉	2018-11-25T06:09:05+08:00	1761	4200	5961	625	6586	13239	49.75%	13.3%	15	15
15	雲林縣東勢鄉	2018-11-24T23:55:57+08:00	1761	4200	5961	625	6586	13239	49.75%	13.3%	15	15
15	雲林縣東勢鄉	2018-11-24T23:27:27+08:00	1761	4200	5961	625	6586	13239	49.75%	13.3%	15	15
15	雲林縣東勢鄉	2018-11-25T06:14:02+08:00	1761	4200	5961	625	6586	13239	49.75%	13.3%	15	15
15	雲林縣東勢鄉	2018-11-24T23:47:39+08:00	1761	4200	5961	625	6586	13239	49.75%	13.3%	15	15
15	雲林縣東勢鄉	2018-11-25T00:18:43+08:00	1761	4200	5961	625	6586	13239	49.75%	13.3%	15	15
15	雲林縣東勢鄉	2018-11-24T22:16:21+08:00	1394	3269	4663	536	5199	10684	48.66%	13.05%	13	15
15	雲林縣東勢鄉	2018-11-24T23:12:27+08:00	1761	4200	5961	625	6586	13239	49.75%	13.3%	15	15
15	雲林縣東勢鄉	2018-11-24T23:39:28+08:00	1761	4200	5961	625	6586	13239	49.75%	13.3%	15	15
15	雲林縣東勢鄉	2018-11-24T22:37:10+08:00	1524	3608	5132	580	5712	11706	48.8%	13.02%	14	15
15	雲林縣東勢鄉	2018-11-24T23:31:23+08:00	1761	4200	5961	625	6586	13239	49.75%	13.3%	15	15
15	雲林縣東勢鄉	2018-11-24T23:20:02+08:00	1761	4200	5961	625	6586	13239	49.75%	13.3%	15	15
15	雲林縣東勢鄉	2018-11-25T01:07:36+08:00	1761	4200	5961	625	6586	13239	49.75%	13.3%	15	15
15	基隆市	2018-11-24T23:12:31+08:00	43058	80982	124040	6977	131017	252417	51.9%	17.06%	217	257
15	基隆市	2018-11-24T23:47:44+08:00	48547	90868	139415	7676	147091	284461	51.71%	17.07%	237	257
15	基隆市	2018-11-24T22:58:09+08:00	40773	76450	117223	6635	123858	238445	51.94%	17.1%	207	257
15	基隆市	2018-11-24T23:56:01+08:00	49323	92373	141696	7816	149512	288796	51.77%	17.08%	240	257
15	基隆市	2018-11-25T03:56:29+08:00	54369	102268	156637	8427	165064	320030	51.58%	16.99%	257	257
15	基隆市	2018-11-24T23:01:46+08:00	40962	76874	117836	6687	124523	239578	51.98%	17.1%	208	257
15	基隆市	2018-11-25T03:32:53+08:00	54369	102268	156637	8427	165064	320030	51.58%	16.99%	257	257
15	基隆市	2018-11-24T23:08:52+08:00	42544	79898	122442	6882	129324	249414	51.85%	17.06%	215	257
15	基隆市	2018-11-24T23:51:49+08:00	49323	92373	141696	7816	149512	288796	51.77%	17.08%	240	257
15	基隆市	2018-11-24T22:13:45+08:00	29832	56526	86358	5046	91404	175846	51.98%	16.96%	162	257
15	基隆市	2018-11-25T03:44:41+08:00	54369	102268	156637	8427	165064	320030	51.58%	16.99%	257	257
15	基隆市	2018-11-25T04:03:06+08:00	54369	102268	156637	8427	165064	320030	51.58%	16.99%	257	257
15	基隆市	2018-11-24T23:27:31+08:00	46785	87320	134105	7394	141499	272977	51.84%	17.14%	230	257
15	基隆市	2018-11-24T22:30:24+08:00	34210	64927	99137	5802	104939	202374	51.85%	16.9%	182	257
15	基隆市	2018-11-24T22:19:50+08:00	32176	60999	93175	5447	98622	190034	51.9%	16.93%	172	257
15	基隆市	2018-11-25T06:14:06+08:00	54369	102268	156637	8427	165064	320030	51.58%	16.99%	257	257
15	基隆市	2018-11-24T23:20:09+08:00	44438	83579	128017	7094	135111	260174	51.93%	17.08%	222	257
15	基隆市	2018-11-24T23:31:28+08:00	46785	87320	134105	7394	141499	272977	51.84%	17.14%	230	257
15	基隆市	2018-11-24T22:37:14+08:00	35281	66878	102159	5921	108080	208490	51.84%	16.92%	186	257
15	基隆市	2018-11-25T00:18:48+08:00	52216	98160	150376	8140	158516	307000	51.63%	17.01%	250	257
15	基隆市	2018-11-25T06:29:32+08:00	54369	102268	156637	8427	165064	320030	51.58%	16.99%	257	257
15	基隆市	2018-11-25T00:09:51+08:00	50736	95268	146004	7950	153954	297873	51.68%	17.03%	245	257
15	基隆市	2018-11-24T22:45:21+08:00	36749	69392	106141	6108	112249	215968	51.97%	17.02%	192	257
15	基隆市	2018-11-24T22:54:38+08:00	40265	75422	115687	6574	122261	234943	52.04%	17.14%	205	257
15	基隆市	2018-11-24T22:33:51+08:00	34975	66304	101279	5866	107145	206887	51.79%	16.91%	185	257
15	基隆市	2018-11-24T23:39:33+08:00	47941	89661	137602	7602	145204	280813	51.71%	17.07%	235	257
15	基隆市	2018-11-24T22:26:49+08:00	33764	64134	97898	5754	103652	199976	51.83%	16.88%	180	257
15	基隆市	2018-11-25T01:12:59+08:00	54126	101819	155945	8396	164341	318630	51.58%	16.99%	256	257
15	基隆市	2018-11-25T00:05:18+08:00	49917	93616	143533	7874	151407	293188	51.64%	17.03%	242	257
15	基隆市	2018-11-25T01:07:41+08:00	54126	101819	155945	8396	164341	318630	51.58%	16.99%	256	257
15	基隆市	2018-11-24T23:05:17+08:00	41643	78121	119764	6780	126544	243483	51.97%	17.1%	211	257
15	基隆市	2018-11-24T23:23:51+08:00	44910	84502	129412	7181	136593	263246	51.89%	17.06%	224	257
15	基隆市	2018-11-24T22:23:29+08:00	33110	62880	95990	5617	101607	196094	51.82%	16.88%	177	257
15	基隆市	2018-11-25T00:00:24+08:00	49585	92905	142490	7856	150346	290365	51.78%	17.08%	241	257
15	基隆市	2018-11-25T01:02:45+08:00	54126	101819	155945	8396	164341	318630	51.58%	16.99%	256	257
15	基隆市	2018-11-24T22:40:41+08:00	35670	67613	103283	5985	109268	210625	51.88%	16.94%	188	257
15	基隆市	2018-11-25T00:57:52+08:00	54126	101819	155945	8396	164341	318630	51.58%	16.99%	256	257
15	基隆市	2018-11-24T22:51:04+08:00	38679	72859	111538	6337	117875	226306	52.09%	17.09%	199	257
15	基隆市	2018-11-25T06:09:10+08:00	54369	102268	156637	8427	165064	320030	51.58%	16.99%	257	257
15	基隆市	2018-11-25T06:24:14+08:00	54369	102268	156637	8427	165064	320030	51.58%	16.99%	257	257
15	基隆市	2018-11-25T00:23:18+08:00	52577	98801	151378	8176	159554	309040	51.63%	17.01%	251	257
15	基隆市	2018-11-24T23:35:23+08:00	47083	87927	135010	7437	142447	274939	51.81%	17.12%	231	257
15	基隆市	2018-11-25T00:14:24+08:00	50736	95268	146004	7950	153954	297873	51.68%	17.03%	245	257
15	基隆市	2018-11-25T03:50:04+08:00	54369	102268	156637	8427	165064	320030	51.58%	16.99%	257	257
15	基隆市	2018-11-24T22:16:26+08:00	31646	60013	91659	5352	97011	187053	51.86%	16.92%	170	257
15	基隆市	2018-11-24T23:43:31+08:00	48198	90180	138378	7614	145992	282344	51.71%	17.07%	236	257
15	基隆市	2018-11-25T01:18:11+08:00	54369	102268	156637	8427	165064	320030	51.58%	16.99%	257	257
15	基隆市	2018-11-24T23:16:16+08:00	44145	83068	127213	7068	134281	258604	51.93%	17.07%	221	257
15	基隆市	2018-11-25T06:19:11+08:00	54369	102268	156637	8427	165064	320030	51.58%	16.99%	257	257
15	基隆市	2018-11-24T22:41:51+08:00	35670	67613	103283	5985	109268	210625	51.88%	16.94%	188	257
15	基隆市	2018-11-25T03:39:08+08:00	54369	102268	156637	8427	165064	320030	51.58%	16.99%	257	257
15	基隆市	2018-11-25T01:26:08+08:00	54369	102268	156637	8427	165064	320030	51.58%	16.99%	257	257
15	新竹縣新埔鎮	2018-11-24T22:26:43+08:00	3558	8383	11941	682	12623	22350	56.48%	15.92%	24	30
15	新竹縣新埔鎮	2018-11-25T00:09:42+08:00	4611	10817	15428	889	16317	28894	56.47%	15.96%	30	30
15	新竹縣新埔鎮	2018-11-25T03:56:21+08:00	4611	10817	15428	889	16317	28894	56.47%	15.96%	30	30
15	新竹縣新埔鎮	2018-11-25T01:12:52+08:00	4611	10817	15428	889	16317	28894	56.47%	15.96%	30	30
15	新竹縣新埔鎮	2018-11-24T22:37:07+08:00	3761	8860	12621	719	13340	23779	56.1%	15.82%	25	30
15	新竹縣新埔鎮	2018-11-24T22:54:32+08:00	4453	10422	14875	847	15722	27877	56.4%	15.97%	29	30
15	新竹縣新埔鎮	2018-11-24T22:50:56+08:00	4302	10048	14350	821	15171	27039	56.11%	15.91%	28	30
15	新竹縣新埔鎮	2018-11-25T00:05:12+08:00	4611	10817	15428	889	16317	28894	56.47%	15.96%	30	30
15	新竹縣新埔鎮	2018-11-24T22:45:15+08:00	4117	9643	13760	790	14550	25879	56.22%	15.91%	27	30
15	新竹縣新埔鎮	2018-11-25T01:02:38+08:00	4611	10817	15428	889	16317	28894	56.47%	15.96%	30	30
15	新竹縣新埔鎮	2018-11-25T00:57:44+08:00	4611	10817	15428	889	16317	28894	56.47%	15.96%	30	30
15	新竹縣新埔鎮	2018-11-24T22:40:34+08:00	3973	9307	13280	759	14039	24901	56.38%	15.96%	26	30
15	新竹縣新埔鎮	2018-11-24T22:19:44+08:00	3326	7921	11247	635	11882	21069	56.4%	15.79%	23	30
15	新竹縣新埔鎮	2018-11-25T00:00:18+08:00	4611	10817	15428	889	16317	28894	56.47%	15.96%	30	30
15	新竹縣新埔鎮	2018-11-24T23:55:54+08:00	4611	10817	15428	889	16317	28894	56.47%	15.96%	30	30
15	新竹縣新埔鎮	2018-11-24T23:27:25+08:00	4611	10817	15428	889	16317	28894	56.47%	15.96%	30	30
15	新竹縣新埔鎮	2018-11-24T23:19:59+08:00	4611	10817	15428	889	16317	28894	56.47%	15.96%	30	30
15	新竹縣新埔鎮	2018-11-24T22:23:22+08:00	3558	8383	11941	682	12623	22350	56.48%	15.92%	24	30
15	新竹縣新埔鎮	2018-11-24T23:01:39+08:00	4453	10422	14875	847	15722	27877	56.4%	15.97%	29	30
15	新竹縣新埔鎮	2018-11-25T01:07:33+08:00	4611	10817	15428	889	16317	28894	56.47%	15.96%	30	30
15	新竹縣新埔鎮	2018-11-24T23:39:25+08:00	4611	10817	15428	889	16317	28894	56.47%	15.96%	30	30
15	新竹縣新埔鎮	2018-11-24T23:12:24+08:00	4453	10422	14875	847	15722	27877	56.4%	15.97%	29	30
15	新竹縣新埔鎮	2018-11-25T00:18:40+08:00	4611	10817	15428	889	16317	28894	56.47%	15.96%	30	30
15	新竹縣新埔鎮	2018-11-24T23:31:20+08:00	4611	10817	15428	889	16317	28894	56.47%	15.96%	30	30
15	新竹縣新埔鎮	2018-11-24T23:35:17+08:00	4611	10817	15428	889	16317	28894	56.47%	15.96%	30	30
15	新竹縣新埔鎮	2018-11-25T04:02:59+08:00	4611	10817	15428	889	16317	28894	56.47%	15.96%	30	30
15	新竹縣新埔鎮	2018-11-25T00:14:17+08:00	4611	10817	15428	889	16317	28894	56.47%	15.96%	30	30
15	新竹縣新埔鎮	2018-11-24T23:43:24+08:00	4611	10817	15428	889	16317	28894	56.47%	15.96%	30	30
15	新竹縣新埔鎮	2018-11-24T22:58:02+08:00	4453	10422	14875	847	15722	27877	56.4%	15.97%	29	30
15	新竹縣新埔鎮	2018-11-25T03:49:58+08:00	4611	10817	15428	889	16317	28894	56.47%	15.96%	30	30
15	新竹縣新埔鎮	2018-11-25T01:18:02+08:00	4611	10817	15428	889	16317	28894	56.47%	15.96%	30	30
15	新竹縣新埔鎮	2018-11-25T06:29:25+08:00	4611	10817	15428	889	16317	28894	56.47%	15.96%	30	30
15	新竹縣新埔鎮	2018-11-24T23:05:11+08:00	4453	10422	14875	847	15722	27877	56.4%	15.97%	29	30
15	新竹縣新埔鎮	2018-11-25T06:13:59+08:00	4611	10817	15428	889	16317	28894	56.47%	15.96%	30	30
15	新竹縣新埔鎮	2018-11-24T22:41:44+08:00	3973	9307	13280	759	14039	24901	56.38%	15.96%	26	30
15	新竹縣新埔鎮	2018-11-25T06:19:04+08:00	4611	10817	15428	889	16317	28894	56.47%	15.96%	30	30
15	新竹縣新埔鎮	2018-11-25T06:24:07+08:00	4611	10817	15428	889	16317	28894	56.47%	15.96%	30	30
15	新竹縣新埔鎮	2018-11-24T22:30:17+08:00	3558	8383	11941	682	12623	22350	56.48%	15.92%	24	30
15	新竹縣新埔鎮	2018-11-24T23:51:42+08:00	4611	10817	15428	889	16317	28894	56.47%	15.96%	30	30
15	新竹縣新埔鎮	2018-11-25T06:09:02+08:00	4611	10817	15428	889	16317	28894	56.47%	15.96%	30	30
15	新竹縣新埔鎮	2018-11-24T23:23:45+08:00	4611	10817	15428	889	16317	28894	56.47%	15.96%	30	30
15	新竹縣新埔鎮	2018-11-25T03:44:32+08:00	4611	10817	15428	889	16317	28894	56.47%	15.96%	30	30
15	新竹縣新埔鎮	2018-11-25T03:32:45+08:00	4611	10817	15428	889	16317	28894	56.47%	15.96%	30	30
15	新竹縣新埔鎮	2018-11-24T23:08:44+08:00	4453	10422	14875	847	15722	27877	56.4%	15.97%	29	30
15	新竹縣新埔鎮	2018-11-24T22:13:37+08:00	2951	7099	10050	576	10626	18787	56.56%	15.71%	21	30
15	新竹縣新埔鎮	2018-11-25T00:23:11+08:00	4611	10817	15428	889	16317	28894	56.47%	15.96%	30	30
15	新竹縣新埔鎮	2018-11-24T23:16:10+08:00	4453	10422	14875	847	15722	27877	56.4%	15.97%	29	30
15	新竹縣新埔鎮	2018-11-24T23:47:37+08:00	4611	10817	15428	889	16317	28894	56.47%	15.96%	30	30
15	新竹縣新埔鎮	2018-11-24T22:16:19+08:00	3149	7511	10660	616	11276	19999	56.38%	15.75%	22	30
15	新竹縣新埔鎮	2018-11-25T01:26:00+08:00	4611	10817	15428	889	16317	28894	56.47%	15.96%	30	30
15	新竹縣新埔鎮	2018-11-25T03:39:01+08:00	4611	10817	15428	889	16317	28894	56.47%	15.96%	30	30
15	新竹縣新埔鎮	2018-11-24T22:33:45+08:00	3558	8383	11941	682	12623	22350	56.48%	15.92%	24	30
15	新竹縣五峰鄉	2018-11-24T22:26:43+08:00	122	486	608	30	638	1266	50.39%	9.64%	2	6
15	新竹縣五峰鄉	2018-11-25T03:56:21+08:00	387	1487	1874	94	1968	3997	49.24%	9.68%	6	6
15	新竹縣五峰鄉	2018-11-25T01:12:52+08:00	387	1487	1874	94	1968	3997	49.24%	9.68%	6	6
15	新竹縣五峰鄉	2018-11-24T22:54:32+08:00	227	914	1141	44	1185	2388	49.62%	9.51%	4	6
15	新竹縣五峰鄉	2018-11-24T22:50:56+08:00	153	620	773	39	812	1661	48.89%	9.21%	3	6
15	新竹縣五峰鄉	2018-11-25T00:09:43+08:00	317	1251	1568	80	1648	3284	50.18%	9.65%	5	6
15	新竹縣五峰鄉	2018-11-25T00:05:12+08:00	317	1251	1568	80	1648	3284	50.18%	9.65%	5	6
15	新竹縣五峰鄉	2018-11-24T22:37:08+08:00	122	486	608	30	638	1266	50.39%	9.64%	2	6
15	新竹縣五峰鄉	2018-11-24T22:45:15+08:00	153	620	773	39	812	1661	48.89%	9.21%	3	6
15	新竹縣五峰鄉	2018-11-25T01:02:38+08:00	387	1487	1874	94	1968	3997	49.24%	9.68%	6	6
15	新竹縣五峰鄉	2018-11-24T22:40:35+08:00	122	486	608	30	638	1266	50.39%	9.64%	2	6
15	新竹縣五峰鄉	2018-11-25T04:03:00+08:00	387	1487	1874	94	1968	3997	49.24%	9.68%	6	6
15	新竹縣五峰鄉	2018-11-25T00:57:45+08:00	387	1487	1874	94	1968	3997	49.24%	9.68%	6	6
15	新竹縣五峰鄉	2018-11-24T22:19:44+08:00	122	486	608	30	638	1266	50.39%	9.64%	2	6
15	新竹縣五峰鄉	2018-11-25T06:14:00+08:00	387	1487	1874	94	1968	3997	49.24%	9.68%	6	6
15	新竹縣五峰鄉	2018-11-25T00:00:18+08:00	317	1251	1568	80	1648	3284	50.18%	9.65%	5	6
15	新竹縣五峰鄉	2018-11-24T23:55:54+08:00	317	1251	1568	80	1648	3284	50.18%	9.65%	5	6
15	新竹縣五峰鄉	2018-11-24T23:27:25+08:00	227	914	1141	44	1185	2388	49.62%	9.51%	4	6
15	新竹縣五峰鄉	2018-11-24T22:23:22+08:00	122	486	608	30	638	1266	50.39%	9.64%	2	6
15	新竹縣五峰鄉	2018-11-24T23:01:39+08:00	227	914	1141	44	1185	2388	49.62%	9.51%	4	6
15	新竹縣五峰鄉	2018-11-24T23:39:25+08:00	227	914	1141	44	1185	2388	49.62%	9.51%	4	6
15	新竹縣五峰鄉	2018-11-24T23:20:00+08:00	227	914	1141	44	1185	2388	49.62%	9.51%	4	6
15	新竹縣五峰鄉	2018-11-25T01:07:34+08:00	387	1487	1874	94	1968	3997	49.24%	9.68%	6	6
15	新竹縣五峰鄉	2018-11-24T23:12:24+08:00	227	914	1141	44	1185	2388	49.62%	9.51%	4	6
15	新竹縣五峰鄉	2018-11-25T00:18:40+08:00	317	1251	1568	80	1648	3284	50.18%	9.65%	5	6
15	新竹縣五峰鄉	2018-11-25T03:39:02+08:00	387	1487	1874	94	1968	3997	49.24%	9.68%	6	6
15	新竹縣五峰鄉	2018-11-24T23:31:20+08:00	227	914	1141	44	1185	2388	49.62%	9.51%	4	6
15	新竹縣五峰鄉	2018-11-24T23:35:17+08:00	227	914	1141	44	1185	2388	49.62%	9.51%	4	6
15	新竹縣五峰鄉	2018-11-25T00:14:17+08:00	317	1251	1568	80	1648	3284	50.18%	9.65%	5	6
15	新竹縣五峰鄉	2018-11-24T23:43:24+08:00	227	914	1141	44	1185	2388	49.62%	9.51%	4	6
15	新竹縣五峰鄉	2018-11-24T22:58:02+08:00	227	914	1141	44	1185	2388	49.62%	9.51%	4	6
15	新竹縣五峰鄉	2018-11-25T03:49:58+08:00	387	1487	1874	94	1968	3997	49.24%	9.68%	6	6
15	新竹縣五峰鄉	2018-11-25T01:18:02+08:00	387	1487	1874	94	1968	3997	49.24%	9.68%	6	6
15	新竹縣五峰鄉	2018-11-25T06:29:25+08:00	387	1487	1874	94	1968	3997	49.24%	9.68%	6	6
15	新竹縣五峰鄉	2018-11-25T06:19:05+08:00	387	1487	1874	94	1968	3997	49.24%	9.68%	6	6
15	新竹縣五峰鄉	2018-11-24T23:05:11+08:00	227	914	1141	44	1185	2388	49.62%	9.51%	4	6
15	新竹縣五峰鄉	2018-11-24T22:41:44+08:00	122	486	608	30	638	1266	50.39%	9.64%	2	6
15	新竹縣五峰鄉	2018-11-24T23:51:43+08:00	317	1251	1568	80	1648	3284	50.18%	9.65%	5	6
15	新竹縣五峰鄉	2018-11-24T22:30:17+08:00	122	486	608	30	638	1266	50.39%	9.64%	2	6
15	新竹縣五峰鄉	2018-11-25T06:24:08+08:00	387	1487	1874	94	1968	3997	49.24%	9.68%	6	6
15	新竹縣五峰鄉	2018-11-25T06:09:02+08:00	387	1487	1874	94	1968	3997	49.24%	9.68%	6	6
15	新竹縣五峰鄉	2018-11-24T23:23:45+08:00	227	914	1141	44	1185	2388	49.62%	9.51%	4	6
15	新竹縣五峰鄉	2018-11-25T03:44:32+08:00	387	1487	1874	94	1968	3997	49.24%	9.68%	6	6
15	新竹縣五峰鄉	2018-11-25T03:32:45+08:00	387	1487	1874	94	1968	3997	49.24%	9.68%	6	6
15	新竹縣五峰鄉	2018-11-24T22:13:38+08:00	70	300	370	27	397	672	59.08%	10.42%	1	6
15	新竹縣五峰鄉	2018-11-24T23:08:45+08:00	227	914	1141	44	1185	2388	49.62%	9.51%	4	6
15	新竹縣五峰鄉	2018-11-25T00:23:11+08:00	317	1251	1568	80	1648	3284	50.18%	9.65%	5	6
15	新竹縣五峰鄉	2018-11-24T23:16:10+08:00	227	914	1141	44	1185	2388	49.62%	9.51%	4	6
15	新竹縣五峰鄉	2018-11-24T23:47:37+08:00	227	914	1141	44	1185	2388	49.62%	9.51%	4	6
15	新竹縣五峰鄉	2018-11-24T22:16:19+08:00	122	486	608	30	638	1266	50.39%	9.64%	2	6
15	新竹縣五峰鄉	2018-11-25T01:26:01+08:00	387	1487	1874	94	1968	3997	49.24%	9.68%	6	6
15	新竹縣五峰鄉	2018-11-24T22:33:45+08:00	122	486	608	30	638	1266	50.39%	9.64%	2	6
15	連江縣北竿鄉	2018-11-24T23:12:31+08:00	0	0	0	0	0	0	0%	0%	0	2
15	連江縣北竿鄉	2018-11-24T23:47:44+08:00	266	811	1077	33	1110	2125	52.24%	12.52%	2	2
15	連江縣北竿鄉	2018-11-24T22:58:09+08:00	0	0	0	0	0	0	0%	0%	0	2
15	連江縣北竿鄉	2018-11-24T23:56:01+08:00	266	811	1077	33	1110	2125	52.24%	12.52%	2	2
15	連江縣北竿鄉	2018-11-25T03:56:29+08:00	266	811	1077	33	1110	2125	52.24%	12.52%	2	2
15	連江縣北竿鄉	2018-11-24T23:01:46+08:00	0	0	0	0	0	0	0%	0%	0	2
15	連江縣北竿鄉	2018-11-25T03:32:53+08:00	266	811	1077	33	1110	2125	52.24%	12.52%	2	2
15	連江縣北竿鄉	2018-11-24T23:08:52+08:00	0	0	0	0	0	0	0%	0%	0	2
15	連江縣北竿鄉	2018-11-24T23:51:49+08:00	266	811	1077	33	1110	2125	52.24%	12.52%	2	2
15	連江縣北竿鄉	2018-11-24T22:13:45+08:00	0	0	0	0	0	0	0%	0%	0	2
15	連江縣北竿鄉	2018-11-25T03:44:41+08:00	266	811	1077	33	1110	2125	52.24%	12.52%	2	2
15	連江縣北竿鄉	2018-11-25T04:03:06+08:00	266	811	1077	33	1110	2125	52.24%	12.52%	2	2
15	連江縣北竿鄉	2018-11-24T23:27:31+08:00	266	811	1077	33	1110	2125	52.24%	12.52%	2	2
15	連江縣北竿鄉	2018-11-24T22:30:24+08:00	0	0	0	0	0	0	0%	0%	0	2
15	連江縣北竿鄉	2018-11-24T22:19:50+08:00	0	0	0	0	0	0	0%	0%	0	2
15	連江縣北竿鄉	2018-11-25T06:14:06+08:00	266	811	1077	33	1110	2125	52.24%	12.52%	2	2
15	連江縣北竿鄉	2018-11-24T23:20:09+08:00	189	599	788	26	814	1515	53.73%	12.48%	1	2
15	連江縣北竿鄉	2018-11-24T23:31:28+08:00	266	811	1077	33	1110	2125	52.24%	12.52%	2	2
15	連江縣北竿鄉	2018-11-24T22:37:14+08:00	0	0	0	0	0	0	0%	0%	0	2
15	連江縣北竿鄉	2018-11-25T00:18:48+08:00	266	811	1077	33	1110	2125	52.24%	12.52%	2	2
15	連江縣北竿鄉	2018-11-25T06:29:32+08:00	266	811	1077	33	1110	2125	52.24%	12.52%	2	2
15	連江縣北竿鄉	2018-11-25T00:09:51+08:00	266	811	1077	33	1110	2125	52.24%	12.52%	2	2
15	連江縣北竿鄉	2018-11-24T22:45:21+08:00	0	0	0	0	0	0	0%	0%	0	2
15	連江縣北竿鄉	2018-11-24T22:54:38+08:00	0	0	0	0	0	0	0%	0%	0	2
15	連江縣北竿鄉	2018-11-24T22:33:51+08:00	0	0	0	0	0	0	0%	0%	0	2
15	連江縣北竿鄉	2018-11-24T23:39:33+08:00	266	811	1077	33	1110	2125	52.24%	12.52%	2	2
15	連江縣北竿鄉	2018-11-24T22:26:49+08:00	0	0	0	0	0	0	0%	0%	0	2
15	連江縣北竿鄉	2018-11-25T01:07:40+08:00	266	811	1077	33	1110	2125	52.24%	12.52%	2	2
15	連江縣北竿鄉	2018-11-25T01:12:59+08:00	266	811	1077	33	1110	2125	52.24%	12.52%	2	2
15	連江縣北竿鄉	2018-11-25T00:05:18+08:00	266	811	1077	33	1110	2125	52.24%	12.52%	2	2
15	連江縣北竿鄉	2018-11-24T23:05:17+08:00	0	0	0	0	0	0	0%	0%	0	2
15	連江縣北竿鄉	2018-11-24T23:23:51+08:00	266	811	1077	33	1110	2125	52.24%	12.52%	2	2
15	連江縣北竿鄉	2018-11-24T22:23:29+08:00	0	0	0	0	0	0	0%	0%	0	2
15	連江縣北竿鄉	2018-11-25T00:00:24+08:00	266	811	1077	33	1110	2125	52.24%	12.52%	2	2
15	連江縣北竿鄉	2018-11-25T01:02:45+08:00	266	811	1077	33	1110	2125	52.24%	12.52%	2	2
15	連江縣北竿鄉	2018-11-24T22:40:41+08:00	0	0	0	0	0	0	0%	0%	0	2
15	連江縣北竿鄉	2018-11-25T00:57:52+08:00	266	811	1077	33	1110	2125	52.24%	12.52%	2	2
15	連江縣北竿鄉	2018-11-24T22:51:04+08:00	0	0	0	0	0	0	0%	0%	0	2
15	連江縣北竿鄉	2018-11-25T06:09:10+08:00	266	811	1077	33	1110	2125	52.24%	12.52%	2	2
15	連江縣北竿鄉	2018-11-25T06:24:14+08:00	266	811	1077	33	1110	2125	52.24%	12.52%	2	2
15	連江縣北竿鄉	2018-11-25T00:23:18+08:00	266	811	1077	33	1110	2125	52.24%	12.52%	2	2
15	連江縣北竿鄉	2018-11-24T23:35:23+08:00	266	811	1077	33	1110	2125	52.24%	12.52%	2	2
15	連江縣北竿鄉	2018-11-25T00:14:24+08:00	266	811	1077	33	1110	2125	52.24%	12.52%	2	2
15	連江縣北竿鄉	2018-11-25T03:50:04+08:00	266	811	1077	33	1110	2125	52.24%	12.52%	2	2
15	連江縣北竿鄉	2018-11-24T22:16:26+08:00	0	0	0	0	0	0	0%	0%	0	2
15	連江縣北竿鄉	2018-11-24T23:43:31+08:00	266	811	1077	33	1110	2125	52.24%	12.52%	2	2
15	連江縣北竿鄉	2018-11-25T01:18:11+08:00	266	811	1077	33	1110	2125	52.24%	12.52%	2	2
15	連江縣北竿鄉	2018-11-24T23:16:16+08:00	189	599	788	26	814	1515	53.73%	12.48%	1	2
15	連江縣北竿鄉	2018-11-25T06:19:11+08:00	266	811	1077	33	1110	2125	52.24%	12.52%	2	2
15	連江縣北竿鄉	2018-11-24T22:41:51+08:00	0	0	0	0	0	0	0%	0%	0	2
15	連江縣北竿鄉	2018-11-25T03:39:08+08:00	266	811	1077	33	1110	2125	52.24%	12.52%	2	2
15	連江縣北竿鄉	2018-11-25T01:26:08+08:00	266	811	1077	33	1110	2125	52.24%	12.52%	2	2
15	高雄市梓官區	2018-11-25T01:18:01+08:00	4999	11063	16062	1266	17328	29293	59.15%	17.07%	27	28
15	高雄市梓官區	2018-11-24T22:58:01+08:00	4544	10029	14573	1193	15766	26438	59.63%	17.19%	25	28
15	高雄市梓官區	2018-11-24T22:26:43+08:00	4544	10029	14573	1193	15766	26438	59.63%	17.19%	25	28
15	高雄市梓官區	2018-11-25T00:09:42+08:00	4999	11063	16062	1266	17328	29293	59.15%	17.07%	27	28
15	高雄市梓官區	2018-11-24T22:37:07+08:00	4544	10029	14573	1193	15766	26438	59.63%	17.19%	25	28
15	高雄市梓官區	2018-11-24T22:54:32+08:00	4544	10029	14573	1193	15766	26438	59.63%	17.19%	25	28
15	高雄市梓官區	2018-11-24T22:50:56+08:00	4544	10029	14573	1193	15766	26438	59.63%	17.19%	25	28
15	高雄市梓官區	2018-11-25T00:18:39+08:00	4999	11063	16062	1266	17328	29293	59.15%	17.07%	27	28
15	高雄市梓官區	2018-11-24T22:45:14+08:00	4544	10029	14573	1193	15766	26438	59.63%	17.19%	25	28
15	高雄市梓官區	2018-11-25T03:56:20+08:00	5238	11624	16862	1304	18166	31025	58.55%	16.88%	28	28
15	高雄市梓官區	2018-11-25T00:05:12+08:00	4739	10483	15222	1234	16456	27698	59.41%	17.11%	26	28
15	高雄市梓官區	2018-11-24T23:16:09+08:00	4739	10483	15222	1234	16456	27698	59.41%	17.11%	26	28
15	高雄市梓官區	2018-11-25T01:02:38+08:00	4999	11063	16062	1266	17328	29293	59.15%	17.07%	27	28
15	高雄市梓官區	2018-11-25T00:57:44+08:00	4999	11063	16062	1266	17328	29293	59.15%	17.07%	27	28
15	高雄市梓官區	2018-11-24T22:40:34+08:00	4544	10029	14573	1193	15766	26438	59.63%	17.19%	25	28
15	高雄市梓官區	2018-11-25T06:09:01+08:00	5238	11624	16862	1304	18166	31025	58.55%	16.88%	28	28
15	高雄市梓官區	2018-11-24T22:19:43+08:00	4544	10029	14573	1193	15766	26438	59.63%	17.19%	25	28
15	高雄市梓官區	2018-11-24T23:55:54+08:00	4739	10483	15222	1234	16456	27698	59.41%	17.11%	26	28
15	高雄市梓官區	2018-11-25T03:44:31+08:00	5238	11624	16862	1304	18166	31025	58.55%	16.88%	28	28
15	高雄市梓官區	2018-11-24T23:19:59+08:00	4739	10483	15222	1234	16456	27698	59.41%	17.11%	26	28
15	高雄市梓官區	2018-11-25T00:00:17+08:00	4739	10483	15222	1234	16456	27698	59.41%	17.11%	26	28
15	高雄市梓官區	2018-11-24T23:27:24+08:00	4739	10483	15222	1234	16456	27698	59.41%	17.11%	26	28
15	高雄市梓官區	2018-11-25T01:07:33+08:00	4999	11063	16062	1266	17328	29293	59.15%	17.07%	27	28
15	高雄市梓官區	2018-11-24T23:31:19+08:00	4739	10483	15222	1234	16456	27698	59.41%	17.11%	26	28
15	高雄市梓官區	2018-11-24T23:12:24+08:00	4544	10029	14573	1193	15766	26438	59.63%	17.19%	25	28
15	高雄市梓官區	2018-11-24T23:39:24+08:00	4739	10483	15222	1234	16456	27698	59.41%	17.11%	26	28
15	高雄市梓官區	2018-11-24T23:01:38+08:00	4544	10029	14573	1193	15766	26438	59.63%	17.19%	25	28
15	高雄市梓官區	2018-11-24T23:35:17+08:00	4739	10483	15222	1234	16456	27698	59.41%	17.11%	26	28
15	高雄市梓官區	2018-11-25T04:02:59+08:00	5238	11624	16862	1304	18166	31025	58.55%	16.88%	28	28
15	高雄市梓官區	2018-11-25T00:14:17+08:00	4999	11063	16062	1266	17328	29293	59.15%	17.07%	27	28
15	高雄市梓官區	2018-11-24T23:43:23+08:00	4739	10483	15222	1234	16456	27698	59.41%	17.11%	26	28
15	高雄市梓官區	2018-11-25T01:12:51+08:00	4999	11063	16062	1266	17328	29293	59.15%	17.07%	27	28
15	高雄市梓官區	2018-11-25T03:49:58+08:00	5238	11624	16862	1304	18166	31025	58.55%	16.88%	28	28
15	高雄市梓官區	2018-11-24T23:05:11+08:00	4544	10029	14573	1193	15766	26438	59.63%	17.19%	25	28
15	高雄市梓官區	2018-11-25T06:13:59+08:00	5238	11624	16862	1304	18166	31025	58.55%	16.88%	28	28
15	高雄市梓官區	2018-11-24T22:41:43+08:00	4544	10029	14573	1193	15766	26438	59.63%	17.19%	25	28
15	高雄市梓官區	2018-11-25T06:19:04+08:00	5238	11624	16862	1304	18166	31025	58.55%	16.88%	28	28
15	高雄市梓官區	2018-11-25T06:29:24+08:00	5238	11624	16862	1304	18166	31025	58.55%	16.88%	28	28
15	高雄市梓官區	2018-11-25T06:24:07+08:00	5238	11624	16862	1304	18166	31025	58.55%	16.88%	28	28
15	高雄市梓官區	2018-11-24T22:30:17+08:00	4544	10029	14573	1193	15766	26438	59.63%	17.19%	25	28
15	高雄市梓官區	2018-11-24T23:51:42+08:00	4739	10483	15222	1234	16456	27698	59.41%	17.11%	26	28
15	高雄市梓官區	2018-11-24T23:23:45+08:00	4739	10483	15222	1234	16456	27698	59.41%	17.11%	26	28
15	高雄市梓官區	2018-11-24T23:08:44+08:00	4544	10029	14573	1193	15766	26438	59.63%	17.19%	25	28
15	高雄市梓官區	2018-11-24T22:23:21+08:00	4544	10029	14573	1193	15766	26438	59.63%	17.19%	25	28
15	高雄市梓官區	2018-11-25T03:32:44+08:00	5238	11624	16862	1304	18166	31025	58.55%	16.88%	28	28
15	高雄市梓官區	2018-11-24T22:13:37+08:00	4544	10029	14573	1193	15766	26438	59.63%	17.19%	25	28
15	高雄市梓官區	2018-11-25T00:23:11+08:00	4999	11063	16062	1266	17328	29293	59.15%	17.07%	27	28
15	高雄市梓官區	2018-11-25T01:26:00+08:00	4999	11063	16062	1266	17328	29293	59.15%	17.07%	27	28
15	高雄市梓官區	2018-11-24T23:47:36+08:00	4739	10483	15222	1234	16456	27698	59.41%	17.11%	26	28
15	高雄市梓官區	2018-11-25T03:39:01+08:00	5238	11624	16862	1304	18166	31025	58.55%	16.88%	28	28
15	高雄市梓官區	2018-11-24T22:33:45+08:00	4544	10029	14573	1193	15766	26438	59.63%	17.19%	25	28
15	高雄市梓官區	2018-11-24T22:16:18+08:00	4544	10029	14573	1193	15766	26438	59.63%	17.19%	25	28
15	宜蘭縣	2018-11-25T03:56:26+08:00	69188	130483	199671	14890	214561	386089	55.57%	17.92%	399	399
15	宜蘭縣	2018-11-24T23:05:15+08:00	59714	112838	172552	13132	185684	333804	55.63%	17.89%	356	399
15	宜蘭縣	2018-11-25T01:18:08+08:00	69188	130483	199671	14890	214561	386089	55.57%	17.92%	399	399
15	宜蘭縣	2018-11-24T23:39:30+08:00	64357	121445	185802	13953	199755	359830	55.51%	17.89%	377	399
15	宜蘭縣	2018-11-25T06:29:29+08:00	69188	130483	199671	14890	214561	386089	55.57%	17.92%	399	399
15	宜蘭縣	2018-11-25T06:19:09+08:00	69188	130483	199671	14890	214561	386089	55.57%	17.92%	399	399
15	宜蘭縣	2018-11-24T22:58:07+08:00	58112	109656	167768	12806	180574	324921	55.57%	17.88%	348	399
15	宜蘭縣	2018-11-24T22:41:49+08:00	53791	101279	155070	11929	166999	301045	55.47%	17.87%	326	399
15	宜蘭縣	2018-11-24T23:43:28+08:00	65523	123575	189098	14183	203281	366122	55.52%	17.9%	382	399
15	宜蘭縣	2018-11-24T22:30:22+08:00	50229	94448	144677	11252	155929	281037	55.48%	17.87%	309	399
15	宜蘭縣	2018-11-24T23:51:47+08:00	66738	125823	192561	14445	207006	372664	55.55%	17.91%	388	399
15	宜蘭縣	2018-11-25T06:09:08+08:00	69188	130483	199671	14890	214561	386089	55.57%	17.92%	399	399
15	宜蘭縣	2018-11-24T22:13:43+08:00	45308	85423	130731	10355	141086	254690	55.4%	17.79%	287	399
15	宜蘭縣	2018-11-25T00:23:15+08:00	68921	130072	198993	14831	213824	384927	55.55%	17.9%	398	399
15	宜蘭縣	2018-11-25T03:44:39+08:00	69188	130483	199671	14890	214561	386089	55.57%	17.92%	399	399
15	宜蘭縣	2018-11-24T23:23:49+08:00	62337	117313	179650	13541	193191	347560	55.58%	17.94%	367	399
15	宜蘭縣	2018-11-24T22:33:49+08:00	52555	98763	151318	11705	163023	293919	55.47%	17.88%	320	399
15	宜蘭縣	2018-11-24T22:37:12+08:00	53301	100349	153650	11854	165504	298387	55.47%	17.86%	324	399
15	宜蘭縣	2018-11-24T23:16:14+08:00	61885	116484	178369	13486	191855	344985	55.61%	17.94%	365	399
15	宜蘭縣	2018-11-24T22:16:24+08:00	46109	86993	133102	10514	143616	259166	55.41%	17.79%	291	399
15	宜蘭縣	2018-11-25T00:14:21+08:00	68479	129267	197746	14738	212484	382341	55.57%	17.91%	396	399
15	宜蘭縣	2018-11-24T23:35:21+08:00	63931	120689	184620	13889	198509	357429	55.54%	17.89%	375	399
15	宜蘭縣	2018-11-24T22:45:19+08:00	54447	102482	156929	12071	169000	304664	55.47%	17.87%	330	399
15	宜蘭縣	2018-11-24T22:54:36+08:00	57250	108113	165363	12658	178021	320422	55.56%	17.87%	344	399
15	宜蘭縣	2018-11-25T00:09:48+08:00	68128	128411	196539	14650	211189	380214	55.54%	17.92%	394	399
15	宜蘭縣	2018-11-24T23:01:44+08:00	59016	111206	170222	12948	183170	329420	55.6%	17.92%	352	399
15	宜蘭縣	2018-11-24T22:26:47+08:00	49992	94053	144045	11189	155234	279749	55.49%	17.87%	308	399
15	宜蘭縣	2018-11-24T23:47:41+08:00	65696	123891	189587	14227	203814	366998	55.54%	17.9%	383	399
15	宜蘭縣	2018-11-25T01:12:57+08:00	69188	130483	199671	14890	214561	386089	55.57%	17.92%	399	399
15	宜蘭縣	2018-11-25T00:05:16+08:00	67825	127845	195670	14611	210281	378488	55.56%	17.92%	393	399
15	宜蘭縣	2018-11-25T00:57:49+08:00	69188	130483	199671	14890	214561	386089	55.57%	17.92%	399	399
15	宜蘭縣	2018-11-24T22:19:48+08:00	47387	89177	136564	10763	147327	265788	55.43%	17.83%	297	399
15	宜蘭縣	2018-11-25T03:32:50+08:00	69188	130483	199671	14890	214561	386089	55.57%	17.92%	399	399
15	宜蘭縣	2018-11-25T04:03:04+08:00	69188	130483	199671	14890	214561	386089	55.57%	17.92%	399	399
15	宜蘭縣	2018-11-24T22:40:39+08:00	53791	101279	155070	11929	166999	301045	55.47%	17.87%	326	399
15	宜蘭縣	2018-11-24T23:08:50+08:00	60155	113538	173693	13197	186890	335960	55.63%	17.91%	358	399
15	宜蘭縣	2018-11-24T22:23:27+08:00	48470	91272	139742	10966	150708	271789	55.45%	17.83%	302	399
15	宜蘭縣	2018-11-24T22:51:02+08:00	55948	105589	161537	12383	173920	313470	55.48%	17.85%	338	399
15	宜蘭縣	2018-11-25T06:14:04+08:00	69188	130483	199671	14890	214561	386089	55.57%	17.92%	399	399
15	宜蘭縣	2018-11-24T23:55:59+08:00	66738	125823	192561	14445	207006	372664	55.55%	17.91%	388	399
15	宜蘭縣	2018-11-25T06:24:12+08:00	69188	130483	199671	14890	214561	386089	55.57%	17.92%	399	399
15	宜蘭縣	2018-11-24T23:27:29+08:00	62522	117672	180194	13609	193803	348642	55.59%	17.93%	368	399
15	宜蘭縣	2018-11-25T00:00:22+08:00	66940	126190	193130	14487	207617	373824	55.54%	17.91%	389	399
15	宜蘭縣	2018-11-25T01:02:43+08:00	69188	130483	199671	14890	214561	386089	55.57%	17.92%	399	399
15	宜蘭縣	2018-11-24T23:12:29+08:00	60378	113917	174295	13243	187538	337190	55.62%	17.91%	359	399
15	宜蘭縣	2018-11-24T23:31:25+08:00	63507	119867	183374	13820	197194	354860	55.57%	17.9%	373	399
15	宜蘭縣	2018-11-24T23:20:04+08:00	62337	117313	179650	13541	193191	347560	55.58%	17.94%	367	399
15	宜蘭縣	2018-11-25T00:18:45+08:00	68712	129698	198410	14777	213187	383775	55.55%	17.9%	397	399
15	宜蘭縣	2018-11-25T01:07:38+08:00	69188	130483	199671	14890	214561	386089	55.57%	17.92%	399	399
15	宜蘭縣	2018-11-25T03:39:06+08:00	69188	130483	199671	14890	214561	386089	55.57%	17.92%	399	399
15	宜蘭縣	2018-11-25T01:26:06+08:00	69188	130483	199671	14890	214561	386089	55.57%	17.92%	399	399
15	宜蘭縣	2018-11-25T03:50:02+08:00	69188	130483	199671	14890	214561	386089	55.57%	17.92%	399	399
15	宜蘭縣三星鄉	2018-11-24T23:05:15+08:00	2895	5697	8592	751	9343	17821	52.43%	16.24%	20	21
15	宜蘭縣三星鄉	2018-11-25T01:18:08+08:00	3118	6076	9194	797	9991	19051	52.44%	16.37%	21	21
15	宜蘭縣三星鄉	2018-11-24T23:43:29+08:00	3118	6076	9194	797	9991	19051	52.44%	16.37%	21	21
15	宜蘭縣三星鄉	2018-11-25T03:56:27+08:00	3118	6076	9194	797	9991	19051	52.44%	16.37%	21	21
15	宜蘭縣三星鄉	2018-11-25T06:19:09+08:00	3118	6076	9194	797	9991	19051	52.44%	16.37%	21	21
15	宜蘭縣三星鄉	2018-11-24T22:58:07+08:00	2895	5697	8592	751	9343	17821	52.43%	16.24%	20	21
15	宜蘭縣三星鄉	2018-11-24T22:41:49+08:00	2895	5697	8592	751	9343	17821	52.43%	16.24%	20	21
15	宜蘭縣三星鄉	2018-11-24T23:39:31+08:00	3118	6076	9194	797	9991	19051	52.44%	16.37%	21	21
15	宜蘭縣三星鄉	2018-11-24T23:47:42+08:00	3118	6076	9194	797	9991	19051	52.44%	16.37%	21	21
15	宜蘭縣三星鄉	2018-11-24T22:30:22+08:00	2895	5697	8592	751	9343	17821	52.43%	16.24%	20	21
15	宜蘭縣三星鄉	2018-11-24T23:51:47+08:00	3118	6076	9194	797	9991	19051	52.44%	16.37%	21	21
15	宜蘭縣三星鄉	2018-11-25T06:09:08+08:00	3118	6076	9194	797	9991	19051	52.44%	16.37%	21	21
15	宜蘭縣三星鄉	2018-11-24T22:13:43+08:00	2638	5264	7902	704	8606	16376	52.55%	16.11%	19	21
15	宜蘭縣三星鄉	2018-11-25T00:57:50+08:00	3118	6076	9194	797	9991	19051	52.44%	16.37%	21	21
15	宜蘭縣三星鄉	2018-11-25T03:44:39+08:00	3118	6076	9194	797	9991	19051	52.44%	16.37%	21	21
15	宜蘭縣三星鄉	2018-11-24T23:31:26+08:00	3118	6076	9194	797	9991	19051	52.44%	16.37%	21	21
15	宜蘭縣三星鄉	2018-11-24T22:33:49+08:00	2895	5697	8592	751	9343	17821	52.43%	16.24%	20	21
15	宜蘭縣三星鄉	2018-11-24T22:37:13+08:00	2895	5697	8592	751	9343	17821	52.43%	16.24%	20	21
15	宜蘭縣三星鄉	2018-11-24T22:16:24+08:00	2638	5264	7902	704	8606	16376	52.55%	16.11%	19	21
15	宜蘭縣三星鄉	2018-11-25T00:18:46+08:00	3118	6076	9194	797	9991	19051	52.44%	16.37%	21	21
15	宜蘭縣三星鄉	2018-11-24T23:35:21+08:00	3118	6076	9194	797	9991	19051	52.44%	16.37%	21	21
15	宜蘭縣三星鄉	2018-11-24T23:16:15+08:00	3118	6076	9194	797	9991	19051	52.44%	16.37%	21	21
15	宜蘭縣三星鄉	2018-11-24T22:45:19+08:00	2895	5697	8592	751	9343	17821	52.43%	16.24%	20	21
15	宜蘭縣三星鄉	2018-11-24T22:54:36+08:00	2895	5697	8592	751	9343	17821	52.43%	16.24%	20	21
15	宜蘭縣三星鄉	2018-11-24T23:01:44+08:00	2895	5697	8592	751	9343	17821	52.43%	16.24%	20	21
15	宜蘭縣三星鄉	2018-11-24T22:26:47+08:00	2895	5697	8592	751	9343	17821	52.43%	16.24%	20	21
15	宜蘭縣三星鄉	2018-11-25T00:05:17+08:00	3118	6076	9194	797	9991	19051	52.44%	16.37%	21	21
15	宜蘭縣三星鄉	2018-11-25T01:12:57+08:00	3118	6076	9194	797	9991	19051	52.44%	16.37%	21	21
15	宜蘭縣三星鄉	2018-11-25T00:09:49+08:00	3118	6076	9194	797	9991	19051	52.44%	16.37%	21	21
15	宜蘭縣三星鄉	2018-11-24T23:23:50+08:00	3118	6076	9194	797	9991	19051	52.44%	16.37%	21	21
15	宜蘭縣三星鄉	2018-11-24T22:19:49+08:00	2638	5264	7902	704	8606	16376	52.55%	16.11%	19	21
15	宜蘭縣三星鄉	2018-11-25T04:03:04+08:00	3118	6076	9194	797	9991	19051	52.44%	16.37%	21	21
15	宜蘭縣三星鄉	2018-11-24T22:40:39+08:00	2895	5697	8592	751	9343	17821	52.43%	16.24%	20	21
15	宜蘭縣三星鄉	2018-11-25T03:32:51+08:00	3118	6076	9194	797	9991	19051	52.44%	16.37%	21	21
15	宜蘭縣三星鄉	2018-11-24T23:08:50+08:00	2895	5697	8592	751	9343	17821	52.43%	16.24%	20	21
15	宜蘭縣三星鄉	2018-11-24T22:23:27+08:00	2638	5264	7902	704	8606	16376	52.55%	16.11%	19	21
15	宜蘭縣三星鄉	2018-11-24T22:51:02+08:00	2895	5697	8592	751	9343	17821	52.43%	16.24%	20	21
15	宜蘭縣三星鄉	2018-11-25T06:14:04+08:00	3118	6076	9194	797	9991	19051	52.44%	16.37%	21	21
15	宜蘭縣三星鄉	2018-11-24T23:55:59+08:00	3118	6076	9194	797	9991	19051	52.44%	16.37%	21	21
15	宜蘭縣三星鄉	2018-11-25T06:24:12+08:00	3118	6076	9194	797	9991	19051	52.44%	16.37%	21	21
15	宜蘭縣三星鄉	2018-11-24T23:27:29+08:00	3118	6076	9194	797	9991	19051	52.44%	16.37%	21	21
15	宜蘭縣三星鄉	2018-11-25T00:00:22+08:00	3118	6076	9194	797	9991	19051	52.44%	16.37%	21	21
15	宜蘭縣三星鄉	2018-11-25T00:23:16+08:00	3118	6076	9194	797	9991	19051	52.44%	16.37%	21	21
15	宜蘭縣三星鄉	2018-11-25T01:02:43+08:00	3118	6076	9194	797	9991	19051	52.44%	16.37%	21	21
15	宜蘭縣三星鄉	2018-11-25T06:29:30+08:00	3118	6076	9194	797	9991	19051	52.44%	16.37%	21	21
15	宜蘭縣三星鄉	2018-11-24T23:12:29+08:00	3118	6076	9194	797	9991	19051	52.44%	16.37%	21	21
15	宜蘭縣三星鄉	2018-11-25T03:50:03+08:00	3118	6076	9194	797	9991	19051	52.44%	16.37%	21	21
15	宜蘭縣三星鄉	2018-11-25T01:07:39+08:00	3118	6076	9194	797	9991	19051	52.44%	16.37%	21	21
15	宜蘭縣三星鄉	2018-11-25T00:14:22+08:00	3118	6076	9194	797	9991	19051	52.44%	16.37%	21	21
15	宜蘭縣三星鄉	2018-11-25T03:39:06+08:00	3118	6076	9194	797	9991	19051	52.44%	16.37%	21	21
15	宜蘭縣三星鄉	2018-11-25T01:26:06+08:00	3118	6076	9194	797	9991	19051	52.44%	16.37%	21	21
15	宜蘭縣三星鄉	2018-11-24T23:20:05+08:00	3118	6076	9194	797	9991	19051	52.44%	16.37%	21	21
15	屏東縣瑪家鄉	2018-11-25T03:56:26+08:00	880	2505	3385	178	3563	5663	62.92%	15.54%	8	8
15	屏東縣瑪家鄉	2018-11-24T23:05:15+08:00	736	2107	2843	153	2996	4606	65.05%	15.98%	7	8
15	屏東縣瑪家鄉	2018-11-25T01:18:08+08:00	880	2505	3385	178	3563	5663	62.92%	15.54%	8	8
15	屏東縣瑪家鄉	2018-11-24T23:39:30+08:00	736	2107	2843	153	2996	4606	65.05%	15.98%	7	8
15	屏東縣瑪家鄉	2018-11-25T06:29:29+08:00	880	2505	3385	178	3563	5663	62.92%	15.54%	8	8
15	屏東縣瑪家鄉	2018-11-25T06:19:09+08:00	880	2505	3385	178	3563	5663	62.92%	15.54%	8	8
15	屏東縣瑪家鄉	2018-11-24T22:58:07+08:00	736	2107	2843	153	2996	4606	65.05%	15.98%	7	8
15	屏東縣瑪家鄉	2018-11-24T22:41:49+08:00	736	2107	2843	153	2996	4606	65.05%	15.98%	7	8
15	屏東縣瑪家鄉	2018-11-24T23:43:28+08:00	736	2107	2843	153	2996	4606	65.05%	15.98%	7	8
15	屏東縣瑪家鄉	2018-11-25T06:09:07+08:00	880	2505	3385	178	3563	5663	62.92%	15.54%	8	8
15	屏東縣瑪家鄉	2018-11-24T22:30:22+08:00	736	2107	2843	153	2996	4606	65.05%	15.98%	7	8
15	屏東縣瑪家鄉	2018-11-24T23:51:47+08:00	736	2107	2843	153	2996	4606	65.05%	15.98%	7	8
15	屏東縣瑪家鄉	2018-11-24T22:13:43+08:00	603	1737	2340	132	2472	3706	66.7%	16.27%	6	8
15	屏東縣瑪家鄉	2018-11-24T23:08:49+08:00	736	2107	2843	153	2996	4606	65.05%	15.98%	7	8
15	屏東縣瑪家鄉	2018-11-24T22:51:01+08:00	736	2107	2843	153	2996	4606	65.05%	15.98%	7	8
15	屏東縣瑪家鄉	2018-11-25T03:44:38+08:00	880	2505	3385	178	3563	5663	62.92%	15.54%	8	8
15	屏東縣瑪家鄉	2018-11-25T00:23:15+08:00	880	2505	3385	178	3563	5663	62.92%	15.54%	8	8
15	屏東縣瑪家鄉	2018-11-24T23:23:49+08:00	736	2107	2843	153	2996	4606	65.05%	15.98%	7	8
15	屏東縣瑪家鄉	2018-11-24T22:33:49+08:00	736	2107	2843	153	2996	4606	65.05%	15.98%	7	8
15	屏東縣瑪家鄉	2018-11-24T22:37:12+08:00	736	2107	2843	153	2996	4606	65.05%	15.98%	7	8
15	屏東縣瑪家鄉	2018-11-24T23:16:14+08:00	736	2107	2843	153	2996	4606	65.05%	15.98%	7	8
15	屏東縣瑪家鄉	2018-11-24T22:16:23+08:00	603	1737	2340	132	2472	3706	66.7%	16.27%	6	8
15	屏東縣瑪家鄉	2018-11-25T00:14:21+08:00	880	2505	3385	178	3563	5663	62.92%	15.54%	8	8
15	屏東縣瑪家鄉	2018-11-24T23:35:21+08:00	736	2107	2843	153	2996	4606	65.05%	15.98%	7	8
15	屏東縣瑪家鄉	2018-11-24T22:45:19+08:00	736	2107	2843	153	2996	4606	65.05%	15.98%	7	8
15	屏東縣瑪家鄉	2018-11-24T22:54:36+08:00	736	2107	2843	153	2996	4606	65.05%	15.98%	7	8
15	屏東縣瑪家鄉	2018-11-25T00:09:48+08:00	880	2505	3385	178	3563	5663	62.92%	15.54%	8	8
15	屏東縣瑪家鄉	2018-11-24T23:01:44+08:00	736	2107	2843	153	2996	4606	65.05%	15.98%	7	8
15	屏東縣瑪家鄉	2018-11-24T22:26:47+08:00	736	2107	2843	153	2996	4606	65.05%	15.98%	7	8
15	屏東縣瑪家鄉	2018-11-24T23:47:41+08:00	736	2107	2843	153	2996	4606	65.05%	15.98%	7	8
15	屏東縣瑪家鄉	2018-11-25T01:12:57+08:00	880	2505	3385	178	3563	5663	62.92%	15.54%	8	8
15	屏東縣瑪家鄉	2018-11-25T00:05:16+08:00	880	2505	3385	178	3563	5663	62.92%	15.54%	8	8
15	屏東縣瑪家鄉	2018-11-25T00:57:49+08:00	880	2505	3385	178	3563	5663	62.92%	15.54%	8	8
15	屏東縣瑪家鄉	2018-11-24T22:19:48+08:00	603	1737	2340	132	2472	3706	66.7%	16.27%	6	8
15	屏東縣瑪家鄉	2018-11-25T03:32:50+08:00	880	2505	3385	178	3563	5663	62.92%	15.54%	8	8
15	屏東縣瑪家鄉	2018-11-25T04:03:04+08:00	880	2505	3385	178	3563	5663	62.92%	15.54%	8	8
15	屏東縣瑪家鄉	2018-11-24T22:40:39+08:00	736	2107	2843	153	2996	4606	65.05%	15.98%	7	8
15	屏東縣瑪家鄉	2018-11-25T01:02:42+08:00	880	2505	3385	178	3563	5663	62.92%	15.54%	8	8
15	屏東縣瑪家鄉	2018-11-25T06:14:03+08:00	880	2505	3385	178	3563	5663	62.92%	15.54%	8	8
15	屏東縣瑪家鄉	2018-11-24T23:55:59+08:00	736	2107	2843	153	2996	4606	65.05%	15.98%	7	8
15	屏東縣瑪家鄉	2018-11-25T06:24:12+08:00	880	2505	3385	178	3563	5663	62.92%	15.54%	8	8
15	屏東縣瑪家鄉	2018-11-24T22:23:26+08:00	736	2107	2843	153	2996	4606	65.05%	15.98%	7	8
15	屏東縣瑪家鄉	2018-11-24T23:27:29+08:00	736	2107	2843	153	2996	4606	65.05%	15.98%	7	8
15	屏東縣瑪家鄉	2018-11-25T00:00:22+08:00	736	2107	2843	153	2996	4606	65.05%	15.98%	7	8
15	屏東縣瑪家鄉	2018-11-24T23:31:25+08:00	736	2107	2843	153	2996	4606	65.05%	15.98%	7	8
15	屏東縣瑪家鄉	2018-11-24T23:20:04+08:00	736	2107	2843	153	2996	4606	65.05%	15.98%	7	8
15	屏東縣瑪家鄉	2018-11-25T00:18:45+08:00	880	2505	3385	178	3563	5663	62.92%	15.54%	8	8
15	屏東縣瑪家鄉	2018-11-25T01:07:38+08:00	880	2505	3385	178	3563	5663	62.92%	15.54%	8	8
15	屏東縣瑪家鄉	2018-11-25T03:39:06+08:00	880	2505	3385	178	3563	5663	62.92%	15.54%	8	8
15	屏東縣瑪家鄉	2018-11-25T01:26:06+08:00	880	2505	3385	178	3563	5663	62.92%	15.54%	8	8
15	屏東縣瑪家鄉	2018-11-25T03:50:02+08:00	880	2505	3385	178	3563	5663	62.92%	15.54%	8	8
15	屏東縣瑪家鄉	2018-11-24T23:12:28+08:00	736	2107	2843	153	2996	4606	65.05%	15.98%	7	8
15	臺東縣成功鎮	2018-11-24T23:56:00+08:00	1217	4110	5327	818	6145	12426	49.45%	9.79%	17	17
15	臺東縣成功鎮	2018-11-24T22:58:08+08:00	961	3108	4069	652	4721	9695	48.7%	9.91%	15	17
15	臺東縣成功鎮	2018-11-25T01:18:09+08:00	1217	4110	5327	818	6145	12426	49.45%	9.79%	17	17
15	臺東縣成功鎮	2018-11-25T03:56:27+08:00	1217	4110	5327	818	6145	12426	49.45%	9.79%	17	17
15	臺東縣成功鎮	2018-11-24T23:47:42+08:00	1217	4110	5327	818	6145	12426	49.45%	9.79%	17	17
15	臺東縣成功鎮	2018-11-24T23:12:30+08:00	1088	3589	4677	742	5419	11060	49%	9.84%	16	17
15	臺東縣成功鎮	2018-11-24T23:27:30+08:00	1217	4110	5327	818	6145	12426	49.45%	9.79%	17	17
15	臺東縣成功鎮	2018-11-25T06:09:09+08:00	1217	4110	5327	818	6145	12426	49.45%	9.79%	17	17
15	臺東縣成功鎮	2018-11-24T23:51:48+08:00	1217	4110	5327	818	6145	12426	49.45%	9.79%	17	17
15	臺東縣成功鎮	2018-11-24T22:30:23+08:00	961	3108	4069	652	4721	9695	48.7%	9.91%	15	17
15	臺東縣成功鎮	2018-11-25T03:32:52+08:00	1217	4110	5327	818	6145	12426	49.45%	9.79%	17	17
15	臺東縣成功鎮	2018-11-24T22:13:44+08:00	961	3108	4069	652	4721	9695	48.7%	9.91%	15	17
15	臺東縣成功鎮	2018-11-25T03:44:40+08:00	1217	4110	5327	818	6145	12426	49.45%	9.79%	17	17
15	臺東縣成功鎮	2018-11-25T00:57:50+08:00	1217	4110	5327	818	6145	12426	49.45%	9.79%	17	17
15	臺東縣成功鎮	2018-11-24T23:20:07+08:00	1217	4110	5327	818	6145	12426	49.45%	9.79%	17	17
15	臺東縣成功鎮	2018-11-24T22:16:25+08:00	961	3108	4069	652	4721	9695	48.7%	9.91%	15	17
15	臺東縣成功鎮	2018-11-24T23:31:26+08:00	1217	4110	5327	818	6145	12426	49.45%	9.79%	17	17
15	臺東縣成功鎮	2018-11-24T22:37:13+08:00	961	3108	4069	652	4721	9695	48.7%	9.91%	15	17
15	臺東縣成功鎮	2018-11-25T00:18:46+08:00	1217	4110	5327	818	6145	12426	49.45%	9.79%	17	17
15	臺東縣成功鎮	2018-11-24T23:16:15+08:00	1217	4110	5327	818	6145	12426	49.45%	9.79%	17	17
15	臺東縣成功鎮	2018-11-25T01:12:58+08:00	1217	4110	5327	818	6145	12426	49.45%	9.79%	17	17
15	臺東縣成功鎮	2018-11-25T00:05:17+08:00	1217	4110	5327	818	6145	12426	49.45%	9.79%	17	17
15	臺東縣成功鎮	2018-11-24T23:05:16+08:00	961	3108	4069	652	4721	9695	48.7%	9.91%	15	17
15	臺東縣成功鎮	2018-11-24T23:39:32+08:00	1217	4110	5327	818	6145	12426	49.45%	9.79%	17	17
15	臺東縣成功鎮	2018-11-24T22:54:37+08:00	961	3108	4069	652	4721	9695	48.7%	9.91%	15	17
15	臺東縣成功鎮	2018-11-24T22:33:50+08:00	961	3108	4069	652	4721	9695	48.7%	9.91%	15	17
15	臺東縣成功鎮	2018-11-24T22:45:20+08:00	961	3108	4069	652	4721	9695	48.7%	9.91%	15	17
15	臺東縣成功鎮	2018-11-24T22:26:48+08:00	961	3108	4069	652	4721	9695	48.7%	9.91%	15	17
15	臺東縣成功鎮	2018-11-24T23:01:45+08:00	961	3108	4069	652	4721	9695	48.7%	9.91%	15	17
15	臺東縣成功鎮	2018-11-25T00:09:49+08:00	1217	4110	5327	818	6145	12426	49.45%	9.79%	17	17
15	臺東縣成功鎮	2018-11-25T04:03:05+08:00	1217	4110	5327	818	6145	12426	49.45%	9.79%	17	17
15	臺東縣成功鎮	2018-11-24T23:08:51+08:00	1088	3589	4677	742	5419	11060	49%	9.84%	16	17
15	臺東縣成功鎮	2018-11-24T23:23:50+08:00	1217	4110	5327	818	6145	12426	49.45%	9.79%	17	17
15	臺東縣成功鎮	2018-11-24T22:19:49+08:00	961	3108	4069	652	4721	9695	48.7%	9.91%	15	17
15	臺東縣成功鎮	2018-11-25T00:00:23+08:00	1217	4110	5327	818	6145	12426	49.45%	9.79%	17	17
15	臺東縣成功鎮	2018-11-24T22:51:03+08:00	961	3108	4069	652	4721	9695	48.7%	9.91%	15	17
15	臺東縣成功鎮	2018-11-24T22:23:28+08:00	961	3108	4069	652	4721	9695	48.7%	9.91%	15	17
15	臺東縣成功鎮	2018-11-24T22:40:40+08:00	961	3108	4069	652	4721	9695	48.7%	9.91%	15	17
15	臺東縣成功鎮	2018-11-25T06:24:13+08:00	1217	4110	5327	818	6145	12426	49.45%	9.79%	17	17
15	臺東縣成功鎮	2018-11-25T01:02:44+08:00	1217	4110	5327	818	6145	12426	49.45%	9.79%	17	17
15	臺東縣成功鎮	2018-11-25T06:14:05+08:00	1217	4110	5327	818	6145	12426	49.45%	9.79%	17	17
15	臺東縣成功鎮	2018-11-25T00:23:16+08:00	1217	4110	5327	818	6145	12426	49.45%	9.79%	17	17
15	臺東縣成功鎮	2018-11-25T06:19:10+08:00	1217	4110	5327	818	6145	12426	49.45%	9.79%	17	17
15	臺東縣成功鎮	2018-11-25T06:29:30+08:00	1217	4110	5327	818	6145	12426	49.45%	9.79%	17	17
15	臺東縣成功鎮	2018-11-25T03:50:03+08:00	1217	4110	5327	818	6145	12426	49.45%	9.79%	17	17
15	臺東縣成功鎮	2018-11-25T01:07:39+08:00	1217	4110	5327	818	6145	12426	49.45%	9.79%	17	17
15	臺東縣成功鎮	2018-11-25T01:26:07+08:00	1217	4110	5327	818	6145	12426	49.45%	9.79%	17	17
15	臺東縣成功鎮	2018-11-25T03:39:07+08:00	1217	4110	5327	818	6145	12426	49.45%	9.79%	17	17
15	臺東縣成功鎮	2018-11-24T22:41:50+08:00	961	3108	4069	652	4721	9695	48.7%	9.91%	15	17
15	臺東縣成功鎮	2018-11-25T00:14:22+08:00	1217	4110	5327	818	6145	12426	49.45%	9.79%	17	17
15	臺東縣成功鎮	2018-11-24T23:35:22+08:00	1217	4110	5327	818	6145	12426	49.45%	9.79%	17	17
15	臺東縣成功鎮	2018-11-24T23:43:30+08:00	1217	4110	5327	818	6145	12426	49.45%	9.79%	17	17
15	臺東縣海端鄉	2018-11-25T03:56:28+08:00	373	1226	1599	155	1754	3278	53.51%	11.38%	6	6
15	臺東縣海端鄉	2018-11-24T22:58:08+08:00	373	1226	1599	155	1754	3278	53.51%	11.38%	6	6
15	臺東縣海端鄉	2018-11-24T23:47:43+08:00	373	1226	1599	155	1754	3278	53.51%	11.38%	6	6
15	臺東縣海端鄉	2018-11-24T23:56:01+08:00	373	1226	1599	155	1754	3278	53.51%	11.38%	6	6
15	臺東縣海端鄉	2018-11-24T23:12:30+08:00	373	1226	1599	155	1754	3278	53.51%	11.38%	6	6
15	臺東縣海端鄉	2018-11-24T23:27:30+08:00	373	1226	1599	155	1754	3278	53.51%	11.38%	6	6
15	臺東縣海端鄉	2018-11-25T06:09:09+08:00	373	1226	1599	155	1754	3278	53.51%	11.38%	6	6
15	臺東縣海端鄉	2018-11-24T23:51:48+08:00	373	1226	1599	155	1754	3278	53.51%	11.38%	6	6
15	臺東縣海端鄉	2018-11-24T22:30:23+08:00	249	916	1165	108	1273	2307	55.18%	10.79%	5	6
15	臺東縣海端鄉	2018-11-25T03:32:52+08:00	373	1226	1599	155	1754	3278	53.51%	11.38%	6	6
15	臺東縣海端鄉	2018-11-24T22:13:44+08:00	195	733	928	82	1010	1810	55.8%	10.77%	4	6
15	臺東縣海端鄉	2018-11-25T03:44:40+08:00	373	1226	1599	155	1754	3278	53.51%	11.38%	6	6
15	臺東縣海端鄉	2018-11-25T00:57:51+08:00	373	1226	1599	155	1754	3278	53.51%	11.38%	6	6
15	臺東縣海端鄉	2018-11-24T22:16:25+08:00	249	916	1165	108	1273	2307	55.18%	10.79%	5	6
15	臺東縣海端鄉	2018-11-25T00:09:50+08:00	373	1226	1599	155	1754	3278	53.51%	11.38%	6	6
15	臺東縣海端鄉	2018-11-25T00:18:47+08:00	373	1226	1599	155	1754	3278	53.51%	11.38%	6	6
15	臺東縣海端鄉	2018-11-24T22:37:14+08:00	249	916	1165	108	1273	2307	55.18%	10.79%	5	6
15	臺東縣海端鄉	2018-11-24T23:20:08+08:00	373	1226	1599	155	1754	3278	53.51%	11.38%	6	6
15	臺東縣海端鄉	2018-11-24T23:31:27+08:00	373	1226	1599	155	1754	3278	53.51%	11.38%	6	6
15	臺東縣海端鄉	2018-11-25T01:12:58+08:00	373	1226	1599	155	1754	3278	53.51%	11.38%	6	6
15	臺東縣海端鄉	2018-11-24T23:05:16+08:00	373	1226	1599	155	1754	3278	53.51%	11.38%	6	6
15	臺東縣海端鄉	2018-11-25T01:07:40+08:00	373	1226	1599	155	1754	3278	53.51%	11.38%	6	6
15	臺東縣海端鄉	2018-11-24T23:39:32+08:00	373	1226	1599	155	1754	3278	53.51%	11.38%	6	6
15	臺東縣海端鄉	2018-11-24T22:54:37+08:00	373	1226	1599	155	1754	3278	53.51%	11.38%	6	6
15	臺東縣海端鄉	2018-11-24T22:33:50+08:00	249	916	1165	108	1273	2307	55.18%	10.79%	5	6
15	臺東縣海端鄉	2018-11-24T22:45:20+08:00	373	1226	1599	155	1754	3278	53.51%	11.38%	6	6
15	臺東縣海端鄉	2018-11-25T00:05:18+08:00	373	1226	1599	155	1754	3278	53.51%	11.38%	6	6
15	臺東縣海端鄉	2018-11-24T22:26:48+08:00	249	916	1165	108	1273	2307	55.18%	10.79%	5	6
15	臺東縣海端鄉	2018-11-24T23:01:45+08:00	373	1226	1599	155	1754	3278	53.51%	11.38%	6	6
15	臺東縣海端鄉	2018-11-25T04:03:05+08:00	373	1226	1599	155	1754	3278	53.51%	11.38%	6	6
15	臺東縣海端鄉	2018-11-24T23:08:51+08:00	373	1226	1599	155	1754	3278	53.51%	11.38%	6	6
15	臺東縣海端鄉	2018-11-24T23:23:50+08:00	373	1226	1599	155	1754	3278	53.51%	11.38%	6	6
15	臺東縣海端鄉	2018-11-24T22:19:49+08:00	249	916	1165	108	1273	2307	55.18%	10.79%	5	6
15	臺東縣海端鄉	2018-11-25T00:23:17+08:00	373	1226	1599	155	1754	3278	53.51%	11.38%	6	6
15	臺東縣海端鄉	2018-11-25T00:00:24+08:00	373	1226	1599	155	1754	3278	53.51%	11.38%	6	6
15	臺東縣海端鄉	2018-11-24T22:51:03+08:00	373	1226	1599	155	1754	3278	53.51%	11.38%	6	6
15	臺東縣海端鄉	2018-11-24T22:23:28+08:00	249	916	1165	108	1273	2307	55.18%	10.79%	5	6
15	臺東縣海端鄉	2018-11-24T22:40:40+08:00	249	916	1165	108	1273	2307	55.18%	10.79%	5	6
15	臺東縣海端鄉	2018-11-25T06:24:13+08:00	373	1226	1599	155	1754	3278	53.51%	11.38%	6	6
15	臺東縣海端鄉	2018-11-25T01:02:44+08:00	373	1226	1599	155	1754	3278	53.51%	11.38%	6	6
15	臺東縣海端鄉	2018-11-25T06:14:05+08:00	373	1226	1599	155	1754	3278	53.51%	11.38%	6	6
15	臺東縣海端鄉	2018-11-25T06:19:10+08:00	373	1226	1599	155	1754	3278	53.51%	11.38%	6	6
15	臺東縣海端鄉	2018-11-25T00:14:23+08:00	373	1226	1599	155	1754	3278	53.51%	11.38%	6	6
15	臺東縣海端鄉	2018-11-25T01:18:10+08:00	373	1226	1599	155	1754	3278	53.51%	11.38%	6	6
15	臺東縣海端鄉	2018-11-25T03:50:04+08:00	373	1226	1599	155	1754	3278	53.51%	11.38%	6	6
15	臺東縣海端鄉	2018-11-25T01:26:07+08:00	373	1226	1599	155	1754	3278	53.51%	11.38%	6	6
15	臺東縣海端鄉	2018-11-25T03:39:07+08:00	373	1226	1599	155	1754	3278	53.51%	11.38%	6	6
15	臺東縣海端鄉	2018-11-24T22:41:50+08:00	249	916	1165	108	1273	2307	55.18%	10.79%	5	6
15	臺東縣海端鄉	2018-11-25T06:29:31+08:00	373	1226	1599	155	1754	3278	53.51%	11.38%	6	6
15	臺東縣海端鄉	2018-11-24T23:16:16+08:00	373	1226	1599	155	1754	3278	53.51%	11.38%	6	6
15	臺東縣海端鄉	2018-11-24T23:35:22+08:00	373	1226	1599	155	1754	3278	53.51%	11.38%	6	6
15	臺東縣海端鄉	2018-11-24T23:43:30+08:00	373	1226	1599	155	1754	3278	53.51%	11.38%	6	6
15	彰化縣彰化市	2018-11-24T22:26:44+08:00	7000	14578	21578	1129	22707	36695	61.88%	19.08%	39	184
15	彰化縣彰化市	2018-11-25T00:05:13+08:00	22001	46904	68905	3664	72569	119241	60.86%	18.45%	119	184
15	彰化縣彰化市	2018-11-24T23:01:40+08:00	13794	29666	43460	2300	45760	75279	60.79%	18.32%	78	184
15	彰化縣彰化市	2018-11-24T23:05:12+08:00	13794	29666	43460	2300	45760	75279	60.79%	18.32%	78	184
15	彰化縣彰化市	2018-11-25T06:29:26+08:00	35239	74545	109784	5749	115533	190995	60.49%	18.45%	184	184
15	彰化縣彰化市	2018-11-25T00:09:44+08:00	22001	46904	68905	3664	72569	119241	60.86%	18.45%	119	184
15	彰化縣彰化市	2018-11-24T22:37:08+08:00	8916	18336	27252	1440	28692	46974	61.08%	18.98%	50	184
15	彰化縣彰化市	2018-11-24T22:54:33+08:00	12813	26850	39663	2102	41765	68607	60.88%	18.68%	72	184
15	彰化縣彰化市	2018-11-24T22:50:57+08:00	12134	25405	37539	1978	39517	64861	60.93%	18.71%	68	184
15	彰化縣彰化市	2018-11-25T01:12:53+08:00	30778	65193	95971	5076	101047	166828	60.57%	18.45%	162	184
15	彰化縣彰化市	2018-11-24T22:40:35+08:00	9552	19766	29318	1552	30870	50511	61.12%	18.91%	53	184
15	彰化縣彰化市	2018-11-24T22:19:45+08:00	5148	10908	16056	814	16870	26922	62.66%	19.12%	30	184
15	彰化縣彰化市	2018-11-25T01:02:39+08:00	30581	64735	95316	5027	100343	165653	60.57%	18.46%	161	184
15	彰化縣彰化市	2018-11-25T04:03:00+08:00	35239	74545	109784	5749	115533	190995	60.49%	18.45%	184	184
15	彰化縣彰化市	2018-11-25T06:14:00+08:00	35239	74545	109784	5749	115533	190995	60.49%	18.45%	184	184
15	彰化縣彰化市	2018-11-24T23:23:46+08:00	16709	35847	52556	2751	55307	90987	60.79%	18.36%	92	184
15	彰化縣彰化市	2018-11-24T22:23:23+08:00	6038	12900	18938	977	19915	32015	62.21%	18.86%	35	184
15	彰化縣彰化市	2018-11-25T03:32:46+08:00	35239	74545	109784	5749	115533	190995	60.49%	18.45%	184	184
15	彰化縣彰化市	2018-11-24T23:55:55+08:00	21174	45216	66390	3557	69947	114831	60.91%	18.44%	115	184
15	彰化縣彰化市	2018-11-25T00:00:19+08:00	21810	46480	68290	3633	71923	118129	60.89%	18.46%	118	184
15	彰化縣彰化市	2018-11-25T00:23:12+08:00	23409	49804	73213	3854	77067	126681	60.84%	18.48%	126	184
15	彰化縣彰化市	2018-11-24T23:08:46+08:00	14026	30150	44176	2319	46495	76506	60.77%	18.33%	79	184
15	彰化縣彰化市	2018-11-24T23:31:21+08:00	16996	36365	53361	2780	56141	92349	60.79%	18.4%	93	184
15	彰化縣彰化市	2018-11-24T23:20:00+08:00	16286	34990	51276	2673	53949	88810	60.75%	18.34%	90	184
15	彰化縣彰化市	2018-11-24T23:35:18+08:00	17644	37564	55208	2875	58083	95598	60.76%	18.46%	97	184
15	彰化縣彰化市	2018-11-25T00:14:18+08:00	22468	47736	70204	3704	73908	121444	60.86%	18.5%	121	184
15	彰化縣彰化市	2018-11-24T23:12:25+08:00	14598	31347	45945	2368	48313	79455	60.81%	18.37%	81	184
15	彰化縣彰化市	2018-11-25T03:39:02+08:00	35239	74545	109784	5749	115533	190995	60.49%	18.45%	184	184
15	彰化縣彰化市	2018-11-25T01:07:35+08:00	30581	64735	95316	5027	100343	165653	60.57%	18.46%	161	184
15	彰化縣彰化市	2018-11-24T22:33:46+08:00	8545	17579	26124	1375	27499	45053	61.04%	18.97%	48	184
15	彰化縣彰化市	2018-11-25T00:18:41+08:00	23068	49036	72104	3798	75902	124714	60.86%	18.5%	124	184
15	彰化縣彰化市	2018-11-24T22:41:45+08:00	9552	19766	29318	1552	30870	50511	61.12%	18.91%	53	184
15	彰化縣彰化市	2018-11-25T03:56:22+08:00	35239	74545	109784	5749	115533	190995	60.49%	18.45%	184	184
15	彰化縣彰化市	2018-11-25T06:19:05+08:00	35239	74545	109784	5749	115533	190995	60.49%	18.45%	184	184
15	彰化縣彰化市	2018-11-24T22:45:16+08:00	10434	21793	32227	1702	33929	55714	60.9%	18.73%	59	184
15	彰化縣彰化市	2018-11-24T23:43:25+08:00	19100	40946	60046	3169	63215	104013	60.78%	18.36%	105	184
15	彰化縣彰化市	2018-11-25T01:18:03+08:00	31160	66014	97174	5134	102308	169012	60.53%	18.44%	164	184
15	彰化縣彰化市	2018-11-25T03:49:59+08:00	35239	74545	109784	5749	115533	190995	60.49%	18.45%	184	184
15	彰化縣彰化市	2018-11-24T22:58:03+08:00	13377	28037	41414	2186	43600	71665	60.84%	18.67%	75	184
15	彰化縣彰化市	2018-11-25T06:09:03+08:00	35239	74545	109784	5749	115533	190995	60.49%	18.45%	184	184
15	彰化縣彰化市	2018-11-24T23:51:43+08:00	20698	44352	65050	3479	68529	112502	60.91%	18.4%	113	184
15	彰化縣彰化市	2018-11-25T06:24:08+08:00	35239	74545	109784	5749	115533	190995	60.49%	18.45%	184	184
15	彰化縣彰化市	2018-11-25T00:57:46+08:00	30581	64735	95316	5027	100343	165653	60.57%	18.46%	161	184
15	彰化縣彰化市	2018-11-24T22:30:18+08:00	7411	15375	22786	1201	23987	38794	61.83%	19.1%	41	184
15	彰化縣彰化市	2018-11-24T23:27:26+08:00	16996	36365	53361	2780	56141	92349	60.79%	18.4%	93	184
15	彰化縣彰化市	2018-11-25T03:44:35+08:00	35239	74545	109784	5749	115533	190995	60.49%	18.45%	184	184
15	彰化縣彰化市	2018-11-24T22:13:39+08:00	4003	8499	12502	646	13148	20945	62.77%	19.11%	24	184
15	彰化縣彰化市	2018-11-24T23:39:26+08:00	18207	38910	57117	2969	60086	98863	60.78%	18.42%	100	184
15	彰化縣彰化市	2018-11-24T23:16:11+08:00	15874	34234	50108	2596	52704	86786	60.73%	18.29%	88	184
15	彰化縣彰化市	2018-11-24T23:47:38+08:00	19710	42153	61863	3280	65143	107046	60.86%	18.41%	108	184
15	彰化縣彰化市	2018-11-25T01:26:01+08:00	31820	67507	99327	5244	104571	172531	60.61%	18.44%	167	184
15	彰化縣彰化市	2018-11-24T22:16:20+08:00	4557	9717	14274	741	15015	23889	62.85%	19.08%	27	184
15	臺中市大安區	2018-11-25T03:56:17+08:00	2665	6258	8923	829	9752	16520	59.03%	16.13%	16	16
15	臺中市大安區	2018-11-25T06:29:21+08:00	2665	6258	8923	829	9752	16520	59.03%	16.13%	16	16
15	臺中市大安區	2018-11-25T03:49:55+08:00	2665	6258	8923	829	9752	16520	59.03%	16.13%	16	16
15	臺中市大安區	2018-11-25T06:19:01+08:00	2665	6258	8923	829	9752	16520	59.03%	16.13%	16	16
15	臺中市大安區	2018-11-24T23:16:07+08:00	2665	6258	8923	829	9752	16520	59.03%	16.13%	16	16
15	臺中市大安區	2018-11-24T22:45:12+08:00	2665	6258	8923	829	9752	16520	59.03%	16.13%	16	16
15	臺中市大安區	2018-11-24T23:43:21+08:00	2665	6258	8923	829	9752	16520	59.03%	16.13%	16	16
15	臺中市大安區	2018-11-24T22:41:40+08:00	2665	6258	8923	829	9752	16520	59.03%	16.13%	16	16
15	臺中市大安區	2018-11-25T00:18:36+08:00	2665	6258	8923	829	9752	16520	59.03%	16.13%	16	16
15	臺中市大安區	2018-11-24T23:51:40+08:00	2665	6258	8923	829	9752	16520	59.03%	16.13%	16	16
15	臺中市大安區	2018-11-25T01:25:57+08:00	2665	6258	8923	829	9752	16520	59.03%	16.13%	16	16
15	臺中市大安區	2018-11-24T22:30:14+08:00	2665	6258	8923	829	9752	16520	59.03%	16.13%	16	16
15	臺中市大安區	2018-11-25T06:24:04+08:00	2665	6258	8923	829	9752	16520	59.03%	16.13%	16	16
15	臺中市大安區	2018-11-25T00:23:08+08:00	2665	6258	8923	829	9752	16520	59.03%	16.13%	16	16
15	臺中市大安區	2018-11-25T03:32:39+08:00	2665	6258	8923	829	9752	16520	59.03%	16.13%	16	16
15	臺中市大安區	2018-11-24T23:27:22+08:00	2665	6258	8923	829	9752	16520	59.03%	16.13%	16	16
15	臺中市大安區	2018-11-24T22:57:59+08:00	2665	6258	8923	829	9752	16520	59.03%	16.13%	16	16
15	臺中市大安區	2018-11-24T23:08:41+08:00	2665	6258	8923	829	9752	16520	59.03%	16.13%	16	16
15	臺中市大安區	2018-11-24T22:13:33+08:00	2665	6258	8923	829	9752	16520	59.03%	16.13%	16	16
15	臺中市大安區	2018-11-24T23:19:56+08:00	2665	6258	8923	829	9752	16520	59.03%	16.13%	16	16
15	臺中市大安區	2018-11-25T01:17:58+08:00	2665	6258	8923	829	9752	16520	59.03%	16.13%	16	16
15	臺中市大安區	2018-11-24T22:54:29+08:00	2665	6258	8923	829	9752	16520	59.03%	16.13%	16	16
15	臺中市大安區	2018-11-24T23:47:33+08:00	2665	6258	8923	829	9752	16520	59.03%	16.13%	16	16
15	臺中市大安區	2018-11-25T04:02:56+08:00	2665	6258	8923	829	9752	16520	59.03%	16.13%	16	16
15	臺中市大安區	2018-11-25T06:08:58+08:00	2665	6258	8923	829	9752	16520	59.03%	16.13%	16	16
15	臺中市大安區	2018-11-24T22:16:15+08:00	2665	6258	8923	829	9752	16520	59.03%	16.13%	16	16
15	臺中市大安區	2018-11-24T23:31:16+08:00	2665	6258	8923	829	9752	16520	59.03%	16.13%	16	16
15	臺中市大安區	2018-11-25T01:12:48+08:00	2665	6258	8923	829	9752	16520	59.03%	16.13%	16	16
15	臺中市大安區	2018-11-24T23:05:08+08:00	2665	6258	8923	829	9752	16520	59.03%	16.13%	16	16
15	臺中市大安區	2018-11-25T00:05:09+08:00	2665	6258	8923	829	9752	16520	59.03%	16.13%	16	16
15	臺中市大安區	2018-11-25T06:13:56+08:00	2665	6258	8923	829	9752	16520	59.03%	16.13%	16	16
15	臺中市大安區	2018-11-24T22:26:40+08:00	2665	6258	8923	829	9752	16520	59.03%	16.13%	16	16
15	臺中市大安區	2018-11-24T22:50:53+08:00	2665	6258	8923	829	9752	16520	59.03%	16.13%	16	16
15	臺中市大安區	2018-11-24T22:37:05+08:00	2665	6258	8923	829	9752	16520	59.03%	16.13%	16	16
15	臺中市大安區	2018-11-24T22:19:41+08:00	2665	6258	8923	829	9752	16520	59.03%	16.13%	16	16
15	臺中市大安區	2018-11-25T03:38:59+08:00	2665	6258	8923	829	9752	16520	59.03%	16.13%	16	16
15	臺中市大安區	2018-11-24T22:40:31+08:00	2665	6258	8923	829	9752	16520	59.03%	16.13%	16	16
15	臺中市大安區	2018-11-25T01:02:35+08:00	2665	6258	8923	829	9752	16520	59.03%	16.13%	16	16
15	臺中市大安區	2018-11-25T00:57:41+08:00	2665	6258	8923	829	9752	16520	59.03%	16.13%	16	16
15	臺中市大安區	2018-11-25T03:44:28+08:00	2665	6258	8923	829	9752	16520	59.03%	16.13%	16	16
15	臺中市大安區	2018-11-24T23:23:42+08:00	2665	6258	8923	829	9752	16520	59.03%	16.13%	16	16
15	臺中市大安區	2018-11-24T22:23:18+08:00	2665	6258	8923	829	9752	16520	59.03%	16.13%	16	16
15	臺中市大安區	2018-11-25T00:00:15+08:00	2665	6258	8923	829	9752	16520	59.03%	16.13%	16	16
15	臺中市大安區	2018-11-24T23:55:51+08:00	2665	6258	8923	829	9752	16520	59.03%	16.13%	16	16
15	臺中市大安區	2018-11-24T23:39:21+08:00	2665	6258	8923	829	9752	16520	59.03%	16.13%	16	16
15	臺中市大安區	2018-11-25T01:07:30+08:00	2665	6258	8923	829	9752	16520	59.03%	16.13%	16	16
15	臺中市大安區	2018-11-24T23:12:20+08:00	2665	6258	8923	829	9752	16520	59.03%	16.13%	16	16
15	臺中市大安區	2018-11-24T23:35:14+08:00	2665	6258	8923	829	9752	16520	59.03%	16.13%	16	16
15	臺中市大安區	2018-11-25T00:14:14+08:00	2665	6258	8923	829	9752	16520	59.03%	16.13%	16	16
15	臺中市大安區	2018-11-24T23:01:35+08:00	2665	6258	8923	829	9752	16520	59.03%	16.13%	16	16
15	臺中市大安區	2018-11-25T00:09:39+08:00	2665	6258	8923	829	9752	16520	59.03%	16.13%	16	16
15	臺中市大安區	2018-11-24T22:33:42+08:00	2665	6258	8923	829	9752	16520	59.03%	16.13%	16	16
15	南投縣埔里鎮	2018-11-25T00:05:14+08:00	10535	25451	35986	2270	38256	66157	57.83%	15.92%	66	68
15	南投縣埔里鎮	2018-11-24T23:01:40+08:00	10535	25451	35986	2270	38256	66157	57.83%	15.92%	66	68
15	南投縣埔里鎮	2018-11-25T06:19:06+08:00	10904	26454	37358	2295	39653	68763	57.67%	15.86%	68	68
15	南投縣埔里鎮	2018-11-24T23:05:12+08:00	10535	25451	35986	2270	38256	66157	57.83%	15.92%	66	68
15	南投縣埔里鎮	2018-11-25T00:09:45+08:00	10732	25954	36686	2295	38981	67439	57.8%	15.91%	67	68
15	南投縣埔里鎮	2018-11-25T06:29:26+08:00	10904	26454	37358	2295	39653	68763	57.67%	15.86%	68	68
15	南投縣埔里鎮	2018-11-24T22:50:58+08:00	10340	25036	35376	2229	37605	65228	57.65%	15.85%	65	68
15	南投縣埔里鎮	2018-11-24T22:37:09+08:00	10162	24613	34775	2203	36978	64122	57.67%	15.85%	64	68
15	南投縣埔里鎮	2018-11-24T22:26:45+08:00	10162	24613	34775	2203	36978	64122	57.67%	15.85%	64	68
15	南投縣埔里鎮	2018-11-24T22:54:33+08:00	10340	25036	35376	2229	37605	65228	57.65%	15.85%	65	68
15	南投縣埔里鎮	2018-11-25T01:12:54+08:00	10904	26454	37358	2295	39653	68763	57.67%	15.86%	68	68
15	南投縣埔里鎮	2018-11-24T22:19:45+08:00	9869	23830	33699	2101	35800	61795	57.93%	15.97%	62	68
15	南投縣埔里鎮	2018-11-25T04:03:01+08:00	10904	26454	37358	2295	39653	68763	57.67%	15.86%	68	68
15	南投縣埔里鎮	2018-11-25T00:23:13+08:00	10904	26454	37358	2295	39653	68763	57.67%	15.86%	68	68
15	南投縣埔里鎮	2018-11-24T23:23:46+08:00	10535	25451	35986	2270	38256	66157	57.83%	15.92%	66	68
15	南投縣埔里鎮	2018-11-24T22:23:23+08:00	9991	24168	34159	2174	36333	62839	57.82%	15.9%	63	68
15	南投縣埔里鎮	2018-11-25T00:00:19+08:00	10535	25451	35986	2270	38256	66157	57.83%	15.92%	66	68
15	南投縣埔里鎮	2018-11-25T01:02:40+08:00	10904	26454	37358	2295	39653	68763	57.67%	15.86%	68	68
15	南投縣埔里鎮	2018-11-25T06:14:01+08:00	10904	26454	37358	2295	39653	68763	57.67%	15.86%	68	68
15	南投縣埔里鎮	2018-11-25T03:32:47+08:00	10904	26454	37358	2295	39653	68763	57.67%	15.86%	68	68
15	南投縣埔里鎮	2018-11-24T23:08:46+08:00	10535	25451	35986	2270	38256	66157	57.83%	15.92%	66	68
15	南投縣埔里鎮	2018-11-25T03:39:03+08:00	10904	26454	37358	2295	39653	68763	57.67%	15.86%	68	68
15	南投縣埔里鎮	2018-11-24T23:35:18+08:00	10535	25451	35986	2270	38256	66157	57.83%	15.92%	66	68
15	南投縣埔里鎮	2018-11-25T01:26:02+08:00	10904	26454	37358	2295	39653	68763	57.67%	15.86%	68	68
15	南投縣埔里鎮	2018-11-24T23:20:01+08:00	10535	25451	35986	2270	38256	66157	57.83%	15.92%	66	68
15	南投縣埔里鎮	2018-11-25T01:07:35+08:00	10904	26454	37358	2295	39653	68763	57.67%	15.86%	68	68
15	南投縣埔里鎮	2018-11-24T22:33:46+08:00	10162	24613	34775	2203	36978	64122	57.67%	15.85%	64	68
15	南投縣埔里鎮	2018-11-25T00:14:19+08:00	10732	25954	36686	2295	38981	67439	57.8%	15.91%	67	68
15	南投縣埔里鎮	2018-11-24T22:41:45+08:00	10162	24613	34775	2203	36978	64122	57.67%	15.85%	64	68
15	南投縣埔里鎮	2018-11-24T22:45:16+08:00	10340	25036	35376	2229	37605	65228	57.65%	15.85%	65	68
15	南投縣埔里鎮	2018-11-24T23:43:25+08:00	10535	25451	35986	2270	38256	66157	57.83%	15.92%	66	68
15	南投縣埔里鎮	2018-11-25T03:56:23+08:00	10904	26454	37358	2295	39653	68763	57.67%	15.86%	68	68
15	南投縣埔里鎮	2018-11-24T22:58:04+08:00	10535	25451	35986	2270	38256	66157	57.83%	15.92%	66	68
15	南投縣埔里鎮	2018-11-25T03:49:59+08:00	10904	26454	37358	2295	39653	68763	57.67%	15.86%	68	68
15	南投縣埔里鎮	2018-11-25T01:18:04+08:00	10904	26454	37358	2295	39653	68763	57.67%	15.86%	68	68
15	南投縣埔里鎮	2018-11-25T06:24:09+08:00	10904	26454	37358	2295	39653	68763	57.67%	15.86%	68	68
15	南投縣埔里鎮	2018-11-25T06:09:04+08:00	10904	26454	37358	2295	39653	68763	57.67%	15.86%	68	68
15	南投縣埔里鎮	2018-11-24T23:51:44+08:00	10535	25451	35986	2270	38256	66157	57.83%	15.92%	66	68
15	南投縣埔里鎮	2018-11-24T22:40:36+08:00	10162	24613	34775	2203	36978	64122	57.67%	15.85%	64	68
15	南投縣埔里鎮	2018-11-24T22:30:19+08:00	10162	24613	34775	2203	36978	64122	57.67%	15.85%	64	68
15	南投縣埔里鎮	2018-11-24T22:13:40+08:00	9624	23278	32902	2046	34948	60324	57.93%	15.95%	61	68
15	南投縣埔里鎮	2018-11-25T00:57:46+08:00	10904	26454	37358	2295	39653	68763	57.67%	15.86%	68	68
15	南投縣埔里鎮	2018-11-24T23:27:26+08:00	10535	25451	35986	2270	38256	66157	57.83%	15.92%	66	68
15	南投縣埔里鎮	2018-11-25T03:44:35+08:00	10904	26454	37358	2295	39653	68763	57.67%	15.86%	68	68
15	南投縣埔里鎮	2018-11-24T23:55:56+08:00	10535	25451	35986	2270	38256	66157	57.83%	15.92%	66	68
15	南投縣埔里鎮	2018-11-24T23:31:22+08:00	10535	25451	35986	2270	38256	66157	57.83%	15.92%	66	68
15	南投縣埔里鎮	2018-11-25T00:18:42+08:00	10904	26454	37358	2295	39653	68763	57.67%	15.86%	68	68
15	南投縣埔里鎮	2018-11-24T23:16:11+08:00	10535	25451	35986	2270	38256	66157	57.83%	15.92%	66	68
15	南投縣埔里鎮	2018-11-24T23:47:38+08:00	10535	25451	35986	2270	38256	66157	57.83%	15.92%	66	68
15	南投縣埔里鎮	2018-11-24T23:12:26+08:00	10535	25451	35986	2270	38256	66157	57.83%	15.92%	66	68
15	南投縣埔里鎮	2018-11-24T22:16:20+08:00	9624	23278	32902	2046	34948	60324	57.93%	15.95%	61	68
15	南投縣埔里鎮	2018-11-24T23:39:27+08:00	10535	25451	35986	2270	38256	66157	57.83%	15.92%	66	68
15	南投縣信義鄉	2018-11-25T00:05:14+08:00	1248	4929	6177	509	6686	10903	61.32%	11.45%	18	20
15	南投縣信義鄉	2018-11-25T06:19:06+08:00	1461	6133	7594	602	8196	13299	61.63%	10.99%	20	20
15	南投縣信義鄉	2018-11-25T00:09:45+08:00	1351	5522	6873	576	7449	11923	62.48%	11.33%	19	20
15	南投縣信義鄉	2018-11-24T22:50:58+08:00	1152	4497	5649	487	6136	9924	61.83%	11.61%	17	20
15	南投縣信義鄉	2018-11-24T22:41:46+08:00	1075	4303	5378	453	5831	9407	61.99%	11.43%	16	20
15	南投縣信義鄉	2018-11-24T22:37:09+08:00	1075	4303	5378	453	5831	9407	61.99%	11.43%	16	20
15	南投縣信義鄉	2018-11-25T06:29:27+08:00	1461	6133	7594	602	8196	13299	61.63%	10.99%	20	20
15	南投縣信義鄉	2018-11-24T23:05:13+08:00	1248	4929	6177	509	6686	10903	61.32%	11.45%	18	20
15	南投縣信義鄉	2018-11-24T23:01:41+08:00	1248	4929	6177	509	6686	10903	61.32%	11.45%	18	20
15	南投縣信義鄉	2018-11-24T22:26:45+08:00	902	3299	4201	357	4558	7578	60.15%	11.9%	14	20
15	南投縣信義鄉	2018-11-24T22:54:34+08:00	1152	4497	5649	487	6136	9924	61.83%	11.61%	17	20
15	南投縣信義鄉	2018-11-25T01:12:54+08:00	1461	6133	7594	602	8196	13299	61.63%	10.99%	20	20
15	南投縣信義鄉	2018-11-25T04:03:01+08:00	1461	6133	7594	602	8196	13299	61.63%	10.99%	20	20
15	南投縣信義鄉	2018-11-25T00:00:20+08:00	1248	4929	6177	509	6686	10903	61.32%	11.45%	18	20
15	南投縣信義鄉	2018-11-25T00:23:13+08:00	1461	6133	7594	602	8196	13299	61.63%	10.99%	20	20
15	南投縣信義鄉	2018-11-25T03:44:36+08:00	1461	6133	7594	602	8196	13299	61.63%	10.99%	20	20
15	南投縣信義鄉	2018-11-24T23:08:47+08:00	1248	4929	6177	509	6686	10903	61.32%	11.45%	18	20
15	南投縣信義鄉	2018-11-24T22:23:24+08:00	902	3299	4201	357	4558	7578	60.15%	11.9%	14	20
15	南投縣信義鄉	2018-11-25T01:02:40+08:00	1461	6133	7594	602	8196	13299	61.63%	10.99%	20	20
15	南投縣信義鄉	2018-11-25T06:14:01+08:00	1461	6133	7594	602	8196	13299	61.63%	10.99%	20	20
15	南投縣信義鄉	2018-11-25T03:32:47+08:00	1461	6133	7594	602	8196	13299	61.63%	10.99%	20	20
15	南投縣信義鄉	2018-11-24T23:23:47+08:00	1248	4929	6177	509	6686	10903	61.32%	11.45%	18	20
15	南投縣信義鄉	2018-11-25T03:50:00+08:00	1461	6133	7594	602	8196	13299	61.63%	10.99%	20	20
15	南投縣信義鄉	2018-11-24T22:33:47+08:00	1075	4303	5378	453	5831	9407	61.99%	11.43%	16	20
15	南投縣信義鄉	2018-11-25T03:39:03+08:00	1461	6133	7594	602	8196	13299	61.63%	10.99%	20	20
15	南投縣信義鄉	2018-11-25T01:26:02+08:00	1461	6133	7594	602	8196	13299	61.63%	10.99%	20	20
15	南投縣信義鄉	2018-11-24T23:20:01+08:00	1248	4929	6177	509	6686	10903	61.32%	11.45%	18	20
15	南投縣信義鄉	2018-11-25T00:14:19+08:00	1351	5522	6873	576	7449	11923	62.48%	11.33%	19	20
15	南投縣信義鄉	2018-11-24T23:16:12+08:00	1248	4929	6177	509	6686	10903	61.32%	11.45%	18	20
15	南投縣信義鄉	2018-11-24T23:35:19+08:00	1248	4929	6177	509	6686	10903	61.32%	11.45%	18	20
15	南投縣信義鄉	2018-11-24T22:45:17+08:00	1075	4303	5378	453	5831	9407	61.99%	11.43%	16	20
15	南投縣信義鄉	2018-11-24T23:43:25+08:00	1248	4929	6177	509	6686	10903	61.32%	11.45%	18	20
15	南投縣信義鄉	2018-11-25T03:56:23+08:00	1461	6133	7594	602	8196	13299	61.63%	10.99%	20	20
15	南投縣信義鄉	2018-11-24T22:58:04+08:00	1248	4929	6177	509	6686	10903	61.32%	11.45%	18	20
15	南投縣信義鄉	2018-11-25T01:18:04+08:00	1461	6133	7594	602	8196	13299	61.63%	10.99%	20	20
15	南投縣信義鄉	2018-11-25T00:57:47+08:00	1461	6133	7594	602	8196	13299	61.63%	10.99%	20	20
15	南投縣信義鄉	2018-11-24T22:19:46+08:00	835	3015	3850	331	4181	7018	59.58%	11.9%	13	20
15	南投縣信義鄉	2018-11-25T06:24:09+08:00	1461	6133	7594	602	8196	13299	61.63%	10.99%	20	20
15	南投縣信義鄉	2018-11-25T06:09:04+08:00	1461	6133	7594	602	8196	13299	61.63%	10.99%	20	20
15	南投縣信義鄉	2018-11-24T22:40:36+08:00	1075	4303	5378	453	5831	9407	61.99%	11.43%	16	20
15	南投縣信義鄉	2018-11-24T22:30:19+08:00	902	3299	4201	357	4558	7578	60.15%	11.9%	14	20
15	南投縣信義鄉	2018-11-24T22:13:40+08:00	835	3015	3850	331	4181	7018	59.58%	11.9%	13	20
15	南投縣信義鄉	2018-11-24T23:51:45+08:00	1248	4929	6177	509	6686	10903	61.32%	11.45%	18	20
15	南投縣信義鄉	2018-11-24T23:27:27+08:00	1248	4929	6177	509	6686	10903	61.32%	11.45%	18	20
15	南投縣信義鄉	2018-11-24T23:55:56+08:00	1248	4929	6177	509	6686	10903	61.32%	11.45%	18	20
15	南投縣信義鄉	2018-11-24T23:47:39+08:00	1248	4929	6177	509	6686	10903	61.32%	11.45%	18	20
15	南投縣信義鄉	2018-11-24T23:31:22+08:00	1248	4929	6177	509	6686	10903	61.32%	11.45%	18	20
15	南投縣信義鄉	2018-11-24T22:16:21+08:00	835	3015	3850	331	4181	7018	59.58%	11.9%	13	20
15	南投縣信義鄉	2018-11-25T00:18:42+08:00	1351	5522	6873	576	7449	11923	62.48%	11.33%	19	20
15	南投縣信義鄉	2018-11-24T23:12:26+08:00	1248	4929	6177	509	6686	10903	61.32%	11.45%	18	20
15	南投縣信義鄉	2018-11-24T23:39:27+08:00	1248	4929	6177	509	6686	10903	61.32%	11.45%	18	20
15	南投縣信義鄉	2018-11-25T01:07:36+08:00	1461	6133	7594	602	8196	13299	61.63%	10.99%	20	20
15	高雄市大社區	2018-11-25T01:18:01+08:00	5559	10016	15575	1163	16738	28930	57.86%	19.22%	23	24
15	高雄市大社區	2018-11-24T22:58:01+08:00	5304	9460	14764	1130	15894	27074	58.71%	19.59%	22	24
15	高雄市大社區	2018-11-24T22:37:07+08:00	5304	9460	14764	1130	15894	27074	58.71%	19.59%	22	24
15	高雄市大社區	2018-11-24T22:45:14+08:00	5304	9460	14764	1130	15894	27074	58.71%	19.59%	22	24
15	高雄市大社區	2018-11-25T03:56:20+08:00	5753	10353	16106	1205	17311	30046	57.61%	19.15%	24	24
15	高雄市大社區	2018-11-24T22:26:42+08:00	5304	9460	14764	1130	15894	27074	58.71%	19.59%	22	24
15	高雄市大社區	2018-11-24T23:16:09+08:00	5304	9460	14764	1130	15894	27074	58.71%	19.59%	22	24
15	高雄市大社區	2018-11-25T00:18:38+08:00	5559	10016	15575	1163	16738	28930	57.86%	19.22%	23	24
15	高雄市大社區	2018-11-25T01:25:59+08:00	5559	10016	15575	1163	16738	28930	57.86%	19.22%	23	24
15	高雄市大社區	2018-11-25T00:57:43+08:00	5559	10016	15575	1163	16738	28930	57.86%	19.22%	23	24
15	高雄市大社區	2018-11-25T01:02:37+08:00	5559	10016	15575	1163	16738	28930	57.86%	19.22%	23	24
15	高雄市大社區	2018-11-24T22:40:33+08:00	5304	9460	14764	1130	15894	27074	58.71%	19.59%	22	24
15	高雄市大社區	2018-11-25T06:09:01+08:00	5753	10353	16106	1205	17311	30046	57.61%	19.15%	24	24
15	高雄市大社區	2018-11-24T22:19:43+08:00	5304	9460	14764	1130	15894	27074	58.71%	19.59%	22	24
15	高雄市大社區	2018-11-24T23:55:53+08:00	5559	10016	15575	1163	16738	28930	57.86%	19.22%	23	24
15	高雄市大社區	2018-11-25T03:44:31+08:00	5753	10353	16106	1205	17311	30046	57.61%	19.15%	24	24
15	高雄市大社區	2018-11-25T00:00:17+08:00	5559	10016	15575	1163	16738	28930	57.86%	19.22%	23	24
15	高雄市大社區	2018-11-24T23:19:58+08:00	5559	10016	15575	1163	16738	28930	57.86%	19.22%	23	24
15	高雄市大社區	2018-11-24T23:27:24+08:00	5559	10016	15575	1163	16738	28930	57.86%	19.22%	23	24
15	高雄市大社區	2018-11-25T01:07:33+08:00	5559	10016	15575	1163	16738	28930	57.86%	19.22%	23	24
15	高雄市大社區	2018-11-24T23:31:19+08:00	5559	10016	15575	1163	16738	28930	57.86%	19.22%	23	24
15	高雄市大社區	2018-11-24T23:01:37+08:00	5304	9460	14764	1130	15894	27074	58.71%	19.59%	22	24
15	高雄市大社區	2018-11-24T23:12:23+08:00	5304	9460	14764	1130	15894	27074	58.71%	19.59%	22	24
15	高雄市大社區	2018-11-25T00:14:16+08:00	5559	10016	15575	1163	16738	28930	57.86%	19.22%	23	24
15	高雄市大社區	2018-11-24T23:35:16+08:00	5559	10016	15575	1163	16738	28930	57.86%	19.22%	23	24
15	高雄市大社區	2018-11-24T23:39:24+08:00	5559	10016	15575	1163	16738	28930	57.86%	19.22%	23	24
15	高雄市大社區	2018-11-25T04:02:59+08:00	5753	10353	16106	1205	17311	30046	57.61%	19.15%	24	24
15	高雄市大社區	2018-11-24T23:43:23+08:00	5559	10016	15575	1163	16738	28930	57.86%	19.22%	23	24
15	高雄市大社區	2018-11-25T01:12:51+08:00	5559	10016	15575	1163	16738	28930	57.86%	19.22%	23	24
15	高雄市大社區	2018-11-24T22:54:31+08:00	5304	9460	14764	1130	15894	27074	58.71%	19.59%	22	24
15	高雄市大社區	2018-11-24T22:50:55+08:00	5304	9460	14764	1130	15894	27074	58.71%	19.59%	22	24
15	高雄市大社區	2018-11-25T00:09:41+08:00	5559	10016	15575	1163	16738	28930	57.86%	19.22%	23	24
15	高雄市大社區	2018-11-25T06:13:59+08:00	5753	10353	16106	1205	17311	30046	57.61%	19.15%	24	24
15	高雄市大社區	2018-11-24T22:41:43+08:00	5304	9460	14764	1130	15894	27074	58.71%	19.59%	22	24
15	高雄市大社區	2018-11-25T03:49:57+08:00	5753	10353	16106	1205	17311	30046	57.61%	19.15%	24	24
15	高雄市大社區	2018-11-24T23:05:10+08:00	5304	9460	14764	1130	15894	27074	58.71%	19.59%	22	24
15	高雄市大社區	2018-11-25T06:19:03+08:00	5753	10353	16106	1205	17311	30046	57.61%	19.15%	24	24
15	高雄市大社區	2018-11-25T06:29:24+08:00	5753	10353	16106	1205	17311	30046	57.61%	19.15%	24	24
15	高雄市大社區	2018-11-25T00:05:11+08:00	5559	10016	15575	1163	16738	28930	57.86%	19.22%	23	24
15	高雄市大社區	2018-11-25T06:24:06+08:00	5753	10353	16106	1205	17311	30046	57.61%	19.15%	24	24
15	高雄市大社區	2018-11-24T22:30:16+08:00	5304	9460	14764	1130	15894	27074	58.71%	19.59%	22	24
15	高雄市大社區	2018-11-24T23:51:42+08:00	5559	10016	15575	1163	16738	28930	57.86%	19.22%	23	24
15	高雄市大社區	2018-11-24T22:13:36+08:00	5304	9460	14764	1130	15894	27074	58.71%	19.59%	22	24
15	高雄市大社區	2018-11-24T23:08:43+08:00	5304	9460	14764	1130	15894	27074	58.71%	19.59%	22	24
15	高雄市大社區	2018-11-25T00:23:10+08:00	5559	10016	15575	1163	16738	28930	57.86%	19.22%	23	24
15	高雄市大社區	2018-11-24T22:23:21+08:00	5304	9460	14764	1130	15894	27074	58.71%	19.59%	22	24
15	高雄市大社區	2018-11-25T03:32:43+08:00	5753	10353	16106	1205	17311	30046	57.61%	19.15%	24	24
15	高雄市大社區	2018-11-24T23:23:44+08:00	5559	10016	15575	1163	16738	28930	57.86%	19.22%	23	24
15	高雄市大社區	2018-11-24T22:33:44+08:00	5304	9460	14764	1130	15894	27074	58.71%	19.59%	22	24
15	高雄市大社區	2018-11-24T23:47:36+08:00	5559	10016	15575	1163	16738	28930	57.86%	19.22%	23	24
15	高雄市大社區	2018-11-25T03:39:01+08:00	5753	10353	16106	1205	17311	30046	57.61%	19.15%	24	24
15	高雄市大社區	2018-11-24T22:16:18+08:00	5304	9460	14764	1130	15894	27074	58.71%	19.59%	22	24
15	高雄市新興區	2018-11-24T22:58:01+08:00	8921	15576	24497	1275	25772	41989	61.38%	21.25%	40	42
15	高雄市新興區	2018-11-24T22:45:14+08:00	8921	15576	24497	1275	25772	41989	61.38%	21.25%	40	42
15	高雄市新興區	2018-11-25T03:56:20+08:00	9445	16428	25873	1336	27209	44355	61.34%	21.29%	42	42
15	高雄市新興區	2018-11-24T22:26:42+08:00	8485	14710	23195	1228	24423	39653	61.59%	21.4%	38	42
15	高雄市新興區	2018-11-25T01:18:00+08:00	9445	16428	25873	1336	27209	44355	61.34%	21.29%	42	42
15	高雄市新興區	2018-11-24T23:16:09+08:00	9156	15956	25112	1304	26416	43038	61.38%	21.27%	41	42
15	高雄市新興區	2018-11-25T00:18:38+08:00	9445	16428	25873	1336	27209	44355	61.34%	21.29%	42	42
15	高雄市新興區	2018-11-24T22:37:06+08:00	8701	15133	23834	1250	25084	40888	61.35%	21.28%	39	42
15	高雄市新興區	2018-11-25T06:09:00+08:00	9445	16428	25873	1336	27209	44355	61.34%	21.29%	42	42
15	高雄市新興區	2018-11-25T01:25:59+08:00	9445	16428	25873	1336	27209	44355	61.34%	21.29%	42	42
15	高雄市新興區	2018-11-25T00:57:43+08:00	9445	16428	25873	1336	27209	44355	61.34%	21.29%	42	42
15	高雄市新興區	2018-11-25T01:02:37+08:00	9445	16428	25873	1336	27209	44355	61.34%	21.29%	42	42
15	高雄市新興區	2018-11-24T22:40:33+08:00	8921	15576	24497	1275	25772	41989	61.38%	21.25%	40	42
15	高雄市新興區	2018-11-24T23:51:41+08:00	9445	16428	25873	1336	27209	44355	61.34%	21.29%	42	42
15	高雄市新興區	2018-11-24T22:19:43+08:00	8156	14100	22256	1183	23439	38044	61.61%	21.44%	37	42
15	高雄市新興區	2018-11-24T23:55:53+08:00	9445	16428	25873	1336	27209	44355	61.34%	21.29%	42	42
15	高雄市新興區	2018-11-25T00:00:17+08:00	9445	16428	25873	1336	27209	44355	61.34%	21.29%	42	42
15	高雄市新興區	2018-11-24T23:19:58+08:00	9156	15956	25112	1304	26416	43038	61.38%	21.27%	41	42
15	高雄市新興區	2018-11-24T23:27:24+08:00	9445	16428	25873	1336	27209	44355	61.34%	21.29%	42	42
15	高雄市新興區	2018-11-25T03:44:30+08:00	9445	16428	25873	1336	27209	44355	61.34%	21.29%	42	42
15	高雄市新興區	2018-11-24T23:01:37+08:00	8921	15576	24497	1275	25772	41989	61.38%	21.25%	40	42
15	高雄市新興區	2018-11-25T04:02:58+08:00	9445	16428	25873	1336	27209	44355	61.34%	21.29%	42	42
15	高雄市新興區	2018-11-25T00:14:16+08:00	9445	16428	25873	1336	27209	44355	61.34%	21.29%	42	42
15	高雄市新興區	2018-11-24T23:35:16+08:00	9445	16428	25873	1336	27209	44355	61.34%	21.29%	42	42
15	高雄市新興區	2018-11-24T23:12:22+08:00	9156	15956	25112	1304	26416	43038	61.38%	21.27%	41	42
15	高雄市新興區	2018-11-24T23:31:18+08:00	9445	16428	25873	1336	27209	44355	61.34%	21.29%	42	42
15	高雄市新興區	2018-11-24T23:39:23+08:00	9445	16428	25873	1336	27209	44355	61.34%	21.29%	42	42
15	高雄市新興區	2018-11-25T01:07:32+08:00	9445	16428	25873	1336	27209	44355	61.34%	21.29%	42	42
15	高雄市新興區	2018-11-24T23:47:35+08:00	9445	16428	25873	1336	27209	44355	61.34%	21.29%	42	42
15	高雄市新興區	2018-11-24T23:43:23+08:00	9445	16428	25873	1336	27209	44355	61.34%	21.29%	42	42
15	高雄市新興區	2018-11-24T22:41:42+08:00	8921	15576	24497	1275	25772	41989	61.38%	21.25%	40	42
15	高雄市新興區	2018-11-25T01:12:51+08:00	9445	16428	25873	1336	27209	44355	61.34%	21.29%	42	42
15	高雄市新興區	2018-11-25T06:13:58+08:00	9445	16428	25873	1336	27209	44355	61.34%	21.29%	42	42
15	高雄市新興區	2018-11-24T22:54:31+08:00	8921	15576	24497	1275	25772	41989	61.38%	21.25%	40	42
15	高雄市新興區	2018-11-24T22:50:55+08:00	8921	15576	24497	1275	25772	41989	61.38%	21.25%	40	42
15	高雄市新興區	2018-11-25T00:09:41+08:00	9445	16428	25873	1336	27209	44355	61.34%	21.29%	42	42
15	高雄市新興區	2018-11-25T06:29:23+08:00	9445	16428	25873	1336	27209	44355	61.34%	21.29%	42	42
15	高雄市新興區	2018-11-25T03:49:57+08:00	9445	16428	25873	1336	27209	44355	61.34%	21.29%	42	42
15	高雄市新興區	2018-11-24T23:05:10+08:00	8921	15576	24497	1275	25772	41989	61.38%	21.25%	40	42
15	高雄市新興區	2018-11-25T06:19:03+08:00	9445	16428	25873	1336	27209	44355	61.34%	21.29%	42	42
15	高雄市新興區	2018-11-25T00:05:11+08:00	9445	16428	25873	1336	27209	44355	61.34%	21.29%	42	42
15	高雄市新興區	2018-11-25T06:24:06+08:00	9445	16428	25873	1336	27209	44355	61.34%	21.29%	42	42
15	高雄市新興區	2018-11-24T22:30:16+08:00	8485	14710	23195	1228	24423	39653	61.59%	21.4%	38	42
15	高雄市新興區	2018-11-24T22:13:36+08:00	7683	13313	20996	1089	22085	35862	61.58%	21.42%	35	42
15	高雄市新興區	2018-11-24T23:08:43+08:00	8921	15576	24497	1275	25772	41989	61.38%	21.25%	40	42
15	高雄市新興區	2018-11-24T22:23:20+08:00	8485	14710	23195	1228	24423	39653	61.59%	21.4%	38	42
15	高雄市新興區	2018-11-25T00:23:10+08:00	9445	16428	25873	1336	27209	44355	61.34%	21.29%	42	42
15	高雄市新興區	2018-11-25T03:32:43+08:00	9445	16428	25873	1336	27209	44355	61.34%	21.29%	42	42
15	高雄市新興區	2018-11-24T23:23:44+08:00	9156	15956	25112	1304	26416	43038	61.38%	21.27%	41	42
15	高雄市新興區	2018-11-24T22:33:44+08:00	8701	15133	23834	1250	25084	40888	61.35%	21.28%	39	42
15	高雄市新興區	2018-11-24T22:16:17+08:00	7683	13313	20996	1089	22085	35862	61.58%	21.42%	35	42
15	高雄市新興區	2018-11-25T03:39:00+08:00	9445	16428	25873	1336	27209	44355	61.34%	21.29%	42	42
15	苗栗縣頭份市	2018-11-24T22:26:44+08:00	8928	21399	30327	1493	31820	56224	56.6%	15.88%	50	71
15	苗栗縣頭份市	2018-11-25T00:05:13+08:00	13417	31783	45200	2218	47418	83617	56.71%	16.05%	71	71
15	苗栗縣頭份市	2018-11-24T22:54:32+08:00	10604	25312	35916	1747	37663	66560	56.59%	15.93%	58	71
15	苗栗縣頭份市	2018-11-25T00:09:43+08:00	13417	31783	45200	2218	47418	83617	56.71%	16.05%	71	71
15	苗栗縣頭份市	2018-11-24T22:37:08+08:00	9328	22316	31644	1546	33190	58639	56.6%	15.91%	52	71
15	苗栗縣頭份市	2018-11-24T22:45:15+08:00	10007	23879	33886	1632	35518	62908	56.46%	15.91%	55	71
15	苗栗縣頭份市	2018-11-24T22:50:57+08:00	10426	24907	35333	1731	37064	65544	56.55%	15.91%	57	71
15	苗栗縣頭份市	2018-11-25T01:12:53+08:00	13417	31783	45200	2218	47418	83617	56.71%	16.05%	71	71
15	苗栗縣頭份市	2018-11-24T22:40:35+08:00	9566	22826	32392	1566	33958	59965	56.63%	15.95%	53	71
15	苗栗縣頭份市	2018-11-25T01:02:39+08:00	13417	31783	45200	2218	47418	83617	56.71%	16.05%	71	71
15	苗栗縣頭份市	2018-11-25T04:03:00+08:00	13417	31783	45200	2218	47418	83617	56.71%	16.05%	71	71
15	苗栗縣頭份市	2018-11-25T00:57:45+08:00	13417	31783	45200	2218	47418	83617	56.71%	16.05%	71	71
15	苗栗縣頭份市	2018-11-24T22:19:44+08:00	8235	19714	27949	1384	29333	51919	56.5%	15.86%	46	71
15	苗栗縣頭份市	2018-11-25T06:14:00+08:00	13417	31783	45200	2218	47418	83617	56.71%	16.05%	71	71
15	苗栗縣頭份市	2018-11-25T00:00:18+08:00	13417	31783	45200	2218	47418	83617	56.71%	16.05%	71	71
15	苗栗縣頭份市	2018-11-24T23:27:25+08:00	12762	30333	43095	2128	45223	79874	56.62%	15.98%	68	71
15	苗栗縣頭份市	2018-11-24T23:55:55+08:00	13417	31783	45200	2218	47418	83617	56.71%	16.05%	71	71
15	苗栗縣頭份市	2018-11-25T00:23:12+08:00	13417	31783	45200	2218	47418	83617	56.71%	16.05%	71	71
15	苗栗縣頭份市	2018-11-24T22:23:22+08:00	8579	20616	29195	1456	30651	54197	56.55%	15.83%	48	71
15	苗栗縣頭份市	2018-11-24T23:01:39+08:00	11259	26936	38195	1861	40056	70702	56.65%	15.92%	61	71
15	苗栗縣頭份市	2018-11-24T23:20:00+08:00	12563	29836	42399	2089	44488	78688	56.54%	15.97%	67	71
15	苗栗縣頭份市	2018-11-25T01:07:34+08:00	13417	31783	45200	2218	47418	83617	56.71%	16.05%	71	71
15	苗栗縣頭份市	2018-11-25T00:18:40+08:00	13417	31783	45200	2218	47418	83617	56.71%	16.05%	71	71
15	苗栗縣頭份市	2018-11-25T00:14:18+08:00	13417	31783	45200	2218	47418	83617	56.71%	16.05%	71	71
15	苗栗縣頭份市	2018-11-24T23:12:25+08:00	11779	28018	39797	1971	41768	73680	56.69%	15.99%	64	71
15	苗栗縣頭份市	2018-11-25T03:39:02+08:00	13417	31783	45200	2218	47418	83617	56.71%	16.05%	71	71
15	苗栗縣頭份市	2018-11-24T23:31:20+08:00	12762	30333	43095	2128	45223	79874	56.62%	15.98%	68	71
15	苗栗縣頭份市	2018-11-24T23:35:17+08:00	12986	30835	43821	2155	45976	81138	56.66%	16%	69	71
15	苗栗縣頭份市	2018-11-24T23:43:24+08:00	13227	31340	44567	2189	46756	82476	56.69%	16.04%	70	71
15	苗栗縣頭份市	2018-11-24T22:58:02+08:00	11034	26393	37427	1827	39254	69432	56.54%	15.89%	60	71
15	苗栗縣頭份市	2018-11-25T03:49:58+08:00	13417	31783	45200	2218	47418	83617	56.71%	16.05%	71	71
15	苗栗縣頭份市	2018-11-25T03:56:22+08:00	13417	31783	45200	2218	47418	83617	56.71%	16.05%	71	71
15	苗栗縣頭份市	2018-11-25T06:29:25+08:00	13417	31783	45200	2218	47418	83617	56.71%	16.05%	71	71
15	苗栗縣頭份市	2018-11-25T06:19:05+08:00	13417	31783	45200	2218	47418	83617	56.71%	16.05%	71	71
15	苗栗縣頭份市	2018-11-24T23:05:11+08:00	11259	26936	38195	1861	40056	70702	56.65%	15.92%	61	71
15	苗栗縣頭份市	2018-11-24T22:41:44+08:00	9566	22826	32392	1566	33958	59965	56.63%	15.95%	53	71
15	苗栗縣頭份市	2018-11-25T01:18:03+08:00	13417	31783	45200	2218	47418	83617	56.71%	16.05%	71	71
15	苗栗縣頭份市	2018-11-25T06:09:03+08:00	13417	31783	45200	2218	47418	83617	56.71%	16.05%	71	71
15	苗栗縣頭份市	2018-11-24T23:51:43+08:00	13227	31340	44567	2189	46756	82476	56.69%	16.04%	70	71
15	苗栗縣頭份市	2018-11-25T06:24:08+08:00	13417	31783	45200	2218	47418	83617	56.71%	16.05%	71	71
15	苗栗縣頭份市	2018-11-24T22:30:18+08:00	9158	21863	31021	1510	32531	57510	56.57%	15.92%	51	71
15	苗栗縣頭份市	2018-11-24T23:23:45+08:00	12563	29836	42399	2089	44488	78688	56.54%	15.97%	67	71
15	苗栗縣頭份市	2018-11-25T03:32:45+08:00	13417	31783	45200	2218	47418	83617	56.71%	16.05%	71	71
15	苗栗縣頭份市	2018-11-24T22:13:38+08:00	7297	17636	24933	1210	26143	46524	56.19%	15.68%	42	71
15	苗栗縣頭份市	2018-11-24T23:08:45+08:00	11419	27292	38711	1902	40613	71650	56.68%	15.94%	62	71
15	苗栗縣頭份市	2018-11-25T03:44:33+08:00	13417	31783	45200	2218	47418	83617	56.71%	16.05%	71	71
15	苗栗縣頭份市	2018-11-24T23:16:10+08:00	12068	28643	40711	2004	42715	75439	56.62%	16%	65	71
15	苗栗縣頭份市	2018-11-24T23:47:37+08:00	13227	31340	44567	2189	46756	82476	56.69%	16.04%	70	71
15	苗栗縣頭份市	2018-11-24T22:16:19+08:00	8016	19216	27232	1357	28589	50676	56.42%	15.82%	45	71
15	苗栗縣頭份市	2018-11-24T23:39:26+08:00	12986	30835	43821	2155	45976	81138	56.66%	16%	69	71
15	苗栗縣頭份市	2018-11-25T01:26:01+08:00	13417	31783	45200	2218	47418	83617	56.71%	16.05%	71	71
15	苗栗縣頭份市	2018-11-24T22:33:45+08:00	9328	22316	31644	1546	33190	58639	56.6%	15.91%	52	71
15	苗栗縣造橋鄉	2018-11-24T22:26:44+08:00	1696	4224	5920	499	6419	11027	58.21%	15.38%	12	12
15	苗栗縣造橋鄉	2018-11-25T00:05:13+08:00	1696	4224	5920	499	6419	11027	58.21%	15.38%	12	12
15	苗栗縣造橋鄉	2018-11-24T23:05:12+08:00	1696	4224	5920	499	6419	11027	58.21%	15.38%	12	12
15	苗栗縣造橋鄉	2018-11-25T06:29:26+08:00	1696	4224	5920	499	6419	11027	58.21%	15.38%	12	12
15	苗栗縣造橋鄉	2018-11-25T00:09:43+08:00	1696	4224	5920	499	6419	11027	58.21%	15.38%	12	12
15	苗栗縣造橋鄉	2018-11-24T22:37:08+08:00	1696	4224	5920	499	6419	11027	58.21%	15.38%	12	12
15	苗栗縣造橋鄉	2018-11-24T22:54:33+08:00	1696	4224	5920	499	6419	11027	58.21%	15.38%	12	12
15	苗栗縣造橋鄉	2018-11-24T22:50:57+08:00	1696	4224	5920	499	6419	11027	58.21%	15.38%	12	12
15	苗栗縣造橋鄉	2018-11-25T01:12:53+08:00	1696	4224	5920	499	6419	11027	58.21%	15.38%	12	12
15	苗栗縣造橋鄉	2018-11-24T22:40:35+08:00	1696	4224	5920	499	6419	11027	58.21%	15.38%	12	12
15	苗栗縣造橋鄉	2018-11-25T01:02:39+08:00	1696	4224	5920	499	6419	11027	58.21%	15.38%	12	12
15	苗栗縣造橋鄉	2018-11-25T04:03:00+08:00	1696	4224	5920	499	6419	11027	58.21%	15.38%	12	12
15	苗栗縣造橋鄉	2018-11-25T00:57:45+08:00	1696	4224	5920	499	6419	11027	58.21%	15.38%	12	12
15	苗栗縣造橋鄉	2018-11-24T22:19:44+08:00	1696	4224	5920	499	6419	11027	58.21%	15.38%	12	12
15	苗栗縣造橋鄉	2018-11-25T06:14:00+08:00	1696	4224	5920	499	6419	11027	58.21%	15.38%	12	12
15	苗栗縣造橋鄉	2018-11-24T23:23:46+08:00	1696	4224	5920	499	6419	11027	58.21%	15.38%	12	12
15	苗栗縣造橋鄉	2018-11-24T22:23:23+08:00	1696	4224	5920	499	6419	11027	58.21%	15.38%	12	12
15	苗栗縣造橋鄉	2018-11-25T03:32:46+08:00	1696	4224	5920	499	6419	11027	58.21%	15.38%	12	12
15	苗栗縣造橋鄉	2018-11-24T23:55:55+08:00	1696	4224	5920	499	6419	11027	58.21%	15.38%	12	12
15	苗栗縣造橋鄉	2018-11-25T00:00:19+08:00	1696	4224	5920	499	6419	11027	58.21%	15.38%	12	12
15	苗栗縣造橋鄉	2018-11-25T00:23:12+08:00	1696	4224	5920	499	6419	11027	58.21%	15.38%	12	12
15	苗栗縣造橋鄉	2018-11-24T23:01:39+08:00	1696	4224	5920	499	6419	11027	58.21%	15.38%	12	12
15	苗栗縣造橋鄉	2018-11-24T23:31:21+08:00	1696	4224	5920	499	6419	11027	58.21%	15.38%	12	12
15	苗栗縣造橋鄉	2018-11-24T23:20:00+08:00	1696	4224	5920	499	6419	11027	58.21%	15.38%	12	12
15	苗栗縣造橋鄉	2018-11-25T01:07:34+08:00	1696	4224	5920	499	6419	11027	58.21%	15.38%	12	12
15	苗栗縣造橋鄉	2018-11-24T23:35:18+08:00	1696	4224	5920	499	6419	11027	58.21%	15.38%	12	12
15	苗栗縣造橋鄉	2018-11-25T00:14:18+08:00	1696	4224	5920	499	6419	11027	58.21%	15.38%	12	12
15	苗栗縣造橋鄉	2018-11-24T23:12:25+08:00	1696	4224	5920	499	6419	11027	58.21%	15.38%	12	12
15	苗栗縣造橋鄉	2018-11-25T03:39:02+08:00	1696	4224	5920	499	6419	11027	58.21%	15.38%	12	12
15	苗栗縣造橋鄉	2018-11-24T22:33:46+08:00	1696	4224	5920	499	6419	11027	58.21%	15.38%	12	12
15	苗栗縣造橋鄉	2018-11-25T00:18:41+08:00	1696	4224	5920	499	6419	11027	58.21%	15.38%	12	12
15	苗栗縣造橋鄉	2018-11-24T22:41:45+08:00	1696	4224	5920	499	6419	11027	58.21%	15.38%	12	12
15	苗栗縣造橋鄉	2018-11-25T03:56:22+08:00	1696	4224	5920	499	6419	11027	58.21%	15.38%	12	12
15	苗栗縣造橋鄉	2018-11-25T06:19:05+08:00	1696	4224	5920	499	6419	11027	58.21%	15.38%	12	12
15	苗栗縣造橋鄉	2018-11-24T22:45:16+08:00	1696	4224	5920	499	6419	11027	58.21%	15.38%	12	12
15	苗栗縣造橋鄉	2018-11-24T23:43:25+08:00	1696	4224	5920	499	6419	11027	58.21%	15.38%	12	12
15	苗栗縣造橋鄉	2018-11-25T01:18:03+08:00	1696	4224	5920	499	6419	11027	58.21%	15.38%	12	12
15	苗栗縣造橋鄉	2018-11-25T03:49:59+08:00	1696	4224	5920	499	6419	11027	58.21%	15.38%	12	12
15	苗栗縣造橋鄉	2018-11-24T22:58:03+08:00	1696	4224	5920	499	6419	11027	58.21%	15.38%	12	12
15	苗栗縣造橋鄉	2018-11-25T06:09:03+08:00	1696	4224	5920	499	6419	11027	58.21%	15.38%	12	12
15	苗栗縣造橋鄉	2018-11-24T23:51:43+08:00	1696	4224	5920	499	6419	11027	58.21%	15.38%	12	12
15	苗栗縣造橋鄉	2018-11-25T06:24:08+08:00	1696	4224	5920	499	6419	11027	58.21%	15.38%	12	12
15	苗栗縣造橋鄉	2018-11-24T22:30:18+08:00	1696	4224	5920	499	6419	11027	58.21%	15.38%	12	12
15	苗栗縣造橋鄉	2018-11-24T23:27:26+08:00	1696	4224	5920	499	6419	11027	58.21%	15.38%	12	12
15	苗栗縣造橋鄉	2018-11-24T23:08:45+08:00	1696	4224	5920	499	6419	11027	58.21%	15.38%	12	12
15	苗栗縣造橋鄉	2018-11-24T22:13:39+08:00	1696	4224	5920	499	6419	11027	58.21%	15.38%	12	12
15	苗栗縣造橋鄉	2018-11-25T03:44:33+08:00	1696	4224	5920	499	6419	11027	58.21%	15.38%	12	12
15	苗栗縣造橋鄉	2018-11-24T23:47:37+08:00	1696	4224	5920	499	6419	11027	58.21%	15.38%	12	12
15	苗栗縣造橋鄉	2018-11-24T23:39:26+08:00	1696	4224	5920	499	6419	11027	58.21%	15.38%	12	12
15	苗栗縣造橋鄉	2018-11-24T23:16:11+08:00	1696	4224	5920	499	6419	11027	58.21%	15.38%	12	12
15	苗栗縣造橋鄉	2018-11-25T01:26:01+08:00	1696	4224	5920	499	6419	11027	58.21%	15.38%	12	12
15	苗栗縣造橋鄉	2018-11-24T22:16:20+08:00	1696	4224	5920	499	6419	11027	58.21%	15.38%	12	12
15	澎湖縣七美鄉	2018-11-25T03:56:28+08:00	326	614	940	78	1018	3374	30.17%	9.66%	6	6
15	澎湖縣七美鄉	2018-11-24T23:47:43+08:00	326	614	940	78	1018	3374	30.17%	9.66%	6	6
15	澎湖縣七美鄉	2018-11-24T22:58:09+08:00	326	614	940	78	1018	3374	30.17%	9.66%	6	6
15	澎湖縣七美鄉	2018-11-24T23:56:01+08:00	326	614	940	78	1018	3374	30.17%	9.66%	6	6
15	澎湖縣七美鄉	2018-11-24T23:01:46+08:00	326	614	940	78	1018	3374	30.17%	9.66%	6	6
15	澎湖縣七美鄉	2018-11-24T23:12:30+08:00	326	614	940	78	1018	3374	30.17%	9.66%	6	6
15	澎湖縣七美鄉	2018-11-25T03:32:53+08:00	326	614	940	78	1018	3374	30.17%	9.66%	6	6
15	澎湖縣七美鄉	2018-11-24T23:51:49+08:00	326	614	940	78	1018	3374	30.17%	9.66%	6	6
15	澎湖縣七美鄉	2018-11-24T22:13:45+08:00	223	414	637	62	699	2203	31.73%	10.12%	5	6
15	澎湖縣七美鄉	2018-11-25T03:44:41+08:00	326	614	940	78	1018	3374	30.17%	9.66%	6	6
15	澎湖縣七美鄉	2018-11-25T04:03:06+08:00	326	614	940	78	1018	3374	30.17%	9.66%	6	6
15	澎湖縣七美鄉	2018-11-24T23:27:31+08:00	326	614	940	78	1018	3374	30.17%	9.66%	6	6
15	澎湖縣七美鄉	2018-11-24T22:30:23+08:00	223	414	637	62	699	2203	31.73%	10.12%	5	6
15	澎湖縣七美鄉	2018-11-25T00:57:51+08:00	326	614	940	78	1018	3374	30.17%	9.66%	6	6
15	澎湖縣七美鄉	2018-11-24T22:19:50+08:00	223	414	637	62	699	2203	31.73%	10.12%	5	6
15	澎湖縣七美鄉	2018-11-25T00:09:50+08:00	326	614	940	78	1018	3374	30.17%	9.66%	6	6
15	澎湖縣七美鄉	2018-11-25T00:18:47+08:00	326	614	940	78	1018	3374	30.17%	9.66%	6	6
15	澎湖縣七美鄉	2018-11-24T22:37:14+08:00	326	614	940	78	1018	3374	30.17%	9.66%	6	6
15	澎湖縣七美鄉	2018-11-24T23:20:08+08:00	326	614	940	78	1018	3374	30.17%	9.66%	6	6
15	澎湖縣七美鄉	2018-11-24T23:31:27+08:00	326	614	940	78	1018	3374	30.17%	9.66%	6	6
15	澎湖縣七美鄉	2018-11-24T22:45:21+08:00	326	614	940	78	1018	3374	30.17%	9.66%	6	6
15	澎湖縣七美鄉	2018-11-24T22:54:38+08:00	326	614	940	78	1018	3374	30.17%	9.66%	6	6
15	澎湖縣七美鄉	2018-11-24T22:33:51+08:00	223	414	637	62	699	2203	31.73%	10.12%	5	6
15	澎湖縣七美鄉	2018-11-24T23:39:33+08:00	326	614	940	78	1018	3374	30.17%	9.66%	6	6
15	澎湖縣七美鄉	2018-11-24T23:05:16+08:00	326	614	940	78	1018	3374	30.17%	9.66%	6	6
15	澎湖縣七美鄉	2018-11-24T22:26:49+08:00	223	414	637	62	699	2203	31.73%	10.12%	5	6
15	澎湖縣七美鄉	2018-11-25T01:07:40+08:00	326	614	940	78	1018	3374	30.17%	9.66%	6	6
15	澎湖縣七美鄉	2018-11-25T01:12:59+08:00	326	614	940	78	1018	3374	30.17%	9.66%	6	6
15	澎湖縣七美鄉	2018-11-25T00:05:18+08:00	326	614	940	78	1018	3374	30.17%	9.66%	6	6
15	澎湖縣七美鄉	2018-11-24T23:08:51+08:00	326	614	940	78	1018	3374	30.17%	9.66%	6	6
15	澎湖縣七美鄉	2018-11-24T23:23:51+08:00	326	614	940	78	1018	3374	30.17%	9.66%	6	6
15	澎湖縣七美鄉	2018-11-24T22:23:29+08:00	223	414	637	62	699	2203	31.73%	10.12%	5	6
15	澎湖縣七美鄉	2018-11-25T00:23:17+08:00	326	614	940	78	1018	3374	30.17%	9.66%	6	6
15	澎湖縣七美鄉	2018-11-25T00:00:24+08:00	326	614	940	78	1018	3374	30.17%	9.66%	6	6
15	澎湖縣七美鄉	2018-11-24T22:51:04+08:00	326	614	940	78	1018	3374	30.17%	9.66%	6	6
15	澎湖縣七美鄉	2018-11-25T06:09:10+08:00	326	614	940	78	1018	3374	30.17%	9.66%	6	6
15	澎湖縣七美鄉	2018-11-25T06:24:14+08:00	326	614	940	78	1018	3374	30.17%	9.66%	6	6
15	澎湖縣七美鄉	2018-11-24T22:40:40+08:00	326	614	940	78	1018	3374	30.17%	9.66%	6	6
15	澎湖縣七美鄉	2018-11-25T01:02:44+08:00	326	614	940	78	1018	3374	30.17%	9.66%	6	6
15	澎湖縣七美鄉	2018-11-25T06:14:05+08:00	326	614	940	78	1018	3374	30.17%	9.66%	6	6
15	澎湖縣七美鄉	2018-11-25T06:19:10+08:00	326	614	940	78	1018	3374	30.17%	9.66%	6	6
15	澎湖縣七美鄉	2018-11-24T23:35:23+08:00	326	614	940	78	1018	3374	30.17%	9.66%	6	6
15	澎湖縣七美鄉	2018-11-25T00:14:24+08:00	326	614	940	78	1018	3374	30.17%	9.66%	6	6
15	澎湖縣七美鄉	2018-11-25T01:18:10+08:00	326	614	940	78	1018	3374	30.17%	9.66%	6	6
15	澎湖縣七美鄉	2018-11-25T03:50:04+08:00	326	614	940	78	1018	3374	30.17%	9.66%	6	6
15	澎湖縣七美鄉	2018-11-24T22:16:26+08:00	223	414	637	62	699	2203	31.73%	10.12%	5	6
15	澎湖縣七美鄉	2018-11-24T23:43:31+08:00	326	614	940	78	1018	3374	30.17%	9.66%	6	6
15	澎湖縣七美鄉	2018-11-25T06:29:31+08:00	326	614	940	78	1018	3374	30.17%	9.66%	6	6
15	澎湖縣七美鄉	2018-11-24T23:16:16+08:00	326	614	940	78	1018	3374	30.17%	9.66%	6	6
15	澎湖縣七美鄉	2018-11-24T22:41:51+08:00	326	614	940	78	1018	3374	30.17%	9.66%	6	6
15	澎湖縣七美鄉	2018-11-25T03:39:08+08:00	326	614	940	78	1018	3374	30.17%	9.66%	6	6
15	澎湖縣七美鄉	2018-11-25T01:26:08+08:00	326	614	940	78	1018	3374	30.17%	9.66%	6	6
15	桃園市蘆竹區	2018-11-24T23:16:06+08:00	18705	36101	54806	2832	57638	112297	51.33%	16.66%	68	76
15	桃園市蘆竹區	2018-11-24T23:43:20+08:00	20321	38110	58431	3010	61441	119779	51.3%	16.97%	72	76
15	桃園市蘆竹區	2018-11-25T06:13:55+08:00	21787	40963	62750	3168	65918	129252	51%	16.86%	76	76
15	桃園市蘆竹區	2018-11-25T06:19:00+08:00	21787	40963	62750	3168	65918	129252	51%	16.86%	76	76
15	桃園市蘆竹區	2018-11-25T06:29:20+08:00	21787	40963	62750	3168	65918	129252	51%	16.86%	76	76
15	桃園市蘆竹區	2018-11-25T03:49:54+08:00	21787	40963	62750	3168	65918	129252	51%	16.86%	76	76
15	桃園市蘆竹區	2018-11-25T03:56:16+08:00	21787	40963	62750	3168	65918	129252	51%	16.86%	76	76
15	桃園市蘆竹區	2018-11-25T01:07:29+08:00	21787	40963	62750	3168	65918	129252	51%	16.86%	76	76
15	桃園市蘆竹區	2018-11-24T22:30:13+08:00	14735	28038	42773	2260	45033	87165	51.66%	16.9%	55	76
15	桃園市蘆竹區	2018-11-25T06:24:03+08:00	21787	40963	62750	3168	65918	129252	51%	16.86%	76	76
15	桃園市蘆竹區	2018-11-25T03:32:38+08:00	21787	40963	62750	3168	65918	129252	51%	16.86%	76	76
15	桃園市蘆竹區	2018-11-25T01:25:56+08:00	21787	40963	62750	3168	65918	129252	51%	16.86%	76	76
15	桃園市蘆竹區	2018-11-25T00:23:07+08:00	21787	40963	62750	3168	65918	129252	51%	16.86%	76	76
15	桃園市蘆竹區	2018-11-24T23:51:39+08:00	21357	40116	61473	3130	64603	126525	51.06%	16.88%	75	76
15	桃園市蘆竹區	2018-11-24T23:23:41+08:00	19290	37172	56462	2924	59386	115697	51.33%	16.67%	70	76
15	桃園市蘆竹區	2018-11-25T01:17:57+08:00	21787	40963	62750	3168	65918	129252	51%	16.86%	76	76
15	桃園市蘆竹區	2018-11-24T23:08:40+08:00	18304	35298	53602	2786	56388	109775	51.37%	16.67%	67	76
15	桃園市蘆竹區	2018-11-24T22:57:58+08:00	17869	34050	51919	2722	54641	106113	51.49%	16.84%	65	76
15	桃園市蘆竹區	2018-11-25T06:08:57+08:00	21787	40963	62750	3168	65918	129252	51%	16.86%	76	76
15	桃園市蘆竹區	2018-11-24T22:54:29+08:00	17584	33521	51105	2689	53794	104366	51.54%	16.85%	64	76
15	桃園市蘆竹區	2018-11-25T01:12:47+08:00	21787	40963	62750	3168	65918	129252	51%	16.86%	76	76
15	桃園市蘆竹區	2018-11-24T22:16:14+08:00	13353	25286	38639	2002	40641	77939	52.14%	17.13%	50	76
15	桃園市蘆竹區	2018-11-25T00:05:08+08:00	21787	40963	62750	3168	65918	129252	51%	16.86%	76	76
15	桃園市蘆竹區	2018-11-24T23:05:07+08:00	18304	35298	53602	2786	56388	109775	51.37%	16.67%	67	76
15	桃園市蘆竹區	2018-11-24T22:33:41+08:00	15397	29159	44556	2338	46894	90966	51.55%	16.93%	57	76
15	桃園市蘆竹區	2018-11-24T23:47:32+08:00	20321	38110	58431	3010	61441	119779	51.3%	16.97%	72	76
15	桃園市蘆竹區	2018-11-24T22:41:39+08:00	16263	30916	47179	2547	49726	96367	51.6%	16.88%	60	76
15	桃園市蘆竹區	2018-11-24T22:37:04+08:00	15994	30361	46355	2527	48882	94734	51.6%	16.88%	59	76
15	桃園市蘆竹區	2018-11-25T00:18:34+08:00	21787	40963	62750	3168	65918	129252	51%	16.86%	76	76
15	桃園市蘆竹區	2018-11-24T22:50:52+08:00	16950	32306	49256	2628	51884	100756	51.49%	16.82%	62	76
15	桃園市蘆竹區	2018-11-24T22:26:40+08:00	14445	27529	41974	2211	44185	85607	51.61%	16.87%	54	76
15	桃園市蘆竹區	2018-11-24T22:45:11+08:00	16263	30916	47179	2547	49726	96367	51.6%	16.88%	60	76
15	桃園市蘆竹區	2018-11-25T00:57:40+08:00	21787	40963	62750	3168	65918	129252	51%	16.86%	76	76
15	桃園市蘆竹區	2018-11-24T22:40:31+08:00	16263	30916	47179	2547	49726	96367	51.6%	16.88%	60	76
15	桃園市蘆竹區	2018-11-25T03:44:27+08:00	21787	40963	62750	3168	65918	129252	51%	16.86%	76	76
15	桃園市蘆竹區	2018-11-24T22:19:40+08:00	13693	25892	39585	2037	41622	79968	52.05%	17.12%	51	76
15	桃園市蘆竹區	2018-11-25T01:02:34+08:00	21787	40963	62750	3168	65918	129252	51%	16.86%	76	76
15	桃園市蘆竹區	2018-11-25T03:38:58+08:00	21787	40963	62750	3168	65918	129252	51%	16.86%	76	76
15	桃園市蘆竹區	2018-11-24T22:13:31+08:00	12849	24244	37093	1947	39040	75063	52.01%	17.12%	48	76
15	桃園市蘆竹區	2018-11-24T23:27:21+08:00	19290	37172	56462	2924	59386	115697	51.33%	16.67%	70	76
15	桃園市蘆竹區	2018-11-24T23:55:50+08:00	21357	40116	61473	3130	64603	126525	51.06%	16.88%	75	76
15	桃園市蘆竹區	2018-11-24T22:23:17+08:00	13950	26420	40370	2109	42479	81800	51.93%	17.05%	52	76
15	桃園市蘆竹區	2018-11-24T23:19:55+08:00	19029	36624	55653	2866	58519	114165	51.26%	16.67%	69	76
15	桃園市蘆竹區	2018-11-25T00:00:14+08:00	21787	40963	62750	3168	65918	129252	51%	16.86%	76	76
15	桃園市蘆竹區	2018-11-25T04:02:55+08:00	21787	40963	62750	3168	65918	129252	51%	16.86%	76	76
15	桃園市蘆竹區	2018-11-25T00:09:38+08:00	21787	40963	62750	3168	65918	129252	51%	16.86%	76	76
15	桃園市蘆竹區	2018-11-24T23:01:34+08:00	18202	34728	52930	2745	55675	108328	51.39%	16.8%	66	76
15	桃園市蘆竹區	2018-11-24T23:35:14+08:00	20321	38110	58431	3010	61441	119779	51.3%	16.97%	72	76
15	桃園市蘆竹區	2018-11-25T00:14:13+08:00	21787	40963	62750	3168	65918	129252	51%	16.86%	76	76
15	桃園市蘆竹區	2018-11-24T23:12:19+08:00	18304	35298	53602	2786	56388	109775	51.37%	16.67%	67	76
15	桃園市蘆竹區	2018-11-24T23:31:15+08:00	19608	37775	57383	2957	60340	117590	51.31%	16.67%	71	76
15	桃園市蘆竹區	2018-11-24T23:39:20+08:00	20321	38110	58431	3010	61441	119779	51.3%	16.97%	72	76
15	屏東縣麟洛鄉	2018-11-24T22:58:06+08:00	2021	3381	5402	362	5764	9970	57.81%	20.27%	10	10
15	屏東縣麟洛鄉	2018-11-25T06:19:08+08:00	2021	3381	5402	362	5764	9970	57.81%	20.27%	10	10
15	屏東縣麟洛鄉	2018-11-25T06:29:28+08:00	2021	3381	5402	362	5764	9970	57.81%	20.27%	10	10
15	屏東縣麟洛鄉	2018-11-24T23:43:27+08:00	2021	3381	5402	362	5764	9970	57.81%	20.27%	10	10
15	屏東縣麟洛鄉	2018-11-24T22:54:35+08:00	2021	3381	5402	362	5764	9970	57.81%	20.27%	10	10
15	屏東縣麟洛鄉	2018-11-24T22:41:48+08:00	2021	3381	5402	362	5764	9970	57.81%	20.27%	10	10
15	屏東縣麟洛鄉	2018-11-24T23:05:14+08:00	2021	3381	5402	362	5764	9970	57.81%	20.27%	10	10
15	屏東縣麟洛鄉	2018-11-25T01:18:07+08:00	2021	3381	5402	362	5764	9970	57.81%	20.27%	10	10
15	屏東縣麟洛鄉	2018-11-24T22:13:42+08:00	1765	2832	4597	335	4932	8584	57.46%	20.56%	9	10
15	屏東縣麟洛鄉	2018-11-24T23:51:46+08:00	2021	3381	5402	362	5764	9970	57.81%	20.27%	10	10
15	屏東縣麟洛鄉	2018-11-25T06:09:06+08:00	2021	3381	5402	362	5764	9970	57.81%	20.27%	10	10
15	屏東縣麟洛鄉	2018-11-25T06:24:11+08:00	2021	3381	5402	362	5764	9970	57.81%	20.27%	10	10
15	屏東縣麟洛鄉	2018-11-24T23:23:48+08:00	2021	3381	5402	362	5764	9970	57.81%	20.27%	10	10
15	屏東縣麟洛鄉	2018-11-25T03:44:38+08:00	2021	3381	5402	362	5764	9970	57.81%	20.27%	10	10
15	屏東縣麟洛鄉	2018-11-25T00:23:15+08:00	2021	3381	5402	362	5764	9970	57.81%	20.27%	10	10
15	屏東縣麟洛鄉	2018-11-25T00:00:21+08:00	2021	3381	5402	362	5764	9970	57.81%	20.27%	10	10
15	屏東縣麟洛鄉	2018-11-24T22:51:00+08:00	2021	3381	5402	362	5764	9970	57.81%	20.27%	10	10
15	屏東縣麟洛鄉	2018-11-25T03:32:49+08:00	2021	3381	5402	362	5764	9970	57.81%	20.27%	10	10
15	屏東縣麟洛鄉	2018-11-24T23:08:48+08:00	2021	3381	5402	362	5764	9970	57.81%	20.27%	10	10
15	屏東縣麟洛鄉	2018-11-24T23:16:13+08:00	2021	3381	5402	362	5764	9970	57.81%	20.27%	10	10
15	屏東縣麟洛鄉	2018-11-24T23:35:20+08:00	2021	3381	5402	362	5764	9970	57.81%	20.27%	10	10
15	屏東縣麟洛鄉	2018-11-25T01:26:05+08:00	2021	3381	5402	362	5764	9970	57.81%	20.27%	10	10
15	屏東縣麟洛鄉	2018-11-25T03:39:05+08:00	2021	3381	5402	362	5764	9970	57.81%	20.27%	10	10
15	屏東縣麟洛鄉	2018-11-24T22:33:48+08:00	2021	3381	5402	362	5764	9970	57.81%	20.27%	10	10
15	屏東縣麟洛鄉	2018-11-25T03:50:01+08:00	2021	3381	5402	362	5764	9970	57.81%	20.27%	10	10
15	屏東縣麟洛鄉	2018-11-24T22:16:23+08:00	1765	2832	4597	335	4932	8584	57.46%	20.56%	9	10
15	屏東縣麟洛鄉	2018-11-25T00:14:21+08:00	2021	3381	5402	362	5764	9970	57.81%	20.27%	10	10
15	屏東縣麟洛鄉	2018-11-25T01:12:56+08:00	2021	3381	5402	362	5764	9970	57.81%	20.27%	10	10
15	屏東縣麟洛鄉	2018-11-24T23:47:40+08:00	2021	3381	5402	362	5764	9970	57.81%	20.27%	10	10
15	屏東縣麟洛鄉	2018-11-24T23:01:43+08:00	2021	3381	5402	362	5764	9970	57.81%	20.27%	10	10
15	屏東縣麟洛鄉	2018-11-25T03:56:25+08:00	2021	3381	5402	362	5764	9970	57.81%	20.27%	10	10
15	屏東縣麟洛鄉	2018-11-24T22:45:18+08:00	2021	3381	5402	362	5764	9970	57.81%	20.27%	10	10
15	屏東縣麟洛鄉	2018-11-25T00:09:47+08:00	2021	3381	5402	362	5764	9970	57.81%	20.27%	10	10
15	屏東縣麟洛鄉	2018-11-24T22:26:46+08:00	2021	3381	5402	362	5764	9970	57.81%	20.27%	10	10
15	屏東縣麟洛鄉	2018-11-25T00:05:16+08:00	2021	3381	5402	362	5764	9970	57.81%	20.27%	10	10
15	屏東縣麟洛鄉	2018-11-24T22:30:21+08:00	2021	3381	5402	362	5764	9970	57.81%	20.27%	10	10
15	屏東縣麟洛鄉	2018-11-24T22:40:38+08:00	2021	3381	5402	362	5764	9970	57.81%	20.27%	10	10
15	屏東縣麟洛鄉	2018-11-25T04:03:03+08:00	2021	3381	5402	362	5764	9970	57.81%	20.27%	10	10
15	屏東縣麟洛鄉	2018-11-25T00:57:48+08:00	2021	3381	5402	362	5764	9970	57.81%	20.27%	10	10
15	屏東縣麟洛鄉	2018-11-24T22:19:47+08:00	1765	2832	4597	335	4932	8584	57.46%	20.56%	9	10
15	屏東縣麟洛鄉	2018-11-24T23:27:28+08:00	2021	3381	5402	362	5764	9970	57.81%	20.27%	10	10
15	屏東縣麟洛鄉	2018-11-25T01:02:42+08:00	2021	3381	5402	362	5764	9970	57.81%	20.27%	10	10
15	屏東縣麟洛鄉	2018-11-25T06:14:03+08:00	2021	3381	5402	362	5764	9970	57.81%	20.27%	10	10
15	屏東縣麟洛鄉	2018-11-24T22:23:26+08:00	2021	3381	5402	362	5764	9970	57.81%	20.27%	10	10
15	屏東縣麟洛鄉	2018-11-24T23:55:58+08:00	2021	3381	5402	362	5764	9970	57.81%	20.27%	10	10
15	屏東縣麟洛鄉	2018-11-25T00:18:44+08:00	2021	3381	5402	362	5764	9970	57.81%	20.27%	10	10
15	屏東縣麟洛鄉	2018-11-24T23:20:03+08:00	2021	3381	5402	362	5764	9970	57.81%	20.27%	10	10
15	屏東縣麟洛鄉	2018-11-25T01:07:37+08:00	2021	3381	5402	362	5764	9970	57.81%	20.27%	10	10
15	屏東縣麟洛鄉	2018-11-24T22:37:11+08:00	2021	3381	5402	362	5764	9970	57.81%	20.27%	10	10
15	屏東縣麟洛鄉	2018-11-24T23:39:29+08:00	2021	3381	5402	362	5764	9970	57.81%	20.27%	10	10
15	屏東縣麟洛鄉	2018-11-24T23:12:28+08:00	2021	3381	5402	362	5764	9970	57.81%	20.27%	10	10
15	屏東縣麟洛鄉	2018-11-24T23:31:24+08:00	2021	3381	5402	362	5764	9970	57.81%	20.27%	10	10
15	臺南市玉井區	2018-11-24T23:16:08+08:00	1665	3878	5543	462	6005	12357	48.6%	13.47%	16	16
15	臺南市玉井區	2018-11-25T03:56:19+08:00	1665	3878	5543	462	6005	12357	48.6%	13.47%	16	16
15	臺南市玉井區	2018-11-24T22:41:41+08:00	1665	3878	5543	462	6005	12357	48.6%	13.47%	16	16
15	臺南市玉井區	2018-11-25T00:18:37+08:00	1665	3878	5543	462	6005	12357	48.6%	13.47%	16	16
15	臺南市玉井區	2018-11-24T22:45:13+08:00	1567	3657	5224	437	5661	11659	48.55%	13.44%	15	16
15	臺南市玉井區	2018-11-24T22:58:00+08:00	1567	3657	5224	437	5661	11659	48.55%	13.44%	15	16
15	臺南市玉井區	2018-11-24T22:37:06+08:00	1665	3878	5543	462	6005	12357	48.6%	13.47%	16	16
15	臺南市玉井區	2018-11-24T22:40:32+08:00	1665	3878	5543	462	6005	12357	48.6%	13.47%	16	16
15	臺南市玉井區	2018-11-25T01:02:36+08:00	1665	3878	5543	462	6005	12357	48.6%	13.47%	16	16
15	臺南市玉井區	2018-11-24T22:19:42+08:00	1665	3878	5543	462	6005	12357	48.6%	13.47%	16	16
15	臺南市玉井區	2018-11-25T01:25:58+08:00	1665	3878	5543	462	6005	12357	48.6%	13.47%	16	16
15	臺南市玉井區	2018-11-24T22:30:15+08:00	1665	3878	5543	462	6005	12357	48.6%	13.47%	16	16
15	臺南市玉井區	2018-11-24T23:51:41+08:00	1665	3878	5543	462	6005	12357	48.6%	13.47%	16	16
15	臺南市玉井區	2018-11-25T00:23:09+08:00	1665	3878	5543	462	6005	12357	48.6%	13.47%	16	16
15	臺南市玉井區	2018-11-25T00:57:42+08:00	1665	3878	5543	462	6005	12357	48.6%	13.47%	16	16
15	臺南市玉井區	2018-11-25T06:24:05+08:00	1665	3878	5543	462	6005	12357	48.6%	13.47%	16	16
15	臺南市玉井區	2018-11-25T00:00:16+08:00	1665	3878	5543	462	6005	12357	48.6%	13.47%	16	16
15	臺南市玉井區	2018-11-25T01:17:59+08:00	1665	3878	5543	462	6005	12357	48.6%	13.47%	16	16
15	臺南市玉井區	2018-11-24T23:19:57+08:00	1665	3878	5543	462	6005	12357	48.6%	13.47%	16	16
15	臺南市玉井區	2018-11-24T23:55:52+08:00	1665	3878	5543	462	6005	12357	48.6%	13.47%	16	16
15	臺南市玉井區	2018-11-24T22:13:34+08:00	1665	3878	5543	462	6005	12357	48.6%	13.47%	16	16
15	臺南市玉井區	2018-11-24T23:27:23+08:00	1665	3878	5543	462	6005	12357	48.6%	13.47%	16	16
15	臺南市玉井區	2018-11-25T03:44:30+08:00	1665	3878	5543	462	6005	12357	48.6%	13.47%	16	16
15	臺南市玉井區	2018-11-24T23:39:22+08:00	1665	3878	5543	462	6005	12357	48.6%	13.47%	16	16
15	臺南市玉井區	2018-11-25T06:08:59+08:00	1665	3878	5543	462	6005	12357	48.6%	13.47%	16	16
15	臺南市玉井區	2018-11-24T23:31:17+08:00	1665	3878	5543	462	6005	12357	48.6%	13.47%	16	16
15	臺南市玉井區	2018-11-25T04:02:58+08:00	1665	3878	5543	462	6005	12357	48.6%	13.47%	16	16
15	臺南市玉井區	2018-11-24T23:47:34+08:00	1665	3878	5543	462	6005	12357	48.6%	13.47%	16	16
15	臺南市玉井區	2018-11-24T23:05:09+08:00	1665	3878	5543	462	6005	12357	48.6%	13.47%	16	16
15	臺南市玉井區	2018-11-24T23:01:36+08:00	1665	3878	5543	462	6005	12357	48.6%	13.47%	16	16
15	臺南市玉井區	2018-11-25T01:07:32+08:00	1665	3878	5543	462	6005	12357	48.6%	13.47%	16	16
15	臺南市玉井區	2018-11-25T00:05:10+08:00	1665	3878	5543	462	6005	12357	48.6%	13.47%	16	16
15	臺南市玉井區	2018-11-25T06:19:02+08:00	1665	3878	5543	462	6005	12357	48.6%	13.47%	16	16
15	臺南市玉井區	2018-11-25T03:49:56+08:00	1665	3878	5543	462	6005	12357	48.6%	13.47%	16	16
15	臺南市玉井區	2018-11-24T22:54:30+08:00	1567	3657	5224	437	5661	11659	48.55%	13.44%	15	16
15	臺南市玉井區	2018-11-24T22:50:54+08:00	1567	3657	5224	437	5661	11659	48.55%	13.44%	15	16
15	臺南市玉井區	2018-11-25T06:13:57+08:00	1665	3878	5543	462	6005	12357	48.6%	13.47%	16	16
15	臺南市玉井區	2018-11-25T01:12:50+08:00	1665	3878	5543	462	6005	12357	48.6%	13.47%	16	16
15	臺南市玉井區	2018-11-24T23:43:22+08:00	1665	3878	5543	462	6005	12357	48.6%	13.47%	16	16
15	臺南市玉井區	2018-11-25T00:09:40+08:00	1665	3878	5543	462	6005	12357	48.6%	13.47%	16	16
15	臺南市玉井區	2018-11-25T06:29:23+08:00	1665	3878	5543	462	6005	12357	48.6%	13.47%	16	16
15	臺南市玉井區	2018-11-24T22:26:41+08:00	1665	3878	5543	462	6005	12357	48.6%	13.47%	16	16
15	臺南市玉井區	2018-11-25T03:32:42+08:00	1665	3878	5543	462	6005	12357	48.6%	13.47%	16	16
15	臺南市玉井區	2018-11-24T23:08:42+08:00	1665	3878	5543	462	6005	12357	48.6%	13.47%	16	16
15	臺南市玉井區	2018-11-24T22:23:19+08:00	1665	3878	5543	462	6005	12357	48.6%	13.47%	16	16
15	臺南市玉井區	2018-11-24T23:23:43+08:00	1665	3878	5543	462	6005	12357	48.6%	13.47%	16	16
15	臺南市玉井區	2018-11-25T00:14:15+08:00	1665	3878	5543	462	6005	12357	48.6%	13.47%	16	16
15	臺南市玉井區	2018-11-24T23:35:15+08:00	1665	3878	5543	462	6005	12357	48.6%	13.47%	16	16
15	臺南市玉井區	2018-11-24T22:33:43+08:00	1665	3878	5543	462	6005	12357	48.6%	13.47%	16	16
15	臺南市玉井區	2018-11-25T03:39:00+08:00	1665	3878	5543	462	6005	12357	48.6%	13.47%	16	16
15	臺南市玉井區	2018-11-24T23:12:21+08:00	1665	3878	5543	462	6005	12357	48.6%	13.47%	16	16
15	臺南市玉井區	2018-11-24T22:16:16+08:00	1665	3878	5543	462	6005	12357	48.6%	13.47%	16	16
15	屏東縣新園鄉	2018-11-24T22:58:06+08:00	4787	9799	14586	1559	16145	30706	52.58%	15.59%	28	28
15	屏東縣新園鄉	2018-11-25T06:19:08+08:00	4787	9799	14586	1559	16145	30706	52.58%	15.59%	28	28
15	屏東縣新園鄉	2018-11-24T23:39:30+08:00	4787	9799	14586	1559	16145	30706	52.58%	15.59%	28	28
15	屏東縣新園鄉	2018-11-24T22:54:35+08:00	4787	9799	14586	1559	16145	30706	52.58%	15.59%	28	28
15	屏東縣新園鄉	2018-11-24T22:41:48+08:00	4787	9799	14586	1559	16145	30706	52.58%	15.59%	28	28
15	屏東縣新園鄉	2018-11-24T23:05:14+08:00	4787	9799	14586	1559	16145	30706	52.58%	15.59%	28	28
15	屏東縣新園鄉	2018-11-25T06:29:29+08:00	4787	9799	14586	1559	16145	30706	52.58%	15.59%	28	28
15	屏東縣新園鄉	2018-11-25T01:18:07+08:00	4787	9799	14586	1559	16145	30706	52.58%	15.59%	28	28
15	屏東縣新園鄉	2018-11-24T23:43:28+08:00	4787	9799	14586	1559	16145	30706	52.58%	15.59%	28	28
15	屏東縣新園鄉	2018-11-25T06:09:07+08:00	4787	9799	14586	1559	16145	30706	52.58%	15.59%	28	28
15	屏東縣新園鄉	2018-11-24T22:13:42+08:00	4787	9799	14586	1559	16145	30706	52.58%	15.59%	28	28
15	屏東縣新園鄉	2018-11-24T23:51:46+08:00	4787	9799	14586	1559	16145	30706	52.58%	15.59%	28	28
15	屏東縣新園鄉	2018-11-25T06:24:11+08:00	4787	9799	14586	1559	16145	30706	52.58%	15.59%	28	28
15	屏東縣新園鄉	2018-11-24T23:08:49+08:00	4787	9799	14586	1559	16145	30706	52.58%	15.59%	28	28
15	屏東縣新園鄉	2018-11-24T22:51:01+08:00	4787	9799	14586	1559	16145	30706	52.58%	15.59%	28	28
15	屏東縣新園鄉	2018-11-25T03:44:38+08:00	4787	9799	14586	1559	16145	30706	52.58%	15.59%	28	28
15	屏東縣新園鄉	2018-11-25T00:23:15+08:00	4787	9799	14586	1559	16145	30706	52.58%	15.59%	28	28
15	屏東縣新園鄉	2018-11-24T23:23:49+08:00	4787	9799	14586	1559	16145	30706	52.58%	15.59%	28	28
15	屏東縣新園鄉	2018-11-24T22:37:12+08:00	4787	9799	14586	1559	16145	30706	52.58%	15.59%	28	28
15	屏東縣新園鄉	2018-11-24T23:16:14+08:00	4787	9799	14586	1559	16145	30706	52.58%	15.59%	28	28
15	屏東縣新園鄉	2018-11-25T01:26:05+08:00	4787	9799	14586	1559	16145	30706	52.58%	15.59%	28	28
15	屏東縣新園鄉	2018-11-25T03:39:05+08:00	4787	9799	14586	1559	16145	30706	52.58%	15.59%	28	28
15	屏東縣新園鄉	2018-11-24T22:33:48+08:00	4787	9799	14586	1559	16145	30706	52.58%	15.59%	28	28
15	屏東縣新園鄉	2018-11-24T22:16:23+08:00	4787	9799	14586	1559	16145	30706	52.58%	15.59%	28	28
15	屏東縣新園鄉	2018-11-25T00:14:21+08:00	4787	9799	14586	1559	16145	30706	52.58%	15.59%	28	28
15	屏東縣新園鄉	2018-11-24T23:35:21+08:00	4787	9799	14586	1559	16145	30706	52.58%	15.59%	28	28
15	屏東縣新園鄉	2018-11-25T01:12:56+08:00	4787	9799	14586	1559	16145	30706	52.58%	15.59%	28	28
15	屏東縣新園鄉	2018-11-25T00:09:48+08:00	4787	9799	14586	1559	16145	30706	52.58%	15.59%	28	28
15	屏東縣新園鄉	2018-11-24T23:01:44+08:00	4787	9799	14586	1559	16145	30706	52.58%	15.59%	28	28
15	屏東縣新園鄉	2018-11-24T22:26:47+08:00	4787	9799	14586	1559	16145	30706	52.58%	15.59%	28	28
15	屏東縣新園鄉	2018-11-25T03:56:25+08:00	4787	9799	14586	1559	16145	30706	52.58%	15.59%	28	28
15	屏東縣新園鄉	2018-11-24T23:47:41+08:00	4787	9799	14586	1559	16145	30706	52.58%	15.59%	28	28
15	屏東縣新園鄉	2018-11-24T22:45:18+08:00	4787	9799	14586	1559	16145	30706	52.58%	15.59%	28	28
15	屏東縣新園鄉	2018-11-25T00:05:16+08:00	4787	9799	14586	1559	16145	30706	52.58%	15.59%	28	28
15	屏東縣新園鄉	2018-11-25T00:57:49+08:00	4787	9799	14586	1559	16145	30706	52.58%	15.59%	28	28
15	屏東縣新園鄉	2018-11-24T22:19:48+08:00	4787	9799	14586	1559	16145	30706	52.58%	15.59%	28	28
15	屏東縣新園鄉	2018-11-24T22:30:21+08:00	4787	9799	14586	1559	16145	30706	52.58%	15.59%	28	28
15	屏東縣新園鄉	2018-11-25T03:32:50+08:00	4787	9799	14586	1559	16145	30706	52.58%	15.59%	28	28
15	屏東縣新園鄉	2018-11-24T22:40:38+08:00	4787	9799	14586	1559	16145	30706	52.58%	15.59%	28	28
15	屏東縣新園鄉	2018-11-25T04:03:03+08:00	4787	9799	14586	1559	16145	30706	52.58%	15.59%	28	28
15	屏東縣新園鄉	2018-11-25T01:02:42+08:00	4787	9799	14586	1559	16145	30706	52.58%	15.59%	28	28
15	屏東縣新園鄉	2018-11-25T06:14:03+08:00	4787	9799	14586	1559	16145	30706	52.58%	15.59%	28	28
15	屏東縣新園鄉	2018-11-24T22:23:26+08:00	4787	9799	14586	1559	16145	30706	52.58%	15.59%	28	28
15	屏東縣新園鄉	2018-11-24T23:27:29+08:00	4787	9799	14586	1559	16145	30706	52.58%	15.59%	28	28
15	屏東縣新園鄉	2018-11-24T23:55:58+08:00	4787	9799	14586	1559	16145	30706	52.58%	15.59%	28	28
15	屏東縣新園鄉	2018-11-25T00:00:22+08:00	4787	9799	14586	1559	16145	30706	52.58%	15.59%	28	28
15	屏東縣新園鄉	2018-11-24T23:20:03+08:00	4787	9799	14586	1559	16145	30706	52.58%	15.59%	28	28
15	屏東縣新園鄉	2018-11-25T00:18:45+08:00	4787	9799	14586	1559	16145	30706	52.58%	15.59%	28	28
15	屏東縣新園鄉	2018-11-25T01:07:38+08:00	4787	9799	14586	1559	16145	30706	52.58%	15.59%	28	28
15	屏東縣新園鄉	2018-11-25T03:50:02+08:00	4787	9799	14586	1559	16145	30706	52.58%	15.59%	28	28
15	屏東縣新園鄉	2018-11-24T23:12:28+08:00	4787	9799	14586	1559	16145	30706	52.58%	15.59%	28	28
15	屏東縣新園鄉	2018-11-24T23:31:24+08:00	4787	9799	14586	1559	16145	30706	52.58%	15.59%	28	28
15	臺南市南區	2018-11-24T23:16:08+08:00	16012	30849	46861	2887	49748	96578	51.51%	16.58%	73	80
15	臺南市南區	2018-11-25T03:56:19+08:00	18076	34732	52808	3166	55974	108650	51.52%	16.64%	80	80
15	臺南市南區	2018-11-25T00:18:37+08:00	18076	34732	52808	3166	55974	108650	51.52%	16.64%	80	80
15	臺南市南區	2018-11-24T22:45:13+08:00	13534	26184	39718	2516	42234	82145	51.41%	16.48%	63	80
15	臺南市南區	2018-11-24T22:58:00+08:00	14510	27990	42500	2666	45166	87420	51.67%	16.6%	67	80
15	臺南市南區	2018-11-24T22:26:42+08:00	11236	21814	33050	2153	35203	68200	51.62%	16.48%	54	80
15	臺南市南區	2018-11-25T01:18:00+08:00	18076	34732	52808	3166	55974	108650	51.52%	16.64%	80	80
15	臺南市南區	2018-11-24T22:37:06+08:00	12784	24887	37671	2409	40080	77758	51.54%	16.44%	60	80
15	臺南市南區	2018-11-25T06:09:00+08:00	18076	34732	52808	3166	55974	108650	51.52%	16.64%	80	80
15	臺南市南區	2018-11-25T00:57:43+08:00	18076	34732	52808	3166	55974	108650	51.52%	16.64%	80	80
15	臺南市南區	2018-11-24T22:19:42+08:00	10724	20883	31607	2092	33699	64811	52%	16.55%	52	80
15	臺南市南區	2018-11-25T01:25:58+08:00	18076	34732	52808	3166	55974	108650	51.52%	16.64%	80	80
15	臺南市南區	2018-11-24T22:30:15+08:00	11517	22414	33931	2182	36113	70185	51.45%	16.41%	55	80
15	臺南市南區	2018-11-25T01:02:37+08:00	18076	34732	52808	3166	55974	108650	51.52%	16.64%	80	80
15	臺南市南區	2018-11-24T22:40:33+08:00	13267	25726	38993	2492	41485	80575	51.49%	16.47%	62	80
15	臺南市南區	2018-11-24T23:51:41+08:00	17761	34065	51826	3109	54935	106876	51.4%	16.62%	79	80
15	臺南市南區	2018-11-25T00:00:16+08:00	17761	34065	51826	3109	54935	106876	51.4%	16.62%	79	80
15	臺南市南區	2018-11-24T22:13:35+08:00	10265	19890	30155	1987	32142	61962	51.87%	16.57%	50	80
15	臺南市南區	2018-11-24T23:55:52+08:00	17761	34065	51826	3109	54935	106876	51.4%	16.62%	79	80
15	臺南市南區	2018-11-24T23:19:58+08:00	16318	31342	47660	2910	50570	98359	51.41%	16.59%	74	80
15	臺南市南區	2018-11-24T23:27:23+08:00	16651	31961	48612	2971	51583	100530	51.31%	16.56%	75	80
15	臺南市南區	2018-11-25T03:44:30+08:00	18076	34732	52808	3166	55974	108650	51.52%	16.64%	80	80
15	臺南市南區	2018-11-24T23:01:37+08:00	15230	29372	44602	2769	47371	91938	51.52%	16.57%	70	80
15	臺南市南區	2018-11-25T04:02:58+08:00	18076	34732	52808	3166	55974	108650	51.52%	16.64%	80	80
15	臺南市南區	2018-11-25T00:14:16+08:00	18076	34732	52808	3166	55974	108650	51.52%	16.64%	80	80
15	臺南市南區	2018-11-24T23:35:16+08:00	17454	33431	50885	3085	53970	104936	51.43%	16.63%	78	80
15	臺南市南區	2018-11-24T23:12:22+08:00	15751	30410	46161	2849	49010	95113	51.53%	16.56%	72	80
15	臺南市南區	2018-11-24T23:31:18+08:00	16878	32376	49254	2997	52251	101680	51.39%	16.6%	76	80
15	臺南市南區	2018-11-24T23:39:23+08:00	17761	34065	51826	3109	54935	106876	51.4%	16.62%	79	80
15	臺南市南區	2018-11-25T01:07:32+08:00	18076	34732	52808	3166	55974	108650	51.52%	16.64%	80	80
15	臺南市南區	2018-11-24T23:47:35+08:00	17761	34065	51826	3109	54935	106876	51.4%	16.62%	79	80
15	臺南市南區	2018-11-24T22:41:42+08:00	13267	25726	38993	2492	41485	80575	51.49%	16.47%	62	80
15	臺南市南區	2018-11-25T06:13:58+08:00	18076	34732	52808	3166	55974	108650	51.52%	16.64%	80	80
15	臺南市南區	2018-11-24T22:54:31+08:00	14510	27990	42500	2666	45166	87420	51.67%	16.6%	67	80
15	臺南市南區	2018-11-25T00:09:41+08:00	18076	34732	52808	3166	55974	108650	51.52%	16.64%	80	80
15	臺南市南區	2018-11-25T03:49:56+08:00	18076	34732	52808	3166	55974	108650	51.52%	16.64%	80	80
15	臺南市南區	2018-11-24T22:50:54+08:00	14071	27216	41287	2593	43880	84953	51.65%	16.56%	65	80
15	臺南市南區	2018-11-25T01:12:50+08:00	18076	34732	52808	3166	55974	108650	51.52%	16.64%	80	80
15	臺南市南區	2018-11-24T23:43:22+08:00	17761	34065	51826	3109	54935	106876	51.4%	16.62%	79	80
15	臺南市南區	2018-11-25T06:29:23+08:00	18076	34732	52808	3166	55974	108650	51.52%	16.64%	80	80
15	臺南市南區	2018-11-24T23:05:10+08:00	15519	29869	45388	2819	48207	93655	51.47%	16.57%	71	80
15	臺南市南區	2018-11-25T06:19:03+08:00	18076	34732	52808	3166	55974	108650	51.52%	16.64%	80	80
15	臺南市南區	2018-11-25T00:05:11+08:00	17761	34065	51826	3109	54935	106876	51.4%	16.62%	79	80
15	臺南市南區	2018-11-25T06:24:06+08:00	18076	34732	52808	3166	55974	108650	51.52%	16.64%	80	80
15	臺南市南區	2018-11-24T23:08:43+08:00	15751	30410	46161	2849	49010	95113	51.53%	16.56%	72	80
15	臺南市南區	2018-11-24T22:23:20+08:00	11010	21410	32420	2113	34533	66867	51.64%	16.47%	53	80
15	臺南市南區	2018-11-25T03:32:42+08:00	18076	34732	52808	3166	55974	108650	51.52%	16.64%	80	80
15	臺南市南區	2018-11-25T00:23:10+08:00	18076	34732	52808	3166	55974	108650	51.52%	16.64%	80	80
15	臺南市南區	2018-11-24T23:23:44+08:00	16318	31342	47660	2910	50570	98359	51.41%	16.59%	74	80
15	臺南市南區	2018-11-24T22:33:44+08:00	12563	24420	36983	2378	39361	76272	51.61%	16.47%	59	80
15	臺南市南區	2018-11-24T22:16:17+08:00	10724	20883	31607	2092	33699	64811	52%	16.55%	52	80
15	臺南市南區	2018-11-25T03:39:00+08:00	18076	34732	52808	3166	55974	108650	51.52%	16.64%	80	80
15	宜蘭縣大同鄉	2018-11-24T23:56:00+08:00	528	2137	2665	217	2882	4935	58.4%	10.7%	10	10
15	宜蘭縣大同鄉	2018-11-24T23:05:15+08:00	528	2137	2665	217	2882	4935	58.4%	10.7%	10	10
15	宜蘭縣大同鄉	2018-11-25T01:18:08+08:00	528	2137	2665	217	2882	4935	58.4%	10.7%	10	10
15	宜蘭縣大同鄉	2018-11-24T23:43:29+08:00	528	2137	2665	217	2882	4935	58.4%	10.7%	10	10
15	宜蘭縣大同鄉	2018-11-25T03:56:27+08:00	528	2137	2665	217	2882	4935	58.4%	10.7%	10	10
15	宜蘭縣大同鄉	2018-11-25T06:19:09+08:00	528	2137	2665	217	2882	4935	58.4%	10.7%	10	10
15	宜蘭縣大同鄉	2018-11-24T22:58:07+08:00	528	2137	2665	217	2882	4935	58.4%	10.7%	10	10
15	宜蘭縣大同鄉	2018-11-24T22:41:49+08:00	528	2137	2665	217	2882	4935	58.4%	10.7%	10	10
15	宜蘭縣大同鄉	2018-11-24T23:39:31+08:00	528	2137	2665	217	2882	4935	58.4%	10.7%	10	10
15	宜蘭縣大同鄉	2018-11-24T23:47:42+08:00	528	2137	2665	217	2882	4935	58.4%	10.7%	10	10
15	宜蘭縣大同鄉	2018-11-24T22:30:22+08:00	350	1504	1854	152	2006	3358	59.74%	10.42%	8	10
15	宜蘭縣大同鄉	2018-11-24T23:51:47+08:00	528	2137	2665	217	2882	4935	58.4%	10.7%	10	10
15	宜蘭縣大同鄉	2018-11-25T06:09:08+08:00	528	2137	2665	217	2882	4935	58.4%	10.7%	10	10
15	宜蘭縣大同鄉	2018-11-24T22:13:43+08:00	350	1504	1854	152	2006	3358	59.74%	10.42%	8	10
15	宜蘭縣大同鄉	2018-11-25T00:57:50+08:00	528	2137	2665	217	2882	4935	58.4%	10.7%	10	10
15	宜蘭縣大同鄉	2018-11-25T03:44:39+08:00	528	2137	2665	217	2882	4935	58.4%	10.7%	10	10
15	宜蘭縣大同鄉	2018-11-24T23:31:26+08:00	528	2137	2665	217	2882	4935	58.4%	10.7%	10	10
15	宜蘭縣大同鄉	2018-11-24T22:33:49+08:00	451	1802	2253	194	2447	4251	57.56%	10.61%	9	10
15	宜蘭縣大同鄉	2018-11-24T22:37:13+08:00	528	2137	2665	217	2882	4935	58.4%	10.7%	10	10
15	宜蘭縣大同鄉	2018-11-24T22:16:24+08:00	350	1504	1854	152	2006	3358	59.74%	10.42%	8	10
15	宜蘭縣大同鄉	2018-11-25T00:18:46+08:00	528	2137	2665	217	2882	4935	58.4%	10.7%	10	10
15	宜蘭縣大同鄉	2018-11-24T23:35:21+08:00	528	2137	2665	217	2882	4935	58.4%	10.7%	10	10
15	宜蘭縣大同鄉	2018-11-24T23:16:15+08:00	528	2137	2665	217	2882	4935	58.4%	10.7%	10	10
15	宜蘭縣大同鄉	2018-11-24T22:45:19+08:00	528	2137	2665	217	2882	4935	58.4%	10.7%	10	10
15	宜蘭縣大同鄉	2018-11-24T22:54:36+08:00	528	2137	2665	217	2882	4935	58.4%	10.7%	10	10
15	宜蘭縣大同鄉	2018-11-24T23:01:44+08:00	528	2137	2665	217	2882	4935	58.4%	10.7%	10	10
15	宜蘭縣大同鄉	2018-11-25T00:05:17+08:00	528	2137	2665	217	2882	4935	58.4%	10.7%	10	10
15	宜蘭縣大同鄉	2018-11-25T01:12:57+08:00	528	2137	2665	217	2882	4935	58.4%	10.7%	10	10
15	宜蘭縣大同鄉	2018-11-24T22:26:48+08:00	350	1504	1854	152	2006	3358	59.74%	10.42%	8	10
15	宜蘭縣大同鄉	2018-11-25T00:09:49+08:00	528	2137	2665	217	2882	4935	58.4%	10.7%	10	10
15	宜蘭縣大同鄉	2018-11-24T23:23:50+08:00	528	2137	2665	217	2882	4935	58.4%	10.7%	10	10
15	宜蘭縣大同鄉	2018-11-24T22:19:49+08:00	350	1504	1854	152	2006	3358	59.74%	10.42%	8	10
15	宜蘭縣大同鄉	2018-11-25T04:03:04+08:00	528	2137	2665	217	2882	4935	58.4%	10.7%	10	10
15	宜蘭縣大同鄉	2018-11-24T22:40:39+08:00	528	2137	2665	217	2882	4935	58.4%	10.7%	10	10
15	宜蘭縣大同鄉	2018-11-25T03:32:51+08:00	528	2137	2665	217	2882	4935	58.4%	10.7%	10	10
15	宜蘭縣大同鄉	2018-11-24T23:08:50+08:00	528	2137	2665	217	2882	4935	58.4%	10.7%	10	10
15	宜蘭縣大同鄉	2018-11-24T22:23:27+08:00	350	1504	1854	152	2006	3358	59.74%	10.42%	8	10
15	宜蘭縣大同鄉	2018-11-24T22:51:02+08:00	528	2137	2665	217	2882	4935	58.4%	10.7%	10	10
15	宜蘭縣大同鄉	2018-11-25T06:14:04+08:00	528	2137	2665	217	2882	4935	58.4%	10.7%	10	10
15	宜蘭縣大同鄉	2018-11-25T00:00:23+08:00	528	2137	2665	217	2882	4935	58.4%	10.7%	10	10
15	宜蘭縣大同鄉	2018-11-25T06:24:12+08:00	528	2137	2665	217	2882	4935	58.4%	10.7%	10	10
15	宜蘭縣大同鄉	2018-11-24T23:27:29+08:00	528	2137	2665	217	2882	4935	58.4%	10.7%	10	10
15	宜蘭縣大同鄉	2018-11-25T00:23:16+08:00	528	2137	2665	217	2882	4935	58.4%	10.7%	10	10
15	宜蘭縣大同鄉	2018-11-25T01:02:43+08:00	528	2137	2665	217	2882	4935	58.4%	10.7%	10	10
15	宜蘭縣大同鄉	2018-11-25T06:29:30+08:00	528	2137	2665	217	2882	4935	58.4%	10.7%	10	10
15	宜蘭縣大同鄉	2018-11-24T23:12:29+08:00	528	2137	2665	217	2882	4935	58.4%	10.7%	10	10
15	宜蘭縣大同鄉	2018-11-25T03:50:03+08:00	528	2137	2665	217	2882	4935	58.4%	10.7%	10	10
15	宜蘭縣大同鄉	2018-11-25T01:07:39+08:00	528	2137	2665	217	2882	4935	58.4%	10.7%	10	10
15	宜蘭縣大同鄉	2018-11-25T00:14:22+08:00	528	2137	2665	217	2882	4935	58.4%	10.7%	10	10
15	宜蘭縣大同鄉	2018-11-25T03:39:06+08:00	528	2137	2665	217	2882	4935	58.4%	10.7%	10	10
15	宜蘭縣大同鄉	2018-11-25T01:26:06+08:00	528	2137	2665	217	2882	4935	58.4%	10.7%	10	10
15	宜蘭縣大同鄉	2018-11-24T23:20:05+08:00	528	2137	2665	217	2882	4935	58.4%	10.7%	10	10
15	宜蘭縣宜蘭市	2018-11-25T03:56:26+08:00	14997	27404	42401	2549	44950	79167	56.78%	18.94%	78	78
15	宜蘭縣宜蘭市	2018-11-24T23:05:15+08:00	9733	17862	27595	1589	29184	51342	56.84%	18.96%	53	78
15	宜蘭縣宜蘭市	2018-11-25T01:18:08+08:00	14997	27404	42401	2549	44950	79167	56.78%	18.94%	78	78
15	宜蘭縣宜蘭市	2018-11-24T23:43:29+08:00	11743	21537	33280	1942	35222	61888	56.91%	18.97%	63	78
15	宜蘭縣宜蘭市	2018-11-25T06:19:09+08:00	14997	27404	42401	2549	44950	79167	56.78%	18.94%	78	78
15	宜蘭縣宜蘭市	2018-11-24T22:58:07+08:00	9253	17042	26295	1529	27824	49066	56.71%	18.86%	51	78
15	宜蘭縣宜蘭市	2018-11-24T22:41:49+08:00	8147	14829	22976	1352	24328	42921	56.68%	18.98%	45	78
15	宜蘭縣宜蘭市	2018-11-24T23:39:31+08:00	11563	21193	32756	1894	34650	60940	56.86%	18.97%	62	78
15	宜蘭縣宜蘭市	2018-11-24T22:30:22+08:00	7389	13420	20809	1224	22033	38882	56.67%	19%	42	78
15	宜蘭縣宜蘭市	2018-11-24T23:51:47+08:00	12958	23785	36743	2204	38947	68430	56.92%	18.94%	69	78
15	宜蘭縣宜蘭市	2018-11-25T06:09:08+08:00	14997	27404	42401	2549	44950	79167	56.78%	18.94%	78	78
15	宜蘭縣宜蘭市	2018-11-24T22:13:43+08:00	6302	11379	17681	1060	18741	32942	56.89%	19.13%	36	78
15	宜蘭縣宜蘭市	2018-11-25T03:44:39+08:00	14997	27404	42401	2549	44950	79167	56.78%	18.94%	78	78
15	宜蘭縣宜蘭市	2018-11-24T23:23:49+08:00	10600	19395	29995	1721	31716	55886	56.75%	18.97%	57	78
15	宜蘭縣宜蘭市	2018-11-24T22:33:49+08:00	7938	14411	22349	1297	23646	41707	56.7%	19.03%	44	78
15	宜蘭縣宜蘭市	2018-11-24T22:37:12+08:00	8147	14829	22976	1352	24328	42921	56.68%	18.98%	45	78
15	宜蘭縣宜蘭市	2018-11-24T23:16:14+08:00	10388	18999	29387	1690	31077	54627	56.89%	19.02%	56	78
15	宜蘭縣宜蘭市	2018-11-24T22:16:24+08:00	6480	11682	18162	1072	19234	33790	56.92%	19.18%	37	78
15	宜蘭縣宜蘭市	2018-11-25T00:14:21+08:00	14288	26188	40476	2397	42873	75419	56.85%	18.94%	75	78
15	宜蘭縣宜蘭市	2018-11-24T23:35:21+08:00	10953	20089	31042	1788	32830	57747	56.85%	18.97%	59	78
15	宜蘭縣宜蘭市	2018-11-24T22:45:19+08:00	8299	15146	23445	1390	24835	43826	56.67%	18.94%	46	78
15	宜蘭縣宜蘭市	2018-11-24T22:54:36+08:00	8869	16312	25181	1467	26648	47008	56.69%	18.87%	49	78
15	宜蘭縣宜蘭市	2018-11-25T00:09:48+08:00	14045	25807	39852	2370	42222	74254	56.86%	18.91%	74	78
15	宜蘭縣宜蘭市	2018-11-24T23:01:44+08:00	9733	17862	27595	1589	29184	51342	56.84%	18.96%	53	78
15	宜蘭縣宜蘭市	2018-11-24T22:26:47+08:00	7389	13420	20809	1224	22033	38882	56.67%	19%	42	78
15	宜蘭縣宜蘭市	2018-11-24T23:47:41+08:00	11916	21853	33769	1986	35755	62764	56.97%	18.99%	64	78
15	宜蘭縣宜蘭市	2018-11-25T01:12:57+08:00	14997	27404	42401	2549	44950	79167	56.78%	18.94%	78	78
15	宜蘭縣宜蘭市	2018-11-25T00:05:16+08:00	14045	25807	39852	2370	42222	74254	56.86%	18.91%	74	78
15	宜蘭縣宜蘭市	2018-11-25T00:57:49+08:00	14997	27404	42401	2549	44950	79167	56.78%	18.94%	78	78
15	宜蘭縣宜蘭市	2018-11-24T22:19:48+08:00	6880	12394	19274	1133	20407	35849	56.92%	19.19%	39	78
15	宜蘭縣宜蘭市	2018-11-25T03:32:50+08:00	14997	27404	42401	2549	44950	79167	56.78%	18.94%	78	78
15	宜蘭縣宜蘭市	2018-11-25T04:03:04+08:00	14997	27404	42401	2549	44950	79167	56.78%	18.94%	78	78
15	宜蘭縣宜蘭市	2018-11-24T22:40:39+08:00	8147	14829	22976	1352	24328	42921	56.68%	18.98%	45	78
15	宜蘭縣宜蘭市	2018-11-24T23:08:50+08:00	9944	18196	28140	1622	29762	52308	56.9%	19.01%	54	78
15	宜蘭縣宜蘭市	2018-11-24T22:23:27+08:00	7206	13077	20283	1199	21482	37936	56.63%	19%	41	78
15	宜蘭縣宜蘭市	2018-11-24T22:51:02+08:00	8681	15833	24514	1442	25956	45878	56.58%	18.92%	48	78
15	宜蘭縣宜蘭市	2018-11-25T06:14:04+08:00	14997	27404	42401	2549	44950	79167	56.78%	18.94%	78	78
15	宜蘭縣宜蘭市	2018-11-24T23:55:59+08:00	12958	23785	36743	2204	38947	68430	56.92%	18.94%	69	78
15	宜蘭縣宜蘭市	2018-11-25T06:24:12+08:00	14997	27404	42401	2549	44950	79167	56.78%	18.94%	78	78
15	宜蘭縣宜蘭市	2018-11-24T23:27:29+08:00	10600	19395	29995	1721	31716	55886	56.75%	18.97%	57	78
15	宜蘭縣宜蘭市	2018-11-25T00:00:22+08:00	13160	24152	37312	2246	39558	69590	56.84%	18.91%	70	78
15	宜蘭縣宜蘭市	2018-11-25T00:23:16+08:00	14730	26993	41723	2490	44213	78005	56.68%	18.88%	77	78
15	宜蘭縣宜蘭市	2018-11-25T01:02:43+08:00	14997	27404	42401	2549	44950	79167	56.78%	18.94%	78	78
15	宜蘭縣宜蘭市	2018-11-25T06:29:30+08:00	14997	27404	42401	2549	44950	79167	56.78%	18.94%	78	78
15	宜蘭縣宜蘭市	2018-11-24T23:12:29+08:00	10388	18999	29387	1690	31077	54627	56.89%	19.02%	56	78
15	宜蘭縣宜蘭市	2018-11-24T23:31:25+08:00	10741	19685	30426	1756	32182	56613	56.85%	18.97%	58	78
15	宜蘭縣宜蘭市	2018-11-24T23:20:04+08:00	10600	19395	29995	1721	31716	55886	56.75%	18.97%	57	78
15	宜蘭縣宜蘭市	2018-11-25T00:18:45+08:00	14521	26619	41140	2436	43576	76853	56.7%	18.89%	76	78
15	宜蘭縣宜蘭市	2018-11-25T01:07:38+08:00	14997	27404	42401	2549	44950	79167	56.78%	18.94%	78	78
15	宜蘭縣宜蘭市	2018-11-25T03:39:06+08:00	14997	27404	42401	2549	44950	79167	56.78%	18.94%	78	78
15	宜蘭縣宜蘭市	2018-11-25T01:26:06+08:00	14997	27404	42401	2549	44950	79167	56.78%	18.94%	78	78
15	宜蘭縣宜蘭市	2018-11-25T03:50:02+08:00	14997	27404	42401	2549	44950	79167	56.78%	18.94%	78	78
15	連江縣莒光鄉	2018-11-24T23:12:31+08:00	200	560	760	25	785	1481	53%	13.5%	2	2
15	連江縣莒光鄉	2018-11-24T23:47:44+08:00	200	560	760	25	785	1481	53%	13.5%	2	2
15	連江縣莒光鄉	2018-11-24T22:58:09+08:00	200	560	760	25	785	1481	53%	13.5%	2	2
15	連江縣莒光鄉	2018-11-24T23:56:01+08:00	200	560	760	25	785	1481	53%	13.5%	2	2
15	連江縣莒光鄉	2018-11-25T03:56:29+08:00	200	560	760	25	785	1481	53%	13.5%	2	2
15	連江縣莒光鄉	2018-11-24T23:01:46+08:00	200	560	760	25	785	1481	53%	13.5%	2	2
15	連江縣莒光鄉	2018-11-25T03:32:53+08:00	200	560	760	25	785	1481	53%	13.5%	2	2
15	連江縣莒光鄉	2018-11-24T23:08:52+08:00	200	560	760	25	785	1481	53%	13.5%	2	2
15	連江縣莒光鄉	2018-11-24T23:51:49+08:00	200	560	760	25	785	1481	53%	13.5%	2	2
15	連江縣莒光鄉	2018-11-24T22:13:45+08:00	0	0	0	0	0	0	0%	0%	0	2
15	連江縣莒光鄉	2018-11-25T03:44:41+08:00	200	560	760	25	785	1481	53%	13.5%	2	2
15	連江縣莒光鄉	2018-11-25T04:03:06+08:00	200	560	760	25	785	1481	53%	13.5%	2	2
15	連江縣莒光鄉	2018-11-24T23:27:31+08:00	200	560	760	25	785	1481	53%	13.5%	2	2
15	連江縣莒光鄉	2018-11-24T22:30:24+08:00	96	235	331	11	342	698	49%	13.75%	1	2
15	連江縣莒光鄉	2018-11-24T22:19:50+08:00	0	0	0	0	0	0	0%	0%	0	2
15	連江縣莒光鄉	2018-11-25T06:14:06+08:00	200	560	760	25	785	1481	53%	13.5%	2	2
15	連江縣莒光鄉	2018-11-24T23:20:09+08:00	200	560	760	25	785	1481	53%	13.5%	2	2
15	連江縣莒光鄉	2018-11-24T23:31:28+08:00	200	560	760	25	785	1481	53%	13.5%	2	2
15	連江縣莒光鄉	2018-11-24T22:37:14+08:00	200	560	760	25	785	1481	53%	13.5%	2	2
15	連江縣莒光鄉	2018-11-25T00:18:48+08:00	200	560	760	25	785	1481	53%	13.5%	2	2
15	連江縣莒光鄉	2018-11-25T06:29:32+08:00	200	560	760	25	785	1481	53%	13.5%	2	2
15	連江縣莒光鄉	2018-11-25T00:09:51+08:00	200	560	760	25	785	1481	53%	13.5%	2	2
15	連江縣莒光鄉	2018-11-24T22:45:21+08:00	200	560	760	25	785	1481	53%	13.5%	2	2
15	連江縣莒光鄉	2018-11-24T22:54:38+08:00	200	560	760	25	785	1481	53%	13.5%	2	2
15	連江縣莒光鄉	2018-11-24T22:33:51+08:00	200	560	760	25	785	1481	53%	13.5%	2	2
15	連江縣莒光鄉	2018-11-24T23:39:33+08:00	200	560	760	25	785	1481	53%	13.5%	2	2
15	連江縣莒光鄉	2018-11-24T22:26:49+08:00	0	0	0	0	0	0	0%	0%	0	2
15	連江縣莒光鄉	2018-11-25T01:07:40+08:00	200	560	760	25	785	1481	53%	13.5%	2	2
15	連江縣莒光鄉	2018-11-25T01:12:59+08:00	200	560	760	25	785	1481	53%	13.5%	2	2
15	連江縣莒光鄉	2018-11-25T00:05:18+08:00	200	560	760	25	785	1481	53%	13.5%	2	2
15	連江縣莒光鄉	2018-11-24T23:05:17+08:00	200	560	760	25	785	1481	53%	13.5%	2	2
15	連江縣莒光鄉	2018-11-24T23:23:51+08:00	200	560	760	25	785	1481	53%	13.5%	2	2
15	連江縣莒光鄉	2018-11-24T22:23:29+08:00	0	0	0	0	0	0	0%	0%	0	2
15	連江縣莒光鄉	2018-11-25T00:00:24+08:00	200	560	760	25	785	1481	53%	13.5%	2	2
15	連江縣莒光鄉	2018-11-25T01:02:45+08:00	200	560	760	25	785	1481	53%	13.5%	2	2
15	連江縣莒光鄉	2018-11-24T22:40:41+08:00	200	560	760	25	785	1481	53%	13.5%	2	2
15	連江縣莒光鄉	2018-11-25T00:57:52+08:00	200	560	760	25	785	1481	53%	13.5%	2	2
15	連江縣莒光鄉	2018-11-24T22:51:04+08:00	200	560	760	25	785	1481	53%	13.5%	2	2
15	連江縣莒光鄉	2018-11-25T06:09:10+08:00	200	560	760	25	785	1481	53%	13.5%	2	2
15	連江縣莒光鄉	2018-11-25T06:24:14+08:00	200	560	760	25	785	1481	53%	13.5%	2	2
15	連江縣莒光鄉	2018-11-25T00:23:18+08:00	200	560	760	25	785	1481	53%	13.5%	2	2
15	連江縣莒光鄉	2018-11-24T23:35:23+08:00	200	560	760	25	785	1481	53%	13.5%	2	2
15	連江縣莒光鄉	2018-11-25T00:14:24+08:00	200	560	760	25	785	1481	53%	13.5%	2	2
15	連江縣莒光鄉	2018-11-25T03:50:04+08:00	200	560	760	25	785	1481	53%	13.5%	2	2
15	連江縣莒光鄉	2018-11-24T22:16:26+08:00	0	0	0	0	0	0	0%	0%	0	2
15	連江縣莒光鄉	2018-11-24T23:43:31+08:00	200	560	760	25	785	1481	53%	13.5%	2	2
15	連江縣莒光鄉	2018-11-25T01:18:11+08:00	200	560	760	25	785	1481	53%	13.5%	2	2
15	連江縣莒光鄉	2018-11-24T23:16:16+08:00	200	560	760	25	785	1481	53%	13.5%	2	2
15	連江縣莒光鄉	2018-11-25T06:19:11+08:00	200	560	760	25	785	1481	53%	13.5%	2	2
15	連江縣莒光鄉	2018-11-24T22:41:51+08:00	200	560	760	25	785	1481	53%	13.5%	2	2
15	連江縣莒光鄉	2018-11-25T03:39:08+08:00	200	560	760	25	785	1481	53%	13.5%	2	2
15	連江縣莒光鄉	2018-11-25T01:26:08+08:00	200	560	760	25	785	1481	53%	13.5%	2	2
15	高雄市那瑪夏區	2018-11-24T22:26:43+08:00	218	807	1025	92	1117	1815	61.54%	12.01%	3	4
15	高雄市那瑪夏區	2018-11-25T00:09:42+08:00	283	1184	1467	122	1589	2424	65.55%	11.67%	4	4
15	高雄市那瑪夏區	2018-11-25T03:56:21+08:00	283	1184	1467	122	1589	2424	65.55%	11.67%	4	4
15	高雄市那瑪夏區	2018-11-25T01:12:52+08:00	283	1184	1467	122	1589	2424	65.55%	11.67%	4	4
15	高雄市那瑪夏區	2018-11-24T22:37:07+08:00	218	807	1025	92	1117	1815	61.54%	12.01%	3	4
15	高雄市那瑪夏區	2018-11-24T22:54:32+08:00	218	807	1025	92	1117	1815	61.54%	12.01%	3	4
15	高雄市那瑪夏區	2018-11-24T22:50:56+08:00	218	807	1025	92	1117	1815	61.54%	12.01%	3	4
15	高雄市那瑪夏區	2018-11-25T00:18:39+08:00	283	1184	1467	122	1589	2424	65.55%	11.67%	4	4
15	高雄市那瑪夏區	2018-11-25T00:05:12+08:00	218	807	1025	92	1117	1815	61.54%	12.01%	3	4
15	高雄市那瑪夏區	2018-11-24T22:45:15+08:00	218	807	1025	92	1117	1815	61.54%	12.01%	3	4
15	高雄市那瑪夏區	2018-11-25T01:02:38+08:00	283	1184	1467	122	1589	2424	65.55%	11.67%	4	4
15	高雄市那瑪夏區	2018-11-25T00:57:44+08:00	283	1184	1467	122	1589	2424	65.55%	11.67%	4	4
15	高雄市那瑪夏區	2018-11-24T22:40:34+08:00	218	807	1025	92	1117	1815	61.54%	12.01%	3	4
15	高雄市那瑪夏區	2018-11-24T22:19:44+08:00	124	534	658	61	719	1074	66.95%	11.55%	2	4
15	高雄市那瑪夏區	2018-11-25T00:00:18+08:00	218	807	1025	92	1117	1815	61.54%	12.01%	3	4
15	高雄市那瑪夏區	2018-11-24T23:55:54+08:00	218	807	1025	92	1117	1815	61.54%	12.01%	3	4
15	高雄市那瑪夏區	2018-11-24T23:27:25+08:00	218	807	1025	92	1117	1815	61.54%	12.01%	3	4
15	高雄市那瑪夏區	2018-11-24T23:19:59+08:00	218	807	1025	92	1117	1815	61.54%	12.01%	3	4
15	高雄市那瑪夏區	2018-11-25T01:07:33+08:00	283	1184	1467	122	1589	2424	65.55%	11.67%	4	4
15	高雄市那瑪夏區	2018-11-24T23:39:25+08:00	218	807	1025	92	1117	1815	61.54%	12.01%	3	4
15	高雄市那瑪夏區	2018-11-24T23:12:24+08:00	218	807	1025	92	1117	1815	61.54%	12.01%	3	4
15	高雄市那瑪夏區	2018-11-24T23:01:38+08:00	218	807	1025	92	1117	1815	61.54%	12.01%	3	4
15	高雄市那瑪夏區	2018-11-24T23:31:20+08:00	218	807	1025	92	1117	1815	61.54%	12.01%	3	4
15	高雄市那瑪夏區	2018-11-24T23:35:17+08:00	218	807	1025	92	1117	1815	61.54%	12.01%	3	4
15	高雄市那瑪夏區	2018-11-25T04:02:59+08:00	283	1184	1467	122	1589	2424	65.55%	11.67%	4	4
15	高雄市那瑪夏區	2018-11-25T00:14:17+08:00	283	1184	1467	122	1589	2424	65.55%	11.67%	4	4
15	高雄市那瑪夏區	2018-11-24T23:43:24+08:00	218	807	1025	92	1117	1815	61.54%	12.01%	3	4
15	高雄市那瑪夏區	2018-11-24T22:58:02+08:00	218	807	1025	92	1117	1815	61.54%	12.01%	3	4
15	高雄市那瑪夏區	2018-11-25T03:49:58+08:00	283	1184	1467	122	1589	2424	65.55%	11.67%	4	4
15	高雄市那瑪夏區	2018-11-25T01:18:02+08:00	283	1184	1467	122	1589	2424	65.55%	11.67%	4	4
15	高雄市那瑪夏區	2018-11-24T23:05:11+08:00	218	807	1025	92	1117	1815	61.54%	12.01%	3	4
15	高雄市那瑪夏區	2018-11-25T06:13:59+08:00	283	1184	1467	122	1589	2424	65.55%	11.67%	4	4
15	高雄市那瑪夏區	2018-11-24T22:41:43+08:00	218	807	1025	92	1117	1815	61.54%	12.01%	3	4
15	高雄市那瑪夏區	2018-11-25T06:19:04+08:00	283	1184	1467	122	1589	2424	65.55%	11.67%	4	4
15	高雄市那瑪夏區	2018-11-25T06:29:24+08:00	283	1184	1467	122	1589	2424	65.55%	11.67%	4	4
15	高雄市那瑪夏區	2018-11-25T06:24:07+08:00	283	1184	1467	122	1589	2424	65.55%	11.67%	4	4
15	高雄市那瑪夏區	2018-11-24T22:30:17+08:00	218	807	1025	92	1117	1815	61.54%	12.01%	3	4
15	高雄市那瑪夏區	2018-11-24T23:51:42+08:00	218	807	1025	92	1117	1815	61.54%	12.01%	3	4
15	高雄市那瑪夏區	2018-11-25T06:09:02+08:00	283	1184	1467	122	1589	2424	65.55%	11.67%	4	4
15	高雄市那瑪夏區	2018-11-24T23:23:45+08:00	218	807	1025	92	1117	1815	61.54%	12.01%	3	4
15	高雄市那瑪夏區	2018-11-25T03:44:32+08:00	283	1184	1467	122	1589	2424	65.55%	11.67%	4	4
15	高雄市那瑪夏區	2018-11-24T23:08:44+08:00	218	807	1025	92	1117	1815	61.54%	12.01%	3	4
15	高雄市那瑪夏區	2018-11-24T22:23:21+08:00	218	807	1025	92	1117	1815	61.54%	12.01%	3	4
15	高雄市那瑪夏區	2018-11-25T03:32:44+08:00	283	1184	1467	122	1589	2424	65.55%	11.67%	4	4
15	高雄市那瑪夏區	2018-11-24T22:13:37+08:00	92	276	368	54	422	585	72.14%	15.73%	1	4
15	高雄市那瑪夏區	2018-11-25T00:23:11+08:00	283	1184	1467	122	1589	2424	65.55%	11.67%	4	4
15	高雄市那瑪夏區	2018-11-24T23:16:10+08:00	218	807	1025	92	1117	1815	61.54%	12.01%	3	4
15	高雄市那瑪夏區	2018-11-25T01:26:00+08:00	283	1184	1467	122	1589	2424	65.55%	11.67%	4	4
15	高雄市那瑪夏區	2018-11-24T23:47:36+08:00	218	807	1025	92	1117	1815	61.54%	12.01%	3	4
15	高雄市那瑪夏區	2018-11-25T03:39:01+08:00	283	1184	1467	122	1589	2424	65.55%	11.67%	4	4
15	高雄市那瑪夏區	2018-11-24T22:33:45+08:00	218	807	1025	92	1117	1815	61.54%	12.01%	3	4
15	高雄市那瑪夏區	2018-11-24T22:16:18+08:00	92	276	368	54	422	585	72.14%	15.73%	1	4
15	高雄市彌陀區	2018-11-25T01:18:01+08:00	2893	6438	9331	889	10220	16487	61.99%	17.55%	18	18
15	高雄市彌陀區	2018-11-24T22:58:01+08:00	2893	6438	9331	889	10220	16487	61.99%	17.55%	18	18
15	高雄市彌陀區	2018-11-24T22:26:43+08:00	2893	6438	9331	889	10220	16487	61.99%	17.55%	18	18
15	高雄市彌陀區	2018-11-25T00:09:42+08:00	2893	6438	9331	889	10220	16487	61.99%	17.55%	18	18
15	高雄市彌陀區	2018-11-24T22:37:07+08:00	2893	6438	9331	889	10220	16487	61.99%	17.55%	18	18
15	高雄市彌陀區	2018-11-24T22:54:32+08:00	2893	6438	9331	889	10220	16487	61.99%	17.55%	18	18
15	高雄市彌陀區	2018-11-24T22:50:56+08:00	2893	6438	9331	889	10220	16487	61.99%	17.55%	18	18
15	高雄市彌陀區	2018-11-25T00:18:39+08:00	2893	6438	9331	889	10220	16487	61.99%	17.55%	18	18
15	高雄市彌陀區	2018-11-24T22:45:14+08:00	2893	6438	9331	889	10220	16487	61.99%	17.55%	18	18
15	高雄市彌陀區	2018-11-25T03:56:20+08:00	2893	6438	9331	889	10220	16487	61.99%	17.55%	18	18
15	高雄市彌陀區	2018-11-25T00:05:12+08:00	2893	6438	9331	889	10220	16487	61.99%	17.55%	18	18
15	高雄市彌陀區	2018-11-24T23:16:09+08:00	2893	6438	9331	889	10220	16487	61.99%	17.55%	18	18
15	高雄市彌陀區	2018-11-25T01:02:38+08:00	2893	6438	9331	889	10220	16487	61.99%	17.55%	18	18
15	高雄市彌陀區	2018-11-25T00:57:44+08:00	2893	6438	9331	889	10220	16487	61.99%	17.55%	18	18
15	高雄市彌陀區	2018-11-24T22:40:34+08:00	2893	6438	9331	889	10220	16487	61.99%	17.55%	18	18
15	高雄市彌陀區	2018-11-25T06:09:01+08:00	2893	6438	9331	889	10220	16487	61.99%	17.55%	18	18
15	高雄市彌陀區	2018-11-24T22:19:43+08:00	2893	6438	9331	889	10220	16487	61.99%	17.55%	18	18
15	高雄市彌陀區	2018-11-24T23:55:54+08:00	2893	6438	9331	889	10220	16487	61.99%	17.55%	18	18
15	高雄市彌陀區	2018-11-25T03:44:31+08:00	2893	6438	9331	889	10220	16487	61.99%	17.55%	18	18
15	高雄市彌陀區	2018-11-24T23:19:59+08:00	2893	6438	9331	889	10220	16487	61.99%	17.55%	18	18
15	高雄市彌陀區	2018-11-25T00:00:17+08:00	2893	6438	9331	889	10220	16487	61.99%	17.55%	18	18
15	高雄市彌陀區	2018-11-24T23:27:24+08:00	2893	6438	9331	889	10220	16487	61.99%	17.55%	18	18
15	高雄市彌陀區	2018-11-25T01:07:33+08:00	2893	6438	9331	889	10220	16487	61.99%	17.55%	18	18
15	高雄市彌陀區	2018-11-24T23:31:19+08:00	2893	6438	9331	889	10220	16487	61.99%	17.55%	18	18
15	高雄市彌陀區	2018-11-24T23:12:24+08:00	2893	6438	9331	889	10220	16487	61.99%	17.55%	18	18
15	高雄市彌陀區	2018-11-24T23:39:24+08:00	2893	6438	9331	889	10220	16487	61.99%	17.55%	18	18
15	高雄市彌陀區	2018-11-24T23:01:38+08:00	2893	6438	9331	889	10220	16487	61.99%	17.55%	18	18
15	高雄市彌陀區	2018-11-24T23:35:17+08:00	2893	6438	9331	889	10220	16487	61.99%	17.55%	18	18
15	高雄市彌陀區	2018-11-25T04:02:59+08:00	2893	6438	9331	889	10220	16487	61.99%	17.55%	18	18
15	高雄市彌陀區	2018-11-25T00:14:17+08:00	2893	6438	9331	889	10220	16487	61.99%	17.55%	18	18
15	高雄市彌陀區	2018-11-24T23:43:23+08:00	2893	6438	9331	889	10220	16487	61.99%	17.55%	18	18
15	高雄市彌陀區	2018-11-25T01:12:51+08:00	2893	6438	9331	889	10220	16487	61.99%	17.55%	18	18
15	高雄市彌陀區	2018-11-25T03:49:58+08:00	2893	6438	9331	889	10220	16487	61.99%	17.55%	18	18
15	高雄市彌陀區	2018-11-24T23:05:11+08:00	2893	6438	9331	889	10220	16487	61.99%	17.55%	18	18
15	高雄市彌陀區	2018-11-25T06:13:59+08:00	2893	6438	9331	889	10220	16487	61.99%	17.55%	18	18
15	高雄市彌陀區	2018-11-24T22:41:43+08:00	2893	6438	9331	889	10220	16487	61.99%	17.55%	18	18
15	高雄市彌陀區	2018-11-25T06:19:04+08:00	2893	6438	9331	889	10220	16487	61.99%	17.55%	18	18
15	高雄市彌陀區	2018-11-25T06:29:24+08:00	2893	6438	9331	889	10220	16487	61.99%	17.55%	18	18
15	高雄市彌陀區	2018-11-25T06:24:07+08:00	2893	6438	9331	889	10220	16487	61.99%	17.55%	18	18
15	高雄市彌陀區	2018-11-24T22:30:16+08:00	2893	6438	9331	889	10220	16487	61.99%	17.55%	18	18
15	高雄市彌陀區	2018-11-24T23:51:42+08:00	2893	6438	9331	889	10220	16487	61.99%	17.55%	18	18
15	高雄市彌陀區	2018-11-24T23:23:45+08:00	2893	6438	9331	889	10220	16487	61.99%	17.55%	18	18
15	高雄市彌陀區	2018-11-24T22:13:36+08:00	2893	6438	9331	889	10220	16487	61.99%	17.55%	18	18
15	高雄市彌陀區	2018-11-24T23:08:44+08:00	2893	6438	9331	889	10220	16487	61.99%	17.55%	18	18
15	高雄市彌陀區	2018-11-24T22:23:21+08:00	2893	6438	9331	889	10220	16487	61.99%	17.55%	18	18
15	高雄市彌陀區	2018-11-25T03:32:44+08:00	2893	6438	9331	889	10220	16487	61.99%	17.55%	18	18
15	高雄市彌陀區	2018-11-25T00:23:11+08:00	2893	6438	9331	889	10220	16487	61.99%	17.55%	18	18
15	高雄市彌陀區	2018-11-25T01:26:00+08:00	2893	6438	9331	889	10220	16487	61.99%	17.55%	18	18
15	高雄市彌陀區	2018-11-24T23:47:36+08:00	2893	6438	9331	889	10220	16487	61.99%	17.55%	18	18
15	高雄市彌陀區	2018-11-25T03:39:01+08:00	2893	6438	9331	889	10220	16487	61.99%	17.55%	18	18
15	高雄市彌陀區	2018-11-24T22:33:45+08:00	2893	6438	9331	889	10220	16487	61.99%	17.55%	18	18
15	高雄市彌陀區	2018-11-24T22:16:18+08:00	2893	6438	9331	889	10220	16487	61.99%	17.55%	18	18
15	臺東縣延平鄉	2018-11-25T03:56:28+08:00	335	1118	1453	146	1599	2930	54.57%	11.43%	5	5
15	臺東縣延平鄉	2018-11-24T22:58:08+08:00	335	1118	1453	146	1599	2930	54.57%	11.43%	5	5
15	臺東縣延平鄉	2018-11-24T23:47:43+08:00	335	1118	1453	146	1599	2930	54.57%	11.43%	5	5
15	臺東縣延平鄉	2018-11-24T23:56:01+08:00	335	1118	1453	146	1599	2930	54.57%	11.43%	5	5
15	臺東縣延平鄉	2018-11-24T23:01:46+08:00	335	1118	1453	146	1599	2930	54.57%	11.43%	5	5
15	臺東縣延平鄉	2018-11-24T23:12:30+08:00	335	1118	1453	146	1599	2930	54.57%	11.43%	5	5
15	臺東縣延平鄉	2018-11-24T23:27:30+08:00	335	1118	1453	146	1599	2930	54.57%	11.43%	5	5
15	臺東縣延平鄉	2018-11-25T06:09:09+08:00	335	1118	1453	146	1599	2930	54.57%	11.43%	5	5
15	臺東縣延平鄉	2018-11-24T22:13:45+08:00	95	346	441	43	484	911	53.13%	10.43%	2	5
15	臺東縣延平鄉	2018-11-24T23:51:48+08:00	335	1118	1453	146	1599	2930	54.57%	11.43%	5	5
15	臺東縣延平鄉	2018-11-24T22:30:23+08:00	95	346	441	43	484	911	53.13%	10.43%	2	5
15	臺東縣延平鄉	2018-11-25T03:32:52+08:00	335	1118	1453	146	1599	2930	54.57%	11.43%	5	5
15	臺東縣延平鄉	2018-11-25T03:44:40+08:00	335	1118	1453	146	1599	2930	54.57%	11.43%	5	5
15	臺東縣延平鄉	2018-11-25T00:57:51+08:00	335	1118	1453	146	1599	2930	54.57%	11.43%	5	5
15	臺東縣延平鄉	2018-11-24T22:19:50+08:00	95	346	441	43	484	911	53.13%	10.43%	2	5
15	臺東縣延平鄉	2018-11-24T22:16:25+08:00	95	346	441	43	484	911	53.13%	10.43%	2	5
15	臺東縣延平鄉	2018-11-25T00:09:50+08:00	335	1118	1453	146	1599	2930	54.57%	11.43%	5	5
15	臺東縣延平鄉	2018-11-25T00:18:47+08:00	335	1118	1453	146	1599	2930	54.57%	11.43%	5	5
15	臺東縣延平鄉	2018-11-24T22:37:14+08:00	153	542	695	64	759	1490	50.94%	10.27%	3	5
15	臺東縣延平鄉	2018-11-24T23:20:08+08:00	335	1118	1453	146	1599	2930	54.57%	11.43%	5	5
15	臺東縣延平鄉	2018-11-24T23:31:27+08:00	335	1118	1453	146	1599	2930	54.57%	11.43%	5	5
15	臺東縣延平鄉	2018-11-25T01:12:58+08:00	335	1118	1453	146	1599	2930	54.57%	11.43%	5	5
15	臺東縣延平鄉	2018-11-24T23:05:16+08:00	335	1118	1453	146	1599	2930	54.57%	11.43%	5	5
15	臺東縣延平鄉	2018-11-25T01:07:40+08:00	335	1118	1453	146	1599	2930	54.57%	11.43%	5	5
15	臺東縣延平鄉	2018-11-24T23:39:32+08:00	335	1118	1453	146	1599	2930	54.57%	11.43%	5	5
15	臺東縣延平鄉	2018-11-24T22:54:37+08:00	283	923	1206	96	1302	2504	52%	11.3%	4	5
15	臺東縣延平鄉	2018-11-24T22:33:50+08:00	95	346	441	43	484	911	53.13%	10.43%	2	5
15	臺東縣延平鄉	2018-11-24T22:45:20+08:00	153	542	695	64	759	1490	50.94%	10.27%	3	5
15	臺東縣延平鄉	2018-11-25T00:05:18+08:00	335	1118	1453	146	1599	2930	54.57%	11.43%	5	5
15	臺東縣延平鄉	2018-11-24T22:26:48+08:00	95	346	441	43	484	911	53.13%	10.43%	2	5
15	臺東縣延平鄉	2018-11-25T04:03:05+08:00	335	1118	1453	146	1599	2930	54.57%	11.43%	5	5
15	臺東縣延平鄉	2018-11-24T23:08:51+08:00	335	1118	1453	146	1599	2930	54.57%	11.43%	5	5
15	臺東縣延平鄉	2018-11-24T23:23:50+08:00	335	1118	1453	146	1599	2930	54.57%	11.43%	5	5
15	臺東縣延平鄉	2018-11-25T00:23:17+08:00	335	1118	1453	146	1599	2930	54.57%	11.43%	5	5
15	臺東縣延平鄉	2018-11-25T00:00:24+08:00	335	1118	1453	146	1599	2930	54.57%	11.43%	5	5
15	臺東縣延平鄉	2018-11-24T22:51:03+08:00	283	923	1206	96	1302	2504	52%	11.3%	4	5
15	臺東縣延平鄉	2018-11-24T22:23:28+08:00	95	346	441	43	484	911	53.13%	10.43%	2	5
15	臺東縣延平鄉	2018-11-24T22:40:40+08:00	153	542	695	64	759	1490	50.94%	10.27%	3	5
15	臺東縣延平鄉	2018-11-25T06:24:13+08:00	335	1118	1453	146	1599	2930	54.57%	11.43%	5	5
15	臺東縣延平鄉	2018-11-25T01:02:44+08:00	335	1118	1453	146	1599	2930	54.57%	11.43%	5	5
15	臺東縣延平鄉	2018-11-25T06:14:05+08:00	335	1118	1453	146	1599	2930	54.57%	11.43%	5	5
15	臺東縣延平鄉	2018-11-25T06:19:10+08:00	335	1118	1453	146	1599	2930	54.57%	11.43%	5	5
15	臺東縣延平鄉	2018-11-25T00:14:23+08:00	335	1118	1453	146	1599	2930	54.57%	11.43%	5	5
15	臺東縣延平鄉	2018-11-25T01:18:10+08:00	335	1118	1453	146	1599	2930	54.57%	11.43%	5	5
15	臺東縣延平鄉	2018-11-25T03:50:04+08:00	335	1118	1453	146	1599	2930	54.57%	11.43%	5	5
15	臺東縣延平鄉	2018-11-25T03:39:07+08:00	335	1118	1453	146	1599	2930	54.57%	11.43%	5	5
15	臺東縣延平鄉	2018-11-24T22:41:50+08:00	153	542	695	64	759	1490	50.94%	10.27%	3	5
15	臺東縣延平鄉	2018-11-25T06:29:31+08:00	335	1118	1453	146	1599	2930	54.57%	11.43%	5	5
15	臺東縣延平鄉	2018-11-24T23:16:16+08:00	335	1118	1453	146	1599	2930	54.57%	11.43%	5	5
15	臺東縣延平鄉	2018-11-24T23:35:22+08:00	335	1118	1453	146	1599	2930	54.57%	11.43%	5	5
15	臺東縣延平鄉	2018-11-24T23:43:30+08:00	335	1118	1453	146	1599	2930	54.57%	11.43%	5	5
15	臺東縣延平鄉	2018-11-25T01:26:08+08:00	335	1118	1453	146	1599	2930	54.57%	11.43%	5	5
15	臺東縣關山鎮	2018-11-24T23:56:00+08:00	1032	2442	3474	270	3744	7509	49.86%	13.74%	9	9
15	臺東縣關山鎮	2018-11-24T22:58:08+08:00	1032	2442	3474	270	3744	7509	49.86%	13.74%	9	9
15	臺東縣關山鎮	2018-11-25T01:18:09+08:00	1032	2442	3474	270	3744	7509	49.86%	13.74%	9	9
15	臺東縣關山鎮	2018-11-25T03:56:27+08:00	1032	2442	3474	270	3744	7509	49.86%	13.74%	9	9
15	臺東縣關山鎮	2018-11-24T23:47:42+08:00	1032	2442	3474	270	3744	7509	49.86%	13.74%	9	9
15	臺東縣關山鎮	2018-11-24T23:12:30+08:00	1032	2442	3474	270	3744	7509	49.86%	13.74%	9	9
15	臺東縣關山鎮	2018-11-24T23:27:30+08:00	1032	2442	3474	270	3744	7509	49.86%	13.74%	9	9
15	臺東縣關山鎮	2018-11-25T06:09:09+08:00	1032	2442	3474	270	3744	7509	49.86%	13.74%	9	9
15	臺東縣關山鎮	2018-11-24T23:51:48+08:00	1032	2442	3474	270	3744	7509	49.86%	13.74%	9	9
15	臺東縣關山鎮	2018-11-24T22:30:23+08:00	1032	2442	3474	270	3744	7509	49.86%	13.74%	9	9
15	臺東縣關山鎮	2018-11-25T03:32:52+08:00	1032	2442	3474	270	3744	7509	49.86%	13.74%	9	9
15	臺東縣關山鎮	2018-11-24T22:13:44+08:00	1032	2442	3474	270	3744	7509	49.86%	13.74%	9	9
15	臺東縣關山鎮	2018-11-25T03:44:40+08:00	1032	2442	3474	270	3744	7509	49.86%	13.74%	9	9
15	臺東縣關山鎮	2018-11-25T00:57:50+08:00	1032	2442	3474	270	3744	7509	49.86%	13.74%	9	9
15	臺東縣關山鎮	2018-11-24T23:20:07+08:00	1032	2442	3474	270	3744	7509	49.86%	13.74%	9	9
15	臺東縣關山鎮	2018-11-24T22:16:25+08:00	1032	2442	3474	270	3744	7509	49.86%	13.74%	9	9
15	臺東縣關山鎮	2018-11-24T23:31:26+08:00	1032	2442	3474	270	3744	7509	49.86%	13.74%	9	9
15	臺東縣關山鎮	2018-11-25T00:09:50+08:00	1032	2442	3474	270	3744	7509	49.86%	13.74%	9	9
15	臺東縣關山鎮	2018-11-24T22:37:13+08:00	1032	2442	3474	270	3744	7509	49.86%	13.74%	9	9
15	臺東縣關山鎮	2018-11-25T00:18:46+08:00	1032	2442	3474	270	3744	7509	49.86%	13.74%	9	9
15	臺東縣關山鎮	2018-11-24T23:16:15+08:00	1032	2442	3474	270	3744	7509	49.86%	13.74%	9	9
15	臺東縣關山鎮	2018-11-25T01:12:58+08:00	1032	2442	3474	270	3744	7509	49.86%	13.74%	9	9
15	臺東縣關山鎮	2018-11-25T00:05:17+08:00	1032	2442	3474	270	3744	7509	49.86%	13.74%	9	9
15	臺東縣關山鎮	2018-11-24T23:05:16+08:00	1032	2442	3474	270	3744	7509	49.86%	13.74%	9	9
15	臺東縣關山鎮	2018-11-24T23:39:32+08:00	1032	2442	3474	270	3744	7509	49.86%	13.74%	9	9
15	臺東縣關山鎮	2018-11-24T22:54:37+08:00	1032	2442	3474	270	3744	7509	49.86%	13.74%	9	9
15	臺東縣關山鎮	2018-11-24T22:33:50+08:00	1032	2442	3474	270	3744	7509	49.86%	13.74%	9	9
15	臺東縣關山鎮	2018-11-24T22:45:20+08:00	1032	2442	3474	270	3744	7509	49.86%	13.74%	9	9
15	臺東縣關山鎮	2018-11-24T22:26:48+08:00	1032	2442	3474	270	3744	7509	49.86%	13.74%	9	9
15	臺東縣關山鎮	2018-11-24T23:01:45+08:00	1032	2442	3474	270	3744	7509	49.86%	13.74%	9	9
15	臺東縣關山鎮	2018-11-25T04:03:05+08:00	1032	2442	3474	270	3744	7509	49.86%	13.74%	9	9
15	臺東縣關山鎮	2018-11-24T23:08:51+08:00	1032	2442	3474	270	3744	7509	49.86%	13.74%	9	9
15	臺東縣關山鎮	2018-11-24T23:23:50+08:00	1032	2442	3474	270	3744	7509	49.86%	13.74%	9	9
15	臺東縣關山鎮	2018-11-24T22:19:49+08:00	1032	2442	3474	270	3744	7509	49.86%	13.74%	9	9
15	臺東縣關山鎮	2018-11-25T00:00:23+08:00	1032	2442	3474	270	3744	7509	49.86%	13.74%	9	9
15	臺東縣關山鎮	2018-11-24T22:51:03+08:00	1032	2442	3474	270	3744	7509	49.86%	13.74%	9	9
15	臺東縣關山鎮	2018-11-24T22:23:28+08:00	1032	2442	3474	270	3744	7509	49.86%	13.74%	9	9
15	臺東縣關山鎮	2018-11-24T22:40:40+08:00	1032	2442	3474	270	3744	7509	49.86%	13.74%	9	9
15	臺東縣關山鎮	2018-11-25T06:24:13+08:00	1032	2442	3474	270	3744	7509	49.86%	13.74%	9	9
15	臺東縣關山鎮	2018-11-25T01:02:44+08:00	1032	2442	3474	270	3744	7509	49.86%	13.74%	9	9
15	臺東縣關山鎮	2018-11-25T06:14:05+08:00	1032	2442	3474	270	3744	7509	49.86%	13.74%	9	9
15	臺東縣關山鎮	2018-11-25T00:23:16+08:00	1032	2442	3474	270	3744	7509	49.86%	13.74%	9	9
15	臺東縣關山鎮	2018-11-25T06:19:10+08:00	1032	2442	3474	270	3744	7509	49.86%	13.74%	9	9
15	臺東縣關山鎮	2018-11-25T03:50:03+08:00	1032	2442	3474	270	3744	7509	49.86%	13.74%	9	9
15	臺東縣關山鎮	2018-11-25T01:07:39+08:00	1032	2442	3474	270	3744	7509	49.86%	13.74%	9	9
15	臺東縣關山鎮	2018-11-25T01:26:07+08:00	1032	2442	3474	270	3744	7509	49.86%	13.74%	9	9
15	臺東縣關山鎮	2018-11-25T03:39:07+08:00	1032	2442	3474	270	3744	7509	49.86%	13.74%	9	9
15	臺東縣關山鎮	2018-11-24T22:41:50+08:00	1032	2442	3474	270	3744	7509	49.86%	13.74%	9	9
15	臺東縣關山鎮	2018-11-25T00:14:22+08:00	1032	2442	3474	270	3744	7509	49.86%	13.74%	9	9
15	臺東縣關山鎮	2018-11-25T06:29:31+08:00	1032	2442	3474	270	3744	7509	49.86%	13.74%	9	9
15	臺東縣關山鎮	2018-11-24T23:35:22+08:00	1032	2442	3474	270	3744	7509	49.86%	13.74%	9	9
15	臺東縣關山鎮	2018-11-24T23:43:30+08:00	1032	2442	3474	270	3744	7509	49.86%	13.74%	9	9
15	臺中市烏日區	2018-11-25T03:56:17+08:00	10735	23059	33794	2375	36169	61705	58.62%	17.4%	40	40
15	臺中市烏日區	2018-11-25T06:29:21+08:00	10735	23059	33794	2375	36169	61705	58.62%	17.4%	40	40
15	臺中市烏日區	2018-11-25T03:49:55+08:00	10735	23059	33794	2375	36169	61705	58.62%	17.4%	40	40
15	臺中市烏日區	2018-11-25T06:19:01+08:00	10735	23059	33794	2375	36169	61705	58.62%	17.4%	40	40
15	臺中市烏日區	2018-11-24T23:16:07+08:00	9489	20226	29715	2055	31770	54084	58.74%	17.54%	36	40
15	臺中市烏日區	2018-11-24T22:45:12+08:00	8594	18244	26838	1914	28752	48768	58.96%	17.62%	33	40
15	臺中市烏日區	2018-11-24T23:43:21+08:00	10735	23059	33794	2375	36169	61705	58.62%	17.4%	40	40
15	臺中市烏日區	2018-11-24T22:41:40+08:00	8594	18244	26838	1914	28752	48768	58.96%	17.62%	33	40
15	臺中市烏日區	2018-11-25T00:18:36+08:00	10735	23059	33794	2375	36169	61705	58.62%	17.4%	40	40
15	臺中市烏日區	2018-11-24T23:51:40+08:00	10735	23059	33794	2375	36169	61705	58.62%	17.4%	40	40
15	臺中市烏日區	2018-11-25T01:25:57+08:00	10735	23059	33794	2375	36169	61705	58.62%	17.4%	40	40
15	臺中市烏日區	2018-11-24T22:30:14+08:00	7556	15968	23524	1697	25221	42589	59.22%	17.74%	29	40
15	臺中市烏日區	2018-11-25T06:24:04+08:00	10735	23059	33794	2375	36169	61705	58.62%	17.4%	40	40
15	臺中市烏日區	2018-11-25T00:23:08+08:00	10735	23059	33794	2375	36169	61705	58.62%	17.4%	40	40
15	臺中市烏日區	2018-11-25T03:32:39+08:00	10735	23059	33794	2375	36169	61705	58.62%	17.4%	40	40
15	臺中市烏日區	2018-11-24T23:27:22+08:00	10468	22432	32900	2283	35183	60131	58.51%	17.41%	39	40
15	臺中市烏日區	2018-11-24T22:57:59+08:00	9489	20226	29715	2055	31770	54084	58.74%	17.54%	36	40
15	臺中市烏日區	2018-11-24T23:08:41+08:00	9489	20226	29715	2055	31770	54084	58.74%	17.54%	36	40
15	臺中市烏日區	2018-11-24T22:13:33+08:00	6443	13480	19923	1446	21369	36024	59.32%	17.89%	25	40
15	臺中市烏日區	2018-11-24T23:19:56+08:00	9837	20913	30750	2131	32881	56145	58.56%	17.52%	37	40
15	臺中市烏日區	2018-11-25T01:17:58+08:00	10735	23059	33794	2375	36169	61705	58.62%	17.4%	40	40
15	臺中市烏日區	2018-11-24T22:54:29+08:00	9489	20226	29715	2055	31770	54084	58.74%	17.54%	36	40
15	臺中市烏日區	2018-11-24T23:47:33+08:00	10735	23059	33794	2375	36169	61705	58.62%	17.4%	40	40
15	臺中市烏日區	2018-11-25T06:08:58+08:00	10735	23059	33794	2375	36169	61705	58.62%	17.4%	40	40
15	臺中市烏日區	2018-11-24T22:16:15+08:00	6711	14168	20879	1528	22407	37846	59.21%	17.73%	26	40
15	臺中市烏日區	2018-11-24T23:31:16+08:00	10735	23059	33794	2375	36169	61705	58.62%	17.4%	40	40
15	臺中市烏日區	2018-11-25T01:12:48+08:00	10735	23059	33794	2375	36169	61705	58.62%	17.4%	40	40
15	臺中市烏日區	2018-11-24T23:05:08+08:00	9489	20226	29715	2055	31770	54084	58.74%	17.54%	36	40
15	臺中市烏日區	2018-11-25T04:02:57+08:00	10735	23059	33794	2375	36169	61705	58.62%	17.4%	40	40
15	臺中市烏日區	2018-11-25T00:05:09+08:00	10735	23059	33794	2375	36169	61705	58.62%	17.4%	40	40
15	臺中市烏日區	2018-11-25T06:13:56+08:00	10735	23059	33794	2375	36169	61705	58.62%	17.4%	40	40
15	臺中市烏日區	2018-11-24T22:50:53+08:00	9489	20226	29715	2055	31770	54084	58.74%	17.54%	36	40
15	臺中市烏日區	2018-11-24T22:37:05+08:00	8301	17586	25887	1860	27747	47077	58.94%	17.63%	32	40
15	臺中市烏日區	2018-11-24T22:26:41+08:00	7556	15968	23524	1697	25221	42589	59.22%	17.74%	29	40
15	臺中市烏日區	2018-11-24T22:19:41+08:00	7000	14768	21768	1595	23363	39393	59.31%	17.77%	27	40
15	臺中市烏日區	2018-11-25T03:38:59+08:00	10735	23059	33794	2375	36169	61705	58.62%	17.4%	40	40
15	臺中市烏日區	2018-11-24T22:40:31+08:00	8594	18244	26838	1914	28752	48768	58.96%	17.62%	33	40
15	臺中市烏日區	2018-11-25T01:02:35+08:00	10735	23059	33794	2375	36169	61705	58.62%	17.4%	40	40
15	臺中市烏日區	2018-11-25T00:57:41+08:00	10735	23059	33794	2375	36169	61705	58.62%	17.4%	40	40
15	臺中市烏日區	2018-11-25T03:44:28+08:00	10735	23059	33794	2375	36169	61705	58.62%	17.4%	40	40
15	臺中市烏日區	2018-11-24T23:23:42+08:00	10468	22432	32900	2283	35183	60131	58.51%	17.41%	39	40
15	臺中市烏日區	2018-11-24T22:23:18+08:00	7556	15968	23524	1697	25221	42589	59.22%	17.74%	29	40
15	臺中市烏日區	2018-11-25T00:00:15+08:00	10735	23059	33794	2375	36169	61705	58.62%	17.4%	40	40
15	臺中市烏日區	2018-11-24T23:55:51+08:00	10735	23059	33794	2375	36169	61705	58.62%	17.4%	40	40
15	臺中市烏日區	2018-11-24T23:35:15+08:00	10735	23059	33794	2375	36169	61705	58.62%	17.4%	40	40
15	臺中市烏日區	2018-11-24T23:39:21+08:00	10735	23059	33794	2375	36169	61705	58.62%	17.4%	40	40
15	臺中市烏日區	2018-11-25T01:07:30+08:00	10735	23059	33794	2375	36169	61705	58.62%	17.4%	40	40
15	臺中市烏日區	2018-11-24T23:12:20+08:00	9489	20226	29715	2055	31770	54084	58.74%	17.54%	36	40
15	臺中市烏日區	2018-11-25T00:14:14+08:00	10735	23059	33794	2375	36169	61705	58.62%	17.4%	40	40
15	臺中市烏日區	2018-11-24T23:01:35+08:00	9489	20226	29715	2055	31770	54084	58.74%	17.54%	36	40
15	臺中市烏日區	2018-11-25T00:09:39+08:00	10735	23059	33794	2375	36169	61705	58.62%	17.4%	40	40
15	臺中市烏日區	2018-11-24T22:33:42+08:00	7556	15968	23524	1697	25221	42589	59.22%	17.74%	29	40
15	彰化縣	2018-11-24T22:26:44+08:00	81767	184434	266201	18681	284882	499969	56.98%	16.35%	530	1
15	彰化縣	2018-11-25T00:05:13+08:00	151444	341376	492820	33471	526291	917012	57.39%	16.51%	920	1
15	彰化縣	2018-11-24T23:01:40+08:00	113030	256015	369045	25563	394608	690193	57.17%	16.38%	712	1
15	彰化縣	2018-11-24T23:05:12+08:00	114907	259595	374502	25985	400487	700258	57.19%	16.41%	722	1
15	彰化縣	2018-11-25T06:29:26+08:00	177421	398192	575613	38235	613848	1066994	57.53%	16.63%	049	1
15	彰化縣	2018-11-25T00:09:44+08:00	153221	345500	498721	33881	532602	927983	57.39%	16.51%	928	1
15	彰化縣	2018-11-24T22:37:08+08:00	92823	209129	301952	21207	323159	567755	56.92%	16.35%	596	1
15	彰化縣	2018-11-24T22:54:33+08:00	106430	240375	346805	24060	370865	649827	57.07%	16.38%	675	1
15	彰化縣	2018-11-24T22:50:57+08:00	104139	235232	339371	23629	363000	636395	57.04%	16.36%	662	1
15	彰化縣	2018-11-25T01:12:53+08:00	172150	386870	559020	37401	596421	1037898	57.46%	16.59%	023	1
15	彰化縣	2018-11-24T22:40:35+08:00	96010	216759	312769	21872	334641	587196	56.99%	16.35%	615	1
15	彰化縣	2018-11-24T22:19:45+08:00	76544	173417	249961	17618	267579	470625	56.86%	16.26%	502	1
15	彰化縣	2018-11-25T01:02:39+08:00	171007	384085	555092	37110	592202	1030295	57.48%	16.6%	016	1
15	彰化縣	2018-11-25T04:03:00+08:00	177421	398192	575613	38235	613848	1066994	57.53%	16.63%	049	1
15	彰化縣	2018-11-25T06:14:00+08:00	177421	398192	575613	38235	613848	1066994	57.53%	16.63%	049	1
15	彰化縣	2018-11-24T23:23:46+08:00	130795	295142	425937	29406	455343	794620	57.3%	16.46%	809	1
15	彰化縣	2018-11-24T22:23:23+08:00	79189	179383	258572	18181	276753	486014	56.94%	16.29%	517	1
15	彰化縣	2018-11-25T03:32:46+08:00	177421	398192	575613	38235	613848	1066994	57.53%	16.63%	049	1
15	彰化縣	2018-11-24T23:55:55+08:00	148715	335776	484491	33008	517499	902080	57.37%	16.49%	907	1
15	彰化縣	2018-11-25T00:00:19+08:00	149541	337529	487070	33145	520215	906718	57.37%	16.49%	911	1
15	彰化縣	2018-11-25T00:23:12+08:00	159022	358287	517309	34943	552252	962216	57.39%	16.53%	956	1
15	彰化縣	2018-11-24T23:08:46+08:00	116211	262715	378926	26258	405184	708183	57.21%	16.41%	729	1
15	彰化縣	2018-11-24T23:31:21+08:00	134456	303390	437846	30223	468069	816790	57.31%	16.46%	830	1
15	彰化縣	2018-11-24T23:20:00+08:00	128476	290188	418664	28859	447523	780940	57.31%	16.45%	797	1
15	彰化縣	2018-11-24T23:35:18+08:00	136883	308792	445675	30638	476313	830983	57.32%	16.47%	843	1
15	彰化縣	2018-11-25T00:14:18+08:00	154770	349184	503954	34115	538069	937662	57.38%	16.51%	936	1
15	彰化縣	2018-11-24T23:12:25+08:00	119478	270086	389564	26924	416488	727338	57.26%	16.43%	746	1
15	彰化縣	2018-11-25T03:39:02+08:00	177421	398192	575613	38235	613848	1066994	57.53%	16.63%	049	1
15	彰化縣	2018-11-25T01:07:35+08:00	171766	385835	557601	37318	594919	1035279	57.46%	16.59%	021	1
15	彰化縣	2018-11-24T22:33:46+08:00	90516	204159	294675	20678	315353	553902	56.93%	16.34%	582	1
15	彰化縣	2018-11-25T00:18:41+08:00	157254	354620	511874	34578	546452	951998	57.4%	16.52%	948	1
15	彰化縣	2018-11-24T22:41:45+08:00	96010	216759	312769	21872	334641	587196	56.99%	16.35%	615	1
15	彰化縣	2018-11-25T03:56:22+08:00	177421	398192	575613	38235	613848	1066994	57.53%	16.63%	049	1
15	彰化縣	2018-11-25T06:19:05+08:00	177421	398192	575613	38235	613848	1066994	57.53%	16.63%	049	1
15	彰化縣	2018-11-24T22:45:16+08:00	98845	223175	322020	22563	344583	604651	56.99%	16.35%	632	1
15	彰化縣	2018-11-24T23:43:25+08:00	141159	318825	459984	31599	491583	857131	57.35%	16.47%	868	1
15	彰化縣	2018-11-25T01:18:03+08:00	172532	387691	560223	37459	597682	1040082	57.46%	16.59%	025	1
15	彰化縣	2018-11-25T03:49:59+08:00	177421	398192	575613	38235	613848	1066994	57.53%	16.63%	049	1
15	彰化縣	2018-11-24T22:58:03+08:00	110994	250660	361654	25131	386785	677020	57.13%	16.39%	700	1
15	彰化縣	2018-11-25T06:09:03+08:00	177421	398192	575613	38235	613848	1066994	57.53%	16.63%	049	1
15	彰化縣	2018-11-24T23:51:43+08:00	146779	330934	477713	32621	510334	889388	57.38%	16.5%	897	1
15	彰化縣	2018-11-25T06:24:08+08:00	177421	398192	575613	38235	613848	1066994	57.53%	16.63%	049	1
15	彰化縣	2018-11-25T00:57:46+08:00	171007	384085	555092	37110	592202	1030295	57.48%	16.6%	016	1
15	彰化縣	2018-11-24T22:30:18+08:00	85110	191698	276808	19482	296290	519728	57.01%	16.38%	549	1
15	彰化縣	2018-11-24T23:27:26+08:00	132210	298194	430404	29663	460067	802551	57.33%	16.47%	816	1
15	彰化縣	2018-11-24T22:13:39+08:00	70425	159609	230034	16284	246318	434212	56.73%	16.22%	468	1
15	彰化縣	2018-11-25T03:44:34+08:00	177421	398192	575613	38235	613848	1066994	57.53%	16.63%	049	1
15	彰化縣	2018-11-24T23:39:26+08:00	138372	312334	450706	30967	481673	840137	57.33%	16.47%	852	1
15	彰化縣	2018-11-24T23:16:11+08:00	125877	285103	410980	28252	439232	766747	57.29%	16.42%	784	1
15	彰化縣	2018-11-24T23:47:38+08:00	143256	323452	466708	31995	498703	869307	57.37%	16.48%	879	1
15	彰化縣	2018-11-25T01:26:01+08:00	173192	389184	562376	37569	599945	1043601	57.49%	16.6%	028	1
15	彰化縣	2018-11-24T22:16:20+08:00	73936	167760	241696	17084	258780	455746	56.78%	16.22%	488	1
15	屏東縣泰武鄉	2018-11-25T03:56:26+08:00	699	1915	2614	195	2809	4344	64.66%	16.09%	7	7
15	屏東縣泰武鄉	2018-11-24T23:05:15+08:00	699	1915	2614	195	2809	4344	64.66%	16.09%	7	7
15	屏東縣泰武鄉	2018-11-25T01:18:08+08:00	699	1915	2614	195	2809	4344	64.66%	16.09%	7	7
15	屏東縣泰武鄉	2018-11-24T23:39:30+08:00	699	1915	2614	195	2809	4344	64.66%	16.09%	7	7
15	屏東縣泰武鄉	2018-11-25T06:29:29+08:00	699	1915	2614	195	2809	4344	64.66%	16.09%	7	7
15	屏東縣泰武鄉	2018-11-25T06:19:09+08:00	699	1915	2614	195	2809	4344	64.66%	16.09%	7	7
15	屏東縣泰武鄉	2018-11-24T22:58:07+08:00	699	1915	2614	195	2809	4344	64.66%	16.09%	7	7
15	屏東縣泰武鄉	2018-11-24T22:41:49+08:00	699	1915	2614	195	2809	4344	64.66%	16.09%	7	7
15	屏東縣泰武鄉	2018-11-24T23:43:28+08:00	699	1915	2614	195	2809	4344	64.66%	16.09%	7	7
15	屏東縣泰武鄉	2018-11-25T06:09:07+08:00	699	1915	2614	195	2809	4344	64.66%	16.09%	7	7
15	屏東縣泰武鄉	2018-11-24T22:30:22+08:00	590	1608	2198	159	2357	3746	62.92%	15.75%	6	7
15	屏東縣泰武鄉	2018-11-24T23:51:47+08:00	699	1915	2614	195	2809	4344	64.66%	16.09%	7	7
15	屏東縣泰武鄉	2018-11-24T22:13:43+08:00	590	1608	2198	159	2357	3746	62.92%	15.75%	6	7
15	屏東縣泰武鄉	2018-11-24T23:08:49+08:00	699	1915	2614	195	2809	4344	64.66%	16.09%	7	7
15	屏東縣泰武鄉	2018-11-24T22:51:01+08:00	699	1915	2614	195	2809	4344	64.66%	16.09%	7	7
15	屏東縣泰武鄉	2018-11-25T03:44:38+08:00	699	1915	2614	195	2809	4344	64.66%	16.09%	7	7
15	屏東縣泰武鄉	2018-11-25T00:23:15+08:00	699	1915	2614	195	2809	4344	64.66%	16.09%	7	7
15	屏東縣泰武鄉	2018-11-24T23:23:49+08:00	699	1915	2614	195	2809	4344	64.66%	16.09%	7	7
15	屏東縣泰武鄉	2018-11-24T22:33:49+08:00	590	1608	2198	159	2357	3746	62.92%	15.75%	6	7
15	屏東縣泰武鄉	2018-11-24T22:37:12+08:00	590	1608	2198	159	2357	3746	62.92%	15.75%	6	7
15	屏東縣泰武鄉	2018-11-24T23:16:14+08:00	699	1915	2614	195	2809	4344	64.66%	16.09%	7	7
15	屏東縣泰武鄉	2018-11-24T22:16:23+08:00	590	1608	2198	159	2357	3746	62.92%	15.75%	6	7
15	屏東縣泰武鄉	2018-11-25T00:14:21+08:00	699	1915	2614	195	2809	4344	64.66%	16.09%	7	7
15	屏東縣泰武鄉	2018-11-24T23:35:21+08:00	699	1915	2614	195	2809	4344	64.66%	16.09%	7	7
15	屏東縣泰武鄉	2018-11-24T22:45:19+08:00	699	1915	2614	195	2809	4344	64.66%	16.09%	7	7
15	屏東縣泰武鄉	2018-11-24T22:54:36+08:00	699	1915	2614	195	2809	4344	64.66%	16.09%	7	7
15	屏東縣泰武鄉	2018-11-25T00:09:48+08:00	699	1915	2614	195	2809	4344	64.66%	16.09%	7	7
15	屏東縣泰武鄉	2018-11-24T23:01:44+08:00	699	1915	2614	195	2809	4344	64.66%	16.09%	7	7
15	屏東縣泰武鄉	2018-11-24T22:26:47+08:00	590	1608	2198	159	2357	3746	62.92%	15.75%	6	7
15	屏東縣泰武鄉	2018-11-24T23:47:41+08:00	699	1915	2614	195	2809	4344	64.66%	16.09%	7	7
15	屏東縣泰武鄉	2018-11-25T01:12:57+08:00	699	1915	2614	195	2809	4344	64.66%	16.09%	7	7
15	屏東縣泰武鄉	2018-11-25T00:05:16+08:00	699	1915	2614	195	2809	4344	64.66%	16.09%	7	7
15	屏東縣泰武鄉	2018-11-25T00:57:49+08:00	699	1915	2614	195	2809	4344	64.66%	16.09%	7	7
15	屏東縣泰武鄉	2018-11-24T22:19:48+08:00	590	1608	2198	159	2357	3746	62.92%	15.75%	6	7
15	屏東縣泰武鄉	2018-11-25T03:32:50+08:00	699	1915	2614	195	2809	4344	64.66%	16.09%	7	7
15	屏東縣泰武鄉	2018-11-25T04:03:04+08:00	699	1915	2614	195	2809	4344	64.66%	16.09%	7	7
15	屏東縣泰武鄉	2018-11-24T22:40:39+08:00	699	1915	2614	195	2809	4344	64.66%	16.09%	7	7
15	屏東縣泰武鄉	2018-11-25T06:14:04+08:00	699	1915	2614	195	2809	4344	64.66%	16.09%	7	7
15	屏東縣泰武鄉	2018-11-25T01:02:42+08:00	699	1915	2614	195	2809	4344	64.66%	16.09%	7	7
15	屏東縣泰武鄉	2018-11-24T23:55:59+08:00	699	1915	2614	195	2809	4344	64.66%	16.09%	7	7
15	屏東縣泰武鄉	2018-11-25T06:24:12+08:00	699	1915	2614	195	2809	4344	64.66%	16.09%	7	7
15	屏東縣泰武鄉	2018-11-24T22:23:26+08:00	590	1608	2198	159	2357	3746	62.92%	15.75%	6	7
15	屏東縣泰武鄉	2018-11-24T23:27:29+08:00	699	1915	2614	195	2809	4344	64.66%	16.09%	7	7
15	屏東縣泰武鄉	2018-11-25T00:00:22+08:00	699	1915	2614	195	2809	4344	64.66%	16.09%	7	7
15	屏東縣泰武鄉	2018-11-24T23:12:29+08:00	699	1915	2614	195	2809	4344	64.66%	16.09%	7	7
15	屏東縣泰武鄉	2018-11-24T23:31:25+08:00	699	1915	2614	195	2809	4344	64.66%	16.09%	7	7
15	屏東縣泰武鄉	2018-11-24T23:20:04+08:00	699	1915	2614	195	2809	4344	64.66%	16.09%	7	7
15	屏東縣泰武鄉	2018-11-25T00:18:45+08:00	699	1915	2614	195	2809	4344	64.66%	16.09%	7	7
15	屏東縣泰武鄉	2018-11-25T01:07:38+08:00	699	1915	2614	195	2809	4344	64.66%	16.09%	7	7
15	屏東縣泰武鄉	2018-11-25T03:39:06+08:00	699	1915	2614	195	2809	4344	64.66%	16.09%	7	7
15	屏東縣泰武鄉	2018-11-25T01:26:06+08:00	699	1915	2614	195	2809	4344	64.66%	16.09%	7	7
15	屏東縣泰武鄉	2018-11-25T03:50:02+08:00	699	1915	2614	195	2809	4344	64.66%	16.09%	7	7
15	苗栗縣西湖鄉	2018-11-24T22:26:44+08:00	987	2288	3275	253	3528	6382	55.28%	15.47%	9	9
15	苗栗縣西湖鄉	2018-11-25T00:05:13+08:00	987	2288	3275	253	3528	6382	55.28%	15.47%	9	9
15	苗栗縣西湖鄉	2018-11-24T23:05:12+08:00	987	2288	3275	253	3528	6382	55.28%	15.47%	9	9
15	苗栗縣西湖鄉	2018-11-25T06:29:26+08:00	987	2288	3275	253	3528	6382	55.28%	15.47%	9	9
15	苗栗縣西湖鄉	2018-11-25T00:09:43+08:00	987	2288	3275	253	3528	6382	55.28%	15.47%	9	9
15	苗栗縣西湖鄉	2018-11-24T22:37:08+08:00	987	2288	3275	253	3528	6382	55.28%	15.47%	9	9
15	苗栗縣西湖鄉	2018-11-24T22:54:33+08:00	987	2288	3275	253	3528	6382	55.28%	15.47%	9	9
15	苗栗縣西湖鄉	2018-11-24T22:50:57+08:00	987	2288	3275	253	3528	6382	55.28%	15.47%	9	9
15	苗栗縣西湖鄉	2018-11-25T01:12:53+08:00	987	2288	3275	253	3528	6382	55.28%	15.47%	9	9
15	苗栗縣西湖鄉	2018-11-24T22:40:35+08:00	987	2288	3275	253	3528	6382	55.28%	15.47%	9	9
15	苗栗縣西湖鄉	2018-11-25T01:02:39+08:00	987	2288	3275	253	3528	6382	55.28%	15.47%	9	9
15	苗栗縣西湖鄉	2018-11-25T04:03:00+08:00	987	2288	3275	253	3528	6382	55.28%	15.47%	9	9
15	苗栗縣西湖鄉	2018-11-25T00:57:45+08:00	987	2288	3275	253	3528	6382	55.28%	15.47%	9	9
15	苗栗縣西湖鄉	2018-11-24T22:19:44+08:00	987	2288	3275	253	3528	6382	55.28%	15.47%	9	9
15	苗栗縣西湖鄉	2018-11-25T06:14:00+08:00	987	2288	3275	253	3528	6382	55.28%	15.47%	9	9
15	苗栗縣西湖鄉	2018-11-24T23:23:46+08:00	987	2288	3275	253	3528	6382	55.28%	15.47%	9	9
15	苗栗縣西湖鄉	2018-11-25T03:32:46+08:00	987	2288	3275	253	3528	6382	55.28%	15.47%	9	9
15	苗栗縣西湖鄉	2018-11-24T23:55:55+08:00	987	2288	3275	253	3528	6382	55.28%	15.47%	9	9
15	苗栗縣西湖鄉	2018-11-25T00:00:19+08:00	987	2288	3275	253	3528	6382	55.28%	15.47%	9	9
15	苗栗縣西湖鄉	2018-11-25T00:23:12+08:00	987	2288	3275	253	3528	6382	55.28%	15.47%	9	9
15	苗栗縣西湖鄉	2018-11-24T22:23:22+08:00	987	2288	3275	253	3528	6382	55.28%	15.47%	9	9
15	苗栗縣西湖鄉	2018-11-24T23:01:39+08:00	987	2288	3275	253	3528	6382	55.28%	15.47%	9	9
15	苗栗縣西湖鄉	2018-11-24T23:31:21+08:00	987	2288	3275	253	3528	6382	55.28%	15.47%	9	9
15	苗栗縣西湖鄉	2018-11-24T23:20:00+08:00	987	2288	3275	253	3528	6382	55.28%	15.47%	9	9
15	苗栗縣西湖鄉	2018-11-25T01:07:34+08:00	987	2288	3275	253	3528	6382	55.28%	15.47%	9	9
15	苗栗縣西湖鄉	2018-11-24T23:35:18+08:00	987	2288	3275	253	3528	6382	55.28%	15.47%	9	9
15	苗栗縣西湖鄉	2018-11-25T00:14:18+08:00	987	2288	3275	253	3528	6382	55.28%	15.47%	9	9
15	苗栗縣西湖鄉	2018-11-24T23:12:25+08:00	987	2288	3275	253	3528	6382	55.28%	15.47%	9	9
15	苗栗縣西湖鄉	2018-11-25T03:39:02+08:00	987	2288	3275	253	3528	6382	55.28%	15.47%	9	9
15	苗栗縣西湖鄉	2018-11-24T22:33:46+08:00	987	2288	3275	253	3528	6382	55.28%	15.47%	9	9
15	苗栗縣西湖鄉	2018-11-25T00:18:41+08:00	987	2288	3275	253	3528	6382	55.28%	15.47%	9	9
15	苗栗縣西湖鄉	2018-11-24T22:41:45+08:00	987	2288	3275	253	3528	6382	55.28%	15.47%	9	9
15	苗栗縣西湖鄉	2018-11-24T23:43:24+08:00	987	2288	3275	253	3528	6382	55.28%	15.47%	9	9
15	苗栗縣西湖鄉	2018-11-25T03:56:22+08:00	987	2288	3275	253	3528	6382	55.28%	15.47%	9	9
15	苗栗縣西湖鄉	2018-11-25T06:19:05+08:00	987	2288	3275	253	3528	6382	55.28%	15.47%	9	9
15	苗栗縣西湖鄉	2018-11-24T22:45:16+08:00	987	2288	3275	253	3528	6382	55.28%	15.47%	9	9
15	苗栗縣西湖鄉	2018-11-25T01:18:03+08:00	987	2288	3275	253	3528	6382	55.28%	15.47%	9	9
15	苗栗縣西湖鄉	2018-11-25T03:49:59+08:00	987	2288	3275	253	3528	6382	55.28%	15.47%	9	9
15	苗栗縣西湖鄉	2018-11-24T22:58:03+08:00	987	2288	3275	253	3528	6382	55.28%	15.47%	9	9
15	苗栗縣西湖鄉	2018-11-25T06:09:03+08:00	987	2288	3275	253	3528	6382	55.28%	15.47%	9	9
15	苗栗縣西湖鄉	2018-11-24T23:51:43+08:00	987	2288	3275	253	3528	6382	55.28%	15.47%	9	9
15	苗栗縣西湖鄉	2018-11-25T06:24:08+08:00	987	2288	3275	253	3528	6382	55.28%	15.47%	9	9
15	苗栗縣西湖鄉	2018-11-24T22:30:18+08:00	987	2288	3275	253	3528	6382	55.28%	15.47%	9	9
15	苗栗縣西湖鄉	2018-11-24T23:27:26+08:00	987	2288	3275	253	3528	6382	55.28%	15.47%	9	9
15	苗栗縣西湖鄉	2018-11-24T23:08:45+08:00	987	2288	3275	253	3528	6382	55.28%	15.47%	9	9
15	苗栗縣西湖鄉	2018-11-24T22:13:39+08:00	987	2288	3275	253	3528	6382	55.28%	15.47%	9	9
15	苗栗縣西湖鄉	2018-11-25T03:44:33+08:00	987	2288	3275	253	3528	6382	55.28%	15.47%	9	9
15	苗栗縣西湖鄉	2018-11-24T23:16:10+08:00	987	2288	3275	253	3528	6382	55.28%	15.47%	9	9
15	苗栗縣西湖鄉	2018-11-24T23:47:37+08:00	987	2288	3275	253	3528	6382	55.28%	15.47%	9	9
15	苗栗縣西湖鄉	2018-11-24T23:39:26+08:00	987	2288	3275	253	3528	6382	55.28%	15.47%	9	9
15	苗栗縣西湖鄉	2018-11-25T01:26:01+08:00	987	2288	3275	253	3528	6382	55.28%	15.47%	9	9
15	苗栗縣西湖鄉	2018-11-24T22:16:20+08:00	987	2288	3275	253	3528	6382	55.28%	15.47%	9	9
15	苗栗縣竹南鎮	2018-11-24T22:26:44+08:00	6874	14651	21525	1142	22667	40116	56.5%	17.14%	39	61
15	苗栗縣竹南鎮	2018-11-25T00:05:13+08:00	11421	24362	35783	1945	37728	67040	56.28%	17.04%	60	61
15	苗栗縣竹南鎮	2018-11-25T03:56:21+08:00	11697	24847	36544	1967	38511	68528	56.2%	17.07%	61	61
15	苗栗縣竹南鎮	2018-11-25T01:12:52+08:00	11697	24847	36544	1967	38511	68528	56.2%	17.07%	61	61
15	苗栗縣竹南鎮	2018-11-24T22:54:32+08:00	9125	19591	28716	1579	30295	53480	56.65%	17.06%	50	61
15	苗栗縣竹南鎮	2018-11-25T00:09:43+08:00	11421	24362	35783	1945	37728	67040	56.28%	17.04%	60	61
15	苗栗縣竹南鎮	2018-11-24T22:37:08+08:00	8150	17345	25495	1402	26897	47436	56.7%	17.18%	45	61
15	苗栗縣竹南鎮	2018-11-24T22:45:15+08:00	8522	18235	26757	1479	28236	49943	56.54%	17.06%	47	61
15	苗栗縣竹南鎮	2018-11-24T22:50:57+08:00	8931	19168	28099	1543	29642	52227	56.76%	17.1%	49	61
15	苗栗縣竹南鎮	2018-11-24T22:40:35+08:00	8292	17721	26013	1433	27446	48602	56.47%	17.06%	46	61
15	苗栗縣竹南鎮	2018-11-25T01:02:39+08:00	11697	24847	36544	1967	38511	68528	56.2%	17.07%	61	61
15	苗栗縣竹南鎮	2018-11-25T04:03:00+08:00	11697	24847	36544	1967	38511	68528	56.2%	17.07%	61	61
15	苗栗縣竹南鎮	2018-11-25T00:57:45+08:00	11421	24362	35783	1945	37728	67040	56.28%	17.04%	60	61
15	苗栗縣竹南鎮	2018-11-24T22:19:44+08:00	6435	13764	20199	1071	21270	37640	56.51%	17.1%	37	61
15	苗栗縣竹南鎮	2018-11-25T06:14:00+08:00	11697	24847	36544	1967	38511	68528	56.2%	17.07%	61	61
15	苗栗縣竹南鎮	2018-11-25T00:00:18+08:00	11421	24362	35783	1945	37728	67040	56.28%	17.04%	60	61
15	苗栗縣竹南鎮	2018-11-24T23:27:25+08:00	10722	22974	33696	1851	35547	62911	56.5%	17.04%	57	61
15	苗栗縣竹南鎮	2018-11-24T23:55:55+08:00	11421	24362	35783	1945	37728	67040	56.28%	17.04%	60	61
15	苗栗縣竹南鎮	2018-11-25T00:23:12+08:00	11421	24362	35783	1945	37728	67040	56.28%	17.04%	60	61
15	苗栗縣竹南鎮	2018-11-24T22:23:22+08:00	6655	14205	20860	1107	21967	38794	56.62%	17.15%	38	61
15	苗栗縣竹南鎮	2018-11-24T23:01:39+08:00	9856	21007	30863	1713	32576	57793	56.37%	17.05%	53	61
15	苗栗縣竹南鎮	2018-11-24T23:20:00+08:00	10722	22974	33696	1851	35547	62911	56.5%	17.04%	57	61
15	苗栗縣竹南鎮	2018-11-25T01:07:34+08:00	11697	24847	36544	1967	38511	68528	56.2%	17.07%	61	61
15	苗栗縣竹南鎮	2018-11-25T00:18:40+08:00	11421	24362	35783	1945	37728	67040	56.28%	17.04%	60	61
15	苗栗縣竹南鎮	2018-11-25T00:14:18+08:00	11421	24362	35783	1945	37728	67040	56.28%	17.04%	60	61
15	苗栗縣竹南鎮	2018-11-24T23:12:25+08:00	10282	21896	32178	1789	33967	60048	56.57%	17.12%	55	61
15	苗栗縣竹南鎮	2018-11-25T03:39:02+08:00	11697	24847	36544	1967	38511	68528	56.2%	17.07%	61	61
15	苗栗縣竹南鎮	2018-11-24T23:31:20+08:00	10980	23464	34444	1885	36329	64455	56.36%	17.04%	58	61
15	苗栗縣竹南鎮	2018-11-24T23:35:17+08:00	11242	24002	35244	1916	37160	65967	56.33%	17.04%	59	61
15	苗栗縣竹南鎮	2018-11-24T23:43:24+08:00	11242	24002	35244	1916	37160	65967	56.33%	17.04%	59	61
15	苗栗縣竹南鎮	2018-11-24T22:58:02+08:00	9608	20517	30125	1670	31795	56330	56.44%	17.06%	52	61
15	苗栗縣竹南鎮	2018-11-25T03:49:58+08:00	11697	24847	36544	1967	38511	68528	56.2%	17.07%	61	61
15	苗栗縣竹南鎮	2018-11-25T01:18:02+08:00	11697	24847	36544	1967	38511	68528	56.2%	17.07%	61	61
15	苗栗縣竹南鎮	2018-11-25T06:29:25+08:00	11697	24847	36544	1967	38511	68528	56.2%	17.07%	61	61
15	苗栗縣竹南鎮	2018-11-25T06:19:05+08:00	11697	24847	36544	1967	38511	68528	56.2%	17.07%	61	61
15	苗栗縣竹南鎮	2018-11-24T23:05:11+08:00	10077	21469	31546	1747	33293	58929	56.5%	17.1%	54	61
15	苗栗縣竹南鎮	2018-11-24T22:41:44+08:00	8292	17721	26013	1433	27446	48602	56.47%	17.06%	46	61
15	苗栗縣竹南鎮	2018-11-25T06:09:03+08:00	11697	24847	36544	1967	38511	68528	56.2%	17.07%	61	61
15	苗栗縣竹南鎮	2018-11-24T23:51:43+08:00	11421	24362	35783	1945	37728	67040	56.28%	17.04%	60	61
15	苗栗縣竹南鎮	2018-11-25T06:24:08+08:00	11697	24847	36544	1967	38511	68528	56.2%	17.07%	61	61
15	苗栗縣竹南鎮	2018-11-24T22:30:18+08:00	7505	15983	23488	1244	24732	43626	56.69%	17.2%	42	61
15	苗栗縣竹南鎮	2018-11-24T23:23:45+08:00	10722	22974	33696	1851	35547	62911	56.5%	17.04%	57	61
15	苗栗縣竹南鎮	2018-11-25T03:44:32+08:00	11697	24847	36544	1967	38511	68528	56.2%	17.07%	61	61
15	苗栗縣竹南鎮	2018-11-25T03:32:45+08:00	11697	24847	36544	1967	38511	68528	56.2%	17.07%	61	61
15	苗栗縣竹南鎮	2018-11-24T22:13:38+08:00	5723	12159	17882	955	18837	33372	56.45%	17.15%	33	61
15	苗栗縣竹南鎮	2018-11-24T23:08:45+08:00	10282	21896	32178	1789	33967	60048	56.57%	17.12%	55	61
15	苗栗縣竹南鎮	2018-11-24T23:16:10+08:00	10509	22476	32985	1818	34803	61618	56.48%	17.06%	56	61
15	苗栗縣竹南鎮	2018-11-24T23:47:37+08:00	11242	24002	35244	1916	37160	65967	56.33%	17.04%	59	61
15	苗栗縣竹南鎮	2018-11-24T22:16:19+08:00	6165	13163	19328	997	20325	36066	56.36%	17.09%	35	61
15	苗栗縣竹南鎮	2018-11-24T23:39:26+08:00	11242	24002	35244	1916	37160	65967	56.33%	17.04%	59	61
15	苗栗縣竹南鎮	2018-11-25T01:26:01+08:00	11697	24847	36544	1967	38511	68528	56.2%	17.07%	61	61
15	苗栗縣竹南鎮	2018-11-24T22:33:45+08:00	7880	16813	24693	1370	26063	45983	56.68%	17.14%	44	61
15	高雄市前金區	2018-11-24T22:58:01+08:00	4084	7642	11726	644	12370	20341	60.81%	20.08%	20	22
15	高雄市前金區	2018-11-24T22:45:14+08:00	3865	7237	11102	632	11734	19244	60.97%	20.08%	19	22
15	高雄市前金區	2018-11-25T03:56:20+08:00	4776	8995	13771	738	14509	23928	60.64%	19.96%	22	22
15	高雄市前金區	2018-11-24T22:26:42+08:00	3865	7237	11102	632	11734	19244	60.97%	20.08%	19	22
15	高雄市前金區	2018-11-25T01:18:00+08:00	4776	8995	13771	738	14509	23928	60.64%	19.96%	22	22
15	高雄市前金區	2018-11-24T23:16:09+08:00	4433	8313	12746	696	13442	22147	60.69%	20.02%	21	22
15	高雄市前金區	2018-11-25T00:18:38+08:00	4776	8995	13771	738	14509	23928	60.64%	19.96%	22	22
15	高雄市前金區	2018-11-24T22:37:06+08:00	3865	7237	11102	632	11734	19244	60.97%	20.08%	19	22
15	高雄市前金區	2018-11-25T06:09:00+08:00	4776	8995	13771	738	14509	23928	60.64%	19.96%	22	22
15	高雄市前金區	2018-11-25T01:25:59+08:00	4776	8995	13771	738	14509	23928	60.64%	19.96%	22	22
15	高雄市前金區	2018-11-25T00:57:43+08:00	4776	8995	13771	738	14509	23928	60.64%	19.96%	22	22
15	高雄市前金區	2018-11-25T01:02:37+08:00	4776	8995	13771	738	14509	23928	60.64%	19.96%	22	22
15	高雄市前金區	2018-11-24T22:40:33+08:00	3865	7237	11102	632	11734	19244	60.97%	20.08%	19	22
15	高雄市前金區	2018-11-24T23:51:41+08:00	4776	8995	13771	738	14509	23928	60.64%	19.96%	22	22
15	高雄市前金區	2018-11-24T22:19:43+08:00	3865	7237	11102	632	11734	19244	60.97%	20.08%	19	22
15	高雄市前金區	2018-11-24T23:55:53+08:00	4776	8995	13771	738	14509	23928	60.64%	19.96%	22	22
15	高雄市前金區	2018-11-25T00:00:17+08:00	4776	8995	13771	738	14509	23928	60.64%	19.96%	22	22
15	高雄市前金區	2018-11-24T23:19:58+08:00	4433	8313	12746	696	13442	22147	60.69%	20.02%	21	22
15	高雄市前金區	2018-11-24T23:27:24+08:00	4433	8313	12746	696	13442	22147	60.69%	20.02%	21	22
15	高雄市前金區	2018-11-25T03:44:30+08:00	4776	8995	13771	738	14509	23928	60.64%	19.96%	22	22
15	高雄市前金區	2018-11-24T23:01:37+08:00	4433	8313	12746	696	13442	22147	60.69%	20.02%	21	22
15	高雄市前金區	2018-11-24T23:12:23+08:00	4433	8313	12746	696	13442	22147	60.69%	20.02%	21	22
15	高雄市前金區	2018-11-25T04:02:58+08:00	4776	8995	13771	738	14509	23928	60.64%	19.96%	22	22
15	高雄市前金區	2018-11-25T00:14:16+08:00	4776	8995	13771	738	14509	23928	60.64%	19.96%	22	22
15	高雄市前金區	2018-11-24T23:35:16+08:00	4433	8313	12746	696	13442	22147	60.69%	20.02%	21	22
15	高雄市前金區	2018-11-24T23:31:18+08:00	4433	8313	12746	696	13442	22147	60.69%	20.02%	21	22
15	高雄市前金區	2018-11-24T23:39:23+08:00	4433	8313	12746	696	13442	22147	60.69%	20.02%	21	22
15	高雄市前金區	2018-11-25T01:07:32+08:00	4776	8995	13771	738	14509	23928	60.64%	19.96%	22	22
15	高雄市前金區	2018-11-24T23:47:35+08:00	4776	8995	13771	738	14509	23928	60.64%	19.96%	22	22
15	高雄市前金區	2018-11-24T23:43:23+08:00	4433	8313	12746	696	13442	22147	60.69%	20.02%	21	22
15	高雄市前金區	2018-11-24T22:41:42+08:00	3865	7237	11102	632	11734	19244	60.97%	20.08%	19	22
15	高雄市前金區	2018-11-25T01:12:51+08:00	4776	8995	13771	738	14509	23928	60.64%	19.96%	22	22
15	高雄市前金區	2018-11-25T06:13:58+08:00	4776	8995	13771	738	14509	23928	60.64%	19.96%	22	22
15	高雄市前金區	2018-11-24T22:54:31+08:00	4084	7642	11726	644	12370	20341	60.81%	20.08%	20	22
15	高雄市前金區	2018-11-24T22:50:55+08:00	3865	7237	11102	632	11734	19244	60.97%	20.08%	19	22
15	高雄市前金區	2018-11-25T00:09:41+08:00	4776	8995	13771	738	14509	23928	60.64%	19.96%	22	22
15	高雄市前金區	2018-11-25T06:29:23+08:00	4776	8995	13771	738	14509	23928	60.64%	19.96%	22	22
15	高雄市前金區	2018-11-25T03:49:57+08:00	4776	8995	13771	738	14509	23928	60.64%	19.96%	22	22
15	高雄市前金區	2018-11-24T23:05:10+08:00	4433	8313	12746	696	13442	22147	60.69%	20.02%	21	22
15	高雄市前金區	2018-11-25T06:19:03+08:00	4776	8995	13771	738	14509	23928	60.64%	19.96%	22	22
15	高雄市前金區	2018-11-25T00:05:11+08:00	4776	8995	13771	738	14509	23928	60.64%	19.96%	22	22
15	高雄市前金區	2018-11-25T06:24:06+08:00	4776	8995	13771	738	14509	23928	60.64%	19.96%	22	22
15	高雄市前金區	2018-11-24T22:30:16+08:00	3865	7237	11102	632	11734	19244	60.97%	20.08%	19	22
15	高雄市前金區	2018-11-24T22:13:36+08:00	3535	6649	10184	610	10794	17570	61.43%	20.12%	18	22
15	高雄市前金區	2018-11-24T23:08:43+08:00	4433	8313	12746	696	13442	22147	60.69%	20.02%	21	22
15	高雄市前金區	2018-11-24T22:23:20+08:00	3865	7237	11102	632	11734	19244	60.97%	20.08%	19	22
15	高雄市前金區	2018-11-25T00:23:10+08:00	4776	8995	13771	738	14509	23928	60.64%	19.96%	22	22
15	高雄市前金區	2018-11-25T03:32:43+08:00	4776	8995	13771	738	14509	23928	60.64%	19.96%	22	22
15	高雄市前金區	2018-11-24T23:23:44+08:00	4433	8313	12746	696	13442	22147	60.69%	20.02%	21	22
15	高雄市前金區	2018-11-24T22:33:44+08:00	3865	7237	11102	632	11734	19244	60.97%	20.08%	19	22
15	高雄市前金區	2018-11-24T22:16:17+08:00	3535	6649	10184	610	10794	17570	61.43%	20.12%	18	22
15	高雄市前金區	2018-11-25T03:39:00+08:00	4776	8995	13771	738	14509	23928	60.64%	19.96%	22	22
15	高雄市仁武區	2018-11-25T01:18:01+08:00	12503	26778	39281	1906	41187	70315	58.57%	17.78%	45	47
15	高雄市仁武區	2018-11-24T22:58:01+08:00	9674	20492	30166	1523	31689	53747	58.96%	18%	36	47
15	高雄市仁武區	2018-11-24T22:37:07+08:00	9367	19850	29217	1464	30681	51870	59.15%	18.06%	35	47
15	高雄市仁武區	2018-11-25T00:18:39+08:00	11814	25224	37038	1801	38839	65776	59.05%	17.96%	42	47
15	高雄市仁武區	2018-11-24T22:45:14+08:00	9367	19850	29217	1464	30681	51870	59.15%	18.06%	35	47
15	高雄市仁武區	2018-11-25T03:56:20+08:00	13068	28094	41162	1991	43153	73611	58.62%	17.75%	47	47
15	高雄市仁武區	2018-11-24T22:26:42+08:00	7845	16878	24723	1280	26003	43685	59.52%	17.96%	30	47
15	高雄市仁武區	2018-11-24T23:16:09+08:00	10700	22801	33501	1660	35161	59597	59%	17.95%	39	47
15	高雄市仁武區	2018-11-25T01:25:59+08:00	12731	27272	40003	1946	41949	71719	58.49%	17.75%	46	47
15	高雄市仁武區	2018-11-25T00:57:44+08:00	12503	26778	39281	1906	41187	70315	58.57%	17.78%	45	47
15	高雄市仁武區	2018-11-25T01:02:37+08:00	12503	26778	39281	1906	41187	70315	58.57%	17.78%	45	47
15	高雄市仁武區	2018-11-24T22:40:33+08:00	9367	19850	29217	1464	30681	51870	59.15%	18.06%	35	47
15	高雄市仁武區	2018-11-25T06:09:01+08:00	13068	28094	41162	1991	43153	73611	58.62%	17.75%	47	47
15	高雄市仁武區	2018-11-24T22:19:43+08:00	7845	16878	24723	1280	26003	43685	59.52%	17.96%	30	47
15	高雄市仁武區	2018-11-24T23:55:53+08:00	11049	23566	34615	1711	36326	61589	58.98%	17.94%	40	47
15	高雄市仁武區	2018-11-25T03:44:31+08:00	13068	28094	41162	1991	43153	73611	58.62%	17.75%	47	47
15	高雄市仁武區	2018-11-24T23:19:59+08:00	10700	22801	33501	1660	35161	59597	59%	17.95%	39	47
15	高雄市仁武區	2018-11-25T00:00:17+08:00	11049	23566	34615	1711	36326	61589	58.98%	17.94%	40	47
15	高雄市仁武區	2018-11-24T23:27:24+08:00	10700	22801	33501	1660	35161	59597	59%	17.95%	39	47
15	高雄市仁武區	2018-11-25T01:07:33+08:00	12503	26778	39281	1906	41187	70315	58.57%	17.78%	45	47
15	高雄市仁武區	2018-11-24T23:31:19+08:00	10700	22801	33501	1660	35161	59597	59%	17.95%	39	47
15	高雄市仁武區	2018-11-24T23:01:37+08:00	10017	21271	31288	1574	32862	55570	59.14%	18.03%	37	47
15	高雄市仁武區	2018-11-24T23:12:23+08:00	10017	21271	31288	1574	32862	55570	59.14%	18.03%	37	47
15	高雄市仁武區	2018-11-25T00:14:16+08:00	11049	23566	34615	1711	36326	61589	58.98%	17.94%	40	47
15	高雄市仁武區	2018-11-24T23:35:16+08:00	10700	22801	33501	1660	35161	59597	59%	17.95%	39	47
15	高雄市仁武區	2018-11-24T23:39:24+08:00	10700	22801	33501	1660	35161	59597	59%	17.95%	39	47
15	高雄市仁武區	2018-11-25T04:02:59+08:00	13068	28094	41162	1991	43153	73611	58.62%	17.75%	47	47
15	高雄市仁武區	2018-11-24T23:43:23+08:00	10700	22801	33501	1660	35161	59597	59%	17.95%	39	47
15	高雄市仁武區	2018-11-25T01:12:51+08:00	12503	26778	39281	1906	41187	70315	58.57%	17.78%	45	47
15	高雄市仁武區	2018-11-24T22:54:31+08:00	9674	20492	30166	1523	31689	53747	58.96%	18%	36	47
15	高雄市仁武區	2018-11-24T22:50:55+08:00	9674	20492	30166	1523	31689	53747	58.96%	18%	36	47
15	高雄市仁武區	2018-11-25T00:09:41+08:00	11049	23566	34615	1711	36326	61589	58.98%	17.94%	40	47
15	高雄市仁武區	2018-11-25T06:13:59+08:00	13068	28094	41162	1991	43153	73611	58.62%	17.75%	47	47
15	高雄市仁武區	2018-11-24T22:41:43+08:00	9367	19850	29217	1464	30681	51870	59.15%	18.06%	35	47
15	高雄市仁武區	2018-11-25T03:49:57+08:00	13068	28094	41162	1991	43153	73611	58.62%	17.75%	47	47
15	高雄市仁武區	2018-11-24T23:05:10+08:00	10017	21271	31288	1574	32862	55570	59.14%	18.03%	37	47
15	高雄市仁武區	2018-11-25T06:19:03+08:00	13068	28094	41162	1991	43153	73611	58.62%	17.75%	47	47
15	高雄市仁武區	2018-11-25T06:29:24+08:00	13068	28094	41162	1991	43153	73611	58.62%	17.75%	47	47
15	高雄市仁武區	2018-11-25T00:05:11+08:00	11049	23566	34615	1711	36326	61589	58.98%	17.94%	40	47
15	高雄市仁武區	2018-11-25T06:24:06+08:00	13068	28094	41162	1991	43153	73611	58.62%	17.75%	47	47
15	高雄市仁武區	2018-11-24T22:30:16+08:00	8392	17976	26368	1351	27719	46572	59.52%	18.02%	32	47
15	高雄市仁武區	2018-11-24T23:51:42+08:00	10700	22801	33501	1660	35161	59597	59%	17.95%	39	47
15	高雄市仁武區	2018-11-24T22:13:36+08:00	6886	14672	21558	1188	22746	38395	59.24%	17.93%	27	47
15	高雄市仁武區	2018-11-24T23:08:43+08:00	10017	21271	31288	1574	32862	55570	59.14%	18.03%	37	47
15	高雄市仁武區	2018-11-25T00:23:10+08:00	11814	25224	37038	1801	38839	65776	59.05%	17.96%	42	47
15	高雄市仁武區	2018-11-24T22:23:21+08:00	7845	16878	24723	1280	26003	43685	59.52%	17.96%	30	47
15	高雄市仁武區	2018-11-25T03:32:43+08:00	13068	28094	41162	1991	43153	73611	58.62%	17.75%	47	47
15	高雄市仁武區	2018-11-24T23:23:44+08:00	10700	22801	33501	1660	35161	59597	59%	17.95%	39	47
15	高雄市仁武區	2018-11-24T22:33:44+08:00	9009	19090	28099	1416	29515	49703	59.38%	18.13%	34	47
15	高雄市仁武區	2018-11-24T23:47:36+08:00	10700	22801	33501	1660	35161	59597	59%	17.95%	39	47
15	高雄市仁武區	2018-11-25T03:39:01+08:00	13068	28094	41162	1991	43153	73611	58.62%	17.75%	47	47
15	高雄市仁武區	2018-11-24T22:16:18+08:00	7238	15476	22714	1219	23933	40310	59.37%	17.96%	28	47
15	南投縣仁愛鄉	2018-11-25T00:05:14+08:00	1641	4758	6399	372	6771	12080	56.05%	13.58%	24	25
15	南投縣仁愛鄉	2018-11-25T06:19:06+08:00	1695	5070	6765	388	7153	12589	56.82%	13.46%	25	25
15	南投縣仁愛鄉	2018-11-25T00:09:45+08:00	1641	4758	6399	372	6771	12080	56.05%	13.58%	24	25
15	南投縣仁愛鄉	2018-11-24T22:50:58+08:00	1001	3581	4582	302	4884	8639	56.53%	11.59%	20	25
15	南投縣仁愛鄉	2018-11-24T22:41:46+08:00	1001	3581	4582	302	4884	8639	56.53%	11.59%	20	25
15	南投縣仁愛鄉	2018-11-24T22:37:09+08:00	922	3255	4177	269	4446	7967	55.81%	11.57%	19	25
15	南投縣仁愛鄉	2018-11-25T06:29:27+08:00	1695	5070	6765	388	7153	12589	56.82%	13.46%	25	25
15	南投縣仁愛鄉	2018-11-24T23:05:13+08:00	1460	3951	5411	329	5740	10291	55.78%	14.19%	22	25
15	南投縣仁愛鄉	2018-11-24T23:01:41+08:00	1396	3717	5113	322	5435	9612	56.54%	14.52%	21	25
15	南投縣仁愛鄉	2018-11-24T22:26:45+08:00	860	3019	3879	262	4141	7558	54.79%	11.38%	18	25
15	南投縣仁愛鄉	2018-11-24T22:54:34+08:00	1001	3581	4582	302	4884	8639	56.53%	11.59%	20	25
15	南投縣仁愛鄉	2018-11-25T01:12:54+08:00	1695	5070	6765	388	7153	12589	56.82%	13.46%	25	25
15	南投縣仁愛鄉	2018-11-24T23:43:26+08:00	1526	4434	5960	358	6318	11180	56.51%	13.65%	23	25
15	南投縣仁愛鄉	2018-11-25T04:03:01+08:00	1695	5070	6765	388	7153	12589	56.82%	13.46%	25	25
15	南投縣仁愛鄉	2018-11-25T00:00:20+08:00	1526	4434	5960	358	6318	11180	56.51%	13.65%	23	25
15	南投縣仁愛鄉	2018-11-25T00:23:13+08:00	1641	4758	6399	372	6771	12080	56.05%	13.58%	24	25
15	南投縣仁愛鄉	2018-11-25T03:44:36+08:00	1695	5070	6765	388	7153	12589	56.82%	13.46%	25	25
15	南投縣仁愛鄉	2018-11-24T23:08:47+08:00	1460	3951	5411	329	5740	10291	55.78%	14.19%	22	25
15	南投縣仁愛鄉	2018-11-24T22:23:24+08:00	860	3019	3879	262	4141	7558	54.79%	11.38%	18	25
15	南投縣仁愛鄉	2018-11-25T01:02:40+08:00	1695	5070	6765	388	7153	12589	56.82%	13.46%	25	25
15	南投縣仁愛鄉	2018-11-25T06:14:01+08:00	1695	5070	6765	388	7153	12589	56.82%	13.46%	25	25
15	南投縣仁愛鄉	2018-11-25T03:32:47+08:00	1695	5070	6765	388	7153	12589	56.82%	13.46%	25	25
15	南投縣仁愛鄉	2018-11-24T23:23:47+08:00	1460	3951	5411	329	5740	10291	55.78%	14.19%	22	25
15	南投縣仁愛鄉	2018-11-25T03:50:00+08:00	1695	5070	6765	388	7153	12589	56.82%	13.46%	25	25
15	南投縣仁愛鄉	2018-11-24T22:33:47+08:00	860	3019	3879	262	4141	7558	54.79%	11.38%	18	25
15	南投縣仁愛鄉	2018-11-25T03:39:03+08:00	1695	5070	6765	388	7153	12589	56.82%	13.46%	25	25
15	南投縣仁愛鄉	2018-11-25T01:26:02+08:00	1695	5070	6765	388	7153	12589	56.82%	13.46%	25	25
15	南投縣仁愛鄉	2018-11-24T23:20:01+08:00	1460	3951	5411	329	5740	10291	55.78%	14.19%	22	25
15	南投縣仁愛鄉	2018-11-25T00:14:19+08:00	1641	4758	6399	372	6771	12080	56.05%	13.58%	24	25
15	南投縣仁愛鄉	2018-11-24T23:16:12+08:00	1460	3951	5411	329	5740	10291	55.78%	14.19%	22	25
15	南投縣仁愛鄉	2018-11-24T23:35:19+08:00	1460	3951	5411	329	5740	10291	55.78%	14.19%	22	25
15	南投縣仁愛鄉	2018-11-24T22:45:17+08:00	1001	3581	4582	302	4884	8639	56.53%	11.59%	20	25
15	南投縣仁愛鄉	2018-11-25T01:18:05+08:00	1695	5070	6765	388	7153	12589	56.82%	13.46%	25	25
15	南投縣仁愛鄉	2018-11-25T03:56:23+08:00	1695	5070	6765	388	7153	12589	56.82%	13.46%	25	25
15	南投縣仁愛鄉	2018-11-24T22:58:04+08:00	1396	3717	5113	322	5435	9612	56.54%	14.52%	21	25
15	南投縣仁愛鄉	2018-11-25T00:57:47+08:00	1695	5070	6765	388	7153	12589	56.82%	13.46%	25	25
15	南投縣仁愛鄉	2018-11-24T22:19:46+08:00	860	3019	3879	262	4141	7558	54.79%	11.38%	18	25
15	南投縣仁愛鄉	2018-11-25T06:24:09+08:00	1695	5070	6765	388	7153	12589	56.82%	13.46%	25	25
15	南投縣仁愛鄉	2018-11-25T06:09:04+08:00	1695	5070	6765	388	7153	12589	56.82%	13.46%	25	25
15	南投縣仁愛鄉	2018-11-24T22:40:36+08:00	1001	3581	4582	302	4884	8639	56.53%	11.59%	20	25
15	南投縣仁愛鄉	2018-11-24T22:30:19+08:00	860	3019	3879	262	4141	7558	54.79%	11.38%	18	25
15	南投縣仁愛鄉	2018-11-24T22:13:40+08:00	764	2613	3377	253	3630	6606	54.95%	11.57%	17	25
15	南投縣仁愛鄉	2018-11-24T23:51:45+08:00	1526	4434	5960	358	6318	11180	56.51%	13.65%	23	25
15	南投縣仁愛鄉	2018-11-24T23:27:27+08:00	1460	3951	5411	329	5740	10291	55.78%	14.19%	22	25
15	南投縣仁愛鄉	2018-11-24T23:55:56+08:00	1526	4434	5960	358	6318	11180	56.51%	13.65%	23	25
15	南投縣仁愛鄉	2018-11-24T23:47:39+08:00	1526	4434	5960	358	6318	11180	56.51%	13.65%	23	25
15	南投縣仁愛鄉	2018-11-24T23:31:22+08:00	1460	3951	5411	329	5740	10291	55.78%	14.19%	22	25
15	南投縣仁愛鄉	2018-11-24T22:16:21+08:00	860	3019	3879	262	4141	7558	54.79%	11.38%	18	25
15	南投縣仁愛鄉	2018-11-25T00:18:42+08:00	1641	4758	6399	372	6771	12080	56.05%	13.58%	24	25
15	南投縣仁愛鄉	2018-11-24T23:12:26+08:00	1460	3951	5411	329	5740	10291	55.78%	14.19%	22	25
15	南投縣仁愛鄉	2018-11-24T23:39:27+08:00	1526	4434	5960	358	6318	11180	56.51%	13.65%	23	25
15	南投縣仁愛鄉	2018-11-25T01:07:36+08:00	1695	5070	6765	388	7153	12589	56.82%	13.46%	25	25
15	南投縣草屯鎮	2018-11-25T00:05:14+08:00	14141	30946	45087	2237	47324	81599	58%	17.33%	75	76
15	南投縣草屯鎮	2018-11-24T23:01:40+08:00	11483	25092	36575	1794	38369	65975	58.16%	17.41%	62	76
15	南投縣草屯鎮	2018-11-25T06:19:06+08:00	14396	31506	45902	2285	48187	82922	58.11%	17.36%	76	76
15	南投縣草屯鎮	2018-11-24T23:05:12+08:00	12256	26830	39086	1937	41023	70561	58.14%	17.37%	66	76
15	南投縣草屯鎮	2018-11-25T00:09:45+08:00	14141	30946	45087	2237	47324	81599	58%	17.33%	75	76
15	南投縣草屯鎮	2018-11-25T06:29:26+08:00	14396	31506	45902	2285	48187	82922	58.11%	17.36%	76	76
15	南投縣草屯鎮	2018-11-24T22:50:58+08:00	9454	21651	31105	1542	32647	55964	58.34%	16.89%	53	76
15	南投縣草屯鎮	2018-11-24T22:41:46+08:00	8572	19686	28258	1424	29682	50852	58.37%	16.86%	48	76
15	南投縣草屯鎮	2018-11-24T22:37:09+08:00	8246	18742	26988	1346	28334	48517	58.4%	17%	46	76
15	南投縣草屯鎮	2018-11-24T22:26:45+08:00	7232	16506	23738	1194	24932	42686	58.41%	16.94%	41	76
15	南投縣草屯鎮	2018-11-24T22:54:33+08:00	10233	23288	33521	1658	35179	60414	58.23%	16.94%	57	76
15	南投縣草屯鎮	2018-11-25T01:12:54+08:00	14396	31506	45902	2285	48187	82922	58.11%	17.36%	76	76
15	南投縣草屯鎮	2018-11-24T22:19:45+08:00	6815	15492	22307	1115	23422	39985	58.58%	17.04%	39	76
15	南投縣草屯鎮	2018-11-25T04:03:01+08:00	14396	31506	45902	2285	48187	82922	58.11%	17.36%	76	76
15	南投縣草屯鎮	2018-11-25T00:23:13+08:00	14141	30946	45087	2237	47324	81599	58%	17.33%	75	76
15	南投縣草屯鎮	2018-11-24T23:23:46+08:00	13877	30464	44341	2201	46542	80272	57.98%	17.29%	74	76
15	南投縣草屯鎮	2018-11-24T22:23:23+08:00	7016	16059	23075	1146	24221	41503	58.36%	16.9%	40	76
15	南投縣草屯鎮	2018-11-25T00:00:19+08:00	14141	30946	45087	2237	47324	81599	58%	17.33%	75	76
15	南投縣草屯鎮	2018-11-25T01:02:40+08:00	14396	31506	45902	2285	48187	82922	58.11%	17.36%	76	76
15	南投縣草屯鎮	2018-11-25T06:14:01+08:00	14396	31506	45902	2285	48187	82922	58.11%	17.36%	76	76
15	南投縣草屯鎮	2018-11-25T03:32:47+08:00	14396	31506	45902	2285	48187	82922	58.11%	17.36%	76	76
15	南投縣草屯鎮	2018-11-24T23:08:46+08:00	12437	27283	39720	1966	41686	71682	58.15%	17.35%	67	76
15	南投縣草屯鎮	2018-11-25T03:50:00+08:00	14396	31506	45902	2285	48187	82922	58.11%	17.36%	76	76
15	南投縣草屯鎮	2018-11-25T03:39:03+08:00	14396	31506	45902	2285	48187	82922	58.11%	17.36%	76	76
15	南投縣草屯鎮	2018-11-24T23:35:18+08:00	13877	30464	44341	2201	46542	80272	57.98%	17.29%	74	76
15	南投縣草屯鎮	2018-11-25T01:26:02+08:00	14396	31506	45902	2285	48187	82922	58.11%	17.36%	76	76
15	南投縣草屯鎮	2018-11-24T23:20:01+08:00	13877	30464	44341	2201	46542	80272	57.98%	17.29%	74	76
15	南投縣草屯鎮	2018-11-25T01:07:35+08:00	14396	31506	45902	2285	48187	82922	58.11%	17.36%	76	76
15	南投縣草屯鎮	2018-11-24T22:33:46+08:00	8068	18361	26429	1320	27749	47552	58.36%	16.97%	45	76
15	南投縣草屯鎮	2018-11-25T00:14:19+08:00	14141	30946	45087	2237	47324	81599	58%	17.33%	75	76
15	南投縣草屯鎮	2018-11-24T23:16:12+08:00	13678	30032	43710	2149	45859	78896	58.13%	17.34%	73	76
15	南投縣草屯鎮	2018-11-24T22:45:16+08:00	8735	20061	28796	1445	30241	51784	58.4%	16.87%	49	76
15	南投縣草屯鎮	2018-11-24T23:43:25+08:00	13877	30464	44341	2201	46542	80272	57.98%	17.29%	74	76
15	南投縣草屯鎮	2018-11-25T03:56:23+08:00	14396	31506	45902	2285	48187	82922	58.11%	17.36%	76	76
15	南投縣草屯鎮	2018-11-24T22:58:04+08:00	11300	24691	35991	1775	37766	64975	58.12%	17.39%	61	76
15	南投縣草屯鎮	2018-11-25T01:18:04+08:00	14396	31506	45902	2285	48187	82922	58.11%	17.36%	76	76
15	南投縣草屯鎮	2018-11-25T06:24:09+08:00	14396	31506	45902	2285	48187	82922	58.11%	17.36%	76	76
15	南投縣草屯鎮	2018-11-25T06:09:04+08:00	14396	31506	45902	2285	48187	82922	58.11%	17.36%	76	76
15	南投縣草屯鎮	2018-11-24T23:51:44+08:00	14141	30946	45087	2237	47324	81599	58%	17.33%	75	76
15	南投縣草屯鎮	2018-11-24T22:40:36+08:00	8572	19686	28258	1424	29682	50852	58.37%	16.86%	48	76
15	南投縣草屯鎮	2018-11-24T22:30:19+08:00	7447	16921	24368	1235	25603	43827	58.42%	16.99%	42	76
15	南投縣草屯鎮	2018-11-24T22:13:40+08:00	6305	14358	20663	1046	21709	36784	59.02%	17.14%	36	76
15	南投縣草屯鎮	2018-11-25T00:57:46+08:00	14396	31506	45902	2285	48187	82922	58.11%	17.36%	76	76
15	南投縣草屯鎮	2018-11-24T23:27:26+08:00	13877	30464	44341	2201	46542	80272	57.98%	17.29%	74	76
15	南投縣草屯鎮	2018-11-25T03:44:35+08:00	14396	31506	45902	2285	48187	82922	58.11%	17.36%	76	76
15	南投縣草屯鎮	2018-11-24T23:55:56+08:00	14141	30946	45087	2237	47324	81599	58%	17.33%	75	76
15	南投縣草屯鎮	2018-11-24T23:31:22+08:00	13877	30464	44341	2201	46542	80272	57.98%	17.29%	74	76
15	南投縣草屯鎮	2018-11-25T00:18:42+08:00	14141	30946	45087	2237	47324	81599	58%	17.33%	75	76
15	南投縣草屯鎮	2018-11-24T23:47:38+08:00	13877	30464	44341	2201	46542	80272	57.98%	17.29%	74	76
15	南投縣草屯鎮	2018-11-24T23:12:26+08:00	12824	28128	40952	2026	42978	74057	58.03%	17.32%	69	76
15	南投縣草屯鎮	2018-11-24T22:16:20+08:00	6440	14614	21054	1070	22124	37661	58.75%	17.1%	37	76
15	南投縣草屯鎮	2018-11-24T23:39:27+08:00	13877	30464	44341	2201	46542	80272	57.98%	17.29%	74	76
15	臺南市東區	2018-11-24T23:16:08+08:00	23948	40774	64722	2701	67423	123336	54.67%	19.42%	76	93
15	臺南市東區	2018-11-25T03:56:19+08:00	29616	50890	80506	3419	83925	153359	54.72%	19.31%	93	93
15	臺南市東區	2018-11-25T00:18:37+08:00	28082	48109	76191	3244	79435	144727	54.89%	19.4%	89	93
15	臺南市東區	2018-11-24T22:45:13+08:00	17707	29632	47339	1960	49299	89978	54.79%	19.68%	56	93
15	臺南市東區	2018-11-24T22:58:00+08:00	21126	35584	56710	2385	59095	107588	54.93%	19.64%	67	93
15	臺南市東區	2018-11-24T22:26:42+08:00	14361	24046	38407	1637	40044	73452	54.52%	19.55%	45	93
15	臺南市東區	2018-11-25T01:18:00+08:00	29616	50890	80506	3419	83925	153359	54.72%	19.31%	93	93
15	臺南市東區	2018-11-24T22:37:06+08:00	15761	26340	42101	1799	43900	80428	54.58%	19.6%	50	93
15	臺南市東區	2018-11-25T06:09:00+08:00	29616	50890	80506	3419	83925	153359	54.72%	19.31%	93	93
15	臺南市東區	2018-11-25T00:57:43+08:00	28885	49487	78372	3336	81708	148881	54.88%	19.4%	91	93
15	臺南市東區	2018-11-24T22:19:42+08:00	13156	22163	35319	1528	36847	67511	54.58%	19.49%	42	93
15	臺南市東區	2018-11-25T01:25:58+08:00	29616	50890	80506	3419	83925	153359	54.72%	19.31%	93	93
15	臺南市東區	2018-11-24T22:30:15+08:00	14667	24574	39241	1670	40911	74986	54.56%	19.56%	46	93
15	臺南市東區	2018-11-25T01:02:37+08:00	29201	50098	79299	3378	82677	150996	54.75%	19.34%	92	93
15	臺南市東區	2018-11-24T22:40:33+08:00	16932	28242	45174	1888	47062	85971	54.74%	19.7%	53	93
15	臺南市東區	2018-11-24T23:51:41+08:00	27013	46094	73107	3074	76181	138864	54.86%	19.45%	85	93
15	臺南市東區	2018-11-25T00:00:16+08:00	27013	46094	73107	3074	76181	138864	54.86%	19.45%	85	93
15	臺南市東區	2018-11-24T22:13:35+08:00	12073	20280	32353	1368	33721	61782	54.58%	19.54%	38	93
15	臺南市東區	2018-11-24T23:55:52+08:00	27013	46094	73107	3074	76181	138864	54.86%	19.45%	85	93
15	臺南市東區	2018-11-24T23:19:58+08:00	25006	42638	67644	2790	70434	128585	54.78%	19.45%	79	93
15	臺南市東區	2018-11-24T23:27:23+08:00	25710	43749	69459	2863	72322	131948	54.81%	19.48%	81	93
15	臺南市東區	2018-11-25T03:44:30+08:00	29616	50890	80506	3419	83925	153359	54.72%	19.31%	93	93
15	臺南市東區	2018-11-24T23:01:37+08:00	21744	36663	58407	2434	60841	110967	54.83%	19.6%	69	93
15	臺南市東區	2018-11-25T04:02:58+08:00	29616	50890	80506	3419	83925	153359	54.72%	19.31%	93	93
15	臺南市東區	2018-11-25T00:14:16+08:00	27785	47536	75321	3216	78537	143172	54.85%	19.41%	88	93
15	臺南市東區	2018-11-24T23:35:16+08:00	26550	45313	71863	3044	74907	136622	54.83%	19.43%	84	93
15	臺南市東區	2018-11-24T23:12:22+08:00	22986	38934	61920	2569	64489	117775	54.76%	19.52%	73	93
15	臺南市東區	2018-11-24T23:31:18+08:00	26550	45313	71863	3044	74907	136622	54.83%	19.43%	84	93
15	臺南市東區	2018-11-24T23:39:23+08:00	26550	45313	71863	3044	74907	136622	54.83%	19.43%	84	93
15	臺南市東區	2018-11-25T01:07:32+08:00	29201	50098	79299	3378	82677	150996	54.75%	19.34%	92	93
15	臺南市東區	2018-11-24T23:47:35+08:00	27013	46094	73107	3074	76181	138864	54.86%	19.45%	85	93
15	臺南市東區	2018-11-24T22:41:42+08:00	16932	28242	45174	1888	47062	85971	54.74%	19.7%	53	93
15	臺南市東區	2018-11-25T06:13:58+08:00	29616	50890	80506	3419	83925	153359	54.72%	19.31%	93	93
15	臺南市東區	2018-11-24T22:54:31+08:00	20499	34667	55166	2321	57487	104708	54.9%	19.58%	65	93
15	臺南市東區	2018-11-25T00:09:41+08:00	27513	47086	74599	3166	77765	141745	54.86%	19.41%	87	93
15	臺南市東區	2018-11-25T03:49:56+08:00	29616	50890	80506	3419	83925	153359	54.72%	19.31%	93	93
15	臺南市東區	2018-11-24T22:50:54+08:00	18762	31605	50367	2135	52502	95981	54.7%	19.55%	60	93
15	臺南市東區	2018-11-25T01:12:50+08:00	29201	50098	79299	3378	82677	150996	54.75%	19.34%	92	93
15	臺南市東區	2018-11-24T23:43:22+08:00	26550	45313	71863	3044	74907	136622	54.83%	19.43%	84	93
15	臺南市東區	2018-11-25T06:29:23+08:00	29616	50890	80506	3419	83925	153359	54.72%	19.31%	93	93
15	臺南市東區	2018-11-24T23:05:10+08:00	22152	37362	59514	2483	61997	113307	54.72%	19.55%	70	93
15	臺南市東區	2018-11-25T06:19:03+08:00	29616	50890	80506	3419	83925	153359	54.72%	19.31%	93	93
15	臺南市東區	2018-11-25T00:05:11+08:00	27513	47086	74599	3166	77765	141745	54.86%	19.41%	87	93
15	臺南市東區	2018-11-25T06:24:06+08:00	29616	50890	80506	3419	83925	153359	54.72%	19.31%	93	93
15	臺南市東區	2018-11-24T23:08:43+08:00	22459	37978	60437	2525	62962	115071	54.72%	19.52%	71	93
15	臺南市東區	2018-11-24T22:23:20+08:00	14361	24046	38407	1637	40044	73452	54.52%	19.55%	45	93
15	臺南市東區	2018-11-25T03:32:42+08:00	29616	50890	80506	3419	83925	153359	54.72%	19.31%	93	93
15	臺南市東區	2018-11-25T00:23:10+08:00	28432	48752	77184	3314	80498	146794	54.84%	19.37%	90	93
15	臺南市東區	2018-11-24T23:23:44+08:00	25367	43195	68562	2820	71382	130224	54.81%	19.48%	80	93
15	臺南市東區	2018-11-24T22:33:44+08:00	15231	25498	40729	1773	42502	77930	54.54%	19.54%	48	93
15	臺南市東區	2018-11-24T22:16:17+08:00	12927	21696	34623	1493	36116	66189	54.56%	19.53%	41	93
15	臺南市東區	2018-11-25T03:39:00+08:00	29616	50890	80506	3419	83925	153359	54.72%	19.31%	93	93
15	屏東縣枋寮鄉	2018-11-24T22:58:06+08:00	2782	5914	8696	1037	9733	18640	52.22%	14.92%	20	22
15	屏東縣枋寮鄉	2018-11-25T06:19:08+08:00	3196	6773	9969	1214	11183	21394	52.27%	14.94%	22	22
15	屏東縣枋寮鄉	2018-11-24T23:39:30+08:00	3196	6773	9969	1214	11183	21394	52.27%	14.94%	22	22
15	屏東縣枋寮鄉	2018-11-24T22:54:35+08:00	2782	5914	8696	1037	9733	18640	52.22%	14.92%	20	22
15	屏東縣枋寮鄉	2018-11-24T22:41:48+08:00	2632	5391	8023	980	9003	17138	52.53%	15.36%	19	22
15	屏東縣枋寮鄉	2018-11-24T23:05:14+08:00	2782	5914	8696	1037	9733	18640	52.22%	14.92%	20	22
15	屏東縣枋寮鄉	2018-11-25T06:29:29+08:00	3196	6773	9969	1214	11183	21394	52.27%	14.94%	22	22
15	屏東縣枋寮鄉	2018-11-25T01:18:07+08:00	3196	6773	9969	1214	11183	21394	52.27%	14.94%	22	22
15	屏東縣枋寮鄉	2018-11-24T23:43:28+08:00	3196	6773	9969	1214	11183	21394	52.27%	14.94%	22	22
15	屏東縣枋寮鄉	2018-11-25T06:09:07+08:00	3196	6773	9969	1214	11183	21394	52.27%	14.94%	22	22
15	屏東縣枋寮鄉	2018-11-24T22:13:42+08:00	2467	5062	7529	909	8438	15862	53.2%	15.55%	18	22
15	屏東縣枋寮鄉	2018-11-24T23:51:46+08:00	3196	6773	9969	1214	11183	21394	52.27%	14.94%	22	22
15	屏東縣枋寮鄉	2018-11-25T06:24:11+08:00	3196	6773	9969	1214	11183	21394	52.27%	14.94%	22	22
15	屏東縣枋寮鄉	2018-11-24T23:08:49+08:00	2782	5914	8696	1037	9733	18640	52.22%	14.92%	20	22
15	屏東縣枋寮鄉	2018-11-24T22:51:01+08:00	2782	5914	8696	1037	9733	18640	52.22%	14.92%	20	22
15	屏東縣枋寮鄉	2018-11-25T03:44:38+08:00	3196	6773	9969	1214	11183	21394	52.27%	14.94%	22	22
15	屏東縣枋寮鄉	2018-11-25T00:23:15+08:00	3196	6773	9969	1214	11183	21394	52.27%	14.94%	22	22
15	屏東縣枋寮鄉	2018-11-24T23:23:49+08:00	3001	6362	9363	1126	10489	20007	52.43%	15%	21	22
15	屏東縣枋寮鄉	2018-11-24T22:37:12+08:00	2632	5391	8023	980	9003	17138	52.53%	15.36%	19	22
15	屏東縣枋寮鄉	2018-11-24T23:16:14+08:00	2782	5914	8696	1037	9733	18640	52.22%	14.92%	20	22
15	屏東縣枋寮鄉	2018-11-24T23:35:20+08:00	3196	6773	9969	1214	11183	21394	52.27%	14.94%	22	22
15	屏東縣枋寮鄉	2018-11-25T01:26:05+08:00	3196	6773	9969	1214	11183	21394	52.27%	14.94%	22	22
15	屏東縣枋寮鄉	2018-11-25T03:39:05+08:00	3196	6773	9969	1214	11183	21394	52.27%	14.94%	22	22
15	屏東縣枋寮鄉	2018-11-24T22:33:48+08:00	2632	5391	8023	980	9003	17138	52.53%	15.36%	19	22
15	屏東縣枋寮鄉	2018-11-24T22:16:23+08:00	2632	5391	8023	980	9003	17138	52.53%	15.36%	19	22
15	屏東縣枋寮鄉	2018-11-25T00:14:21+08:00	3196	6773	9969	1214	11183	21394	52.27%	14.94%	22	22
15	屏東縣枋寮鄉	2018-11-25T01:12:56+08:00	3196	6773	9969	1214	11183	21394	52.27%	14.94%	22	22
15	屏東縣枋寮鄉	2018-11-25T00:09:48+08:00	3196	6773	9969	1214	11183	21394	52.27%	14.94%	22	22
15	屏東縣枋寮鄉	2018-11-24T23:01:44+08:00	2782	5914	8696	1037	9733	18640	52.22%	14.92%	20	22
15	屏東縣枋寮鄉	2018-11-24T22:26:47+08:00	2632	5391	8023	980	9003	17138	52.53%	15.36%	19	22
15	屏東縣枋寮鄉	2018-11-25T03:56:25+08:00	3196	6773	9969	1214	11183	21394	52.27%	14.94%	22	22
15	屏東縣枋寮鄉	2018-11-24T23:47:41+08:00	3196	6773	9969	1214	11183	21394	52.27%	14.94%	22	22
15	屏東縣枋寮鄉	2018-11-24T22:45:18+08:00	2782	5914	8696	1037	9733	18640	52.22%	14.92%	20	22
15	屏東縣枋寮鄉	2018-11-25T00:05:16+08:00	3196	6773	9969	1214	11183	21394	52.27%	14.94%	22	22
15	屏東縣枋寮鄉	2018-11-25T00:57:49+08:00	3196	6773	9969	1214	11183	21394	52.27%	14.94%	22	22
15	屏東縣枋寮鄉	2018-11-24T22:19:48+08:00	2632	5391	8023	980	9003	17138	52.53%	15.36%	19	22
15	屏東縣枋寮鄉	2018-11-24T22:30:21+08:00	2632	5391	8023	980	9003	17138	52.53%	15.36%	19	22
15	屏東縣枋寮鄉	2018-11-25T03:32:50+08:00	3196	6773	9969	1214	11183	21394	52.27%	14.94%	22	22
15	屏東縣枋寮鄉	2018-11-24T22:40:38+08:00	2632	5391	8023	980	9003	17138	52.53%	15.36%	19	22
15	屏東縣枋寮鄉	2018-11-25T04:03:03+08:00	3196	6773	9969	1214	11183	21394	52.27%	14.94%	22	22
15	屏東縣枋寮鄉	2018-11-24T23:27:28+08:00	3001	6362	9363	1126	10489	20007	52.43%	15%	21	22
15	屏東縣枋寮鄉	2018-11-25T01:02:42+08:00	3196	6773	9969	1214	11183	21394	52.27%	14.94%	22	22
15	屏東縣枋寮鄉	2018-11-25T06:14:03+08:00	3196	6773	9969	1214	11183	21394	52.27%	14.94%	22	22
15	屏東縣枋寮鄉	2018-11-24T22:23:26+08:00	2632	5391	8023	980	9003	17138	52.53%	15.36%	19	22
15	屏東縣枋寮鄉	2018-11-24T23:55:58+08:00	3196	6773	9969	1214	11183	21394	52.27%	14.94%	22	22
15	屏東縣枋寮鄉	2018-11-25T00:00:22+08:00	3196	6773	9969	1214	11183	21394	52.27%	14.94%	22	22
15	屏東縣枋寮鄉	2018-11-25T00:18:44+08:00	3196	6773	9969	1214	11183	21394	52.27%	14.94%	22	22
15	屏東縣枋寮鄉	2018-11-24T23:20:03+08:00	2782	5914	8696	1037	9733	18640	52.22%	14.92%	20	22
15	屏東縣枋寮鄉	2018-11-25T01:07:38+08:00	3196	6773	9969	1214	11183	21394	52.27%	14.94%	22	22
15	屏東縣枋寮鄉	2018-11-25T03:50:02+08:00	3196	6773	9969	1214	11183	21394	52.27%	14.94%	22	22
15	屏東縣枋寮鄉	2018-11-24T23:12:28+08:00	2782	5914	8696	1037	9733	18640	52.22%	14.92%	20	22
15	屏東縣枋寮鄉	2018-11-24T23:31:24+08:00	3196	6773	9969	1214	11183	21394	52.27%	14.94%	22	22
15	臺南市山上區	2018-11-24T23:16:08+08:00	928	1713	2641	228	2869	6511	44.06%	14.25%	9	9
15	臺南市山上區	2018-11-25T03:56:19+08:00	928	1713	2641	228	2869	6511	44.06%	14.25%	9	9
15	臺南市山上區	2018-11-24T22:41:41+08:00	928	1713	2641	228	2869	6511	44.06%	14.25%	9	9
15	臺南市山上區	2018-11-25T00:18:37+08:00	928	1713	2641	228	2869	6511	44.06%	14.25%	9	9
15	臺南市山上區	2018-11-24T22:45:13+08:00	928	1713	2641	228	2869	6511	44.06%	14.25%	9	9
15	臺南市山上區	2018-11-24T22:58:00+08:00	928	1713	2641	228	2869	6511	44.06%	14.25%	9	9
15	臺南市山上區	2018-11-24T22:37:06+08:00	928	1713	2641	228	2869	6511	44.06%	14.25%	9	9
15	臺南市山上區	2018-11-24T22:40:32+08:00	928	1713	2641	228	2869	6511	44.06%	14.25%	9	9
15	臺南市山上區	2018-11-25T01:02:36+08:00	928	1713	2641	228	2869	6511	44.06%	14.25%	9	9
15	臺南市山上區	2018-11-24T22:19:42+08:00	928	1713	2641	228	2869	6511	44.06%	14.25%	9	9
15	臺南市山上區	2018-11-25T01:25:58+08:00	928	1713	2641	228	2869	6511	44.06%	14.25%	9	9
15	臺南市山上區	2018-11-24T22:30:15+08:00	928	1713	2641	228	2869	6511	44.06%	14.25%	9	9
15	臺南市山上區	2018-11-24T23:51:41+08:00	928	1713	2641	228	2869	6511	44.06%	14.25%	9	9
15	臺南市山上區	2018-11-25T00:23:09+08:00	928	1713	2641	228	2869	6511	44.06%	14.25%	9	9
15	臺南市山上區	2018-11-25T00:57:42+08:00	928	1713	2641	228	2869	6511	44.06%	14.25%	9	9
15	臺南市山上區	2018-11-25T06:24:05+08:00	928	1713	2641	228	2869	6511	44.06%	14.25%	9	9
15	臺南市山上區	2018-11-25T00:00:16+08:00	928	1713	2641	228	2869	6511	44.06%	14.25%	9	9
15	臺南市山上區	2018-11-25T01:17:59+08:00	928	1713	2641	228	2869	6511	44.06%	14.25%	9	9
15	臺南市山上區	2018-11-24T23:19:57+08:00	928	1713	2641	228	2869	6511	44.06%	14.25%	9	9
15	臺南市山上區	2018-11-24T23:55:52+08:00	928	1713	2641	228	2869	6511	44.06%	14.25%	9	9
15	臺南市山上區	2018-11-24T22:13:34+08:00	928	1713	2641	228	2869	6511	44.06%	14.25%	9	9
15	臺南市山上區	2018-11-24T23:27:23+08:00	928	1713	2641	228	2869	6511	44.06%	14.25%	9	9
15	臺南市山上區	2018-11-25T03:44:30+08:00	928	1713	2641	228	2869	6511	44.06%	14.25%	9	9
15	臺南市山上區	2018-11-24T23:39:22+08:00	928	1713	2641	228	2869	6511	44.06%	14.25%	9	9
15	臺南市山上區	2018-11-25T06:08:59+08:00	928	1713	2641	228	2869	6511	44.06%	14.25%	9	9
15	臺南市山上區	2018-11-24T23:31:17+08:00	928	1713	2641	228	2869	6511	44.06%	14.25%	9	9
15	臺南市山上區	2018-11-25T04:02:58+08:00	928	1713	2641	228	2869	6511	44.06%	14.25%	9	9
15	臺南市山上區	2018-11-24T23:47:34+08:00	928	1713	2641	228	2869	6511	44.06%	14.25%	9	9
15	臺南市山上區	2018-11-24T23:05:09+08:00	928	1713	2641	228	2869	6511	44.06%	14.25%	9	9
15	臺南市山上區	2018-11-24T23:01:36+08:00	928	1713	2641	228	2869	6511	44.06%	14.25%	9	9
15	臺南市山上區	2018-11-25T01:07:32+08:00	928	1713	2641	228	2869	6511	44.06%	14.25%	9	9
15	臺南市山上區	2018-11-25T00:05:10+08:00	928	1713	2641	228	2869	6511	44.06%	14.25%	9	9
15	臺南市山上區	2018-11-25T06:19:02+08:00	928	1713	2641	228	2869	6511	44.06%	14.25%	9	9
15	臺南市山上區	2018-11-25T03:49:56+08:00	928	1713	2641	228	2869	6511	44.06%	14.25%	9	9
15	臺南市山上區	2018-11-24T22:54:30+08:00	928	1713	2641	228	2869	6511	44.06%	14.25%	9	9
15	臺南市山上區	2018-11-24T22:50:54+08:00	928	1713	2641	228	2869	6511	44.06%	14.25%	9	9
15	臺南市山上區	2018-11-25T06:13:57+08:00	928	1713	2641	228	2869	6511	44.06%	14.25%	9	9
15	臺南市山上區	2018-11-25T01:12:50+08:00	928	1713	2641	228	2869	6511	44.06%	14.25%	9	9
15	臺南市山上區	2018-11-24T23:43:22+08:00	928	1713	2641	228	2869	6511	44.06%	14.25%	9	9
15	臺南市山上區	2018-11-25T00:09:40+08:00	928	1713	2641	228	2869	6511	44.06%	14.25%	9	9
15	臺南市山上區	2018-11-25T06:29:23+08:00	928	1713	2641	228	2869	6511	44.06%	14.25%	9	9
15	臺南市山上區	2018-11-24T22:26:41+08:00	928	1713	2641	228	2869	6511	44.06%	14.25%	9	9
15	臺南市山上區	2018-11-25T03:32:42+08:00	928	1713	2641	228	2869	6511	44.06%	14.25%	9	9
15	臺南市山上區	2018-11-24T23:08:42+08:00	928	1713	2641	228	2869	6511	44.06%	14.25%	9	9
15	臺南市山上區	2018-11-24T22:23:19+08:00	928	1713	2641	228	2869	6511	44.06%	14.25%	9	9
15	臺南市山上區	2018-11-24T23:23:43+08:00	928	1713	2641	228	2869	6511	44.06%	14.25%	9	9
15	臺南市山上區	2018-11-25T00:14:15+08:00	928	1713	2641	228	2869	6511	44.06%	14.25%	9	9
15	臺南市山上區	2018-11-24T23:35:15+08:00	928	1713	2641	228	2869	6511	44.06%	14.25%	9	9
15	臺南市山上區	2018-11-24T22:33:43+08:00	928	1713	2641	228	2869	6511	44.06%	14.25%	9	9
15	臺南市山上區	2018-11-25T03:39:00+08:00	928	1713	2641	228	2869	6511	44.06%	14.25%	9	9
15	臺南市山上區	2018-11-24T23:12:21+08:00	928	1713	2641	228	2869	6511	44.06%	14.25%	9	9
15	臺南市山上區	2018-11-24T22:16:16+08:00	928	1713	2641	228	2869	6511	44.06%	14.25%	9	9
15	屏東縣長治鄉	2018-11-24T22:58:06+08:00	4527	8662	13189	1270	14459	26256	55.07%	17.24%	22	22
15	屏東縣長治鄉	2018-11-25T06:19:08+08:00	4527	8662	13189	1270	14459	26256	55.07%	17.24%	22	22
15	屏東縣長治鄉	2018-11-25T06:29:28+08:00	4527	8662	13189	1270	14459	26256	55.07%	17.24%	22	22
15	屏東縣長治鄉	2018-11-24T23:43:27+08:00	4527	8662	13189	1270	14459	26256	55.07%	17.24%	22	22
15	屏東縣長治鄉	2018-11-24T22:54:35+08:00	4527	8662	13189	1270	14459	26256	55.07%	17.24%	22	22
15	屏東縣長治鄉	2018-11-24T22:41:48+08:00	4527	8662	13189	1270	14459	26256	55.07%	17.24%	22	22
15	屏東縣長治鄉	2018-11-24T23:05:14+08:00	4527	8662	13189	1270	14459	26256	55.07%	17.24%	22	22
15	屏東縣長治鄉	2018-11-25T01:18:07+08:00	4527	8662	13189	1270	14459	26256	55.07%	17.24%	22	22
15	屏東縣長治鄉	2018-11-24T22:13:42+08:00	3501	6799	10300	988	11288	20382	55.38%	17.18%	18	22
15	屏東縣長治鄉	2018-11-24T23:51:46+08:00	4527	8662	13189	1270	14459	26256	55.07%	17.24%	22	22
15	屏東縣長治鄉	2018-11-25T06:09:06+08:00	4527	8662	13189	1270	14459	26256	55.07%	17.24%	22	22
15	屏東縣長治鄉	2018-11-25T06:24:11+08:00	4527	8662	13189	1270	14459	26256	55.07%	17.24%	22	22
15	屏東縣長治鄉	2018-11-24T23:23:48+08:00	4527	8662	13189	1270	14459	26256	55.07%	17.24%	22	22
15	屏東縣長治鄉	2018-11-25T03:44:38+08:00	4527	8662	13189	1270	14459	26256	55.07%	17.24%	22	22
15	屏東縣長治鄉	2018-11-25T00:23:15+08:00	4527	8662	13189	1270	14459	26256	55.07%	17.24%	22	22
15	屏東縣長治鄉	2018-11-25T00:00:21+08:00	4527	8662	13189	1270	14459	26256	55.07%	17.24%	22	22
15	屏東縣長治鄉	2018-11-24T22:51:00+08:00	4527	8662	13189	1270	14459	26256	55.07%	17.24%	22	22
15	屏東縣長治鄉	2018-11-25T03:32:49+08:00	4527	8662	13189	1270	14459	26256	55.07%	17.24%	22	22
15	屏東縣長治鄉	2018-11-24T23:08:48+08:00	4527	8662	13189	1270	14459	26256	55.07%	17.24%	22	22
15	屏東縣長治鄉	2018-11-24T23:16:13+08:00	4527	8662	13189	1270	14459	26256	55.07%	17.24%	22	22
15	屏東縣長治鄉	2018-11-24T23:35:20+08:00	4527	8662	13189	1270	14459	26256	55.07%	17.24%	22	22
15	屏東縣長治鄉	2018-11-25T01:26:05+08:00	4527	8662	13189	1270	14459	26256	55.07%	17.24%	22	22
15	屏東縣長治鄉	2018-11-25T03:39:05+08:00	4527	8662	13189	1270	14459	26256	55.07%	17.24%	22	22
15	屏東縣長治鄉	2018-11-24T22:33:48+08:00	4527	8662	13189	1270	14459	26256	55.07%	17.24%	22	22
15	屏東縣長治鄉	2018-11-25T03:50:01+08:00	4527	8662	13189	1270	14459	26256	55.07%	17.24%	22	22
15	屏東縣長治鄉	2018-11-24T22:16:23+08:00	3823	7317	11140	1043	12183	22195	54.89%	17.22%	19	22
15	屏東縣長治鄉	2018-11-25T00:14:21+08:00	4527	8662	13189	1270	14459	26256	55.07%	17.24%	22	22
15	屏東縣長治鄉	2018-11-25T01:12:56+08:00	4527	8662	13189	1270	14459	26256	55.07%	17.24%	22	22
15	屏東縣長治鄉	2018-11-24T23:47:40+08:00	4527	8662	13189	1270	14459	26256	55.07%	17.24%	22	22
15	屏東縣長治鄉	2018-11-24T23:01:43+08:00	4527	8662	13189	1270	14459	26256	55.07%	17.24%	22	22
15	屏東縣長治鄉	2018-11-25T03:56:25+08:00	4527	8662	13189	1270	14459	26256	55.07%	17.24%	22	22
15	屏東縣長治鄉	2018-11-24T22:45:18+08:00	4527	8662	13189	1270	14459	26256	55.07%	17.24%	22	22
15	屏東縣長治鄉	2018-11-25T00:09:47+08:00	4527	8662	13189	1270	14459	26256	55.07%	17.24%	22	22
15	屏東縣長治鄉	2018-11-24T22:26:46+08:00	4097	7844	11941	1123	13064	23809	54.87%	17.21%	20	22
15	屏東縣長治鄉	2018-11-25T00:05:16+08:00	4527	8662	13189	1270	14459	26256	55.07%	17.24%	22	22
15	屏東縣長治鄉	2018-11-24T22:30:21+08:00	4328	8250	12578	1182	13760	25014	55.01%	17.3%	21	22
15	屏東縣長治鄉	2018-11-24T22:40:38+08:00	4527	8662	13189	1270	14459	26256	55.07%	17.24%	22	22
15	屏東縣長治鄉	2018-11-25T04:03:03+08:00	4527	8662	13189	1270	14459	26256	55.07%	17.24%	22	22
15	屏東縣長治鄉	2018-11-25T00:57:48+08:00	4527	8662	13189	1270	14459	26256	55.07%	17.24%	22	22
15	屏東縣長治鄉	2018-11-24T22:19:47+08:00	3823	7317	11140	1043	12183	22195	54.89%	17.22%	19	22
15	屏東縣長治鄉	2018-11-24T23:27:28+08:00	4527	8662	13189	1270	14459	26256	55.07%	17.24%	22	22
15	屏東縣長治鄉	2018-11-25T01:02:42+08:00	4527	8662	13189	1270	14459	26256	55.07%	17.24%	22	22
15	屏東縣長治鄉	2018-11-25T06:14:03+08:00	4527	8662	13189	1270	14459	26256	55.07%	17.24%	22	22
15	屏東縣長治鄉	2018-11-24T22:23:26+08:00	3823	7317	11140	1043	12183	22195	54.89%	17.22%	19	22
15	屏東縣長治鄉	2018-11-24T23:55:58+08:00	4527	8662	13189	1270	14459	26256	55.07%	17.24%	22	22
15	屏東縣長治鄉	2018-11-25T00:18:44+08:00	4527	8662	13189	1270	14459	26256	55.07%	17.24%	22	22
15	屏東縣長治鄉	2018-11-24T23:20:03+08:00	4527	8662	13189	1270	14459	26256	55.07%	17.24%	22	22
15	屏東縣長治鄉	2018-11-25T01:07:37+08:00	4527	8662	13189	1270	14459	26256	55.07%	17.24%	22	22
15	屏東縣長治鄉	2018-11-24T22:37:11+08:00	4527	8662	13189	1270	14459	26256	55.07%	17.24%	22	22
15	屏東縣長治鄉	2018-11-24T23:39:29+08:00	4527	8662	13189	1270	14459	26256	55.07%	17.24%	22	22
15	屏東縣長治鄉	2018-11-24T23:12:28+08:00	4527	8662	13189	1270	14459	26256	55.07%	17.24%	22	22
15	屏東縣長治鄉	2018-11-24T23:31:24+08:00	4527	8662	13189	1270	14459	26256	55.07%	17.24%	22	22
15	桃園市楊梅區	2018-11-24T23:16:06+08:00	14845	31651	46496	2316	48812	94030	51.91%	15.79%	59	82
15	桃園市楊梅區	2018-11-24T23:43:20+08:00	17646	38107	55753	2776	58529	113159	51.72%	15.59%	70	82
15	桃園市楊梅區	2018-11-25T06:13:55+08:00	21210	46233	67443	3207	70650	137917	51.23%	15.38%	82	82
15	桃園市楊梅區	2018-11-25T06:19:00+08:00	21210	46233	67443	3207	70650	137917	51.23%	15.38%	82	82
15	桃園市楊梅區	2018-11-25T06:29:20+08:00	21210	46233	67443	3207	70650	137917	51.23%	15.38%	82	82
15	桃園市楊梅區	2018-11-25T03:49:54+08:00	21210	46233	67443	3207	70650	137917	51.23%	15.38%	82	82
15	桃園市楊梅區	2018-11-25T03:56:16+08:00	21210	46233	67443	3207	70650	137917	51.23%	15.38%	82	82
15	桃園市楊梅區	2018-11-25T01:07:29+08:00	20906	45519	66425	3190	69615	135691	51.3%	15.41%	81	82
15	桃園市楊梅區	2018-11-24T22:30:13+08:00	11481	24398	35879	1827	37706	72966	51.68%	15.73%	47	82
15	桃園市楊梅區	2018-11-25T06:24:03+08:00	21210	46233	67443	3207	70650	137917	51.23%	15.38%	82	82
15	桃園市楊梅區	2018-11-25T03:32:38+08:00	21210	46233	67443	3207	70650	137917	51.23%	15.38%	82	82
15	桃園市楊梅區	2018-11-25T01:25:56+08:00	21210	46233	67443	3207	70650	137917	51.23%	15.38%	82	82
15	桃園市楊梅區	2018-11-25T00:23:07+08:00	20302	44084	64386	3084	67470	131190	51.43%	15.48%	79	82
15	桃園市楊梅區	2018-11-24T23:51:39+08:00	18791	40820	59611	2900	62511	121294	51.54%	15.49%	74	82
15	桃園市楊梅區	2018-11-24T23:23:41+08:00	15354	32795	48149	2348	50497	97286	51.91%	15.78%	61	82
15	桃園市楊梅區	2018-11-25T01:17:57+08:00	21210	46233	67443	3207	70650	137917	51.23%	15.38%	82	82
15	桃園市楊梅區	2018-11-24T23:08:40+08:00	14845	31651	46496	2316	48812	94030	51.91%	15.79%	59	82
15	桃園市楊梅區	2018-11-24T22:57:58+08:00	14094	29989	44083	2196	46279	89162	51.9%	15.81%	56	82
15	桃園市楊梅區	2018-11-25T06:08:57+08:00	21210	46233	67443	3207	70650	137917	51.23%	15.38%	82	82
15	桃園市楊梅區	2018-11-25T01:12:47+08:00	21210	46233	67443	3207	70650	137917	51.23%	15.38%	82	82
15	桃園市楊梅區	2018-11-24T22:16:14+08:00	10622	22368	32990	1637	34627	67230	51.51%	15.8%	43	82
15	桃園市楊梅區	2018-11-25T00:05:08+08:00	19377	42087	61464	2981	64445	125256	51.45%	15.47%	76	82
15	桃園市楊梅區	2018-11-24T23:05:07+08:00	14586	31076	45662	2289	47951	92473	51.85%	15.77%	58	82
15	桃園市楊梅區	2018-11-24T22:54:28+08:00	13866	29457	43323	2143	45466	87611	51.9%	15.83%	55	82
15	桃園市楊梅區	2018-11-24T22:33:41+08:00	11799	25055	36854	1856	38710	74877	51.7%	15.76%	48	82
15	桃園市楊梅區	2018-11-24T23:47:32+08:00	17961	38858	56819	2805	59624	115090	51.81%	15.61%	71	82
15	桃園市楊梅區	2018-11-24T22:41:39+08:00	12043	25579	37622	1905	39527	76326	51.79%	15.78%	49	82
15	桃園市楊梅區	2018-11-24T22:37:04+08:00	12043	25579	37622	1905	39527	76326	51.79%	15.78%	49	82
15	桃園市楊梅區	2018-11-25T00:18:34+08:00	20302	44084	64386	3084	67470	131190	51.43%	15.48%	79	82
15	桃園市楊梅區	2018-11-24T22:50:52+08:00	12873	27473	40346	2011	42357	81940	51.69%	15.71%	52	82
15	桃園市楊梅區	2018-11-24T22:26:40+08:00	11481	24398	35879	1827	37706	72966	51.68%	15.73%	47	82
15	桃園市楊梅區	2018-11-24T22:45:11+08:00	12359	26215	38574	1931	40505	78208	51.79%	15.8%	50	82
15	桃園市楊梅區	2018-11-25T00:57:40+08:00	20625	44826	65451	3122	68573	133401	51.4%	15.46%	80	82
15	桃園市楊梅區	2018-11-25T03:44:27+08:00	21210	46233	67443	3207	70650	137917	51.23%	15.38%	82	82
15	桃園市楊梅區	2018-11-24T22:19:40+08:00	11002	23262	34264	1719	35983	69693	51.63%	15.79%	45	82
15	桃園市楊梅區	2018-11-25T01:02:34+08:00	20906	45519	66425	3190	69615	135691	51.3%	15.41%	81	82
15	桃園市楊梅區	2018-11-24T22:40:30+08:00	12043	25579	37622	1905	39527	76326	51.79%	15.78%	49	82
15	桃園市楊梅區	2018-11-25T03:38:58+08:00	21210	46233	67443	3207	70650	137917	51.23%	15.38%	82	82
15	桃園市楊梅區	2018-11-24T22:13:31+08:00	10371	21833	32204	1615	33819	65814	51.39%	15.76%	42	82
15	桃園市楊梅區	2018-11-24T23:27:21+08:00	15915	34109	50024	2454	52478	101134	51.89%	15.74%	63	82
15	桃園市楊梅區	2018-11-24T23:55:50+08:00	18791	40820	59611	2900	62511	121294	51.54%	15.49%	74	82
15	桃園市楊梅區	2018-11-24T22:23:17+08:00	11210	23787	34997	1772	36769	71208	51.64%	15.74%	46	82
15	桃園市楊梅區	2018-11-24T23:19:55+08:00	15068	32181	47249	2335	49584	95438	51.95%	15.79%	60	82
15	桃園市楊梅區	2018-11-25T00:00:14+08:00	19061	41430	60491	2953	63444	123155	51.52%	15.48%	75	82
15	桃園市楊梅區	2018-11-25T04:02:55+08:00	21210	46233	67443	3207	70650	137917	51.23%	15.38%	82	82
15	桃園市楊梅區	2018-11-25T00:09:38+08:00	19946	43434	63380	3036	66416	129252	51.38%	15.43%	78	82
15	桃園市楊梅區	2018-11-24T23:01:34+08:00	14586	31076	45662	2289	47951	92473	51.85%	15.77%	58	82
15	桃園市楊梅區	2018-11-24T23:35:14+08:00	16769	36007	52776	2587	55363	106795	51.84%	15.7%	66	82
15	桃園市楊梅區	2018-11-25T00:14:13+08:00	20302	44084	64386	3084	67470	131190	51.43%	15.48%	79	82
15	桃園市楊梅區	2018-11-24T23:12:19+08:00	14845	31651	46496	2316	48812	94030	51.91%	15.79%	59	82
15	桃園市楊梅區	2018-11-24T23:31:15+08:00	16487	35376	51863	2548	54411	104775	51.93%	15.74%	65	82
15	桃園市楊梅區	2018-11-24T23:39:20+08:00	17285	37220	54505	2671	57176	110361	51.81%	15.66%	68	82
15	花蓮縣吉安鄉	2018-11-24T23:56:00+08:00	7541	18981	26522	1264	27786	52263	53.17%	14.43%	44	59
15	花蓮縣吉安鄉	2018-11-24T23:05:15+08:00	5320	13294	18614	890	19504	36334	53.68%	14.64%	31	59
15	花蓮縣吉安鄉	2018-11-24T23:43:29+08:00	6989	17606	24595	1182	25777	48437	53.22%	14.43%	41	59
15	花蓮縣吉安鄉	2018-11-25T01:18:09+08:00	9841	25026	34867	1771	36638	69445	52.76%	14.17%	57	59
15	花蓮縣吉安鄉	2018-11-25T03:56:27+08:00	10232	26015	36247	1847	38094	72116	52.82%	14.19%	59	59
15	花蓮縣吉安鄉	2018-11-25T06:19:09+08:00	10232	26015	36247	1847	38094	72116	52.82%	14.19%	59	59
15	花蓮縣吉安鄉	2018-11-24T22:58:07+08:00	4922	12355	17277	841	18118	33761	53.67%	14.58%	29	59
15	花蓮縣吉安鄉	2018-11-24T22:41:49+08:00	3700	9519	13219	632	13851	25843	53.6%	14.32%	23	59
15	花蓮縣吉安鄉	2018-11-24T23:39:31+08:00	6800	17165	23965	1158	25123	47276	53.14%	14.38%	40	59
15	花蓮縣吉安鄉	2018-11-24T23:47:42+08:00	7315	18440	25755	1239	26994	50748	53.19%	14.41%	43	59
15	花蓮縣吉安鄉	2018-11-24T22:30:22+08:00	3345	8737	12082	566	12648	23719	53.32%	14.1%	21	59
15	花蓮縣吉安鄉	2018-11-24T23:27:30+08:00	6168	15577	21745	1071	22816	42714	53.42%	14.44%	36	59
15	花蓮縣吉安鄉	2018-11-24T23:51:48+08:00	7541	18981	26522	1264	27786	52263	53.17%	14.43%	44	59
15	花蓮縣吉安鄉	2018-11-25T06:09:08+08:00	10232	26015	36247	1847	38094	72116	52.82%	14.19%	59	59
15	花蓮縣吉安鄉	2018-11-24T22:13:44+08:00	2820	7389	10209	480	10689	20075	53.25%	14.05%	18	59
15	花蓮縣吉安鄉	2018-11-25T00:57:50+08:00	9661	24626	34287	1741	36028	68310	52.74%	14.14%	56	59
15	花蓮縣吉安鄉	2018-11-25T03:44:39+08:00	10232	26015	36247	1847	38094	72116	52.82%	14.19%	59	59
15	花蓮縣吉安鄉	2018-11-24T23:31:26+08:00	6168	15577	21745	1071	22816	42714	53.42%	14.44%	36	59
15	花蓮縣吉安鄉	2018-11-24T22:37:13+08:00	3700	9519	13219	632	13851	25843	53.6%	14.32%	23	59
15	花蓮縣吉安鄉	2018-11-24T22:16:24+08:00	2820	7389	10209	480	10689	20075	53.25%	14.05%	18	59
15	花蓮縣吉安鄉	2018-11-25T00:18:46+08:00	8434	21391	29825	1474	31299	59278	52.8%	14.23%	49	59
15	花蓮縣吉安鄉	2018-11-24T23:16:15+08:00	5478	13670	19148	916	20064	37393	53.66%	14.65%	32	59
15	花蓮縣吉安鄉	2018-11-25T01:12:58+08:00	9841	25026	34867	1771	36638	69445	52.76%	14.17%	57	59
15	花蓮縣吉安鄉	2018-11-25T00:05:17+08:00	7890	19943	27833	1321	29154	55119	52.89%	14.31%	46	59
15	花蓮縣吉安鄉	2018-11-24T22:54:37+08:00	4696	11830	16526	794	17320	32294	53.63%	14.54%	28	59
15	花蓮縣吉安鄉	2018-11-24T22:33:50+08:00	3700	9519	13219	632	13851	25843	53.6%	14.32%	23	59
15	花蓮縣吉安鄉	2018-11-24T22:45:20+08:00	3700	9519	13219	632	13851	25843	53.6%	14.32%	23	59
15	花蓮縣吉安鄉	2018-11-24T22:26:48+08:00	3345	8737	12082	566	12648	23719	53.32%	14.1%	21	59
15	花蓮縣吉安鄉	2018-11-24T23:01:45+08:00	5320	13294	18614	890	19504	36334	53.68%	14.64%	31	59
15	花蓮縣吉安鄉	2018-11-25T00:09:49+08:00	8080	20397	28477	1391	29868	56420	52.94%	14.32%	47	59
15	花蓮縣吉安鄉	2018-11-25T04:03:05+08:00	10232	26015	36247	1847	38094	72116	52.82%	14.19%	59	59
15	花蓮縣吉安鄉	2018-11-24T23:23:50+08:00	6002	15131	21133	1043	22176	41557	53.36%	14.44%	35	59
15	花蓮縣吉安鄉	2018-11-24T22:19:49+08:00	3007	7842	10849	512	11361	21332	53.26%	14.1%	19	59
15	花蓮縣吉安鄉	2018-11-24T22:40:39+08:00	3700	9519	13219	632	13851	25843	53.6%	14.32%	23	59
15	花蓮縣吉安鄉	2018-11-25T03:32:51+08:00	10232	26015	36247	1847	38094	72116	52.82%	14.19%	59	59
15	花蓮縣吉安鄉	2018-11-24T23:08:50+08:00	5320	13294	18614	890	19504	36334	53.68%	14.64%	31	59
15	花蓮縣吉安鄉	2018-11-24T22:23:27+08:00	3345	8737	12082	566	12648	23719	53.32%	14.1%	21	59
15	花蓮縣吉安鄉	2018-11-24T22:51:02+08:00	4453	11268	15721	758	16479	30862	53.4%	14.43%	27	59
15	花蓮縣吉安鄉	2018-11-25T06:14:04+08:00	10232	26015	36247	1847	38094	72116	52.82%	14.19%	59	59
15	花蓮縣吉安鄉	2018-11-25T00:00:23+08:00	7890	19943	27833	1321	29154	55119	52.89%	14.31%	46	59
15	花蓮縣吉安鄉	2018-11-25T06:24:12+08:00	10232	26015	36247	1847	38094	72116	52.82%	14.19%	59	59
15	花蓮縣吉安鄉	2018-11-25T00:23:16+08:00	8643	21887	30530	1496	32026	60598	52.85%	14.26%	50	59
15	花蓮縣吉安鄉	2018-11-25T01:02:43+08:00	9661	24626	34287	1741	36028	68310	52.74%	14.14%	56	59
15	花蓮縣吉安鄉	2018-11-25T06:29:30+08:00	10232	26015	36247	1847	38094	72116	52.82%	14.19%	59	59
15	花蓮縣吉安鄉	2018-11-24T23:12:29+08:00	5478	13670	19148	916	20064	37393	53.66%	14.65%	32	59
15	花蓮縣吉安鄉	2018-11-25T03:50:03+08:00	10232	26015	36247	1847	38094	72116	52.82%	14.19%	59	59
15	花蓮縣吉安鄉	2018-11-25T01:07:39+08:00	9841	25026	34867	1771	36638	69445	52.76%	14.17%	57	59
15	花蓮縣吉安鄉	2018-11-25T01:26:07+08:00	9841	25026	34867	1771	36638	69445	52.76%	14.17%	57	59
15	花蓮縣吉安鄉	2018-11-25T03:39:07+08:00	10232	26015	36247	1847	38094	72116	52.82%	14.19%	59	59
15	花蓮縣吉安鄉	2018-11-25T00:14:22+08:00	8080	20397	28477	1391	29868	56420	52.94%	14.32%	47	59
15	花蓮縣吉安鄉	2018-11-24T23:35:22+08:00	6490	16394	22884	1122	24006	45084	53.25%	14.4%	38	59
15	花蓮縣吉安鄉	2018-11-24T23:20:05+08:00	6002	15131	21133	1043	22176	41557	53.36%	14.44%	35	59
15	新竹市北區	2018-11-24T23:01:47+08:00	12383	23224	35607	1748	37355	66804	55.92%	18.54%	61	105
15	新竹市北區	2018-11-24T23:47:44+08:00	18974	35543	54517	2649	57166	102278	55.89%	18.55%	89	105
15	新竹市北區	2018-11-24T22:58:09+08:00	11910	22376	34286	1694	35980	64381	55.89%	18.5%	59	105
15	新竹市北區	2018-11-25T03:56:29+08:00	22925	42900	65825	3223	69048	123122	56.08%	18.62%	105	105
15	新竹市北區	2018-11-24T23:08:52+08:00	12993	24442	37435	1857	39292	70384	55.83%	18.46%	64	105
15	新竹市北區	2018-11-25T03:32:54+08:00	22925	42900	65825	3223	69048	123122	56.08%	18.62%	105	105
15	新竹市北區	2018-11-24T23:51:49+08:00	20046	37418	57464	2763	60227	107570	55.99%	18.64%	93	105
15	新竹市北區	2018-11-25T03:44:41+08:00	22925	42900	65825	3223	69048	123122	56.08%	18.62%	105	105
15	新竹市北區	2018-11-24T23:23:52+08:00	14991	28332	43323	2112	45435	81244	55.92%	18.45%	73	105
15	新竹市北區	2018-11-24T23:27:31+08:00	16021	30089	46110	2221	48331	86204	56.07%	18.58%	77	105
15	新竹市北區	2018-11-24T22:30:24+08:00	8901	16771	25672	1244	26916	47930	56.16%	18.57%	46	105
15	新竹市北區	2018-11-25T04:03:07+08:00	22925	42900	65825	3223	69048	123122	56.08%	18.62%	105	105
15	新竹市北區	2018-11-24T22:19:51+08:00	8429	15743	24172	1173	25345	45073	56.23%	18.7%	43	105
15	新竹市北區	2018-11-25T06:14:06+08:00	22925	42900	65825	3223	69048	123122	56.08%	18.62%	105	105
15	新竹市北區	2018-11-24T23:20:09+08:00	14481	27402	41883	2043	43926	78755	55.78%	18.39%	71	105
15	新竹市北區	2018-11-24T23:31:28+08:00	16293	30545	46838	2278	49116	87632	56.05%	18.59%	78	105
15	新竹市北區	2018-11-24T23:43:32+08:00	18551	34696	53247	2572	55819	99977	55.83%	18.56%	87	105
15	新竹市北區	2018-11-24T22:37:15+08:00	10050	18880	28930	1448	30378	54011	56.24%	18.61%	51	105
15	新竹市北區	2018-11-25T01:18:12+08:00	22925	42900	65825	3223	69048	123122	56.08%	18.62%	105	105
15	新竹市北區	2018-11-25T00:18:48+08:00	22925	42900	65825	3223	69048	123122	56.08%	18.62%	105	105
15	新竹市北區	2018-11-25T06:29:32+08:00	22925	42900	65825	3223	69048	123122	56.08%	18.62%	105	105
15	新竹市北區	2018-11-24T22:45:21+08:00	10759	20180	30939	1545	32484	57559	56.44%	18.69%	54	105
15	新竹市北區	2018-11-24T22:54:38+08:00	11196	20924	32120	1620	33740	60564	55.71%	18.49%	56	105
15	新竹市北區	2018-11-24T23:12:32+08:00	13839	26045	39884	1978	41862	75267	55.62%	18.39%	68	105
15	新竹市北區	2018-11-24T22:33:51+08:00	9589	18120	27709	1411	29120	51731	56.29%	18.54%	49	105
15	新竹市北區	2018-11-24T23:39:34+08:00	18156	33905	52061	2497	54558	97670	55.86%	18.59%	85	105
15	新竹市北區	2018-11-25T00:05:19+08:00	22149	41361	63510	3102	66612	119070	55.94%	18.6%	102	105
15	新竹市北區	2018-11-24T22:26:49+08:00	8785	16519	25304	1231	26535	47172	56.25%	18.62%	45	105
15	新竹市北區	2018-11-25T01:07:41+08:00	22925	42900	65825	3223	69048	123122	56.08%	18.62%	105	105
15	新竹市北區	2018-11-24T23:05:17+08:00	12569	23578	36147	1779	37926	67874	55.88%	18.52%	62	105
15	新竹市北區	2018-11-24T23:56:02+08:00	20441	38190	58631	2812	61443	109791	55.96%	18.62%	95	105
15	新竹市北區	2018-11-24T22:13:46+08:00	7802	14642	22444	1086	23530	41855	56.22%	18.64%	40	105
15	新竹市北區	2018-11-24T22:23:29+08:00	8553	16014	24567	1202	25769	45778	56.29%	18.68%	44	105
15	新竹市北區	2018-11-25T06:09:11+08:00	22925	42900	65825	3223	69048	123122	56.08%	18.62%	105	105
15	新竹市北區	2018-11-25T01:02:45+08:00	22925	42900	65825	3223	69048	123122	56.08%	18.62%	105	105
15	新竹市北區	2018-11-24T22:40:41+08:00	10050	18880	28930	1448	30378	54011	56.24%	18.61%	51	105
15	新竹市北區	2018-11-25T00:57:52+08:00	22925	42900	65825	3223	69048	123122	56.08%	18.62%	105	105
15	新竹市北區	2018-11-24T22:51:04+08:00	10759	20180	30939	1545	32484	57559	56.44%	18.69%	54	105
15	新竹市北區	2018-11-25T01:13:00+08:00	22925	42900	65825	3223	69048	123122	56.08%	18.62%	105	105
15	新竹市北區	2018-11-25T06:24:14+08:00	22925	42900	65825	3223	69048	123122	56.08%	18.62%	105	105
15	新竹市北區	2018-11-25T00:23:18+08:00	22925	42900	65825	3223	69048	123122	56.08%	18.62%	105	105
15	新竹市北區	2018-11-25T00:00:25+08:00	21198	39578	60776	2935	63711	113915	55.93%	18.61%	98	105
15	新竹市北區	2018-11-24T23:35:23+08:00	16800	31415	48215	2369	50584	90549	55.86%	18.55%	80	105
15	新竹市北區	2018-11-24T23:16:17+08:00	14289	26938	41227	2023	43250	77666	55.69%	18.4%	70	105
15	新竹市北區	2018-11-25T00:14:24+08:00	22925	42900	65825	3223	69048	123122	56.08%	18.62%	105	105
15	新竹市北區	2018-11-25T01:26:09+08:00	22925	42900	65825	3223	69048	123122	56.08%	18.62%	105	105
15	新竹市北區	2018-11-24T22:16:26+08:00	8065	15131	23196	1113	24309	43251	56.2%	18.65%	41	105
15	新竹市北區	2018-11-25T00:09:52+08:00	22651	42368	65019	3200	68219	121699	56.06%	18.61%	104	105
15	新竹市北區	2018-11-25T06:19:11+08:00	22925	42900	65825	3223	69048	123122	56.08%	18.62%	105	105
15	新竹市北區	2018-11-24T22:41:51+08:00	10050	18880	28930	1448	30378	54011	56.24%	18.61%	51	105
15	新竹市北區	2018-11-25T03:50:05+08:00	22925	42900	65825	3223	69048	123122	56.08%	18.62%	105	105
15	新竹市北區	2018-11-25T03:39:08+08:00	22925	42900	65825	3223	69048	123122	56.08%	18.62%	105	105
15	臺南市西港區	2018-11-24T23:16:08+08:00	3256	6328	9584	568	10152	21564	47.08%	15.1%	20	20
15	臺南市西港區	2018-11-24T22:41:41+08:00	3256	6328	9584	568	10152	21564	47.08%	15.1%	20	20
15	臺南市西港區	2018-11-25T00:18:37+08:00	3256	6328	9584	568	10152	21564	47.08%	15.1%	20	20
15	臺南市西港區	2018-11-24T22:45:13+08:00	3256	6328	9584	568	10152	21564	47.08%	15.1%	20	20
15	臺南市西港區	2018-11-25T03:56:18+08:00	3256	6328	9584	568	10152	21564	47.08%	15.1%	20	20
15	臺南市西港區	2018-11-24T22:58:00+08:00	3256	6328	9584	568	10152	21564	47.08%	15.1%	20	20
15	臺南市西港區	2018-11-24T23:51:40+08:00	3256	6328	9584	568	10152	21564	47.08%	15.1%	20	20
15	臺南市西港區	2018-11-24T22:40:32+08:00	3256	6328	9584	568	10152	21564	47.08%	15.1%	20	20
15	臺南市西港區	2018-11-25T01:02:36+08:00	3256	6328	9584	568	10152	21564	47.08%	15.1%	20	20
15	臺南市西港區	2018-11-24T22:19:42+08:00	3256	6328	9584	568	10152	21564	47.08%	15.1%	20	20
15	臺南市西港區	2018-11-25T01:25:58+08:00	3256	6328	9584	568	10152	21564	47.08%	15.1%	20	20
15	臺南市西港區	2018-11-24T22:30:15+08:00	3256	6328	9584	568	10152	21564	47.08%	15.1%	20	20
15	臺南市西港區	2018-11-25T00:23:09+08:00	3256	6328	9584	568	10152	21564	47.08%	15.1%	20	20
15	臺南市西港區	2018-11-25T00:57:42+08:00	3256	6328	9584	568	10152	21564	47.08%	15.1%	20	20
15	臺南市西港區	2018-11-25T06:24:05+08:00	3256	6328	9584	568	10152	21564	47.08%	15.1%	20	20
15	臺南市西港區	2018-11-25T00:00:16+08:00	3256	6328	9584	568	10152	21564	47.08%	15.1%	20	20
15	臺南市西港區	2018-11-25T01:17:59+08:00	3256	6328	9584	568	10152	21564	47.08%	15.1%	20	20
15	臺南市西港區	2018-11-24T23:19:57+08:00	3256	6328	9584	568	10152	21564	47.08%	15.1%	20	20
15	臺南市西港區	2018-11-24T23:55:52+08:00	3256	6328	9584	568	10152	21564	47.08%	15.1%	20	20
15	臺南市西港區	2018-11-24T22:13:33+08:00	3256	6328	9584	568	10152	21564	47.08%	15.1%	20	20
15	臺南市西港區	2018-11-24T23:27:23+08:00	3256	6328	9584	568	10152	21564	47.08%	15.1%	20	20
15	臺南市西港區	2018-11-24T23:39:22+08:00	3256	6328	9584	568	10152	21564	47.08%	15.1%	20	20
15	臺南市西港區	2018-11-25T01:12:49+08:00	3256	6328	9584	568	10152	21564	47.08%	15.1%	20	20
15	臺南市西港區	2018-11-25T06:08:59+08:00	3256	6328	9584	568	10152	21564	47.08%	15.1%	20	20
15	臺南市西港區	2018-11-24T23:31:17+08:00	3256	6328	9584	568	10152	21564	47.08%	15.1%	20	20
15	臺南市西港區	2018-11-24T23:47:34+08:00	3256	6328	9584	568	10152	21564	47.08%	15.1%	20	20
15	臺南市西港區	2018-11-24T23:05:09+08:00	3256	6328	9584	568	10152	21564	47.08%	15.1%	20	20
15	臺南市西港區	2018-11-24T23:01:36+08:00	3256	6328	9584	568	10152	21564	47.08%	15.1%	20	20
15	臺南市西港區	2018-11-25T04:02:57+08:00	3256	6328	9584	568	10152	21564	47.08%	15.1%	20	20
15	臺南市西港區	2018-11-25T00:05:10+08:00	3256	6328	9584	568	10152	21564	47.08%	15.1%	20	20
15	臺南市西港區	2018-11-25T06:19:02+08:00	3256	6328	9584	568	10152	21564	47.08%	15.1%	20	20
15	臺南市西港區	2018-11-25T06:29:22+08:00	3256	6328	9584	568	10152	21564	47.08%	15.1%	20	20
15	臺南市西港區	2018-11-25T03:49:56+08:00	3256	6328	9584	568	10152	21564	47.08%	15.1%	20	20
15	臺南市西港區	2018-11-24T22:54:30+08:00	3256	6328	9584	568	10152	21564	47.08%	15.1%	20	20
15	臺南市西港區	2018-11-24T22:50:54+08:00	3256	6328	9584	568	10152	21564	47.08%	15.1%	20	20
15	臺南市西港區	2018-11-25T06:13:57+08:00	3256	6328	9584	568	10152	21564	47.08%	15.1%	20	20
15	臺南市西港區	2018-11-24T22:37:05+08:00	3256	6328	9584	568	10152	21564	47.08%	15.1%	20	20
15	臺南市西港區	2018-11-24T23:43:22+08:00	3256	6328	9584	568	10152	21564	47.08%	15.1%	20	20
15	臺南市西港區	2018-11-25T00:09:40+08:00	3256	6328	9584	568	10152	21564	47.08%	15.1%	20	20
15	臺南市西港區	2018-11-24T22:26:41+08:00	3256	6328	9584	568	10152	21564	47.08%	15.1%	20	20
15	臺南市西港區	2018-11-25T03:44:29+08:00	3256	6328	9584	568	10152	21564	47.08%	15.1%	20	20
15	臺南市西港區	2018-11-25T03:32:42+08:00	3256	6328	9584	568	10152	21564	47.08%	15.1%	20	20
15	臺南市西港區	2018-11-24T23:08:42+08:00	3256	6328	9584	568	10152	21564	47.08%	15.1%	20	20
15	臺南市西港區	2018-11-24T22:23:19+08:00	3256	6328	9584	568	10152	21564	47.08%	15.1%	20	20
15	臺南市西港區	2018-11-24T23:23:43+08:00	3256	6328	9584	568	10152	21564	47.08%	15.1%	20	20
15	臺南市西港區	2018-11-25T00:14:15+08:00	3256	6328	9584	568	10152	21564	47.08%	15.1%	20	20
15	臺南市西港區	2018-11-24T23:35:15+08:00	3256	6328	9584	568	10152	21564	47.08%	15.1%	20	20
15	臺南市西港區	2018-11-24T22:33:43+08:00	3256	6328	9584	568	10152	21564	47.08%	15.1%	20	20
15	臺南市西港區	2018-11-25T03:39:00+08:00	3256	6328	9584	568	10152	21564	47.08%	15.1%	20	20
15	臺南市西港區	2018-11-24T23:12:21+08:00	3256	6328	9584	568	10152	21564	47.08%	15.1%	20	20
15	臺南市西港區	2018-11-24T22:16:16+08:00	3256	6328	9584	568	10152	21564	47.08%	15.1%	20	20
15	臺南市西港區	2018-11-25T01:07:31+08:00	3256	6328	9584	568	10152	21564	47.08%	15.1%	20	20
15	屏東縣來義鄉	2018-11-25T03:56:26+08:00	822	2639	3461	271	3732	6257	59.65%	13.14%	9	9
15	屏東縣來義鄉	2018-11-24T23:05:15+08:00	424	1421	1845	115	1960	3288	59.61%	12.9%	6	9
15	屏東縣來義鄉	2018-11-25T01:18:08+08:00	822	2639	3461	271	3732	6257	59.65%	13.14%	9	9
15	屏東縣來義鄉	2018-11-24T23:39:30+08:00	525	1853	2378	146	2524	4128	61.14%	12.72%	7	9
15	屏東縣來義鄉	2018-11-25T06:29:29+08:00	822	2639	3461	271	3732	6257	59.65%	13.14%	9	9
15	屏東縣來義鄉	2018-11-25T06:19:09+08:00	822	2639	3461	271	3732	6257	59.65%	13.14%	9	9
15	屏東縣來義鄉	2018-11-24T22:58:07+08:00	290	1114	1404	94	1498	2399	62.44%	12.09%	5	9
15	屏東縣來義鄉	2018-11-24T22:41:49+08:00	290	1114	1404	94	1498	2399	62.44%	12.09%	5	9
15	屏東縣來義鄉	2018-11-24T23:43:28+08:00	525	1853	2378	146	2524	4128	61.14%	12.72%	7	9
15	屏東縣來義鄉	2018-11-25T06:09:07+08:00	822	2639	3461	271	3732	6257	59.65%	13.14%	9	9
15	屏東縣來義鄉	2018-11-24T22:30:22+08:00	290	1114	1404	94	1498	2399	62.44%	12.09%	5	9
15	屏東縣來義鄉	2018-11-24T23:51:47+08:00	525	1853	2378	146	2524	4128	61.14%	12.72%	7	9
15	屏東縣來義鄉	2018-11-24T22:13:43+08:00	290	1114	1404	94	1498	2399	62.44%	12.09%	5	9
15	屏東縣來義鄉	2018-11-24T23:08:49+08:00	525	1853	2378	146	2524	4128	61.14%	12.72%	7	9
15	屏東縣來義鄉	2018-11-24T22:51:01+08:00	290	1114	1404	94	1498	2399	62.44%	12.09%	5	9
15	屏東縣來義鄉	2018-11-25T03:44:38+08:00	822	2639	3461	271	3732	6257	59.65%	13.14%	9	9
15	屏東縣來義鄉	2018-11-25T00:23:15+08:00	632	2280	2912	226	3138	5045	62.2%	12.53%	8	9
15	屏東縣來義鄉	2018-11-24T23:23:49+08:00	525	1853	2378	146	2524	4128	61.14%	12.72%	7	9
15	屏東縣來義鄉	2018-11-24T22:33:49+08:00	290	1114	1404	94	1498	2399	62.44%	12.09%	5	9
15	屏東縣來義鄉	2018-11-24T22:37:12+08:00	290	1114	1404	94	1498	2399	62.44%	12.09%	5	9
15	屏東縣來義鄉	2018-11-24T23:16:14+08:00	525	1853	2378	146	2524	4128	61.14%	12.72%	7	9
15	屏東縣來義鄉	2018-11-24T22:16:23+08:00	290	1114	1404	94	1498	2399	62.44%	12.09%	5	9
15	屏東縣來義鄉	2018-11-25T00:14:21+08:00	632	2280	2912	226	3138	5045	62.2%	12.53%	8	9
15	屏東縣來義鄉	2018-11-24T23:35:21+08:00	525	1853	2378	146	2524	4128	61.14%	12.72%	7	9
15	屏東縣來義鄉	2018-11-24T22:45:19+08:00	290	1114	1404	94	1498	2399	62.44%	12.09%	5	9
15	屏東縣來義鄉	2018-11-24T22:54:36+08:00	290	1114	1404	94	1498	2399	62.44%	12.09%	5	9
15	屏東縣來義鄉	2018-11-25T00:09:48+08:00	632	2280	2912	226	3138	5045	62.2%	12.53%	8	9
15	屏東縣來義鄉	2018-11-24T23:01:44+08:00	424	1421	1845	115	1960	3288	59.61%	12.9%	6	9
15	屏東縣來義鄉	2018-11-24T22:26:47+08:00	290	1114	1404	94	1498	2399	62.44%	12.09%	5	9
15	屏東縣來義鄉	2018-11-24T23:47:41+08:00	525	1853	2378	146	2524	4128	61.14%	12.72%	7	9
15	屏東縣來義鄉	2018-11-25T01:12:57+08:00	822	2639	3461	271	3732	6257	59.65%	13.14%	9	9
15	屏東縣來義鄉	2018-11-25T00:05:16+08:00	632	2280	2912	226	3138	5045	62.2%	12.53%	8	9
15	屏東縣來義鄉	2018-11-25T00:57:49+08:00	822	2639	3461	271	3732	6257	59.65%	13.14%	9	9
15	屏東縣來義鄉	2018-11-24T22:19:48+08:00	290	1114	1404	94	1498	2399	62.44%	12.09%	5	9
15	屏東縣來義鄉	2018-11-25T03:32:50+08:00	822	2639	3461	271	3732	6257	59.65%	13.14%	9	9
15	屏東縣來義鄉	2018-11-25T04:03:04+08:00	822	2639	3461	271	3732	6257	59.65%	13.14%	9	9
15	屏東縣來義鄉	2018-11-24T22:40:39+08:00	290	1114	1404	94	1498	2399	62.44%	12.09%	5	9
15	屏東縣來義鄉	2018-11-25T06:14:04+08:00	822	2639	3461	271	3732	6257	59.65%	13.14%	9	9
15	屏東縣來義鄉	2018-11-25T01:02:42+08:00	822	2639	3461	271	3732	6257	59.65%	13.14%	9	9
15	屏東縣來義鄉	2018-11-24T23:55:59+08:00	525	1853	2378	146	2524	4128	61.14%	12.72%	7	9
15	屏東縣來義鄉	2018-11-25T06:24:12+08:00	822	2639	3461	271	3732	6257	59.65%	13.14%	9	9
15	屏東縣來義鄉	2018-11-24T22:23:26+08:00	290	1114	1404	94	1498	2399	62.44%	12.09%	5	9
15	屏東縣來義鄉	2018-11-24T23:27:29+08:00	525	1853	2378	146	2524	4128	61.14%	12.72%	7	9
15	屏東縣來義鄉	2018-11-25T00:00:22+08:00	525	1853	2378	146	2524	4128	61.14%	12.72%	7	9
15	屏東縣來義鄉	2018-11-24T23:12:29+08:00	525	1853	2378	146	2524	4128	61.14%	12.72%	7	9
15	屏東縣來義鄉	2018-11-24T23:31:25+08:00	525	1853	2378	146	2524	4128	61.14%	12.72%	7	9
15	屏東縣來義鄉	2018-11-24T23:20:04+08:00	525	1853	2378	146	2524	4128	61.14%	12.72%	7	9
15	屏東縣來義鄉	2018-11-25T00:18:45+08:00	632	2280	2912	226	3138	5045	62.2%	12.53%	8	9
15	屏東縣來義鄉	2018-11-25T01:07:38+08:00	822	2639	3461	271	3732	6257	59.65%	13.14%	9	9
15	屏東縣來義鄉	2018-11-25T03:39:06+08:00	822	2639	3461	271	3732	6257	59.65%	13.14%	9	9
15	屏東縣來義鄉	2018-11-25T01:26:06+08:00	822	2639	3461	271	3732	6257	59.65%	13.14%	9	9
15	屏東縣來義鄉	2018-11-25T03:50:02+08:00	822	2639	3461	271	3732	6257	59.65%	13.14%	9	9
15	臺南市柳營區	2018-11-24T22:41:41+08:00	2872	5658	8530	766	9296	18804	49.44%	15.27%	25	25
15	臺南市柳營區	2018-11-24T22:45:13+08:00	2872	5658	8530	766	9296	18804	49.44%	15.27%	25	25
15	臺南市柳營區	2018-11-24T23:16:07+08:00	2872	5658	8530	766	9296	18804	49.44%	15.27%	25	25
15	臺南市柳營區	2018-11-25T03:56:18+08:00	2872	5658	8530	766	9296	18804	49.44%	15.27%	25	25
15	臺南市柳營區	2018-11-24T23:43:21+08:00	2872	5658	8530	766	9296	18804	49.44%	15.27%	25	25
15	臺南市柳營區	2018-11-25T00:18:36+08:00	2872	5658	8530	766	9296	18804	49.44%	15.27%	25	25
15	臺南市柳營區	2018-11-24T23:51:40+08:00	2872	5658	8530	766	9296	18804	49.44%	15.27%	25	25
15	臺南市柳營區	2018-11-24T22:40:32+08:00	2872	5658	8530	766	9296	18804	49.44%	15.27%	25	25
15	臺南市柳營區	2018-11-25T01:25:57+08:00	2872	5658	8530	766	9296	18804	49.44%	15.27%	25	25
15	臺南市柳營區	2018-11-25T01:02:36+08:00	2872	5658	8530	766	9296	18804	49.44%	15.27%	25	25
15	臺南市柳營區	2018-11-24T22:30:14+08:00	2872	5658	8530	766	9296	18804	49.44%	15.27%	25	25
15	臺南市柳營區	2018-11-25T00:23:09+08:00	2872	5658	8530	766	9296	18804	49.44%	15.27%	25	25
15	臺南市柳營區	2018-11-25T00:57:42+08:00	2872	5658	8530	766	9296	18804	49.44%	15.27%	25	25
15	臺南市柳營區	2018-11-25T06:24:05+08:00	2872	5658	8530	766	9296	18804	49.44%	15.27%	25	25
15	臺南市柳營區	2018-11-24T22:57:59+08:00	2872	5658	8530	766	9296	18804	49.44%	15.27%	25	25
15	臺南市柳營區	2018-11-24T23:19:57+08:00	2872	5658	8530	766	9296	18804	49.44%	15.27%	25	25
15	臺南市柳營區	2018-11-25T03:32:41+08:00	2872	5658	8530	766	9296	18804	49.44%	15.27%	25	25
15	臺南市柳營區	2018-11-24T22:13:33+08:00	2872	5658	8530	766	9296	18804	49.44%	15.27%	25	25
15	臺南市柳營區	2018-11-24T23:27:23+08:00	2872	5658	8530	766	9296	18804	49.44%	15.27%	25	25
15	臺南市柳營區	2018-11-25T01:17:58+08:00	2872	5658	8530	766	9296	18804	49.44%	15.27%	25	25
15	臺南市柳營區	2018-11-24T23:39:22+08:00	2872	5658	8530	766	9296	18804	49.44%	15.27%	25	25
15	臺南市柳營區	2018-11-25T01:12:49+08:00	2872	5658	8530	766	9296	18804	49.44%	15.27%	25	25
15	臺南市柳營區	2018-11-25T06:08:59+08:00	2872	5658	8530	766	9296	18804	49.44%	15.27%	25	25
15	臺南市柳營區	2018-11-24T23:31:17+08:00	2872	5658	8530	766	9296	18804	49.44%	15.27%	25	25
15	臺南市柳營區	2018-11-24T23:47:34+08:00	2872	5658	8530	766	9296	18804	49.44%	15.27%	25	25
15	臺南市柳營區	2018-11-24T23:05:09+08:00	2872	5658	8530	766	9296	18804	49.44%	15.27%	25	25
15	臺南市柳營區	2018-11-24T23:01:36+08:00	2872	5658	8530	766	9296	18804	49.44%	15.27%	25	25
15	臺南市柳營區	2018-11-25T04:02:57+08:00	2872	5658	8530	766	9296	18804	49.44%	15.27%	25	25
15	臺南市柳營區	2018-11-25T00:05:10+08:00	2872	5658	8530	766	9296	18804	49.44%	15.27%	25	25
15	臺南市柳營區	2018-11-25T06:19:02+08:00	2872	5658	8530	766	9296	18804	49.44%	15.27%	25	25
15	臺南市柳營區	2018-11-25T06:29:22+08:00	2872	5658	8530	766	9296	18804	49.44%	15.27%	25	25
15	臺南市柳營區	2018-11-25T03:49:56+08:00	2872	5658	8530	766	9296	18804	49.44%	15.27%	25	25
15	臺南市柳營區	2018-11-24T22:54:30+08:00	2872	5658	8530	766	9296	18804	49.44%	15.27%	25	25
15	臺南市柳營區	2018-11-25T06:13:57+08:00	2872	5658	8530	766	9296	18804	49.44%	15.27%	25	25
15	臺南市柳營區	2018-11-24T22:50:53+08:00	2872	5658	8530	766	9296	18804	49.44%	15.27%	25	25
15	臺南市柳營區	2018-11-24T22:37:05+08:00	2872	5658	8530	766	9296	18804	49.44%	15.27%	25	25
15	臺南市柳營區	2018-11-24T22:26:41+08:00	2872	5658	8530	766	9296	18804	49.44%	15.27%	25	25
15	臺南市柳營區	2018-11-24T22:19:41+08:00	2872	5658	8530	766	9296	18804	49.44%	15.27%	25	25
15	臺南市柳營區	2018-11-25T03:38:59+08:00	2872	5658	8530	766	9296	18804	49.44%	15.27%	25	25
15	臺南市柳營區	2018-11-25T03:44:29+08:00	2872	5658	8530	766	9296	18804	49.44%	15.27%	25	25
15	臺南市柳營區	2018-11-25T00:00:15+08:00	2872	5658	8530	766	9296	18804	49.44%	15.27%	25	25
15	臺南市柳營區	2018-11-24T23:08:42+08:00	2872	5658	8530	766	9296	18804	49.44%	15.27%	25	25
15	臺南市柳營區	2018-11-24T22:23:19+08:00	2872	5658	8530	766	9296	18804	49.44%	15.27%	25	25
15	臺南市柳營區	2018-11-24T23:23:43+08:00	2872	5658	8530	766	9296	18804	49.44%	15.27%	25	25
15	臺南市柳營區	2018-11-24T23:55:51+08:00	2872	5658	8530	766	9296	18804	49.44%	15.27%	25	25
15	臺南市柳營區	2018-11-25T00:14:15+08:00	2872	5658	8530	766	9296	18804	49.44%	15.27%	25	25
15	臺南市柳營區	2018-11-24T23:35:15+08:00	2872	5658	8530	766	9296	18804	49.44%	15.27%	25	25
15	臺南市柳營區	2018-11-24T22:33:43+08:00	2872	5658	8530	766	9296	18804	49.44%	15.27%	25	25
15	臺南市柳營區	2018-11-24T23:12:20+08:00	2872	5658	8530	766	9296	18804	49.44%	15.27%	25	25
15	臺南市柳營區	2018-11-24T22:16:16+08:00	2872	5658	8530	766	9296	18804	49.44%	15.27%	25	25
15	臺南市柳營區	2018-11-25T00:09:39+08:00	2872	5658	8530	766	9296	18804	49.44%	15.27%	25	25
15	臺南市柳營區	2018-11-25T01:07:31+08:00	2872	5658	8530	766	9296	18804	49.44%	15.27%	25	25
15	屏東縣南州鄉	2018-11-24T22:58:06+08:00	1618	2921	4539	476	5015	9479	52.91%	17.07%	11	11
15	屏東縣南州鄉	2018-11-25T06:19:08+08:00	1618	2921	4539	476	5015	9479	52.91%	17.07%	11	11
15	屏東縣南州鄉	2018-11-25T03:56:26+08:00	1618	2921	4539	476	5015	9479	52.91%	17.07%	11	11
15	屏東縣南州鄉	2018-11-24T23:39:30+08:00	1618	2921	4539	476	5015	9479	52.91%	17.07%	11	11
15	屏東縣南州鄉	2018-11-24T22:41:48+08:00	1440	2589	4029	428	4457	8517	52.33%	16.91%	10	11
15	屏東縣南州鄉	2018-11-24T23:05:14+08:00	1618	2921	4539	476	5015	9479	52.91%	17.07%	11	11
15	屏東縣南州鄉	2018-11-25T06:29:29+08:00	1618	2921	4539	476	5015	9479	52.91%	17.07%	11	11
15	屏東縣南州鄉	2018-11-25T01:18:07+08:00	1618	2921	4539	476	5015	9479	52.91%	17.07%	11	11
15	屏東縣南州鄉	2018-11-24T23:43:28+08:00	1618	2921	4539	476	5015	9479	52.91%	17.07%	11	11
15	屏東縣南州鄉	2018-11-25T06:09:07+08:00	1618	2921	4539	476	5015	9479	52.91%	17.07%	11	11
15	屏東縣南州鄉	2018-11-24T23:51:47+08:00	1618	2921	4539	476	5015	9479	52.91%	17.07%	11	11
15	屏東縣南州鄉	2018-11-24T22:13:42+08:00	1272	2241	3513	353	3866	7473	51.73%	17.02%	9	11
15	屏東縣南州鄉	2018-11-25T06:24:11+08:00	1618	2921	4539	476	5015	9479	52.91%	17.07%	11	11
15	屏東縣南州鄉	2018-11-24T23:08:49+08:00	1618	2921	4539	476	5015	9479	52.91%	17.07%	11	11
15	屏東縣南州鄉	2018-11-24T22:51:01+08:00	1618	2921	4539	476	5015	9479	52.91%	17.07%	11	11
15	屏東縣南州鄉	2018-11-25T03:44:38+08:00	1618	2921	4539	476	5015	9479	52.91%	17.07%	11	11
15	屏東縣南州鄉	2018-11-25T00:23:15+08:00	1618	2921	4539	476	5015	9479	52.91%	17.07%	11	11
15	屏東縣南州鄉	2018-11-24T23:23:49+08:00	1618	2921	4539	476	5015	9479	52.91%	17.07%	11	11
15	屏東縣南州鄉	2018-11-24T22:33:49+08:00	1440	2589	4029	428	4457	8517	52.33%	16.91%	10	11
15	屏東縣南州鄉	2018-11-24T22:37:12+08:00	1440	2589	4029	428	4457	8517	52.33%	16.91%	10	11
15	屏東縣南州鄉	2018-11-24T23:16:14+08:00	1618	2921	4539	476	5015	9479	52.91%	17.07%	11	11
15	屏東縣南州鄉	2018-11-25T01:26:05+08:00	1618	2921	4539	476	5015	9479	52.91%	17.07%	11	11
15	屏東縣南州鄉	2018-11-24T22:16:23+08:00	1272	2241	3513	353	3866	7473	51.73%	17.02%	9	11
15	屏東縣南州鄉	2018-11-25T00:14:21+08:00	1618	2921	4539	476	5015	9479	52.91%	17.07%	11	11
15	屏東縣南州鄉	2018-11-24T23:35:21+08:00	1618	2921	4539	476	5015	9479	52.91%	17.07%	11	11
15	屏東縣南州鄉	2018-11-24T22:45:19+08:00	1440	2589	4029	428	4457	8517	52.33%	16.91%	10	11
15	屏東縣南州鄉	2018-11-24T22:54:36+08:00	1618	2921	4539	476	5015	9479	52.91%	17.07%	11	11
15	屏東縣南州鄉	2018-11-25T00:09:48+08:00	1618	2921	4539	476	5015	9479	52.91%	17.07%	11	11
15	屏東縣南州鄉	2018-11-24T23:01:44+08:00	1618	2921	4539	476	5015	9479	52.91%	17.07%	11	11
15	屏東縣南州鄉	2018-11-24T22:26:47+08:00	1440	2589	4029	428	4457	8517	52.33%	16.91%	10	11
15	屏東縣南州鄉	2018-11-24T23:47:41+08:00	1618	2921	4539	476	5015	9479	52.91%	17.07%	11	11
15	屏東縣南州鄉	2018-11-25T01:12:57+08:00	1618	2921	4539	476	5015	9479	52.91%	17.07%	11	11
15	屏東縣南州鄉	2018-11-25T00:05:16+08:00	1618	2921	4539	476	5015	9479	52.91%	17.07%	11	11
15	屏東縣南州鄉	2018-11-25T00:57:49+08:00	1618	2921	4539	476	5015	9479	52.91%	17.07%	11	11
15	屏東縣南州鄉	2018-11-24T22:19:48+08:00	1272	2241	3513	353	3866	7473	51.73%	17.02%	9	11
15	屏東縣南州鄉	2018-11-24T22:30:21+08:00	1440	2589	4029	428	4457	8517	52.33%	16.91%	10	11
15	屏東縣南州鄉	2018-11-25T03:32:50+08:00	1618	2921	4539	476	5015	9479	52.91%	17.07%	11	11
15	屏東縣南州鄉	2018-11-24T22:40:38+08:00	1440	2589	4029	428	4457	8517	52.33%	16.91%	10	11
15	屏東縣南州鄉	2018-11-25T04:03:04+08:00	1618	2921	4539	476	5015	9479	52.91%	17.07%	11	11
15	屏東縣南州鄉	2018-11-25T01:02:42+08:00	1618	2921	4539	476	5015	9479	52.91%	17.07%	11	11
15	屏東縣南州鄉	2018-11-25T06:14:03+08:00	1618	2921	4539	476	5015	9479	52.91%	17.07%	11	11
15	屏東縣南州鄉	2018-11-24T23:55:59+08:00	1618	2921	4539	476	5015	9479	52.91%	17.07%	11	11
15	屏東縣南州鄉	2018-11-24T22:23:26+08:00	1440	2589	4029	428	4457	8517	52.33%	16.91%	10	11
15	屏東縣南州鄉	2018-11-24T23:27:29+08:00	1618	2921	4539	476	5015	9479	52.91%	17.07%	11	11
15	屏東縣南州鄉	2018-11-25T00:00:22+08:00	1618	2921	4539	476	5015	9479	52.91%	17.07%	11	11
15	屏東縣南州鄉	2018-11-24T23:31:25+08:00	1618	2921	4539	476	5015	9479	52.91%	17.07%	11	11
15	屏東縣南州鄉	2018-11-24T23:20:04+08:00	1618	2921	4539	476	5015	9479	52.91%	17.07%	11	11
15	屏東縣南州鄉	2018-11-25T00:18:45+08:00	1618	2921	4539	476	5015	9479	52.91%	17.07%	11	11
15	屏東縣南州鄉	2018-11-25T01:07:38+08:00	1618	2921	4539	476	5015	9479	52.91%	17.07%	11	11
15	屏東縣南州鄉	2018-11-25T03:39:06+08:00	1618	2921	4539	476	5015	9479	52.91%	17.07%	11	11
15	屏東縣南州鄉	2018-11-25T03:50:02+08:00	1618	2921	4539	476	5015	9479	52.91%	17.07%	11	11
15	屏東縣南州鄉	2018-11-24T23:12:28+08:00	1618	2921	4539	476	5015	9479	52.91%	17.07%	11	11
15	嘉義市	2018-11-24T23:01:47+08:00	33150	63765	96915	4798	101713	185366	54.87%	17.88%	152	177
15	嘉義市	2018-11-24T23:47:44+08:00	37370	71764	109134	5541	114675	209986	54.61%	17.8%	169	177
15	嘉義市	2018-11-24T22:45:22+08:00	30954	59324	90278	4424	94702	172888	54.78%	17.9%	142	177
15	嘉義市	2018-11-25T03:56:29+08:00	39449	75746	115195	5781	120976	221553	54.6%	17.81%	177	177
15	嘉義市	2018-11-24T23:08:52+08:00	33733	64738	98471	4882	103353	188010	54.97%	17.94%	154	177
15	嘉義市	2018-11-25T03:32:54+08:00	39449	75746	115195	5781	120976	221553	54.6%	17.81%	177	177
15	嘉義市	2018-11-24T23:51:49+08:00	37381	71823	109204	5541	114745	210046	54.63%	17.8%	169	177
15	嘉義市	2018-11-24T23:23:52+08:00	35723	68638	104361	5263	109624	200904	54.57%	17.78%	163	177
15	嘉義市	2018-11-24T22:30:24+08:00	28222	53993	82215	4030	86245	157344	54.81%	17.94%	131	177
15	嘉義市	2018-11-25T04:03:07+08:00	39449	75746	115195	5781	120976	221553	54.6%	17.81%	177	177
15	嘉義市	2018-11-24T22:19:51+08:00	26486	50613	77099	3731	80830	147300	54.87%	17.98%	124	177
15	嘉義市	2018-11-25T06:14:06+08:00	39449	75746	115195	5781	120976	221553	54.6%	17.81%	177	177
15	嘉義市	2018-11-24T23:20:09+08:00	35347	67822	103169	5173	108342	198366	54.62%	17.82%	161	177
15	嘉義市	2018-11-24T23:31:28+08:00	36022	69214	105236	5303	110539	202456	54.6%	17.79%	164	177
15	嘉義市	2018-11-24T23:43:32+08:00	37101	71271	108372	5501	113873	208628	54.58%	17.78%	168	177
15	嘉義市	2018-11-24T22:37:15+08:00	29680	56943	86623	4278	90901	165889	54.8%	17.89%	137	177
15	嘉義市	2018-11-24T22:41:52+08:00	30148	57801	87949	4359	92308	168329	54.84%	17.91%	139	177
15	嘉義市	2018-11-24T22:26:50+08:00	27663	52958	80621	3964	84585	153892	54.96%	17.98%	129	177
15	嘉義市	2018-11-25T01:18:12+08:00	39449	75746	115195	5781	120976	221553	54.6%	17.81%	177	177
15	嘉義市	2018-11-25T00:18:48+08:00	39449	75746	115195	5781	120976	221553	54.6%	17.81%	177	177
15	嘉義市	2018-11-25T06:29:32+08:00	39449	75746	115195	5781	120976	221553	54.6%	17.81%	177	177
15	嘉義市	2018-11-24T22:54:38+08:00	32212	61980	94192	4639	98831	180312	54.81%	17.86%	148	177
15	嘉義市	2018-11-24T23:12:32+08:00	34160	65525	99685	4938	104623	190540	54.91%	17.93%	156	177
15	嘉義市	2018-11-24T22:33:51+08:00	28960	55515	84475	4178	88653	161593	54.86%	17.92%	134	177
15	嘉義市	2018-11-24T23:39:34+08:00	36868	70814	107682	5482	113164	207362	54.57%	17.78%	167	177
15	嘉義市	2018-11-25T00:05:19+08:00	39112	74878	113990	5757	119747	218966	54.69%	17.86%	175	177
15	嘉義市	2018-11-25T01:07:41+08:00	39449	75746	115195	5781	120976	221553	54.6%	17.81%	177	177
15	嘉義市	2018-11-24T23:05:17+08:00	33899	65076	98975	4899	103874	189145	54.92%	17.92%	155	177
15	嘉義市	2018-11-24T23:56:02+08:00	37381	71823	109204	5541	114745	210046	54.63%	17.8%	169	177
15	嘉義市	2018-11-24T22:13:46+08:00	24598	47018	71616	3447	75063	136498	54.99%	18.02%	116	177
15	嘉義市	2018-11-25T03:44:42+08:00	39449	75746	115195	5781	120976	221553	54.6%	17.81%	177	177
15	嘉義市	2018-11-24T23:27:32+08:00	36022	69214	105236	5303	110539	202456	54.6%	17.79%	164	177
15	嘉義市	2018-11-24T22:23:29+08:00	26721	51116	77837	3758	81595	148580	54.92%	17.98%	125	177
15	嘉義市	2018-11-25T06:09:11+08:00	39449	75746	115195	5781	120976	221553	54.6%	17.81%	177	177
15	嘉義市	2018-11-24T22:51:05+08:00	31225	59873	91098	4464	95562	174433	54.78%	17.9%	143	177
15	嘉義市	2018-11-25T01:02:45+08:00	39449	75746	115195	5781	120976	221553	54.6%	17.81%	177	177
15	嘉義市	2018-11-24T22:40:41+08:00	30148	57801	87949	4359	92308	168329	54.84%	17.91%	139	177
15	嘉義市	2018-11-25T00:57:52+08:00	39449	75746	115195	5781	120976	221553	54.6%	17.81%	177	177
15	嘉義市	2018-11-25T01:13:00+08:00	39449	75746	115195	5781	120976	221553	54.6%	17.81%	177	177
15	嘉義市	2018-11-25T06:24:14+08:00	39449	75746	115195	5781	120976	221553	54.6%	17.81%	177	177
15	嘉義市	2018-11-25T00:23:18+08:00	39449	75746	115195	5781	120976	221553	54.6%	17.81%	177	177
15	嘉義市	2018-11-25T00:00:25+08:00	37626	72388	110014	5593	115607	211613	54.63%	17.78%	170	177
15	嘉義市	2018-11-24T23:35:23+08:00	36545	70255	106800	5420	112220	205531	54.6%	17.78%	166	177
15	嘉義市	2018-11-24T23:16:17+08:00	34719	66752	101471	5018	106489	193873	54.93%	17.91%	158	177
15	嘉義市	2018-11-25T00:14:24+08:00	39449	75746	115195	5781	120976	221553	54.6%	17.81%	177	177
15	嘉義市	2018-11-24T22:58:10+08:00	33150	63765	96915	4798	101713	185366	54.87%	17.88%	152	177
15	嘉義市	2018-11-25T01:26:09+08:00	39449	75746	115195	5781	120976	221553	54.6%	17.81%	177	177
15	嘉義市	2018-11-25T03:39:09+08:00	39449	75746	115195	5781	120976	221553	54.6%	17.81%	177	177
15	嘉義市	2018-11-24T22:16:26+08:00	26023	49714	75737	3676	79413	144660	54.9%	17.99%	122	177
15	嘉義市	2018-11-25T00:09:52+08:00	39449	75746	115195	5781	120976	221553	54.6%	17.81%	177	177
15	嘉義市	2018-11-25T06:19:11+08:00	39449	75746	115195	5781	120976	221553	54.6%	17.81%	177	177
15	嘉義市	2018-11-25T03:50:05+08:00	39449	75746	115195	5781	120976	221553	54.6%	17.81%	177	177
15	宜蘭縣冬山鄉	2018-11-24T23:05:15+08:00	7014	13109	20123	1260	21383	39278	54.44%	17.86%	35	39
15	宜蘭縣冬山鄉	2018-11-25T01:18:08+08:00	8099	14995	23094	1420	24514	45405	53.99%	17.84%	39	39
15	宜蘭縣冬山鄉	2018-11-24T23:43:29+08:00	7796	14429	22225	1381	23606	43679	54.04%	17.85%	38	39
15	宜蘭縣冬山鄉	2018-11-25T03:56:27+08:00	8099	14995	23094	1420	24514	45405	53.99%	17.84%	39	39
15	宜蘭縣冬山鄉	2018-11-25T06:19:09+08:00	8099	14995	23094	1420	24514	45405	53.99%	17.84%	39	39
15	宜蘭縣冬山鄉	2018-11-24T22:58:07+08:00	7014	13109	20123	1260	21383	39278	54.44%	17.86%	35	39
15	宜蘭縣冬山鄉	2018-11-24T22:41:49+08:00	6305	11894	18199	1169	19368	35822	54.07%	17.6%	32	39
15	宜蘭縣冬山鄉	2018-11-24T23:39:31+08:00	7796	14429	22225	1381	23606	43679	54.04%	17.85%	38	39
15	宜蘭縣冬山鄉	2018-11-24T23:47:42+08:00	7796	14429	22225	1381	23606	43679	54.04%	17.85%	38	39
15	宜蘭縣冬山鄉	2018-11-24T22:30:22+08:00	5391	10268	15659	1024	16683	30612	54.5%	17.61%	28	39
15	宜蘭縣冬山鄉	2018-11-24T23:51:47+08:00	7796	14429	22225	1381	23606	43679	54.04%	17.85%	38	39
15	宜蘭縣冬山鄉	2018-11-25T06:09:08+08:00	8099	14995	23094	1420	24514	45405	53.99%	17.84%	39	39
15	宜蘭縣冬山鄉	2018-11-24T22:13:43+08:00	4752	9003	13755	894	14649	27101	54.05%	17.53%	25	39
15	宜蘭縣冬山鄉	2018-11-25T00:57:50+08:00	8099	14995	23094	1420	24514	45405	53.99%	17.84%	39	39
15	宜蘭縣冬山鄉	2018-11-25T03:44:39+08:00	8099	14995	23094	1420	24514	45405	53.99%	17.84%	39	39
15	宜蘭縣冬山鄉	2018-11-24T23:23:49+08:00	7363	13563	20926	1294	22220	40749	54.53%	18.07%	36	39
15	宜蘭縣冬山鄉	2018-11-24T22:33:49+08:00	5840	11022	16862	1094	17956	33056	54.32%	17.67%	30	39
15	宜蘭縣冬山鄉	2018-11-24T22:37:13+08:00	6045	11408	17453	1134	18587	34303	54.18%	17.62%	31	39
15	宜蘭縣冬山鄉	2018-11-24T22:16:24+08:00	4919	9293	14212	929	15141	27985	54.1%	17.58%	26	39
15	宜蘭縣冬山鄉	2018-11-25T00:18:46+08:00	8099	14995	23094	1420	24514	45405	53.99%	17.84%	39	39
15	宜蘭縣冬山鄉	2018-11-24T23:35:21+08:00	7796	14429	22225	1381	23606	43679	54.04%	17.85%	38	39
15	宜蘭縣冬山鄉	2018-11-24T23:16:15+08:00	7363	13563	20926	1294	22220	40749	54.53%	18.07%	36	39
15	宜蘭縣冬山鄉	2018-11-24T22:45:19+08:00	6305	11894	18199	1169	19368	35822	54.07%	17.6%	32	39
15	宜蘭縣冬山鄉	2018-11-24T22:54:36+08:00	6753	12699	19452	1228	20680	38031	54.38%	17.76%	34	39
15	宜蘭縣冬山鄉	2018-11-24T23:01:44+08:00	7014	13109	20123	1260	21383	39278	54.44%	17.86%	35	39
15	宜蘭縣冬山鄉	2018-11-24T22:26:47+08:00	5391	10268	15659	1024	16683	30612	54.5%	17.61%	28	39
15	宜蘭縣冬山鄉	2018-11-25T00:05:17+08:00	7796	14429	22225	1381	23606	43679	54.04%	17.85%	38	39
15	宜蘭縣冬山鄉	2018-11-25T01:12:57+08:00	8099	14995	23094	1420	24514	45405	53.99%	17.84%	39	39
15	宜蘭縣冬山鄉	2018-11-25T00:09:49+08:00	8099	14995	23094	1420	24514	45405	53.99%	17.84%	39	39
15	宜蘭縣冬山鄉	2018-11-24T22:19:49+08:00	5114	9641	14755	965	15720	29086	54.05%	17.58%	27	39
15	宜蘭縣冬山鄉	2018-11-25T04:03:04+08:00	8099	14995	23094	1420	24514	45405	53.99%	17.84%	39	39
15	宜蘭縣冬山鄉	2018-11-24T22:40:39+08:00	6305	11894	18199	1169	19368	35822	54.07%	17.6%	32	39
15	宜蘭縣冬山鄉	2018-11-25T03:32:51+08:00	8099	14995	23094	1420	24514	45405	53.99%	17.84%	39	39
15	宜蘭縣冬山鄉	2018-11-24T23:08:50+08:00	7014	13109	20123	1260	21383	39278	54.44%	17.86%	35	39
15	宜蘭縣冬山鄉	2018-11-24T22:23:27+08:00	5114	9641	14755	965	15720	29086	54.05%	17.58%	27	39
15	宜蘭縣冬山鄉	2018-11-24T22:51:02+08:00	6573	12417	18990	1213	20203	37214	54.29%	17.66%	33	39
15	宜蘭縣冬山鄉	2018-11-25T06:14:04+08:00	8099	14995	23094	1420	24514	45405	53.99%	17.84%	39	39
15	宜蘭縣冬山鄉	2018-11-24T23:55:59+08:00	7796	14429	22225	1381	23606	43679	54.04%	17.85%	38	39
15	宜蘭縣冬山鄉	2018-11-25T06:24:12+08:00	8099	14995	23094	1420	24514	45405	53.99%	17.84%	39	39
15	宜蘭縣冬山鄉	2018-11-24T23:27:29+08:00	7584	14011	21595	1344	22939	42244	54.3%	17.95%	37	39
15	宜蘭縣冬山鄉	2018-11-25T00:00:22+08:00	7796	14429	22225	1381	23606	43679	54.04%	17.85%	38	39
15	宜蘭縣冬山鄉	2018-11-25T00:23:16+08:00	8099	14995	23094	1420	24514	45405	53.99%	17.84%	39	39
15	宜蘭縣冬山鄉	2018-11-25T01:02:43+08:00	8099	14995	23094	1420	24514	45405	53.99%	17.84%	39	39
15	宜蘭縣冬山鄉	2018-11-25T06:29:30+08:00	8099	14995	23094	1420	24514	45405	53.99%	17.84%	39	39
15	宜蘭縣冬山鄉	2018-11-24T23:12:29+08:00	7363	13563	20926	1294	22220	40749	54.53%	18.07%	36	39
15	宜蘭縣冬山鄉	2018-11-24T23:31:25+08:00	7584	14011	21595	1344	22939	42244	54.3%	17.95%	37	39
15	宜蘭縣冬山鄉	2018-11-25T03:50:03+08:00	8099	14995	23094	1420	24514	45405	53.99%	17.84%	39	39
15	宜蘭縣冬山鄉	2018-11-25T00:14:22+08:00	8099	14995	23094	1420	24514	45405	53.99%	17.84%	39	39
15	宜蘭縣冬山鄉	2018-11-25T01:07:38+08:00	8099	14995	23094	1420	24514	45405	53.99%	17.84%	39	39
15	宜蘭縣冬山鄉	2018-11-25T03:39:06+08:00	8099	14995	23094	1420	24514	45405	53.99%	17.84%	39	39
15	宜蘭縣冬山鄉	2018-11-25T01:26:06+08:00	8099	14995	23094	1420	24514	45405	53.99%	17.84%	39	39
15	宜蘭縣冬山鄉	2018-11-24T23:20:05+08:00	7363	13563	20926	1294	22220	40749	54.53%	18.07%	36	39
15	嘉義縣大林鎮	2018-11-25T01:18:06+08:00	4191	8594	12785	1117	13902	26922	51.64%	15.57%	25	25
15	嘉義縣大林鎮	2018-11-25T06:29:28+08:00	4191	8594	12785	1117	13902	26922	51.64%	15.57%	25	25
15	嘉義縣大林鎮	2018-11-25T01:12:55+08:00	4191	8594	12785	1117	13902	26922	51.64%	15.57%	25	25
15	嘉義縣大林鎮	2018-11-24T23:05:13+08:00	3367	6804	10171	943	11114	21790	51.01%	15.45%	22	25
15	嘉義縣大林鎮	2018-11-25T06:19:07+08:00	4191	8594	12785	1117	13902	26922	51.64%	15.57%	25	25
15	嘉義縣大林鎮	2018-11-25T00:05:15+08:00	3879	7955	11834	1050	12884	25099	51.33%	15.45%	24	25
15	嘉義縣大林鎮	2018-11-24T22:54:34+08:00	3161	6308	9469	882	10351	20325	50.93%	15.55%	21	25
15	嘉義縣大林鎮	2018-11-24T22:41:47+08:00	3161	6308	9469	882	10351	20325	50.93%	15.55%	21	25
15	嘉義縣大林鎮	2018-11-24T23:43:26+08:00	3879	7955	11834	1050	12884	25099	51.33%	15.45%	24	25
15	嘉義縣大林鎮	2018-11-24T22:50:59+08:00	3161	6308	9469	882	10351	20325	50.93%	15.55%	21	25
15	嘉義縣大林鎮	2018-11-25T01:02:41+08:00	4191	8594	12785	1117	13902	26922	51.64%	15.57%	25	25
15	嘉義縣大林鎮	2018-11-25T00:23:14+08:00	4191	8594	12785	1117	13902	26922	51.64%	15.57%	25	25
15	嘉義縣大林鎮	2018-11-25T03:32:48+08:00	4191	8594	12785	1117	13902	26922	51.64%	15.57%	25	25
15	嘉義縣大林鎮	2018-11-24T23:23:48+08:00	3642	7489	11131	1001	12132	23520	51.58%	15.48%	23	25
15	嘉義縣大林鎮	2018-11-25T06:24:10+08:00	4191	8594	12785	1117	13902	26922	51.64%	15.57%	25	25
15	嘉義縣大林鎮	2018-11-25T00:00:21+08:00	3879	7955	11834	1050	12884	25099	51.33%	15.45%	24	25
15	嘉義縣大林鎮	2018-11-24T22:23:25+08:00	2748	5588	8336	782	9118	18073	50.45%	15.21%	19	25
15	嘉義縣大林鎮	2018-11-25T03:44:37+08:00	4191	8594	12785	1117	13902	26922	51.64%	15.57%	25	25
15	嘉義縣大林鎮	2018-11-24T23:08:48+08:00	3367	6804	10171	943	11114	21790	51.01%	15.45%	22	25
15	嘉義縣大林鎮	2018-11-24T22:33:47+08:00	3161	6308	9469	882	10351	20325	50.93%	15.55%	21	25
15	嘉義縣大林鎮	2018-11-24T22:16:22+08:00	2748	5588	8336	782	9118	18073	50.45%	15.21%	19	25
15	嘉義縣大林鎮	2018-11-25T03:39:04+08:00	4191	8594	12785	1117	13902	26922	51.64%	15.57%	25	25
15	嘉義縣大林鎮	2018-11-25T01:26:04+08:00	4191	8594	12785	1117	13902	26922	51.64%	15.57%	25	25
15	嘉義縣大林鎮	2018-11-24T23:16:13+08:00	3367	6804	10171	943	11114	21790	51.01%	15.45%	22	25
15	嘉義縣大林鎮	2018-11-25T00:14:20+08:00	4191	8594	12785	1117	13902	26922	51.64%	15.57%	25	25
15	嘉義縣大林鎮	2018-11-25T03:50:01+08:00	4191	8594	12785	1117	13902	26922	51.64%	15.57%	25	25
15	嘉義縣大林鎮	2018-11-24T23:35:19+08:00	3879	7955	11834	1050	12884	25099	51.33%	15.45%	24	25
15	嘉義縣大林鎮	2018-11-24T23:47:40+08:00	3879	7955	11834	1050	12884	25099	51.33%	15.45%	24	25
15	嘉義縣大林鎮	2018-11-24T22:45:17+08:00	3161	6308	9469	882	10351	20325	50.93%	15.55%	21	25
15	嘉義縣大林鎮	2018-11-24T22:58:05+08:00	3161	6308	9469	882	10351	20325	50.93%	15.55%	21	25
15	嘉義縣大林鎮	2018-11-25T00:09:46+08:00	3879	7955	11834	1050	12884	25099	51.33%	15.45%	24	25
15	嘉義縣大林鎮	2018-11-25T03:56:24+08:00	4191	8594	12785	1117	13902	26922	51.64%	15.57%	25	25
15	嘉義縣大林鎮	2018-11-24T22:26:46+08:00	2748	5588	8336	782	9118	18073	50.45%	15.21%	19	25
15	嘉義縣大林鎮	2018-11-24T23:01:42+08:00	3161	6308	9469	882	10351	20325	50.93%	15.55%	21	25
15	嘉義縣大林鎮	2018-11-25T00:57:47+08:00	4191	8594	12785	1117	13902	26922	51.64%	15.57%	25	25
15	嘉義縣大林鎮	2018-11-24T22:19:46+08:00	2748	5588	8336	782	9118	18073	50.45%	15.21%	19	25
15	嘉義縣大林鎮	2018-11-24T22:13:41+08:00	2748	5588	8336	782	9118	18073	50.45%	15.21%	19	25
15	嘉義縣大林鎮	2018-11-25T04:03:02+08:00	4191	8594	12785	1117	13902	26922	51.64%	15.57%	25	25
15	嘉義縣大林鎮	2018-11-24T22:40:37+08:00	3161	6308	9469	882	10351	20325	50.93%	15.55%	21	25
15	嘉義縣大林鎮	2018-11-24T23:51:45+08:00	3879	7955	11834	1050	12884	25099	51.33%	15.45%	24	25
15	嘉義縣大林鎮	2018-11-24T22:30:20+08:00	3040	6120	9160	833	9993	19609	50.96%	15.5%	20	25
15	嘉義縣大林鎮	2018-11-25T06:09:05+08:00	4191	8594	12785	1117	13902	26922	51.64%	15.57%	25	25
15	嘉義縣大林鎮	2018-11-24T23:55:57+08:00	3879	7955	11834	1050	12884	25099	51.33%	15.45%	24	25
15	嘉義縣大林鎮	2018-11-24T23:27:27+08:00	3879	7955	11834	1050	12884	25099	51.33%	15.45%	24	25
15	嘉義縣大林鎮	2018-11-25T06:14:02+08:00	4191	8594	12785	1117	13902	26922	51.64%	15.57%	25	25
15	嘉義縣大林鎮	2018-11-25T00:18:43+08:00	4191	8594	12785	1117	13902	26922	51.64%	15.57%	25	25
15	嘉義縣大林鎮	2018-11-25T01:07:37+08:00	4191	8594	12785	1117	13902	26922	51.64%	15.57%	25	25
15	嘉義縣大林鎮	2018-11-24T23:12:27+08:00	3367	6804	10171	943	11114	21790	51.01%	15.45%	22	25
15	嘉義縣大林鎮	2018-11-24T23:39:28+08:00	3879	7955	11834	1050	12884	25099	51.33%	15.45%	24	25
15	嘉義縣大林鎮	2018-11-24T22:37:11+08:00	3161	6308	9469	882	10351	20325	50.93%	15.55%	21	25
15	嘉義縣大林鎮	2018-11-24T23:31:23+08:00	3879	7955	11834	1050	12884	25099	51.33%	15.45%	24	25
15	嘉義縣大林鎮	2018-11-24T23:20:02+08:00	3367	6804	10171	943	11114	21790	51.01%	15.45%	22	25
15	嘉義縣竹崎鄉	2018-11-25T01:18:06+08:00	4432	10473	14905	1194	16099	31228	51.55%	14.19%	36	36
15	嘉義縣竹崎鄉	2018-11-25T06:29:28+08:00	4432	10473	14905	1194	16099	31228	51.55%	14.19%	36	36
15	嘉義縣竹崎鄉	2018-11-24T23:43:27+08:00	4272	10025	14297	1133	15430	29936	51.54%	14.27%	35	36
15	嘉義縣竹崎鄉	2018-11-24T22:54:35+08:00	3817	9024	12841	1002	13843	27108	51.07%	14.08%	33	36
15	嘉義縣竹崎鄉	2018-11-24T23:05:14+08:00	3817	9024	12841	1002	13843	27108	51.07%	14.08%	33	36
15	嘉義縣竹崎鄉	2018-11-25T06:19:07+08:00	4432	10473	14905	1194	16099	31228	51.55%	14.19%	36	36
15	嘉義縣竹崎鄉	2018-11-25T00:05:15+08:00	4272	10025	14297	1133	15430	29936	51.54%	14.27%	35	36
15	嘉義縣竹崎鄉	2018-11-24T22:41:47+08:00	3450	8168	11618	941	12559	24691	50.86%	13.97%	31	36
15	嘉義縣竹崎鄉	2018-11-24T23:51:46+08:00	4272	10025	14297	1133	15430	29936	51.54%	14.27%	35	36
15	嘉義縣竹崎鄉	2018-11-25T06:09:06+08:00	4432	10473	14905	1194	16099	31228	51.55%	14.19%	36	36
15	嘉義縣竹崎鄉	2018-11-25T01:02:41+08:00	4432	10473	14905	1194	16099	31228	51.55%	14.19%	36	36
15	嘉義縣竹崎鄉	2018-11-25T00:23:14+08:00	4432	10473	14905	1194	16099	31228	51.55%	14.19%	36	36
15	嘉義縣竹崎鄉	2018-11-25T06:24:11+08:00	4432	10473	14905	1194	16099	31228	51.55%	14.19%	36	36
15	嘉義縣竹崎鄉	2018-11-24T23:23:48+08:00	3957	9303	13260	1068	14328	27941	51.28%	14.16%	34	36
15	嘉義縣竹崎鄉	2018-11-25T00:00:21+08:00	4272	10025	14297	1133	15430	29936	51.54%	14.27%	35	36
15	嘉義縣竹崎鄉	2018-11-24T22:23:25+08:00	3104	7367	10471	867	11338	22485	50.42%	13.8%	29	36
15	嘉義縣竹崎鄉	2018-11-24T22:51:00+08:00	3450	8168	11618	941	12559	24691	50.86%	13.97%	31	36
15	嘉義縣竹崎鄉	2018-11-25T03:32:49+08:00	4432	10473	14905	1194	16099	31228	51.55%	14.19%	36	36
15	嘉義縣竹崎鄉	2018-11-25T03:44:37+08:00	4432	10473	14905	1194	16099	31228	51.55%	14.19%	36	36
15	嘉義縣竹崎鄉	2018-11-24T23:08:48+08:00	3817	9024	12841	1002	13843	27108	51.07%	14.08%	33	36
15	嘉義縣竹崎鄉	2018-11-24T22:16:22+08:00	2754	6524	9278	727	10005	19886	50.31%	13.85%	27	36
15	嘉義縣竹崎鄉	2018-11-25T01:26:04+08:00	4432	10473	14905	1194	16099	31228	51.55%	14.19%	36	36
15	嘉義縣竹崎鄉	2018-11-24T23:16:13+08:00	3817	9024	12841	1002	13843	27108	51.07%	14.08%	33	36
15	嘉義縣竹崎鄉	2018-11-24T23:35:20+08:00	3957	9303	13260	1068	14328	27941	51.28%	14.16%	34	36
15	嘉義縣竹崎鄉	2018-11-25T00:14:20+08:00	4272	10025	14297	1133	15430	29936	51.54%	14.27%	35	36
15	嘉義縣竹崎鄉	2018-11-25T03:39:05+08:00	4432	10473	14905	1194	16099	31228	51.55%	14.19%	36	36
15	嘉義縣竹崎鄉	2018-11-24T22:33:48+08:00	3450	8168	11618	941	12559	24691	50.86%	13.97%	31	36
15	嘉義縣竹崎鄉	2018-11-25T03:50:01+08:00	4432	10473	14905	1194	16099	31228	51.55%	14.19%	36	36
15	嘉義縣竹崎鄉	2018-11-25T01:12:56+08:00	4432	10473	14905	1194	16099	31228	51.55%	14.19%	36	36
15	嘉義縣竹崎鄉	2018-11-24T23:47:40+08:00	4272	10025	14297	1133	15430	29936	51.54%	14.27%	35	36
15	嘉義縣竹崎鄉	2018-11-24T23:01:43+08:00	3817	9024	12841	1002	13843	27108	51.07%	14.08%	33	36
15	嘉義縣竹崎鄉	2018-11-24T22:58:05+08:00	3817	9024	12841	1002	13843	27108	51.07%	14.08%	33	36
15	嘉義縣竹崎鄉	2018-11-25T00:09:46+08:00	4272	10025	14297	1133	15430	29936	51.54%	14.27%	35	36
15	嘉義縣竹崎鄉	2018-11-25T03:56:25+08:00	4432	10473	14905	1194	16099	31228	51.55%	14.19%	36	36
15	嘉義縣竹崎鄉	2018-11-24T22:45:18+08:00	3450	8168	11618	941	12559	24691	50.86%	13.97%	31	36
15	嘉義縣竹崎鄉	2018-11-24T22:26:46+08:00	3215	7593	10808	884	11692	23101	50.61%	13.92%	30	36
15	嘉義縣竹崎鄉	2018-11-24T22:13:41+08:00	2754	6524	9278	727	10005	19886	50.31%	13.85%	27	36
15	嘉義縣竹崎鄉	2018-11-24T22:40:38+08:00	3450	8168	11618	941	12559	24691	50.86%	13.97%	31	36
15	嘉義縣竹崎鄉	2018-11-25T04:03:03+08:00	4432	10473	14905	1194	16099	31228	51.55%	14.19%	36	36
15	嘉義縣竹崎鄉	2018-11-25T00:57:48+08:00	4432	10473	14905	1194	16099	31228	51.55%	14.19%	36	36
15	嘉義縣竹崎鄉	2018-11-24T22:19:47+08:00	2879	6877	9756	777	10533	20917	50.36%	13.76%	28	36
15	嘉義縣竹崎鄉	2018-11-24T22:30:20+08:00	3215	7593	10808	884	11692	23101	50.61%	13.92%	30	36
15	嘉義縣竹崎鄉	2018-11-24T23:27:28+08:00	3957	9303	13260	1068	14328	27941	51.28%	14.16%	34	36
15	嘉義縣竹崎鄉	2018-11-24T23:55:58+08:00	4272	10025	14297	1133	15430	29936	51.54%	14.27%	35	36
15	嘉義縣竹崎鄉	2018-11-25T06:14:02+08:00	4432	10473	14905	1194	16099	31228	51.55%	14.19%	36	36
15	嘉義縣竹崎鄉	2018-11-25T00:18:44+08:00	4432	10473	14905	1194	16099	31228	51.55%	14.19%	36	36
15	嘉義縣竹崎鄉	2018-11-24T23:20:03+08:00	3817	9024	12841	1002	13843	27108	51.07%	14.08%	33	36
15	嘉義縣竹崎鄉	2018-11-25T01:07:37+08:00	4432	10473	14905	1194	16099	31228	51.55%	14.19%	36	36
15	嘉義縣竹崎鄉	2018-11-24T23:12:27+08:00	3817	9024	12841	1002	13843	27108	51.07%	14.08%	33	36
15	嘉義縣竹崎鄉	2018-11-24T22:37:11+08:00	3450	8168	11618	941	12559	24691	50.86%	13.97%	31	36
15	嘉義縣竹崎鄉	2018-11-24T23:39:29+08:00	3957	9303	13260	1068	14328	27941	51.28%	14.16%	34	36
15	嘉義縣竹崎鄉	2018-11-24T23:31:24+08:00	3957	9303	13260	1068	14328	27941	51.28%	14.16%	34	36
15	金門縣金湖鎮	2018-11-25T03:56:28+08:00	2250	6756	9006	490	9496	25915	36.64%	8.68%	17	17
15	金門縣金湖鎮	2018-11-24T23:12:31+08:00	2151	6374	8525	436	8961	24405	36.72%	8.81%	16	17
15	金門縣金湖鎮	2018-11-24T23:47:43+08:00	2250	6756	9006	490	9496	25915	36.64%	8.68%	17	17
15	金門縣金湖鎮	2018-11-24T22:58:09+08:00	2151	6374	8525	436	8961	24405	36.72%	8.81%	16	17
15	金門縣金湖鎮	2018-11-24T23:56:01+08:00	2250	6756	9006	490	9496	25915	36.64%	8.68%	17	17
15	金門縣金湖鎮	2018-11-24T23:01:46+08:00	2151	6374	8525	436	8961	24405	36.72%	8.81%	16	17
15	金門縣金湖鎮	2018-11-25T03:32:53+08:00	2250	6756	9006	490	9496	25915	36.64%	8.68%	17	17
15	金門縣金湖鎮	2018-11-24T23:08:52+08:00	2151	6374	8525	436	8961	24405	36.72%	8.81%	16	17
15	金門縣金湖鎮	2018-11-24T23:51:49+08:00	2250	6756	9006	490	9496	25915	36.64%	8.68%	17	17
15	金門縣金湖鎮	2018-11-24T22:13:45+08:00	1436	4367	5803	303	6106	16983	35.95%	8.46%	11	17
15	金門縣金湖鎮	2018-11-25T03:44:41+08:00	2250	6756	9006	490	9496	25915	36.64%	8.68%	17	17
15	金門縣金湖鎮	2018-11-25T04:03:06+08:00	2250	6756	9006	490	9496	25915	36.64%	8.68%	17	17
15	金門縣金湖鎮	2018-11-24T23:27:31+08:00	2151	6374	8525	436	8961	24405	36.72%	8.81%	16	17
15	金門縣金湖鎮	2018-11-24T22:30:24+08:00	1674	5089	6763	364	7127	19897	35.82%	8.41%	13	17
15	金門縣金湖鎮	2018-11-25T00:57:51+08:00	2250	6756	9006	490	9496	25915	36.64%	8.68%	17	17
15	金門縣金湖鎮	2018-11-24T22:19:50+08:00	1535	4726	6261	338	6599	18497	35.68%	8.3%	12	17
15	金門縣金湖鎮	2018-11-25T00:09:50+08:00	2250	6756	9006	490	9496	25915	36.64%	8.68%	17	17
15	金門縣金湖鎮	2018-11-25T00:18:47+08:00	2250	6756	9006	490	9496	25915	36.64%	8.68%	17	17
15	金門縣金湖鎮	2018-11-24T22:37:14+08:00	1804	5538	7342	390	7732	21300	36.3%	8.47%	14	17
15	金門縣金湖鎮	2018-11-24T23:20:08+08:00	2151	6374	8525	436	8961	24405	36.72%	8.81%	16	17
15	金門縣金湖鎮	2018-11-24T23:31:27+08:00	2151	6374	8525	436	8961	24405	36.72%	8.81%	16	17
15	金門縣金湖鎮	2018-11-24T22:45:21+08:00	1804	5538	7342	390	7732	21300	36.3%	8.47%	14	17
15	金門縣金湖鎮	2018-11-24T22:54:38+08:00	2000	5954	7954	420	8374	23080	36.28%	8.67%	15	17
15	金門縣金湖鎮	2018-11-24T22:33:51+08:00	1804	5538	7342	390	7732	21300	36.3%	8.47%	14	17
15	金門縣金湖鎮	2018-11-24T23:39:33+08:00	2250	6756	9006	490	9496	25915	36.64%	8.68%	17	17
15	金門縣金湖鎮	2018-11-24T22:26:49+08:00	1674	5089	6763	364	7127	19897	35.82%	8.41%	13	17
15	金門縣金湖鎮	2018-11-25T01:07:40+08:00	2250	6756	9006	490	9496	25915	36.64%	8.68%	17	17
15	金門縣金湖鎮	2018-11-25T01:12:59+08:00	2250	6756	9006	490	9496	25915	36.64%	8.68%	17	17
15	金門縣金湖鎮	2018-11-25T00:05:18+08:00	2250	6756	9006	490	9496	25915	36.64%	8.68%	17	17
15	金門縣金湖鎮	2018-11-24T23:05:17+08:00	2151	6374	8525	436	8961	24405	36.72%	8.81%	16	17
15	金門縣金湖鎮	2018-11-24T23:23:51+08:00	2151	6374	8525	436	8961	24405	36.72%	8.81%	16	17
15	金門縣金湖鎮	2018-11-24T22:23:29+08:00	1674	5089	6763	364	7127	19897	35.82%	8.41%	13	17
15	金門縣金湖鎮	2018-11-25T00:23:17+08:00	2250	6756	9006	490	9496	25915	36.64%	8.68%	17	17
15	金門縣金湖鎮	2018-11-25T00:00:24+08:00	2250	6756	9006	490	9496	25915	36.64%	8.68%	17	17
15	金門縣金湖鎮	2018-11-25T01:02:45+08:00	2250	6756	9006	490	9496	25915	36.64%	8.68%	17	17
15	金門縣金湖鎮	2018-11-24T22:51:04+08:00	1804	5538	7342	390	7732	21300	36.3%	8.47%	14	17
15	金門縣金湖鎮	2018-11-25T06:09:10+08:00	2250	6756	9006	490	9496	25915	36.64%	8.68%	17	17
15	金門縣金湖鎮	2018-11-25T06:24:14+08:00	2250	6756	9006	490	9496	25915	36.64%	8.68%	17	17
15	金門縣金湖鎮	2018-11-24T22:40:40+08:00	1804	5538	7342	390	7732	21300	36.3%	8.47%	14	17
15	金門縣金湖鎮	2018-11-25T06:14:05+08:00	2250	6756	9006	490	9496	25915	36.64%	8.68%	17	17
15	金門縣金湖鎮	2018-11-24T23:35:23+08:00	2151	6374	8525	436	8961	24405	36.72%	8.81%	16	17
15	金門縣金湖鎮	2018-11-25T00:14:24+08:00	2250	6756	9006	490	9496	25915	36.64%	8.68%	17	17
15	金門縣金湖鎮	2018-11-25T03:50:04+08:00	2250	6756	9006	490	9496	25915	36.64%	8.68%	17	17
15	金門縣金湖鎮	2018-11-24T22:16:26+08:00	1436	4367	5803	303	6106	16983	35.95%	8.46%	11	17
15	金門縣金湖鎮	2018-11-24T23:43:31+08:00	2250	6756	9006	490	9496	25915	36.64%	8.68%	17	17
15	金門縣金湖鎮	2018-11-25T01:18:11+08:00	2250	6756	9006	490	9496	25915	36.64%	8.68%	17	17
15	金門縣金湖鎮	2018-11-25T06:29:31+08:00	2250	6756	9006	490	9496	25915	36.64%	8.68%	17	17
15	金門縣金湖鎮	2018-11-24T23:16:16+08:00	2151	6374	8525	436	8961	24405	36.72%	8.81%	16	17
15	金門縣金湖鎮	2018-11-25T06:19:11+08:00	2250	6756	9006	490	9496	25915	36.64%	8.68%	17	17
15	金門縣金湖鎮	2018-11-24T22:41:51+08:00	1804	5538	7342	390	7732	21300	36.3%	8.47%	14	17
15	金門縣金湖鎮	2018-11-25T03:39:08+08:00	2250	6756	9006	490	9496	25915	36.64%	8.68%	17	17
15	金門縣金湖鎮	2018-11-25T01:26:08+08:00	2250	6756	9006	490	9496	25915	36.64%	8.68%	17	17
15	高雄市燕巢區	2018-11-25T01:18:01+08:00	4398	9355	13753	1159	14912	26012	57.33%	16.91%	25	25
15	高雄市燕巢區	2018-11-24T22:58:01+08:00	4398	9355	13753	1159	14912	26012	57.33%	16.91%	25	25
15	高雄市燕巢區	2018-11-24T22:26:43+08:00	4206	8886	13092	1100	14192	24910	56.97%	16.88%	24	25
15	高雄市燕巢區	2018-11-25T00:09:42+08:00	4398	9355	13753	1159	14912	26012	57.33%	16.91%	25	25
15	高雄市燕巢區	2018-11-24T22:37:07+08:00	4206	8886	13092	1100	14192	24910	56.97%	16.88%	24	25
15	高雄市燕巢區	2018-11-25T00:18:39+08:00	4398	9355	13753	1159	14912	26012	57.33%	16.91%	25	25
15	高雄市燕巢區	2018-11-24T22:45:14+08:00	4206	8886	13092	1100	14192	24910	56.97%	16.88%	24	25
15	高雄市燕巢區	2018-11-25T03:56:20+08:00	4398	9355	13753	1159	14912	26012	57.33%	16.91%	25	25
15	高雄市燕巢區	2018-11-25T00:05:12+08:00	4398	9355	13753	1159	14912	26012	57.33%	16.91%	25	25
15	高雄市燕巢區	2018-11-24T23:16:09+08:00	4398	9355	13753	1159	14912	26012	57.33%	16.91%	25	25
15	高雄市燕巢區	2018-11-25T01:02:38+08:00	4398	9355	13753	1159	14912	26012	57.33%	16.91%	25	25
15	高雄市燕巢區	2018-11-25T01:25:59+08:00	4398	9355	13753	1159	14912	26012	57.33%	16.91%	25	25
15	高雄市燕巢區	2018-11-25T00:57:44+08:00	4398	9355	13753	1159	14912	26012	57.33%	16.91%	25	25
15	高雄市燕巢區	2018-11-24T22:40:34+08:00	4206	8886	13092	1100	14192	24910	56.97%	16.88%	24	25
15	高雄市燕巢區	2018-11-25T06:09:01+08:00	4398	9355	13753	1159	14912	26012	57.33%	16.91%	25	25
15	高雄市燕巢區	2018-11-24T22:19:43+08:00	4206	8886	13092	1100	14192	24910	56.97%	16.88%	24	25
15	高雄市燕巢區	2018-11-24T23:55:53+08:00	4398	9355	13753	1159	14912	26012	57.33%	16.91%	25	25
15	高雄市燕巢區	2018-11-25T03:44:31+08:00	4398	9355	13753	1159	14912	26012	57.33%	16.91%	25	25
15	高雄市燕巢區	2018-11-24T23:19:59+08:00	4398	9355	13753	1159	14912	26012	57.33%	16.91%	25	25
15	高雄市燕巢區	2018-11-25T00:00:17+08:00	4398	9355	13753	1159	14912	26012	57.33%	16.91%	25	25
15	高雄市燕巢區	2018-11-24T23:27:24+08:00	4398	9355	13753	1159	14912	26012	57.33%	16.91%	25	25
15	高雄市燕巢區	2018-11-25T01:07:33+08:00	4398	9355	13753	1159	14912	26012	57.33%	16.91%	25	25
15	高雄市燕巢區	2018-11-24T23:31:19+08:00	4398	9355	13753	1159	14912	26012	57.33%	16.91%	25	25
15	高雄市燕巢區	2018-11-24T23:12:23+08:00	4398	9355	13753	1159	14912	26012	57.33%	16.91%	25	25
15	高雄市燕巢區	2018-11-25T00:14:16+08:00	4398	9355	13753	1159	14912	26012	57.33%	16.91%	25	25
15	高雄市燕巢區	2018-11-24T23:35:16+08:00	4398	9355	13753	1159	14912	26012	57.33%	16.91%	25	25
15	高雄市燕巢區	2018-11-24T23:39:24+08:00	4398	9355	13753	1159	14912	26012	57.33%	16.91%	25	25
15	高雄市燕巢區	2018-11-24T23:01:38+08:00	4398	9355	13753	1159	14912	26012	57.33%	16.91%	25	25
15	高雄市燕巢區	2018-11-25T04:02:59+08:00	4398	9355	13753	1159	14912	26012	57.33%	16.91%	25	25
15	高雄市燕巢區	2018-11-24T23:43:23+08:00	4398	9355	13753	1159	14912	26012	57.33%	16.91%	25	25
15	高雄市燕巢區	2018-11-25T01:12:51+08:00	4398	9355	13753	1159	14912	26012	57.33%	16.91%	25	25
15	高雄市燕巢區	2018-11-24T22:54:31+08:00	4398	9355	13753	1159	14912	26012	57.33%	16.91%	25	25
15	高雄市燕巢區	2018-11-24T22:50:55+08:00	4206	8886	13092	1100	14192	24910	56.97%	16.88%	24	25
15	高雄市燕巢區	2018-11-25T06:13:59+08:00	4398	9355	13753	1159	14912	26012	57.33%	16.91%	25	25
15	高雄市燕巢區	2018-11-24T22:41:43+08:00	4206	8886	13092	1100	14192	24910	56.97%	16.88%	24	25
15	高雄市燕巢區	2018-11-25T03:49:57+08:00	4398	9355	13753	1159	14912	26012	57.33%	16.91%	25	25
15	高雄市燕巢區	2018-11-24T23:05:10+08:00	4398	9355	13753	1159	14912	26012	57.33%	16.91%	25	25
15	高雄市燕巢區	2018-11-25T06:19:03+08:00	4398	9355	13753	1159	14912	26012	57.33%	16.91%	25	25
15	高雄市燕巢區	2018-11-25T06:29:24+08:00	4398	9355	13753	1159	14912	26012	57.33%	16.91%	25	25
15	高雄市燕巢區	2018-11-25T06:24:06+08:00	4398	9355	13753	1159	14912	26012	57.33%	16.91%	25	25
15	高雄市燕巢區	2018-11-24T22:30:16+08:00	4206	8886	13092	1100	14192	24910	56.97%	16.88%	24	25
15	高雄市燕巢區	2018-11-24T23:51:42+08:00	4398	9355	13753	1159	14912	26012	57.33%	16.91%	25	25
15	高雄市燕巢區	2018-11-24T22:13:36+08:00	4206	8886	13092	1100	14192	24910	56.97%	16.88%	24	25
15	高雄市燕巢區	2018-11-24T23:08:44+08:00	4398	9355	13753	1159	14912	26012	57.33%	16.91%	25	25
15	高雄市燕巢區	2018-11-25T00:23:10+08:00	4398	9355	13753	1159	14912	26012	57.33%	16.91%	25	25
15	高雄市燕巢區	2018-11-24T22:23:21+08:00	4206	8886	13092	1100	14192	24910	56.97%	16.88%	24	25
15	高雄市燕巢區	2018-11-25T03:32:44+08:00	4398	9355	13753	1159	14912	26012	57.33%	16.91%	25	25
15	高雄市燕巢區	2018-11-24T23:23:44+08:00	4398	9355	13753	1159	14912	26012	57.33%	16.91%	25	25
15	高雄市燕巢區	2018-11-24T22:33:44+08:00	4206	8886	13092	1100	14192	24910	56.97%	16.88%	24	25
15	高雄市燕巢區	2018-11-24T23:47:36+08:00	4398	9355	13753	1159	14912	26012	57.33%	16.91%	25	25
15	高雄市燕巢區	2018-11-25T03:39:01+08:00	4398	9355	13753	1159	14912	26012	57.33%	16.91%	25	25
15	高雄市燕巢區	2018-11-24T22:16:18+08:00	4206	8886	13092	1100	14192	24910	56.97%	16.88%	24	25
15	高雄市美濃區	2018-11-25T01:18:01+08:00	4922	12858	17780	1641	19421	35311	55%	13.94%	32	32
15	高雄市美濃區	2018-11-24T22:58:01+08:00	4922	12858	17780	1641	19421	35311	55%	13.94%	32	32
15	高雄市美濃區	2018-11-24T22:26:43+08:00	4754	12442	17196	1610	18806	34059	55.22%	13.96%	31	32
15	高雄市美濃區	2018-11-25T00:09:42+08:00	4922	12858	17780	1641	19421	35311	55%	13.94%	32	32
15	高雄市美濃區	2018-11-25T01:12:52+08:00	4922	12858	17780	1641	19421	35311	55%	13.94%	32	32
15	高雄市美濃區	2018-11-24T22:37:07+08:00	4754	12442	17196	1610	18806	34059	55.22%	13.96%	31	32
15	高雄市美濃區	2018-11-24T22:54:32+08:00	4922	12858	17780	1641	19421	35311	55%	13.94%	32	32
15	高雄市美濃區	2018-11-24T22:50:56+08:00	4922	12858	17780	1641	19421	35311	55%	13.94%	32	32
15	高雄市美濃區	2018-11-25T00:18:39+08:00	4922	12858	17780	1641	19421	35311	55%	13.94%	32	32
15	高雄市美濃區	2018-11-25T03:56:20+08:00	4922	12858	17780	1641	19421	35311	55%	13.94%	32	32
15	高雄市美濃區	2018-11-25T00:05:12+08:00	4922	12858	17780	1641	19421	35311	55%	13.94%	32	32
15	高雄市美濃區	2018-11-24T23:16:09+08:00	4922	12858	17780	1641	19421	35311	55%	13.94%	32	32
15	高雄市美濃區	2018-11-24T22:45:15+08:00	4754	12442	17196	1610	18806	34059	55.22%	13.96%	31	32
15	高雄市美濃區	2018-11-25T01:02:38+08:00	4922	12858	17780	1641	19421	35311	55%	13.94%	32	32
15	高雄市美濃區	2018-11-25T00:57:44+08:00	4922	12858	17780	1641	19421	35311	55%	13.94%	32	32
15	高雄市美濃區	2018-11-24T22:40:34+08:00	4754	12442	17196	1610	18806	34059	55.22%	13.96%	31	32
15	高雄市美濃區	2018-11-25T06:09:01+08:00	4922	12858	17780	1641	19421	35311	55%	13.94%	32	32
15	高雄市美濃區	2018-11-24T22:19:43+08:00	4565	11946	16511	1581	18092	32621	55.46%	13.99%	30	32
15	高雄市美濃區	2018-11-24T23:55:54+08:00	4922	12858	17780	1641	19421	35311	55%	13.94%	32	32
15	高雄市美濃區	2018-11-25T03:44:31+08:00	4922	12858	17780	1641	19421	35311	55%	13.94%	32	32
15	高雄市美濃區	2018-11-24T23:27:25+08:00	4922	12858	17780	1641	19421	35311	55%	13.94%	32	32
15	高雄市美濃區	2018-11-24T23:19:59+08:00	4922	12858	17780	1641	19421	35311	55%	13.94%	32	32
15	高雄市美濃區	2018-11-25T00:00:17+08:00	4922	12858	17780	1641	19421	35311	55%	13.94%	32	32
15	高雄市美濃區	2018-11-25T01:07:33+08:00	4922	12858	17780	1641	19421	35311	55%	13.94%	32	32
15	高雄市美濃區	2018-11-24T23:31:19+08:00	4922	12858	17780	1641	19421	35311	55%	13.94%	32	32
15	高雄市美濃區	2018-11-24T23:12:24+08:00	4922	12858	17780	1641	19421	35311	55%	13.94%	32	32
15	高雄市美濃區	2018-11-24T23:39:24+08:00	4922	12858	17780	1641	19421	35311	55%	13.94%	32	32
15	高雄市美濃區	2018-11-24T23:01:38+08:00	4922	12858	17780	1641	19421	35311	55%	13.94%	32	32
15	高雄市美濃區	2018-11-24T23:35:17+08:00	4922	12858	17780	1641	19421	35311	55%	13.94%	32	32
15	高雄市美濃區	2018-11-25T04:02:59+08:00	4922	12858	17780	1641	19421	35311	55%	13.94%	32	32
15	高雄市美濃區	2018-11-25T00:14:17+08:00	4922	12858	17780	1641	19421	35311	55%	13.94%	32	32
15	高雄市美濃區	2018-11-24T23:43:23+08:00	4922	12858	17780	1641	19421	35311	55%	13.94%	32	32
15	高雄市美濃區	2018-11-25T03:49:58+08:00	4922	12858	17780	1641	19421	35311	55%	13.94%	32	32
15	高雄市美濃區	2018-11-24T23:05:11+08:00	4922	12858	17780	1641	19421	35311	55%	13.94%	32	32
15	高雄市美濃區	2018-11-25T06:13:59+08:00	4922	12858	17780	1641	19421	35311	55%	13.94%	32	32
15	高雄市美濃區	2018-11-24T22:41:43+08:00	4754	12442	17196	1610	18806	34059	55.22%	13.96%	31	32
15	高雄市美濃區	2018-11-25T06:19:04+08:00	4922	12858	17780	1641	19421	35311	55%	13.94%	32	32
15	高雄市美濃區	2018-11-25T06:29:24+08:00	4922	12858	17780	1641	19421	35311	55%	13.94%	32	32
15	高雄市美濃區	2018-11-25T06:24:07+08:00	4922	12858	17780	1641	19421	35311	55%	13.94%	32	32
15	高雄市美濃區	2018-11-24T22:30:17+08:00	4754	12442	17196	1610	18806	34059	55.22%	13.96%	31	32
15	高雄市美濃區	2018-11-24T23:51:42+08:00	4922	12858	17780	1641	19421	35311	55%	13.94%	32	32
15	高雄市美濃區	2018-11-24T23:23:45+08:00	4922	12858	17780	1641	19421	35311	55%	13.94%	32	32
15	高雄市美濃區	2018-11-24T23:08:44+08:00	4922	12858	17780	1641	19421	35311	55%	13.94%	32	32
15	高雄市美濃區	2018-11-24T22:23:21+08:00	4565	11946	16511	1581	18092	32621	55.46%	13.99%	30	32
15	高雄市美濃區	2018-11-25T03:32:44+08:00	4922	12858	17780	1641	19421	35311	55%	13.94%	32	32
15	高雄市美濃區	2018-11-24T22:13:37+08:00	4336	11349	15685	1532	17217	31072	55.41%	13.95%	29	32
15	高雄市美濃區	2018-11-25T00:23:11+08:00	4922	12858	17780	1641	19421	35311	55%	13.94%	32	32
15	高雄市美濃區	2018-11-25T01:26:00+08:00	4922	12858	17780	1641	19421	35311	55%	13.94%	32	32
15	高雄市美濃區	2018-11-24T23:47:36+08:00	4922	12858	17780	1641	19421	35311	55%	13.94%	32	32
15	高雄市美濃區	2018-11-25T03:39:01+08:00	4922	12858	17780	1641	19421	35311	55%	13.94%	32	32
15	高雄市美濃區	2018-11-24T22:33:45+08:00	4754	12442	17196	1610	18806	34059	55.22%	13.96%	31	32
15	高雄市美濃區	2018-11-24T22:16:18+08:00	4336	11349	15685	1532	17217	31072	55.41%	13.95%	29	32
15	臺中市北區	2018-11-25T03:56:17+08:00	23371	44261	67632	2943	70575	124621	56.63%	18.75%	87	87
15	臺中市北區	2018-11-24T23:16:06+08:00	17371	32584	49955	2195	52150	91433	57.04%	19%	66	87
15	臺中市北區	2018-11-25T06:29:21+08:00	23371	44261	67632	2943	70575	124621	56.63%	18.75%	87	87
15	臺中市北區	2018-11-25T03:49:55+08:00	23371	44261	67632	2943	70575	124621	56.63%	18.75%	87	87
15	臺中市北區	2018-11-25T06:19:01+08:00	23371	44261	67632	2943	70575	124621	56.63%	18.75%	87	87
15	臺中市北區	2018-11-24T22:45:12+08:00	14917	27881	42798	1851	44649	78150	57.13%	19.09%	57	87
15	臺中市北區	2018-11-24T23:43:21+08:00	19248	36162	55410	2408	57818	101280	57.09%	19%	73	87
15	臺中市北區	2018-11-24T22:41:40+08:00	14669	27262	41931	1831	43762	76646	57.1%	19.14%	56	87
15	臺中市北區	2018-11-25T01:25:57+08:00	23067	43671	66738	2897	69635	122743	56.73%	18.79%	86	87
15	臺中市北區	2018-11-24T22:30:13+08:00	12170	22413	34583	1485	36068	63345	56.94%	19.21%	48	87
15	臺中市北區	2018-11-25T06:24:04+08:00	23371	44261	67632	2943	70575	124621	56.63%	18.75%	87	87
15	臺中市北區	2018-11-25T00:23:07+08:00	21439	40338	61777	2713	64490	113263	56.94%	18.93%	80	87
15	臺中市北區	2018-11-25T03:32:39+08:00	23371	44261	67632	2943	70575	124621	56.63%	18.75%	87	87
15	臺中市北區	2018-11-24T23:51:39+08:00	19525	36766	56291	2468	58759	103073	57.01%	18.94%	74	87
15	臺中市北區	2018-11-24T23:27:22+08:00	17371	32584	49955	2195	52150	91433	57.04%	19%	66	87
15	臺中市北區	2018-11-24T22:13:32+08:00	10244	18663	28907	1240	30147	52866	57.03%	19.38%	40	87
15	臺中市北區	2018-11-25T01:17:57+08:00	22854	43013	65867	2882	68749	120982	56.83%	18.89%	85	87
15	臺中市北區	2018-11-24T23:08:40+08:00	16481	30920	47401	2089	49490	86755	57.05%	19%	63	87
15	臺中市北區	2018-11-24T22:57:58+08:00	15416	28856	44272	1932	46204	80786	57.19%	19.08%	59	87
15	臺中市北區	2018-11-24T23:19:56+08:00	17371	32584	49955	2195	52150	91433	57.04%	19%	66	87
15	臺中市北區	2018-11-24T22:54:29+08:00	15416	28856	44272	1932	46204	80786	57.19%	19.08%	59	87
15	臺中市北區	2018-11-25T04:02:56+08:00	23371	44261	67632	2943	70575	124621	56.63%	18.75%	87	87
15	臺中市北區	2018-11-25T06:08:58+08:00	23371	44261	67632	2943	70575	124621	56.63%	18.75%	87	87
15	臺中市北區	2018-11-24T22:16:15+08:00	11008	20210	31218	1369	32587	57063	57.11%	19.29%	43	87
15	臺中市北區	2018-11-24T23:31:16+08:00	17728	33116	50844	2223	53067	93102	57%	19.04%	67	87
15	臺中市北區	2018-11-25T01:12:48+08:00	22854	43013	65867	2882	68749	120982	56.83%	18.89%	85	87
15	臺中市北區	2018-11-24T23:05:08+08:00	16042	30067	46109	1998	48107	84288	57.07%	19.03%	61	87
15	臺中市北區	2018-11-24T23:47:32+08:00	19525	36766	56291	2468	58759	103073	57.01%	18.94%	74	87
15	臺中市北區	2018-11-25T00:05:09+08:00	20213	37999	58212	2554	60766	106558	57.03%	18.97%	76	87
15	臺中市北區	2018-11-24T22:37:04+08:00	14239	26450	40689	1784	42473	74475	57.03%	19.12%	54	87
15	臺中市北區	2018-11-24T22:50:52+08:00	15180	28317	43497	1886	45383	79383	57.17%	19.12%	58	87
15	臺中市北區	2018-11-25T06:13:56+08:00	23371	44261	67632	2943	70575	124621	56.63%	18.75%	87	87
15	臺中市北區	2018-11-24T22:26:40+08:00	11457	21028	32485	1417	33902	59432	57.04%	19.28%	45	87
15	臺中市北區	2018-11-25T00:18:35+08:00	21439	40338	61777	2713	64490	113263	56.94%	18.93%	80	87
15	臺中市北區	2018-11-24T22:40:31+08:00	14669	27262	41931	1831	43762	76646	57.1%	19.14%	56	87
15	臺中市北區	2018-11-25T01:02:35+08:00	22854	43013	65867	2882	68749	120982	56.83%	18.89%	85	87
15	臺中市北區	2018-11-25T00:57:41+08:00	22854	43013	65867	2882	68749	120982	56.83%	18.89%	85	87
15	臺中市北區	2018-11-24T22:19:40+08:00	11008	20210	31218	1369	32587	57063	57.11%	19.29%	43	87
15	臺中市北區	2018-11-25T03:38:58+08:00	23371	44261	67632	2943	70575	124621	56.63%	18.75%	87	87
15	臺中市北區	2018-11-25T03:44:28+08:00	23371	44261	67632	2943	70575	124621	56.63%	18.75%	87	87
15	臺中市北區	2018-11-24T23:23:42+08:00	17371	32584	49955	2195	52150	91433	57.04%	19%	66	87
15	臺中市北區	2018-11-24T22:23:18+08:00	11226	20626	31852	1386	33238	58282	57.03%	19.26%	44	87
15	臺中市北區	2018-11-24T23:55:51+08:00	19818	37322	57140	2507	59647	104626	57.01%	18.94%	75	87
15	臺中市北區	2018-11-25T00:00:14+08:00	19818	37322	57140	2507	59647	104626	57.01%	18.94%	75	87
15	臺中市北區	2018-11-24T23:39:21+08:00	18918	35531	54449	2376	56825	99549	57.08%	19%	72	87
15	臺中市北區	2018-11-25T01:07:30+08:00	22854	43013	65867	2882	68749	120982	56.83%	18.89%	85	87
15	臺中市北區	2018-11-25T00:09:38+08:00	20533	38577	59110	2593	61703	108118	57.07%	18.99%	77	87
15	臺中市北區	2018-11-24T23:35:14+08:00	18187	34168	52355	2282	54637	95783	57.04%	18.99%	69	87
15	臺中市北區	2018-11-25T00:14:14+08:00	21079	39711	60790	2680	63470	111396	56.98%	18.92%	79	87
15	臺中市北區	2018-11-24T23:01:35+08:00	15690	29434	45124	1950	47074	82496	57.06%	19.02%	60	87
15	臺中市北區	2018-11-24T23:12:19+08:00	16801	31458	48259	2124	50383	88362	57.02%	19.01%	64	87
15	臺中市北區	2018-11-24T22:33:42+08:00	13891	25785	39676	1733	41409	72593	57.04%	19.14%	53	87
15	臺中市后里區	2018-11-25T03:56:17+08:00	7622	16964	24586	1666	26252	44962	58.39%	16.95%	37	37
15	臺中市后里區	2018-11-25T06:29:21+08:00	7622	16964	24586	1666	26252	44962	58.39%	16.95%	37	37
15	臺中市后里區	2018-11-25T03:49:55+08:00	7622	16964	24586	1666	26252	44962	58.39%	16.95%	37	37
15	臺中市后里區	2018-11-25T06:19:01+08:00	7622	16964	24586	1666	26252	44962	58.39%	16.95%	37	37
15	臺中市后里區	2018-11-24T23:16:07+08:00	7622	16964	24586	1666	26252	44962	58.39%	16.95%	37	37
15	臺中市后里區	2018-11-24T22:45:12+08:00	7622	16964	24586	1666	26252	44962	58.39%	16.95%	37	37
15	臺中市后里區	2018-11-24T23:43:21+08:00	7622	16964	24586	1666	26252	44962	58.39%	16.95%	37	37
15	臺中市后里區	2018-11-24T22:41:40+08:00	7417	16502	23919	1595	25514	43737	58.34%	16.96%	36	37
15	臺中市后里區	2018-11-25T01:25:57+08:00	7622	16964	24586	1666	26252	44962	58.39%	16.95%	37	37
15	臺中市后里區	2018-11-24T22:30:14+08:00	6664	14695	21359	1436	22795	38945	58.53%	17.11%	33	37
15	臺中市后里區	2018-11-25T06:24:04+08:00	7622	16964	24586	1666	26252	44962	58.39%	16.95%	37	37
15	臺中市后里區	2018-11-25T00:23:08+08:00	7622	16964	24586	1666	26252	44962	58.39%	16.95%	37	37
15	臺中市后里區	2018-11-25T03:32:39+08:00	7622	16964	24586	1666	26252	44962	58.39%	16.95%	37	37
15	臺中市后里區	2018-11-24T23:51:39+08:00	7622	16964	24586	1666	26252	44962	58.39%	16.95%	37	37
15	臺中市后里區	2018-11-24T23:27:22+08:00	7622	16964	24586	1666	26252	44962	58.39%	16.95%	37	37
15	臺中市后里區	2018-11-24T22:13:32+08:00	5987	13132	19119	1311	20430	35081	58.24%	17.07%	30	37
15	臺中市后里區	2018-11-24T22:57:59+08:00	7622	16964	24586	1666	26252	44962	58.39%	16.95%	37	37
15	臺中市后里區	2018-11-24T23:08:41+08:00	7622	16964	24586	1666	26252	44962	58.39%	16.95%	37	37
15	臺中市后里區	2018-11-24T23:19:56+08:00	7622	16964	24586	1666	26252	44962	58.39%	16.95%	37	37
15	臺中市后里區	2018-11-25T01:17:58+08:00	7622	16964	24586	1666	26252	44962	58.39%	16.95%	37	37
15	臺中市后里區	2018-11-24T22:54:29+08:00	7622	16964	24586	1666	26252	44962	58.39%	16.95%	37	37
15	臺中市后里區	2018-11-24T23:47:33+08:00	7622	16964	24586	1666	26252	44962	58.39%	16.95%	37	37
15	臺中市后里區	2018-11-25T04:02:56+08:00	7622	16964	24586	1666	26252	44962	58.39%	16.95%	37	37
15	臺中市后里區	2018-11-25T06:08:58+08:00	7622	16964	24586	1666	26252	44962	58.39%	16.95%	37	37
15	臺中市后里區	2018-11-24T22:16:15+08:00	6222	13637	19859	1354	21213	36259	58.5%	17.16%	31	37
15	臺中市后里區	2018-11-24T23:31:16+08:00	7622	16964	24586	1666	26252	44962	58.39%	16.95%	37	37
15	臺中市后里區	2018-11-25T01:12:48+08:00	7622	16964	24586	1666	26252	44962	58.39%	16.95%	37	37
15	臺中市后里區	2018-11-24T23:05:08+08:00	7622	16964	24586	1666	26252	44962	58.39%	16.95%	37	37
15	臺中市后里區	2018-11-25T00:05:09+08:00	7622	16964	24586	1666	26252	44962	58.39%	16.95%	37	37
15	臺中市后里區	2018-11-24T22:37:04+08:00	6953	15366	22319	1502	23821	40614	58.65%	17.12%	34	37
15	臺中市后里區	2018-11-25T06:13:56+08:00	7622	16964	24586	1666	26252	44962	58.39%	16.95%	37	37
15	臺中市后里區	2018-11-24T22:26:40+08:00	6664	14695	21359	1436	22795	38945	58.53%	17.11%	33	37
15	臺中市后里區	2018-11-24T22:50:53+08:00	7622	16964	24586	1666	26252	44962	58.39%	16.95%	37	37
15	臺中市后里區	2018-11-25T00:18:35+08:00	7622	16964	24586	1666	26252	44962	58.39%	16.95%	37	37
15	臺中市后里區	2018-11-24T22:19:41+08:00	6384	14095	20479	1390	21869	37354	58.55%	17.09%	32	37
15	臺中市后里區	2018-11-25T03:38:59+08:00	7622	16964	24586	1666	26252	44962	58.39%	16.95%	37	37
15	臺中市后里區	2018-11-24T22:40:31+08:00	7417	16502	23919	1595	25514	43737	58.34%	16.96%	36	37
15	臺中市后里區	2018-11-25T01:02:35+08:00	7622	16964	24586	1666	26252	44962	58.39%	16.95%	37	37
15	臺中市后里區	2018-11-25T00:57:41+08:00	7622	16964	24586	1666	26252	44962	58.39%	16.95%	37	37
15	臺中市后里區	2018-11-25T03:44:28+08:00	7622	16964	24586	1666	26252	44962	58.39%	16.95%	37	37
15	臺中市后里區	2018-11-24T23:23:42+08:00	7622	16964	24586	1666	26252	44962	58.39%	16.95%	37	37
15	臺中市后里區	2018-11-24T22:23:18+08:00	6664	14695	21359	1436	22795	38945	58.53%	17.11%	33	37
15	臺中市后里區	2018-11-25T00:00:15+08:00	7622	16964	24586	1666	26252	44962	58.39%	16.95%	37	37
15	臺中市后里區	2018-11-24T23:55:51+08:00	7622	16964	24586	1666	26252	44962	58.39%	16.95%	37	37
15	臺中市后里區	2018-11-24T23:39:21+08:00	7622	16964	24586	1666	26252	44962	58.39%	16.95%	37	37
15	臺中市后里區	2018-11-25T01:07:30+08:00	7622	16964	24586	1666	26252	44962	58.39%	16.95%	37	37
15	臺中市后里區	2018-11-24T23:12:20+08:00	7622	16964	24586	1666	26252	44962	58.39%	16.95%	37	37
15	臺中市后里區	2018-11-24T23:35:14+08:00	7622	16964	24586	1666	26252	44962	58.39%	16.95%	37	37
15	臺中市后里區	2018-11-25T00:14:14+08:00	7622	16964	24586	1666	26252	44962	58.39%	16.95%	37	37
15	臺中市后里區	2018-11-24T23:01:35+08:00	7622	16964	24586	1666	26252	44962	58.39%	16.95%	37	37
15	臺中市后里區	2018-11-25T00:09:39+08:00	7622	16964	24586	1666	26252	44962	58.39%	16.95%	37	37
15	臺中市后里區	2018-11-24T22:33:42+08:00	6664	14695	21359	1436	22795	38945	58.53%	17.11%	33	37
15	臺北市萬華區	2018-11-25T06:29:19+08:00	33238	52945	86183	5302	91485	164020	55.78%	20.26%	117	117
15	臺北市萬華區	2018-11-25T01:07:28+08:00	33238	52945	86183	5302	91485	164020	55.78%	20.26%	117	117
15	臺北市萬華區	2018-11-25T06:13:55+08:00	33238	52945	86183	5302	91485	164020	55.78%	20.26%	117	117
15	臺北市萬華區	2018-11-24T22:50:51+08:00	25741	40945	66686	4159	70845	126817	55.86%	20.3%	92	117
15	臺北市萬華區	2018-11-25T06:19:00+08:00	33238	52945	86183	5302	91485	164020	55.78%	20.26%	117	117
15	臺北市萬華區	2018-11-25T03:49:53+08:00	33238	52945	86183	5302	91485	164020	55.78%	20.26%	117	117
15	臺北市萬華區	2018-11-25T06:29:20+08:00	33238	52945	86183	5302	91485	164020	55.78%	20.26%	117	117
15	臺北市萬華區	2018-11-25T03:49:54+08:00	33238	52945	86183	5302	91485	164020	55.78%	20.26%	117	117
15	臺北市萬華區	2018-11-24T22:50:50+08:00	25741	40945	66686	4159	70845	126817	55.86%	20.3%	92	117
15	臺北市萬華區	2018-11-25T06:13:54+08:00	33238	52945	86183	5302	91485	164020	55.78%	20.26%	117	117
15	臺北市萬華區	2018-11-25T01:07:29+08:00	33238	52945	86183	5302	91485	164020	55.78%	20.26%	117	117
15	臺北市萬華區	2018-11-24T23:43:19+08:00	30589	48929	79518	4883	84401	150851	55.95%	20.28%	108	117
15	臺北市萬華區	2018-11-24T22:13:29+08:00	20845	33068	53913	3431	57344	102694	55.84%	20.3%	75	117
15	臺北市萬華區	2018-11-25T06:24:03+08:00	33238	52945	86183	5302	91485	164020	55.78%	20.26%	117	117
15	臺北市萬華區	2018-11-24T23:08:39+08:00	28326	44847	73173	4565	77738	139152	55.87%	20.36%	100	117
15	臺北市萬華區	2018-11-25T00:23:06+08:00	32959	52500	85459	5248	90707	162626	55.78%	20.27%	116	117
15	臺北市萬華區	2018-11-24T22:30:12+08:00	22890	36386	59276	3755	63031	112734	55.91%	20.3%	82	117
15	臺北市萬華區	2018-11-24T23:55:49+08:00	31648	50646	82294	5078	87372	156293	55.9%	20.25%	112	117
15	臺北市萬華區	2018-11-25T03:32:37+08:00	33238	52945	86183	5302	91485	164020	55.78%	20.26%	117	117
15	臺北市萬華區	2018-11-25T06:24:02+08:00	33238	52945	86183	5302	91485	164020	55.78%	20.26%	117	117
15	臺北市萬華區	2018-11-24T23:51:37+08:00	31648	50646	82294	5078	87372	156293	55.9%	20.25%	112	117
15	臺北市萬華區	2018-11-24T23:23:41+08:00	30296	48476	78772	4841	83613	149574	55.9%	20.25%	107	117
15	臺北市萬華區	2018-11-24T22:40:29+08:00	24884	39667	64551	4027	68578	122725	55.88%	20.28%	89	117
15	臺北市萬華區	2018-11-24T22:57:57+08:00	27793	43971	71764	4468	76232	136490	55.85%	20.36%	98	117
15	臺北市萬華區	2018-11-24T23:51:38+08:00	31648	50646	82294	5078	87372	156293	55.9%	20.25%	112	117
15	臺北市萬華區	2018-11-25T06:18:59+08:00	33238	52945	86183	5302	91485	164020	55.78%	20.26%	117	117
15	臺北市萬華區	2018-11-25T01:17:56+08:00	33238	52945	86183	5302	91485	164020	55.78%	20.26%	117	117
15	臺北市萬華區	2018-11-24T23:23:40+08:00	30296	48476	78772	4841	83613	149574	55.9%	20.25%	107	117
15	臺北市萬華區	2018-11-24T22:33:40+08:00	23483	37355	60838	3815	64653	115592	55.93%	20.32%	84	117
15	臺北市萬華區	2018-11-24T22:16:13+08:00	21718	34391	56109	3590	59699	106795	55.9%	20.34%	78	117
15	臺北市萬華區	2018-11-25T00:14:11+08:00	32294	51515	83809	5157	88966	159283	55.85%	20.27%	114	117
15	臺北市萬華區	2018-11-24T23:05:07+08:00	28077	44466	72543	4528	77071	137910	55.88%	20.36%	99	117
15	臺北市萬華區	2018-11-24T22:41:38+08:00	24884	39667	64551	4027	68578	122725	55.88%	20.28%	89	117
15	臺北市萬華區	2018-11-24T22:54:28+08:00	26800	42502	69302	4292	73594	131540	55.95%	20.37%	95	117
15	臺北市萬華區	2018-11-25T01:12:46+08:00	33238	52945	86183	5302	91485	164020	55.78%	20.26%	117	117
15	臺北市萬華區	2018-11-25T06:08:56+08:00	33238	52945	86183	5302	91485	164020	55.78%	20.26%	117	117
15	臺北市萬華區	2018-11-24T22:41:37+08:00	24884	39667	64551	4027	68578	122725	55.88%	20.28%	89	117
15	臺北市萬華區	2018-11-25T00:05:07+08:00	32294	51515	83809	5157	88966	159283	55.85%	20.27%	114	117
15	臺北市萬華區	2018-11-24T23:05:06+08:00	28077	44466	72543	4528	77071	137910	55.88%	20.36%	99	117
15	臺北市萬華區	2018-11-25T00:18:33+08:00	32633	52021	84654	5185	89839	161029	55.79%	20.27%	115	117
15	臺北市萬華區	2018-11-24T22:37:03+08:00	24291	38604	62895	3964	66859	119876	55.77%	20.26%	87	117
15	臺北市萬華區	2018-11-24T22:45:10+08:00	25417	40472	65889	4105	69994	125364	55.83%	20.27%	91	117
15	臺北市萬華區	2018-11-24T23:16:05+08:00	29726	47478	77204	4759	81963	146764	55.85%	20.25%	105	117
15	臺北市萬華區	2018-11-24T22:45:11+08:00	25417	40472	65889	4105	69994	125364	55.83%	20.27%	91	117
15	臺北市萬華區	2018-11-25T03:56:15+08:00	33238	52945	86183	5302	91485	164020	55.78%	20.26%	117	117
15	臺北市萬華區	2018-11-25T03:38:57+08:00	33238	52945	86183	5302	91485	164020	55.78%	20.26%	117	117
15	臺北市萬華區	2018-11-25T03:44:26+08:00	33238	52945	86183	5302	91485	164020	55.78%	20.26%	117	117
15	臺北市萬華區	2018-11-24T22:30:11+08:00	22890	36386	59276	3755	63031	112734	55.91%	20.3%	82	117
15	臺北市萬華區	2018-11-25T01:02:33+08:00	33238	52945	86183	5302	91485	164020	55.78%	20.26%	117	117
15	臺北市萬華區	2018-11-24T22:40:30+08:00	24884	39667	64551	4027	68578	122725	55.88%	20.28%	89	117
15	臺北市萬華區	2018-11-25T01:25:55+08:00	33238	52945	86183	5302	91485	164020	55.78%	20.26%	117	117
15	臺北市萬華區	2018-11-24T22:23:16+08:00	21718	34391	56109	3590	59699	106795	55.9%	20.34%	78	117
15	臺北市萬華區	2018-11-24T23:19:54+08:00	29726	47478	77204	4759	81963	146764	55.85%	20.25%	105	117
15	臺北市萬華區	2018-11-25T00:57:39+08:00	33238	52945	86183	5302	91485	164020	55.78%	20.26%	117	117
15	臺北市萬華區	2018-11-24T23:27:21+08:00	30296	48476	78772	4841	83613	149574	55.9%	20.25%	107	117
15	臺北市萬華區	2018-11-25T01:17:55+08:00	33238	52945	86183	5302	91485	164020	55.78%	20.26%	117	117
15	臺北市萬華區	2018-11-24T22:19:39+08:00	21718	34391	56109	3590	59699	106795	55.9%	20.34%	78	117
15	臺北市萬華區	2018-11-24T23:27:20+08:00	30296	48476	78772	4841	83613	149574	55.9%	20.25%	107	117
15	臺北市萬華區	2018-11-24T22:13:30+08:00	20845	33068	53913	3431	57344	102694	55.84%	20.3%	75	117
15	臺北市萬華區	2018-11-25T00:00:13+08:00	31934	51094	83028	5107	88135	157888	55.82%	20.23%	113	117
15	臺北市萬華區	2018-11-25T00:14:12+08:00	32294	51515	83809	5157	88966	159283	55.85%	20.27%	114	117
15	臺北市萬華區	2018-11-25T04:02:55+08:00	33238	52945	86183	5302	91485	164020	55.78%	20.26%	117	117
15	臺北市萬華區	2018-11-24T23:39:19+08:00	30589	48929	79518	4883	84401	150851	55.95%	20.28%	108	117
15	臺北市萬華區	2018-11-24T22:26:39+08:00	22320	35414	57734	3657	61391	109759	55.93%	20.34%	80	117
15	臺北市萬華區	2018-11-24T23:12:18+08:00	28873	45949	74822	4651	79473	142306	55.85%	20.29%	102	117
15	臺北市萬華區	2018-11-24T23:31:14+08:00	30589	48929	79518	4883	84401	150851	55.95%	20.28%	108	117
15	臺北市萬華區	2018-11-24T23:01:33+08:00	27793	43971	71764	4468	76232	136490	55.85%	20.36%	98	117
15	臺北市萬華區	2018-11-24T23:01:34+08:00	27793	43971	71764	4468	76232	136490	55.85%	20.36%	98	117
15	臺北市萬華區	2018-11-24T23:47:31+08:00	30861	49339	80200	4934	85134	152218	55.93%	20.27%	109	117
15	臺北市萬華區	2018-11-24T23:35:13+08:00	30589	48929	79518	4883	84401	150851	55.95%	20.28%	108	117
15	臺北市萬華區	2018-11-25T04:02:54+08:00	33238	52945	86183	5302	91485	164020	55.78%	20.26%	117	117
15	臺北市萬華區	2018-11-25T00:09:37+08:00	32294	51515	83809	5157	88966	159283	55.85%	20.27%	114	117
15	基隆市中正區	2018-11-24T23:12:31+08:00	5173	9439	14612	1004	15616	32378	48.23%	15.98%	28	35
15	基隆市中正區	2018-11-24T23:47:44+08:00	5716	10587	16303	1166	17469	36131	48.35%	15.82%	31	35
15	基隆市中正區	2018-11-24T22:58:09+08:00	5173	9439	14612	1004	15616	32378	48.23%	15.98%	28	35
15	基隆市中正區	2018-11-25T03:56:29+08:00	6983	13181	20164	1324	21488	45545	47.18%	15.33%	35	35
15	基隆市中正區	2018-11-24T23:01:46+08:00	5173	9439	14612	1004	15616	32378	48.23%	15.98%	28	35
15	基隆市中正區	2018-11-25T03:32:53+08:00	6983	13181	20164	1324	21488	45545	47.18%	15.33%	35	35
15	基隆市中正區	2018-11-24T23:08:52+08:00	5173	9439	14612	1004	15616	32378	48.23%	15.98%	28	35
15	基隆市中正區	2018-11-24T23:51:49+08:00	5716	10587	16303	1166	17469	36131	48.35%	15.82%	31	35
15	基隆市中正區	2018-11-24T22:13:45+08:00	3788	7289	11077	795	11872	24457	48.54%	15.49%	22	35
15	基隆市中正區	2018-11-25T03:44:41+08:00	6983	13181	20164	1324	21488	45545	47.18%	15.33%	35	35
15	基隆市中正區	2018-11-25T04:03:06+08:00	6983	13181	20164	1324	21488	45545	47.18%	15.33%	35	35
15	基隆市中正區	2018-11-24T23:27:31+08:00	5514	10115	15629	1090	16719	34586	48.34%	15.94%	30	35
15	基隆市中正區	2018-11-24T22:30:24+08:00	4523	8650	13173	907	14080	29212	48.2%	15.48%	26	35
15	基隆市中正區	2018-11-24T22:19:50+08:00	3963	7630	11593	819	12412	25719	48.26%	15.41%	23	35
15	基隆市中正區	2018-11-25T06:14:06+08:00	6983	13181	20164	1324	21488	45545	47.18%	15.33%	35	35
15	基隆市中正區	2018-11-24T23:20:09+08:00	5173	9439	14612	1004	15616	32378	48.23%	15.98%	28	35
15	基隆市中正區	2018-11-24T23:31:28+08:00	5514	10115	15629	1090	16719	34586	48.34%	15.94%	30	35
15	基隆市中正區	2018-11-24T22:37:14+08:00	4707	9108	13815	922	14737	30625	48.12%	15.37%	27	35
15	基隆市中正區	2018-11-25T00:18:48+08:00	6408	12054	18462	1220	19682	41619	47.29%	15.4%	33	35
15	基隆市中正區	2018-11-25T06:29:32+08:00	6983	13181	20164	1324	21488	45545	47.18%	15.33%	35	35
15	基隆市中正區	2018-11-25T00:09:51+08:00	6048	11298	17346	1184	18530	38954	47.57%	15.53%	32	35
15	基隆市中正區	2018-11-24T22:45:21+08:00	4707	9108	13815	922	14737	30625	48.12%	15.37%	27	35
15	基隆市中正區	2018-11-24T22:54:38+08:00	5173	9439	14612	1004	15616	32378	48.23%	15.98%	28	35
15	基隆市中正區	2018-11-24T22:33:51+08:00	4707	9108	13815	922	14737	30625	48.12%	15.37%	27	35
15	基隆市中正區	2018-11-24T23:39:33+08:00	5716	10587	16303	1166	17469	36131	48.35%	15.82%	31	35
15	基隆市中正區	2018-11-24T22:26:49+08:00	4523	8650	13173	907	14080	29212	48.2%	15.48%	26	35
15	基隆市中正區	2018-11-25T01:12:59+08:00	6983	13181	20164	1324	21488	45545	47.18%	15.33%	35	35
15	基隆市中正區	2018-11-25T00:05:18+08:00	6048	11298	17346	1184	18530	38954	47.57%	15.53%	32	35
15	基隆市中正區	2018-11-25T01:07:41+08:00	6983	13181	20164	1324	21488	45545	47.18%	15.33%	35	35
15	基隆市中正區	2018-11-24T23:05:17+08:00	5173	9439	14612	1004	15616	32378	48.23%	15.98%	28	35
15	基隆市中正區	2018-11-24T23:56:02+08:00	5716	10587	16303	1166	17469	36131	48.35%	15.82%	31	35
15	基隆市中正區	2018-11-24T23:23:51+08:00	5333	9794	15127	1045	16172	33549	48.2%	15.9%	29	35
15	基隆市中正區	2018-11-24T22:23:29+08:00	4523	8650	13173	907	14080	29212	48.2%	15.48%	26	35
15	基隆市中正區	2018-11-25T00:00:24+08:00	5716	10587	16303	1166	17469	36131	48.35%	15.82%	31	35
15	基隆市中正區	2018-11-25T01:02:45+08:00	6983	13181	20164	1324	21488	45545	47.18%	15.33%	35	35
15	基隆市中正區	2018-11-24T22:40:41+08:00	4707	9108	13815	922	14737	30625	48.12%	15.37%	27	35
15	基隆市中正區	2018-11-25T00:57:52+08:00	6983	13181	20164	1324	21488	45545	47.18%	15.33%	35	35
15	基隆市中正區	2018-11-24T22:51:04+08:00	4707	9108	13815	922	14737	30625	48.12%	15.37%	27	35
15	基隆市中正區	2018-11-25T06:09:10+08:00	6983	13181	20164	1324	21488	45545	47.18%	15.33%	35	35
15	基隆市中正區	2018-11-25T06:24:14+08:00	6983	13181	20164	1324	21488	45545	47.18%	15.33%	35	35
15	基隆市中正區	2018-11-25T00:23:18+08:00	6408	12054	18462	1220	19682	41619	47.29%	15.4%	33	35
15	基隆市中正區	2018-11-24T23:35:23+08:00	5514	10115	15629	1090	16719	34586	48.34%	15.94%	30	35
15	基隆市中正區	2018-11-25T00:14:24+08:00	6048	11298	17346	1184	18530	38954	47.57%	15.53%	32	35
15	基隆市中正區	2018-11-25T01:26:09+08:00	6983	13181	20164	1324	21488	45545	47.18%	15.33%	35	35
15	基隆市中正區	2018-11-25T03:50:04+08:00	6983	13181	20164	1324	21488	45545	47.18%	15.33%	35	35
15	基隆市中正區	2018-11-24T22:16:26+08:00	3963	7630	11593	819	12412	25719	48.26%	15.41%	23	35
15	基隆市中正區	2018-11-24T23:43:31+08:00	5716	10587	16303	1166	17469	36131	48.35%	15.82%	31	35
15	基隆市中正區	2018-11-25T01:18:11+08:00	6983	13181	20164	1324	21488	45545	47.18%	15.33%	35	35
15	基隆市中正區	2018-11-24T23:16:16+08:00	5173	9439	14612	1004	15616	32378	48.23%	15.98%	28	35
15	基隆市中正區	2018-11-25T06:19:11+08:00	6983	13181	20164	1324	21488	45545	47.18%	15.33%	35	35
15	基隆市中正區	2018-11-24T22:41:51+08:00	4707	9108	13815	922	14737	30625	48.12%	15.37%	27	35
15	基隆市中正區	2018-11-25T03:39:08+08:00	6983	13181	20164	1324	21488	45545	47.18%	15.33%	35	35
15	新竹縣尖石鄉	2018-11-24T22:26:43+08:00	310	1190	1500	94	1594	3165	50.36%	9.79%	8	15
15	新竹縣尖石鄉	2018-11-25T03:56:21+08:00	710	2826	3536	217	3753	7364	50.96%	9.64%	15	15
15	新竹縣尖石鄉	2018-11-25T01:12:52+08:00	710	2826	3536	217	3753	7364	50.96%	9.64%	15	15
15	新竹縣尖石鄉	2018-11-24T22:54:32+08:00	501	1873	2374	147	2521	5118	49.26%	9.79%	11	15
15	新竹縣尖石鄉	2018-11-24T22:50:56+08:00	501	1873	2374	147	2521	5118	49.26%	9.79%	11	15
15	新竹縣尖石鄉	2018-11-25T00:09:43+08:00	710	2826	3536	217	3753	7364	50.96%	9.64%	15	15
15	新竹縣尖石鄉	2018-11-25T00:05:12+08:00	710	2826	3536	217	3753	7364	50.96%	9.64%	15	15
15	新竹縣尖石鄉	2018-11-24T22:37:08+08:00	388	1395	1783	123	1906	3950	48.25%	9.82%	9	15
15	新竹縣尖石鄉	2018-11-24T22:45:15+08:00	460	1613	2073	127	2200	4543	48.43%	10.13%	10	15
15	新竹縣尖石鄉	2018-11-25T01:02:38+08:00	710	2826	3536	217	3753	7364	50.96%	9.64%	15	15
15	新竹縣尖石鄉	2018-11-24T22:40:34+08:00	388	1395	1783	123	1906	3950	48.25%	9.82%	9	15
15	新竹縣尖石鄉	2018-11-25T04:03:00+08:00	710	2826	3536	217	3753	7364	50.96%	9.64%	15	15
15	新竹縣尖石鄉	2018-11-25T00:57:45+08:00	710	2826	3536	217	3753	7364	50.96%	9.64%	15	15
15	新竹縣尖石鄉	2018-11-24T22:19:44+08:00	310	1190	1500	94	1594	3165	50.36%	9.79%	8	15
15	新竹縣尖石鄉	2018-11-25T06:14:00+08:00	710	2826	3536	217	3753	7364	50.96%	9.64%	15	15
15	新竹縣尖石鄉	2018-11-25T00:00:18+08:00	657	2531	3188	205	3393	6704	50.61%	9.8%	14	15
15	新竹縣尖石鄉	2018-11-24T23:55:54+08:00	657	2531	3188	205	3393	6704	50.61%	9.8%	14	15
15	新竹縣尖石鄉	2018-11-24T23:27:25+08:00	617	2343	2960	202	3162	6205	50.96%	9.94%	13	15
15	新竹縣尖石鄉	2018-11-24T22:23:22+08:00	310	1190	1500	94	1594	3165	50.36%	9.79%	8	15
15	新竹縣尖石鄉	2018-11-24T23:01:39+08:00	501	1873	2374	147	2521	5118	49.26%	9.79%	11	15
15	新竹縣尖石鄉	2018-11-24T23:39:25+08:00	657	2531	3188	205	3393	6704	50.61%	9.8%	14	15
15	新竹縣尖石鄉	2018-11-24T23:20:00+08:00	553	2039	2592	154	2746	5592	49.11%	9.89%	12	15
15	新竹縣尖石鄉	2018-11-25T01:07:34+08:00	710	2826	3536	217	3753	7364	50.96%	9.64%	15	15
15	新竹縣尖石鄉	2018-11-24T23:12:24+08:00	553	2039	2592	154	2746	5592	49.11%	9.89%	12	15
15	新竹縣尖石鄉	2018-11-25T00:18:40+08:00	710	2826	3536	217	3753	7364	50.96%	9.64%	15	15
15	新竹縣尖石鄉	2018-11-25T03:39:02+08:00	710	2826	3536	217	3753	7364	50.96%	9.64%	15	15
15	新竹縣尖石鄉	2018-11-24T23:31:20+08:00	657	2531	3188	205	3393	6704	50.61%	9.8%	14	15
15	新竹縣尖石鄉	2018-11-24T23:35:17+08:00	657	2531	3188	205	3393	6704	50.61%	9.8%	14	15
15	新竹縣尖石鄉	2018-11-25T00:14:17+08:00	710	2826	3536	217	3753	7364	50.96%	9.64%	15	15
15	新竹縣尖石鄉	2018-11-24T23:43:24+08:00	657	2531	3188	205	3393	6704	50.61%	9.8%	14	15
15	新竹縣尖石鄉	2018-11-24T22:58:02+08:00	501	1873	2374	147	2521	5118	49.26%	9.79%	11	15
15	新竹縣尖石鄉	2018-11-25T03:49:58+08:00	710	2826	3536	217	3753	7364	50.96%	9.64%	15	15
15	新竹縣尖石鄉	2018-11-25T01:18:02+08:00	710	2826	3536	217	3753	7364	50.96%	9.64%	15	15
15	新竹縣尖石鄉	2018-11-25T06:29:25+08:00	710	2826	3536	217	3753	7364	50.96%	9.64%	15	15
15	新竹縣尖石鄉	2018-11-25T06:19:05+08:00	710	2826	3536	217	3753	7364	50.96%	9.64%	15	15
15	新竹縣尖石鄉	2018-11-24T23:05:11+08:00	553	2039	2592	154	2746	5592	49.11%	9.89%	12	15
15	新竹縣尖石鄉	2018-11-24T22:41:44+08:00	388	1395	1783	123	1906	3950	48.25%	9.82%	9	15
15	新竹縣尖石鄉	2018-11-24T23:51:43+08:00	657	2531	3188	205	3393	6704	50.61%	9.8%	14	15
15	新竹縣尖石鄉	2018-11-24T22:30:17+08:00	310	1190	1500	94	1594	3165	50.36%	9.79%	8	15
15	新竹縣尖石鄉	2018-11-25T06:24:08+08:00	710	2826	3536	217	3753	7364	50.96%	9.64%	15	15
15	新竹縣尖石鄉	2018-11-25T06:09:02+08:00	710	2826	3536	217	3753	7364	50.96%	9.64%	15	15
15	新竹縣尖石鄉	2018-11-24T23:23:45+08:00	553	2039	2592	154	2746	5592	49.11%	9.89%	12	15
15	新竹縣尖石鄉	2018-11-25T03:44:32+08:00	710	2826	3536	217	3753	7364	50.96%	9.64%	15	15
15	新竹縣尖石鄉	2018-11-25T03:32:45+08:00	710	2826	3536	217	3753	7364	50.96%	9.64%	15	15
15	新竹縣尖石鄉	2018-11-24T22:13:38+08:00	244	937	1181	77	1258	2392	52.59%	10.2%	7	15
15	新竹縣尖石鄉	2018-11-24T23:08:45+08:00	553	2039	2592	154	2746	5592	49.11%	9.89%	12	15
15	新竹縣尖石鄉	2018-11-25T00:23:11+08:00	710	2826	3536	217	3753	7364	50.96%	9.64%	15	15
15	新竹縣尖石鄉	2018-11-24T23:16:10+08:00	553	2039	2592	154	2746	5592	49.11%	9.89%	12	15
15	新竹縣尖石鄉	2018-11-24T23:47:37+08:00	657	2531	3188	205	3393	6704	50.61%	9.8%	14	15
15	新竹縣尖石鄉	2018-11-24T22:16:19+08:00	310	1190	1500	94	1594	3165	50.36%	9.79%	8	15
15	新竹縣尖石鄉	2018-11-25T01:26:01+08:00	710	2826	3536	217	3753	7364	50.96%	9.64%	15	15
15	新竹縣尖石鄉	2018-11-24T22:33:45+08:00	388	1395	1783	123	1906	3950	48.25%	9.82%	9	15
15	新竹縣竹東鎮	2018-11-24T22:26:43+08:00	6114	14029	20143	998	21141	39208	53.92%	15.59%	40	72
15	新竹縣竹東鎮	2018-11-25T00:09:42+08:00	11829	26533	38362	1872	40234	74681	53.87%	15.84%	69	72
15	新竹縣竹東鎮	2018-11-25T03:56:21+08:00	12563	28093	40656	1955	42611	78794	54.08%	15.94%	72	72
15	新竹縣竹東鎮	2018-11-25T01:12:52+08:00	12306	27511	39817	1923	41740	77246	54.04%	15.93%	71	72
15	新竹縣竹東鎮	2018-11-24T22:37:07+08:00	6949	16068	23017	1162	24179	44789	53.98%	15.51%	45	72
15	新竹縣竹東鎮	2018-11-24T22:54:32+08:00	8701	19786	28487	1407	29894	55330	54.03%	15.73%	53	72
15	新竹縣竹東鎮	2018-11-24T22:50:56+08:00	8329	18850	27179	1347	28526	52967	53.86%	15.72%	51	72
15	新竹縣竹東鎮	2018-11-25T00:05:12+08:00	11435	25731	37166	1825	38991	72270	53.95%	15.82%	67	72
15	新竹縣竹東鎮	2018-11-24T22:45:15+08:00	7946	17886	25832	1290	27122	50392	53.82%	15.77%	49	72
15	新竹縣竹東鎮	2018-11-25T01:02:38+08:00	12306	27511	39817	1923	41740	77246	54.04%	15.93%	71	72
15	新竹縣竹東鎮	2018-11-25T00:57:44+08:00	12306	27511	39817	1923	41740	77246	54.04%	15.93%	71	72
15	新竹縣竹東鎮	2018-11-24T22:40:34+08:00	7522	16909	24431	1208	25639	47654	53.8%	15.78%	47	72
15	新竹縣竹東鎮	2018-11-24T22:19:44+08:00	5579	12863	18442	919	19361	36076	53.67%	15.46%	37	72
15	新竹縣竹東鎮	2018-11-25T00:00:18+08:00	11435	25731	37166	1825	38991	72270	53.95%	15.82%	67	72
15	新竹縣竹東鎮	2018-11-24T23:55:54+08:00	11435	25731	37166	1825	38991	72270	53.95%	15.82%	67	72
15	新竹縣竹東鎮	2018-11-24T23:27:25+08:00	10400	23566	33966	1676	35642	66099	53.92%	15.73%	62	72
15	新竹縣竹東鎮	2018-11-24T23:19:59+08:00	10196	23131	33327	1655	34982	64854	53.94%	15.72%	61	72
15	新竹縣竹東鎮	2018-11-24T22:23:22+08:00	5915	13564	19479	968	20447	37993	53.82%	15.57%	39	72
15	新竹縣竹東鎮	2018-11-25T01:07:33+08:00	12306	27511	39817	1923	41740	77246	54.04%	15.93%	71	72
15	新竹縣竹東鎮	2018-11-24T23:39:25+08:00	11101	24966	36067	1770	37837	70255	53.86%	15.8%	65	72
15	新竹縣竹東鎮	2018-11-24T23:12:24+08:00	9843	22369	32212	1602	33814	62628	53.99%	15.72%	59	72
15	新竹縣竹東鎮	2018-11-25T00:18:40+08:00	11829	26533	38362	1872	40234	74681	53.87%	15.84%	69	72
15	新竹縣竹東鎮	2018-11-24T23:01:38+08:00	9443	21402	30845	1543	32388	60049	53.94%	15.73%	57	72
15	新竹縣竹東鎮	2018-11-24T23:31:20+08:00	10581	23983	34564	1702	36266	67345	53.85%	15.71%	63	72
15	新竹縣竹東鎮	2018-11-24T23:35:17+08:00	10581	23983	34564	1702	36266	67345	53.85%	15.71%	63	72
15	新竹縣竹東鎮	2018-11-25T04:02:59+08:00	12563	28093	40656	1955	42611	78794	54.08%	15.94%	72	72
15	新竹縣竹東鎮	2018-11-25T00:14:17+08:00	11829	26533	38362	1872	40234	74681	53.87%	15.84%	69	72
15	新竹縣竹東鎮	2018-11-24T23:43:24+08:00	11285	25376	36661	1804	38465	71395	53.88%	15.81%	66	72
15	新竹縣竹東鎮	2018-11-24T22:58:02+08:00	9066	20550	29616	1477	31093	57505	54.07%	15.77%	55	72
15	新竹縣竹東鎮	2018-11-25T03:49:58+08:00	12563	28093	40656	1955	42611	78794	54.08%	15.94%	72	72
15	新竹縣竹東鎮	2018-11-25T01:18:02+08:00	12306	27511	39817	1923	41740	77246	54.04%	15.93%	71	72
15	新竹縣竹東鎮	2018-11-25T06:29:25+08:00	12563	28093	40656	1955	42611	78794	54.08%	15.94%	72	72
15	新竹縣竹東鎮	2018-11-24T23:05:11+08:00	9443	21402	30845	1543	32388	60049	53.94%	15.73%	57	72
15	新竹縣竹東鎮	2018-11-25T06:13:59+08:00	12563	28093	40656	1955	42611	78794	54.08%	15.94%	72	72
15	新竹縣竹東鎮	2018-11-24T22:41:44+08:00	7522	16909	24431	1208	25639	47654	53.8%	15.78%	47	72
15	新竹縣竹東鎮	2018-11-25T06:19:04+08:00	12563	28093	40656	1955	42611	78794	54.08%	15.94%	72	72
15	新竹縣竹東鎮	2018-11-25T06:24:07+08:00	12563	28093	40656	1955	42611	78794	54.08%	15.94%	72	72
15	新竹縣竹東鎮	2018-11-24T22:30:17+08:00	6114	14029	20143	998	21141	39208	53.92%	15.59%	40	72
15	新竹縣竹東鎮	2018-11-24T23:51:42+08:00	11285	25376	36661	1804	38465	71395	53.88%	15.81%	66	72
15	新竹縣竹東鎮	2018-11-25T06:09:02+08:00	12563	28093	40656	1955	42611	78794	54.08%	15.94%	72	72
15	新竹縣竹東鎮	2018-11-24T23:23:45+08:00	10400	23566	33966	1676	35642	66099	53.92%	15.73%	62	72
15	新竹縣竹東鎮	2018-11-25T03:44:32+08:00	12563	28093	40656	1955	42611	78794	54.08%	15.94%	72	72
15	新竹縣竹東鎮	2018-11-24T23:08:44+08:00	9634	21869	31503	1561	33064	61324	53.92%	15.71%	58	72
15	新竹縣竹東鎮	2018-11-25T03:32:44+08:00	12563	28093	40656	1955	42611	78794	54.08%	15.94%	72	72
15	新竹縣竹東鎮	2018-11-24T22:13:37+08:00	5090	11705	16795	835	17630	32846	53.67%	15.5%	34	72
15	新竹縣竹東鎮	2018-11-25T00:23:11+08:00	11829	26533	38362	1872	40234	74681	53.87%	15.84%	69	72
15	新竹縣竹東鎮	2018-11-24T23:16:10+08:00	10038	22768	32806	1632	34438	63711	54.05%	15.76%	60	72
15	新竹縣竹東鎮	2018-11-24T23:47:37+08:00	11285	25376	36661	1804	38465	71395	53.88%	15.81%	66	72
15	新竹縣竹東鎮	2018-11-24T22:16:19+08:00	5400	12463	17863	898	18761	35008	53.59%	15.43%	36	72
15	新竹縣竹東鎮	2018-11-25T01:26:00+08:00	12306	27511	39817	1923	41740	77246	54.04%	15.93%	71	72
15	新竹縣竹東鎮	2018-11-25T03:39:01+08:00	12563	28093	40656	1955	42611	78794	54.08%	15.94%	72	72
15	新竹縣竹東鎮	2018-11-24T22:33:45+08:00	6663	15426	22089	1099	23188	43118	53.78%	15.45%	43	72
15	雲林縣褒忠鄉	2018-11-25T00:05:14+08:00	1790	3641	5431	430	5861	11381	51.5%	15.73%	14	14
15	雲林縣褒忠鄉	2018-11-25T01:12:55+08:00	1790	3641	5431	430	5861	11381	51.5%	15.73%	14	14
15	雲林縣褒忠鄉	2018-11-25T06:29:27+08:00	1790	3641	5431	430	5861	11381	51.5%	15.73%	14	14
15	雲林縣褒忠鄉	2018-11-24T23:05:13+08:00	1790	3641	5431	430	5861	11381	51.5%	15.73%	14	14
15	雲林縣褒忠鄉	2018-11-25T06:19:07+08:00	1790	3641	5431	430	5861	11381	51.5%	15.73%	14	14
15	雲林縣褒忠鄉	2018-11-24T22:26:45+08:00	1790	3641	5431	430	5861	11381	51.5%	15.73%	14	14
15	雲林縣褒忠鄉	2018-11-24T22:54:34+08:00	1790	3641	5431	430	5861	11381	51.5%	15.73%	14	14
15	雲林縣褒忠鄉	2018-11-24T22:41:47+08:00	1790	3641	5431	430	5861	11381	51.5%	15.73%	14	14
15	雲林縣褒忠鄉	2018-11-24T23:43:26+08:00	1790	3641	5431	430	5861	11381	51.5%	15.73%	14	14
15	雲林縣褒忠鄉	2018-11-24T22:50:59+08:00	1790	3641	5431	430	5861	11381	51.5%	15.73%	14	14
15	雲林縣褒忠鄉	2018-11-25T00:00:20+08:00	1790	3641	5431	430	5861	11381	51.5%	15.73%	14	14
15	雲林縣褒忠鄉	2018-11-25T00:23:13+08:00	1790	3641	5431	430	5861	11381	51.5%	15.73%	14	14
15	雲林縣褒忠鄉	2018-11-25T01:02:41+08:00	1790	3641	5431	430	5861	11381	51.5%	15.73%	14	14
15	雲林縣褒忠鄉	2018-11-25T03:32:48+08:00	1790	3641	5431	430	5861	11381	51.5%	15.73%	14	14
15	雲林縣褒忠鄉	2018-11-25T03:44:36+08:00	1790	3641	5431	430	5861	11381	51.5%	15.73%	14	14
15	雲林縣褒忠鄉	2018-11-24T23:08:47+08:00	1790	3641	5431	430	5861	11381	51.5%	15.73%	14	14
15	雲林縣褒忠鄉	2018-11-24T22:23:24+08:00	1583	3257	4840	390	5230	10157	51.49%	15.59%	13	14
15	雲林縣褒忠鄉	2018-11-25T06:24:10+08:00	1790	3641	5431	430	5861	11381	51.5%	15.73%	14	14
15	雲林縣褒忠鄉	2018-11-24T23:23:47+08:00	1790	3641	5431	430	5861	11381	51.5%	15.73%	14	14
15	雲林縣褒忠鄉	2018-11-25T03:50:00+08:00	1790	3641	5431	430	5861	11381	51.5%	15.73%	14	14
15	雲林縣褒忠鄉	2018-11-24T22:33:47+08:00	1790	3641	5431	430	5861	11381	51.5%	15.73%	14	14
15	雲林縣褒忠鄉	2018-11-25T01:26:03+08:00	1790	3641	5431	430	5861	11381	51.5%	15.73%	14	14
15	雲林縣褒忠鄉	2018-11-25T03:39:04+08:00	1790	3641	5431	430	5861	11381	51.5%	15.73%	14	14
15	雲林縣褒忠鄉	2018-11-25T00:14:19+08:00	1790	3641	5431	430	5861	11381	51.5%	15.73%	14	14
15	雲林縣褒忠鄉	2018-11-24T23:16:12+08:00	1790	3641	5431	430	5861	11381	51.5%	15.73%	14	14
15	雲林縣褒忠鄉	2018-11-24T23:35:19+08:00	1790	3641	5431	430	5861	11381	51.5%	15.73%	14	14
15	雲林縣褒忠鄉	2018-11-24T22:45:17+08:00	1790	3641	5431	430	5861	11381	51.5%	15.73%	14	14
15	雲林縣褒忠鄉	2018-11-25T01:18:05+08:00	1790	3641	5431	430	5861	11381	51.5%	15.73%	14	14
15	雲林縣褒忠鄉	2018-11-24T22:58:05+08:00	1790	3641	5431	430	5861	11381	51.5%	15.73%	14	14
15	雲林縣褒忠鄉	2018-11-25T00:09:46+08:00	1790	3641	5431	430	5861	11381	51.5%	15.73%	14	14
15	雲林縣褒忠鄉	2018-11-25T03:56:24+08:00	1790	3641	5431	430	5861	11381	51.5%	15.73%	14	14
15	雲林縣褒忠鄉	2018-11-24T23:01:42+08:00	1790	3641	5431	430	5861	11381	51.5%	15.73%	14	14
15	雲林縣褒忠鄉	2018-11-25T00:57:47+08:00	1790	3641	5431	430	5861	11381	51.5%	15.73%	14	14
15	雲林縣褒忠鄉	2018-11-24T22:19:46+08:00	1583	3257	4840	390	5230	10157	51.49%	15.59%	13	14
15	雲林縣褒忠鄉	2018-11-24T22:13:41+08:00	1583	3257	4840	390	5230	10157	51.49%	15.59%	13	14
15	雲林縣褒忠鄉	2018-11-25T04:03:02+08:00	1790	3641	5431	430	5861	11381	51.5%	15.73%	14	14
15	雲林縣褒忠鄉	2018-11-24T22:40:37+08:00	1790	3641	5431	430	5861	11381	51.5%	15.73%	14	14
15	雲林縣褒忠鄉	2018-11-24T23:51:45+08:00	1790	3641	5431	430	5861	11381	51.5%	15.73%	14	14
15	雲林縣褒忠鄉	2018-11-24T22:30:20+08:00	1790	3641	5431	430	5861	11381	51.5%	15.73%	14	14
15	雲林縣褒忠鄉	2018-11-25T06:09:05+08:00	1790	3641	5431	430	5861	11381	51.5%	15.73%	14	14
15	雲林縣褒忠鄉	2018-11-24T23:55:57+08:00	1790	3641	5431	430	5861	11381	51.5%	15.73%	14	14
15	雲林縣褒忠鄉	2018-11-24T23:27:27+08:00	1790	3641	5431	430	5861	11381	51.5%	15.73%	14	14
15	雲林縣褒忠鄉	2018-11-25T06:14:02+08:00	1790	3641	5431	430	5861	11381	51.5%	15.73%	14	14
15	雲林縣褒忠鄉	2018-11-24T23:47:39+08:00	1790	3641	5431	430	5861	11381	51.5%	15.73%	14	14
15	雲林縣褒忠鄉	2018-11-25T00:18:43+08:00	1790	3641	5431	430	5861	11381	51.5%	15.73%	14	14
15	雲林縣褒忠鄉	2018-11-24T22:16:21+08:00	1583	3257	4840	390	5230	10157	51.49%	15.59%	13	14
15	雲林縣褒忠鄉	2018-11-24T23:12:27+08:00	1790	3641	5431	430	5861	11381	51.5%	15.73%	14	14
15	雲林縣褒忠鄉	2018-11-24T23:39:28+08:00	1790	3641	5431	430	5861	11381	51.5%	15.73%	14	14
15	雲林縣褒忠鄉	2018-11-24T22:37:10+08:00	1790	3641	5431	430	5861	11381	51.5%	15.73%	14	14
15	雲林縣褒忠鄉	2018-11-24T23:31:23+08:00	1790	3641	5431	430	5861	11381	51.5%	15.73%	14	14
15	雲林縣褒忠鄉	2018-11-24T23:20:02+08:00	1790	3641	5431	430	5861	11381	51.5%	15.73%	14	14
15	雲林縣褒忠鄉	2018-11-25T01:07:36+08:00	1790	3641	5431	430	5861	11381	51.5%	15.73%	14	14
15	雲林縣土庫鎮	2018-11-25T00:05:14+08:00	3824	7891	11715	1166	12881	24412	52.77%	15.66%	29	29
15	雲林縣土庫鎮	2018-11-25T06:19:06+08:00	3824	7891	11715	1166	12881	24412	52.77%	15.66%	29	29
15	雲林縣土庫鎮	2018-11-25T00:09:45+08:00	3824	7891	11715	1166	12881	24412	52.77%	15.66%	29	29
15	雲林縣土庫鎮	2018-11-24T22:41:46+08:00	3824	7891	11715	1166	12881	24412	52.77%	15.66%	29	29
15	雲林縣土庫鎮	2018-11-25T06:29:27+08:00	3824	7891	11715	1166	12881	24412	52.77%	15.66%	29	29
15	雲林縣土庫鎮	2018-11-24T23:05:13+08:00	3824	7891	11715	1166	12881	24412	52.77%	15.66%	29	29
15	雲林縣土庫鎮	2018-11-24T22:26:45+08:00	3824	7891	11715	1166	12881	24412	52.77%	15.66%	29	29
15	雲林縣土庫鎮	2018-11-24T22:54:34+08:00	3824	7891	11715	1166	12881	24412	52.77%	15.66%	29	29
15	雲林縣土庫鎮	2018-11-25T01:12:54+08:00	3824	7891	11715	1166	12881	24412	52.77%	15.66%	29	29
15	雲林縣土庫鎮	2018-11-24T23:43:26+08:00	3824	7891	11715	1166	12881	24412	52.77%	15.66%	29	29
15	雲林縣土庫鎮	2018-11-24T22:50:59+08:00	3824	7891	11715	1166	12881	24412	52.77%	15.66%	29	29
15	雲林縣土庫鎮	2018-11-25T00:00:20+08:00	3824	7891	11715	1166	12881	24412	52.77%	15.66%	29	29
15	雲林縣土庫鎮	2018-11-25T00:23:13+08:00	3824	7891	11715	1166	12881	24412	52.77%	15.66%	29	29
15	雲林縣土庫鎮	2018-11-25T03:44:36+08:00	3824	7891	11715	1166	12881	24412	52.77%	15.66%	29	29
15	雲林縣土庫鎮	2018-11-24T23:08:47+08:00	3824	7891	11715	1166	12881	24412	52.77%	15.66%	29	29
15	雲林縣土庫鎮	2018-11-24T22:23:24+08:00	3824	7891	11715	1166	12881	24412	52.77%	15.66%	29	29
15	雲林縣土庫鎮	2018-11-25T06:24:10+08:00	3824	7891	11715	1166	12881	24412	52.77%	15.66%	29	29
15	雲林縣土庫鎮	2018-11-25T01:02:40+08:00	3824	7891	11715	1166	12881	24412	52.77%	15.66%	29	29
15	雲林縣土庫鎮	2018-11-25T06:14:01+08:00	3824	7891	11715	1166	12881	24412	52.77%	15.66%	29	29
15	雲林縣土庫鎮	2018-11-25T03:32:47+08:00	3824	7891	11715	1166	12881	24412	52.77%	15.66%	29	29
15	雲林縣土庫鎮	2018-11-24T23:23:47+08:00	3824	7891	11715	1166	12881	24412	52.77%	15.66%	29	29
15	雲林縣土庫鎮	2018-11-25T03:50:00+08:00	3824	7891	11715	1166	12881	24412	52.77%	15.66%	29	29
15	雲林縣土庫鎮	2018-11-24T22:33:47+08:00	3824	7891	11715	1166	12881	24412	52.77%	15.66%	29	29
15	雲林縣土庫鎮	2018-11-25T01:26:03+08:00	3824	7891	11715	1166	12881	24412	52.77%	15.66%	29	29
15	雲林縣土庫鎮	2018-11-25T03:39:03+08:00	3824	7891	11715	1166	12881	24412	52.77%	15.66%	29	29
15	雲林縣土庫鎮	2018-11-25T00:14:19+08:00	3824	7891	11715	1166	12881	24412	52.77%	15.66%	29	29
15	雲林縣土庫鎮	2018-11-24T23:16:12+08:00	3824	7891	11715	1166	12881	24412	52.77%	15.66%	29	29
15	雲林縣土庫鎮	2018-11-24T23:35:19+08:00	3824	7891	11715	1166	12881	24412	52.77%	15.66%	29	29
15	雲林縣土庫鎮	2018-11-24T22:45:17+08:00	3824	7891	11715	1166	12881	24412	52.77%	15.66%	29	29
15	雲林縣土庫鎮	2018-11-25T01:18:05+08:00	3824	7891	11715	1166	12881	24412	52.77%	15.66%	29	29
15	雲林縣土庫鎮	2018-11-25T03:56:23+08:00	3824	7891	11715	1166	12881	24412	52.77%	15.66%	29	29
15	雲林縣土庫鎮	2018-11-24T22:58:04+08:00	3824	7891	11715	1166	12881	24412	52.77%	15.66%	29	29
15	雲林縣土庫鎮	2018-11-24T23:01:42+08:00	3824	7891	11715	1166	12881	24412	52.77%	15.66%	29	29
15	雲林縣土庫鎮	2018-11-25T00:57:47+08:00	3824	7891	11715	1166	12881	24412	52.77%	15.66%	29	29
15	雲林縣土庫鎮	2018-11-24T22:19:46+08:00	3824	7891	11715	1166	12881	24412	52.77%	15.66%	29	29
15	雲林縣土庫鎮	2018-11-25T04:03:02+08:00	3824	7891	11715	1166	12881	24412	52.77%	15.66%	29	29
15	雲林縣土庫鎮	2018-11-24T22:30:19+08:00	3824	7891	11715	1166	12881	24412	52.77%	15.66%	29	29
15	雲林縣土庫鎮	2018-11-24T22:13:40+08:00	3824	7891	11715	1166	12881	24412	52.77%	15.66%	29	29
15	雲林縣土庫鎮	2018-11-24T22:40:37+08:00	3824	7891	11715	1166	12881	24412	52.77%	15.66%	29	29
15	雲林縣土庫鎮	2018-11-24T23:51:45+08:00	3824	7891	11715	1166	12881	24412	52.77%	15.66%	29	29
15	雲林縣土庫鎮	2018-11-25T06:09:05+08:00	3824	7891	11715	1166	12881	24412	52.77%	15.66%	29	29
15	雲林縣土庫鎮	2018-11-24T23:55:57+08:00	3824	7891	11715	1166	12881	24412	52.77%	15.66%	29	29
15	雲林縣土庫鎮	2018-11-24T23:27:27+08:00	3824	7891	11715	1166	12881	24412	52.77%	15.66%	29	29
15	雲林縣土庫鎮	2018-11-24T23:47:39+08:00	3824	7891	11715	1166	12881	24412	52.77%	15.66%	29	29
15	雲林縣土庫鎮	2018-11-24T23:31:22+08:00	3824	7891	11715	1166	12881	24412	52.77%	15.66%	29	29
15	雲林縣土庫鎮	2018-11-24T22:16:21+08:00	3824	7891	11715	1166	12881	24412	52.77%	15.66%	29	29
15	雲林縣土庫鎮	2018-11-24T23:39:28+08:00	3824	7891	11715	1166	12881	24412	52.77%	15.66%	29	29
15	雲林縣土庫鎮	2018-11-25T00:18:42+08:00	3824	7891	11715	1166	12881	24412	52.77%	15.66%	29	29
15	雲林縣土庫鎮	2018-11-24T22:37:10+08:00	3824	7891	11715	1166	12881	24412	52.77%	15.66%	29	29
15	雲林縣土庫鎮	2018-11-24T23:12:26+08:00	3824	7891	11715	1166	12881	24412	52.77%	15.66%	29	29
15	雲林縣土庫鎮	2018-11-24T23:20:02+08:00	3824	7891	11715	1166	12881	24412	52.77%	15.66%	29	29
15	雲林縣土庫鎮	2018-11-25T01:07:36+08:00	3824	7891	11715	1166	12881	24412	52.77%	15.66%	29	29
15	彰化縣鹿港鎮	2018-11-24T22:26:44+08:00	6681	15156	21837	1573	23410	39600	59.12%	16.87%	38	65
15	彰化縣鹿港鎮	2018-11-25T00:05:13+08:00	10444	24072	34516	2442	36958	63144	58.53%	16.54%	59	65
15	彰化縣鹿港鎮	2018-11-24T23:01:40+08:00	7424	16634	24058	1704	25762	43579	59.12%	17.04%	42	65
15	彰化縣鹿港鎮	2018-11-25T06:19:06+08:00	11517	26869	38386	2697	41083	70505	58.27%	16.34%	65	65
15	彰化縣鹿港鎮	2018-11-24T23:05:12+08:00	7595	17041	24636	1745	26381	44582	59.17%	17.04%	43	65
15	彰化縣鹿港鎮	2018-11-25T06:29:26+08:00	11517	26869	38386	2697	41083	70505	58.27%	16.34%	65	65
15	彰化縣鹿港鎮	2018-11-24T22:50:58+08:00	6994	15867	22861	1654	24515	41464	59.12%	16.87%	40	65
15	彰化縣鹿港鎮	2018-11-24T22:37:09+08:00	6994	15867	22861	1654	24515	41464	59.12%	16.87%	40	65
15	彰化縣鹿港鎮	2018-11-25T00:09:44+08:00	10444	24072	34516	2442	36958	63144	58.53%	16.54%	59	65
15	彰化縣鹿港鎮	2018-11-24T22:54:33+08:00	7424	16634	24058	1704	25762	43579	59.12%	17.04%	42	65
15	彰化縣鹿港鎮	2018-11-25T01:12:53+08:00	11517	26869	38386	2697	41083	70505	58.27%	16.34%	65	65
15	彰化縣鹿港鎮	2018-11-24T22:40:35+08:00	6994	15867	22861	1654	24515	41464	59.12%	16.87%	40	65
15	彰化縣鹿港鎮	2018-11-24T22:19:45+08:00	6681	15156	21837	1573	23410	39600	59.12%	16.87%	38	65
15	彰化縣鹿港鎮	2018-11-25T04:03:01+08:00	11517	26869	38386	2697	41083	70505	58.27%	16.34%	65	65
15	彰化縣鹿港鎮	2018-11-25T01:02:39+08:00	11330	26292	37622	2663	40285	69061	58.33%	16.41%	64	65
15	彰化縣鹿港鎮	2018-11-24T23:23:46+08:00	8993	20372	29365	2072	31437	52998	59.32%	16.97%	50	65
15	彰化縣鹿港鎮	2018-11-24T22:23:23+08:00	6681	15156	21837	1573	23410	39600	59.12%	16.87%	38	65
15	彰化縣鹿港鎮	2018-11-25T03:32:46+08:00	11517	26869	38386	2697	41083	70505	58.27%	16.34%	65	65
15	彰化縣鹿港鎮	2018-11-25T00:00:19+08:00	10444	24072	34516	2442	36958	63144	58.53%	16.54%	59	65
15	彰化縣鹿港鎮	2018-11-25T06:14:01+08:00	11517	26869	38386	2697	41083	70505	58.27%	16.34%	65	65
15	彰化縣鹿港鎮	2018-11-25T00:23:12+08:00	10791	25071	35862	2512	38374	65713	58.4%	16.42%	61	65
15	彰化縣鹿港鎮	2018-11-24T23:08:46+08:00	7595	17041	24636	1745	26381	44582	59.17%	17.04%	43	65
15	彰化縣鹿港鎮	2018-11-24T23:31:21+08:00	9326	21078	30404	2179	32583	55042	59.2%	16.94%	52	65
15	彰化縣鹿港鎮	2018-11-25T03:39:03+08:00	11517	26869	38386	2697	41083	70505	58.27%	16.34%	65	65
15	彰化縣鹿港鎮	2018-11-24T23:35:18+08:00	9519	21642	31161	2211	33372	56614	58.95%	16.81%	53	65
15	彰化縣鹿港鎮	2018-11-25T00:14:18+08:00	10604	24575	35179	2486	37665	64417	58.47%	16.46%	60	65
15	彰化縣鹿港鎮	2018-11-24T23:12:25+08:00	7786	17544	25330	1785	27115	45809	59.19%	17%	44	65
15	彰化縣鹿港鎮	2018-11-25T01:26:02+08:00	11517	26869	38386	2697	41083	70505	58.27%	16.34%	65	65
15	彰化縣鹿港鎮	2018-11-24T23:20:01+08:00	8627	19493	28120	1969	30089	50764	59.27%	16.99%	48	65
15	彰化縣鹿港鎮	2018-11-25T01:07:35+08:00	11330	26292	37622	2663	40285	69061	58.33%	16.41%	64	65
15	彰化縣鹿港鎮	2018-11-24T22:33:46+08:00	6823	15538	22361	1594	23955	40584	59.03%	16.81%	39	65
15	彰化縣鹿港鎮	2018-11-25T00:18:41+08:00	10791	25071	35862	2512	38374	65713	58.4%	16.42%	61	65
15	彰化縣鹿港鎮	2018-11-24T22:41:45+08:00	6994	15867	22861	1654	24515	41464	59.12%	16.87%	40	65
15	彰化縣鹿港鎮	2018-11-25T03:56:22+08:00	11517	26869	38386	2697	41083	70505	58.27%	16.34%	65	65
15	彰化縣鹿港鎮	2018-11-24T22:45:16+08:00	6994	15867	22861	1654	24515	41464	59.12%	16.87%	40	65
15	彰化縣鹿港鎮	2018-11-24T23:43:25+08:00	9784	22360	32144	2277	34421	58539	58.8%	16.71%	55	65
15	彰化縣鹿港鎮	2018-11-25T03:49:59+08:00	11517	26869	38386	2697	41083	70505	58.27%	16.34%	65	65
15	彰化縣鹿港鎮	2018-11-25T01:18:04+08:00	11517	26869	38386	2697	41083	70505	58.27%	16.34%	65	65
15	彰化縣鹿港鎮	2018-11-24T22:58:03+08:00	7424	16634	24058	1704	25762	43579	59.12%	17.04%	42	65
15	彰化縣鹿港鎮	2018-11-25T06:24:09+08:00	11517	26869	38386	2697	41083	70505	58.27%	16.34%	65	65
15	彰化縣鹿港鎮	2018-11-25T06:09:04+08:00	11517	26869	38386	2697	41083	70505	58.27%	16.34%	65	65
15	彰化縣鹿港鎮	2018-11-24T23:51:44+08:00	10135	23146	33281	2363	35644	60754	58.67%	16.68%	57	65
15	彰化縣鹿港鎮	2018-11-25T00:57:46+08:00	11330	26292	37622	2663	40285	69061	58.33%	16.41%	64	65
15	彰化縣鹿港鎮	2018-11-24T22:30:18+08:00	6681	15156	21837	1573	23410	39600	59.12%	16.87%	38	65
15	彰化縣鹿港鎮	2018-11-24T23:27:26+08:00	9136	20724	29860	2092	31952	53905	59.27%	16.95%	51	65
15	彰化縣鹿港鎮	2018-11-25T03:44:35+08:00	11517	26869	38386	2697	41083	70505	58.27%	16.34%	65	65
15	彰化縣鹿港鎮	2018-11-24T22:13:39+08:00	6297	14284	20581	1500	22081	37342	59.13%	16.86%	36	65
15	彰化縣鹿港鎮	2018-11-24T23:55:56+08:00	10444	24072	34516	2442	36958	63144	58.53%	16.54%	59	65
15	彰化縣鹿港鎮	2018-11-24T23:16:11+08:00	8449	19056	27505	1922	29427	49539	59.4%	17.06%	47	65
15	彰化縣鹿港鎮	2018-11-24T23:47:38+08:00	9784	22360	32144	2277	34421	58539	58.8%	16.71%	55	65
15	彰化縣鹿港鎮	2018-11-24T22:16:20+08:00	6482	14721	21203	1536	22739	38439	59.16%	16.86%	37	65
15	彰化縣鹿港鎮	2018-11-24T23:39:27+08:00	9784	22360	32144	2277	34421	58539	58.8%	16.71%	55	65
15	臺中市外埔區	2018-11-25T03:56:17+08:00	4102	10757	14859	1018	15877	27059	58.68%	15.16%	20	20
15	臺中市外埔區	2018-11-25T06:29:21+08:00	4102	10757	14859	1018	15877	27059	58.68%	15.16%	20	20
15	臺中市外埔區	2018-11-25T03:49:55+08:00	4102	10757	14859	1018	15877	27059	58.68%	15.16%	20	20
15	臺中市外埔區	2018-11-25T06:19:01+08:00	4102	10757	14859	1018	15877	27059	58.68%	15.16%	20	20
15	臺中市外埔區	2018-11-24T23:16:07+08:00	4102	10757	14859	1018	15877	27059	58.68%	15.16%	20	20
15	臺中市外埔區	2018-11-24T22:45:12+08:00	4102	10757	14859	1018	15877	27059	58.68%	15.16%	20	20
15	臺中市外埔區	2018-11-24T23:43:21+08:00	4102	10757	14859	1018	15877	27059	58.68%	15.16%	20	20
15	臺中市外埔區	2018-11-24T22:41:40+08:00	4102	10757	14859	1018	15877	27059	58.68%	15.16%	20	20
15	臺中市外埔區	2018-11-25T00:18:36+08:00	4102	10757	14859	1018	15877	27059	58.68%	15.16%	20	20
15	臺中市外埔區	2018-11-24T23:51:40+08:00	4102	10757	14859	1018	15877	27059	58.68%	15.16%	20	20
15	臺中市外埔區	2018-11-25T01:25:57+08:00	4102	10757	14859	1018	15877	27059	58.68%	15.16%	20	20
15	臺中市外埔區	2018-11-24T22:30:14+08:00	4102	10757	14859	1018	15877	27059	58.68%	15.16%	20	20
15	臺中市外埔區	2018-11-25T06:24:04+08:00	4102	10757	14859	1018	15877	27059	58.68%	15.16%	20	20
15	臺中市外埔區	2018-11-25T00:23:08+08:00	4102	10757	14859	1018	15877	27059	58.68%	15.16%	20	20
15	臺中市外埔區	2018-11-25T03:32:39+08:00	4102	10757	14859	1018	15877	27059	58.68%	15.16%	20	20
15	臺中市外埔區	2018-11-24T23:27:22+08:00	4102	10757	14859	1018	15877	27059	58.68%	15.16%	20	20
15	臺中市外埔區	2018-11-24T22:57:59+08:00	4102	10757	14859	1018	15877	27059	58.68%	15.16%	20	20
15	臺中市外埔區	2018-11-24T23:08:41+08:00	4102	10757	14859	1018	15877	27059	58.68%	15.16%	20	20
15	臺中市外埔區	2018-11-24T22:13:33+08:00	3812	10064	13876	931	14807	25157	58.86%	15.15%	19	20
15	臺中市外埔區	2018-11-24T23:19:56+08:00	4102	10757	14859	1018	15877	27059	58.68%	15.16%	20	20
15	臺中市外埔區	2018-11-25T01:17:58+08:00	4102	10757	14859	1018	15877	27059	58.68%	15.16%	20	20
15	臺中市外埔區	2018-11-24T22:54:29+08:00	4102	10757	14859	1018	15877	27059	58.68%	15.16%	20	20
15	臺中市外埔區	2018-11-24T23:47:33+08:00	4102	10757	14859	1018	15877	27059	58.68%	15.16%	20	20
15	臺中市外埔區	2018-11-25T04:02:56+08:00	4102	10757	14859	1018	15877	27059	58.68%	15.16%	20	20
15	臺中市外埔區	2018-11-25T06:08:58+08:00	4102	10757	14859	1018	15877	27059	58.68%	15.16%	20	20
15	臺中市外埔區	2018-11-24T22:16:15+08:00	3812	10064	13876	931	14807	25157	58.86%	15.15%	19	20
15	臺中市外埔區	2018-11-24T23:31:16+08:00	4102	10757	14859	1018	15877	27059	58.68%	15.16%	20	20
15	臺中市外埔區	2018-11-25T01:12:48+08:00	4102	10757	14859	1018	15877	27059	58.68%	15.16%	20	20
15	臺中市外埔區	2018-11-24T23:05:08+08:00	4102	10757	14859	1018	15877	27059	58.68%	15.16%	20	20
15	臺中市外埔區	2018-11-25T00:05:09+08:00	4102	10757	14859	1018	15877	27059	58.68%	15.16%	20	20
15	臺中市外埔區	2018-11-25T06:13:56+08:00	4102	10757	14859	1018	15877	27059	58.68%	15.16%	20	20
15	臺中市外埔區	2018-11-24T22:26:40+08:00	3812	10064	13876	931	14807	25157	58.86%	15.15%	19	20
15	臺中市外埔區	2018-11-24T22:50:53+08:00	4102	10757	14859	1018	15877	27059	58.68%	15.16%	20	20
15	臺中市外埔區	2018-11-24T22:37:05+08:00	4102	10757	14859	1018	15877	27059	58.68%	15.16%	20	20
15	臺中市外埔區	2018-11-24T22:19:41+08:00	3812	10064	13876	931	14807	25157	58.86%	15.15%	19	20
15	臺中市外埔區	2018-11-25T03:38:59+08:00	4102	10757	14859	1018	15877	27059	58.68%	15.16%	20	20
15	臺中市外埔區	2018-11-24T22:40:31+08:00	4102	10757	14859	1018	15877	27059	58.68%	15.16%	20	20
15	臺中市外埔區	2018-11-25T01:02:35+08:00	4102	10757	14859	1018	15877	27059	58.68%	15.16%	20	20
15	臺中市外埔區	2018-11-25T00:57:41+08:00	4102	10757	14859	1018	15877	27059	58.68%	15.16%	20	20
15	臺中市外埔區	2018-11-25T03:44:28+08:00	4102	10757	14859	1018	15877	27059	58.68%	15.16%	20	20
15	臺中市外埔區	2018-11-24T23:23:42+08:00	4102	10757	14859	1018	15877	27059	58.68%	15.16%	20	20
15	臺中市外埔區	2018-11-24T22:23:18+08:00	3812	10064	13876	931	14807	25157	58.86%	15.15%	19	20
15	臺中市外埔區	2018-11-25T00:00:15+08:00	4102	10757	14859	1018	15877	27059	58.68%	15.16%	20	20
15	臺中市外埔區	2018-11-24T23:55:51+08:00	4102	10757	14859	1018	15877	27059	58.68%	15.16%	20	20
15	臺中市外埔區	2018-11-24T23:39:21+08:00	4102	10757	14859	1018	15877	27059	58.68%	15.16%	20	20
15	臺中市外埔區	2018-11-25T01:07:30+08:00	4102	10757	14859	1018	15877	27059	58.68%	15.16%	20	20
15	臺中市外埔區	2018-11-24T23:12:20+08:00	4102	10757	14859	1018	15877	27059	58.68%	15.16%	20	20
15	臺中市外埔區	2018-11-24T23:35:14+08:00	4102	10757	14859	1018	15877	27059	58.68%	15.16%	20	20
15	臺中市外埔區	2018-11-25T00:14:14+08:00	4102	10757	14859	1018	15877	27059	58.68%	15.16%	20	20
15	臺中市外埔區	2018-11-24T23:01:35+08:00	4102	10757	14859	1018	15877	27059	58.68%	15.16%	20	20
15	臺中市外埔區	2018-11-25T00:09:39+08:00	4102	10757	14859	1018	15877	27059	58.68%	15.16%	20	20
15	臺中市外埔區	2018-11-24T22:33:42+08:00	4102	10757	14859	1018	15877	27059	58.68%	15.16%	20	20
15	臺東縣臺東市	2018-11-24T23:56:00+08:00	10526	25771	36297	2513	38810	70630	54.95%	14.9%	58	69
15	臺東縣臺東市	2018-11-24T22:58:08+08:00	5970	14904	20874	1416	22290	40769	54.67%	14.64%	38	69
15	臺東縣臺東市	2018-11-25T01:18:09+08:00	12224	29963	42187	2897	45084	82485	54.66%	14.82%	66	69
15	臺東縣臺東市	2018-11-25T03:56:27+08:00	12992	31881	44873	3100	47973	87803	54.64%	14.8%	69	69
15	臺東縣臺東市	2018-11-24T23:47:42+08:00	9669	24057	33726	2351	36077	65544	55.04%	14.75%	55	69
15	臺東縣臺東市	2018-11-24T23:12:30+08:00	6890	17475	24365	1780	26145	47731	54.78%	14.44%	43	69
15	臺東縣臺東市	2018-11-24T23:27:30+08:00	7596	19158	26754	1979	28733	52187	55.06%	14.56%	46	69
15	臺東縣臺東市	2018-11-25T06:09:09+08:00	12992	31881	44873	3100	47973	87803	54.64%	14.8%	69	69
15	臺東縣臺東市	2018-11-24T23:51:48+08:00	9924	24708	34632	2399	37031	67182	55.12%	14.77%	56	69
15	臺東縣臺東市	2018-11-24T22:30:23+08:00	3972	9956	13928	1002	14930	27544	54.2%	14.42%	28	69
15	臺東縣臺東市	2018-11-25T03:32:52+08:00	12992	31881	44873	3100	47973	87803	54.64%	14.8%	69	69
15	臺東縣臺東市	2018-11-24T22:13:44+08:00	3170	7852	11022	761	11783	21601	54.55%	14.68%	23	69
15	臺東縣臺東市	2018-11-25T03:44:40+08:00	12992	31881	44873	3100	47973	87803	54.64%	14.8%	69	69
15	臺東縣臺東市	2018-11-25T00:57:50+08:00	12224	29963	42187	2897	45084	82485	54.66%	14.82%	66	69
15	臺東縣臺東市	2018-11-24T23:20:07+08:00	7136	18164	25300	1839	27139	49326	55.02%	14.47%	44	69
15	臺東縣臺東市	2018-11-24T22:16:25+08:00	3405	8437	11842	798	12640	23280	54.3%	14.63%	24	69
15	臺東縣臺東市	2018-11-24T23:31:26+08:00	8141	20402	28543	2058	30601	55465	55.17%	14.68%	48	69
15	臺東縣臺東市	2018-11-24T22:37:13+08:00	4778	11786	16564	1168	17732	32575	54.43%	14.67%	32	69
15	臺東縣臺東市	2018-11-25T00:18:46+08:00	11612	28196	39808	2741	42549	77987	54.56%	14.89%	63	69
15	臺東縣臺東市	2018-11-24T23:16:15+08:00	6890	17475	24365	1780	26145	47731	54.78%	14.44%	43	69
15	臺東縣臺東市	2018-11-25T01:12:58+08:00	12224	29963	42187	2897	45084	82485	54.66%	14.82%	66	69
15	臺東縣臺東市	2018-11-25T00:05:17+08:00	11391	27769	39160	2733	41893	76637	54.66%	14.86%	62	69
15	臺東縣臺東市	2018-11-24T23:05:16+08:00	6745	16958	23703	1668	25371	46226	54.88%	14.59%	42	69
15	臺東縣臺東市	2018-11-24T23:39:32+08:00	9042	22571	31613	2229	33842	61408	55.11%	14.72%	52	69
15	臺東縣臺東市	2018-11-24T22:54:37+08:00	5970	14904	20874	1416	22290	40769	54.67%	14.64%	38	69
15	臺東縣臺東市	2018-11-24T22:33:50+08:00	4371	10809	15180	1077	16257	29952	54.28%	14.59%	30	69
15	臺東縣臺東市	2018-11-24T22:45:20+08:00	5053	12463	17516	1222	18738	34435	54.42%	14.67%	34	69
15	臺東縣臺東市	2018-11-24T22:26:48+08:00	3844	9656	13500	971	14471	26685	54.23%	14.41%	27	69
15	臺東縣臺東市	2018-11-24T23:01:45+08:00	6384	15917	22301	1538	23839	43479	54.83%	14.68%	40	69
15	臺東縣臺東市	2018-11-25T00:09:49+08:00	11391	27769	39160	2733	41893	76637	54.66%	14.86%	62	69
15	臺東縣臺東市	2018-11-25T04:03:05+08:00	12992	31881	44873	3100	47973	87803	54.64%	14.8%	69	69
15	臺東縣臺東市	2018-11-24T23:08:51+08:00	6890	17475	24365	1780	26145	47731	54.78%	14.44%	43	69
15	臺東縣臺東市	2018-11-24T23:23:50+08:00	7136	18164	25300	1839	27139	49326	55.02%	14.47%	44	69
15	臺東縣臺東市	2018-11-24T22:19:49+08:00	3554	8821	12375	861	13236	24396	54.25%	14.57%	25	69
15	臺東縣臺東市	2018-11-25T00:00:23+08:00	11012	26901	37913	2580	40493	73880	54.81%	14.91%	60	69
15	臺東縣臺東市	2018-11-24T22:51:03+08:00	5530	13681	19211	1343	20554	37766	54.42%	14.64%	36	69
15	臺東縣臺東市	2018-11-24T22:23:28+08:00	3554	8821	12375	861	13236	24396	54.25%	14.57%	25	69
15	臺東縣臺東市	2018-11-24T22:40:40+08:00	4778	11786	16564	1168	17732	32575	54.43%	14.67%	32	69
15	臺東縣臺東市	2018-11-25T06:24:13+08:00	12992	31881	44873	3100	47973	87803	54.64%	14.8%	69	69
15	臺東縣臺東市	2018-11-25T01:02:44+08:00	12224	29963	42187	2897	45084	82485	54.66%	14.82%	66	69
15	臺東縣臺東市	2018-11-25T06:14:05+08:00	12992	31881	44873	3100	47973	87803	54.64%	14.8%	69	69
15	臺東縣臺東市	2018-11-25T00:23:16+08:00	11612	28196	39808	2741	42549	77987	54.56%	14.89%	63	69
15	臺東縣臺東市	2018-11-25T06:19:10+08:00	12992	31881	44873	3100	47973	87803	54.64%	14.8%	69	69
15	臺東縣臺東市	2018-11-25T06:29:30+08:00	12992	31881	44873	3100	47973	87803	54.64%	14.8%	69	69
15	臺東縣臺東市	2018-11-25T03:50:03+08:00	12992	31881	44873	3100	47973	87803	54.64%	14.8%	69	69
15	臺東縣臺東市	2018-11-25T01:07:39+08:00	12224	29963	42187	2897	45084	82485	54.66%	14.82%	66	69
15	臺東縣臺東市	2018-11-25T01:26:07+08:00	12336	30299	42635	2946	45581	83543	54.56%	14.77%	67	69
15	臺東縣臺東市	2018-11-25T03:39:07+08:00	12992	31881	44873	3100	47973	87803	54.64%	14.8%	69	69
15	臺東縣臺東市	2018-11-24T22:41:50+08:00	4778	11786	16564	1168	17732	32575	54.43%	14.67%	32	69
15	臺東縣臺東市	2018-11-25T00:14:22+08:00	11391	27769	39160	2733	41893	76637	54.66%	14.86%	62	69
15	臺東縣臺東市	2018-11-24T23:35:22+08:00	8546	21518	30064	2157	32221	58646	54.94%	14.57%	50	69
15	臺東縣臺東市	2018-11-24T23:43:30+08:00	9508	23688	33196	2303	35499	64312	55.2%	14.78%	54	69
15	臺東縣綠島鄉	2018-11-25T03:56:28+08:00	467	1039	1506	73	1579	3579	44.12%	13.05%	4	4
15	臺東縣綠島鄉	2018-11-24T22:58:08+08:00	327	733	1060	46	1106	2497	44.29%	13.1%	3	4
15	臺東縣綠島鄉	2018-11-24T23:47:43+08:00	467	1039	1506	73	1579	3579	44.12%	13.05%	4	4
15	臺東縣綠島鄉	2018-11-24T23:56:01+08:00	467	1039	1506	73	1579	3579	44.12%	13.05%	4	4
15	臺東縣綠島鄉	2018-11-24T23:12:30+08:00	327	733	1060	46	1106	2497	44.29%	13.1%	3	4
15	臺東縣綠島鄉	2018-11-24T23:27:30+08:00	327	733	1060	46	1106	2497	44.29%	13.1%	3	4
15	臺東縣綠島鄉	2018-11-25T06:09:09+08:00	467	1039	1506	73	1579	3579	44.12%	13.05%	4	4
15	臺東縣綠島鄉	2018-11-24T23:51:48+08:00	467	1039	1506	73	1579	3579	44.12%	13.05%	4	4
15	臺東縣綠島鄉	2018-11-24T22:30:23+08:00	327	733	1060	46	1106	2497	44.29%	13.1%	3	4
15	臺東縣綠島鄉	2018-11-25T03:32:52+08:00	467	1039	1506	73	1579	3579	44.12%	13.05%	4	4
15	臺東縣綠島鄉	2018-11-24T22:13:44+08:00	151	310	461	20	481	1023	47.02%	14.76%	2	4
15	臺東縣綠島鄉	2018-11-25T03:44:40+08:00	467	1039	1506	73	1579	3579	44.12%	13.05%	4	4
15	臺東縣綠島鄉	2018-11-25T00:57:51+08:00	467	1039	1506	73	1579	3579	44.12%	13.05%	4	4
15	臺東縣綠島鄉	2018-11-24T22:16:25+08:00	151	310	461	20	481	1023	47.02%	14.76%	2	4
15	臺東縣綠島鄉	2018-11-25T00:09:50+08:00	467	1039	1506	73	1579	3579	44.12%	13.05%	4	4
15	臺東縣綠島鄉	2018-11-25T00:18:47+08:00	467	1039	1506	73	1579	3579	44.12%	13.05%	4	4
15	臺東縣綠島鄉	2018-11-24T22:37:14+08:00	327	733	1060	46	1106	2497	44.29%	13.1%	3	4
15	臺東縣綠島鄉	2018-11-24T23:20:08+08:00	327	733	1060	46	1106	2497	44.29%	13.1%	3	4
15	臺東縣綠島鄉	2018-11-24T23:31:27+08:00	327	733	1060	46	1106	2497	44.29%	13.1%	3	4
15	臺東縣綠島鄉	2018-11-25T01:12:58+08:00	467	1039	1506	73	1579	3579	44.12%	13.05%	4	4
15	臺東縣綠島鄉	2018-11-24T23:05:16+08:00	327	733	1060	46	1106	2497	44.29%	13.1%	3	4
15	臺東縣綠島鄉	2018-11-25T01:07:40+08:00	467	1039	1506	73	1579	3579	44.12%	13.05%	4	4
15	臺東縣綠島鄉	2018-11-24T23:39:32+08:00	327	733	1060	46	1106	2497	44.29%	13.1%	3	4
15	臺東縣綠島鄉	2018-11-24T22:54:37+08:00	327	733	1060	46	1106	2497	44.29%	13.1%	3	4
15	臺東縣綠島鄉	2018-11-24T22:33:50+08:00	327	733	1060	46	1106	2497	44.29%	13.1%	3	4
15	臺東縣綠島鄉	2018-11-24T22:45:20+08:00	327	733	1060	46	1106	2497	44.29%	13.1%	3	4
15	臺東縣綠島鄉	2018-11-25T00:05:18+08:00	467	1039	1506	73	1579	3579	44.12%	13.05%	4	4
15	臺東縣綠島鄉	2018-11-24T22:26:48+08:00	327	733	1060	46	1106	2497	44.29%	13.1%	3	4
15	臺東縣綠島鄉	2018-11-24T23:01:45+08:00	327	733	1060	46	1106	2497	44.29%	13.1%	3	4
15	臺東縣綠島鄉	2018-11-25T04:03:05+08:00	467	1039	1506	73	1579	3579	44.12%	13.05%	4	4
15	臺東縣綠島鄉	2018-11-24T23:08:51+08:00	327	733	1060	46	1106	2497	44.29%	13.1%	3	4
15	臺東縣綠島鄉	2018-11-24T23:23:50+08:00	327	733	1060	46	1106	2497	44.29%	13.1%	3	4
15	臺東縣綠島鄉	2018-11-24T22:19:49+08:00	151	310	461	20	481	1023	47.02%	14.76%	2	4
15	臺東縣綠島鄉	2018-11-25T00:23:17+08:00	467	1039	1506	73	1579	3579	44.12%	13.05%	4	4
15	臺東縣綠島鄉	2018-11-25T00:00:24+08:00	467	1039	1506	73	1579	3579	44.12%	13.05%	4	4
15	臺東縣綠島鄉	2018-11-24T22:51:03+08:00	327	733	1060	46	1106	2497	44.29%	13.1%	3	4
15	臺東縣綠島鄉	2018-11-24T22:23:28+08:00	151	310	461	20	481	1023	47.02%	14.76%	2	4
15	臺東縣綠島鄉	2018-11-24T22:40:40+08:00	327	733	1060	46	1106	2497	44.29%	13.1%	3	4
15	臺東縣綠島鄉	2018-11-25T06:24:13+08:00	467	1039	1506	73	1579	3579	44.12%	13.05%	4	4
15	臺東縣綠島鄉	2018-11-25T01:02:44+08:00	467	1039	1506	73	1579	3579	44.12%	13.05%	4	4
15	臺東縣綠島鄉	2018-11-25T06:14:05+08:00	467	1039	1506	73	1579	3579	44.12%	13.05%	4	4
15	臺東縣綠島鄉	2018-11-25T06:19:10+08:00	467	1039	1506	73	1579	3579	44.12%	13.05%	4	4
15	臺東縣綠島鄉	2018-11-25T00:14:23+08:00	467	1039	1506	73	1579	3579	44.12%	13.05%	4	4
15	臺東縣綠島鄉	2018-11-25T01:18:10+08:00	467	1039	1506	73	1579	3579	44.12%	13.05%	4	4
15	臺東縣綠島鄉	2018-11-25T03:50:03+08:00	467	1039	1506	73	1579	3579	44.12%	13.05%	4	4
15	臺東縣綠島鄉	2018-11-25T01:26:07+08:00	467	1039	1506	73	1579	3579	44.12%	13.05%	4	4
15	臺東縣綠島鄉	2018-11-25T03:39:07+08:00	467	1039	1506	73	1579	3579	44.12%	13.05%	4	4
15	臺東縣綠島鄉	2018-11-24T22:41:50+08:00	327	733	1060	46	1106	2497	44.29%	13.1%	3	4
15	臺東縣綠島鄉	2018-11-25T06:29:31+08:00	467	1039	1506	73	1579	3579	44.12%	13.05%	4	4
15	臺東縣綠島鄉	2018-11-24T23:16:16+08:00	327	733	1060	46	1106	2497	44.29%	13.1%	3	4
15	臺東縣綠島鄉	2018-11-24T23:35:22+08:00	327	733	1060	46	1106	2497	44.29%	13.1%	3	4
15	臺東縣綠島鄉	2018-11-24T23:43:30+08:00	467	1039	1506	73	1579	3579	44.12%	13.05%	4	4
15	宜蘭縣蘇澳鎮	2018-11-25T03:56:26+08:00	6130	11634	17764	1642	19406	34512	56.23%	17.76%	43	43
15	宜蘭縣蘇澳鎮	2018-11-24T23:05:15+08:00	6130	11634	17764	1642	19406	34512	56.23%	17.76%	43	43
15	宜蘭縣蘇澳鎮	2018-11-25T01:18:08+08:00	6130	11634	17764	1642	19406	34512	56.23%	17.76%	43	43
15	宜蘭縣蘇澳鎮	2018-11-24T23:43:29+08:00	6130	11634	17764	1642	19406	34512	56.23%	17.76%	43	43
15	宜蘭縣蘇澳鎮	2018-11-25T06:19:09+08:00	6130	11634	17764	1642	19406	34512	56.23%	17.76%	43	43
15	宜蘭縣蘇澳鎮	2018-11-24T22:58:07+08:00	6130	11634	17764	1642	19406	34512	56.23%	17.76%	43	43
15	宜蘭縣蘇澳鎮	2018-11-24T22:41:49+08:00	5648	10809	16457	1530	17987	32058	56.11%	17.62%	41	43
15	宜蘭縣蘇澳鎮	2018-11-24T23:39:31+08:00	6130	11634	17764	1642	19406	34512	56.23%	17.76%	43	43
15	宜蘭縣蘇澳鎮	2018-11-24T23:47:42+08:00	6130	11634	17764	1642	19406	34512	56.23%	17.76%	43	43
15	宜蘭縣蘇澳鎮	2018-11-24T22:30:22+08:00	5648	10809	16457	1530	17987	32058	56.11%	17.62%	41	43
15	宜蘭縣蘇澳鎮	2018-11-24T23:51:47+08:00	6130	11634	17764	1642	19406	34512	56.23%	17.76%	43	43
15	宜蘭縣蘇澳鎮	2018-11-25T06:09:08+08:00	6130	11634	17764	1642	19406	34512	56.23%	17.76%	43	43
15	宜蘭縣蘇澳鎮	2018-11-24T22:13:43+08:00	5459	10418	15877	1500	17377	30930	56.18%	17.65%	40	43
15	宜蘭縣蘇澳鎮	2018-11-25T03:44:39+08:00	6130	11634	17764	1642	19406	34512	56.23%	17.76%	43	43
15	宜蘭縣蘇澳鎮	2018-11-24T23:23:49+08:00	6130	11634	17764	1642	19406	34512	56.23%	17.76%	43	43
15	宜蘭縣蘇澳鎮	2018-11-24T22:33:49+08:00	5648	10809	16457	1530	17987	32058	56.11%	17.62%	41	43
15	宜蘭縣蘇澳鎮	2018-11-24T22:37:12+08:00	5648	10809	16457	1530	17987	32058	56.11%	17.62%	41	43
15	宜蘭縣蘇澳鎮	2018-11-24T23:16:14+08:00	6130	11634	17764	1642	19406	34512	56.23%	17.76%	43	43
15	宜蘭縣蘇澳鎮	2018-11-24T22:16:24+08:00	5459	10418	15877	1500	17377	30930	56.18%	17.65%	40	43
15	宜蘭縣蘇澳鎮	2018-11-24T23:35:21+08:00	6130	11634	17764	1642	19406	34512	56.23%	17.76%	43	43
15	宜蘭縣蘇澳鎮	2018-11-24T22:45:19+08:00	5648	10809	16457	1530	17987	32058	56.11%	17.62%	41	43
15	宜蘭縣蘇澳鎮	2018-11-24T22:54:36+08:00	5913	11231	17144	1588	18732	33318	56.22%	17.75%	42	43
15	宜蘭縣蘇澳鎮	2018-11-25T00:09:48+08:00	6130	11634	17764	1642	19406	34512	56.23%	17.76%	43	43
15	宜蘭縣蘇澳鎮	2018-11-24T23:01:44+08:00	6130	11634	17764	1642	19406	34512	56.23%	17.76%	43	43
15	宜蘭縣蘇澳鎮	2018-11-24T22:26:47+08:00	5648	10809	16457	1530	17987	32058	56.11%	17.62%	41	43
15	宜蘭縣蘇澳鎮	2018-11-25T01:12:57+08:00	6130	11634	17764	1642	19406	34512	56.23%	17.76%	43	43
15	宜蘭縣蘇澳鎮	2018-11-25T00:05:16+08:00	6130	11634	17764	1642	19406	34512	56.23%	17.76%	43	43
15	宜蘭縣蘇澳鎮	2018-11-25T00:57:49+08:00	6130	11634	17764	1642	19406	34512	56.23%	17.76%	43	43
15	宜蘭縣蘇澳鎮	2018-11-24T22:19:48+08:00	5459	10418	15877	1500	17377	30930	56.18%	17.65%	40	43
15	宜蘭縣蘇澳鎮	2018-11-25T04:03:04+08:00	6130	11634	17764	1642	19406	34512	56.23%	17.76%	43	43
15	宜蘭縣蘇澳鎮	2018-11-24T22:40:39+08:00	5648	10809	16457	1530	17987	32058	56.11%	17.62%	41	43
15	宜蘭縣蘇澳鎮	2018-11-25T03:32:51+08:00	6130	11634	17764	1642	19406	34512	56.23%	17.76%	43	43
15	宜蘭縣蘇澳鎮	2018-11-24T23:08:50+08:00	6130	11634	17764	1642	19406	34512	56.23%	17.76%	43	43
15	宜蘭縣蘇澳鎮	2018-11-24T22:23:27+08:00	5648	10809	16457	1530	17987	32058	56.11%	17.62%	41	43
15	宜蘭縣蘇澳鎮	2018-11-24T22:51:02+08:00	5648	10809	16457	1530	17987	32058	56.11%	17.62%	41	43
15	宜蘭縣蘇澳鎮	2018-11-25T06:14:04+08:00	6130	11634	17764	1642	19406	34512	56.23%	17.76%	43	43
15	宜蘭縣蘇澳鎮	2018-11-24T23:55:59+08:00	6130	11634	17764	1642	19406	34512	56.23%	17.76%	43	43
15	宜蘭縣蘇澳鎮	2018-11-25T06:24:12+08:00	6130	11634	17764	1642	19406	34512	56.23%	17.76%	43	43
15	宜蘭縣蘇澳鎮	2018-11-24T23:27:29+08:00	6130	11634	17764	1642	19406	34512	56.23%	17.76%	43	43
15	宜蘭縣蘇澳鎮	2018-11-25T00:00:22+08:00	6130	11634	17764	1642	19406	34512	56.23%	17.76%	43	43
15	宜蘭縣蘇澳鎮	2018-11-25T00:23:16+08:00	6130	11634	17764	1642	19406	34512	56.23%	17.76%	43	43
15	宜蘭縣蘇澳鎮	2018-11-25T01:02:43+08:00	6130	11634	17764	1642	19406	34512	56.23%	17.76%	43	43
15	宜蘭縣蘇澳鎮	2018-11-25T06:29:30+08:00	6130	11634	17764	1642	19406	34512	56.23%	17.76%	43	43
15	宜蘭縣蘇澳鎮	2018-11-24T23:12:29+08:00	6130	11634	17764	1642	19406	34512	56.23%	17.76%	43	43
15	宜蘭縣蘇澳鎮	2018-11-24T23:31:25+08:00	6130	11634	17764	1642	19406	34512	56.23%	17.76%	43	43
15	宜蘭縣蘇澳鎮	2018-11-24T23:20:04+08:00	6130	11634	17764	1642	19406	34512	56.23%	17.76%	43	43
15	宜蘭縣蘇澳鎮	2018-11-25T00:14:22+08:00	6130	11634	17764	1642	19406	34512	56.23%	17.76%	43	43
15	宜蘭縣蘇澳鎮	2018-11-25T00:18:45+08:00	6130	11634	17764	1642	19406	34512	56.23%	17.76%	43	43
15	宜蘭縣蘇澳鎮	2018-11-25T01:07:38+08:00	6130	11634	17764	1642	19406	34512	56.23%	17.76%	43	43
15	宜蘭縣蘇澳鎮	2018-11-25T03:39:06+08:00	6130	11634	17764	1642	19406	34512	56.23%	17.76%	43	43
15	宜蘭縣蘇澳鎮	2018-11-25T01:26:06+08:00	6130	11634	17764	1642	19406	34512	56.23%	17.76%	43	43
15	宜蘭縣蘇澳鎮	2018-11-25T03:50:02+08:00	6130	11634	17764	1642	19406	34512	56.23%	17.76%	43	43
15	連江縣南竿鄉	2018-11-24T23:12:31+08:00	0	0	0	0	0	0	0%	0%	0	4
15	連江縣南竿鄉	2018-11-24T23:47:44+08:00	0	0	0	0	0	0	0%	0%	0	4
15	連江縣南竿鄉	2018-11-24T22:58:09+08:00	0	0	0	0	0	0	0%	0%	0	4
15	連江縣南竿鄉	2018-11-24T23:56:01+08:00	0	0	0	0	0	0	0%	0%	0	4
15	連江縣南竿鄉	2018-11-25T03:56:29+08:00	849	2342	3191	98	3289	6461	50.91%	13.14%	4	4
15	連江縣南竿鄉	2018-11-24T23:01:46+08:00	0	0	0	0	0	0	0%	0%	0	4
15	連江縣南竿鄉	2018-11-25T03:32:53+08:00	849	2342	3191	98	3289	6461	50.91%	13.14%	4	4
15	連江縣南竿鄉	2018-11-24T23:08:52+08:00	0	0	0	0	0	0	0%	0%	0	4
15	連江縣南竿鄉	2018-11-24T23:51:49+08:00	0	0	0	0	0	0	0%	0%	0	4
15	連江縣南竿鄉	2018-11-24T22:13:45+08:00	0	0	0	0	0	0	0%	0%	0	4
15	連江縣南竿鄉	2018-11-25T03:44:41+08:00	849	2342	3191	98	3289	6461	50.91%	13.14%	4	4
15	連江縣南竿鄉	2018-11-25T04:03:06+08:00	849	2342	3191	98	3289	6461	50.91%	13.14%	4	4
15	連江縣南竿鄉	2018-11-24T23:27:31+08:00	0	0	0	0	0	0	0%	0%	0	4
15	連江縣南竿鄉	2018-11-24T22:30:24+08:00	0	0	0	0	0	0	0%	0%	0	4
15	連江縣南竿鄉	2018-11-24T22:19:50+08:00	0	0	0	0	0	0	0%	0%	0	4
15	連江縣南竿鄉	2018-11-25T06:14:06+08:00	849	2342	3191	98	3289	6461	50.91%	13.14%	4	4
15	連江縣南竿鄉	2018-11-24T23:20:09+08:00	0	0	0	0	0	0	0%	0%	0	4
15	連江縣南竿鄉	2018-11-24T23:31:28+08:00	0	0	0	0	0	0	0%	0%	0	4
15	連江縣南竿鄉	2018-11-24T22:37:14+08:00	0	0	0	0	0	0	0%	0%	0	4
15	連江縣南竿鄉	2018-11-25T00:18:48+08:00	0	0	0	0	0	0	0%	0%	0	4
15	連江縣南竿鄉	2018-11-25T06:29:32+08:00	849	2342	3191	98	3289	6461	50.91%	13.14%	4	4
15	連江縣南竿鄉	2018-11-25T00:09:51+08:00	0	0	0	0	0	0	0%	0%	0	4
15	連江縣南竿鄉	2018-11-24T22:45:21+08:00	0	0	0	0	0	0	0%	0%	0	4
15	連江縣南竿鄉	2018-11-24T22:54:38+08:00	0	0	0	0	0	0	0%	0%	0	4
15	連江縣南竿鄉	2018-11-24T22:33:51+08:00	0	0	0	0	0	0	0%	0%	0	4
15	連江縣南竿鄉	2018-11-24T23:39:33+08:00	0	0	0	0	0	0	0%	0%	0	4
15	連江縣南竿鄉	2018-11-24T22:26:49+08:00	0	0	0	0	0	0	0%	0%	0	4
15	連江縣南竿鄉	2018-11-25T01:07:40+08:00	849	2342	3191	98	3289	6461	50.91%	13.14%	4	4
15	連江縣南竿鄉	2018-11-25T01:12:59+08:00	849	2342	3191	98	3289	6461	50.91%	13.14%	4	4
15	連江縣南竿鄉	2018-11-25T00:05:18+08:00	0	0	0	0	0	0	0%	0%	0	4
15	連江縣南竿鄉	2018-11-24T23:05:17+08:00	0	0	0	0	0	0	0%	0%	0	4
15	連江縣南竿鄉	2018-11-24T23:23:51+08:00	0	0	0	0	0	0	0%	0%	0	4
15	連江縣南竿鄉	2018-11-24T22:23:29+08:00	0	0	0	0	0	0	0%	0%	0	4
15	連江縣南竿鄉	2018-11-25T00:00:24+08:00	0	0	0	0	0	0	0%	0%	0	4
15	連江縣南竿鄉	2018-11-25T01:02:45+08:00	683	1719	2402	84	2486	4918	50.55%	13.89%	3	4
15	連江縣南竿鄉	2018-11-24T22:40:41+08:00	0	0	0	0	0	0	0%	0%	0	4
15	連江縣南竿鄉	2018-11-25T00:57:52+08:00	520	1312	1832	66	1898	3804	49.89%	13.67%	2	4
15	連江縣南竿鄉	2018-11-24T22:51:04+08:00	0	0	0	0	0	0	0%	0%	0	4
15	連江縣南竿鄉	2018-11-25T06:09:10+08:00	849	2342	3191	98	3289	6461	50.91%	13.14%	4	4
15	連江縣南竿鄉	2018-11-25T06:24:14+08:00	849	2342	3191	98	3289	6461	50.91%	13.14%	4	4
15	連江縣南竿鄉	2018-11-25T00:23:18+08:00	0	0	0	0	0	0	0%	0%	0	4
15	連江縣南竿鄉	2018-11-24T23:35:23+08:00	0	0	0	0	0	0	0%	0%	0	4
15	連江縣南竿鄉	2018-11-25T00:14:24+08:00	0	0	0	0	0	0	0%	0%	0	4
15	連江縣南竿鄉	2018-11-25T03:50:04+08:00	849	2342	3191	98	3289	6461	50.91%	13.14%	4	4
15	連江縣南竿鄉	2018-11-24T22:16:26+08:00	0	0	0	0	0	0	0%	0%	0	4
15	連江縣南竿鄉	2018-11-24T23:43:31+08:00	0	0	0	0	0	0	0%	0%	0	4
15	連江縣南竿鄉	2018-11-25T01:18:11+08:00	849	2342	3191	98	3289	6461	50.91%	13.14%	4	4
15	連江縣南竿鄉	2018-11-24T23:16:16+08:00	0	0	0	0	0	0	0%	0%	0	4
15	連江縣南竿鄉	2018-11-25T06:19:11+08:00	849	2342	3191	98	3289	6461	50.91%	13.14%	4	4
15	連江縣南竿鄉	2018-11-24T22:41:51+08:00	0	0	0	0	0	0	0%	0%	0	4
15	連江縣南竿鄉	2018-11-25T03:39:08+08:00	849	2342	3191	98	3289	6461	50.91%	13.14%	4	4
15	連江縣南竿鄉	2018-11-25T01:26:08+08:00	849	2342	3191	98	3289	6461	50.91%	13.14%	4	4
15	屏東縣恆春鎮	2018-11-24T22:58:06+08:00	2005	4314	6319	538	6857	14731	46.55%	13.61%	16	25
15	屏東縣恆春鎮	2018-11-25T06:19:08+08:00	3668	7587	11255	822	12077	25661	47.06%	14.29%	25	25
15	屏東縣恆春鎮	2018-11-25T06:29:28+08:00	3668	7587	11255	822	12077	25661	47.06%	14.29%	25	25
15	屏東縣恆春鎮	2018-11-24T23:43:27+08:00	2705	5665	8370	654	9024	18964	47.58%	14.26%	20	25
15	屏東縣恆春鎮	2018-11-24T22:54:35+08:00	1926	4142	6068	527	6595	14023	47.03%	13.73%	15	25
15	屏東縣恆春鎮	2018-11-24T22:41:48+08:00	1770	3853	5623	483	6106	13003	46.96%	13.61%	14	25
15	屏東縣恆春鎮	2018-11-24T23:05:14+08:00	2217	4694	6911	576	7487	16011	46.76%	13.85%	17	25
15	屏東縣恆春鎮	2018-11-25T01:18:07+08:00	3668	7587	11255	822	12077	25661	47.06%	14.29%	25	25
15	屏東縣恆春鎮	2018-11-25T00:05:15+08:00	3264	6847	10111	735	10846	22923	47.31%	14.24%	23	25
15	屏東縣恆春鎮	2018-11-24T22:13:42+08:00	772	1598	2370	230	2600	5421	47.96%	14.24%	7	25
15	屏東縣恆春鎮	2018-11-24T23:51:46+08:00	3032	6382	9414	706	10120	21418	47.25%	14.16%	22	25
15	屏東縣恆春鎮	2018-11-25T06:09:06+08:00	3668	7587	11255	822	12077	25661	47.06%	14.29%	25	25
15	屏東縣恆春鎮	2018-11-25T00:23:14+08:00	3461	7220	10681	785	11466	24408	46.98%	14.18%	24	25
15	屏東縣恆春鎮	2018-11-25T06:24:11+08:00	3668	7587	11255	822	12077	25661	47.06%	14.29%	25	25
15	屏東縣恆春鎮	2018-11-24T23:23:48+08:00	2217	4694	6911	576	7487	16011	46.76%	13.85%	17	25
15	屏東縣恆春鎮	2018-11-25T00:00:21+08:00	3032	6382	9414	706	10120	21418	47.25%	14.16%	22	25
15	屏東縣恆春鎮	2018-11-24T22:51:00+08:00	1926	4142	6068	527	6595	14023	47.03%	13.73%	15	25
15	屏東縣恆春鎮	2018-11-25T03:32:49+08:00	3668	7587	11255	822	12077	25661	47.06%	14.29%	25	25
15	屏東縣恆春鎮	2018-11-25T03:44:37+08:00	3668	7587	11255	822	12077	25661	47.06%	14.29%	25	25
15	屏東縣恆春鎮	2018-11-24T23:08:48+08:00	2217	4694	6911	576	7487	16011	46.76%	13.85%	17	25
15	屏東縣恆春鎮	2018-11-24T22:16:22+08:00	772	1598	2370	230	2600	5421	47.96%	14.24%	7	25
15	屏東縣恆春鎮	2018-11-24T23:16:13+08:00	2217	4694	6911	576	7487	16011	46.76%	13.85%	17	25
15	屏東縣恆春鎮	2018-11-24T23:35:20+08:00	2563	5359	7922	621	8543	18068	47.28%	14.19%	19	25
15	屏東縣恆春鎮	2018-11-25T00:14:20+08:00	3461	7220	10681	785	11466	24408	46.98%	14.18%	24	25
15	屏東縣恆春鎮	2018-11-25T01:26:05+08:00	3668	7587	11255	822	12077	25661	47.06%	14.29%	25	25
15	屏東縣恆春鎮	2018-11-25T03:39:05+08:00	3668	7587	11255	822	12077	25661	47.06%	14.29%	25	25
15	屏東縣恆春鎮	2018-11-24T22:33:48+08:00	1432	3043	4475	393	4868	10356	47.01%	13.83%	12	25
15	屏東縣恆春鎮	2018-11-25T03:50:01+08:00	3668	7587	11255	822	12077	25661	47.06%	14.29%	25	25
15	屏東縣恆春鎮	2018-11-25T01:12:56+08:00	3668	7587	11255	822	12077	25661	47.06%	14.29%	25	25
15	屏東縣恆春鎮	2018-11-24T23:47:40+08:00	3032	6382	9414	706	10120	21418	47.25%	14.16%	22	25
15	屏東縣恆春鎮	2018-11-24T23:01:43+08:00	2217	4694	6911	576	7487	16011	46.76%	13.85%	17	25
15	屏東縣恆春鎮	2018-11-25T03:56:25+08:00	3668	7587	11255	822	12077	25661	47.06%	14.29%	25	25
15	屏東縣恆春鎮	2018-11-24T22:45:18+08:00	1770	3853	5623	483	6106	13003	46.96%	13.61%	14	25
15	屏東縣恆春鎮	2018-11-25T00:09:47+08:00	3264	6847	10111	735	10846	22923	47.31%	14.24%	23	25
15	屏東縣恆春鎮	2018-11-24T22:26:46+08:00	1142	2414	3556	326	3882	8151	47.63%	14.01%	10	25
15	屏東縣恆春鎮	2018-11-24T22:30:21+08:00	1142	2414	3556	326	3882	8151	47.63%	14.01%	10	25
15	屏東縣恆春鎮	2018-11-24T22:40:38+08:00	1770	3853	5623	483	6106	13003	46.96%	13.61%	14	25
15	屏東縣恆春鎮	2018-11-25T04:03:03+08:00	3668	7587	11255	822	12077	25661	47.06%	14.29%	25	25
15	屏東縣恆春鎮	2018-11-25T00:57:48+08:00	3668	7587	11255	822	12077	25661	47.06%	14.29%	25	25
15	屏東縣恆春鎮	2018-11-24T22:19:47+08:00	917	1927	2844	276	3120	6532	47.76%	14.04%	8	25
15	屏東縣恆春鎮	2018-11-24T23:27:28+08:00	2217	4694	6911	576	7487	16011	46.76%	13.85%	17	25
15	屏東縣恆春鎮	2018-11-25T01:02:42+08:00	3668	7587	11255	822	12077	25661	47.06%	14.29%	25	25
15	屏東縣恆春鎮	2018-11-25T06:14:03+08:00	3668	7587	11255	822	12077	25661	47.06%	14.29%	25	25
15	屏東縣恆春鎮	2018-11-24T22:23:26+08:00	1054	2200	3254	310	3564	7376	48.32%	14.29%	9	25
15	屏東縣恆春鎮	2018-11-24T23:55:58+08:00	3032	6382	9414	706	10120	21418	47.25%	14.16%	22	25
15	屏東縣恆春鎮	2018-11-25T00:18:44+08:00	3461	7220	10681	785	11466	24408	46.98%	14.18%	24	25
15	屏東縣恆春鎮	2018-11-24T23:20:03+08:00	2217	4694	6911	576	7487	16011	46.76%	13.85%	17	25
15	屏東縣恆春鎮	2018-11-25T01:07:37+08:00	3668	7587	11255	822	12077	25661	47.06%	14.29%	25	25
15	屏東縣恆春鎮	2018-11-24T22:37:11+08:00	1627	3523	5150	433	5583	11899	46.92%	13.67%	13	25
15	屏東縣恆春鎮	2018-11-24T23:39:29+08:00	2705	5665	8370	654	9024	18964	47.58%	14.26%	20	25
15	屏東縣恆春鎮	2018-11-24T23:12:28+08:00	2217	4694	6911	576	7487	16011	46.76%	13.85%	17	25
15	屏東縣恆春鎮	2018-11-24T23:31:24+08:00	2404	5089	7493	604	8097	17144	47.23%	14.02%	18	25
15	臺南市新市區	2018-11-24T23:16:08+08:00	5374	9981	15355	957	16312	30386	53.68%	17.69%	27	27
15	臺南市新市區	2018-11-25T03:56:19+08:00	5374	9981	15355	957	16312	30386	53.68%	17.69%	27	27
15	臺南市新市區	2018-11-24T22:41:41+08:00	5374	9981	15355	957	16312	30386	53.68%	17.69%	27	27
15	臺南市新市區	2018-11-25T00:18:37+08:00	5374	9981	15355	957	16312	30386	53.68%	17.69%	27	27
15	臺南市新市區	2018-11-24T22:45:13+08:00	5374	9981	15355	957	16312	30386	53.68%	17.69%	27	27
15	臺南市新市區	2018-11-24T22:58:00+08:00	5374	9981	15355	957	16312	30386	53.68%	17.69%	27	27
15	臺南市新市區	2018-11-24T22:37:06+08:00	5374	9981	15355	957	16312	30386	53.68%	17.69%	27	27
15	臺南市新市區	2018-11-24T22:40:32+08:00	5374	9981	15355	957	16312	30386	53.68%	17.69%	27	27
15	臺南市新市區	2018-11-25T01:02:36+08:00	5374	9981	15355	957	16312	30386	53.68%	17.69%	27	27
15	臺南市新市區	2018-11-24T22:19:42+08:00	5374	9981	15355	957	16312	30386	53.68%	17.69%	27	27
15	臺南市新市區	2018-11-25T01:25:58+08:00	5374	9981	15355	957	16312	30386	53.68%	17.69%	27	27
15	臺南市新市區	2018-11-24T22:30:15+08:00	5374	9981	15355	957	16312	30386	53.68%	17.69%	27	27
15	臺南市新市區	2018-11-24T23:51:41+08:00	5374	9981	15355	957	16312	30386	53.68%	17.69%	27	27
15	臺南市新市區	2018-11-25T00:23:09+08:00	5374	9981	15355	957	16312	30386	53.68%	17.69%	27	27
15	臺南市新市區	2018-11-25T00:57:42+08:00	5374	9981	15355	957	16312	30386	53.68%	17.69%	27	27
15	臺南市新市區	2018-11-25T06:24:05+08:00	5374	9981	15355	957	16312	30386	53.68%	17.69%	27	27
15	臺南市新市區	2018-11-25T00:00:16+08:00	5374	9981	15355	957	16312	30386	53.68%	17.69%	27	27
15	臺南市新市區	2018-11-25T01:17:59+08:00	5374	9981	15355	957	16312	30386	53.68%	17.69%	27	27
15	臺南市新市區	2018-11-24T23:19:57+08:00	5374	9981	15355	957	16312	30386	53.68%	17.69%	27	27
15	臺南市新市區	2018-11-24T23:55:52+08:00	5374	9981	15355	957	16312	30386	53.68%	17.69%	27	27
15	臺南市新市區	2018-11-24T22:13:34+08:00	5196	9671	14867	929	15796	29475	53.59%	17.63%	26	27
15	臺南市新市區	2018-11-24T23:27:23+08:00	5374	9981	15355	957	16312	30386	53.68%	17.69%	27	27
15	臺南市新市區	2018-11-24T23:39:22+08:00	5374	9981	15355	957	16312	30386	53.68%	17.69%	27	27
15	臺南市新市區	2018-11-25T06:08:59+08:00	5374	9981	15355	957	16312	30386	53.68%	17.69%	27	27
15	臺南市新市區	2018-11-24T23:31:17+08:00	5374	9981	15355	957	16312	30386	53.68%	17.69%	27	27
15	臺南市新市區	2018-11-24T23:47:34+08:00	5374	9981	15355	957	16312	30386	53.68%	17.69%	27	27
15	臺南市新市區	2018-11-24T23:05:09+08:00	5374	9981	15355	957	16312	30386	53.68%	17.69%	27	27
15	臺南市新市區	2018-11-24T23:01:36+08:00	5374	9981	15355	957	16312	30386	53.68%	17.69%	27	27
15	臺南市新市區	2018-11-25T04:02:57+08:00	5374	9981	15355	957	16312	30386	53.68%	17.69%	27	27
15	臺南市新市區	2018-11-25T00:05:10+08:00	5374	9981	15355	957	16312	30386	53.68%	17.69%	27	27
15	臺南市新市區	2018-11-25T06:19:02+08:00	5374	9981	15355	957	16312	30386	53.68%	17.69%	27	27
15	臺南市新市區	2018-11-25T06:29:22+08:00	5374	9981	15355	957	16312	30386	53.68%	17.69%	27	27
15	臺南市新市區	2018-11-25T03:49:56+08:00	5374	9981	15355	957	16312	30386	53.68%	17.69%	27	27
15	臺南市新市區	2018-11-24T22:54:30+08:00	5374	9981	15355	957	16312	30386	53.68%	17.69%	27	27
15	臺南市新市區	2018-11-24T22:50:54+08:00	5374	9981	15355	957	16312	30386	53.68%	17.69%	27	27
15	臺南市新市區	2018-11-25T06:13:57+08:00	5374	9981	15355	957	16312	30386	53.68%	17.69%	27	27
15	臺南市新市區	2018-11-25T01:12:50+08:00	5374	9981	15355	957	16312	30386	53.68%	17.69%	27	27
15	臺南市新市區	2018-11-24T23:43:22+08:00	5374	9981	15355	957	16312	30386	53.68%	17.69%	27	27
15	臺南市新市區	2018-11-25T00:09:40+08:00	5374	9981	15355	957	16312	30386	53.68%	17.69%	27	27
15	臺南市新市區	2018-11-24T22:26:41+08:00	5374	9981	15355	957	16312	30386	53.68%	17.69%	27	27
15	臺南市新市區	2018-11-25T03:44:29+08:00	5374	9981	15355	957	16312	30386	53.68%	17.69%	27	27
15	臺南市新市區	2018-11-25T03:32:42+08:00	5374	9981	15355	957	16312	30386	53.68%	17.69%	27	27
15	臺南市新市區	2018-11-24T23:08:42+08:00	5374	9981	15355	957	16312	30386	53.68%	17.69%	27	27
15	臺南市新市區	2018-11-24T22:23:19+08:00	5374	9981	15355	957	16312	30386	53.68%	17.69%	27	27
15	臺南市新市區	2018-11-24T23:23:43+08:00	5374	9981	15355	957	16312	30386	53.68%	17.69%	27	27
15	臺南市新市區	2018-11-25T00:14:15+08:00	5374	9981	15355	957	16312	30386	53.68%	17.69%	27	27
15	臺南市新市區	2018-11-24T23:35:15+08:00	5374	9981	15355	957	16312	30386	53.68%	17.69%	27	27
15	臺南市新市區	2018-11-24T22:33:43+08:00	5374	9981	15355	957	16312	30386	53.68%	17.69%	27	27
15	臺南市新市區	2018-11-25T03:39:00+08:00	5374	9981	15355	957	16312	30386	53.68%	17.69%	27	27
15	臺南市新市區	2018-11-24T23:12:21+08:00	5374	9981	15355	957	16312	30386	53.68%	17.69%	27	27
15	臺南市新市區	2018-11-24T22:16:16+08:00	5374	9981	15355	957	16312	30386	53.68%	17.69%	27	27
15	臺南市新市區	2018-11-25T01:07:31+08:00	5374	9981	15355	957	16312	30386	53.68%	17.69%	27	27
15	屏東縣竹田鄉	2018-11-24T22:58:06+08:00	2967	4470	7437	750	8187	14126	57.96%	21%	15	16
15	屏東縣竹田鄉	2018-11-25T06:19:08+08:00	3162	4856	8018	812	8830	15353	57.51%	20.6%	16	16
15	屏東縣竹田鄉	2018-11-24T23:39:30+08:00	2967	4470	7437	750	8187	14126	57.96%	21%	15	16
15	屏東縣竹田鄉	2018-11-24T22:54:35+08:00	2967	4470	7437	750	8187	14126	57.96%	21%	15	16
15	屏東縣竹田鄉	2018-11-24T22:41:48+08:00	2337	3846	6183	636	6819	11675	58.41%	20.02%	13	16
15	屏東縣竹田鄉	2018-11-24T23:05:14+08:00	2967	4470	7437	750	8187	14126	57.96%	21%	15	16
15	屏東縣竹田鄉	2018-11-25T06:29:29+08:00	3162	4856	8018	812	8830	15353	57.51%	20.6%	16	16
15	屏東縣竹田鄉	2018-11-25T01:18:07+08:00	3162	4856	8018	812	8830	15353	57.51%	20.6%	16	16
15	屏東縣竹田鄉	2018-11-24T23:43:28+08:00	2967	4470	7437	750	8187	14126	57.96%	21%	15	16
15	屏東縣竹田鄉	2018-11-25T06:09:07+08:00	3162	4856	8018	812	8830	15353	57.51%	20.6%	16	16
15	屏東縣竹田鄉	2018-11-24T22:13:42+08:00	1384	1733	3117	331	3448	5645	61.08%	24.52%	7	16
15	屏東縣竹田鄉	2018-11-24T23:51:46+08:00	2967	4470	7437	750	8187	14126	57.96%	21%	15	16
15	屏東縣竹田鄉	2018-11-25T06:24:11+08:00	3162	4856	8018	812	8830	15353	57.51%	20.6%	16	16
15	屏東縣竹田鄉	2018-11-24T23:08:49+08:00	2967	4470	7437	750	8187	14126	57.96%	21%	15	16
15	屏東縣竹田鄉	2018-11-24T22:51:01+08:00	2967	4470	7437	750	8187	14126	57.96%	21%	15	16
15	屏東縣竹田鄉	2018-11-25T03:44:38+08:00	3162	4856	8018	812	8830	15353	57.51%	20.6%	16	16
15	屏東縣竹田鄉	2018-11-25T00:23:15+08:00	3162	4856	8018	812	8830	15353	57.51%	20.6%	16	16
15	屏東縣竹田鄉	2018-11-24T23:23:49+08:00	2967	4470	7437	750	8187	14126	57.96%	21%	15	16
15	屏東縣竹田鄉	2018-11-24T22:37:12+08:00	2123	3298	5421	556	5977	10172	58.76%	20.87%	12	16
15	屏東縣竹田鄉	2018-11-24T23:16:14+08:00	2967	4470	7437	750	8187	14126	57.96%	21%	15	16
15	屏東縣竹田鄉	2018-11-24T23:35:20+08:00	2967	4470	7437	750	8187	14126	57.96%	21%	15	16
15	屏東縣竹田鄉	2018-11-25T01:26:05+08:00	3162	4856	8018	812	8830	15353	57.51%	20.6%	16	16
15	屏東縣竹田鄉	2018-11-25T03:39:05+08:00	3162	4856	8018	812	8830	15353	57.51%	20.6%	16	16
15	屏東縣竹田鄉	2018-11-24T22:33:48+08:00	2123	3298	5421	556	5977	10172	58.76%	20.87%	12	16
15	屏東縣竹田鄉	2018-11-24T22:16:23+08:00	1485	1923	3408	362	3770	6149	61.31%	24.15%	8	16
15	屏東縣竹田鄉	2018-11-25T00:14:21+08:00	3162	4856	8018	812	8830	15353	57.51%	20.6%	16	16
15	屏東縣竹田鄉	2018-11-25T01:12:56+08:00	3162	4856	8018	812	8830	15353	57.51%	20.6%	16	16
15	屏東縣竹田鄉	2018-11-24T23:01:43+08:00	2967	4470	7437	750	8187	14126	57.96%	21%	15	16
15	屏東縣竹田鄉	2018-11-24T22:26:47+08:00	1933	2873	4806	507	5313	8943	59.41%	21.61%	11	16
15	屏東縣竹田鄉	2018-11-25T03:56:25+08:00	3162	4856	8018	812	8830	15353	57.51%	20.6%	16	16
15	屏東縣竹田鄉	2018-11-24T23:47:41+08:00	2967	4470	7437	750	8187	14126	57.96%	21%	15	16
15	屏東縣竹田鄉	2018-11-24T22:45:18+08:00	2506	4255	6761	687	7448	12867	57.88%	19.48%	14	16
15	屏東縣竹田鄉	2018-11-25T00:09:47+08:00	3162	4856	8018	812	8830	15353	57.51%	20.6%	16	16
15	屏東縣竹田鄉	2018-11-25T00:05:16+08:00	2967	4470	7437	750	8187	14126	57.96%	21%	15	16
15	屏東縣竹田鄉	2018-11-24T22:19:48+08:00	1743	2478	4221	436	4657	7809	59.64%	22.32%	10	16
15	屏東縣竹田鄉	2018-11-24T22:30:21+08:00	1933	2873	4806	507	5313	8943	59.41%	21.61%	11	16
15	屏東縣竹田鄉	2018-11-25T03:32:50+08:00	3162	4856	8018	812	8830	15353	57.51%	20.6%	16	16
15	屏東縣竹田鄉	2018-11-24T22:40:38+08:00	2337	3846	6183	636	6819	11675	58.41%	20.02%	13	16
15	屏東縣竹田鄉	2018-11-25T04:03:03+08:00	3162	4856	8018	812	8830	15353	57.51%	20.6%	16	16
15	屏東縣竹田鄉	2018-11-25T00:57:48+08:00	3162	4856	8018	812	8830	15353	57.51%	20.6%	16	16
15	屏東縣竹田鄉	2018-11-24T23:27:28+08:00	2967	4470	7437	750	8187	14126	57.96%	21%	15	16
15	屏東縣竹田鄉	2018-11-25T01:02:42+08:00	3162	4856	8018	812	8830	15353	57.51%	20.6%	16	16
15	屏東縣竹田鄉	2018-11-25T06:14:03+08:00	3162	4856	8018	812	8830	15353	57.51%	20.6%	16	16
15	屏東縣竹田鄉	2018-11-24T22:23:26+08:00	1933	2873	4806	507	5313	8943	59.41%	21.61%	11	16
15	屏東縣竹田鄉	2018-11-24T23:55:58+08:00	2967	4470	7437	750	8187	14126	57.96%	21%	15	16
15	屏東縣竹田鄉	2018-11-25T00:00:22+08:00	2967	4470	7437	750	8187	14126	57.96%	21%	15	16
15	屏東縣竹田鄉	2018-11-25T00:18:44+08:00	3162	4856	8018	812	8830	15353	57.51%	20.6%	16	16
15	屏東縣竹田鄉	2018-11-24T23:20:03+08:00	2967	4470	7437	750	8187	14126	57.96%	21%	15	16
15	屏東縣竹田鄉	2018-11-25T01:07:38+08:00	3162	4856	8018	812	8830	15353	57.51%	20.6%	16	16
15	屏東縣竹田鄉	2018-11-25T03:50:02+08:00	3162	4856	8018	812	8830	15353	57.51%	20.6%	16	16
15	屏東縣竹田鄉	2018-11-24T23:12:28+08:00	2967	4470	7437	750	8187	14126	57.96%	21%	15	16
15	屏東縣竹田鄉	2018-11-24T23:31:24+08:00	2967	4470	7437	750	8187	14126	57.96%	21%	15	16
15	臺南市龍崎區	2018-11-24T23:16:08+08:00	485	1167	1652	150	1802	3713	48.53%	13.06%	8	8
15	臺南市龍崎區	2018-11-25T03:56:19+08:00	485	1167	1652	150	1802	3713	48.53%	13.06%	8	8
15	臺南市龍崎區	2018-11-25T00:18:37+08:00	485	1167	1652	150	1802	3713	48.53%	13.06%	8	8
15	臺南市龍崎區	2018-11-24T22:45:13+08:00	485	1167	1652	150	1802	3713	48.53%	13.06%	8	8
15	臺南市龍崎區	2018-11-24T22:58:00+08:00	485	1167	1652	150	1802	3713	48.53%	13.06%	8	8
15	臺南市龍崎區	2018-11-24T22:26:42+08:00	485	1167	1652	150	1802	3713	48.53%	13.06%	8	8
15	臺南市龍崎區	2018-11-25T01:18:00+08:00	485	1167	1652	150	1802	3713	48.53%	13.06%	8	8
15	臺南市龍崎區	2018-11-24T22:37:06+08:00	485	1167	1652	150	1802	3713	48.53%	13.06%	8	8
15	臺南市龍崎區	2018-11-25T06:09:00+08:00	485	1167	1652	150	1802	3713	48.53%	13.06%	8	8
15	臺南市龍崎區	2018-11-25T00:57:43+08:00	485	1167	1652	150	1802	3713	48.53%	13.06%	8	8
15	臺南市龍崎區	2018-11-24T22:19:42+08:00	485	1167	1652	150	1802	3713	48.53%	13.06%	8	8
15	臺南市龍崎區	2018-11-25T01:25:58+08:00	485	1167	1652	150	1802	3713	48.53%	13.06%	8	8
15	臺南市龍崎區	2018-11-24T22:30:15+08:00	485	1167	1652	150	1802	3713	48.53%	13.06%	8	8
15	臺南市龍崎區	2018-11-25T01:02:37+08:00	485	1167	1652	150	1802	3713	48.53%	13.06%	8	8
15	臺南市龍崎區	2018-11-24T22:40:33+08:00	485	1167	1652	150	1802	3713	48.53%	13.06%	8	8
15	臺南市龍崎區	2018-11-24T23:51:41+08:00	485	1167	1652	150	1802	3713	48.53%	13.06%	8	8
15	臺南市龍崎區	2018-11-25T00:23:09+08:00	485	1167	1652	150	1802	3713	48.53%	13.06%	8	8
15	臺南市龍崎區	2018-11-25T00:00:16+08:00	485	1167	1652	150	1802	3713	48.53%	13.06%	8	8
15	臺南市龍崎區	2018-11-24T22:13:35+08:00	485	1167	1652	150	1802	3713	48.53%	13.06%	8	8
15	臺南市龍崎區	2018-11-24T23:55:52+08:00	485	1167	1652	150	1802	3713	48.53%	13.06%	8	8
15	臺南市龍崎區	2018-11-24T23:19:58+08:00	485	1167	1652	150	1802	3713	48.53%	13.06%	8	8
15	臺南市龍崎區	2018-11-24T23:27:23+08:00	485	1167	1652	150	1802	3713	48.53%	13.06%	8	8
15	臺南市龍崎區	2018-11-25T03:44:30+08:00	485	1167	1652	150	1802	3713	48.53%	13.06%	8	8
15	臺南市龍崎區	2018-11-24T23:01:37+08:00	485	1167	1652	150	1802	3713	48.53%	13.06%	8	8
15	臺南市龍崎區	2018-11-25T04:02:58+08:00	485	1167	1652	150	1802	3713	48.53%	13.06%	8	8
15	臺南市龍崎區	2018-11-25T00:14:16+08:00	485	1167	1652	150	1802	3713	48.53%	13.06%	8	8
15	臺南市龍崎區	2018-11-24T23:35:16+08:00	485	1167	1652	150	1802	3713	48.53%	13.06%	8	8
15	臺南市龍崎區	2018-11-24T23:31:18+08:00	485	1167	1652	150	1802	3713	48.53%	13.06%	8	8
15	臺南市龍崎區	2018-11-24T23:39:23+08:00	485	1167	1652	150	1802	3713	48.53%	13.06%	8	8
15	臺南市龍崎區	2018-11-25T01:07:32+08:00	485	1167	1652	150	1802	3713	48.53%	13.06%	8	8
15	臺南市龍崎區	2018-11-24T23:47:35+08:00	485	1167	1652	150	1802	3713	48.53%	13.06%	8	8
15	臺南市龍崎區	2018-11-24T22:41:42+08:00	485	1167	1652	150	1802	3713	48.53%	13.06%	8	8
15	臺南市龍崎區	2018-11-25T06:13:58+08:00	485	1167	1652	150	1802	3713	48.53%	13.06%	8	8
15	臺南市龍崎區	2018-11-25T00:09:41+08:00	485	1167	1652	150	1802	3713	48.53%	13.06%	8	8
15	臺南市龍崎區	2018-11-25T03:49:56+08:00	485	1167	1652	150	1802	3713	48.53%	13.06%	8	8
15	臺南市龍崎區	2018-11-24T22:54:30+08:00	485	1167	1652	150	1802	3713	48.53%	13.06%	8	8
15	臺南市龍崎區	2018-11-24T22:50:54+08:00	485	1167	1652	150	1802	3713	48.53%	13.06%	8	8
15	臺南市龍崎區	2018-11-25T01:12:50+08:00	485	1167	1652	150	1802	3713	48.53%	13.06%	8	8
15	臺南市龍崎區	2018-11-24T23:43:22+08:00	485	1167	1652	150	1802	3713	48.53%	13.06%	8	8
15	臺南市龍崎區	2018-11-25T06:29:23+08:00	485	1167	1652	150	1802	3713	48.53%	13.06%	8	8
15	臺南市龍崎區	2018-11-24T23:05:10+08:00	485	1167	1652	150	1802	3713	48.53%	13.06%	8	8
15	臺南市龍崎區	2018-11-25T06:19:03+08:00	485	1167	1652	150	1802	3713	48.53%	13.06%	8	8
15	臺南市龍崎區	2018-11-25T00:05:11+08:00	485	1167	1652	150	1802	3713	48.53%	13.06%	8	8
15	臺南市龍崎區	2018-11-25T06:24:06+08:00	485	1167	1652	150	1802	3713	48.53%	13.06%	8	8
15	臺南市龍崎區	2018-11-24T23:08:43+08:00	485	1167	1652	150	1802	3713	48.53%	13.06%	8	8
15	臺南市龍崎區	2018-11-24T22:23:20+08:00	485	1167	1652	150	1802	3713	48.53%	13.06%	8	8
15	臺南市龍崎區	2018-11-25T03:32:42+08:00	485	1167	1652	150	1802	3713	48.53%	13.06%	8	8
15	臺南市龍崎區	2018-11-24T23:23:43+08:00	485	1167	1652	150	1802	3713	48.53%	13.06%	8	8
15	臺南市龍崎區	2018-11-24T22:33:43+08:00	485	1167	1652	150	1802	3713	48.53%	13.06%	8	8
15	臺南市龍崎區	2018-11-24T22:16:17+08:00	485	1167	1652	150	1802	3713	48.53%	13.06%	8	8
15	臺南市龍崎區	2018-11-25T03:39:00+08:00	485	1167	1652	150	1802	3713	48.53%	13.06%	8	8
15	臺南市龍崎區	2018-11-24T23:12:21+08:00	485	1167	1652	150	1802	3713	48.53%	13.06%	8	8
15	桃園市大園區	2018-11-24T23:16:06+08:00	7959	16581	24540	1384	25924	51516	50.32%	15.45%	36	50
15	桃園市大園區	2018-11-24T23:43:20+08:00	8689	18112	26801	1502	28303	56341	50.24%	15.42%	39	50
15	桃園市大園區	2018-11-25T06:19:00+08:00	11444	23644	35088	1798	36886	73900	49.91%	15.49%	50	50
15	桃園市大園區	2018-11-25T06:29:20+08:00	11444	23644	35088	1798	36886	73900	49.91%	15.49%	50	50
15	桃園市大園區	2018-11-25T03:49:54+08:00	11444	23644	35088	1798	36886	73900	49.91%	15.49%	50	50
15	桃園市大園區	2018-11-25T03:56:16+08:00	11444	23644	35088	1798	36886	73900	49.91%	15.49%	50	50
15	桃園市大園區	2018-11-25T01:07:29+08:00	11444	23644	35088	1798	36886	73900	49.91%	15.49%	50	50
15	桃園市大園區	2018-11-24T22:30:13+08:00	5579	11817	17396	985	18381	36463	50.41%	15.3%	26	50
15	桃園市大園區	2018-11-25T06:24:03+08:00	11444	23644	35088	1798	36886	73900	49.91%	15.49%	50	50
15	桃園市大園區	2018-11-25T03:32:38+08:00	11444	23644	35088	1798	36886	73900	49.91%	15.49%	50	50
15	桃園市大園區	2018-11-25T01:25:56+08:00	11444	23644	35088	1798	36886	73900	49.91%	15.49%	50	50
15	桃園市大園區	2018-11-25T00:23:07+08:00	10968	22606	33574	1733	35307	70946	49.77%	15.46%	48	50
15	桃園市大園區	2018-11-24T23:51:39+08:00	9136	19052	28188	1550	29738	59566	49.92%	15.34%	41	50
15	桃園市大園區	2018-11-24T22:13:32+08:00	4884	10307	15191	854	16045	32290	49.69%	15.13%	23	50
15	桃園市大園區	2018-11-24T23:23:41+08:00	7959	16581	24540	1384	25924	51516	50.32%	15.45%	36	50
15	桃園市大園區	2018-11-25T01:17:57+08:00	11444	23644	35088	1798	36886	73900	49.91%	15.49%	50	50
15	桃園市大園區	2018-11-24T23:08:40+08:00	7199	15139	22338	1259	23597	46781	50.44%	15.39%	33	50
15	桃園市大園區	2018-11-24T22:57:58+08:00	6774	14279	21053	1200	22253	44058	50.51%	15.38%	31	50
15	桃園市大園區	2018-11-25T06:08:57+08:00	11444	23644	35088	1798	36886	73900	49.91%	15.49%	50	50
15	桃園市大園區	2018-11-24T22:54:29+08:00	6774	14279	21053	1200	22253	44058	50.51%	15.38%	31	50
15	桃園市大園區	2018-11-25T01:12:47+08:00	11444	23644	35088	1798	36886	73900	49.91%	15.49%	50	50
15	桃園市大園區	2018-11-24T22:16:14+08:00	5116	10802	15918	912	16830	33704	49.93%	15.18%	24	50
15	桃園市大園區	2018-11-25T00:05:08+08:00	9689	20103	29792	1578	31370	62917	49.86%	15.4%	43	50
15	桃園市大園區	2018-11-24T23:05:07+08:00	6985	14680	21665	1235	22900	45384	50.46%	15.39%	32	50
15	桃園市大園區	2018-11-25T04:02:56+08:00	11444	23644	35088	1798	36886	73900	49.91%	15.49%	50	50
15	桃園市大園區	2018-11-24T22:33:41+08:00	5808	12374	18182	1043	19225	38113	50.44%	15.24%	27	50
15	桃園市大園區	2018-11-24T23:47:32+08:00	8893	18540	27433	1522	28955	57929	49.98%	15.35%	40	50
15	桃園市大園區	2018-11-24T22:41:39+08:00	6307	13361	19668	1120	20788	41342	50.28%	15.26%	29	50
15	桃園市大園區	2018-11-24T22:37:04+08:00	6307	13361	19668	1120	20788	41342	50.28%	15.26%	29	50
15	桃園市大園區	2018-11-25T00:18:34+08:00	10968	22606	33574	1733	35307	70946	49.77%	15.46%	48	50
15	桃園市大園區	2018-11-24T22:50:52+08:00	6774	14279	21053	1200	22253	44058	50.51%	15.38%	31	50
15	桃園市大園區	2018-11-25T06:13:56+08:00	11444	23644	35088	1798	36886	73900	49.91%	15.49%	50	50
15	桃園市大園區	2018-11-24T22:26:40+08:00	5579	11817	17396	985	18381	36463	50.41%	15.3%	26	50
15	桃園市大園區	2018-11-24T22:45:11+08:00	6533	13759	20292	1143	21435	42603	50.31%	15.33%	30	50
15	桃園市大園區	2018-11-25T00:57:40+08:00	11444	23644	35088	1798	36886	73900	49.91%	15.49%	50	50
15	桃園市大園區	2018-11-24T22:40:31+08:00	6307	13361	19668	1120	20788	41342	50.28%	15.26%	29	50
15	桃園市大園區	2018-11-25T03:44:27+08:00	11444	23644	35088	1798	36886	73900	49.91%	15.49%	50	50
15	桃園市大園區	2018-11-24T22:19:40+08:00	5116	10802	15918	912	16830	33704	49.93%	15.18%	24	50
15	桃園市大園區	2018-11-25T01:02:34+08:00	11444	23644	35088	1798	36886	73900	49.91%	15.49%	50	50
15	桃園市大園區	2018-11-25T03:38:58+08:00	11444	23644	35088	1798	36886	73900	49.91%	15.49%	50	50
15	桃園市大園區	2018-11-24T23:27:21+08:00	8156	17061	25217	1421	26638	52935	50.32%	15.41%	37	50
15	桃園市大園區	2018-11-24T23:55:50+08:00	9136	19052	28188	1550	29738	59566	49.92%	15.34%	41	50
15	桃園市大園區	2018-11-24T22:23:17+08:00	5579	11817	17396	985	18381	36463	50.41%	15.3%	26	50
15	桃園市大園區	2018-11-24T23:19:55+08:00	7959	16581	24540	1384	25924	51516	50.32%	15.45%	36	50
15	桃園市大園區	2018-11-25T00:00:14+08:00	9405	19549	28954	1568	30522	61267	49.82%	15.35%	42	50
15	桃園市大園區	2018-11-25T00:09:38+08:00	10002	20636	30638	1617	32255	64473	50.03%	15.51%	44	50
15	桃園市大園區	2018-11-24T23:01:34+08:00	6985	14680	21665	1235	22900	45384	50.46%	15.39%	32	50
15	桃園市大園區	2018-11-24T23:35:14+08:00	8156	17061	25217	1421	26638	52935	50.32%	15.41%	37	50
15	桃園市大園區	2018-11-25T00:14:13+08:00	10287	21090	31377	1637	33014	65963	50.05%	15.6%	45	50
15	桃園市大園區	2018-11-24T23:12:19+08:00	7451	15658	23109	1294	24403	48468	50.35%	15.37%	34	50
15	桃園市大園區	2018-11-24T23:31:15+08:00	8156	17061	25217	1421	26638	52935	50.32%	15.41%	37	50
15	桃園市大園區	2018-11-24T23:39:20+08:00	8429	17583	26012	1451	27463	54779	50.13%	15.39%	38	50
15	新竹縣北埔鄉	2018-11-24T22:26:43+08:00	960	2137	3097	173	3270	5764	56.73%	16.66%	8	10
15	新竹縣北埔鄉	2018-11-25T03:56:21+08:00	1549	2847	4396	238	4634	8180	56.65%	18.94%	10	10
15	新竹縣北埔鄉	2018-11-25T01:12:52+08:00	1549	2847	4396	238	4634	8180	56.65%	18.94%	10	10
15	新竹縣北埔鄉	2018-11-24T22:54:32+08:00	960	2137	3097	173	3270	5764	56.73%	16.66%	8	10
15	新竹縣北埔鄉	2018-11-24T22:50:56+08:00	960	2137	3097	173	3270	5764	56.73%	16.66%	8	10
15	新竹縣北埔鄉	2018-11-25T00:09:43+08:00	1549	2847	4396	238	4634	8180	56.65%	18.94%	10	10
15	新竹縣北埔鄉	2018-11-25T00:05:12+08:00	1549	2847	4396	238	4634	8180	56.65%	18.94%	10	10
15	新竹縣北埔鄉	2018-11-24T22:37:08+08:00	960	2137	3097	173	3270	5764	56.73%	16.66%	8	10
15	新竹縣北埔鄉	2018-11-24T22:45:15+08:00	960	2137	3097	173	3270	5764	56.73%	16.66%	8	10
15	新竹縣北埔鄉	2018-11-25T01:02:38+08:00	1549	2847	4396	238	4634	8180	56.65%	18.94%	10	10
15	新竹縣北埔鄉	2018-11-24T22:40:34+08:00	960	2137	3097	173	3270	5764	56.73%	16.66%	8	10
15	新竹縣北埔鄉	2018-11-25T04:03:00+08:00	1549	2847	4396	238	4634	8180	56.65%	18.94%	10	10
15	新竹縣北埔鄉	2018-11-25T00:57:45+08:00	1549	2847	4396	238	4634	8180	56.65%	18.94%	10	10
15	新竹縣北埔鄉	2018-11-24T22:19:44+08:00	960	2137	3097	173	3270	5764	56.73%	16.66%	8	10
15	新竹縣北埔鄉	2018-11-25T06:14:00+08:00	1549	2847	4396	238	4634	8180	56.65%	18.94%	10	10
15	新竹縣北埔鄉	2018-11-25T00:00:18+08:00	1549	2847	4396	238	4634	8180	56.65%	18.94%	10	10
15	新竹縣北埔鄉	2018-11-24T23:55:54+08:00	1549	2847	4396	238	4634	8180	56.65%	18.94%	10	10
15	新竹縣北埔鄉	2018-11-24T23:27:25+08:00	960	2137	3097	173	3270	5764	56.73%	16.66%	8	10
15	新竹縣北埔鄉	2018-11-24T22:23:22+08:00	960	2137	3097	173	3270	5764	56.73%	16.66%	8	10
15	新竹縣北埔鄉	2018-11-24T23:01:39+08:00	960	2137	3097	173	3270	5764	56.73%	16.66%	8	10
15	新竹縣北埔鄉	2018-11-24T23:39:25+08:00	1263	2260	3523	183	3706	6527	56.78%	19.35%	9	10
15	新竹縣北埔鄉	2018-11-24T23:20:00+08:00	960	2137	3097	173	3270	5764	56.73%	16.66%	8	10
15	新竹縣北埔鄉	2018-11-25T01:07:34+08:00	1549	2847	4396	238	4634	8180	56.65%	18.94%	10	10
15	新竹縣北埔鄉	2018-11-24T23:12:24+08:00	960	2137	3097	173	3270	5764	56.73%	16.66%	8	10
15	新竹縣北埔鄉	2018-11-25T00:18:40+08:00	1549	2847	4396	238	4634	8180	56.65%	18.94%	10	10
15	新竹縣北埔鄉	2018-11-25T03:39:02+08:00	1549	2847	4396	238	4634	8180	56.65%	18.94%	10	10
15	新竹縣北埔鄉	2018-11-24T23:31:20+08:00	1263	2260	3523	183	3706	6527	56.78%	19.35%	9	10
15	新竹縣北埔鄉	2018-11-24T23:35:17+08:00	1263	2260	3523	183	3706	6527	56.78%	19.35%	9	10
15	新竹縣北埔鄉	2018-11-25T00:14:17+08:00	1549	2847	4396	238	4634	8180	56.65%	18.94%	10	10
15	新竹縣北埔鄉	2018-11-24T23:43:24+08:00	1263	2260	3523	183	3706	6527	56.78%	19.35%	9	10
15	新竹縣北埔鄉	2018-11-24T22:58:02+08:00	960	2137	3097	173	3270	5764	56.73%	16.66%	8	10
15	新竹縣北埔鄉	2018-11-25T03:49:58+08:00	1549	2847	4396	238	4634	8180	56.65%	18.94%	10	10
15	新竹縣北埔鄉	2018-11-25T01:18:02+08:00	1549	2847	4396	238	4634	8180	56.65%	18.94%	10	10
15	新竹縣北埔鄉	2018-11-25T06:29:25+08:00	1549	2847	4396	238	4634	8180	56.65%	18.94%	10	10
15	新竹縣北埔鄉	2018-11-24T23:05:11+08:00	960	2137	3097	173	3270	5764	56.73%	16.66%	8	10
15	新竹縣北埔鄉	2018-11-24T22:41:44+08:00	960	2137	3097	173	3270	5764	56.73%	16.66%	8	10
15	新竹縣北埔鄉	2018-11-25T06:19:04+08:00	1549	2847	4396	238	4634	8180	56.65%	18.94%	10	10
15	新竹縣北埔鄉	2018-11-24T22:30:17+08:00	960	2137	3097	173	3270	5764	56.73%	16.66%	8	10
15	新竹縣北埔鄉	2018-11-25T06:24:08+08:00	1549	2847	4396	238	4634	8180	56.65%	18.94%	10	10
15	新竹縣北埔鄉	2018-11-24T23:51:42+08:00	1549	2847	4396	238	4634	8180	56.65%	18.94%	10	10
15	新竹縣北埔鄉	2018-11-25T06:09:02+08:00	1549	2847	4396	238	4634	8180	56.65%	18.94%	10	10
15	新竹縣北埔鄉	2018-11-24T23:23:45+08:00	960	2137	3097	173	3270	5764	56.73%	16.66%	8	10
15	新竹縣北埔鄉	2018-11-25T03:44:32+08:00	1549	2847	4396	238	4634	8180	56.65%	18.94%	10	10
15	新竹縣北埔鄉	2018-11-25T03:32:45+08:00	1549	2847	4396	238	4634	8180	56.65%	18.94%	10	10
15	新竹縣北埔鄉	2018-11-24T22:13:38+08:00	960	2137	3097	173	3270	5764	56.73%	16.66%	8	10
15	新竹縣北埔鄉	2018-11-24T23:08:45+08:00	960	2137	3097	173	3270	5764	56.73%	16.66%	8	10
15	新竹縣北埔鄉	2018-11-25T00:23:11+08:00	1549	2847	4396	238	4634	8180	56.65%	18.94%	10	10
15	新竹縣北埔鄉	2018-11-24T23:16:10+08:00	960	2137	3097	173	3270	5764	56.73%	16.66%	8	10
15	新竹縣北埔鄉	2018-11-24T23:47:37+08:00	1549	2847	4396	238	4634	8180	56.65%	18.94%	10	10
15	新竹縣北埔鄉	2018-11-24T22:16:19+08:00	960	2137	3097	173	3270	5764	56.73%	16.66%	8	10
15	新竹縣北埔鄉	2018-11-25T01:26:00+08:00	1549	2847	4396	238	4634	8180	56.65%	18.94%	10	10
15	新竹縣北埔鄉	2018-11-24T22:33:45+08:00	960	2137	3097	173	3270	5764	56.73%	16.66%	8	10
15	澎湖縣望安鄉	2018-11-25T03:56:28+08:00	487	1186	1673	167	1840	4628	39.76%	10.52%	10	10
15	澎湖縣望安鄉	2018-11-24T23:47:43+08:00	487	1186	1673	167	1840	4628	39.76%	10.52%	10	10
15	澎湖縣望安鄉	2018-11-24T22:58:09+08:00	429	1049	1478	166	1644	4152	39.6%	10.33%	9	10
15	澎湖縣望安鄉	2018-11-24T23:56:01+08:00	487	1186	1673	167	1840	4628	39.76%	10.52%	10	10
15	澎湖縣望安鄉	2018-11-24T23:01:46+08:00	429	1049	1478	166	1644	4152	39.6%	10.33%	9	10
15	澎湖縣望安鄉	2018-11-24T23:12:30+08:00	429	1049	1478	166	1644	4152	39.6%	10.33%	9	10
15	澎湖縣望安鄉	2018-11-25T03:32:53+08:00	487	1186	1673	167	1840	4628	39.76%	10.52%	10	10
15	澎湖縣望安鄉	2018-11-24T23:51:49+08:00	487	1186	1673	167	1840	4628	39.76%	10.52%	10	10
15	澎湖縣望安鄉	2018-11-24T22:13:45+08:00	316	765	1081	110	1191	3117	38.21%	10.14%	6	10
15	澎湖縣望安鄉	2018-11-25T03:44:41+08:00	487	1186	1673	167	1840	4628	39.76%	10.52%	10	10
15	澎湖縣望安鄉	2018-11-25T04:03:06+08:00	487	1186	1673	167	1840	4628	39.76%	10.52%	10	10
15	澎湖縣望安鄉	2018-11-24T23:27:31+08:00	429	1049	1478	166	1644	4152	39.6%	10.33%	9	10
15	澎湖縣望安鄉	2018-11-24T22:30:23+08:00	429	1049	1478	166	1644	4152	39.6%	10.33%	9	10
15	澎湖縣望安鄉	2018-11-25T00:57:51+08:00	487	1186	1673	167	1840	4628	39.76%	10.52%	10	10
15	澎湖縣望安鄉	2018-11-24T22:19:50+08:00	316	765	1081	110	1191	3117	38.21%	10.14%	6	10
15	澎湖縣望安鄉	2018-11-25T00:09:50+08:00	487	1186	1673	167	1840	4628	39.76%	10.52%	10	10
15	澎湖縣望安鄉	2018-11-25T00:18:47+08:00	487	1186	1673	167	1840	4628	39.76%	10.52%	10	10
15	澎湖縣望安鄉	2018-11-24T22:37:14+08:00	429	1049	1478	166	1644	4152	39.6%	10.33%	9	10
15	澎湖縣望安鄉	2018-11-24T23:20:08+08:00	429	1049	1478	166	1644	4152	39.6%	10.33%	9	10
15	澎湖縣望安鄉	2018-11-24T23:31:27+08:00	429	1049	1478	166	1644	4152	39.6%	10.33%	9	10
15	澎湖縣望安鄉	2018-11-24T22:45:21+08:00	429	1049	1478	166	1644	4152	39.6%	10.33%	9	10
15	澎湖縣望安鄉	2018-11-24T22:33:51+08:00	429	1049	1478	166	1644	4152	39.6%	10.33%	9	10
15	澎湖縣望安鄉	2018-11-24T23:39:33+08:00	487	1186	1673	167	1840	4628	39.76%	10.52%	10	10
15	澎湖縣望安鄉	2018-11-24T23:05:16+08:00	429	1049	1478	166	1644	4152	39.6%	10.33%	9	10
15	澎湖縣望安鄉	2018-11-24T22:26:49+08:00	376	910	1286	144	1430	3588	39.86%	10.48%	7	10
15	澎湖縣望安鄉	2018-11-25T01:07:40+08:00	487	1186	1673	167	1840	4628	39.76%	10.52%	10	10
15	澎湖縣望安鄉	2018-11-24T22:54:37+08:00	429	1049	1478	166	1644	4152	39.6%	10.33%	9	10
15	澎湖縣望安鄉	2018-11-25T01:12:59+08:00	487	1186	1673	167	1840	4628	39.76%	10.52%	10	10
15	澎湖縣望安鄉	2018-11-25T00:05:18+08:00	487	1186	1673	167	1840	4628	39.76%	10.52%	10	10
15	澎湖縣望安鄉	2018-11-24T23:08:51+08:00	429	1049	1478	166	1644	4152	39.6%	10.33%	9	10
15	澎湖縣望安鄉	2018-11-24T23:23:51+08:00	429	1049	1478	166	1644	4152	39.6%	10.33%	9	10
15	澎湖縣望安鄉	2018-11-24T22:23:29+08:00	316	765	1081	110	1191	3117	38.21%	10.14%	6	10
15	澎湖縣望安鄉	2018-11-25T00:23:17+08:00	487	1186	1673	167	1840	4628	39.76%	10.52%	10	10
15	澎湖縣望安鄉	2018-11-25T00:00:24+08:00	487	1186	1673	167	1840	4628	39.76%	10.52%	10	10
15	澎湖縣望安鄉	2018-11-24T22:51:04+08:00	429	1049	1478	166	1644	4152	39.6%	10.33%	9	10
15	澎湖縣望安鄉	2018-11-25T06:09:10+08:00	487	1186	1673	167	1840	4628	39.76%	10.52%	10	10
15	澎湖縣望安鄉	2018-11-24T22:40:40+08:00	429	1049	1478	166	1644	4152	39.6%	10.33%	9	10
15	澎湖縣望安鄉	2018-11-25T06:24:13+08:00	487	1186	1673	167	1840	4628	39.76%	10.52%	10	10
15	澎湖縣望安鄉	2018-11-25T01:02:44+08:00	487	1186	1673	167	1840	4628	39.76%	10.52%	10	10
15	澎湖縣望安鄉	2018-11-25T06:14:05+08:00	487	1186	1673	167	1840	4628	39.76%	10.52%	10	10
15	澎湖縣望安鄉	2018-11-25T06:19:10+08:00	487	1186	1673	167	1840	4628	39.76%	10.52%	10	10
15	澎湖縣望安鄉	2018-11-24T23:35:23+08:00	487	1186	1673	167	1840	4628	39.76%	10.52%	10	10
15	澎湖縣望安鄉	2018-11-25T00:14:24+08:00	487	1186	1673	167	1840	4628	39.76%	10.52%	10	10
15	澎湖縣望安鄉	2018-11-25T01:18:10+08:00	487	1186	1673	167	1840	4628	39.76%	10.52%	10	10
15	澎湖縣望安鄉	2018-11-25T03:50:04+08:00	487	1186	1673	167	1840	4628	39.76%	10.52%	10	10
15	澎湖縣望安鄉	2018-11-24T22:16:26+08:00	316	765	1081	110	1191	3117	38.21%	10.14%	6	10
15	澎湖縣望安鄉	2018-11-24T23:43:31+08:00	487	1186	1673	167	1840	4628	39.76%	10.52%	10	10
15	澎湖縣望安鄉	2018-11-25T06:29:31+08:00	487	1186	1673	167	1840	4628	39.76%	10.52%	10	10
15	澎湖縣望安鄉	2018-11-24T23:16:16+08:00	429	1049	1478	166	1644	4152	39.6%	10.33%	9	10
15	澎湖縣望安鄉	2018-11-24T22:41:51+08:00	429	1049	1478	166	1644	4152	39.6%	10.33%	9	10
15	澎湖縣望安鄉	2018-11-25T03:39:08+08:00	487	1186	1673	167	1840	4628	39.76%	10.52%	10	10
15	澎湖縣望安鄉	2018-11-25T01:26:08+08:00	487	1186	1673	167	1840	4628	39.76%	10.52%	10	10
15	高雄市大樹區	2018-11-25T01:18:01+08:00	6166	13003	19169	1427	20596	36772	56.01%	16.77%	32	32
15	高雄市大樹區	2018-11-24T22:58:01+08:00	5818	12063	17881	1371	19252	34311	56.11%	16.96%	31	32
15	高雄市大樹區	2018-11-24T22:37:07+08:00	5818	12063	17881	1371	19252	34311	56.11%	16.96%	31	32
15	高雄市大樹區	2018-11-24T22:45:14+08:00	5818	12063	17881	1371	19252	34311	56.11%	16.96%	31	32
15	高雄市大樹區	2018-11-25T03:56:20+08:00	6166	13003	19169	1427	20596	36772	56.01%	16.77%	32	32
15	高雄市大樹區	2018-11-24T22:26:42+08:00	5818	12063	17881	1371	19252	34311	56.11%	16.96%	31	32
15	高雄市大樹區	2018-11-24T23:16:09+08:00	5818	12063	17881	1371	19252	34311	56.11%	16.96%	31	32
15	高雄市大樹區	2018-11-25T00:18:38+08:00	6166	13003	19169	1427	20596	36772	56.01%	16.77%	32	32
15	高雄市大樹區	2018-11-25T01:25:59+08:00	6166	13003	19169	1427	20596	36772	56.01%	16.77%	32	32
15	高雄市大樹區	2018-11-25T00:57:43+08:00	6166	13003	19169	1427	20596	36772	56.01%	16.77%	32	32
15	高雄市大樹區	2018-11-25T01:02:37+08:00	6166	13003	19169	1427	20596	36772	56.01%	16.77%	32	32
15	高雄市大樹區	2018-11-24T22:40:33+08:00	5818	12063	17881	1371	19252	34311	56.11%	16.96%	31	32
15	高雄市大樹區	2018-11-25T06:09:01+08:00	6166	13003	19169	1427	20596	36772	56.01%	16.77%	32	32
15	高雄市大樹區	2018-11-24T22:19:43+08:00	5748	11786	17534	1348	18882	33591	56.21%	17.11%	30	32
15	高雄市大樹區	2018-11-24T23:55:53+08:00	6166	13003	19169	1427	20596	36772	56.01%	16.77%	32	32
15	高雄市大樹區	2018-11-25T03:44:31+08:00	6166	13003	19169	1427	20596	36772	56.01%	16.77%	32	32
15	高雄市大樹區	2018-11-25T00:00:17+08:00	6166	13003	19169	1427	20596	36772	56.01%	16.77%	32	32
15	高雄市大樹區	2018-11-24T23:19:58+08:00	5818	12063	17881	1371	19252	34311	56.11%	16.96%	31	32
15	高雄市大樹區	2018-11-24T23:27:24+08:00	6166	13003	19169	1427	20596	36772	56.01%	16.77%	32	32
15	高雄市大樹區	2018-11-25T01:07:33+08:00	6166	13003	19169	1427	20596	36772	56.01%	16.77%	32	32
15	高雄市大樹區	2018-11-24T23:31:19+08:00	6166	13003	19169	1427	20596	36772	56.01%	16.77%	32	32
15	高雄市大樹區	2018-11-24T23:01:37+08:00	5818	12063	17881	1371	19252	34311	56.11%	16.96%	31	32
15	高雄市大樹區	2018-11-24T23:12:23+08:00	5818	12063	17881	1371	19252	34311	56.11%	16.96%	31	32
15	高雄市大樹區	2018-11-25T00:14:16+08:00	6166	13003	19169	1427	20596	36772	56.01%	16.77%	32	32
15	高雄市大樹區	2018-11-24T23:35:16+08:00	6166	13003	19169	1427	20596	36772	56.01%	16.77%	32	32
15	高雄市大樹區	2018-11-24T23:39:24+08:00	6166	13003	19169	1427	20596	36772	56.01%	16.77%	32	32
15	高雄市大樹區	2018-11-25T04:02:59+08:00	6166	13003	19169	1427	20596	36772	56.01%	16.77%	32	32
15	高雄市大樹區	2018-11-24T23:43:23+08:00	6166	13003	19169	1427	20596	36772	56.01%	16.77%	32	32
15	高雄市大樹區	2018-11-25T01:12:51+08:00	6166	13003	19169	1427	20596	36772	56.01%	16.77%	32	32
15	高雄市大樹區	2018-11-25T06:13:58+08:00	6166	13003	19169	1427	20596	36772	56.01%	16.77%	32	32
15	高雄市大樹區	2018-11-24T22:54:31+08:00	5818	12063	17881	1371	19252	34311	56.11%	16.96%	31	32
15	高雄市大樹區	2018-11-24T22:50:55+08:00	5818	12063	17881	1371	19252	34311	56.11%	16.96%	31	32
15	高雄市大樹區	2018-11-25T00:09:41+08:00	6166	13003	19169	1427	20596	36772	56.01%	16.77%	32	32
15	高雄市大樹區	2018-11-24T22:41:43+08:00	5818	12063	17881	1371	19252	34311	56.11%	16.96%	31	32
15	高雄市大樹區	2018-11-25T03:49:57+08:00	6166	13003	19169	1427	20596	36772	56.01%	16.77%	32	32
15	高雄市大樹區	2018-11-24T23:05:10+08:00	5818	12063	17881	1371	19252	34311	56.11%	16.96%	31	32
15	高雄市大樹區	2018-11-25T06:19:03+08:00	6166	13003	19169	1427	20596	36772	56.01%	16.77%	32	32
15	高雄市大樹區	2018-11-25T06:29:24+08:00	6166	13003	19169	1427	20596	36772	56.01%	16.77%	32	32
15	高雄市大樹區	2018-11-25T00:05:11+08:00	6166	13003	19169	1427	20596	36772	56.01%	16.77%	32	32
15	高雄市大樹區	2018-11-25T06:24:06+08:00	6166	13003	19169	1427	20596	36772	56.01%	16.77%	32	32
15	高雄市大樹區	2018-11-24T22:30:16+08:00	5818	12063	17881	1371	19252	34311	56.11%	16.96%	31	32
15	高雄市大樹區	2018-11-24T23:51:42+08:00	6166	13003	19169	1427	20596	36772	56.01%	16.77%	32	32
15	高雄市大樹區	2018-11-24T22:13:36+08:00	5748	11786	17534	1348	18882	33591	56.21%	17.11%	30	32
15	高雄市大樹區	2018-11-24T23:08:43+08:00	5818	12063	17881	1371	19252	34311	56.11%	16.96%	31	32
15	高雄市大樹區	2018-11-25T00:23:10+08:00	6166	13003	19169	1427	20596	36772	56.01%	16.77%	32	32
15	高雄市大樹區	2018-11-24T22:23:21+08:00	5748	11786	17534	1348	18882	33591	56.21%	17.11%	30	32
15	高雄市大樹區	2018-11-25T03:32:43+08:00	6166	13003	19169	1427	20596	36772	56.01%	16.77%	32	32
15	高雄市大樹區	2018-11-24T23:23:44+08:00	5818	12063	17881	1371	19252	34311	56.11%	16.96%	31	32
15	高雄市大樹區	2018-11-24T22:33:44+08:00	5818	12063	17881	1371	19252	34311	56.11%	16.96%	31	32
15	高雄市大樹區	2018-11-24T23:47:36+08:00	6166	13003	19169	1427	20596	36772	56.01%	16.77%	32	32
15	高雄市大樹區	2018-11-25T03:39:01+08:00	6166	13003	19169	1427	20596	36772	56.01%	16.77%	32	32
15	高雄市大樹區	2018-11-24T22:16:18+08:00	5748	11786	17534	1348	18882	33591	56.21%	17.11%	30	32
15	高雄市三民區	2018-11-24T22:58:01+08:00	33870	63109	96979	5450	102429	172516	59.37%	19.63%	122	189
15	高雄市三民區	2018-11-25T03:56:19+08:00	56856	106137	162993	8385	171378	289519	59.19%	19.64%	189	189
15	高雄市三民區	2018-11-24T22:45:14+08:00	29931	55810	85741	4903	90644	153534	59.04%	19.49%	110	189
15	高雄市三民區	2018-11-24T22:26:42+08:00	25269	47891	73160	4115	77275	130362	59.28%	19.38%	95	189
15	高雄市三民區	2018-11-25T01:18:00+08:00	56116	104813	160929	8303	169232	285904	59.19%	19.63%	187	189
15	高雄市三民區	2018-11-24T23:16:09+08:00	36226	67538	103764	5797	109561	183879	59.58%	19.7%	129	189
15	高雄市三民區	2018-11-25T00:18:38+08:00	50549	94566	145115	7562	152677	257501	59.29%	19.63%	172	189
15	高雄市三民區	2018-11-24T22:37:06+08:00	27956	52805	80761	4593	85354	144104	59.23%	19.4%	104	189
15	高雄市三民區	2018-11-25T06:09:00+08:00	56856	106137	162993	8385	171378	289519	59.19%	19.64%	189	189
15	高雄市三民區	2018-11-25T01:25:59+08:00	56116	104813	160929	8303	169232	285904	59.19%	19.63%	187	189
15	高雄市三民區	2018-11-25T00:57:43+08:00	55836	104125	159961	8246	168207	283980	59.23%	19.66%	186	189
15	高雄市三民區	2018-11-25T01:02:37+08:00	55836	104125	159961	8246	168207	283980	59.23%	19.66%	186	189
15	高雄市三民區	2018-11-24T22:40:33+08:00	28830	54052	82882	4728	87610	148356	59.05%	19.43%	107	189
15	高雄市三民區	2018-11-24T23:51:41+08:00	46540	86907	133447	7138	140585	236755	59.38%	19.66%	160	189
15	高雄市三民區	2018-11-24T22:19:43+08:00	23949	45370	69319	3928	73247	123630	59.25%	19.37%	91	189
15	高雄市三民區	2018-11-24T23:55:53+08:00	47185	88170	135355	7231	142586	240041	59.4%	19.66%	162	189
15	高雄市三民區	2018-11-25T00:00:17+08:00	47447	88693	136140	7249	143389	241447	59.39%	19.65%	163	189
15	高雄市三民區	2018-11-24T23:19:58+08:00	36592	68157	104749	5837	110586	185679	59.56%	19.71%	130	189
15	高雄市三民區	2018-11-24T23:27:24+08:00	38765	72235	111000	6116	117116	196516	59.6%	19.73%	137	189
15	高雄市三民區	2018-11-25T03:44:30+08:00	56856	106137	162993	8385	171378	289519	59.19%	19.64%	189	189
15	高雄市三民區	2018-11-24T23:01:37+08:00	34566	64417	98983	5509	104492	175874	59.41%	19.65%	124	189
15	高雄市三民區	2018-11-25T04:02:58+08:00	56856	106137	162993	8385	171378	289519	59.19%	19.64%	189	189
15	高雄市三民區	2018-11-25T00:14:16+08:00	49952	93338	143290	7497	150787	254106	59.34%	19.66%	170	189
15	高雄市三民區	2018-11-24T23:35:16+08:00	41855	78454	120309	6552	126861	213325	59.47%	19.62%	147	189
15	高雄市三民區	2018-11-24T23:12:22+08:00	35956	66945	102901	5733	108634	182406	59.56%	19.71%	128	189
15	高雄市三民區	2018-11-24T23:31:18+08:00	40796	76441	117237	6450	123687	207904	59.49%	19.62%	144	189
15	高雄市三民區	2018-11-24T23:39:23+08:00	42511	79740	122251	6626	128877	216654	59.49%	19.62%	149	189
15	高雄市三民區	2018-11-25T01:07:32+08:00	56116	104813	160929	8303	169232	285904	59.19%	19.63%	187	189
15	高雄市三民區	2018-11-24T23:47:35+08:00	45483	84879	130362	6967	137329	231299	59.37%	19.66%	157	189
15	高雄市三民區	2018-11-24T23:43:23+08:00	44348	82907	127255	6833	134088	225798	59.38%	19.64%	154	189
15	高雄市三民區	2018-11-24T22:41:42+08:00	28830	54052	82882	4728	87610	148356	59.05%	19.43%	107	189
15	高雄市三民區	2018-11-25T01:12:51+08:00	56116	104813	160929	8303	169232	285904	59.19%	19.63%	187	189
15	高雄市三民區	2018-11-25T06:13:58+08:00	56856	106137	162993	8385	171378	289519	59.19%	19.64%	189	189
15	高雄市三民區	2018-11-24T22:54:31+08:00	32994	61338	94332	5297	99629	168051	59.28%	19.63%	119	189
15	高雄市三民區	2018-11-24T22:50:55+08:00	32337	60220	92557	5240	97797	165020	59.26%	19.6%	117	189
15	高雄市三民區	2018-11-25T00:09:41+08:00	48815	91253	140068	7407	147475	248418	59.37%	19.65%	167	189
15	高雄市三民區	2018-11-25T06:29:23+08:00	56856	106137	162993	8385	171378	289519	59.19%	19.64%	189	189
15	高雄市三民區	2018-11-25T03:49:57+08:00	56856	106137	162993	8385	171378	289519	59.19%	19.64%	189	189
15	高雄市三民區	2018-11-24T23:05:10+08:00	34900	65038	99938	5575	105513	177528	59.43%	19.66%	125	189
15	高雄市三民區	2018-11-25T06:19:03+08:00	56856	106137	162993	8385	171378	289519	59.19%	19.64%	189	189
15	高雄市三民區	2018-11-25T00:05:11+08:00	47712	89231	136943	7283	144226	242874	59.38%	19.64%	164	189
15	高雄市三民區	2018-11-25T06:24:06+08:00	56856	106137	162993	8385	171378	289519	59.19%	19.64%	189	189
15	高雄市三民區	2018-11-24T22:30:16+08:00	25609	48486	74095	4163	78258	131986	59.29%	19.4%	96	189
15	高雄市三民區	2018-11-24T22:13:36+08:00	21395	40552	61947	3567	65514	109448	59.86%	19.55%	83	189
15	高雄市三民區	2018-11-24T23:08:43+08:00	35590	66277	101867	5665	107532	180722	59.5%	19.69%	127	189
15	高雄市三民區	2018-11-24T22:23:20+08:00	24356	46141	70497	3951	74448	125664	59.24%	19.38%	92	189
15	高雄市三民區	2018-11-25T00:23:10+08:00	50549	94566	145115	7562	152677	257501	59.29%	19.63%	172	189
15	高雄市三民區	2018-11-25T03:32:43+08:00	56856	106137	162993	8385	171378	289519	59.19%	19.64%	189	189
15	高雄市三民區	2018-11-24T23:23:44+08:00	38156	71167	109323	6038	115361	193478	59.62%	19.72%	135	189
15	高雄市三民區	2018-11-24T22:33:44+08:00	26527	49978	76505	4315	80820	136396	59.25%	19.45%	99	189
15	高雄市三民區	2018-11-24T22:16:17+08:00	22628	42902	65530	3758	69288	117245	59.1%	19.3%	87	189
15	高雄市三民區	2018-11-25T03:39:00+08:00	56856	106137	162993	8385	171378	289519	59.19%	19.64%	189	189
15	苗栗縣後龍鎮	2018-11-24T22:26:44+08:00	3886	8114	12000	992	12992	23885	54.39%	16.27%	28	35
15	苗栗縣後龍鎮	2018-11-25T00:05:13+08:00	5002	10779	15781	1327	17108	30948	55.28%	16.16%	35	35
15	苗栗縣後龍鎮	2018-11-24T22:54:32+08:00	4678	9999	14677	1238	15915	28799	55.26%	16.24%	33	35
15	苗栗縣後龍鎮	2018-11-25T00:09:43+08:00	5002	10779	15781	1327	17108	30948	55.28%	16.16%	35	35
15	苗栗縣後龍鎮	2018-11-24T22:37:08+08:00	4201	8938	13139	1083	14222	25902	54.91%	16.22%	30	35
15	苗栗縣後龍鎮	2018-11-24T22:45:15+08:00	4385	9274	13659	1124	14783	26785	55.19%	16.37%	31	35
15	苗栗縣後龍鎮	2018-11-24T22:50:57+08:00	4385	9274	13659	1124	14783	26785	55.19%	16.37%	31	35
15	苗栗縣後龍鎮	2018-11-25T01:12:53+08:00	5002	10779	15781	1327	17108	30948	55.28%	16.16%	35	35
15	苗栗縣後龍鎮	2018-11-24T22:40:35+08:00	4385	9274	13659	1124	14783	26785	55.19%	16.37%	31	35
15	苗栗縣後龍鎮	2018-11-25T01:02:39+08:00	5002	10779	15781	1327	17108	30948	55.28%	16.16%	35	35
15	苗栗縣後龍鎮	2018-11-25T04:03:00+08:00	5002	10779	15781	1327	17108	30948	55.28%	16.16%	35	35
15	苗栗縣後龍鎮	2018-11-25T00:57:45+08:00	5002	10779	15781	1327	17108	30948	55.28%	16.16%	35	35
15	苗栗縣後龍鎮	2018-11-24T22:19:44+08:00	3744	7797	11541	946	12487	22920	54.48%	16.34%	27	35
15	苗栗縣後龍鎮	2018-11-25T06:14:00+08:00	5002	10779	15781	1327	17108	30948	55.28%	16.16%	35	35
15	苗栗縣後龍鎮	2018-11-25T00:00:18+08:00	5002	10779	15781	1327	17108	30948	55.28%	16.16%	35	35
15	苗栗縣後龍鎮	2018-11-24T23:27:25+08:00	5002	10779	15781	1327	17108	30948	55.28%	16.16%	35	35
15	苗栗縣後龍鎮	2018-11-24T23:55:55+08:00	5002	10779	15781	1327	17108	30948	55.28%	16.16%	35	35
15	苗栗縣後龍鎮	2018-11-25T00:23:12+08:00	5002	10779	15781	1327	17108	30948	55.28%	16.16%	35	35
15	苗栗縣後龍鎮	2018-11-24T22:23:22+08:00	3886	8114	12000	992	12992	23885	54.39%	16.27%	28	35
15	苗栗縣後龍鎮	2018-11-24T23:01:39+08:00	4678	9999	14677	1238	15915	28799	55.26%	16.24%	33	35
15	苗栗縣後龍鎮	2018-11-24T23:20:00+08:00	5002	10779	15781	1327	17108	30948	55.28%	16.16%	35	35
15	苗栗縣後龍鎮	2018-11-25T01:07:34+08:00	5002	10779	15781	1327	17108	30948	55.28%	16.16%	35	35
15	苗栗縣後龍鎮	2018-11-24T23:35:18+08:00	5002	10779	15781	1327	17108	30948	55.28%	16.16%	35	35
15	苗栗縣後龍鎮	2018-11-25T00:18:40+08:00	5002	10779	15781	1327	17108	30948	55.28%	16.16%	35	35
15	苗栗縣後龍鎮	2018-11-25T00:14:18+08:00	5002	10779	15781	1327	17108	30948	55.28%	16.16%	35	35
15	苗栗縣後龍鎮	2018-11-24T23:12:25+08:00	4880	10418	15298	1282	16580	29912	55.43%	16.31%	34	35
15	苗栗縣後龍鎮	2018-11-25T03:39:02+08:00	5002	10779	15781	1327	17108	30948	55.28%	16.16%	35	35
15	苗栗縣後龍鎮	2018-11-24T23:31:20+08:00	5002	10779	15781	1327	17108	30948	55.28%	16.16%	35	35
15	苗栗縣後龍鎮	2018-11-24T23:43:24+08:00	5002	10779	15781	1327	17108	30948	55.28%	16.16%	35	35
15	苗栗縣後龍鎮	2018-11-24T22:58:02+08:00	4678	9999	14677	1238	15915	28799	55.26%	16.24%	33	35
15	苗栗縣後龍鎮	2018-11-25T03:56:22+08:00	5002	10779	15781	1327	17108	30948	55.28%	16.16%	35	35
15	苗栗縣後龍鎮	2018-11-25T06:29:25+08:00	5002	10779	15781	1327	17108	30948	55.28%	16.16%	35	35
15	苗栗縣後龍鎮	2018-11-25T06:19:05+08:00	5002	10779	15781	1327	17108	30948	55.28%	16.16%	35	35
15	苗栗縣後龍鎮	2018-11-24T23:05:11+08:00	4678	9999	14677	1238	15915	28799	55.26%	16.24%	33	35
15	苗栗縣後龍鎮	2018-11-24T22:41:44+08:00	4385	9274	13659	1124	14783	26785	55.19%	16.37%	31	35
15	苗栗縣後龍鎮	2018-11-25T01:18:03+08:00	5002	10779	15781	1327	17108	30948	55.28%	16.16%	35	35
15	苗栗縣後龍鎮	2018-11-25T03:49:59+08:00	5002	10779	15781	1327	17108	30948	55.28%	16.16%	35	35
15	苗栗縣後龍鎮	2018-11-25T06:09:03+08:00	5002	10779	15781	1327	17108	30948	55.28%	16.16%	35	35
15	苗栗縣後龍鎮	2018-11-24T23:51:43+08:00	5002	10779	15781	1327	17108	30948	55.28%	16.16%	35	35
15	苗栗縣後龍鎮	2018-11-25T06:24:08+08:00	5002	10779	15781	1327	17108	30948	55.28%	16.16%	35	35
15	苗栗縣後龍鎮	2018-11-24T22:30:18+08:00	3990	8355	12345	1026	13371	24686	54.16%	16.16%	29	35
15	苗栗縣後龍鎮	2018-11-24T23:23:45+08:00	5002	10779	15781	1327	17108	30948	55.28%	16.16%	35	35
15	苗栗縣後龍鎮	2018-11-25T03:32:45+08:00	5002	10779	15781	1327	17108	30948	55.28%	16.16%	35	35
15	苗栗縣後龍鎮	2018-11-24T22:13:38+08:00	3744	7797	11541	946	12487	22920	54.48%	16.34%	27	35
15	苗栗縣後龍鎮	2018-11-24T23:08:45+08:00	4880	10418	15298	1282	16580	29912	55.43%	16.31%	34	35
15	苗栗縣後龍鎮	2018-11-25T03:44:33+08:00	5002	10779	15781	1327	17108	30948	55.28%	16.16%	35	35
15	苗栗縣後龍鎮	2018-11-24T23:16:10+08:00	5002	10779	15781	1327	17108	30948	55.28%	16.16%	35	35
15	苗栗縣後龍鎮	2018-11-24T23:47:37+08:00	5002	10779	15781	1327	17108	30948	55.28%	16.16%	35	35
15	苗栗縣後龍鎮	2018-11-24T22:16:19+08:00	3744	7797	11541	946	12487	22920	54.48%	16.34%	27	35
15	苗栗縣後龍鎮	2018-11-24T23:39:26+08:00	5002	10779	15781	1327	17108	30948	55.28%	16.16%	35	35
15	苗栗縣後龍鎮	2018-11-25T01:26:01+08:00	5002	10779	15781	1327	17108	30948	55.28%	16.16%	35	35
15	苗栗縣後龍鎮	2018-11-24T22:33:45+08:00	4201	8938	13139	1083	14222	25902	54.91%	16.22%	30	35
15	苗栗縣三灣鄉	2018-11-24T22:26:44+08:00	855	2253	3108	280	3388	5852	57.89%	14.61%	9	9
15	苗栗縣三灣鄉	2018-11-25T00:05:13+08:00	855	2253	3108	280	3388	5852	57.89%	14.61%	9	9
15	苗栗縣三灣鄉	2018-11-24T23:01:40+08:00	855	2253	3108	280	3388	5852	57.89%	14.61%	9	9
15	苗栗縣三灣鄉	2018-11-24T23:05:12+08:00	855	2253	3108	280	3388	5852	57.89%	14.61%	9	9
15	苗栗縣三灣鄉	2018-11-25T06:29:26+08:00	855	2253	3108	280	3388	5852	57.89%	14.61%	9	9
15	苗栗縣三灣鄉	2018-11-25T00:09:43+08:00	855	2253	3108	280	3388	5852	57.89%	14.61%	9	9
15	苗栗縣三灣鄉	2018-11-24T22:37:08+08:00	855	2253	3108	280	3388	5852	57.89%	14.61%	9	9
15	苗栗縣三灣鄉	2018-11-24T22:54:33+08:00	855	2253	3108	280	3388	5852	57.89%	14.61%	9	9
15	苗栗縣三灣鄉	2018-11-24T22:50:57+08:00	855	2253	3108	280	3388	5852	57.89%	14.61%	9	9
15	苗栗縣三灣鄉	2018-11-25T01:12:53+08:00	855	2253	3108	280	3388	5852	57.89%	14.61%	9	9
15	苗栗縣三灣鄉	2018-11-24T22:40:35+08:00	855	2253	3108	280	3388	5852	57.89%	14.61%	9	9
15	苗栗縣三灣鄉	2018-11-24T22:19:45+08:00	855	2253	3108	280	3388	5852	57.89%	14.61%	9	9
15	苗栗縣三灣鄉	2018-11-25T01:02:39+08:00	855	2253	3108	280	3388	5852	57.89%	14.61%	9	9
15	苗栗縣三灣鄉	2018-11-25T04:03:00+08:00	855	2253	3108	280	3388	5852	57.89%	14.61%	9	9
15	苗栗縣三灣鄉	2018-11-25T06:14:00+08:00	855	2253	3108	280	3388	5852	57.89%	14.61%	9	9
15	苗栗縣三灣鄉	2018-11-24T23:23:46+08:00	855	2253	3108	280	3388	5852	57.89%	14.61%	9	9
15	苗栗縣三灣鄉	2018-11-24T22:23:23+08:00	855	2253	3108	280	3388	5852	57.89%	14.61%	9	9
15	苗栗縣三灣鄉	2018-11-25T03:32:46+08:00	855	2253	3108	280	3388	5852	57.89%	14.61%	9	9
15	苗栗縣三灣鄉	2018-11-24T23:55:55+08:00	855	2253	3108	280	3388	5852	57.89%	14.61%	9	9
15	苗栗縣三灣鄉	2018-11-25T00:00:19+08:00	855	2253	3108	280	3388	5852	57.89%	14.61%	9	9
15	苗栗縣三灣鄉	2018-11-25T00:23:12+08:00	855	2253	3108	280	3388	5852	57.89%	14.61%	9	9
15	苗栗縣三灣鄉	2018-11-24T23:31:21+08:00	855	2253	3108	280	3388	5852	57.89%	14.61%	9	9
15	苗栗縣三灣鄉	2018-11-24T23:20:00+08:00	855	2253	3108	280	3388	5852	57.89%	14.61%	9	9
15	苗栗縣三灣鄉	2018-11-25T01:07:34+08:00	855	2253	3108	280	3388	5852	57.89%	14.61%	9	9
15	苗栗縣三灣鄉	2018-11-24T23:35:18+08:00	855	2253	3108	280	3388	5852	57.89%	14.61%	9	9
15	苗栗縣三灣鄉	2018-11-25T00:14:18+08:00	855	2253	3108	280	3388	5852	57.89%	14.61%	9	9
15	苗栗縣三灣鄉	2018-11-24T23:12:25+08:00	855	2253	3108	280	3388	5852	57.89%	14.61%	9	9
15	苗栗縣三灣鄉	2018-11-25T03:39:02+08:00	855	2253	3108	280	3388	5852	57.89%	14.61%	9	9
15	苗栗縣三灣鄉	2018-11-24T22:33:46+08:00	855	2253	3108	280	3388	5852	57.89%	14.61%	9	9
15	苗栗縣三灣鄉	2018-11-25T00:18:41+08:00	855	2253	3108	280	3388	5852	57.89%	14.61%	9	9
15	苗栗縣三灣鄉	2018-11-24T22:41:45+08:00	855	2253	3108	280	3388	5852	57.89%	14.61%	9	9
15	苗栗縣三灣鄉	2018-11-25T03:56:22+08:00	855	2253	3108	280	3388	5852	57.89%	14.61%	9	9
15	苗栗縣三灣鄉	2018-11-25T06:19:05+08:00	855	2253	3108	280	3388	5852	57.89%	14.61%	9	9
15	苗栗縣三灣鄉	2018-11-24T22:45:16+08:00	855	2253	3108	280	3388	5852	57.89%	14.61%	9	9
15	苗栗縣三灣鄉	2018-11-24T23:43:25+08:00	855	2253	3108	280	3388	5852	57.89%	14.61%	9	9
15	苗栗縣三灣鄉	2018-11-25T01:18:03+08:00	855	2253	3108	280	3388	5852	57.89%	14.61%	9	9
15	苗栗縣三灣鄉	2018-11-25T03:49:59+08:00	855	2253	3108	280	3388	5852	57.89%	14.61%	9	9
15	苗栗縣三灣鄉	2018-11-24T22:58:03+08:00	855	2253	3108	280	3388	5852	57.89%	14.61%	9	9
15	苗栗縣三灣鄉	2018-11-25T06:09:03+08:00	855	2253	3108	280	3388	5852	57.89%	14.61%	9	9
15	苗栗縣三灣鄉	2018-11-24T23:51:43+08:00	855	2253	3108	280	3388	5852	57.89%	14.61%	9	9
15	苗栗縣三灣鄉	2018-11-25T06:24:08+08:00	855	2253	3108	280	3388	5852	57.89%	14.61%	9	9
15	苗栗縣三灣鄉	2018-11-25T00:57:46+08:00	855	2253	3108	280	3388	5852	57.89%	14.61%	9	9
15	苗栗縣三灣鄉	2018-11-24T22:30:18+08:00	855	2253	3108	280	3388	5852	57.89%	14.61%	9	9
15	苗栗縣三灣鄉	2018-11-24T23:27:26+08:00	855	2253	3108	280	3388	5852	57.89%	14.61%	9	9
15	苗栗縣三灣鄉	2018-11-24T23:08:45+08:00	855	2253	3108	280	3388	5852	57.89%	14.61%	9	9
15	苗栗縣三灣鄉	2018-11-24T22:13:39+08:00	855	2253	3108	280	3388	5852	57.89%	14.61%	9	9
15	苗栗縣三灣鄉	2018-11-25T03:44:33+08:00	855	2253	3108	280	3388	5852	57.89%	14.61%	9	9
15	苗栗縣三灣鄉	2018-11-24T23:47:37+08:00	855	2253	3108	280	3388	5852	57.89%	14.61%	9	9
15	苗栗縣三灣鄉	2018-11-24T23:39:26+08:00	855	2253	3108	280	3388	5852	57.89%	14.61%	9	9
15	苗栗縣三灣鄉	2018-11-24T23:16:11+08:00	855	2253	3108	280	3388	5852	57.89%	14.61%	9	9
15	苗栗縣三灣鄉	2018-11-25T01:26:01+08:00	855	2253	3108	280	3388	5852	57.89%	14.61%	9	9
15	苗栗縣三灣鄉	2018-11-24T22:16:20+08:00	855	2253	3108	280	3388	5852	57.89%	14.61%	9	9
15	南投縣南投市	2018-11-25T00:05:14+08:00	14491	34230	48721	2383	51104	84328	60.6%	17.18%	84	84
15	南投縣南投市	2018-11-24T23:01:40+08:00	11179	26393	37572	1904	39476	65066	60.67%	17.18%	68	84
15	南投縣南投市	2018-11-25T06:19:06+08:00	14491	34230	48721	2383	51104	84328	60.6%	17.18%	84	84
15	南投縣南投市	2018-11-24T23:05:12+08:00	11400	26947	38347	1944	40291	66518	60.57%	17.14%	69	84
15	南投縣南投市	2018-11-25T06:29:26+08:00	14491	34230	48721	2383	51104	84328	60.6%	17.18%	84	84
15	南投縣南投市	2018-11-24T22:50:58+08:00	10541	24878	35419	1805	37224	61242	60.78%	17.21%	65	84
15	南投縣南投市	2018-11-24T22:37:09+08:00	9876	23042	32918	1686	34604	56738	60.99%	17.41%	61	84
15	南投縣南投市	2018-11-25T00:09:44+08:00	14491	34230	48721	2383	51104	84328	60.6%	17.18%	84	84
15	南投縣南投市	2018-11-24T22:26:45+08:00	8985	21090	30075	1502	31577	51701	61.08%	17.38%	56	84
15	南投縣南投市	2018-11-24T22:54:33+08:00	10973	25860	36833	1886	38719	63836	60.65%	17.19%	67	84
15	南投縣南投市	2018-11-25T01:12:54+08:00	14491	34230	48721	2383	51104	84328	60.6%	17.18%	84	84
15	南投縣南投市	2018-11-24T22:19:45+08:00	8761	20620	29381	1479	30860	50408	61.22%	17.38%	55	84
15	南投縣南投市	2018-11-25T04:03:01+08:00	14491	34230	48721	2383	51104	84328	60.6%	17.18%	84	84
15	南投縣南投市	2018-11-25T00:23:13+08:00	14491	34230	48721	2383	51104	84328	60.6%	17.18%	84	84
15	南投縣南投市	2018-11-24T23:23:46+08:00	12904	30477	43381	2144	45525	75189	60.55%	17.16%	76	84
15	南投縣南投市	2018-11-24T22:23:23+08:00	8985	21090	30075	1502	31577	51701	61.08%	17.38%	56	84
15	南投縣南投市	2018-11-25T00:00:19+08:00	14312	33760	48072	2364	50436	83250	60.58%	17.19%	83	84
15	南投縣南投市	2018-11-25T01:02:40+08:00	14491	34230	48721	2383	51104	84328	60.6%	17.18%	84	84
15	南投縣南投市	2018-11-25T06:14:01+08:00	14491	34230	48721	2383	51104	84328	60.6%	17.18%	84	84
15	南投縣南投市	2018-11-25T03:32:47+08:00	14491	34230	48721	2383	51104	84328	60.6%	17.18%	84	84
15	南投縣南投市	2018-11-24T23:08:46+08:00	11661	27523	39184	1969	41153	68002	60.52%	17.15%	70	84
15	南投縣南投市	2018-11-25T03:39:03+08:00	14491	34230	48721	2383	51104	84328	60.6%	17.18%	84	84
15	南投縣南投市	2018-11-24T23:35:18+08:00	13890	32947	46837	2308	49145	81156	60.56%	17.12%	81	84
15	南投縣南投市	2018-11-25T01:26:02+08:00	14491	34230	48721	2383	51104	84328	60.6%	17.18%	84	84
15	南投縣南投市	2018-11-24T23:20:01+08:00	12686	29931	42617	2106	44723	73901	60.52%	17.17%	75	84
15	南投縣南投市	2018-11-25T01:07:35+08:00	14491	34230	48721	2383	51104	84328	60.6%	17.18%	84	84
15	南投縣南投市	2018-11-24T22:33:46+08:00	9644	22581	32225	1663	33888	55616	60.93%	17.34%	60	84
15	南投縣南投市	2018-11-25T00:14:19+08:00	14491	34230	48721	2383	51104	84328	60.6%	17.18%	84	84
15	南投縣南投市	2018-11-24T22:41:45+08:00	10235	23955	34190	1757	35947	58835	61.1%	17.4%	63	84
15	南投縣南投市	2018-11-24T22:45:16+08:00	10382	24327	34709	1787	36496	59808	61.02%	17.36%	64	84
15	南投縣南投市	2018-11-24T23:43:25+08:00	14312	33760	48072	2364	50436	83250	60.58%	17.19%	83	84
15	南投縣南投市	2018-11-25T03:56:23+08:00	14491	34230	48721	2383	51104	84328	60.6%	17.18%	84	84
15	南投縣南投市	2018-11-25T03:49:59+08:00	14491	34230	48721	2383	51104	84328	60.6%	17.18%	84	84
15	南投縣南投市	2018-11-25T01:18:04+08:00	14491	34230	48721	2383	51104	84328	60.6%	17.18%	84	84
15	南投縣南投市	2018-11-24T22:58:03+08:00	11179	26393	37572	1904	39476	65066	60.67%	17.18%	68	84
15	南投縣南投市	2018-11-25T06:24:09+08:00	14491	34230	48721	2383	51104	84328	60.6%	17.18%	84	84
15	南投縣南投市	2018-11-25T06:09:04+08:00	14491	34230	48721	2383	51104	84328	60.6%	17.18%	84	84
15	南投縣南投市	2018-11-24T23:51:44+08:00	14312	33760	48072	2364	50436	83250	60.58%	17.19%	83	84
15	南投縣南投市	2018-11-24T22:40:36+08:00	10235	23955	34190	1757	35947	58835	61.1%	17.4%	63	84
15	南投縣南投市	2018-11-24T22:30:19+08:00	9165	21538	30703	1540	32243	52822	61.04%	17.35%	57	84
15	南投縣南投市	2018-11-25T00:57:46+08:00	14491	34230	48721	2383	51104	84328	60.6%	17.18%	84	84
15	南投縣南投市	2018-11-24T23:27:26+08:00	13503	31923	45426	2229	47655	78766	60.5%	17.14%	79	84
15	南投縣南投市	2018-11-25T03:44:35+08:00	14491	34230	48721	2383	51104	84328	60.6%	17.18%	84	84
15	南投縣南投市	2018-11-24T22:13:39+08:00	7959	18885	26844	1362	28206	46180	61.08%	17.23%	51	84
15	南投縣南投市	2018-11-24T23:55:56+08:00	14312	33760	48072	2364	50436	83250	60.58%	17.19%	83	84
15	南投縣南投市	2018-11-24T23:31:22+08:00	13890	32947	46837	2308	49145	81156	60.56%	17.12%	81	84
15	南投縣南投市	2018-11-25T00:18:42+08:00	14491	34230	48721	2383	51104	84328	60.6%	17.18%	84	84
15	南投縣南投市	2018-11-24T23:16:11+08:00	12686	29931	42617	2106	44723	73901	60.52%	17.17%	75	84
15	南投縣南投市	2018-11-24T23:47:38+08:00	14312	33760	48072	2364	50436	83250	60.58%	17.19%	83	84
15	南投縣南投市	2018-11-24T23:12:26+08:00	12004	28412	40416	2010	42426	70191	60.44%	17.1%	72	84
15	南投縣南投市	2018-11-24T22:16:20+08:00	8386	19873	28259	1411	29670	48530	61.14%	17.28%	53	84
15	南投縣南投市	2018-11-24T23:39:27+08:00	14090	33333	47423	2334	49757	82180	60.55%	17.15%	82	84
15	南投縣水里鄉	2018-11-25T00:05:14+08:00	2326	5784	8110	569	8679	15458	56.15%	15.05%	22	22
15	南投縣水里鄉	2018-11-25T06:19:06+08:00	2326	5784	8110	569	8679	15458	56.15%	15.05%	22	22
15	南投縣水里鄉	2018-11-25T00:09:45+08:00	2326	5784	8110	569	8679	15458	56.15%	15.05%	22	22
15	南投縣水里鄉	2018-11-24T22:50:58+08:00	2326	5784	8110	569	8679	15458	56.15%	15.05%	22	22
15	南投縣水里鄉	2018-11-24T22:41:46+08:00	2180	5427	7607	547	8154	14583	55.91%	14.95%	21	22
15	南投縣水里鄉	2018-11-24T22:37:09+08:00	2180	5427	7607	547	8154	14583	55.91%	14.95%	21	22
15	南投縣水里鄉	2018-11-25T06:29:27+08:00	2326	5784	8110	569	8679	15458	56.15%	15.05%	22	22
15	南投縣水里鄉	2018-11-24T23:05:13+08:00	2326	5784	8110	569	8679	15458	56.15%	15.05%	22	22
15	南投縣水里鄉	2018-11-24T23:01:41+08:00	2326	5784	8110	569	8679	15458	56.15%	15.05%	22	22
15	南投縣水里鄉	2018-11-24T22:26:45+08:00	2180	5427	7607	547	8154	14583	55.91%	14.95%	21	22
15	南投縣水里鄉	2018-11-24T22:54:34+08:00	2326	5784	8110	569	8679	15458	56.15%	15.05%	22	22
15	南投縣水里鄉	2018-11-25T01:12:54+08:00	2326	5784	8110	569	8679	15458	56.15%	15.05%	22	22
15	南投縣水里鄉	2018-11-25T04:03:01+08:00	2326	5784	8110	569	8679	15458	56.15%	15.05%	22	22
15	南投縣水里鄉	2018-11-25T00:00:20+08:00	2326	5784	8110	569	8679	15458	56.15%	15.05%	22	22
15	南投縣水里鄉	2018-11-25T00:23:13+08:00	2326	5784	8110	569	8679	15458	56.15%	15.05%	22	22
15	南投縣水里鄉	2018-11-25T03:44:36+08:00	2326	5784	8110	569	8679	15458	56.15%	15.05%	22	22
15	南投縣水里鄉	2018-11-24T23:08:47+08:00	2326	5784	8110	569	8679	15458	56.15%	15.05%	22	22
15	南投縣水里鄉	2018-11-24T22:23:24+08:00	2180	5427	7607	547	8154	14583	55.91%	14.95%	21	22
15	南投縣水里鄉	2018-11-25T01:02:40+08:00	2326	5784	8110	569	8679	15458	56.15%	15.05%	22	22
15	南投縣水里鄉	2018-11-25T06:14:01+08:00	2326	5784	8110	569	8679	15458	56.15%	15.05%	22	22
15	南投縣水里鄉	2018-11-25T03:32:47+08:00	2326	5784	8110	569	8679	15458	56.15%	15.05%	22	22
15	南投縣水里鄉	2018-11-24T23:23:47+08:00	2326	5784	8110	569	8679	15458	56.15%	15.05%	22	22
15	南投縣水里鄉	2018-11-25T03:50:00+08:00	2326	5784	8110	569	8679	15458	56.15%	15.05%	22	22
15	南投縣水里鄉	2018-11-24T22:33:47+08:00	2180	5427	7607	547	8154	14583	55.91%	14.95%	21	22
15	南投縣水里鄉	2018-11-25T03:39:03+08:00	2326	5784	8110	569	8679	15458	56.15%	15.05%	22	22
15	南投縣水里鄉	2018-11-25T01:26:02+08:00	2326	5784	8110	569	8679	15458	56.15%	15.05%	22	22
15	南投縣水里鄉	2018-11-24T23:20:01+08:00	2326	5784	8110	569	8679	15458	56.15%	15.05%	22	22
15	南投縣水里鄉	2018-11-25T00:14:19+08:00	2326	5784	8110	569	8679	15458	56.15%	15.05%	22	22
15	南投縣水里鄉	2018-11-24T23:16:12+08:00	2326	5784	8110	569	8679	15458	56.15%	15.05%	22	22
15	南投縣水里鄉	2018-11-24T23:35:19+08:00	2326	5784	8110	569	8679	15458	56.15%	15.05%	22	22
15	南投縣水里鄉	2018-11-24T22:45:17+08:00	2180	5427	7607	547	8154	14583	55.91%	14.95%	21	22
15	南投縣水里鄉	2018-11-24T23:43:25+08:00	2326	5784	8110	569	8679	15458	56.15%	15.05%	22	22
15	南投縣水里鄉	2018-11-25T03:56:23+08:00	2326	5784	8110	569	8679	15458	56.15%	15.05%	22	22
15	南投縣水里鄉	2018-11-24T22:58:04+08:00	2326	5784	8110	569	8679	15458	56.15%	15.05%	22	22
15	南投縣水里鄉	2018-11-25T01:18:04+08:00	2326	5784	8110	569	8679	15458	56.15%	15.05%	22	22
15	南投縣水里鄉	2018-11-25T00:57:47+08:00	2326	5784	8110	569	8679	15458	56.15%	15.05%	22	22
15	南投縣水里鄉	2018-11-24T22:19:46+08:00	2180	5427	7607	547	8154	14583	55.91%	14.95%	21	22
15	南投縣水里鄉	2018-11-25T06:24:09+08:00	2326	5784	8110	569	8679	15458	56.15%	15.05%	22	22
15	南投縣水里鄉	2018-11-25T06:09:04+08:00	2326	5784	8110	569	8679	15458	56.15%	15.05%	22	22
15	南投縣水里鄉	2018-11-24T22:40:36+08:00	2180	5427	7607	547	8154	14583	55.91%	14.95%	21	22
15	南投縣水里鄉	2018-11-24T22:30:19+08:00	2180	5427	7607	547	8154	14583	55.91%	14.95%	21	22
15	南投縣水里鄉	2018-11-24T22:13:40+08:00	2180	5427	7607	547	8154	14583	55.91%	14.95%	21	22
15	南投縣水里鄉	2018-11-24T23:51:45+08:00	2326	5784	8110	569	8679	15458	56.15%	15.05%	22	22
15	南投縣水里鄉	2018-11-24T23:27:27+08:00	2326	5784	8110	569	8679	15458	56.15%	15.05%	22	22
15	南投縣水里鄉	2018-11-24T23:55:56+08:00	2326	5784	8110	569	8679	15458	56.15%	15.05%	22	22
15	南投縣水里鄉	2018-11-24T23:47:39+08:00	2326	5784	8110	569	8679	15458	56.15%	15.05%	22	22
15	南投縣水里鄉	2018-11-24T23:31:22+08:00	2326	5784	8110	569	8679	15458	56.15%	15.05%	22	22
15	南投縣水里鄉	2018-11-24T22:16:21+08:00	2180	5427	7607	547	8154	14583	55.91%	14.95%	21	22
15	南投縣水里鄉	2018-11-25T00:18:42+08:00	2326	5784	8110	569	8679	15458	56.15%	15.05%	22	22
15	南投縣水里鄉	2018-11-24T23:12:26+08:00	2326	5784	8110	569	8679	15458	56.15%	15.05%	22	22
15	南投縣水里鄉	2018-11-24T23:39:27+08:00	2326	5784	8110	569	8679	15458	56.15%	15.05%	22	22
15	南投縣水里鄉	2018-11-25T01:07:36+08:00	2326	5784	8110	569	8679	15458	56.15%	15.05%	22	22
15	嘉義縣番路鄉	2018-11-24T22:58:06+08:00	1436	3778	5214	453	5667	10156	55.8%	14.14%	15	15
15	嘉義縣番路鄉	2018-11-25T01:18:06+08:00	1436	3778	5214	453	5667	10156	55.8%	14.14%	15	15
15	嘉義縣番路鄉	2018-11-25T06:29:28+08:00	1436	3778	5214	453	5667	10156	55.8%	14.14%	15	15
15	嘉義縣番路鄉	2018-11-24T23:43:27+08:00	1436	3778	5214	453	5667	10156	55.8%	14.14%	15	15
15	嘉義縣番路鄉	2018-11-24T22:54:35+08:00	1436	3778	5214	453	5667	10156	55.8%	14.14%	15	15
15	嘉義縣番路鄉	2018-11-24T23:05:14+08:00	1436	3778	5214	453	5667	10156	55.8%	14.14%	15	15
15	嘉義縣番路鄉	2018-11-25T06:19:07+08:00	1436	3778	5214	453	5667	10156	55.8%	14.14%	15	15
15	嘉義縣番路鄉	2018-11-25T00:05:15+08:00	1436	3778	5214	453	5667	10156	55.8%	14.14%	15	15
15	嘉義縣番路鄉	2018-11-24T22:41:47+08:00	1140	3145	4285	376	4661	8365	55.72%	13.63%	14	15
15	嘉義縣番路鄉	2018-11-24T22:13:42+08:00	1140	3145	4285	376	4661	8365	55.72%	13.63%	14	15
15	嘉義縣番路鄉	2018-11-24T23:51:46+08:00	1436	3778	5214	453	5667	10156	55.8%	14.14%	15	15
15	嘉義縣番路鄉	2018-11-25T06:09:06+08:00	1436	3778	5214	453	5667	10156	55.8%	14.14%	15	15
15	嘉義縣番路鄉	2018-11-25T01:02:41+08:00	1436	3778	5214	453	5667	10156	55.8%	14.14%	15	15
15	嘉義縣番路鄉	2018-11-25T00:23:14+08:00	1436	3778	5214	453	5667	10156	55.8%	14.14%	15	15
15	嘉義縣番路鄉	2018-11-25T06:24:11+08:00	1436	3778	5214	453	5667	10156	55.8%	14.14%	15	15
15	嘉義縣番路鄉	2018-11-24T23:23:48+08:00	1436	3778	5214	453	5667	10156	55.8%	14.14%	15	15
15	嘉義縣番路鄉	2018-11-25T00:00:21+08:00	1436	3778	5214	453	5667	10156	55.8%	14.14%	15	15
15	嘉義縣番路鄉	2018-11-24T22:23:25+08:00	1140	3145	4285	376	4661	8365	55.72%	13.63%	14	15
15	嘉義縣番路鄉	2018-11-24T22:51:00+08:00	1140	3145	4285	376	4661	8365	55.72%	13.63%	14	15
15	嘉義縣番路鄉	2018-11-25T03:32:49+08:00	1436	3778	5214	453	5667	10156	55.8%	14.14%	15	15
15	嘉義縣番路鄉	2018-11-25T03:44:37+08:00	1436	3778	5214	453	5667	10156	55.8%	14.14%	15	15
15	嘉義縣番路鄉	2018-11-24T23:08:48+08:00	1436	3778	5214	453	5667	10156	55.8%	14.14%	15	15
15	嘉義縣番路鄉	2018-11-24T22:16:22+08:00	1140	3145	4285	376	4661	8365	55.72%	13.63%	14	15
15	嘉義縣番路鄉	2018-11-25T01:26:04+08:00	1436	3778	5214	453	5667	10156	55.8%	14.14%	15	15
15	嘉義縣番路鄉	2018-11-24T23:16:13+08:00	1436	3778	5214	453	5667	10156	55.8%	14.14%	15	15
15	嘉義縣番路鄉	2018-11-24T23:35:20+08:00	1436	3778	5214	453	5667	10156	55.8%	14.14%	15	15
15	嘉義縣番路鄉	2018-11-25T00:14:20+08:00	1436	3778	5214	453	5667	10156	55.8%	14.14%	15	15
15	嘉義縣番路鄉	2018-11-25T03:39:05+08:00	1436	3778	5214	453	5667	10156	55.8%	14.14%	15	15
15	嘉義縣番路鄉	2018-11-24T22:33:48+08:00	1140	3145	4285	376	4661	8365	55.72%	13.63%	14	15
15	嘉義縣番路鄉	2018-11-25T03:50:01+08:00	1436	3778	5214	453	5667	10156	55.8%	14.14%	15	15
15	嘉義縣番路鄉	2018-11-25T01:12:56+08:00	1436	3778	5214	453	5667	10156	55.8%	14.14%	15	15
15	嘉義縣番路鄉	2018-11-24T23:47:40+08:00	1436	3778	5214	453	5667	10156	55.8%	14.14%	15	15
15	嘉義縣番路鄉	2018-11-24T23:01:43+08:00	1436	3778	5214	453	5667	10156	55.8%	14.14%	15	15
15	嘉義縣番路鄉	2018-11-25T00:09:46+08:00	1436	3778	5214	453	5667	10156	55.8%	14.14%	15	15
15	嘉義縣番路鄉	2018-11-25T03:56:25+08:00	1436	3778	5214	453	5667	10156	55.8%	14.14%	15	15
15	嘉義縣番路鄉	2018-11-24T22:45:18+08:00	1140	3145	4285	376	4661	8365	55.72%	13.63%	14	15
15	嘉義縣番路鄉	2018-11-24T22:26:46+08:00	1140	3145	4285	376	4661	8365	55.72%	13.63%	14	15
15	嘉義縣番路鄉	2018-11-24T22:40:38+08:00	1140	3145	4285	376	4661	8365	55.72%	13.63%	14	15
15	嘉義縣番路鄉	2018-11-25T04:03:03+08:00	1436	3778	5214	453	5667	10156	55.8%	14.14%	15	15
15	嘉義縣番路鄉	2018-11-25T00:57:48+08:00	1436	3778	5214	453	5667	10156	55.8%	14.14%	15	15
15	嘉義縣番路鄉	2018-11-24T22:19:47+08:00	1140	3145	4285	376	4661	8365	55.72%	13.63%	14	15
15	嘉義縣番路鄉	2018-11-24T22:30:20+08:00	1140	3145	4285	376	4661	8365	55.72%	13.63%	14	15
15	嘉義縣番路鄉	2018-11-24T23:27:28+08:00	1436	3778	5214	453	5667	10156	55.8%	14.14%	15	15
15	嘉義縣番路鄉	2018-11-24T23:55:58+08:00	1436	3778	5214	453	5667	10156	55.8%	14.14%	15	15
15	嘉義縣番路鄉	2018-11-25T06:14:02+08:00	1436	3778	5214	453	5667	10156	55.8%	14.14%	15	15
15	嘉義縣番路鄉	2018-11-25T00:18:44+08:00	1436	3778	5214	453	5667	10156	55.8%	14.14%	15	15
15	嘉義縣番路鄉	2018-11-24T23:20:03+08:00	1436	3778	5214	453	5667	10156	55.8%	14.14%	15	15
15	嘉義縣番路鄉	2018-11-25T01:07:37+08:00	1436	3778	5214	453	5667	10156	55.8%	14.14%	15	15
15	嘉義縣番路鄉	2018-11-24T23:12:27+08:00	1436	3778	5214	453	5667	10156	55.8%	14.14%	15	15
15	嘉義縣番路鄉	2018-11-24T22:37:11+08:00	1140	3145	4285	376	4661	8365	55.72%	13.63%	14	15
15	嘉義縣番路鄉	2018-11-24T23:39:29+08:00	1436	3778	5214	453	5667	10156	55.8%	14.14%	15	15
15	嘉義縣番路鄉	2018-11-24T23:31:24+08:00	1436	3778	5214	453	5667	10156	55.8%	14.14%	15	15
15	金門縣金城鎮	2018-11-25T03:56:28+08:00	3241	9347	12588	645	13233	37815	34.99%	8.57%	21	21
15	金門縣金城鎮	2018-11-24T23:47:43+08:00	3241	9347	12588	645	13233	37815	34.99%	8.57%	21	21
15	金門縣金城鎮	2018-11-24T22:58:09+08:00	2858	8141	10999	574	11573	33397	34.65%	8.56%	19	21
15	金門縣金城鎮	2018-11-24T23:56:01+08:00	3241	9347	12588	645	13233	37815	34.99%	8.57%	21	21
15	金門縣金城鎮	2018-11-24T23:01:46+08:00	3078	8755	11833	622	12455	35914	34.68%	8.57%	20	21
15	金門縣金城鎮	2018-11-24T23:12:30+08:00	3078	8755	11833	622	12455	35914	34.68%	8.57%	20	21
15	金門縣金城鎮	2018-11-25T03:32:53+08:00	3241	9347	12588	645	13233	37815	34.99%	8.57%	21	21
15	金門縣金城鎮	2018-11-24T23:51:49+08:00	3241	9347	12588	645	13233	37815	34.99%	8.57%	21	21
15	金門縣金城鎮	2018-11-24T22:13:45+08:00	2693	7795	10488	549	11037	31722	34.79%	8.49%	18	21
15	金門縣金城鎮	2018-11-25T03:44:41+08:00	3241	9347	12588	645	13233	37815	34.99%	8.57%	21	21
15	金門縣金城鎮	2018-11-25T04:03:06+08:00	3241	9347	12588	645	13233	37815	34.99%	8.57%	21	21
15	金門縣金城鎮	2018-11-24T23:27:31+08:00	3078	8755	11833	622	12455	35914	34.68%	8.57%	20	21
15	金門縣金城鎮	2018-11-24T22:30:24+08:00	2693	7795	10488	549	11037	31722	34.79%	8.49%	18	21
15	金門縣金城鎮	2018-11-25T00:57:51+08:00	3241	9347	12588	645	13233	37815	34.99%	8.57%	21	21
15	金門縣金城鎮	2018-11-24T22:19:50+08:00	2693	7795	10488	549	11037	31722	34.79%	8.49%	18	21
15	金門縣金城鎮	2018-11-25T00:09:50+08:00	3241	9347	12588	645	13233	37815	34.99%	8.57%	21	21
15	金門縣金城鎮	2018-11-25T00:18:47+08:00	3241	9347	12588	645	13233	37815	34.99%	8.57%	21	21
15	金門縣金城鎮	2018-11-24T22:37:14+08:00	2693	7795	10488	549	11037	31722	34.79%	8.49%	18	21
15	金門縣金城鎮	2018-11-24T23:20:08+08:00	3078	8755	11833	622	12455	35914	34.68%	8.57%	20	21
15	金門縣金城鎮	2018-11-24T23:31:27+08:00	3241	9347	12588	645	13233	37815	34.99%	8.57%	21	21
15	金門縣金城鎮	2018-11-24T22:45:21+08:00	2858	8141	10999	574	11573	33397	34.65%	8.56%	19	21
15	金門縣金城鎮	2018-11-24T22:54:38+08:00	2858	8141	10999	574	11573	33397	34.65%	8.56%	19	21
15	金門縣金城鎮	2018-11-24T22:33:51+08:00	2693	7795	10488	549	11037	31722	34.79%	8.49%	18	21
15	金門縣金城鎮	2018-11-24T23:39:33+08:00	3241	9347	12588	645	13233	37815	34.99%	8.57%	21	21
15	金門縣金城鎮	2018-11-24T23:05:16+08:00	3078	8755	11833	622	12455	35914	34.68%	8.57%	20	21
15	金門縣金城鎮	2018-11-24T22:26:49+08:00	2693	7795	10488	549	11037	31722	34.79%	8.49%	18	21
15	金門縣金城鎮	2018-11-25T01:07:40+08:00	3241	9347	12588	645	13233	37815	34.99%	8.57%	21	21
15	金門縣金城鎮	2018-11-25T01:12:59+08:00	3241	9347	12588	645	13233	37815	34.99%	8.57%	21	21
15	金門縣金城鎮	2018-11-25T00:05:18+08:00	3241	9347	12588	645	13233	37815	34.99%	8.57%	21	21
15	金門縣金城鎮	2018-11-24T23:08:51+08:00	3078	8755	11833	622	12455	35914	34.68%	8.57%	20	21
15	金門縣金城鎮	2018-11-24T23:23:51+08:00	3078	8755	11833	622	12455	35914	34.68%	8.57%	20	21
15	金門縣金城鎮	2018-11-24T22:23:29+08:00	2693	7795	10488	549	11037	31722	34.79%	8.49%	18	21
15	金門縣金城鎮	2018-11-25T00:23:17+08:00	3241	9347	12588	645	13233	37815	34.99%	8.57%	21	21
15	金門縣金城鎮	2018-11-25T00:00:24+08:00	3241	9347	12588	645	13233	37815	34.99%	8.57%	21	21
15	金門縣金城鎮	2018-11-25T01:02:45+08:00	3241	9347	12588	645	13233	37815	34.99%	8.57%	21	21
15	金門縣金城鎮	2018-11-24T22:51:04+08:00	2858	8141	10999	574	11573	33397	34.65%	8.56%	19	21
15	金門縣金城鎮	2018-11-25T06:09:10+08:00	3241	9347	12588	645	13233	37815	34.99%	8.57%	21	21
15	金門縣金城鎮	2018-11-25T06:24:14+08:00	3241	9347	12588	645	13233	37815	34.99%	8.57%	21	21
15	金門縣金城鎮	2018-11-24T22:40:40+08:00	2693	7795	10488	549	11037	31722	34.79%	8.49%	18	21
15	金門縣金城鎮	2018-11-25T06:14:05+08:00	3241	9347	12588	645	13233	37815	34.99%	8.57%	21	21
15	金門縣金城鎮	2018-11-24T23:35:23+08:00	3241	9347	12588	645	13233	37815	34.99%	8.57%	21	21
15	金門縣金城鎮	2018-11-25T00:14:24+08:00	3241	9347	12588	645	13233	37815	34.99%	8.57%	21	21
15	金門縣金城鎮	2018-11-25T03:50:04+08:00	3241	9347	12588	645	13233	37815	34.99%	8.57%	21	21
15	金門縣金城鎮	2018-11-24T22:16:26+08:00	2693	7795	10488	549	11037	31722	34.79%	8.49%	18	21
15	金門縣金城鎮	2018-11-24T23:43:31+08:00	3241	9347	12588	645	13233	37815	34.99%	8.57%	21	21
15	金門縣金城鎮	2018-11-25T01:18:11+08:00	3241	9347	12588	645	13233	37815	34.99%	8.57%	21	21
15	金門縣金城鎮	2018-11-25T06:29:31+08:00	3241	9347	12588	645	13233	37815	34.99%	8.57%	21	21
15	金門縣金城鎮	2018-11-24T23:16:16+08:00	3078	8755	11833	622	12455	35914	34.68%	8.57%	20	21
15	金門縣金城鎮	2018-11-25T06:19:11+08:00	3241	9347	12588	645	13233	37815	34.99%	8.57%	21	21
15	金門縣金城鎮	2018-11-24T22:41:51+08:00	2693	7795	10488	549	11037	31722	34.79%	8.49%	18	21
15	金門縣金城鎮	2018-11-25T03:39:08+08:00	3241	9347	12588	645	13233	37815	34.99%	8.57%	21	21
15	金門縣金城鎮	2018-11-25T01:26:08+08:00	3241	9347	12588	645	13233	37815	34.99%	8.57%	21	21
15	嘉義縣溪口鄉	2018-11-25T01:18:06+08:00	2024	3870	5894	726	6620	13105	50.52%	15.44%	17	17
15	嘉義縣溪口鄉	2018-11-25T06:29:28+08:00	2024	3870	5894	726	6620	13105	50.52%	15.44%	17	17
15	嘉義縣溪口鄉	2018-11-24T23:43:27+08:00	1550	2961	4511	537	5048	9977	50.6%	15.54%	14	17
15	嘉義縣溪口鄉	2018-11-25T01:12:55+08:00	2024	3870	5894	726	6620	13105	50.52%	15.44%	17	17
15	嘉義縣溪口鄉	2018-11-24T22:54:35+08:00	1249	2352	3601	443	4044	7935	50.96%	15.74%	12	17
15	嘉義縣溪口鄉	2018-11-24T23:05:13+08:00	1441	2679	4120	500	4620	8974	51.48%	16.06%	13	17
15	嘉義縣溪口鄉	2018-11-25T06:19:07+08:00	2024	3870	5894	726	6620	13105	50.52%	15.44%	17	17
15	嘉義縣溪口鄉	2018-11-25T00:05:15+08:00	1550	2961	4511	537	5048	9977	50.6%	15.54%	14	17
15	嘉義縣溪口鄉	2018-11-24T22:41:47+08:00	1117	2095	3212	399	3611	7149	50.51%	15.62%	11	17
15	嘉義縣溪口鄉	2018-11-24T22:50:59+08:00	1249	2352	3601	443	4044	7935	50.96%	15.74%	12	17
15	嘉義縣溪口鄉	2018-11-25T06:09:06+08:00	2024	3870	5894	726	6620	13105	50.52%	15.44%	17	17
15	嘉義縣溪口鄉	2018-11-25T01:02:41+08:00	2024	3870	5894	726	6620	13105	50.52%	15.44%	17	17
15	嘉義縣溪口鄉	2018-11-25T00:23:14+08:00	1550	2961	4511	537	5048	9977	50.6%	15.54%	14	17
15	嘉義縣溪口鄉	2018-11-25T03:32:48+08:00	2024	3870	5894	726	6620	13105	50.52%	15.44%	17	17
15	嘉義縣溪口鄉	2018-11-24T23:23:48+08:00	1441	2679	4120	500	4620	8974	51.48%	16.06%	13	17
15	嘉義縣溪口鄉	2018-11-25T06:24:10+08:00	2024	3870	5894	726	6620	13105	50.52%	15.44%	17	17
15	嘉義縣溪口鄉	2018-11-25T00:00:21+08:00	1550	2961	4511	537	5048	9977	50.6%	15.54%	14	17
15	嘉義縣溪口鄉	2018-11-24T22:23:25+08:00	1015	1914	2929	351	3280	6441	50.92%	15.76%	10	17
15	嘉義縣溪口鄉	2018-11-25T03:44:37+08:00	2024	3870	5894	726	6620	13105	50.52%	15.44%	17	17
15	嘉義縣溪口鄉	2018-11-24T23:08:48+08:00	1441	2679	4120	500	4620	8974	51.48%	16.06%	13	17
15	嘉義縣溪口鄉	2018-11-24T22:16:22+08:00	1015	1914	2929	351	3280	6441	50.92%	15.76%	10	17
15	嘉義縣溪口鄉	2018-11-25T03:39:04+08:00	2024	3870	5894	726	6620	13105	50.52%	15.44%	17	17
15	嘉義縣溪口鄉	2018-11-25T01:26:04+08:00	2024	3870	5894	726	6620	13105	50.52%	15.44%	17	17
15	嘉義縣溪口鄉	2018-11-24T23:16:13+08:00	1441	2679	4120	500	4620	8974	51.48%	16.06%	13	17
15	嘉義縣溪口鄉	2018-11-24T23:35:20+08:00	1550	2961	4511	537	5048	9977	50.6%	15.54%	14	17
15	嘉義縣溪口鄉	2018-11-25T00:14:20+08:00	1550	2961	4511	537	5048	9977	50.6%	15.54%	14	17
15	嘉義縣溪口鄉	2018-11-24T22:33:48+08:00	1117	2095	3212	399	3611	7149	50.51%	15.62%	11	17
15	嘉義縣溪口鄉	2018-11-25T03:50:01+08:00	2024	3870	5894	726	6620	13105	50.52%	15.44%	17	17
15	嘉義縣溪口鄉	2018-11-24T23:47:40+08:00	1550	2961	4511	537	5048	9977	50.6%	15.54%	14	17
15	嘉義縣溪口鄉	2018-11-24T22:45:17+08:00	1249	2352	3601	443	4044	7935	50.96%	15.74%	12	17
15	嘉義縣溪口鄉	2018-11-24T22:58:05+08:00	1249	2352	3601	443	4044	7935	50.96%	15.74%	12	17
15	嘉義縣溪口鄉	2018-11-25T00:09:46+08:00	1550	2961	4511	537	5048	9977	50.6%	15.54%	14	17
15	嘉義縣溪口鄉	2018-11-25T03:56:24+08:00	2024	3870	5894	726	6620	13105	50.52%	15.44%	17	17
15	嘉義縣溪口鄉	2018-11-24T22:26:46+08:00	1117	2095	3212	399	3611	7149	50.51%	15.62%	11	17
15	嘉義縣溪口鄉	2018-11-24T23:01:42+08:00	1441	2679	4120	500	4620	8974	51.48%	16.06%	13	17
15	嘉義縣溪口鄉	2018-11-24T22:19:46+08:00	1015	1914	2929	351	3280	6441	50.92%	15.76%	10	17
15	嘉義縣溪口鄉	2018-11-24T22:13:41+08:00	1015	1914	2929	351	3280	6441	50.92%	15.76%	10	17
15	嘉義縣溪口鄉	2018-11-25T04:03:02+08:00	2024	3870	5894	726	6620	13105	50.52%	15.44%	17	17
15	嘉義縣溪口鄉	2018-11-25T00:57:48+08:00	2024	3870	5894	726	6620	13105	50.52%	15.44%	17	17
15	嘉義縣溪口鄉	2018-11-24T22:40:37+08:00	1117	2095	3212	399	3611	7149	50.51%	15.62%	11	17
15	嘉義縣溪口鄉	2018-11-24T23:51:45+08:00	1550	2961	4511	537	5048	9977	50.6%	15.54%	14	17
15	嘉義縣溪口鄉	2018-11-24T22:30:20+08:00	1117	2095	3212	399	3611	7149	50.51%	15.62%	11	17
15	嘉義縣溪口鄉	2018-11-24T23:55:57+08:00	1550	2961	4511	537	5048	9977	50.6%	15.54%	14	17
15	嘉義縣溪口鄉	2018-11-24T23:27:27+08:00	1441	2679	4120	500	4620	8974	51.48%	16.06%	13	17
15	嘉義縣溪口鄉	2018-11-25T06:14:02+08:00	2024	3870	5894	726	6620	13105	50.52%	15.44%	17	17
15	嘉義縣溪口鄉	2018-11-25T00:18:43+08:00	1550	2961	4511	537	5048	9977	50.6%	15.54%	14	17
15	嘉義縣溪口鄉	2018-11-25T01:07:37+08:00	2024	3870	5894	726	6620	13105	50.52%	15.44%	17	17
15	嘉義縣溪口鄉	2018-11-24T23:12:27+08:00	1441	2679	4120	500	4620	8974	51.48%	16.06%	13	17
15	嘉義縣溪口鄉	2018-11-24T22:37:11+08:00	1117	2095	3212	399	3611	7149	50.51%	15.62%	11	17
15	嘉義縣溪口鄉	2018-11-24T23:39:29+08:00	1550	2961	4511	537	5048	9977	50.6%	15.54%	14	17
15	嘉義縣溪口鄉	2018-11-24T23:31:23+08:00	1550	2961	4511	537	5048	9977	50.6%	15.54%	14	17
15	嘉義縣溪口鄉	2018-11-24T23:20:02+08:00	1441	2679	4120	500	4620	8974	51.48%	16.06%	13	17
15	高雄市甲仙區	2018-11-25T01:18:01+08:00	706	1702	2408	279	2687	5417	49.6%	13.03%	7	7
15	高雄市甲仙區	2018-11-24T22:26:43+08:00	495	1224	1719	173	1892	3836	49.32%	12.9%	6	7
15	高雄市甲仙區	2018-11-25T00:09:42+08:00	706	1702	2408	279	2687	5417	49.6%	13.03%	7	7
15	高雄市甲仙區	2018-11-25T03:56:21+08:00	706	1702	2408	279	2687	5417	49.6%	13.03%	7	7
15	高雄市甲仙區	2018-11-25T01:12:52+08:00	706	1702	2408	279	2687	5417	49.6%	13.03%	7	7
15	高雄市甲仙區	2018-11-24T22:37:07+08:00	495	1224	1719	173	1892	3836	49.32%	12.9%	6	7
15	高雄市甲仙區	2018-11-24T22:54:32+08:00	706	1702	2408	279	2687	5417	49.6%	13.03%	7	7
15	高雄市甲仙區	2018-11-24T22:50:56+08:00	495	1224	1719	173	1892	3836	49.32%	12.9%	6	7
15	高雄市甲仙區	2018-11-25T00:18:39+08:00	706	1702	2408	279	2687	5417	49.6%	13.03%	7	7
15	高雄市甲仙區	2018-11-25T00:05:12+08:00	706	1702	2408	279	2687	5417	49.6%	13.03%	7	7
15	高雄市甲仙區	2018-11-24T23:16:09+08:00	706	1702	2408	279	2687	5417	49.6%	13.03%	7	7
15	高雄市甲仙區	2018-11-24T22:45:15+08:00	495	1224	1719	173	1892	3836	49.32%	12.9%	6	7
15	高雄市甲仙區	2018-11-25T01:02:38+08:00	706	1702	2408	279	2687	5417	49.6%	13.03%	7	7
15	高雄市甲仙區	2018-11-25T00:57:44+08:00	706	1702	2408	279	2687	5417	49.6%	13.03%	7	7
15	高雄市甲仙區	2018-11-24T22:40:34+08:00	495	1224	1719	173	1892	3836	49.32%	12.9%	6	7
15	高雄市甲仙區	2018-11-24T22:19:43+08:00	495	1224	1719	173	1892	3836	49.32%	12.9%	6	7
15	高雄市甲仙區	2018-11-24T23:55:54+08:00	706	1702	2408	279	2687	5417	49.6%	13.03%	7	7
15	高雄市甲仙區	2018-11-24T23:27:25+08:00	706	1702	2408	279	2687	5417	49.6%	13.03%	7	7
15	高雄市甲仙區	2018-11-24T23:19:59+08:00	706	1702	2408	279	2687	5417	49.6%	13.03%	7	7
15	高雄市甲仙區	2018-11-25T00:00:17+08:00	706	1702	2408	279	2687	5417	49.6%	13.03%	7	7
15	高雄市甲仙區	2018-11-25T01:07:33+08:00	706	1702	2408	279	2687	5417	49.6%	13.03%	7	7
15	高雄市甲仙區	2018-11-24T23:31:19+08:00	706	1702	2408	279	2687	5417	49.6%	13.03%	7	7
15	高雄市甲仙區	2018-11-24T23:39:25+08:00	706	1702	2408	279	2687	5417	49.6%	13.03%	7	7
15	高雄市甲仙區	2018-11-24T23:12:24+08:00	706	1702	2408	279	2687	5417	49.6%	13.03%	7	7
15	高雄市甲仙區	2018-11-24T23:01:38+08:00	706	1702	2408	279	2687	5417	49.6%	13.03%	7	7
15	高雄市甲仙區	2018-11-24T23:35:17+08:00	706	1702	2408	279	2687	5417	49.6%	13.03%	7	7
15	高雄市甲仙區	2018-11-25T04:02:59+08:00	706	1702	2408	279	2687	5417	49.6%	13.03%	7	7
15	高雄市甲仙區	2018-11-25T00:14:17+08:00	706	1702	2408	279	2687	5417	49.6%	13.03%	7	7
15	高雄市甲仙區	2018-11-24T23:43:23+08:00	706	1702	2408	279	2687	5417	49.6%	13.03%	7	7
15	高雄市甲仙區	2018-11-24T22:58:02+08:00	706	1702	2408	279	2687	5417	49.6%	13.03%	7	7
15	高雄市甲仙區	2018-11-25T03:49:58+08:00	706	1702	2408	279	2687	5417	49.6%	13.03%	7	7
15	高雄市甲仙區	2018-11-24T23:05:11+08:00	706	1702	2408	279	2687	5417	49.6%	13.03%	7	7
15	高雄市甲仙區	2018-11-25T06:13:59+08:00	706	1702	2408	279	2687	5417	49.6%	13.03%	7	7
15	高雄市甲仙區	2018-11-24T22:41:43+08:00	495	1224	1719	173	1892	3836	49.32%	12.9%	6	7
15	高雄市甲仙區	2018-11-25T06:19:04+08:00	706	1702	2408	279	2687	5417	49.6%	13.03%	7	7
15	高雄市甲仙區	2018-11-25T06:29:24+08:00	706	1702	2408	279	2687	5417	49.6%	13.03%	7	7
15	高雄市甲仙區	2018-11-25T06:24:07+08:00	706	1702	2408	279	2687	5417	49.6%	13.03%	7	7
15	高雄市甲仙區	2018-11-24T22:30:17+08:00	495	1224	1719	173	1892	3836	49.32%	12.9%	6	7
15	高雄市甲仙區	2018-11-24T23:51:42+08:00	706	1702	2408	279	2687	5417	49.6%	13.03%	7	7
15	高雄市甲仙區	2018-11-25T06:09:02+08:00	706	1702	2408	279	2687	5417	49.6%	13.03%	7	7
15	高雄市甲仙區	2018-11-24T23:23:45+08:00	706	1702	2408	279	2687	5417	49.6%	13.03%	7	7
15	高雄市甲仙區	2018-11-25T03:44:32+08:00	706	1702	2408	279	2687	5417	49.6%	13.03%	7	7
15	高雄市甲仙區	2018-11-24T23:08:44+08:00	706	1702	2408	279	2687	5417	49.6%	13.03%	7	7
15	高雄市甲仙區	2018-11-24T22:23:21+08:00	495	1224	1719	173	1892	3836	49.32%	12.9%	6	7
15	高雄市甲仙區	2018-11-25T03:32:44+08:00	706	1702	2408	279	2687	5417	49.6%	13.03%	7	7
15	高雄市甲仙區	2018-11-24T22:13:37+08:00	495	1224	1719	173	1892	3836	49.32%	12.9%	6	7
15	高雄市甲仙區	2018-11-25T00:23:11+08:00	706	1702	2408	279	2687	5417	49.6%	13.03%	7	7
15	高雄市甲仙區	2018-11-25T01:26:00+08:00	706	1702	2408	279	2687	5417	49.6%	13.03%	7	7
15	高雄市甲仙區	2018-11-24T23:47:36+08:00	706	1702	2408	279	2687	5417	49.6%	13.03%	7	7
15	高雄市甲仙區	2018-11-25T03:39:01+08:00	706	1702	2408	279	2687	5417	49.6%	13.03%	7	7
15	高雄市甲仙區	2018-11-24T22:33:45+08:00	495	1224	1719	173	1892	3836	49.32%	12.9%	6	7
15	高雄市甲仙區	2018-11-24T22:16:18+08:00	495	1224	1719	173	1892	3836	49.32%	12.9%	6	7
15	高雄市阿蓮區	2018-11-25T01:18:01+08:00	4353	8139	12492	792	13284	24534	54.15%	17.74%	21	21
15	高雄市阿蓮區	2018-11-24T22:58:01+08:00	4353	8139	12492	792	13284	24534	54.15%	17.74%	21	21
15	高雄市阿蓮區	2018-11-24T22:26:43+08:00	4353	8139	12492	792	13284	24534	54.15%	17.74%	21	21
15	高雄市阿蓮區	2018-11-25T00:09:42+08:00	4353	8139	12492	792	13284	24534	54.15%	17.74%	21	21
15	高雄市阿蓮區	2018-11-24T22:37:07+08:00	4353	8139	12492	792	13284	24534	54.15%	17.74%	21	21
15	高雄市阿蓮區	2018-11-25T00:18:39+08:00	4353	8139	12492	792	13284	24534	54.15%	17.74%	21	21
15	高雄市阿蓮區	2018-11-24T22:45:14+08:00	4353	8139	12492	792	13284	24534	54.15%	17.74%	21	21
15	高雄市阿蓮區	2018-11-25T03:56:20+08:00	4353	8139	12492	792	13284	24534	54.15%	17.74%	21	21
15	高雄市阿蓮區	2018-11-25T00:05:12+08:00	4353	8139	12492	792	13284	24534	54.15%	17.74%	21	21
15	高雄市阿蓮區	2018-11-24T23:16:09+08:00	4353	8139	12492	792	13284	24534	54.15%	17.74%	21	21
15	高雄市阿蓮區	2018-11-25T01:02:38+08:00	4353	8139	12492	792	13284	24534	54.15%	17.74%	21	21
15	高雄市阿蓮區	2018-11-25T00:57:44+08:00	4353	8139	12492	792	13284	24534	54.15%	17.74%	21	21
15	高雄市阿蓮區	2018-11-24T22:40:34+08:00	4353	8139	12492	792	13284	24534	54.15%	17.74%	21	21
15	高雄市阿蓮區	2018-11-25T06:09:01+08:00	4353	8139	12492	792	13284	24534	54.15%	17.74%	21	21
15	高雄市阿蓮區	2018-11-24T22:19:43+08:00	4353	8139	12492	792	13284	24534	54.15%	17.74%	21	21
15	高雄市阿蓮區	2018-11-24T23:55:53+08:00	4353	8139	12492	792	13284	24534	54.15%	17.74%	21	21
15	高雄市阿蓮區	2018-11-25T03:44:31+08:00	4353	8139	12492	792	13284	24534	54.15%	17.74%	21	21
15	高雄市阿蓮區	2018-11-24T23:19:59+08:00	4353	8139	12492	792	13284	24534	54.15%	17.74%	21	21
15	高雄市阿蓮區	2018-11-25T00:00:17+08:00	4353	8139	12492	792	13284	24534	54.15%	17.74%	21	21
15	高雄市阿蓮區	2018-11-24T23:27:24+08:00	4353	8139	12492	792	13284	24534	54.15%	17.74%	21	21
15	高雄市阿蓮區	2018-11-25T01:07:33+08:00	4353	8139	12492	792	13284	24534	54.15%	17.74%	21	21
15	高雄市阿蓮區	2018-11-24T23:31:19+08:00	4353	8139	12492	792	13284	24534	54.15%	17.74%	21	21
15	高雄市阿蓮區	2018-11-24T23:12:23+08:00	4353	8139	12492	792	13284	24534	54.15%	17.74%	21	21
15	高雄市阿蓮區	2018-11-25T00:14:16+08:00	4353	8139	12492	792	13284	24534	54.15%	17.74%	21	21
15	高雄市阿蓮區	2018-11-24T23:35:16+08:00	4353	8139	12492	792	13284	24534	54.15%	17.74%	21	21
15	高雄市阿蓮區	2018-11-24T23:39:24+08:00	4353	8139	12492	792	13284	24534	54.15%	17.74%	21	21
15	高雄市阿蓮區	2018-11-24T23:01:38+08:00	4353	8139	12492	792	13284	24534	54.15%	17.74%	21	21
15	高雄市阿蓮區	2018-11-25T04:02:59+08:00	4353	8139	12492	792	13284	24534	54.15%	17.74%	21	21
15	高雄市阿蓮區	2018-11-24T23:43:23+08:00	4353	8139	12492	792	13284	24534	54.15%	17.74%	21	21
15	高雄市阿蓮區	2018-11-25T01:12:51+08:00	4353	8139	12492	792	13284	24534	54.15%	17.74%	21	21
15	高雄市阿蓮區	2018-11-24T22:54:31+08:00	4353	8139	12492	792	13284	24534	54.15%	17.74%	21	21
15	高雄市阿蓮區	2018-11-24T22:50:55+08:00	4353	8139	12492	792	13284	24534	54.15%	17.74%	21	21
15	高雄市阿蓮區	2018-11-25T06:13:59+08:00	4353	8139	12492	792	13284	24534	54.15%	17.74%	21	21
15	高雄市阿蓮區	2018-11-24T22:41:43+08:00	4353	8139	12492	792	13284	24534	54.15%	17.74%	21	21
15	高雄市阿蓮區	2018-11-25T03:49:57+08:00	4353	8139	12492	792	13284	24534	54.15%	17.74%	21	21
15	高雄市阿蓮區	2018-11-24T23:05:10+08:00	4353	8139	12492	792	13284	24534	54.15%	17.74%	21	21
15	高雄市阿蓮區	2018-11-25T06:19:04+08:00	4353	8139	12492	792	13284	24534	54.15%	17.74%	21	21
15	高雄市阿蓮區	2018-11-25T06:29:24+08:00	4353	8139	12492	792	13284	24534	54.15%	17.74%	21	21
15	高雄市阿蓮區	2018-11-25T06:24:07+08:00	4353	8139	12492	792	13284	24534	54.15%	17.74%	21	21
15	高雄市阿蓮區	2018-11-24T22:30:16+08:00	4353	8139	12492	792	13284	24534	54.15%	17.74%	21	21
15	高雄市阿蓮區	2018-11-24T23:51:42+08:00	4353	8139	12492	792	13284	24534	54.15%	17.74%	21	21
15	高雄市阿蓮區	2018-11-24T22:13:36+08:00	4353	8139	12492	792	13284	24534	54.15%	17.74%	21	21
15	高雄市阿蓮區	2018-11-24T23:08:44+08:00	4353	8139	12492	792	13284	24534	54.15%	17.74%	21	21
15	高雄市阿蓮區	2018-11-25T00:23:10+08:00	4353	8139	12492	792	13284	24534	54.15%	17.74%	21	21
15	高雄市阿蓮區	2018-11-24T22:23:21+08:00	4353	8139	12492	792	13284	24534	54.15%	17.74%	21	21
15	高雄市阿蓮區	2018-11-25T03:32:44+08:00	4353	8139	12492	792	13284	24534	54.15%	17.74%	21	21
15	高雄市阿蓮區	2018-11-24T23:23:44+08:00	4353	8139	12492	792	13284	24534	54.15%	17.74%	21	21
15	高雄市阿蓮區	2018-11-24T22:33:44+08:00	4353	8139	12492	792	13284	24534	54.15%	17.74%	21	21
15	高雄市阿蓮區	2018-11-25T01:26:00+08:00	4353	8139	12492	792	13284	24534	54.15%	17.74%	21	21
15	高雄市阿蓮區	2018-11-24T23:47:36+08:00	4353	8139	12492	792	13284	24534	54.15%	17.74%	21	21
15	高雄市阿蓮區	2018-11-25T03:39:01+08:00	4353	8139	12492	792	13284	24534	54.15%	17.74%	21	21
15	高雄市阿蓮區	2018-11-24T22:16:18+08:00	4353	8139	12492	792	13284	24534	54.15%	17.74%	21	21
15	花蓮縣光復鄉	2018-11-24T23:56:00+08:00	1153	3359	4512	598	5110	9634	53.04%	11.97%	15	17
15	花蓮縣光復鄉	2018-11-24T22:58:08+08:00	795	2394	3189	393	3582	6995	51.21%	11.37%	12	17
15	花蓮縣光復鄉	2018-11-24T23:43:29+08:00	1153	3359	4512	598	5110	9634	53.04%	11.97%	15	17
15	花蓮縣光復鄉	2018-11-25T01:18:09+08:00	1345	3871	5216	674	5890	11417	51.59%	11.78%	17	17
15	花蓮縣光復鄉	2018-11-25T03:56:27+08:00	1345	3871	5216	674	5890	11417	51.59%	11.78%	17	17
15	花蓮縣光復鄉	2018-11-24T22:41:49+08:00	509	1512	2021	231	2252	4689	48.03%	10.86%	10	17
15	花蓮縣光復鄉	2018-11-24T23:39:31+08:00	1153	3359	4512	598	5110	9634	53.04%	11.97%	15	17
15	花蓮縣光復鄉	2018-11-24T23:47:42+08:00	1153	3359	4512	598	5110	9634	53.04%	11.97%	15	17
15	花蓮縣光復鄉	2018-11-24T22:30:22+08:00	509	1512	2021	231	2252	4689	48.03%	10.86%	10	17
15	花蓮縣光復鄉	2018-11-24T23:27:30+08:00	1033	3014	4047	492	4539	8676	52.32%	11.91%	14	17
15	花蓮縣光復鄉	2018-11-24T23:51:48+08:00	1153	3359	4512	598	5110	9634	53.04%	11.97%	15	17
15	花蓮縣光復鄉	2018-11-25T06:09:08+08:00	1345	3871	5216	674	5890	11417	51.59%	11.78%	17	17
15	花蓮縣光復鄉	2018-11-24T22:13:44+08:00	447	1327	1774	209	1983	4218	47.01%	10.6%	9	17
15	花蓮縣光復鄉	2018-11-25T00:57:50+08:00	1345	3871	5216	674	5890	11417	51.59%	11.78%	17	17
15	花蓮縣光復鄉	2018-11-25T03:44:39+08:00	1345	3871	5216	674	5890	11417	51.59%	11.78%	17	17
15	花蓮縣光復鄉	2018-11-24T23:31:26+08:00	1033	3014	4047	492	4539	8676	52.32%	11.91%	14	17
15	花蓮縣光復鄉	2018-11-24T22:37:13+08:00	509	1512	2021	231	2252	4689	48.03%	10.86%	10	17
15	花蓮縣光復鄉	2018-11-24T22:16:24+08:00	447	1327	1774	209	1983	4218	47.01%	10.6%	9	17
15	花蓮縣光復鄉	2018-11-24T23:20:06+08:00	1033	3014	4047	492	4539	8676	52.32%	11.91%	14	17
15	花蓮縣光復鄉	2018-11-25T00:18:46+08:00	1345	3871	5216	674	5890	11417	51.59%	11.78%	17	17
15	花蓮縣光復鄉	2018-11-24T23:16:15+08:00	891	2618	3509	428	3937	7635	51.57%	11.67%	13	17
15	花蓮縣光復鄉	2018-11-25T01:12:58+08:00	1345	3871	5216	674	5890	11417	51.59%	11.78%	17	17
15	花蓮縣光復鄉	2018-11-25T00:05:17+08:00	1153	3359	4512	598	5110	9634	53.04%	11.97%	15	17
15	花蓮縣光復鄉	2018-11-24T23:05:16+08:00	891	2618	3509	428	3937	7635	51.57%	11.67%	13	17
15	花蓮縣光復鄉	2018-11-24T22:54:37+08:00	795	2394	3189	393	3582	6995	51.21%	11.37%	12	17
15	花蓮縣光復鄉	2018-11-24T22:33:50+08:00	509	1512	2021	231	2252	4689	48.03%	10.86%	10	17
15	花蓮縣光復鄉	2018-11-24T22:45:20+08:00	509	1512	2021	231	2252	4689	48.03%	10.86%	10	17
15	花蓮縣光復鄉	2018-11-24T22:26:48+08:00	509	1512	2021	231	2252	4689	48.03%	10.86%	10	17
15	花蓮縣光復鄉	2018-11-24T23:01:45+08:00	891	2618	3509	428	3937	7635	51.57%	11.67%	13	17
15	花蓮縣光復鄉	2018-11-25T00:09:49+08:00	1239	3649	4888	654	5542	10485	52.86%	11.82%	16	17
15	花蓮縣光復鄉	2018-11-25T04:03:05+08:00	1345	3871	5216	674	5890	11417	51.59%	11.78%	17	17
15	花蓮縣光復鄉	2018-11-24T23:23:50+08:00	1033	3014	4047	492	4539	8676	52.32%	11.91%	14	17
15	花蓮縣光復鄉	2018-11-24T22:19:49+08:00	447	1327	1774	209	1983	4218	47.01%	10.6%	9	17
15	花蓮縣光復鄉	2018-11-24T22:40:39+08:00	509	1512	2021	231	2252	4689	48.03%	10.86%	10	17
15	花蓮縣光復鄉	2018-11-25T03:32:51+08:00	1345	3871	5216	674	5890	11417	51.59%	11.78%	17	17
15	花蓮縣光復鄉	2018-11-24T23:08:50+08:00	891	2618	3509	428	3937	7635	51.57%	11.67%	13	17
15	花蓮縣光復鄉	2018-11-24T22:23:27+08:00	509	1512	2021	231	2252	4689	48.03%	10.86%	10	17
15	花蓮縣光復鄉	2018-11-24T22:51:02+08:00	687	1991	2678	305	2983	5984	49.85%	11.48%	11	17
15	花蓮縣光復鄉	2018-11-25T06:14:04+08:00	1345	3871	5216	674	5890	11417	51.59%	11.78%	17	17
15	花蓮縣光復鄉	2018-11-25T00:00:23+08:00	1153	3359	4512	598	5110	9634	53.04%	11.97%	15	17
15	花蓮縣光復鄉	2018-11-25T06:24:13+08:00	1345	3871	5216	674	5890	11417	51.59%	11.78%	17	17
15	花蓮縣光復鄉	2018-11-25T00:23:16+08:00	1345	3871	5216	674	5890	11417	51.59%	11.78%	17	17
15	花蓮縣光復鄉	2018-11-25T01:02:43+08:00	1345	3871	5216	674	5890	11417	51.59%	11.78%	17	17
15	花蓮縣光復鄉	2018-11-25T06:19:10+08:00	1345	3871	5216	674	5890	11417	51.59%	11.78%	17	17
15	花蓮縣光復鄉	2018-11-25T06:29:30+08:00	1345	3871	5216	674	5890	11417	51.59%	11.78%	17	17
15	花蓮縣光復鄉	2018-11-24T23:12:29+08:00	891	2618	3509	428	3937	7635	51.57%	11.67%	13	17
15	花蓮縣光復鄉	2018-11-25T03:50:03+08:00	1345	3871	5216	674	5890	11417	51.59%	11.78%	17	17
15	花蓮縣光復鄉	2018-11-25T01:07:39+08:00	1345	3871	5216	674	5890	11417	51.59%	11.78%	17	17
15	花蓮縣光復鄉	2018-11-25T01:26:07+08:00	1345	3871	5216	674	5890	11417	51.59%	11.78%	17	17
15	花蓮縣光復鄉	2018-11-25T03:39:07+08:00	1345	3871	5216	674	5890	11417	51.59%	11.78%	17	17
15	花蓮縣光復鄉	2018-11-25T00:14:22+08:00	1345	3871	5216	674	5890	11417	51.59%	11.78%	17	17
15	花蓮縣光復鄉	2018-11-24T23:35:22+08:00	1033	3014	4047	492	4539	8676	52.32%	11.91%	14	17
15	臺中市大里區	2018-11-25T03:49:55+08:00	29508	62260	91768	5115	96883	171769	56.4%	17.18%	106	106
15	臺中市大里區	2018-11-25T06:19:01+08:00	29508	62260	91768	5115	96883	171769	56.4%	17.18%	106	106
15	臺中市大里區	2018-11-24T22:41:41+08:00	17093	35625	52718	2963	55681	97796	56.94%	17.48%	64	106
15	臺中市大里區	2018-11-24T23:16:07+08:00	23689	49992	73681	4139	77820	137765	56.49%	17.2%	87	106
15	臺中市大里區	2018-11-25T03:56:18+08:00	29508	62260	91768	5115	96883	171769	56.4%	17.18%	106	106
15	臺中市大里區	2018-11-24T22:45:12+08:00	17583	36751	54334	3049	57383	101024	56.8%	17.4%	66	106
15	臺中市大里區	2018-11-24T23:43:21+08:00	28401	59736	88137	4903	93040	164896	56.42%	17.22%	102	106
15	臺中市大里區	2018-11-25T00:18:36+08:00	29508	62260	91768	5115	96883	171769	56.4%	17.18%	106	106
15	臺中市大里區	2018-11-24T23:51:40+08:00	28401	59736	88137	4903	93040	164896	56.42%	17.22%	102	106
15	臺中市大里區	2018-11-24T22:40:32+08:00	17093	35625	52718	2963	55681	97796	56.94%	17.48%	64	106
15	臺中市大里區	2018-11-25T01:25:57+08:00	29508	62260	91768	5115	96883	171769	56.4%	17.18%	106	106
15	臺中市大里區	2018-11-24T22:30:14+08:00	16254	33697	49951	2821	52772	92621	56.98%	17.55%	61	106
15	臺中市大里區	2018-11-25T00:23:08+08:00	29508	62260	91768	5115	96883	171769	56.4%	17.18%	106	106
15	臺中市大里區	2018-11-25T00:57:42+08:00	29508	62260	91768	5115	96883	171769	56.4%	17.18%	106	106
15	臺中市大里區	2018-11-25T06:24:05+08:00	29508	62260	91768	5115	96883	171769	56.4%	17.18%	106	106
15	臺中市大里區	2018-11-24T23:27:22+08:00	25604	53482	79086	4435	83521	148047	56.42%	17.29%	93	106
15	臺中市大里區	2018-11-24T22:57:59+08:00	19966	41777	61743	3528	65271	115143	56.69%	17.34%	74	106
15	臺中市大里區	2018-11-25T03:32:41+08:00	29508	62260	91768	5115	96883	171769	56.4%	17.18%	106	106
15	臺中市大里區	2018-11-24T23:08:41+08:00	22139	46267	68406	3826	72232	127788	56.52%	17.32%	81	106
15	臺中市大里區	2018-11-24T22:13:33+08:00	13002	26958	39960	2284	42244	73963	57.12%	17.58%	50	106
15	臺中市大里區	2018-11-24T23:19:56+08:00	24404	50811	75215	4258	79473	140618	56.52%	17.35%	89	106
15	臺中市大里區	2018-11-25T01:17:58+08:00	29508	62260	91768	5115	96883	171769	56.4%	17.18%	106	106
15	臺中市大里區	2018-11-24T23:39:22+08:00	27841	58416	86257	4839	91096	161186	56.52%	17.27%	100	106
15	臺中市大里區	2018-11-25T01:12:49+08:00	29508	62260	91768	5115	96883	171769	56.4%	17.18%	106	106
15	臺中市大里區	2018-11-24T23:47:33+08:00	28401	59736	88137	4903	93040	164896	56.42%	17.22%	102	106
15	臺中市大里區	2018-11-24T23:05:09+08:00	21593	44939	66532	3736	70268	124080	56.63%	17.4%	79	106
15	臺中市大里區	2018-11-25T06:08:58+08:00	29508	62260	91768	5115	96883	171769	56.4%	17.18%	106	106
15	臺中市大里區	2018-11-24T22:16:15+08:00	13956	28958	42914	2472	45386	79858	56.83%	17.48%	53	106
15	臺中市大里區	2018-11-24T23:31:16+08:00	26929	56273	83202	4677	87879	155510	56.51%	17.32%	97	106
15	臺中市大里區	2018-11-24T23:01:36+08:00	20584	43067	63651	3621	67272	118814	56.62%	17.32%	76	106
15	臺中市大里區	2018-11-25T04:02:57+08:00	29508	62260	91768	5115	96883	171769	56.4%	17.18%	106	106
15	臺中市大里區	2018-11-25T00:05:10+08:00	28710	60366	89076	4952	94028	166693	56.41%	17.22%	103	106
15	臺中市大里區	2018-11-25T06:29:22+08:00	29508	62260	91768	5115	96883	171769	56.4%	17.18%	106	106
15	臺中市大里區	2018-11-24T22:54:30+08:00	19645	41186	60831	3487	64318	113481	56.68%	17.31%	73	106
15	臺中市大里區	2018-11-25T06:13:57+08:00	29508	62260	91768	5115	96883	171769	56.4%	17.18%	106	106
15	臺中市大里區	2018-11-24T22:50:53+08:00	19057	39900	58957	3367	62324	109748	56.79%	17.36%	71	106
15	臺中市大里區	2018-11-24T22:37:05+08:00	17093	35625	52718	2963	55681	97796	56.94%	17.48%	64	106
15	臺中市大里區	2018-11-24T22:26:41+08:00	16007	33122	49129	2793	51922	91051	57.03%	17.58%	60	106
15	臺中市大里區	2018-11-24T22:19:41+08:00	14614	30249	44863	2573	47436	83386	56.89%	17.53%	55	106
15	臺中市大里區	2018-11-25T03:38:59+08:00	29508	62260	91768	5115	96883	171769	56.4%	17.18%	106	106
15	臺中市大里區	2018-11-25T03:44:29+08:00	29508	62260	91768	5115	96883	171769	56.4%	17.18%	106	106
15	臺中市大里區	2018-11-25T01:02:35+08:00	29508	62260	91768	5115	96883	171769	56.4%	17.18%	106	106
15	臺中市大里區	2018-11-24T23:23:42+08:00	25329	52848	78177	4393	82570	146172	56.49%	17.33%	92	106
15	臺中市大里區	2018-11-24T22:23:18+08:00	15166	31417	46583	2684	49267	86429	57%	17.55%	57	106
15	臺中市大里區	2018-11-25T00:00:15+08:00	28710	60366	89076	4952	94028	166693	56.41%	17.22%	103	106
15	臺中市大里區	2018-11-24T23:55:51+08:00	28401	59736	88137	4903	93040	164896	56.42%	17.22%	102	106
15	臺中市大里區	2018-11-24T23:35:15+08:00	27184	56989	84173	4718	88891	157447	56.46%	17.27%	98	106
15	臺中市大里區	2018-11-24T23:12:20+08:00	22696	47476	70172	3953	74125	131211	56.49%	17.3%	83	106
15	臺中市大里區	2018-11-25T00:14:14+08:00	28991	61004	89995	5011	95006	168348	56.43%	17.22%	104	106
15	臺中市大里區	2018-11-25T00:09:39+08:00	28991	61004	89995	5011	95006	168348	56.43%	17.22%	104	106
15	臺中市大里區	2018-11-25T01:07:31+08:00	29508	62260	91768	5115	96883	171769	56.4%	17.18%	106	106
15	臺中市大里區	2018-11-24T22:33:42+08:00	16846	35092	51938	2927	54865	96366	56.93%	17.48%	63	106
15	臺東縣長濱鄉	2018-11-25T03:56:28+08:00	593	1717	2310	401	2711	6484	41.81%	9.15%	11	11
15	臺東縣長濱鄉	2018-11-24T23:56:00+08:00	593	1717	2310	401	2711	6484	41.81%	9.15%	11	11
15	臺東縣長濱鄉	2018-11-24T22:58:08+08:00	527	1502	2029	341	2370	5759	41.15%	9.15%	10	11
15	臺東縣長濱鄉	2018-11-24T23:47:43+08:00	593	1717	2310	401	2711	6484	41.81%	9.15%	11	11
15	臺東縣長濱鄉	2018-11-24T23:12:30+08:00	527	1502	2029	341	2370	5759	41.15%	9.15%	10	11
15	臺東縣長濱鄉	2018-11-24T23:27:30+08:00	527	1502	2029	341	2370	5759	41.15%	9.15%	10	11
15	臺東縣長濱鄉	2018-11-25T06:09:09+08:00	593	1717	2310	401	2711	6484	41.81%	9.15%	11	11
15	臺東縣長濱鄉	2018-11-24T23:51:48+08:00	593	1717	2310	401	2711	6484	41.81%	9.15%	11	11
15	臺東縣長濱鄉	2018-11-24T22:30:23+08:00	476	1321	1797	305	2102	5154	40.78%	9.24%	9	11
15	臺東縣長濱鄉	2018-11-25T03:32:52+08:00	593	1717	2310	401	2711	6484	41.81%	9.15%	11	11
15	臺東縣長濱鄉	2018-11-24T22:13:44+08:00	373	1036	1409	202	1611	4241	37.99%	8.8%	8	11
15	臺東縣長濱鄉	2018-11-25T03:44:40+08:00	593	1717	2310	401	2711	6484	41.81%	9.15%	11	11
15	臺東縣長濱鄉	2018-11-25T00:57:51+08:00	593	1717	2310	401	2711	6484	41.81%	9.15%	11	11
15	臺東縣長濱鄉	2018-11-24T22:16:25+08:00	373	1036	1409	202	1611	4241	37.99%	8.8%	8	11
15	臺東縣長濱鄉	2018-11-25T00:09:50+08:00	593	1717	2310	401	2711	6484	41.81%	9.15%	11	11
15	臺東縣長濱鄉	2018-11-25T00:18:47+08:00	593	1717	2310	401	2711	6484	41.81%	9.15%	11	11
15	臺東縣長濱鄉	2018-11-24T22:37:14+08:00	527	1502	2029	341	2370	5759	41.15%	9.15%	10	11
15	臺東縣長濱鄉	2018-11-24T23:20:08+08:00	527	1502	2029	341	2370	5759	41.15%	9.15%	10	11
15	臺東縣長濱鄉	2018-11-24T23:31:27+08:00	527	1502	2029	341	2370	5759	41.15%	9.15%	10	11
15	臺東縣長濱鄉	2018-11-24T23:16:15+08:00	527	1502	2029	341	2370	5759	41.15%	9.15%	10	11
15	臺東縣長濱鄉	2018-11-25T01:12:58+08:00	593	1717	2310	401	2711	6484	41.81%	9.15%	11	11
15	臺東縣長濱鄉	2018-11-25T00:05:17+08:00	593	1717	2310	401	2711	6484	41.81%	9.15%	11	11
15	臺東縣長濱鄉	2018-11-24T23:05:16+08:00	527	1502	2029	341	2370	5759	41.15%	9.15%	10	11
15	臺東縣長濱鄉	2018-11-24T23:39:32+08:00	593	1717	2310	401	2711	6484	41.81%	9.15%	11	11
15	臺東縣長濱鄉	2018-11-24T22:54:37+08:00	527	1502	2029	341	2370	5759	41.15%	9.15%	10	11
15	臺東縣長濱鄉	2018-11-24T22:33:50+08:00	476	1321	1797	305	2102	5154	40.78%	9.24%	9	11
15	臺東縣長濱鄉	2018-11-24T22:45:20+08:00	527	1502	2029	341	2370	5759	41.15%	9.15%	10	11
15	臺東縣長濱鄉	2018-11-24T22:26:48+08:00	373	1036	1409	202	1611	4241	37.99%	8.8%	8	11
15	臺東縣長濱鄉	2018-11-24T23:01:45+08:00	527	1502	2029	341	2370	5759	41.15%	9.15%	10	11
15	臺東縣長濱鄉	2018-11-25T04:03:05+08:00	593	1717	2310	401	2711	6484	41.81%	9.15%	11	11
15	臺東縣長濱鄉	2018-11-24T23:08:51+08:00	527	1502	2029	341	2370	5759	41.15%	9.15%	10	11
15	臺東縣長濱鄉	2018-11-24T23:23:50+08:00	527	1502	2029	341	2370	5759	41.15%	9.15%	10	11
15	臺東縣長濱鄉	2018-11-24T22:19:49+08:00	373	1036	1409	202	1611	4241	37.99%	8.8%	8	11
15	臺東縣長濱鄉	2018-11-25T00:23:17+08:00	593	1717	2310	401	2711	6484	41.81%	9.15%	11	11
15	臺東縣長濱鄉	2018-11-25T00:00:23+08:00	593	1717	2310	401	2711	6484	41.81%	9.15%	11	11
15	臺東縣長濱鄉	2018-11-24T22:51:03+08:00	527	1502	2029	341	2370	5759	41.15%	9.15%	10	11
15	臺東縣長濱鄉	2018-11-24T22:23:28+08:00	373	1036	1409	202	1611	4241	37.99%	8.8%	8	11
15	臺東縣長濱鄉	2018-11-24T22:40:40+08:00	527	1502	2029	341	2370	5759	41.15%	9.15%	10	11
15	臺東縣長濱鄉	2018-11-25T06:24:13+08:00	593	1717	2310	401	2711	6484	41.81%	9.15%	11	11
15	臺東縣長濱鄉	2018-11-25T01:02:44+08:00	593	1717	2310	401	2711	6484	41.81%	9.15%	11	11
15	臺東縣長濱鄉	2018-11-25T06:14:05+08:00	593	1717	2310	401	2711	6484	41.81%	9.15%	11	11
15	臺東縣長濱鄉	2018-11-25T06:19:10+08:00	593	1717	2310	401	2711	6484	41.81%	9.15%	11	11
15	臺東縣長濱鄉	2018-11-25T00:14:23+08:00	593	1717	2310	401	2711	6484	41.81%	9.15%	11	11
15	臺東縣長濱鄉	2018-11-25T01:18:10+08:00	593	1717	2310	401	2711	6484	41.81%	9.15%	11	11
15	臺東縣長濱鄉	2018-11-25T03:50:03+08:00	593	1717	2310	401	2711	6484	41.81%	9.15%	11	11
15	臺東縣長濱鄉	2018-11-25T01:07:39+08:00	593	1717	2310	401	2711	6484	41.81%	9.15%	11	11
15	臺東縣長濱鄉	2018-11-25T01:26:07+08:00	593	1717	2310	401	2711	6484	41.81%	9.15%	11	11
15	臺東縣長濱鄉	2018-11-25T03:39:07+08:00	593	1717	2310	401	2711	6484	41.81%	9.15%	11	11
15	臺東縣長濱鄉	2018-11-24T22:41:50+08:00	527	1502	2029	341	2370	5759	41.15%	9.15%	10	11
15	臺東縣長濱鄉	2018-11-25T06:29:31+08:00	593	1717	2310	401	2711	6484	41.81%	9.15%	11	11
15	臺東縣長濱鄉	2018-11-24T23:35:22+08:00	527	1502	2029	341	2370	5759	41.15%	9.15%	10	11
15	臺東縣長濱鄉	2018-11-24T23:43:30+08:00	593	1717	2310	401	2711	6484	41.81%	9.15%	11	11
15	嘉義市西區	2018-11-24T23:01:47+08:00	18198	36224	54422	2774	57196	104644	54.66%	17.39%	84	96
15	嘉義市西區	2018-11-24T23:47:44+08:00	19925	39728	59653	3044	62697	114377	54.82%	17.42%	91	96
15	嘉義市西區	2018-11-24T22:45:22+08:00	16660	33084	49744	2497	52241	95778	54.54%	17.39%	77	96
15	嘉義市西區	2018-11-25T03:56:29+08:00	20975	42127	63102	3221	66323	120906	54.86%	17.35%	96	96
15	嘉義市西區	2018-11-24T23:08:52+08:00	18579	36894	55473	2822	58295	106308	54.84%	17.48%	85	96
15	嘉義市西區	2018-11-25T03:32:54+08:00	20975	42127	63102	3221	66323	120906	54.86%	17.35%	96	96
15	嘉義市西區	2018-11-24T23:51:49+08:00	20181	40352	60533	3096	63629	116004	54.85%	17.4%	92	96
15	嘉義市西區	2018-11-24T23:23:52+08:00	19413	38734	58147	2949	61096	111626	54.73%	17.39%	89	96
15	嘉義市西區	2018-11-24T22:23:30+08:00	14414	28578	42992	2108	45100	82888	54.41%	17.39%	68	96
15	嘉義市西區	2018-11-24T22:30:24+08:00	15394	30546	45940	2290	48230	88591	54.44%	17.38%	72	96
15	嘉義市西區	2018-11-25T04:03:07+08:00	20975	42127	63102	3221	66323	120906	54.86%	17.35%	96	96
15	嘉義市西區	2018-11-24T22:19:51+08:00	14179	28075	42254	2081	44335	81608	54.33%	17.37%	67	96
15	嘉義市西區	2018-11-25T06:14:06+08:00	20975	42127	63102	3221	66323	120906	54.86%	17.35%	96	96
15	嘉義市西區	2018-11-24T23:20:09+08:00	19217	38377	57594	2899	60493	110517	54.74%	17.39%	88	96
15	嘉義市西區	2018-11-24T23:31:28+08:00	19413	38734	58147	2949	61096	111626	54.73%	17.39%	89	96
15	嘉義市西區	2018-11-24T23:43:32+08:00	19656	39235	58891	3004	61895	113019	54.77%	17.39%	90	96
15	嘉義市西區	2018-11-24T22:37:15+08:00	16083	31900	47983	2421	50404	92564	54.45%	17.38%	75	96
15	嘉義市西區	2018-11-24T22:41:52+08:00	16347	32412	48759	2477	51236	93924	54.55%	17.4%	76	96
15	嘉義市西區	2018-11-24T22:26:50+08:00	15107	30002	45109	2243	47352	86962	54.45%	17.37%	71	96
15	嘉義市西區	2018-11-25T01:18:12+08:00	20975	42127	63102	3221	66323	120906	54.86%	17.35%	96	96
15	嘉義市西區	2018-11-25T00:18:48+08:00	20975	42127	63102	3221	66323	120906	54.86%	17.35%	96	96
15	嘉義市西區	2018-11-25T06:29:32+08:00	20975	42127	63102	3221	66323	120906	54.86%	17.35%	96	96
15	嘉義市西區	2018-11-24T22:54:38+08:00	17530	34941	52471	2641	55112	101018	54.56%	17.35%	81	96
15	嘉義市西區	2018-11-24T23:12:32+08:00	18579	36894	55473	2822	58295	106308	54.84%	17.48%	85	96
15	嘉義市西區	2018-11-24T22:33:51+08:00	15853	31463	47316	2391	49707	91269	54.46%	17.37%	74	96
15	嘉義市西區	2018-11-24T23:39:34+08:00	19656	39235	58891	3004	61895	113019	54.77%	17.39%	90	96
15	嘉義市西區	2018-11-25T00:05:19+08:00	20875	41647	62522	3217	65739	119723	54.91%	17.44%	95	96
15	嘉義市西區	2018-11-25T01:07:41+08:00	20975	42127	63102	3221	66323	120906	54.86%	17.35%	96	96
15	嘉義市西區	2018-11-24T23:05:17+08:00	18745	37232	55977	2839	58816	107443	54.74%	17.45%	86	96
15	嘉義市西區	2018-11-24T23:56:02+08:00	20181	40352	60533	3096	63629	116004	54.85%	17.4%	92	96
15	嘉義市西區	2018-11-24T22:13:46+08:00	13057	25911	38968	1907	40875	75021	54.48%	17.4%	62	96
15	嘉義市西區	2018-11-25T03:44:42+08:00	20975	42127	63102	3221	66323	120906	54.86%	17.35%	96	96
15	嘉義市西區	2018-11-24T23:27:32+08:00	19413	38734	58147	2949	61096	111626	54.73%	17.39%	89	96
15	嘉義市西區	2018-11-25T06:09:11+08:00	20975	42127	63102	3221	66323	120906	54.86%	17.35%	96	96
15	嘉義市西區	2018-11-24T22:51:05+08:00	16931	33633	50564	2537	53101	97323	54.56%	17.4%	78	96
15	嘉義市西區	2018-11-25T01:02:45+08:00	20975	42127	63102	3221	66323	120906	54.86%	17.35%	96	96
15	嘉義市西區	2018-11-24T22:40:41+08:00	16347	32412	48759	2477	51236	93924	54.55%	17.4%	76	96
15	嘉義市西區	2018-11-25T00:57:52+08:00	20975	42127	63102	3221	66323	120906	54.86%	17.35%	96	96
15	嘉義市西區	2018-11-25T01:13:00+08:00	20975	42127	63102	3221	66323	120906	54.86%	17.35%	96	96
15	嘉義市西區	2018-11-25T06:24:14+08:00	20975	42127	63102	3221	66323	120906	54.86%	17.35%	96	96
15	嘉義市西區	2018-11-25T00:23:18+08:00	20975	42127	63102	3221	66323	120906	54.86%	17.35%	96	96
15	嘉義市西區	2018-11-25T00:00:25+08:00	20181	40352	60533	3096	63629	116004	54.85%	17.4%	92	96
15	嘉義市西區	2018-11-24T23:35:23+08:00	19656	39235	58891	3004	61895	113019	54.77%	17.39%	90	96
15	嘉義市西區	2018-11-24T23:16:17+08:00	18988	37931	56919	2873	59792	109218	54.75%	17.39%	87	96
15	嘉義市西區	2018-11-24T22:58:10+08:00	18198	36224	54422	2774	57196	104644	54.66%	17.39%	84	96
15	嘉義市西區	2018-11-25T01:26:09+08:00	20975	42127	63102	3221	66323	120906	54.86%	17.35%	96	96
15	嘉義市西區	2018-11-25T03:39:09+08:00	20975	42127	63102	3221	66323	120906	54.86%	17.35%	96	96
15	嘉義市西區	2018-11-25T00:14:25+08:00	20975	42127	63102	3221	66323	120906	54.86%	17.35%	96	96
15	嘉義市西區	2018-11-25T00:09:52+08:00	20975	42127	63102	3221	66323	120906	54.86%	17.35%	96	96
15	嘉義市西區	2018-11-25T06:19:11+08:00	20975	42127	63102	3221	66323	120906	54.86%	17.35%	96	96
15	嘉義市西區	2018-11-25T03:50:05+08:00	20975	42127	63102	3221	66323	120906	54.86%	17.35%	96	96
15	嘉義市西區	2018-11-24T22:16:27+08:00	13978	27696	41674	2052	43726	80388	54.39%	17.39%	66	96
15	屏東縣琉球鄉	2018-11-24T22:58:06+08:00	1041	3387	4428	327	4755	10706	44.41%	9.72%	9	9
15	屏東縣琉球鄉	2018-11-25T03:56:26+08:00	1041	3387	4428	327	4755	10706	44.41%	9.72%	9	9
15	屏東縣琉球鄉	2018-11-24T23:05:15+08:00	1041	3387	4428	327	4755	10706	44.41%	9.72%	9	9
15	屏東縣琉球鄉	2018-11-24T23:39:30+08:00	1041	3387	4428	327	4755	10706	44.41%	9.72%	9	9
15	屏東縣琉球鄉	2018-11-24T22:41:48+08:00	1041	3387	4428	327	4755	10706	44.41%	9.72%	9	9
15	屏東縣琉球鄉	2018-11-25T06:29:29+08:00	1041	3387	4428	327	4755	10706	44.41%	9.72%	9	9
15	屏東縣琉球鄉	2018-11-25T01:18:07+08:00	1041	3387	4428	327	4755	10706	44.41%	9.72%	9	9
15	屏東縣琉球鄉	2018-11-25T06:19:09+08:00	1041	3387	4428	327	4755	10706	44.41%	9.72%	9	9
15	屏東縣琉球鄉	2018-11-24T23:43:28+08:00	1041	3387	4428	327	4755	10706	44.41%	9.72%	9	9
15	屏東縣琉球鄉	2018-11-25T06:09:07+08:00	1041	3387	4428	327	4755	10706	44.41%	9.72%	9	9
15	屏東縣琉球鄉	2018-11-24T23:51:47+08:00	1041	3387	4428	327	4755	10706	44.41%	9.72%	9	9
15	屏東縣琉球鄉	2018-11-24T22:13:43+08:00	1041	3387	4428	327	4755	10706	44.41%	9.72%	9	9
15	屏東縣琉球鄉	2018-11-25T06:24:11+08:00	1041	3387	4428	327	4755	10706	44.41%	9.72%	9	9
15	屏東縣琉球鄉	2018-11-24T23:08:49+08:00	1041	3387	4428	327	4755	10706	44.41%	9.72%	9	9
15	屏東縣琉球鄉	2018-11-24T22:51:01+08:00	1041	3387	4428	327	4755	10706	44.41%	9.72%	9	9
15	屏東縣琉球鄉	2018-11-25T03:44:38+08:00	1041	3387	4428	327	4755	10706	44.41%	9.72%	9	9
15	屏東縣琉球鄉	2018-11-25T00:23:15+08:00	1041	3387	4428	327	4755	10706	44.41%	9.72%	9	9
15	屏東縣琉球鄉	2018-11-24T23:23:49+08:00	1041	3387	4428	327	4755	10706	44.41%	9.72%	9	9
15	屏東縣琉球鄉	2018-11-24T22:33:49+08:00	1041	3387	4428	327	4755	10706	44.41%	9.72%	9	9
15	屏東縣琉球鄉	2018-11-24T22:37:12+08:00	1041	3387	4428	327	4755	10706	44.41%	9.72%	9	9
15	屏東縣琉球鄉	2018-11-24T23:16:14+08:00	1041	3387	4428	327	4755	10706	44.41%	9.72%	9	9
15	屏東縣琉球鄉	2018-11-25T01:26:05+08:00	1041	3387	4428	327	4755	10706	44.41%	9.72%	9	9
15	屏東縣琉球鄉	2018-11-24T22:16:23+08:00	1041	3387	4428	327	4755	10706	44.41%	9.72%	9	9
15	屏東縣琉球鄉	2018-11-25T00:14:21+08:00	1041	3387	4428	327	4755	10706	44.41%	9.72%	9	9
15	屏東縣琉球鄉	2018-11-24T23:35:21+08:00	1041	3387	4428	327	4755	10706	44.41%	9.72%	9	9
15	屏東縣琉球鄉	2018-11-24T22:45:19+08:00	1041	3387	4428	327	4755	10706	44.41%	9.72%	9	9
15	屏東縣琉球鄉	2018-11-24T22:54:36+08:00	1041	3387	4428	327	4755	10706	44.41%	9.72%	9	9
15	屏東縣琉球鄉	2018-11-25T00:09:48+08:00	1041	3387	4428	327	4755	10706	44.41%	9.72%	9	9
15	屏東縣琉球鄉	2018-11-24T23:01:44+08:00	1041	3387	4428	327	4755	10706	44.41%	9.72%	9	9
15	屏東縣琉球鄉	2018-11-24T22:26:47+08:00	1041	3387	4428	327	4755	10706	44.41%	9.72%	9	9
15	屏東縣琉球鄉	2018-11-24T23:47:41+08:00	1041	3387	4428	327	4755	10706	44.41%	9.72%	9	9
15	屏東縣琉球鄉	2018-11-25T01:12:57+08:00	1041	3387	4428	327	4755	10706	44.41%	9.72%	9	9
15	屏東縣琉球鄉	2018-11-25T00:05:16+08:00	1041	3387	4428	327	4755	10706	44.41%	9.72%	9	9
15	屏東縣琉球鄉	2018-11-25T00:57:49+08:00	1041	3387	4428	327	4755	10706	44.41%	9.72%	9	9
15	屏東縣琉球鄉	2018-11-24T22:19:48+08:00	1041	3387	4428	327	4755	10706	44.41%	9.72%	9	9
15	屏東縣琉球鄉	2018-11-24T22:30:21+08:00	1041	3387	4428	327	4755	10706	44.41%	9.72%	9	9
15	屏東縣琉球鄉	2018-11-25T03:32:50+08:00	1041	3387	4428	327	4755	10706	44.41%	9.72%	9	9
15	屏東縣琉球鄉	2018-11-24T22:40:38+08:00	1041	3387	4428	327	4755	10706	44.41%	9.72%	9	9
15	屏東縣琉球鄉	2018-11-25T04:03:04+08:00	1041	3387	4428	327	4755	10706	44.41%	9.72%	9	9
15	屏東縣琉球鄉	2018-11-25T01:02:42+08:00	1041	3387	4428	327	4755	10706	44.41%	9.72%	9	9
15	屏東縣琉球鄉	2018-11-25T06:14:03+08:00	1041	3387	4428	327	4755	10706	44.41%	9.72%	9	9
15	屏東縣琉球鄉	2018-11-24T23:55:59+08:00	1041	3387	4428	327	4755	10706	44.41%	9.72%	9	9
15	屏東縣琉球鄉	2018-11-24T22:23:26+08:00	1041	3387	4428	327	4755	10706	44.41%	9.72%	9	9
15	屏東縣琉球鄉	2018-11-24T23:27:29+08:00	1041	3387	4428	327	4755	10706	44.41%	9.72%	9	9
15	屏東縣琉球鄉	2018-11-25T00:00:22+08:00	1041	3387	4428	327	4755	10706	44.41%	9.72%	9	9
15	屏東縣琉球鄉	2018-11-24T23:31:25+08:00	1041	3387	4428	327	4755	10706	44.41%	9.72%	9	9
15	屏東縣琉球鄉	2018-11-24T23:20:04+08:00	1041	3387	4428	327	4755	10706	44.41%	9.72%	9	9
15	屏東縣琉球鄉	2018-11-25T00:18:45+08:00	1041	3387	4428	327	4755	10706	44.41%	9.72%	9	9
15	屏東縣琉球鄉	2018-11-25T01:07:38+08:00	1041	3387	4428	327	4755	10706	44.41%	9.72%	9	9
15	屏東縣琉球鄉	2018-11-25T03:39:06+08:00	1041	3387	4428	327	4755	10706	44.41%	9.72%	9	9
15	屏東縣琉球鄉	2018-11-25T03:50:02+08:00	1041	3387	4428	327	4755	10706	44.41%	9.72%	9	9
15	屏東縣琉球鄉	2018-11-24T23:12:28+08:00	1041	3387	4428	327	4755	10706	44.41%	9.72%	9	9
15	臺南市東山區	2018-11-24T22:41:41+08:00	2089	4204	6293	628	6921	18471	37.47%	11.31%	23	23
15	臺南市東山區	2018-11-24T22:45:13+08:00	2089	4204	6293	628	6921	18471	37.47%	11.31%	23	23
15	臺南市東山區	2018-11-24T23:16:07+08:00	2089	4204	6293	628	6921	18471	37.47%	11.31%	23	23
15	臺南市東山區	2018-11-25T03:56:18+08:00	2089	4204	6293	647	6940	18471	37.57%	11.31%	23	23
15	臺南市東山區	2018-11-24T23:43:21+08:00	2089	4204	6293	628	6921	18471	37.47%	11.31%	23	23
15	臺南市東山區	2018-11-25T00:18:36+08:00	2089	4204	6293	628	6921	18471	37.47%	11.31%	23	23
15	臺南市東山區	2018-11-24T23:51:40+08:00	2089	4204	6293	628	6921	18471	37.47%	11.31%	23	23
15	臺南市東山區	2018-11-24T22:40:32+08:00	2089	4204	6293	628	6921	18471	37.47%	11.31%	23	23
15	臺南市東山區	2018-11-25T01:02:36+08:00	2089	4204	6293	628	6921	18471	37.47%	11.31%	23	23
15	臺南市東山區	2018-11-24T22:30:14+08:00	2089	4204	6293	628	6921	18471	37.47%	11.31%	23	23
15	臺南市東山區	2018-11-25T01:25:58+08:00	2002	3991	5993	624	6617	17370	38.09%	11.53%	22	23
15	臺南市東山區	2018-11-25T00:23:09+08:00	2089	4204	6293	628	6921	18471	37.47%	11.31%	23	23
15	臺南市東山區	2018-11-25T00:57:42+08:00	2089	4204	6293	628	6921	18471	37.47%	11.31%	23	23
15	臺南市東山區	2018-11-25T06:24:05+08:00	2089	4204	6293	647	6940	18471	37.57%	11.31%	23	23
15	臺南市東山區	2018-11-25T01:17:59+08:00	2089	4204	6293	628	6921	18471	37.47%	11.31%	23	23
15	臺南市東山區	2018-11-24T22:57:59+08:00	2089	4204	6293	628	6921	18471	37.47%	11.31%	23	23
15	臺南市東山區	2018-11-24T23:19:57+08:00	2089	4204	6293	628	6921	18471	37.47%	11.31%	23	23
15	臺南市東山區	2018-11-25T03:32:41+08:00	2089	4204	6293	647	6940	18471	37.57%	11.31%	23	23
15	臺南市東山區	2018-11-24T22:13:33+08:00	2089	4204	6293	628	6921	18471	37.47%	11.31%	23	23
15	臺南市東山區	2018-11-24T23:27:23+08:00	2089	4204	6293	628	6921	18471	37.47%	11.31%	23	23
15	臺南市東山區	2018-11-24T23:39:22+08:00	2089	4204	6293	628	6921	18471	37.47%	11.31%	23	23
15	臺南市東山區	2018-11-25T01:12:49+08:00	2089	4204	6293	628	6921	18471	37.47%	11.31%	23	23
15	臺南市東山區	2018-11-25T06:08:59+08:00	2089	4204	6293	647	6940	18471	37.57%	11.31%	23	23
15	臺南市東山區	2018-11-24T23:31:17+08:00	2089	4204	6293	628	6921	18471	37.47%	11.31%	23	23
15	臺南市東山區	2018-11-24T23:47:34+08:00	2089	4204	6293	628	6921	18471	37.47%	11.31%	23	23
15	臺南市東山區	2018-11-24T23:05:09+08:00	2089	4204	6293	628	6921	18471	37.47%	11.31%	23	23
15	臺南市東山區	2018-11-24T23:01:36+08:00	2089	4204	6293	628	6921	18471	37.47%	11.31%	23	23
15	臺南市東山區	2018-11-25T04:02:57+08:00	2089	4204	6293	647	6940	18471	37.57%	11.31%	23	23
15	臺南市東山區	2018-11-25T00:05:10+08:00	2089	4204	6293	628	6921	18471	37.47%	11.31%	23	23
15	臺南市東山區	2018-11-25T06:19:02+08:00	2089	4204	6293	647	6940	18471	37.57%	11.31%	23	23
15	臺南市東山區	2018-11-25T06:29:22+08:00	2089	4204	6293	647	6940	18471	37.57%	11.31%	23	23
15	臺南市東山區	2018-11-25T03:49:56+08:00	2089	4204	6293	647	6940	18471	37.57%	11.31%	23	23
15	臺南市東山區	2018-11-24T22:54:30+08:00	2089	4204	6293	628	6921	18471	37.47%	11.31%	23	23
15	臺南市東山區	2018-11-25T06:13:57+08:00	2089	4204	6293	647	6940	18471	37.57%	11.31%	23	23
15	臺南市東山區	2018-11-24T22:50:53+08:00	2089	4204	6293	628	6921	18471	37.47%	11.31%	23	23
15	臺南市東山區	2018-11-24T22:37:05+08:00	2089	4204	6293	628	6921	18471	37.47%	11.31%	23	23
15	臺南市東山區	2018-11-25T00:09:40+08:00	2089	4204	6293	628	6921	18471	37.47%	11.31%	23	23
15	臺南市東山區	2018-11-24T22:26:41+08:00	2089	4204	6293	628	6921	18471	37.47%	11.31%	23	23
15	臺南市東山區	2018-11-24T22:19:41+08:00	1985	4024	6009	594	6603	17831	37.03%	11.13%	22	23
15	臺南市東山區	2018-11-25T03:38:59+08:00	2089	4204	6293	647	6940	18471	37.57%	11.31%	23	23
15	臺南市東山區	2018-11-25T03:44:29+08:00	2089	4204	6293	647	6940	18471	37.57%	11.31%	23	23
15	臺南市東山區	2018-11-25T00:00:15+08:00	2089	4204	6293	628	6921	18471	37.47%	11.31%	23	23
15	臺南市東山區	2018-11-24T23:08:42+08:00	2089	4204	6293	628	6921	18471	37.47%	11.31%	23	23
15	臺南市東山區	2018-11-24T22:23:19+08:00	1985	4024	6009	594	6603	17831	37.03%	11.13%	22	23
15	臺南市東山區	2018-11-24T23:23:43+08:00	2089	4204	6293	628	6921	18471	37.47%	11.31%	23	23
15	臺南市東山區	2018-11-24T23:55:51+08:00	2089	4204	6293	628	6921	18471	37.47%	11.31%	23	23
15	臺南市東山區	2018-11-25T00:14:15+08:00	2089	4204	6293	628	6921	18471	37.47%	11.31%	23	23
15	臺南市東山區	2018-11-24T23:35:15+08:00	2089	4204	6293	628	6921	18471	37.47%	11.31%	23	23
15	臺南市東山區	2018-11-24T22:33:43+08:00	2089	4204	6293	628	6921	18471	37.47%	11.31%	23	23
15	臺南市東山區	2018-11-24T23:12:20+08:00	2089	4204	6293	628	6921	18471	37.47%	11.31%	23	23
15	臺南市東山區	2018-11-24T22:16:16+08:00	1985	4024	6009	594	6603	17831	37.03%	11.13%	22	23
15	臺南市東山區	2018-11-25T01:07:31+08:00	2089	4204	6293	628	6921	18471	37.47%	11.31%	23	23
15	屏東縣獅子鄉	2018-11-25T03:56:26+08:00	525	1655	2180	93	2273	4230	53.74%	12.41%	8	8
15	屏東縣獅子鄉	2018-11-24T23:05:15+08:00	525	1655	2180	93	2273	4230	53.74%	12.41%	8	8
15	屏東縣獅子鄉	2018-11-25T01:18:08+08:00	525	1655	2180	93	2273	4230	53.74%	12.41%	8	8
15	屏東縣獅子鄉	2018-11-24T23:39:30+08:00	525	1655	2180	93	2273	4230	53.74%	12.41%	8	8
15	屏東縣獅子鄉	2018-11-25T06:29:29+08:00	525	1655	2180	93	2273	4230	53.74%	12.41%	8	8
15	屏東縣獅子鄉	2018-11-25T06:19:09+08:00	525	1655	2180	93	2273	4230	53.74%	12.41%	8	8
15	屏東縣獅子鄉	2018-11-24T22:58:07+08:00	463	1396	1859	87	1946	3519	55.3%	13.16%	7	8
15	屏東縣獅子鄉	2018-11-24T22:41:49+08:00	420	1281	1701	81	1782	3173	56.16%	13.24%	6	8
15	屏東縣獅子鄉	2018-11-24T23:43:28+08:00	525	1655	2180	93	2273	4230	53.74%	12.41%	8	8
15	屏東縣獅子鄉	2018-11-25T06:09:07+08:00	525	1655	2180	93	2273	4230	53.74%	12.41%	8	8
15	屏東縣獅子鄉	2018-11-24T22:30:22+08:00	339	1009	1348	71	1419	2571	55.19%	13.19%	5	8
15	屏東縣獅子鄉	2018-11-24T23:51:47+08:00	525	1655	2180	93	2273	4230	53.74%	12.41%	8	8
15	屏東縣獅子鄉	2018-11-24T22:13:43+08:00	339	1009	1348	71	1419	2571	55.19%	13.19%	5	8
15	屏東縣獅子鄉	2018-11-24T23:08:49+08:00	525	1655	2180	93	2273	4230	53.74%	12.41%	8	8
15	屏東縣獅子鄉	2018-11-25T00:23:15+08:00	525	1655	2180	93	2273	4230	53.74%	12.41%	8	8
15	屏東縣獅子鄉	2018-11-25T03:44:39+08:00	525	1655	2180	93	2273	4230	53.74%	12.41%	8	8
15	屏東縣獅子鄉	2018-11-24T23:23:49+08:00	525	1655	2180	93	2273	4230	53.74%	12.41%	8	8
15	屏東縣獅子鄉	2018-11-24T22:33:49+08:00	420	1281	1701	81	1782	3173	56.16%	13.24%	6	8
15	屏東縣獅子鄉	2018-11-24T22:37:12+08:00	420	1281	1701	81	1782	3173	56.16%	13.24%	6	8
15	屏東縣獅子鄉	2018-11-24T23:16:14+08:00	525	1655	2180	93	2273	4230	53.74%	12.41%	8	8
15	屏東縣獅子鄉	2018-11-24T22:16:24+08:00	339	1009	1348	71	1419	2571	55.19%	13.19%	5	8
15	屏東縣獅子鄉	2018-11-25T00:14:21+08:00	525	1655	2180	93	2273	4230	53.74%	12.41%	8	8
15	屏東縣獅子鄉	2018-11-24T23:35:21+08:00	525	1655	2180	93	2273	4230	53.74%	12.41%	8	8
15	屏東縣獅子鄉	2018-11-24T22:45:19+08:00	420	1281	1701	81	1782	3173	56.16%	13.24%	6	8
15	屏東縣獅子鄉	2018-11-24T22:54:36+08:00	463	1396	1859	87	1946	3519	55.3%	13.16%	7	8
15	屏東縣獅子鄉	2018-11-25T00:09:48+08:00	525	1655	2180	93	2273	4230	53.74%	12.41%	8	8
15	屏東縣獅子鄉	2018-11-24T23:01:44+08:00	463	1396	1859	87	1946	3519	55.3%	13.16%	7	8
15	屏東縣獅子鄉	2018-11-24T22:26:47+08:00	339	1009	1348	71	1419	2571	55.19%	13.19%	5	8
15	屏東縣獅子鄉	2018-11-24T23:47:41+08:00	525	1655	2180	93	2273	4230	53.74%	12.41%	8	8
15	屏東縣獅子鄉	2018-11-25T01:12:57+08:00	525	1655	2180	93	2273	4230	53.74%	12.41%	8	8
15	屏東縣獅子鄉	2018-11-25T00:05:16+08:00	525	1655	2180	93	2273	4230	53.74%	12.41%	8	8
15	屏東縣獅子鄉	2018-11-25T00:57:49+08:00	525	1655	2180	93	2273	4230	53.74%	12.41%	8	8
15	屏東縣獅子鄉	2018-11-24T22:19:48+08:00	339	1009	1348	71	1419	2571	55.19%	13.19%	5	8
15	屏東縣獅子鄉	2018-11-25T03:32:50+08:00	525	1655	2180	93	2273	4230	53.74%	12.41%	8	8
15	屏東縣獅子鄉	2018-11-25T04:03:04+08:00	525	1655	2180	93	2273	4230	53.74%	12.41%	8	8
15	屏東縣獅子鄉	2018-11-24T22:40:39+08:00	420	1281	1701	81	1782	3173	56.16%	13.24%	6	8
15	屏東縣獅子鄉	2018-11-24T22:23:27+08:00	339	1009	1348	71	1419	2571	55.19%	13.19%	5	8
15	屏東縣獅子鄉	2018-11-24T22:51:02+08:00	463	1396	1859	87	1946	3519	55.3%	13.16%	7	8
15	屏東縣獅子鄉	2018-11-25T06:14:04+08:00	525	1655	2180	93	2273	4230	53.74%	12.41%	8	8
15	屏東縣獅子鄉	2018-11-24T23:55:59+08:00	525	1655	2180	93	2273	4230	53.74%	12.41%	8	8
15	屏東縣獅子鄉	2018-11-25T06:24:12+08:00	525	1655	2180	93	2273	4230	53.74%	12.41%	8	8
15	屏東縣獅子鄉	2018-11-24T23:27:29+08:00	525	1655	2180	93	2273	4230	53.74%	12.41%	8	8
15	屏東縣獅子鄉	2018-11-25T00:00:22+08:00	525	1655	2180	93	2273	4230	53.74%	12.41%	8	8
15	屏東縣獅子鄉	2018-11-25T01:02:43+08:00	525	1655	2180	93	2273	4230	53.74%	12.41%	8	8
15	屏東縣獅子鄉	2018-11-24T23:12:29+08:00	525	1655	2180	93	2273	4230	53.74%	12.41%	8	8
15	屏東縣獅子鄉	2018-11-24T23:31:25+08:00	525	1655	2180	93	2273	4230	53.74%	12.41%	8	8
15	屏東縣獅子鄉	2018-11-24T23:20:04+08:00	525	1655	2180	93	2273	4230	53.74%	12.41%	8	8
15	屏東縣獅子鄉	2018-11-25T00:18:45+08:00	525	1655	2180	93	2273	4230	53.74%	12.41%	8	8
15	屏東縣獅子鄉	2018-11-25T01:07:38+08:00	525	1655	2180	93	2273	4230	53.74%	12.41%	8	8
15	屏東縣獅子鄉	2018-11-25T03:39:06+08:00	525	1655	2180	93	2273	4230	53.74%	12.41%	8	8
15	屏東縣獅子鄉	2018-11-25T01:26:06+08:00	525	1655	2180	93	2273	4230	53.74%	12.41%	8	8
15	屏東縣獅子鄉	2018-11-25T03:50:02+08:00	525	1655	2180	93	2273	4230	53.74%	12.41%	8	8
15	臺南市將軍區	2018-11-24T23:16:08+08:00	2093	5114	7207	609	7816	17754	44.02%	11.79%	24	24
15	臺南市將軍區	2018-11-24T22:41:41+08:00	2093	5114	7207	609	7816	17754	44.02%	11.79%	24	24
15	臺南市將軍區	2018-11-25T00:18:37+08:00	2093	5114	7207	609	7816	17754	44.02%	11.79%	24	24
15	臺南市將軍區	2018-11-24T22:45:13+08:00	2093	5114	7207	609	7816	17754	44.02%	11.79%	24	24
15	臺南市將軍區	2018-11-25T03:56:18+08:00	2093	5114	7207	609	7816	17754	44.02%	11.79%	24	24
15	臺南市將軍區	2018-11-24T22:58:00+08:00	2093	5114	7207	609	7816	17754	44.02%	11.79%	24	24
15	臺南市將軍區	2018-11-24T23:51:40+08:00	2093	5114	7207	609	7816	17754	44.02%	11.79%	24	24
15	臺南市將軍區	2018-11-24T22:40:32+08:00	2093	5114	7207	609	7816	17754	44.02%	11.79%	24	24
15	臺南市將軍區	2018-11-25T01:02:36+08:00	2093	5114	7207	609	7816	17754	44.02%	11.79%	24	24
15	臺南市將軍區	2018-11-24T22:19:42+08:00	2093	5114	7207	609	7816	17754	44.02%	11.79%	24	24
15	臺南市將軍區	2018-11-25T01:25:58+08:00	2093	5114	7207	609	7816	17754	44.02%	11.79%	24	24
15	臺南市將軍區	2018-11-24T22:30:15+08:00	2093	5114	7207	609	7816	17754	44.02%	11.79%	24	24
15	臺南市將軍區	2018-11-25T00:23:09+08:00	2093	5114	7207	609	7816	17754	44.02%	11.79%	24	24
15	臺南市將軍區	2018-11-25T00:57:42+08:00	2093	5114	7207	609	7816	17754	44.02%	11.79%	24	24
15	臺南市將軍區	2018-11-25T06:24:05+08:00	2093	5114	7207	609	7816	17754	44.02%	11.79%	24	24
15	臺南市將軍區	2018-11-25T00:00:16+08:00	2093	5114	7207	609	7816	17754	44.02%	11.79%	24	24
15	臺南市將軍區	2018-11-25T01:17:59+08:00	2093	5114	7207	609	7816	17754	44.02%	11.79%	24	24
15	臺南市將軍區	2018-11-24T23:19:57+08:00	2093	5114	7207	609	7816	17754	44.02%	11.79%	24	24
15	臺南市將軍區	2018-11-24T23:55:52+08:00	2093	5114	7207	609	7816	17754	44.02%	11.79%	24	24
15	臺南市將軍區	2018-11-24T22:13:34+08:00	2093	5114	7207	609	7816	17754	44.02%	11.79%	24	24
15	臺南市將軍區	2018-11-24T23:27:23+08:00	2093	5114	7207	609	7816	17754	44.02%	11.79%	24	24
15	臺南市將軍區	2018-11-24T23:39:22+08:00	2093	5114	7207	609	7816	17754	44.02%	11.79%	24	24
15	臺南市將軍區	2018-11-25T01:12:49+08:00	2093	5114	7207	609	7816	17754	44.02%	11.79%	24	24
15	臺南市將軍區	2018-11-25T06:08:59+08:00	2093	5114	7207	609	7816	17754	44.02%	11.79%	24	24
15	臺南市將軍區	2018-11-24T23:31:17+08:00	2093	5114	7207	609	7816	17754	44.02%	11.79%	24	24
15	臺南市將軍區	2018-11-24T23:47:34+08:00	2093	5114	7207	609	7816	17754	44.02%	11.79%	24	24
15	臺南市將軍區	2018-11-24T23:05:09+08:00	2093	5114	7207	609	7816	17754	44.02%	11.79%	24	24
15	臺南市將軍區	2018-11-24T23:01:36+08:00	2093	5114	7207	609	7816	17754	44.02%	11.79%	24	24
15	臺南市將軍區	2018-11-25T04:02:57+08:00	2093	5114	7207	609	7816	17754	44.02%	11.79%	24	24
15	臺南市將軍區	2018-11-25T00:05:10+08:00	2093	5114	7207	609	7816	17754	44.02%	11.79%	24	24
15	臺南市將軍區	2018-11-25T06:19:02+08:00	2093	5114	7207	609	7816	17754	44.02%	11.79%	24	24
15	臺南市將軍區	2018-11-25T06:29:22+08:00	2093	5114	7207	609	7816	17754	44.02%	11.79%	24	24
15	臺南市將軍區	2018-11-25T03:49:56+08:00	2093	5114	7207	609	7816	17754	44.02%	11.79%	24	24
15	臺南市將軍區	2018-11-24T22:54:30+08:00	2093	5114	7207	609	7816	17754	44.02%	11.79%	24	24
15	臺南市將軍區	2018-11-24T22:50:54+08:00	2093	5114	7207	609	7816	17754	44.02%	11.79%	24	24
15	臺南市將軍區	2018-11-25T06:13:57+08:00	2093	5114	7207	609	7816	17754	44.02%	11.79%	24	24
15	臺南市將軍區	2018-11-24T22:37:05+08:00	2093	5114	7207	609	7816	17754	44.02%	11.79%	24	24
15	臺南市將軍區	2018-11-24T23:43:22+08:00	2093	5114	7207	609	7816	17754	44.02%	11.79%	24	24
15	臺南市將軍區	2018-11-25T00:09:40+08:00	2093	5114	7207	609	7816	17754	44.02%	11.79%	24	24
15	臺南市將軍區	2018-11-24T22:26:41+08:00	2093	5114	7207	609	7816	17754	44.02%	11.79%	24	24
15	臺南市將軍區	2018-11-25T03:44:29+08:00	2093	5114	7207	609	7816	17754	44.02%	11.79%	24	24
15	臺南市將軍區	2018-11-25T03:32:42+08:00	2093	5114	7207	609	7816	17754	44.02%	11.79%	24	24
15	臺南市將軍區	2018-11-24T23:08:42+08:00	2093	5114	7207	609	7816	17754	44.02%	11.79%	24	24
15	臺南市將軍區	2018-11-24T22:23:19+08:00	2093	5114	7207	609	7816	17754	44.02%	11.79%	24	24
15	臺南市將軍區	2018-11-24T23:23:43+08:00	2093	5114	7207	609	7816	17754	44.02%	11.79%	24	24
15	臺南市將軍區	2018-11-25T00:14:15+08:00	2093	5114	7207	609	7816	17754	44.02%	11.79%	24	24
15	臺南市將軍區	2018-11-24T23:35:15+08:00	2093	5114	7207	609	7816	17754	44.02%	11.79%	24	24
15	臺南市將軍區	2018-11-24T22:33:43+08:00	2093	5114	7207	609	7816	17754	44.02%	11.79%	24	24
15	臺南市將軍區	2018-11-25T03:39:00+08:00	2093	5114	7207	609	7816	17754	44.02%	11.79%	24	24
15	臺南市將軍區	2018-11-24T23:12:21+08:00	2093	5114	7207	609	7816	17754	44.02%	11.79%	24	24
15	臺南市將軍區	2018-11-24T22:16:16+08:00	2093	5114	7207	609	7816	17754	44.02%	11.79%	24	24
15	臺南市將軍區	2018-11-25T01:07:31+08:00	2093	5114	7207	609	7816	17754	44.02%	11.79%	24	24
15	新竹市	2018-11-24T23:01:47+08:00	46019	83768	129787	6019	135806	239973	56.59%	19.18%	214	299
15	新竹市	2018-11-24T23:47:44+08:00	61140	111761	172901	8059	180960	319782	56.59%	19.12%	275	299
15	新竹市	2018-11-24T22:58:09+08:00	44692	81264	125956	5829	131785	232759	56.62%	19.2%	208	299
15	新竹市	2018-11-25T03:56:29+08:00	67231	123030	190261	8894	199155	351775	56.61%	19.11%	299	299
15	新竹市	2018-11-25T03:32:53+08:00	67231	123030	190261	8894	199155	351775	56.61%	19.11%	299	299
15	新竹市	2018-11-24T23:08:52+08:00	48390	87966	136356	6331	142687	252092	56.6%	19.2%	223	299
15	新竹市	2018-11-24T23:51:49+08:00	62463	114125	176588	8209	184797	326701	56.56%	19.12%	280	299
15	新竹市	2018-11-25T03:44:41+08:00	67231	123030	190261	8894	199155	351775	56.61%	19.11%	299	299
15	新竹市	2018-11-24T23:27:31+08:00	56247	102680	158927	7381	166308	293428	56.68%	19.17%	255	299
15	新竹市	2018-11-24T22:30:24+08:00	35568	64845	100413	4669	105082	185864	56.54%	19.14%	170	299
15	新竹市	2018-11-25T04:03:07+08:00	67231	123030	190261	8894	199155	351775	56.61%	19.11%	299	299
15	新竹市	2018-11-24T22:19:51+08:00	32995	60295	93290	4369	97659	173298	56.35%	19.04%	159	299
15	新竹市	2018-11-25T06:14:06+08:00	67231	123030	190261	8894	199155	351775	56.61%	19.11%	299	299
15	新竹市	2018-11-24T23:20:09+08:00	53445	97101	150546	6959	157505	278271	56.6%	19.21%	243	299
15	新竹市	2018-11-24T23:31:28+08:00	56827	103662	160489	7471	167960	296256	56.69%	19.18%	257	299
15	新竹市	2018-11-24T23:43:32+08:00	60110	109871	169981	7901	177882	314263	56.6%	19.13%	271	299
15	新竹市	2018-11-24T22:37:15+08:00	39251	71292	110543	5122	115665	204302	56.61%	19.21%	185	299
15	新竹市	2018-11-25T00:18:48+08:00	66507	121598	188105	8783	196888	347957	56.58%	19.11%	296	299
15	新竹市	2018-11-25T06:29:32+08:00	67231	123030	190261	8894	199155	351775	56.61%	19.11%	299	299
15	新竹市	2018-11-24T22:45:21+08:00	40379	73347	113726	5323	119049	209874	56.72%	19.24%	190	299
15	新竹市	2018-11-24T22:54:38+08:00	43720	79345	123065	5729	128794	227675	56.57%	19.2%	204	299
15	新竹市	2018-11-24T23:12:32+08:00	49317	89606	138923	6445	145368	257006	56.56%	19.19%	227	299
15	新竹市	2018-11-24T22:33:51+08:00	37823	68892	106715	4981	111696	197399	56.58%	19.16%	179	299
15	新竹市	2018-11-24T23:39:34+08:00	59715	109080	168795	7826	176621	311956	56.62%	19.14%	269	299
15	新竹市	2018-11-25T00:05:19+08:00	64908	118628	183536	8581	192117	339821	56.53%	19.1%	290	299
15	新竹市	2018-11-24T22:26:49+08:00	34347	62832	97179	4547	101726	180323	56.41%	19.05%	165	299
15	新竹市	2018-11-25T01:07:41+08:00	67231	123030	190261	8894	199155	351775	56.61%	19.11%	299	299
15	新竹市	2018-11-24T23:05:17+08:00	46744	84961	131705	6121	137826	243562	56.59%	19.19%	217	299
15	新竹市	2018-11-24T23:56:02+08:00	62858	114897	177755	8258	186013	328922	56.55%	19.11%	282	299
15	新竹市	2018-11-24T22:13:46+08:00	31002	56807	87809	4146	91955	163371	56.29%	18.98%	151	299
15	新竹市	2018-11-24T23:23:51+08:00	54580	99671	154251	7155	161406	284778	56.68%	19.17%	248	299
15	新竹市	2018-11-24T22:23:29+08:00	33669	61589	95258	4456	99714	176828	56.39%	19.04%	162	299
15	新竹市	2018-11-25T01:02:45+08:00	67231	123030	190261	8894	199155	351775	56.61%	19.11%	299	299
15	新竹市	2018-11-24T22:40:41+08:00	39670	72047	111717	5226	116943	206326	56.68%	19.23%	187	299
15	新竹市	2018-11-25T00:57:52+08:00	67231	123030	190261	8894	199155	351775	56.61%	19.11%	299	299
15	新竹市	2018-11-24T22:51:04+08:00	41235	74914	116149	5431	121580	214216	56.76%	19.25%	194	299
15	新竹市	2018-11-25T06:09:10+08:00	67231	123030	190261	8894	199155	351775	56.61%	19.11%	299	299
15	新竹市	2018-11-25T01:13:00+08:00	67231	123030	190261	8894	199155	351775	56.61%	19.11%	299	299
15	新竹市	2018-11-25T06:24:14+08:00	67231	123030	190261	8894	199155	351775	56.61%	19.11%	299	299
15	新竹市	2018-11-25T00:23:18+08:00	66507	121598	188105	8783	196888	347957	56.58%	19.11%	296	299
15	新竹市	2018-11-25T00:00:25+08:00	63615	116285	179900	8381	188281	333046	56.53%	19.1%	285	299
15	新竹市	2018-11-24T23:35:23+08:00	57552	104904	162456	7585	170041	300247	56.63%	19.17%	260	299
15	新竹市	2018-11-24T23:16:17+08:00	52524	95184	147708	6807	154515	273125	56.57%	19.23%	239	299
15	新竹市	2018-11-25T00:14:24+08:00	66249	121133	187382	8755	196137	346640	56.58%	19.11%	295	299
15	新竹市	2018-11-25T01:26:09+08:00	67231	123030	190261	8894	199155	351775	56.61%	19.11%	299	299
15	新竹市	2018-11-25T03:50:04+08:00	67231	123030	190261	8894	199155	351775	56.61%	19.11%	299	299
15	新竹市	2018-11-24T22:16:26+08:00	31918	58521	90439	4253	94692	168271	56.27%	18.97%	155	299
15	新竹市	2018-11-25T01:18:11+08:00	67231	123030	190261	8894	199155	351775	56.61%	19.11%	299	299
15	新竹市	2018-11-25T00:09:52+08:00	65711	120122	185833	8706	194539	343863	56.57%	19.11%	293	299
15	新竹市	2018-11-25T06:19:11+08:00	67231	123030	190261	8894	199155	351775	56.61%	19.11%	299	299
15	新竹市	2018-11-24T22:41:51+08:00	39670	72047	111717	5226	116943	206326	56.68%	19.23%	187	299
15	新竹市	2018-11-25T03:39:08+08:00	67231	123030	190261	8894	199155	351775	56.61%	19.11%	299	299
15	新竹縣	2018-11-24T22:26:43+08:00	29777	67151	96928	5437	102365	182457	56.1%	16.32%	195	404
15	新竹縣	2018-11-25T00:09:42+08:00	64997	139676	204673	10435	215108	381435	56.39%	17.04%	358	404
15	新竹縣	2018-11-25T03:56:21+08:00	77180	163313	240493	11783	252276	445051	56.68%	17.34%	404	404
15	新竹縣	2018-11-25T01:12:52+08:00	76249	161527	237776	11697	249473	440224	56.67%	17.32%	401	404
15	新竹縣	2018-11-24T22:37:07+08:00	35045	79181	114226	6404	120630	214428	56.26%	16.34%	223	404
15	新竹縣	2018-11-24T22:54:32+08:00	42906	94867	137773	7516	145289	258090	56.29%	16.62%	261	404
15	新竹縣	2018-11-24T22:50:56+08:00	40532	89908	130440	7183	137623	244846	56.21%	16.55%	249	404
15	新竹縣	2018-11-25T00:05:12+08:00	62985	135247	198232	10154	208386	369514	56.39%	17.05%	349	404
15	新竹縣	2018-11-24T22:45:15+08:00	38006	84493	122499	6806	129305	230273	56.15%	16.5%	237	404
15	新竹縣	2018-11-25T01:02:38+08:00	75714	160546	236260	11649	247909	437506	56.66%	17.31%	399	404
15	新竹縣	2018-11-25T00:57:44+08:00	75448	160020	235468	11602	247070	436036	56.66%	17.3%	398	404
15	新竹縣	2018-11-24T22:40:34+08:00	36427	81821	118248	6576	124824	221876	56.26%	16.42%	229	404
15	新竹縣	2018-11-24T22:19:44+08:00	27851	63375	91226	5208	96434	171465	56.24%	16.24%	186	404
15	新竹縣	2018-11-25T00:00:18+08:00	61407	132121	193528	10008	203536	361093	56.37%	17.01%	343	404
15	新竹縣	2018-11-24T23:55:54+08:00	60688	130659	191347	9891	201238	356896	56.39%	17%	340	404
15	新竹縣	2018-11-24T23:27:25+08:00	53826	116587	170413	9083	179496	317759	56.49%	16.94%	310	404
15	新竹縣	2018-11-24T23:19:59+08:00	52193	112807	165000	8863	173863	308072	56.44%	16.94%	302	404
15	新竹縣	2018-11-25T01:07:33+08:00	75999	160992	236991	11674	248665	438718	56.68%	17.32%	400	404
15	新竹縣	2018-11-24T23:39:25+08:00	57758	124416	182174	9517	191691	340219	56.34%	16.98%	327	404
15	新竹縣	2018-11-24T23:12:24+08:00	48908	106716	155624	8429	164053	290991	56.38%	16.81%	288	404
15	新竹縣	2018-11-25T00:18:40+08:00	66799	143040	209839	10686	220525	391035	56.4%	17.08%	365	404
15	新竹縣	2018-11-24T23:01:38+08:00	46068	100540	146608	7964	154572	274451	56.32%	16.79%	274	404
15	新竹縣	2018-11-24T23:31:20+08:00	55827	120266	176093	9224	185317	328649	56.39%	16.99%	319	404
15	新竹縣	2018-11-24T23:35:17+08:00	56161	121040	177201	9316	186517	330720	56.4%	16.98%	321	404
15	新竹縣	2018-11-25T04:02:59+08:00	77180	163313	240493	11783	252276	445051	56.68%	17.34%	404	404
15	新竹縣	2018-11-25T00:14:17+08:00	65352	140433	205785	10510	216295	383573	56.39%	17.04%	360	404
15	新竹縣	2018-11-24T23:43:24+08:00	58497	125768	184265	9608	193873	344160	56.33%	17%	330	404
15	新竹縣	2018-11-24T22:58:02+08:00	44125	96845	140970	7738	148708	264250	56.28%	16.7%	266	404
15	新竹縣	2018-11-25T03:49:58+08:00	77180	163313	240493	11783	252276	445051	56.68%	17.34%	404	404
15	新竹縣	2018-11-25T01:18:02+08:00	76582	162106	238688	11715	250403	441869	56.67%	17.33%	402	404
15	新竹縣	2018-11-25T06:29:25+08:00	77180	163313	240493	11783	252276	445051	56.68%	17.34%	404	404
15	新竹縣	2018-11-24T23:05:11+08:00	47181	102934	150115	8129	158244	280854	56.34%	16.8%	280	404
15	新竹縣	2018-11-25T06:13:59+08:00	77180	163313	240493	11783	252276	445051	56.68%	17.34%	404	404
15	新竹縣	2018-11-24T22:41:44+08:00	36427	81821	118248	6576	124824	221876	56.26%	16.42%	229	404
15	新竹縣	2018-11-25T06:19:04+08:00	77180	163313	240493	11783	252276	445051	56.68%	17.34%	404	404
15	新竹縣	2018-11-25T06:24:07+08:00	77180	163313	240493	11783	252276	445051	56.68%	17.34%	404	404
15	新竹縣	2018-11-24T22:30:17+08:00	30882	69407	100289	5623	105912	188485	56.19%	16.38%	200	404
15	新竹縣	2018-11-24T23:51:42+08:00	60070	129349	189419	9826	199245	353346	56.39%	17%	337	404
15	新竹縣	2018-11-25T06:09:02+08:00	77180	163313	240493	11783	252276	445051	56.68%	17.34%	404	404
15	新竹縣	2018-11-24T23:23:45+08:00	53097	114871	167968	8957	176925	313395	56.45%	16.94%	306	404
15	新竹縣	2018-11-25T03:44:32+08:00	77180	163313	240493	11783	252276	445051	56.68%	17.34%	404	404
15	新竹縣	2018-11-24T23:08:44+08:00	48211	105247	153458	8301	161759	286899	56.38%	16.8%	285	404
15	新竹縣	2018-11-24T22:23:21+08:00	29321	66242	95563	5385	100948	179896	56.11%	16.3%	193	404
15	新竹縣	2018-11-25T03:32:44+08:00	77180	163313	240493	11783	252276	445051	56.68%	17.34%	404	404
15	新竹縣	2018-11-24T22:13:37+08:00	24187	55669	79856	4597	84453	150012	56.3%	16.12%	167	404
15	新竹縣	2018-11-25T00:23:11+08:00	67091	143584	210675	10714	221389	392364	56.42%	17.1%	366	404
15	新竹縣	2018-11-24T23:16:10+08:00	51297	110852	162149	8713	170862	302784	56.43%	16.94%	298	404
15	新竹縣	2018-11-25T01:26:00+08:00	76582	162106	238688	11715	250403	441869	56.67%	17.33%	402	404
15	新竹縣	2018-11-24T23:47:36+08:00	58783	126355	185138	9663	194801	345813	56.33%	17%	331	404
15	新竹縣	2018-11-25T03:39:01+08:00	77180	163313	240493	11783	252276	445051	56.68%	17.34%	404	404
15	新竹縣	2018-11-24T22:33:45+08:00	33999	76795	110794	6167	116961	207997	56.23%	16.35%	216	404
15	新竹縣	2018-11-24T22:16:18+08:00	25969	59509	85478	4863	90341	161214	56.04%	16.11%	177	404
15	新竹縣寶山鄉	2018-11-24T22:26:43+08:00	1556	2603	4159	254	4413	7377	59.82%	21.09%	8	12
15	新竹縣寶山鄉	2018-11-25T03:56:21+08:00	2608	4591	7199	410	7609	12973	58.65%	20.1%	12	12
15	新竹縣寶山鄉	2018-11-25T01:12:52+08:00	2608	4591	7199	410	7609	12973	58.65%	20.1%	12	12
15	新竹縣寶山鄉	2018-11-24T22:54:32+08:00	1556	2603	4159	254	4413	7377	59.82%	21.09%	8	12
15	新竹縣寶山鄉	2018-11-24T22:50:56+08:00	1556	2603	4159	254	4413	7377	59.82%	21.09%	8	12
15	新竹縣寶山鄉	2018-11-25T00:09:43+08:00	2342	4065	6407	363	6770	11503	58.85%	20.36%	11	12
15	新竹縣寶山鄉	2018-11-25T00:05:12+08:00	2342	4065	6407	363	6770	11503	58.85%	20.36%	11	12
15	新竹縣寶山鄉	2018-11-24T22:37:08+08:00	1556	2603	4159	254	4413	7377	59.82%	21.09%	8	12
15	新竹縣寶山鄉	2018-11-24T22:45:15+08:00	1556	2603	4159	254	4413	7377	59.82%	21.09%	8	12
15	新竹縣寶山鄉	2018-11-25T01:02:38+08:00	2608	4591	7199	410	7609	12973	58.65%	20.1%	12	12
15	新竹縣寶山鄉	2018-11-24T22:40:34+08:00	1556	2603	4159	254	4413	7377	59.82%	21.09%	8	12
15	新竹縣寶山鄉	2018-11-25T04:03:00+08:00	2608	4591	7199	410	7609	12973	58.65%	20.1%	12	12
15	新竹縣寶山鄉	2018-11-25T00:57:45+08:00	2342	4065	6407	363	6770	11503	58.85%	20.36%	11	12
15	新竹縣寶山鄉	2018-11-24T22:19:44+08:00	1556	2603	4159	254	4413	7377	59.82%	21.09%	8	12
15	新竹縣寶山鄉	2018-11-25T06:14:00+08:00	2608	4591	7199	410	7609	12973	58.65%	20.1%	12	12
15	新竹縣寶山鄉	2018-11-25T00:00:18+08:00	1959	3386	5345	322	5667	9603	59.01%	20.4%	10	12
15	新竹縣寶山鄉	2018-11-24T23:55:54+08:00	1959	3386	5345	322	5667	9603	59.01%	20.4%	10	12
15	新竹縣寶山鄉	2018-11-24T23:27:25+08:00	1959	3386	5345	322	5667	9603	59.01%	20.4%	10	12
15	新竹縣寶山鄉	2018-11-24T22:23:22+08:00	1556	2603	4159	254	4413	7377	59.82%	21.09%	8	12
15	新竹縣寶山鄉	2018-11-24T23:01:39+08:00	1556	2603	4159	254	4413	7377	59.82%	21.09%	8	12
15	新竹縣寶山鄉	2018-11-24T23:39:25+08:00	1959	3386	5345	322	5667	9603	59.01%	20.4%	10	12
15	新竹縣寶山鄉	2018-11-24T23:20:00+08:00	1959	3386	5345	322	5667	9603	59.01%	20.4%	10	12
15	新竹縣寶山鄉	2018-11-25T01:07:34+08:00	2608	4591	7199	410	7609	12973	58.65%	20.1%	12	12
15	新竹縣寶山鄉	2018-11-24T23:12:24+08:00	1556	2603	4159	254	4413	7377	59.82%	21.09%	8	12
15	新竹縣寶山鄉	2018-11-25T00:18:40+08:00	2342	4065	6407	363	6770	11503	58.85%	20.36%	11	12
15	新竹縣寶山鄉	2018-11-25T03:39:02+08:00	2608	4591	7199	410	7609	12973	58.65%	20.1%	12	12
15	新竹縣寶山鄉	2018-11-24T23:31:20+08:00	1959	3386	5345	322	5667	9603	59.01%	20.4%	10	12
15	新竹縣寶山鄉	2018-11-24T23:35:17+08:00	1959	3386	5345	322	5667	9603	59.01%	20.4%	10	12
15	新竹縣寶山鄉	2018-11-25T00:14:17+08:00	2342	4065	6407	363	6770	11503	58.85%	20.36%	11	12
15	新竹縣寶山鄉	2018-11-24T23:43:24+08:00	1959	3386	5345	322	5667	9603	59.01%	20.4%	10	12
15	新竹縣寶山鄉	2018-11-24T22:58:02+08:00	1556	2603	4159	254	4413	7377	59.82%	21.09%	8	12
15	新竹縣寶山鄉	2018-11-25T03:49:58+08:00	2608	4591	7199	410	7609	12973	58.65%	20.1%	12	12
15	新竹縣寶山鄉	2018-11-25T01:18:02+08:00	2608	4591	7199	410	7609	12973	58.65%	20.1%	12	12
15	新竹縣寶山鄉	2018-11-25T06:29:25+08:00	2608	4591	7199	410	7609	12973	58.65%	20.1%	12	12
15	新竹縣寶山鄉	2018-11-25T06:19:05+08:00	2608	4591	7199	410	7609	12973	58.65%	20.1%	12	12
15	新竹縣寶山鄉	2018-11-24T23:05:11+08:00	1556	2603	4159	254	4413	7377	59.82%	21.09%	8	12
15	新竹縣寶山鄉	2018-11-24T22:41:44+08:00	1556	2603	4159	254	4413	7377	59.82%	21.09%	8	12
15	新竹縣寶山鄉	2018-11-24T23:51:43+08:00	1959	3386	5345	322	5667	9603	59.01%	20.4%	10	12
15	新竹縣寶山鄉	2018-11-24T22:30:17+08:00	1556	2603	4159	254	4413	7377	59.82%	21.09%	8	12
15	新竹縣寶山鄉	2018-11-25T06:24:08+08:00	2608	4591	7199	410	7609	12973	58.65%	20.1%	12	12
15	新竹縣寶山鄉	2018-11-25T06:09:02+08:00	2608	4591	7199	410	7609	12973	58.65%	20.1%	12	12
15	新竹縣寶山鄉	2018-11-24T23:23:45+08:00	1959	3386	5345	322	5667	9603	59.01%	20.4%	10	12
15	新竹縣寶山鄉	2018-11-25T03:44:32+08:00	2608	4591	7199	410	7609	12973	58.65%	20.1%	12	12
15	新竹縣寶山鄉	2018-11-25T03:32:45+08:00	2608	4591	7199	410	7609	12973	58.65%	20.1%	12	12
15	新竹縣寶山鄉	2018-11-24T22:13:38+08:00	1368	2101	3469	192	3661	6172	59.32%	22.16%	7	12
15	新竹縣寶山鄉	2018-11-24T23:08:45+08:00	1556	2603	4159	254	4413	7377	59.82%	21.09%	8	12
15	新竹縣寶山鄉	2018-11-25T00:23:11+08:00	2342	4065	6407	363	6770	11503	58.85%	20.36%	11	12
15	新竹縣寶山鄉	2018-11-24T23:16:10+08:00	1959	3386	5345	322	5667	9603	59.01%	20.4%	10	12
15	新竹縣寶山鄉	2018-11-24T23:47:37+08:00	1959	3386	5345	322	5667	9603	59.01%	20.4%	10	12
15	新竹縣寶山鄉	2018-11-24T22:16:19+08:00	1368	2101	3469	192	3661	6172	59.32%	22.16%	7	12
15	新竹縣寶山鄉	2018-11-25T01:26:01+08:00	2608	4591	7199	410	7609	12973	58.65%	20.1%	12	12
15	新竹縣寶山鄉	2018-11-24T22:33:45+08:00	1556	2603	4159	254	4413	7377	59.82%	21.09%	8	12
15	基隆市暖暖區	2018-11-24T23:12:31+08:00	5354	9988	15342	619	15961	30224	52.81%	17.71%	26	28
15	基隆市暖暖區	2018-11-24T23:47:44+08:00	5869	10948	16817	679	17496	33225	52.66%	17.66%	28	28
15	基隆市暖暖區	2018-11-24T22:58:09+08:00	5126	9562	14688	594	15282	28899	52.88%	17.74%	25	28
15	基隆市暖暖區	2018-11-25T03:56:29+08:00	5869	10948	16817	679	17496	33225	52.66%	17.66%	28	28
15	基隆市暖暖區	2018-11-24T23:01:46+08:00	5126	9562	14688	594	15282	28899	52.88%	17.74%	25	28
15	基隆市暖暖區	2018-11-25T03:32:53+08:00	5869	10948	16817	679	17496	33225	52.66%	17.66%	28	28
15	基隆市暖暖區	2018-11-24T23:08:52+08:00	5354	9988	15342	619	15961	30224	52.81%	17.71%	26	28
15	基隆市暖暖區	2018-11-24T23:51:49+08:00	5869	10948	16817	679	17496	33225	52.66%	17.66%	28	28
15	基隆市暖暖區	2018-11-25T03:44:41+08:00	5869	10948	16817	679	17496	33225	52.66%	17.66%	28	28
15	基隆市暖暖區	2018-11-25T04:03:06+08:00	5869	10948	16817	679	17496	33225	52.66%	17.66%	28	28
15	基隆市暖暖區	2018-11-24T23:27:31+08:00	5869	10948	16817	679	17496	33225	52.66%	17.66%	28	28
15	基隆市暖暖區	2018-11-24T22:30:24+08:00	3976	7750	11726	480	12206	23245	52.51%	17.1%	21	28
15	基隆市暖暖區	2018-11-24T22:19:50+08:00	3710	7219	10929	458	11387	21635	52.63%	17.15%	20	28
15	基隆市暖暖區	2018-11-25T06:14:06+08:00	5869	10948	16817	679	17496	33225	52.66%	17.66%	28	28
15	基隆市暖暖區	2018-11-24T23:20:09+08:00	5647	10499	16146	645	16791	31794	52.81%	17.76%	27	28
15	基隆市暖暖區	2018-11-24T23:31:28+08:00	5869	10948	16817	679	17496	33225	52.66%	17.66%	28	28
15	基隆市暖暖區	2018-11-24T22:37:14+08:00	4537	8731	13268	555	13823	26226	52.71%	17.3%	23	28
15	基隆市暖暖區	2018-11-25T00:18:48+08:00	5869	10948	16817	679	17496	33225	52.66%	17.66%	28	28
15	基隆市暖暖區	2018-11-25T06:29:32+08:00	5869	10948	16817	679	17496	33225	52.66%	17.66%	28	28
15	基隆市暖暖區	2018-11-25T00:09:51+08:00	5869	10948	16817	679	17496	33225	52.66%	17.66%	28	28
15	基隆市暖暖區	2018-11-24T22:45:21+08:00	5126	9562	14688	594	15282	28899	52.88%	17.74%	25	28
15	基隆市暖暖區	2018-11-24T22:54:38+08:00	5126	9562	14688	594	15282	28899	52.88%	17.74%	25	28
15	基隆市暖暖區	2018-11-24T22:33:51+08:00	4231	8157	12388	500	12888	24623	52.34%	17.18%	22	28
15	基隆市暖暖區	2018-11-24T23:39:33+08:00	5869	10948	16817	679	17496	33225	52.66%	17.66%	28	28
15	基隆市暖暖區	2018-11-24T22:26:49+08:00	3976	7750	11726	480	12206	23245	52.51%	17.1%	21	28
15	基隆市暖暖區	2018-11-25T01:12:59+08:00	5869	10948	16817	679	17496	33225	52.66%	17.66%	28	28
15	基隆市暖暖區	2018-11-25T00:05:18+08:00	5869	10948	16817	679	17496	33225	52.66%	17.66%	28	28
15	基隆市暖暖區	2018-11-25T01:07:41+08:00	5869	10948	16817	679	17496	33225	52.66%	17.66%	28	28
15	基隆市暖暖區	2018-11-24T23:05:17+08:00	5126	9562	14688	594	15282	28899	52.88%	17.74%	25	28
15	基隆市暖暖區	2018-11-24T23:56:02+08:00	5869	10948	16817	679	17496	33225	52.66%	17.66%	28	28
15	基隆市暖暖區	2018-11-24T22:13:46+08:00	3710	7219	10929	458	11387	21635	52.63%	17.15%	20	28
15	基隆市暖暖區	2018-11-24T23:23:51+08:00	5647	10499	16146	645	16791	31794	52.81%	17.76%	27	28
15	基隆市暖暖區	2018-11-24T22:23:29+08:00	3710	7219	10929	458	11387	21635	52.63%	17.15%	20	28
15	基隆市暖暖區	2018-11-25T00:00:24+08:00	5869	10948	16817	679	17496	33225	52.66%	17.66%	28	28
15	基隆市暖暖區	2018-11-25T01:02:45+08:00	5869	10948	16817	679	17496	33225	52.66%	17.66%	28	28
15	基隆市暖暖區	2018-11-24T22:40:41+08:00	4753	9115	13868	571	14439	27399	52.7%	17.35%	24	28
15	基隆市暖暖區	2018-11-25T00:57:52+08:00	5869	10948	16817	679	17496	33225	52.66%	17.66%	28	28
15	基隆市暖暖區	2018-11-24T22:51:04+08:00	5126	9562	14688	594	15282	28899	52.88%	17.74%	25	28
15	基隆市暖暖區	2018-11-25T06:09:10+08:00	5869	10948	16817	679	17496	33225	52.66%	17.66%	28	28
15	基隆市暖暖區	2018-11-25T06:24:14+08:00	5869	10948	16817	679	17496	33225	52.66%	17.66%	28	28
15	基隆市暖暖區	2018-11-25T00:23:18+08:00	5869	10948	16817	679	17496	33225	52.66%	17.66%	28	28
15	基隆市暖暖區	2018-11-24T23:35:23+08:00	5869	10948	16817	679	17496	33225	52.66%	17.66%	28	28
15	基隆市暖暖區	2018-11-25T00:14:24+08:00	5869	10948	16817	679	17496	33225	52.66%	17.66%	28	28
15	基隆市暖暖區	2018-11-25T01:26:09+08:00	5869	10948	16817	679	17496	33225	52.66%	17.66%	28	28
15	基隆市暖暖區	2018-11-25T03:50:04+08:00	5869	10948	16817	679	17496	33225	52.66%	17.66%	28	28
15	基隆市暖暖區	2018-11-24T22:16:26+08:00	3710	7219	10929	458	11387	21635	52.63%	17.15%	20	28
15	基隆市暖暖區	2018-11-24T23:43:31+08:00	5869	10948	16817	679	17496	33225	52.66%	17.66%	28	28
15	基隆市暖暖區	2018-11-25T01:18:11+08:00	5869	10948	16817	679	17496	33225	52.66%	17.66%	28	28
15	基隆市暖暖區	2018-11-24T23:16:16+08:00	5354	9988	15342	619	15961	30224	52.81%	17.71%	26	28
15	基隆市暖暖區	2018-11-25T06:19:11+08:00	5869	10948	16817	679	17496	33225	52.66%	17.66%	28	28
15	基隆市暖暖區	2018-11-24T22:41:51+08:00	4753	9115	13868	571	14439	27399	52.7%	17.35%	24	28
15	基隆市暖暖區	2018-11-25T03:39:08+08:00	5869	10948	16817	679	17496	33225	52.66%	17.66%	28	28
15	南投縣中寮鄉	2018-11-25T00:05:14+08:00	2179	4895	7074	556	7630	13181	57.89%	16.53%	24	24
15	南投縣中寮鄉	2018-11-25T06:19:06+08:00	1943	5131	7074	556	7630	13181	57.89%	14.74%	24	24
15	南投縣中寮鄉	2018-11-25T00:09:45+08:00	1790	4742	6532	522	7054	12191	57.86%	14.68%	23	24
15	南投縣中寮鄉	2018-11-24T22:50:58+08:00	2179	4895	7074	556	7630	13181	57.89%	16.53%	24	24
15	南投縣中寮鄉	2018-11-24T22:41:46+08:00	2179	4895	7074	556	7630	13181	57.89%	16.53%	24	24
15	南投縣中寮鄉	2018-11-24T22:37:09+08:00	2179	4895	7074	556	7630	13181	57.89%	16.53%	24	24
15	南投縣中寮鄉	2018-11-25T06:29:27+08:00	1943	5131	7074	556	7630	13181	57.89%	14.74%	24	24
15	南投縣中寮鄉	2018-11-24T23:05:13+08:00	2179	4895	7074	556	7630	13181	57.89%	16.53%	24	24
15	南投縣中寮鄉	2018-11-24T23:01:41+08:00	2179	4895	7074	556	7630	13181	57.89%	16.53%	24	24
15	南投縣中寮鄉	2018-11-24T22:26:45+08:00	2179	4895	7074	556	7630	13181	57.89%	16.53%	24	24
15	南投縣中寮鄉	2018-11-24T22:54:34+08:00	2179	4895	7074	556	7630	13181	57.89%	16.53%	24	24
15	南投縣中寮鄉	2018-11-25T01:12:54+08:00	1943	5131	7074	556	7630	13181	57.89%	14.74%	24	24
15	南投縣中寮鄉	2018-11-24T22:19:45+08:00	2179	4895	7074	556	7630	13181	57.89%	16.53%	24	24
15	南投縣中寮鄉	2018-11-25T04:03:01+08:00	1943	5131	7074	556	7630	13181	57.89%	14.74%	24	24
15	南投縣中寮鄉	2018-11-25T00:00:20+08:00	2179	4895	7074	556	7630	13181	57.89%	16.53%	24	24
15	南投縣中寮鄉	2018-11-25T00:23:13+08:00	1943	5131	7074	556	7630	13181	57.89%	14.74%	24	24
15	南投縣中寮鄉	2018-11-24T23:08:47+08:00	2179	4895	7074	556	7630	13181	57.89%	16.53%	24	24
15	南投縣中寮鄉	2018-11-24T22:23:24+08:00	2179	4895	7074	556	7630	13181	57.89%	16.53%	24	24
15	南投縣中寮鄉	2018-11-25T01:02:40+08:00	1943	5131	7074	556	7630	13181	57.89%	14.74%	24	24
15	南投縣中寮鄉	2018-11-25T06:14:01+08:00	1943	5131	7074	556	7630	13181	57.89%	14.74%	24	24
15	南投縣中寮鄉	2018-11-25T03:32:47+08:00	1943	5131	7074	556	7630	13181	57.89%	14.74%	24	24
15	南投縣中寮鄉	2018-11-24T23:23:47+08:00	2179	4895	7074	556	7630	13181	57.89%	16.53%	24	24
15	南投縣中寮鄉	2018-11-25T03:50:00+08:00	1943	5131	7074	556	7630	13181	57.89%	14.74%	24	24
15	南投縣中寮鄉	2018-11-24T22:33:47+08:00	2179	4895	7074	556	7630	13181	57.89%	16.53%	24	24
15	南投縣中寮鄉	2018-11-25T03:39:03+08:00	1943	5131	7074	556	7630	13181	57.89%	14.74%	24	24
15	南投縣中寮鄉	2018-11-25T01:26:02+08:00	1943	5131	7074	556	7630	13181	57.89%	14.74%	24	24
15	南投縣中寮鄉	2018-11-24T23:20:01+08:00	2179	4895	7074	556	7630	13181	57.89%	16.53%	24	24
15	南投縣中寮鄉	2018-11-25T01:07:35+08:00	1943	5131	7074	556	7630	13181	57.89%	14.74%	24	24
15	南投縣中寮鄉	2018-11-25T00:14:19+08:00	1943	5131	7074	556	7630	13181	57.89%	14.74%	24	24
15	南投縣中寮鄉	2018-11-24T23:16:12+08:00	2179	4895	7074	556	7630	13181	57.89%	16.53%	24	24
15	南投縣中寮鄉	2018-11-24T23:35:19+08:00	2179	4895	7074	556	7630	13181	57.89%	16.53%	24	24
15	南投縣中寮鄉	2018-11-24T22:45:17+08:00	2179	4895	7074	556	7630	13181	57.89%	16.53%	24	24
15	南投縣中寮鄉	2018-11-24T23:43:25+08:00	2078	4638	6716	533	7249	12567	57.68%	16.54%	23	24
15	南投縣中寮鄉	2018-11-25T03:56:23+08:00	1943	5131	7074	556	7630	13181	57.89%	14.74%	24	24
15	南投縣中寮鄉	2018-11-24T22:58:04+08:00	2179	4895	7074	556	7630	13181	57.89%	16.53%	24	24
15	南投縣中寮鄉	2018-11-25T01:18:04+08:00	1943	5131	7074	556	7630	13181	57.89%	14.74%	24	24
15	南投縣中寮鄉	2018-11-25T00:57:47+08:00	1943	5131	7074	556	7630	13181	57.89%	14.74%	24	24
15	南投縣中寮鄉	2018-11-25T06:24:09+08:00	1943	5131	7074	556	7630	13181	57.89%	14.74%	24	24
15	南投縣中寮鄉	2018-11-25T06:09:04+08:00	1943	5131	7074	556	7630	13181	57.89%	14.74%	24	24
15	南投縣中寮鄉	2018-11-24T23:51:44+08:00	2179	4895	7074	556	7630	13181	57.89%	16.53%	24	24
15	南投縣中寮鄉	2018-11-24T22:40:36+08:00	2179	4895	7074	556	7630	13181	57.89%	16.53%	24	24
15	南投縣中寮鄉	2018-11-24T22:30:19+08:00	2179	4895	7074	556	7630	13181	57.89%	16.53%	24	24
15	南投縣中寮鄉	2018-11-24T22:13:40+08:00	2179	4895	7074	556	7630	13181	57.89%	16.53%	24	24
15	南投縣中寮鄉	2018-11-24T23:27:26+08:00	2179	4895	7074	556	7630	13181	57.89%	16.53%	24	24
15	南投縣中寮鄉	2018-11-25T03:44:35+08:00	1943	5131	7074	556	7630	13181	57.89%	14.74%	24	24
15	南投縣中寮鄉	2018-11-24T23:55:56+08:00	2179	4895	7074	556	7630	13181	57.89%	16.53%	24	24
15	南投縣中寮鄉	2018-11-24T23:47:39+08:00	2179	4895	7074	556	7630	13181	57.89%	16.53%	24	24
15	南投縣中寮鄉	2018-11-24T23:31:22+08:00	2179	4895	7074	556	7630	13181	57.89%	16.53%	24	24
15	南投縣中寮鄉	2018-11-24T22:16:21+08:00	2179	4895	7074	556	7630	13181	57.89%	16.53%	24	24
15	南投縣中寮鄉	2018-11-25T00:18:42+08:00	1943	5131	7074	556	7630	13181	57.89%	14.74%	24	24
15	南投縣中寮鄉	2018-11-24T23:12:26+08:00	2179	4895	7074	556	7630	13181	57.89%	16.53%	24	24
15	南投縣中寮鄉	2018-11-24T23:39:27+08:00	2179	4895	7074	556	7630	13181	57.89%	16.53%	24	24
15	雲林縣古坑鄉	2018-11-25T00:05:14+08:00	4164	9260	13424	1136	14560	27477	52.99%	15.15%	27	27
15	雲林縣古坑鄉	2018-11-25T06:19:06+08:00	4164	9260	13424	1136	14560	27477	52.99%	15.15%	27	27
15	雲林縣古坑鄉	2018-11-25T00:09:45+08:00	4164	9260	13424	1136	14560	27477	52.99%	15.15%	27	27
15	雲林縣古坑鄉	2018-11-25T01:12:55+08:00	4164	9260	13424	1136	14560	27477	52.99%	15.15%	27	27
15	雲林縣古坑鄉	2018-11-24T22:41:46+08:00	3038	6801	9839	837	10676	20322	52.53%	14.95%	21	27
15	雲林縣古坑鄉	2018-11-25T06:29:27+08:00	4164	9260	13424	1136	14560	27477	52.99%	15.15%	27	27
15	雲林縣古坑鄉	2018-11-24T23:05:13+08:00	3736	8236	11972	1009	12981	24536	52.91%	15.23%	25	27
15	雲林縣古坑鄉	2018-11-24T22:26:45+08:00	2675	5920	8595	741	9336	17894	52.17%	14.95%	19	27
15	雲林縣古坑鄉	2018-11-24T22:54:34+08:00	3575	7923	11498	957	12455	23542	52.91%	15.19%	24	27
15	雲林縣古坑鄉	2018-11-24T23:43:26+08:00	3999	8814	12813	1063	13876	26308	52.74%	15.2%	26	27
15	雲林縣古坑鄉	2018-11-24T22:50:59+08:00	3190	7116	10306	876	11182	21320	52.45%	14.96%	22	27
15	雲林縣古坑鄉	2018-11-25T00:00:20+08:00	4164	9260	13424	1136	14560	27477	52.99%	15.15%	27	27
15	雲林縣古坑鄉	2018-11-25T00:23:13+08:00	4164	9260	13424	1136	14560	27477	52.99%	15.15%	27	27
15	雲林縣古坑鄉	2018-11-25T03:44:36+08:00	4164	9260	13424	1136	14560	27477	52.99%	15.15%	27	27
15	雲林縣古坑鄉	2018-11-24T23:08:47+08:00	3736	8236	11972	1009	12981	24536	52.91%	15.23%	25	27
15	雲林縣古坑鄉	2018-11-24T22:23:24+08:00	2675	5920	8595	741	9336	17894	52.17%	14.95%	19	27
15	雲林縣古坑鄉	2018-11-25T06:24:10+08:00	4164	9260	13424	1136	14560	27477	52.99%	15.15%	27	27
15	雲林縣古坑鄉	2018-11-25T01:02:40+08:00	4164	9260	13424	1136	14560	27477	52.99%	15.15%	27	27
15	雲林縣古坑鄉	2018-11-25T06:14:01+08:00	4164	9260	13424	1136	14560	27477	52.99%	15.15%	27	27
15	雲林縣古坑鄉	2018-11-25T03:32:47+08:00	4164	9260	13424	1136	14560	27477	52.99%	15.15%	27	27
15	雲林縣古坑鄉	2018-11-24T23:23:47+08:00	3736	8236	11972	1009	12981	24536	52.91%	15.23%	25	27
15	雲林縣古坑鄉	2018-11-25T03:50:00+08:00	4164	9260	13424	1136	14560	27477	52.99%	15.15%	27	27
15	雲林縣古坑鄉	2018-11-24T22:33:47+08:00	2851	6314	9165	796	9961	19020	52.37%	14.99%	20	27
15	雲林縣古坑鄉	2018-11-25T01:26:03+08:00	4164	9260	13424	1136	14560	27477	52.99%	15.15%	27	27
15	雲林縣古坑鄉	2018-11-25T03:39:04+08:00	4164	9260	13424	1136	14560	27477	52.99%	15.15%	27	27
15	雲林縣古坑鄉	2018-11-25T00:14:19+08:00	4164	9260	13424	1136	14560	27477	52.99%	15.15%	27	27
15	雲林縣古坑鄉	2018-11-24T23:16:12+08:00	3736	8236	11972	1009	12981	24536	52.91%	15.23%	25	27
15	雲林縣古坑鄉	2018-11-24T23:35:19+08:00	3736	8236	11972	1009	12981	24536	52.91%	15.23%	25	27
15	雲林縣古坑鄉	2018-11-24T22:45:17+08:00	3038	6801	9839	837	10676	20322	52.53%	14.95%	21	27
15	雲林縣古坑鄉	2018-11-25T01:18:05+08:00	4164	9260	13424	1136	14560	27477	52.99%	15.15%	27	27
15	雲林縣古坑鄉	2018-11-25T03:56:24+08:00	4164	9260	13424	1136	14560	27477	52.99%	15.15%	27	27
15	雲林縣古坑鄉	2018-11-24T22:58:04+08:00	3736	8236	11972	1009	12981	24536	52.91%	15.23%	25	27
15	雲林縣古坑鄉	2018-11-24T23:01:42+08:00	3736	8236	11972	1009	12981	24536	52.91%	15.23%	25	27
15	雲林縣古坑鄉	2018-11-25T00:57:47+08:00	4164	9260	13424	1136	14560	27477	52.99%	15.15%	27	27
15	雲林縣古坑鄉	2018-11-24T22:19:46+08:00	2675	5920	8595	741	9336	17894	52.17%	14.95%	19	27
15	雲林縣古坑鄉	2018-11-25T04:03:02+08:00	4164	9260	13424	1136	14560	27477	52.99%	15.15%	27	27
15	雲林縣古坑鄉	2018-11-24T22:30:19+08:00	2675	5920	8595	741	9336	17894	52.17%	14.95%	19	27
15	雲林縣古坑鄉	2018-11-24T22:13:40+08:00	2675	5920	8595	741	9336	17894	52.17%	14.95%	19	27
15	雲林縣古坑鄉	2018-11-24T22:40:37+08:00	3038	6801	9839	837	10676	20322	52.53%	14.95%	21	27
15	雲林縣古坑鄉	2018-11-24T23:51:45+08:00	4164	9260	13424	1136	14560	27477	52.99%	15.15%	27	27
15	雲林縣古坑鄉	2018-11-25T06:09:05+08:00	4164	9260	13424	1136	14560	27477	52.99%	15.15%	27	27
15	雲林縣古坑鄉	2018-11-24T23:55:57+08:00	4164	9260	13424	1136	14560	27477	52.99%	15.15%	27	27
15	雲林縣古坑鄉	2018-11-24T23:27:27+08:00	3736	8236	11972	1009	12981	24536	52.91%	15.23%	25	27
15	雲林縣古坑鄉	2018-11-24T23:47:39+08:00	3999	8814	12813	1063	13876	26308	52.74%	15.2%	26	27
15	雲林縣古坑鄉	2018-11-24T23:31:22+08:00	3736	8236	11972	1009	12981	24536	52.91%	15.23%	25	27
15	雲林縣古坑鄉	2018-11-24T22:16:21+08:00	2675	5920	8595	741	9336	17894	52.17%	14.95%	19	27
15	雲林縣古坑鄉	2018-11-24T23:39:28+08:00	3736	8236	11972	1009	12981	24536	52.91%	15.23%	25	27
15	雲林縣古坑鄉	2018-11-25T00:18:42+08:00	4164	9260	13424	1136	14560	27477	52.99%	15.15%	27	27
15	雲林縣古坑鄉	2018-11-24T22:37:10+08:00	2851	6314	9165	796	9961	19020	52.37%	14.99%	20	27
15	雲林縣古坑鄉	2018-11-24T23:12:26+08:00	3736	8236	11972	1009	12981	24536	52.91%	15.23%	25	27
15	雲林縣古坑鄉	2018-11-24T23:20:02+08:00	3736	8236	11972	1009	12981	24536	52.91%	15.23%	25	27
15	雲林縣古坑鄉	2018-11-25T01:07:36+08:00	4164	9260	13424	1136	14560	27477	52.99%	15.15%	27	27
15	雲林縣元長鄉	2018-11-25T01:12:55+08:00	2717	6177	8894	945	9839	22830	43.1%	11.9%	25	25
15	雲林縣元長鄉	2018-11-25T06:29:27+08:00	2717	6177	8894	945	9839	22830	43.1%	11.9%	25	25
15	雲林縣元長鄉	2018-11-24T23:05:13+08:00	2717	6177	8894	945	9839	22830	43.1%	11.9%	25	25
15	雲林縣元長鄉	2018-11-25T06:19:07+08:00	2717	6177	8894	945	9839	22830	43.1%	11.9%	25	25
15	雲林縣元長鄉	2018-11-25T00:05:15+08:00	2717	6177	8894	945	9839	22830	43.1%	11.9%	25	25
15	雲林縣元長鄉	2018-11-24T22:26:45+08:00	2717	6177	8894	945	9839	22830	43.1%	11.9%	25	25
15	雲林縣元長鄉	2018-11-24T22:54:34+08:00	2717	6177	8894	945	9839	22830	43.1%	11.9%	25	25
15	雲林縣元長鄉	2018-11-24T22:41:47+08:00	2717	6177	8894	945	9839	22830	43.1%	11.9%	25	25
15	雲林縣元長鄉	2018-11-24T23:43:26+08:00	2717	6177	8894	945	9839	22830	43.1%	11.9%	25	25
15	雲林縣元長鄉	2018-11-24T22:50:59+08:00	2717	6177	8894	945	9839	22830	43.1%	11.9%	25	25
15	雲林縣元長鄉	2018-11-25T00:00:20+08:00	2717	6177	8894	945	9839	22830	43.1%	11.9%	25	25
15	雲林縣元長鄉	2018-11-25T01:02:41+08:00	2717	6177	8894	945	9839	22830	43.1%	11.9%	25	25
15	雲林縣元長鄉	2018-11-25T00:23:14+08:00	2717	6177	8894	945	9839	22830	43.1%	11.9%	25	25
15	雲林縣元長鄉	2018-11-25T03:32:48+08:00	2717	6177	8894	945	9839	22830	43.1%	11.9%	25	25
15	雲林縣元長鄉	2018-11-25T03:44:36+08:00	2717	6177	8894	945	9839	22830	43.1%	11.9%	25	25
15	雲林縣元長鄉	2018-11-24T23:08:47+08:00	2717	6177	8894	945	9839	22830	43.1%	11.9%	25	25
15	雲林縣元長鄉	2018-11-25T06:24:10+08:00	2717	6177	8894	945	9839	22830	43.1%	11.9%	25	25
15	雲林縣元長鄉	2018-11-24T22:23:25+08:00	2717	6177	8894	945	9839	22830	43.1%	11.9%	25	25
15	雲林縣元長鄉	2018-11-24T23:23:47+08:00	2717	6177	8894	945	9839	22830	43.1%	11.9%	25	25
15	雲林縣元長鄉	2018-11-25T03:50:00+08:00	2717	6177	8894	945	9839	22830	43.1%	11.9%	25	25
15	雲林縣元長鄉	2018-11-24T22:33:47+08:00	2717	6177	8894	945	9839	22830	43.1%	11.9%	25	25
15	雲林縣元長鄉	2018-11-25T01:26:03+08:00	2717	6177	8894	945	9839	22830	43.1%	11.9%	25	25
15	雲林縣元長鄉	2018-11-25T03:39:04+08:00	2717	6177	8894	945	9839	22830	43.1%	11.9%	25	25
15	雲林縣元長鄉	2018-11-25T00:14:20+08:00	2717	6177	8894	945	9839	22830	43.1%	11.9%	25	25
15	雲林縣元長鄉	2018-11-24T23:16:12+08:00	2717	6177	8894	945	9839	22830	43.1%	11.9%	25	25
15	雲林縣元長鄉	2018-11-24T23:35:19+08:00	2717	6177	8894	945	9839	22830	43.1%	11.9%	25	25
15	雲林縣元長鄉	2018-11-24T22:45:17+08:00	2717	6177	8894	945	9839	22830	43.1%	11.9%	25	25
15	雲林縣元長鄉	2018-11-25T01:18:05+08:00	2717	6177	8894	945	9839	22830	43.1%	11.9%	25	25
15	雲林縣元長鄉	2018-11-24T22:58:05+08:00	2717	6177	8894	945	9839	22830	43.1%	11.9%	25	25
15	雲林縣元長鄉	2018-11-25T00:09:46+08:00	2717	6177	8894	945	9839	22830	43.1%	11.9%	25	25
15	雲林縣元長鄉	2018-11-25T03:56:24+08:00	2717	6177	8894	945	9839	22830	43.1%	11.9%	25	25
15	雲林縣元長鄉	2018-11-24T23:01:42+08:00	2717	6177	8894	945	9839	22830	43.1%	11.9%	25	25
15	雲林縣元長鄉	2018-11-25T00:57:47+08:00	2717	6177	8894	945	9839	22830	43.1%	11.9%	25	25
15	雲林縣元長鄉	2018-11-24T22:19:46+08:00	2717	6177	8894	945	9839	22830	43.1%	11.9%	25	25
15	雲林縣元長鄉	2018-11-24T22:13:41+08:00	2534	5734	8268	908	9176	21303	43.07%	11.9%	24	25
15	雲林縣元長鄉	2018-11-25T04:03:02+08:00	2717	6177	8894	945	9839	22830	43.1%	11.9%	25	25
15	雲林縣元長鄉	2018-11-24T22:40:37+08:00	2717	6177	8894	945	9839	22830	43.1%	11.9%	25	25
15	雲林縣元長鄉	2018-11-24T23:51:45+08:00	2717	6177	8894	945	9839	22830	43.1%	11.9%	25	25
15	雲林縣元長鄉	2018-11-24T22:30:20+08:00	2717	6177	8894	945	9839	22830	43.1%	11.9%	25	25
15	雲林縣元長鄉	2018-11-25T06:09:05+08:00	2717	6177	8894	945	9839	22830	43.1%	11.9%	25	25
15	雲林縣元長鄉	2018-11-24T23:55:57+08:00	2717	6177	8894	945	9839	22830	43.1%	11.9%	25	25
15	雲林縣元長鄉	2018-11-24T23:27:27+08:00	2717	6177	8894	945	9839	22830	43.1%	11.9%	25	25
15	雲林縣元長鄉	2018-11-25T06:14:02+08:00	2717	6177	8894	945	9839	22830	43.1%	11.9%	25	25
15	雲林縣元長鄉	2018-11-24T23:47:39+08:00	2717	6177	8894	945	9839	22830	43.1%	11.9%	25	25
15	雲林縣元長鄉	2018-11-25T00:18:43+08:00	2717	6177	8894	945	9839	22830	43.1%	11.9%	25	25
15	雲林縣元長鄉	2018-11-24T22:16:21+08:00	2717	6177	8894	945	9839	22830	43.1%	11.9%	25	25
15	雲林縣元長鄉	2018-11-24T23:12:27+08:00	2717	6177	8894	945	9839	22830	43.1%	11.9%	25	25
15	雲林縣元長鄉	2018-11-24T23:39:28+08:00	2717	6177	8894	945	9839	22830	43.1%	11.9%	25	25
15	雲林縣元長鄉	2018-11-24T22:37:10+08:00	2717	6177	8894	945	9839	22830	43.1%	11.9%	25	25
15	雲林縣元長鄉	2018-11-24T23:31:23+08:00	2717	6177	8894	945	9839	22830	43.1%	11.9%	25	25
15	雲林縣元長鄉	2018-11-24T23:20:02+08:00	2717	6177	8894	945	9839	22830	43.1%	11.9%	25	25
15	雲林縣元長鄉	2018-11-25T01:07:36+08:00	2717	6177	8894	945	9839	22830	43.1%	11.9%	25	25
15	臺南市關廟區	2018-11-24T23:16:08+08:00	4948	9878	14826	1096	15922	29913	53.23%	16.54%	32	32
15	臺南市關廟區	2018-11-25T03:56:19+08:00	4948	9878	14826	1096	15922	29913	53.23%	16.54%	32	32
15	臺南市關廟區	2018-11-25T00:18:37+08:00	4948	9878	14826	1096	15922	29913	53.23%	16.54%	32	32
15	臺南市關廟區	2018-11-24T22:45:13+08:00	4948	9878	14826	1096	15922	29913	53.23%	16.54%	32	32
15	臺南市關廟區	2018-11-24T22:58:00+08:00	4948	9878	14826	1096	15922	29913	53.23%	16.54%	32	32
15	臺南市關廟區	2018-11-24T22:26:42+08:00	4948	9878	14826	1096	15922	29913	53.23%	16.54%	32	32
15	臺南市關廟區	2018-11-25T01:18:00+08:00	4948	9878	14826	1096	15922	29913	53.23%	16.54%	32	32
15	臺南市關廟區	2018-11-24T22:37:06+08:00	4948	9878	14826	1096	15922	29913	53.23%	16.54%	32	32
15	臺南市關廟區	2018-11-25T06:09:00+08:00	4948	9878	14826	1096	15922	29913	53.23%	16.54%	32	32
15	臺南市關廟區	2018-11-25T00:57:43+08:00	4948	9878	14826	1096	15922	29913	53.23%	16.54%	32	32
15	臺南市關廟區	2018-11-24T22:19:42+08:00	4948	9878	14826	1096	15922	29913	53.23%	16.54%	32	32
15	臺南市關廟區	2018-11-25T01:25:58+08:00	4948	9878	14826	1096	15922	29913	53.23%	16.54%	32	32
15	臺南市關廟區	2018-11-24T22:30:15+08:00	4948	9878	14826	1096	15922	29913	53.23%	16.54%	32	32
15	臺南市關廟區	2018-11-25T01:02:37+08:00	4948	9878	14826	1096	15922	29913	53.23%	16.54%	32	32
15	臺南市關廟區	2018-11-24T22:40:33+08:00	4948	9878	14826	1096	15922	29913	53.23%	16.54%	32	32
15	臺南市關廟區	2018-11-24T23:51:41+08:00	4948	9878	14826	1096	15922	29913	53.23%	16.54%	32	32
15	臺南市關廟區	2018-11-25T00:23:09+08:00	4948	9878	14826	1096	15922	29913	53.23%	16.54%	32	32
15	臺南市關廟區	2018-11-25T00:00:16+08:00	4948	9878	14826	1096	15922	29913	53.23%	16.54%	32	32
15	臺南市關廟區	2018-11-24T22:13:35+08:00	4948	9878	14826	1096	15922	29913	53.23%	16.54%	32	32
15	臺南市關廟區	2018-11-24T23:55:52+08:00	4948	9878	14826	1096	15922	29913	53.23%	16.54%	32	32
15	臺南市關廟區	2018-11-24T23:19:58+08:00	4948	9878	14826	1096	15922	29913	53.23%	16.54%	32	32
15	臺南市關廟區	2018-11-24T23:27:23+08:00	4948	9878	14826	1096	15922	29913	53.23%	16.54%	32	32
15	臺南市關廟區	2018-11-25T03:44:30+08:00	4948	9878	14826	1096	15922	29913	53.23%	16.54%	32	32
15	臺南市關廟區	2018-11-24T23:01:37+08:00	4948	9878	14826	1096	15922	29913	53.23%	16.54%	32	32
15	臺南市關廟區	2018-11-25T04:02:58+08:00	4948	9878	14826	1096	15922	29913	53.23%	16.54%	32	32
15	臺南市關廟區	2018-11-25T00:14:16+08:00	4948	9878	14826	1096	15922	29913	53.23%	16.54%	32	32
15	臺南市關廟區	2018-11-24T23:35:16+08:00	4948	9878	14826	1096	15922	29913	53.23%	16.54%	32	32
15	臺南市關廟區	2018-11-24T23:05:09+08:00	4948	9878	14826	1096	15922	29913	53.23%	16.54%	32	32
15	臺南市關廟區	2018-11-24T23:31:18+08:00	4948	9878	14826	1096	15922	29913	53.23%	16.54%	32	32
15	臺南市關廟區	2018-11-24T23:39:23+08:00	4948	9878	14826	1096	15922	29913	53.23%	16.54%	32	32
15	臺南市關廟區	2018-11-25T01:07:32+08:00	4948	9878	14826	1096	15922	29913	53.23%	16.54%	32	32
15	臺南市關廟區	2018-11-24T23:47:35+08:00	4948	9878	14826	1096	15922	29913	53.23%	16.54%	32	32
15	臺南市關廟區	2018-11-24T22:41:42+08:00	4948	9878	14826	1096	15922	29913	53.23%	16.54%	32	32
15	臺南市關廟區	2018-11-25T06:13:58+08:00	4948	9878	14826	1096	15922	29913	53.23%	16.54%	32	32
15	臺南市關廟區	2018-11-25T00:09:41+08:00	4948	9878	14826	1096	15922	29913	53.23%	16.54%	32	32
15	臺南市關廟區	2018-11-25T03:49:56+08:00	4948	9878	14826	1096	15922	29913	53.23%	16.54%	32	32
15	臺南市關廟區	2018-11-24T22:54:30+08:00	4948	9878	14826	1096	15922	29913	53.23%	16.54%	32	32
15	臺南市關廟區	2018-11-24T22:50:54+08:00	4948	9878	14826	1096	15922	29913	53.23%	16.54%	32	32
15	臺南市關廟區	2018-11-25T01:12:50+08:00	4948	9878	14826	1096	15922	29913	53.23%	16.54%	32	32
15	臺南市關廟區	2018-11-24T23:43:22+08:00	4948	9878	14826	1096	15922	29913	53.23%	16.54%	32	32
15	臺南市關廟區	2018-11-25T06:29:23+08:00	4948	9878	14826	1096	15922	29913	53.23%	16.54%	32	32
15	臺南市關廟區	2018-11-25T06:19:03+08:00	4948	9878	14826	1096	15922	29913	53.23%	16.54%	32	32
15	臺南市關廟區	2018-11-25T00:05:11+08:00	4948	9878	14826	1096	15922	29913	53.23%	16.54%	32	32
15	臺南市關廟區	2018-11-25T06:24:06+08:00	4948	9878	14826	1096	15922	29913	53.23%	16.54%	32	32
15	臺南市關廟區	2018-11-24T22:23:20+08:00	4948	9878	14826	1096	15922	29913	53.23%	16.54%	32	32
15	臺南市關廟區	2018-11-25T03:32:42+08:00	4948	9878	14826	1096	15922	29913	53.23%	16.54%	32	32
15	臺南市關廟區	2018-11-24T23:08:42+08:00	4948	9878	14826	1096	15922	29913	53.23%	16.54%	32	32
15	臺南市關廟區	2018-11-24T23:23:43+08:00	4948	9878	14826	1096	15922	29913	53.23%	16.54%	32	32
15	臺南市關廟區	2018-11-24T22:33:43+08:00	4948	9878	14826	1096	15922	29913	53.23%	16.54%	32	32
15	臺南市關廟區	2018-11-24T22:16:17+08:00	4948	9878	14826	1096	15922	29913	53.23%	16.54%	32	32
15	臺南市關廟區	2018-11-25T03:39:00+08:00	4948	9878	14826	1096	15922	29913	53.23%	16.54%	32	32
15	臺南市關廟區	2018-11-24T23:12:21+08:00	4948	9878	14826	1096	15922	29913	53.23%	16.54%	32	32
15	臺北市中正區	2018-11-25T06:29:19+08:00	27634	44386	72020	3023	75043	128292	58.49%	21.54%	96	96
15	臺北市中正區	2018-11-25T01:07:28+08:00	27634	44386	72020	3023	75043	128292	58.49%	21.54%	96	96
15	臺北市中正區	2018-11-25T06:13:55+08:00	27634	44386	72020	3023	75043	128292	58.49%	21.54%	96	96
15	臺北市中正區	2018-11-24T22:50:51+08:00	17351	27652	45003	1927	46930	80298	58.44%	21.61%	62	96
15	臺北市中正區	2018-11-25T06:19:00+08:00	27634	44386	72020	3023	75043	128292	58.49%	21.54%	96	96
15	臺北市中正區	2018-11-25T03:49:53+08:00	27634	44386	72020	3023	75043	128292	58.49%	21.54%	96	96
15	臺北市中正區	2018-11-24T22:50:50+08:00	17351	27652	45003	1927	46930	80298	58.44%	21.61%	62	96
15	臺北市中正區	2018-11-25T06:13:54+08:00	27634	44386	72020	3023	75043	128292	58.49%	21.54%	96	96
15	臺北市中正區	2018-11-24T23:43:19+08:00	22187	35551	57738	2429	60167	102666	58.6%	21.61%	78	96
15	臺北市中正區	2018-11-24T22:13:29+08:00	13388	21340	34728	1469	36197	62229	58.17%	21.51%	49	96
15	臺北市中正區	2018-11-25T06:24:03+08:00	27634	44386	72020	3023	75043	128292	58.49%	21.54%	96	96
15	臺北市中正區	2018-11-24T23:08:39+08:00	19889	31622	51511	2171	53682	91749	58.51%	21.68%	70	96
15	臺北市中正區	2018-11-25T00:23:06+08:00	25772	41368	67140	2840	69980	119771	58.43%	21.52%	90	96
15	臺北市中正區	2018-11-24T22:30:12+08:00	15453	24503	39956	1713	41669	71384	58.37%	21.65%	56	96
15	臺北市中正區	2018-11-24T23:08:38+08:00	19889	31622	51511	2171	53682	91749	58.51%	21.68%	70	96
15	臺北市中正區	2018-11-24T23:55:49+08:00	23909	38333	62242	2637	64879	111139	58.38%	21.51%	84	96
15	臺北市中正區	2018-11-25T03:32:37+08:00	27634	44386	72020	3023	75043	128292	58.49%	21.54%	96	96
15	臺北市中正區	2018-11-25T06:24:02+08:00	27634	44386	72020	3023	75043	128292	58.49%	21.54%	96	96
15	臺北市中正區	2018-11-24T23:51:37+08:00	22748	36449	59197	2487	61684	105225	58.62%	21.62%	80	96
15	臺北市中正區	2018-11-24T23:23:41+08:00	21628	34578	56206	2324	58530	99863	58.61%	21.66%	76	96
15	臺北市中正區	2018-11-24T22:23:15+08:00	14871	23621	38492	1641	40133	68804	58.33%	21.61%	54	96
15	臺北市中正區	2018-11-24T22:40:29+08:00	17008	27110	44118	1894	46012	78747	58.43%	21.6%	61	96
15	臺北市中正區	2018-11-24T22:57:57+08:00	17620	28034	45654	1962	47616	81481	58.44%	21.62%	63	96
15	臺北市中正區	2018-11-24T23:51:38+08:00	22748	36449	59197	2487	61684	105225	58.62%	21.62%	80	96
15	臺北市中正區	2018-11-25T06:18:59+08:00	27634	44386	72020	3023	75043	128292	58.49%	21.54%	96	96
15	臺北市中正區	2018-11-24T22:57:56+08:00	17620	28034	45654	1962	47616	81481	58.44%	21.62%	63	96
15	臺北市中正區	2018-11-25T01:17:56+08:00	27634	44386	72020	3023	75043	128292	58.49%	21.54%	96	96
15	臺北市中正區	2018-11-24T23:23:40+08:00	21628	34578	56206	2324	58530	99863	58.61%	21.66%	76	96
15	臺北市中正區	2018-11-24T22:33:40+08:00	16082	25589	41671	1794	43465	74325	58.48%	21.64%	58	96
15	臺北市中正區	2018-11-24T22:54:27+08:00	17620	28034	45654	1962	47616	81481	58.44%	21.62%	63	96
15	臺北市中正區	2018-11-24T22:16:13+08:00	13872	22063	35935	1518	37453	64325	58.22%	21.57%	51	96
15	臺北市中正區	2018-11-25T00:14:11+08:00	24804	39859	64663	2726	67389	115357	58.42%	21.5%	87	96
15	臺北市中正區	2018-11-24T23:05:07+08:00	19248	30493	49741	2119	51860	88644	58.5%	21.71%	68	96
15	臺北市中正區	2018-11-24T22:41:38+08:00	17008	27110	44118	1894	46012	78747	58.43%	21.6%	61	96
15	臺北市中正區	2018-11-24T22:54:28+08:00	17620	28034	45654	1962	47616	81481	58.44%	21.62%	63	96
15	臺北市中正區	2018-11-25T01:12:46+08:00	27634	44386	72020	3023	75043	128292	58.49%	21.54%	96	96
15	臺北市中正區	2018-11-25T06:08:56+08:00	27634	44386	72020	3023	75043	128292	58.49%	21.54%	96	96
15	臺北市中正區	2018-11-24T22:41:37+08:00	17008	27110	44118	1894	46012	78747	58.43%	21.6%	61	96
15	臺北市中正區	2018-11-25T00:05:07+08:00	24522	39411	63933	2685	66618	114047	58.41%	21.5%	86	96
15	臺北市中正區	2018-11-24T23:05:06+08:00	19248	30493	49741	2119	51860	88644	58.5%	21.71%	68	96
15	臺北市中正區	2018-11-25T00:18:33+08:00	24804	39859	64663	2726	67389	115357	58.42%	21.5%	87	96
15	臺北市中正區	2018-11-24T22:37:03+08:00	16082	25589	41671	1794	43465	74325	58.48%	21.64%	58	96
15	臺北市中正區	2018-11-24T22:45:10+08:00	17008	27110	44118	1894	46012	78747	58.43%	21.6%	61	96
15	臺北市中正區	2018-11-24T23:16:05+08:00	21300	34038	55338	2303	57641	98419	58.57%	21.64%	75	96
15	臺北市中正區	2018-11-24T22:45:11+08:00	17008	27110	44118	1894	46012	78747	58.43%	21.6%	61	96
15	臺北市中正區	2018-11-25T03:56:15+08:00	27634	44386	72020	3023	75043	128292	58.49%	21.54%	96	96
15	臺北市中正區	2018-11-25T03:38:57+08:00	27634	44386	72020	3023	75043	128292	58.49%	21.54%	96	96
15	臺北市中正區	2018-11-25T03:44:26+08:00	27634	44386	72020	3023	75043	128292	58.49%	21.54%	96	96
15	臺北市中正區	2018-11-24T22:30:11+08:00	15453	24503	39956	1713	41669	71384	58.37%	21.65%	56	96
15	臺北市中正區	2018-11-25T01:02:33+08:00	27634	44386	72020	3023	75043	128292	58.49%	21.54%	96	96
15	臺北市中正區	2018-11-24T22:40:30+08:00	17008	27110	44118	1894	46012	78747	58.43%	21.6%	61	96
15	臺北市中正區	2018-11-25T01:25:55+08:00	27634	44386	72020	3023	75043	128292	58.49%	21.54%	96	96
15	臺北市中正區	2018-11-24T22:23:16+08:00	14871	23621	38492	1641	40133	68804	58.33%	21.61%	54	96
15	臺北市中正區	2018-11-24T23:19:54+08:00	21628	34578	56206	2324	58530	99863	58.61%	21.66%	76	96
15	臺北市中正區	2018-11-25T00:57:39+08:00	27634	44386	72020	3023	75043	128292	58.49%	21.54%	96	96
15	臺北市中正區	2018-11-24T23:27:21+08:00	21628	34578	56206	2324	58530	99863	58.61%	21.66%	76	96
15	臺北市中正區	2018-11-25T01:17:55+08:00	27634	44386	72020	3023	75043	128292	58.49%	21.54%	96	96
15	臺北市中正區	2018-11-24T22:19:39+08:00	14179	22538	36717	1545	38262	65590	58.34%	21.62%	52	96
15	臺北市中正區	2018-11-24T23:27:20+08:00	21628	34578	56206	2324	58530	99863	58.61%	21.66%	76	96
15	臺北市中正區	2018-11-24T22:13:30+08:00	13388	21340	34728	1469	36197	62229	58.17%	21.51%	49	96
15	臺北市中正區	2018-11-25T00:00:13+08:00	24522	39411	63933	2685	66618	114047	58.41%	21.5%	86	96
15	臺北市中正區	2018-11-25T00:14:12+08:00	24804	39859	64663	2726	67389	115357	58.42%	21.5%	87	96
15	臺北市中正區	2018-11-25T04:02:55+08:00	27634	44386	72020	3023	75043	128292	58.49%	21.54%	96	96
15	臺北市中正區	2018-11-24T23:39:19+08:00	22187	35551	57738	2429	60167	102666	58.6%	21.61%	78	96
15	臺北市中正區	2018-11-24T22:26:39+08:00	15207	24080	39287	1677	40964	70215	58.34%	21.66%	55	96
15	臺北市中正區	2018-11-24T23:12:18+08:00	20753	33015	53768	2240	56008	95643	58.56%	21.7%	73	96
15	臺北市中正區	2018-11-24T23:31:14+08:00	22187	35551	57738	2429	60167	102666	58.6%	21.61%	78	96
15	臺北市中正區	2018-11-24T23:01:33+08:00	18878	29899	48777	2087	50864	86875	58.55%	21.73%	67	96
15	臺北市中正區	2018-11-24T23:01:34+08:00	18878	29899	48777	2087	50864	86875	58.55%	21.73%	67	96
15	臺北市中正區	2018-11-24T23:47:31+08:00	22512	36025	58537	2465	61002	104024	58.64%	21.64%	79	96
15	臺北市中正區	2018-11-24T23:35:13+08:00	22187	35551	57738	2429	60167	102666	58.6%	21.61%	78	96
15	臺北市中正區	2018-11-25T04:02:54+08:00	27634	44386	72020	3023	75043	128292	58.49%	21.54%	96	96
15	臺北市中正區	2018-11-25T00:09:37+08:00	24804	39859	64663	2726	67389	115357	58.42%	21.5%	87	96
15	臺北市中正區	2018-11-24T23:39:18+08:00	22187	35551	57738	2429	60167	102666	58.6%	21.61%	78	96
15	臺北市中正區	2018-11-25T06:08:55+08:00	27634	44386	72020	3023	75043	128292	58.49%	21.54%	96	96
15	臺中市潭子區	2018-11-25T03:56:17+08:00	15257	33803	49060	2572	51632	89487	57.7%	17.05%	55	55
15	臺中市潭子區	2018-11-25T06:29:21+08:00	15257	33803	49060	2572	51632	89487	57.7%	17.05%	55	55
15	臺中市潭子區	2018-11-25T03:49:55+08:00	15257	33803	49060	2572	51632	89487	57.7%	17.05%	55	55
15	臺中市潭子區	2018-11-25T06:19:01+08:00	15257	33803	49060	2572	51632	89487	57.7%	17.05%	55	55
15	臺中市潭子區	2018-11-24T23:16:07+08:00	13645	30245	43890	2353	46243	79805	57.94%	17.1%	49	55
15	臺中市潭子區	2018-11-24T22:45:12+08:00	10622	23492	34114	1799	35913	61813	58.1%	17.18%	39	55
15	臺中市潭子區	2018-11-24T23:43:21+08:00	14462	31919	46381	2450	48831	84399	57.86%	17.14%	52	55
15	臺中市潭子區	2018-11-24T22:41:40+08:00	10622	23492	34114	1799	35913	61813	58.1%	17.18%	39	55
15	臺中市潭子區	2018-11-25T01:25:57+08:00	15257	33803	49060	2572	51632	89487	57.7%	17.05%	55	55
15	臺中市潭子區	2018-11-24T22:30:14+08:00	9485	21045	30530	1604	32134	55301	58.11%	17.15%	35	55
15	臺中市潭子區	2018-11-25T06:24:04+08:00	15257	33803	49060	2572	51632	89487	57.7%	17.05%	55	55
15	臺中市潭子區	2018-11-25T00:23:08+08:00	15257	33803	49060	2572	51632	89487	57.7%	17.05%	55	55
15	臺中市潭子區	2018-11-25T03:32:39+08:00	15257	33803	49060	2572	51632	89487	57.7%	17.05%	55	55
15	臺中市潭子區	2018-11-24T23:51:39+08:00	14462	31919	46381	2450	48831	84399	57.86%	17.14%	52	55
15	臺中市潭子區	2018-11-24T23:27:22+08:00	13645	30245	43890	2353	46243	79805	57.94%	17.1%	49	55
15	臺中市潭子區	2018-11-24T22:13:32+08:00	8039	17823	25862	1347	27209	46838	58.09%	17.16%	30	55
15	臺中市潭子區	2018-11-24T22:57:59+08:00	12380	27385	39765	2141	41906	72239	58.01%	17.14%	45	55
15	臺中市潭子區	2018-11-24T23:08:41+08:00	12980	28704	41684	2219	43903	75755	57.95%	17.13%	47	55
15	臺中市潭子區	2018-11-24T23:19:56+08:00	13645	30245	43890	2353	46243	79805	57.94%	17.1%	49	55
15	臺中市潭子區	2018-11-25T01:17:58+08:00	15257	33803	49060	2572	51632	89487	57.7%	17.05%	55	55
15	臺中市潭子區	2018-11-24T22:54:29+08:00	11832	26182	38014	2047	40061	69114	57.96%	17.12%	43	55
15	臺中市潭子區	2018-11-24T23:47:33+08:00	14462	31919	46381	2450	48831	84399	57.86%	17.14%	52	55
15	臺中市潭子區	2018-11-25T04:02:56+08:00	15257	33803	49060	2572	51632	89487	57.7%	17.05%	55	55
15	臺中市潭子區	2018-11-25T06:08:58+08:00	15257	33803	49060	2572	51632	89487	57.7%	17.05%	55	55
15	臺中市潭子區	2018-11-24T22:16:15+08:00	8039	17823	25862	1347	27209	46838	58.09%	17.16%	30	55
15	臺中市潭子區	2018-11-24T23:31:16+08:00	13645	30245	43890	2353	46243	79805	57.94%	17.1%	49	55
15	臺中市潭子區	2018-11-25T01:12:48+08:00	15257	33803	49060	2572	51632	89487	57.7%	17.05%	55	55
15	臺中市潭子區	2018-11-24T23:05:08+08:00	12980	28704	41684	2219	43903	75755	57.95%	17.13%	47	55
15	臺中市潭子區	2018-11-25T00:05:09+08:00	15018	33193	48211	2541	50752	87902	57.74%	17.08%	54	55
15	臺中市潭子區	2018-11-24T22:37:04+08:00	10622	23492	34114	1799	35913	61813	58.1%	17.18%	39	55
15	臺中市潭子區	2018-11-25T06:13:56+08:00	15257	33803	49060	2572	51632	89487	57.7%	17.05%	55	55
15	臺中市潭子區	2018-11-24T22:26:40+08:00	8850	19713	28563	1529	30092	51864	58.02%	17.06%	33	55
15	臺中市潭子區	2018-11-24T22:50:53+08:00	11556	25571	37127	1989	39116	67370	58.06%	17.15%	42	55
15	臺中市潭子區	2018-11-25T00:18:35+08:00	15257	33803	49060	2572	51632	89487	57.7%	17.05%	55	55
15	臺中市潭子區	2018-11-24T22:19:41+08:00	8290	18513	26803	1408	28211	48699	57.93%	17.02%	31	55
15	臺中市潭子區	2018-11-25T03:38:59+08:00	15257	33803	49060	2572	51632	89487	57.7%	17.05%	55	55
15	臺中市潭子區	2018-11-24T22:40:31+08:00	10622	23492	34114	1799	35913	61813	58.1%	17.18%	39	55
15	臺中市潭子區	2018-11-25T01:02:35+08:00	15257	33803	49060	2572	51632	89487	57.7%	17.05%	55	55
15	臺中市潭子區	2018-11-25T00:57:41+08:00	15257	33803	49060	2572	51632	89487	57.7%	17.05%	55	55
15	臺中市潭子區	2018-11-25T03:44:28+08:00	15257	33803	49060	2572	51632	89487	57.7%	17.05%	55	55
15	臺中市潭子區	2018-11-24T23:23:42+08:00	13645	30245	43890	2353	46243	79805	57.94%	17.1%	49	55
15	臺中市潭子區	2018-11-24T22:23:18+08:00	8598	19128	27726	1486	29212	50329	58.04%	17.08%	32	55
15	臺中市潭子區	2018-11-25T00:00:15+08:00	14800	32694	47494	2491	49985	86495	57.79%	17.11%	53	55
15	臺中市潭子區	2018-11-24T23:55:51+08:00	14800	32694	47494	2491	49985	86495	57.79%	17.11%	53	55
15	臺中市潭子區	2018-11-24T23:39:21+08:00	13945	30894	44839	2384	47223	81582	57.88%	17.09%	50	55
15	臺中市潭子區	2018-11-25T01:07:30+08:00	15257	33803	49060	2572	51632	89487	57.7%	17.05%	55	55
15	臺中市潭子區	2018-11-24T23:12:20+08:00	12980	28704	41684	2219	43903	75755	57.95%	17.13%	47	55
15	臺中市潭子區	2018-11-24T23:35:14+08:00	13645	30245	43890	2353	46243	79805	57.94%	17.1%	49	55
15	臺中市潭子區	2018-11-25T00:14:14+08:00	15257	33803	49060	2572	51632	89487	57.7%	17.05%	55	55
15	臺中市潭子區	2018-11-24T23:01:35+08:00	12706	28092	40798	2177	42975	74133	57.97%	17.14%	46	55
15	臺中市潭子區	2018-11-25T00:09:39+08:00	15018	33193	48211	2541	50752	87902	57.74%	17.08%	54	55
15	臺中市潭子區	2018-11-24T22:33:42+08:00	10294	22837	33131	1740	34871	60018	58.1%	17.15%	38	55
15	臺中市南屯區	2018-11-25T03:56:17+08:00	27215	51229	78444	3663	82107	135448	60.62%	20.09%	101	101
15	臺中市南屯區	2018-11-24T23:16:06+08:00	24963	46948	71911	3410	75321	124038	60.72%	20.13%	93	101
15	臺中市南屯區	2018-11-25T06:29:21+08:00	27215	51229	78444	3663	82107	135448	60.62%	20.09%	101	101
15	臺中市南屯區	2018-11-25T03:49:55+08:00	27215	51229	78444	3663	82107	135448	60.62%	20.09%	101	101
15	臺中市南屯區	2018-11-25T06:19:01+08:00	27215	51229	78444	3663	82107	135448	60.62%	20.09%	101	101
15	臺中市南屯區	2018-11-24T22:45:12+08:00	23054	43141	66195	3119	69314	114219	60.69%	20.18%	86	101
15	臺中市南屯區	2018-11-24T23:43:21+08:00	26103	49014	75117	3524	78641	129536	60.71%	20.15%	97	101
15	臺中市南屯區	2018-11-24T22:41:40+08:00	22555	42122	64677	3065	67742	111508	60.75%	20.23%	84	101
15	臺中市南屯區	2018-11-25T01:25:57+08:00	27215	51229	78444	3663	82107	135448	60.62%	20.09%	101	101
15	臺中市南屯區	2018-11-24T22:30:13+08:00	20421	37830	58251	2737	60988	100435	60.72%	20.33%	76	101
15	臺中市南屯區	2018-11-25T06:24:04+08:00	27215	51229	78444	3663	82107	135448	60.62%	20.09%	101	101
15	臺中市南屯區	2018-11-25T00:23:07+08:00	26717	50177	76894	3604	80498	132526	60.74%	20.16%	99	101
15	臺中市南屯區	2018-11-25T03:32:39+08:00	27215	51229	78444	3663	82107	135448	60.62%	20.09%	101	101
15	臺中市南屯區	2018-11-24T23:51:39+08:00	26103	49014	75117	3524	78641	129536	60.71%	20.15%	97	101
15	臺中市南屯區	2018-11-24T23:27:22+08:00	24963	46948	71911	3410	75321	124038	60.72%	20.13%	93	101
15	臺中市南屯區	2018-11-24T22:13:32+08:00	18395	34348	52743	2506	55249	90971	60.73%	20.22%	70	101
15	臺中市南屯區	2018-11-25T01:17:57+08:00	27215	51229	78444	3663	82107	135448	60.62%	20.09%	101	101
15	臺中市南屯區	2018-11-24T23:08:41+08:00	24963	46948	71911	3410	75321	124038	60.72%	20.13%	93	101
15	臺中市南屯區	2018-11-24T22:57:58+08:00	24963	46948	71911	3410	75321	124038	60.72%	20.13%	93	101
15	臺中市南屯區	2018-11-24T23:19:56+08:00	24963	46948	71911	3410	75321	124038	60.72%	20.13%	93	101
15	臺中市南屯區	2018-11-24T22:54:29+08:00	24666	46359	71025	3347	74372	122509	60.71%	20.13%	92	101
15	臺中市南屯區	2018-11-25T04:02:56+08:00	27215	51229	78444	3663	82107	135448	60.62%	20.09%	101	101
15	臺中市南屯區	2018-11-25T06:08:58+08:00	27215	51229	78444	3663	82107	135448	60.62%	20.09%	101	101
15	臺中市南屯區	2018-11-24T22:16:15+08:00	18723	35033	53756	2545	56301	92601	60.8%	20.22%	71	101
15	臺中市南屯區	2018-11-24T23:31:16+08:00	24963	46948	71911	3410	75321	124038	60.72%	20.13%	93	101
15	臺中市南屯區	2018-11-25T01:12:48+08:00	27215	51229	78444	3663	82107	135448	60.62%	20.09%	101	101
15	臺中市南屯區	2018-11-24T23:05:08+08:00	24963	46948	71911	3410	75321	124038	60.72%	20.13%	93	101
15	臺中市南屯區	2018-11-24T23:47:32+08:00	26103	49014	75117	3524	78641	129536	60.71%	20.15%	97	101
15	臺中市南屯區	2018-11-25T00:05:09+08:00	26131	49036	75167	3505	78672	129604	60.7%	20.16%	97	101
15	臺中市南屯區	2018-11-24T22:37:04+08:00	21998	41064	63062	2979	66041	108779	60.71%	20.22%	82	101
15	臺中市南屯區	2018-11-24T22:50:52+08:00	24059	45277	69336	3245	72581	119538	60.72%	20.13%	90	101
15	臺中市南屯區	2018-11-25T06:13:56+08:00	27215	51229	78444	3663	82107	135448	60.62%	20.09%	101	101
15	臺中市南屯區	2018-11-24T22:26:40+08:00	20093	37356	57449	2699	60148	98855	60.84%	20.33%	75	101
15	臺中市南屯區	2018-11-25T00:18:35+08:00	26717	50177	76894	3604	80498	132526	60.74%	20.16%	99	101
15	臺中市南屯區	2018-11-24T22:40:31+08:00	22555	42122	64677	3065	67742	111508	60.75%	20.23%	84	101
15	臺中市南屯區	2018-11-25T01:02:35+08:00	27215	51229	78444	3663	82107	135448	60.62%	20.09%	101	101
15	臺中市南屯區	2018-11-25T00:57:41+08:00	27215	51229	78444	3663	82107	135448	60.62%	20.09%	101	101
15	臺中市南屯區	2018-11-24T22:19:40+08:00	18723	35033	53756	2545	56301	92601	60.8%	20.22%	71	101
15	臺中市南屯區	2018-11-25T03:38:58+08:00	27215	51229	78444	3663	82107	135448	60.62%	20.09%	101	101
15	臺中市南屯區	2018-11-25T03:44:28+08:00	27215	51229	78444	3663	82107	135448	60.62%	20.09%	101	101
15	臺中市南屯區	2018-11-24T23:23:42+08:00	24963	46948	71911	3410	75321	124038	60.72%	20.13%	93	101
15	臺中市南屯區	2018-11-24T22:23:18+08:00	19372	36168	55540	2612	58152	95654	60.79%	20.25%	73	101
15	臺中市南屯區	2018-11-25T00:00:15+08:00	26103	49014	75117	3524	78641	129536	60.71%	20.15%	97	101
15	臺中市南屯區	2018-11-24T23:55:51+08:00	26103	49014	75117	3524	78641	129536	60.71%	20.15%	97	101
15	臺中市南屯區	2018-11-24T23:39:21+08:00	25799	48529	74328	3491	77819	128242	60.68%	20.12%	96	101
15	臺中市南屯區	2018-11-25T01:07:30+08:00	27215	51229	78444	3663	82107	135448	60.62%	20.09%	101	101
15	臺中市南屯區	2018-11-25T00:09:38+08:00	26131	49036	75167	3505	78672	129604	60.7%	20.16%	97	101
15	臺中市南屯區	2018-11-24T23:12:20+08:00	24963	46948	71911	3410	75321	124038	60.72%	20.13%	93	101
15	臺中市南屯區	2018-11-24T23:35:14+08:00	25561	48034	73595	3463	77058	127026	60.66%	20.12%	95	101
15	臺中市南屯區	2018-11-25T00:14:14+08:00	26441	49589	76030	3548	79578	131012	60.74%	20.18%	98	101
15	臺中市南屯區	2018-11-24T23:01:35+08:00	24963	46948	71911	3410	75321	124038	60.72%	20.13%	93	101
15	臺中市南屯區	2018-11-24T22:33:42+08:00	21407	40051	61458	2906	64364	105999	60.72%	20.2%	80	101
15	高雄市田寮區	2018-11-25T01:18:01+08:00	897	1982	2879	325	3204	6671	48.03%	13.45%	12	12
15	高雄市田寮區	2018-11-24T22:58:01+08:00	897	1982	2879	325	3204	6671	48.03%	13.45%	12	12
15	高雄市田寮區	2018-11-24T22:26:43+08:00	897	1982	2879	325	3204	6671	48.03%	13.45%	12	12
15	高雄市田寮區	2018-11-25T00:09:42+08:00	897	1982	2879	325	3204	6671	48.03%	13.45%	12	12
15	高雄市田寮區	2018-11-24T22:37:07+08:00	897	1982	2879	325	3204	6671	48.03%	13.45%	12	12
15	高雄市田寮區	2018-11-25T00:18:39+08:00	897	1982	2879	325	3204	6671	48.03%	13.45%	12	12
15	高雄市田寮區	2018-11-24T22:45:14+08:00	897	1982	2879	325	3204	6671	48.03%	13.45%	12	12
15	高雄市田寮區	2018-11-25T03:56:20+08:00	897	1982	2879	325	3204	6671	48.03%	13.45%	12	12
15	高雄市田寮區	2018-11-25T00:05:12+08:00	897	1982	2879	325	3204	6671	48.03%	13.45%	12	12
15	高雄市田寮區	2018-11-24T23:16:09+08:00	897	1982	2879	325	3204	6671	48.03%	13.45%	12	12
15	高雄市田寮區	2018-11-25T01:02:38+08:00	897	1982	2879	325	3204	6671	48.03%	13.45%	12	12
15	高雄市田寮區	2018-11-25T00:57:44+08:00	897	1982	2879	325	3204	6671	48.03%	13.45%	12	12
15	高雄市田寮區	2018-11-24T22:40:34+08:00	897	1982	2879	325	3204	6671	48.03%	13.45%	12	12
15	高雄市田寮區	2018-11-25T06:09:01+08:00	897	1982	2879	325	3204	6671	48.03%	13.45%	12	12
15	高雄市田寮區	2018-11-24T22:19:43+08:00	897	1982	2879	325	3204	6671	48.03%	13.45%	12	12
15	高雄市田寮區	2018-11-24T23:55:53+08:00	897	1982	2879	325	3204	6671	48.03%	13.45%	12	12
15	高雄市田寮區	2018-11-25T03:44:31+08:00	897	1982	2879	325	3204	6671	48.03%	13.45%	12	12
15	高雄市田寮區	2018-11-24T23:19:59+08:00	897	1982	2879	325	3204	6671	48.03%	13.45%	12	12
15	高雄市田寮區	2018-11-25T00:00:17+08:00	897	1982	2879	325	3204	6671	48.03%	13.45%	12	12
15	高雄市田寮區	2018-11-24T23:27:24+08:00	897	1982	2879	325	3204	6671	48.03%	13.45%	12	12
15	高雄市田寮區	2018-11-25T01:07:33+08:00	897	1982	2879	325	3204	6671	48.03%	13.45%	12	12
15	高雄市田寮區	2018-11-24T23:31:19+08:00	897	1982	2879	325	3204	6671	48.03%	13.45%	12	12
15	高雄市田寮區	2018-11-24T23:12:23+08:00	897	1982	2879	325	3204	6671	48.03%	13.45%	12	12
15	高雄市田寮區	2018-11-25T00:14:16+08:00	897	1982	2879	325	3204	6671	48.03%	13.45%	12	12
15	高雄市田寮區	2018-11-24T23:35:16+08:00	897	1982	2879	325	3204	6671	48.03%	13.45%	12	12
15	高雄市田寮區	2018-11-24T23:39:24+08:00	897	1982	2879	325	3204	6671	48.03%	13.45%	12	12
15	高雄市田寮區	2018-11-24T23:01:38+08:00	897	1982	2879	325	3204	6671	48.03%	13.45%	12	12
15	高雄市田寮區	2018-11-25T04:02:59+08:00	897	1982	2879	325	3204	6671	48.03%	13.45%	12	12
15	高雄市田寮區	2018-11-24T23:43:23+08:00	897	1982	2879	325	3204	6671	48.03%	13.45%	12	12
15	高雄市田寮區	2018-11-25T01:12:51+08:00	897	1982	2879	325	3204	6671	48.03%	13.45%	12	12
15	高雄市田寮區	2018-11-24T22:54:31+08:00	897	1982	2879	325	3204	6671	48.03%	13.45%	12	12
15	高雄市田寮區	2018-11-24T22:50:55+08:00	897	1982	2879	325	3204	6671	48.03%	13.45%	12	12
15	高雄市田寮區	2018-11-25T06:13:59+08:00	897	1982	2879	325	3204	6671	48.03%	13.45%	12	12
15	高雄市田寮區	2018-11-24T22:41:43+08:00	897	1982	2879	325	3204	6671	48.03%	13.45%	12	12
15	高雄市田寮區	2018-11-25T03:49:57+08:00	897	1982	2879	325	3204	6671	48.03%	13.45%	12	12
15	高雄市田寮區	2018-11-24T23:05:10+08:00	897	1982	2879	325	3204	6671	48.03%	13.45%	12	12
15	高雄市田寮區	2018-11-25T06:19:04+08:00	897	1982	2879	325	3204	6671	48.03%	13.45%	12	12
15	高雄市田寮區	2018-11-25T06:29:24+08:00	897	1982	2879	325	3204	6671	48.03%	13.45%	12	12
15	高雄市田寮區	2018-11-25T06:24:07+08:00	897	1982	2879	325	3204	6671	48.03%	13.45%	12	12
15	高雄市田寮區	2018-11-24T22:30:16+08:00	897	1982	2879	325	3204	6671	48.03%	13.45%	12	12
15	高雄市田寮區	2018-11-24T23:51:42+08:00	897	1982	2879	325	3204	6671	48.03%	13.45%	12	12
15	高雄市田寮區	2018-11-24T22:13:36+08:00	897	1982	2879	325	3204	6671	48.03%	13.45%	12	12
15	高雄市田寮區	2018-11-24T23:08:44+08:00	897	1982	2879	325	3204	6671	48.03%	13.45%	12	12
15	高雄市田寮區	2018-11-25T00:23:10+08:00	897	1982	2879	325	3204	6671	48.03%	13.45%	12	12
15	高雄市田寮區	2018-11-24T22:23:21+08:00	897	1982	2879	325	3204	6671	48.03%	13.45%	12	12
15	高雄市田寮區	2018-11-25T03:32:44+08:00	897	1982	2879	325	3204	6671	48.03%	13.45%	12	12
15	高雄市田寮區	2018-11-24T23:23:44+08:00	897	1982	2879	325	3204	6671	48.03%	13.45%	12	12
15	高雄市田寮區	2018-11-24T22:33:44+08:00	897	1982	2879	325	3204	6671	48.03%	13.45%	12	12
15	高雄市田寮區	2018-11-25T01:26:00+08:00	897	1982	2879	325	3204	6671	48.03%	13.45%	12	12
15	高雄市田寮區	2018-11-24T23:47:36+08:00	897	1982	2879	325	3204	6671	48.03%	13.45%	12	12
15	高雄市田寮區	2018-11-25T03:39:01+08:00	897	1982	2879	325	3204	6671	48.03%	13.45%	12	12
15	高雄市田寮區	2018-11-24T22:16:18+08:00	897	1982	2879	325	3204	6671	48.03%	13.45%	12	12
15	高雄市六龜區	2018-11-25T01:18:01+08:00	1451	3386	4837	642	5479	11501	47.64%	12.62%	12	12
15	高雄市六龜區	2018-11-24T22:58:01+08:00	1313	3072	4385	584	4969	10498	47.33%	12.51%	11	12
15	高雄市六龜區	2018-11-24T22:26:43+08:00	1313	3072	4385	584	4969	10498	47.33%	12.51%	11	12
15	高雄市六龜區	2018-11-25T00:09:42+08:00	1451	3386	4837	642	5479	11501	47.64%	12.62%	12	12
15	高雄市六龜區	2018-11-25T03:56:21+08:00	1451	3386	4837	642	5479	11501	47.64%	12.62%	12	12
15	高雄市六龜區	2018-11-25T01:12:52+08:00	1451	3386	4837	642	5479	11501	47.64%	12.62%	12	12
15	高雄市六龜區	2018-11-24T22:37:07+08:00	1313	3072	4385	584	4969	10498	47.33%	12.51%	11	12
15	高雄市六龜區	2018-11-24T22:54:32+08:00	1313	3072	4385	584	4969	10498	47.33%	12.51%	11	12
15	高雄市六龜區	2018-11-24T22:50:56+08:00	1313	3072	4385	584	4969	10498	47.33%	12.51%	11	12
15	高雄市六龜區	2018-11-25T00:18:39+08:00	1451	3386	4837	642	5479	11501	47.64%	12.62%	12	12
15	高雄市六龜區	2018-11-25T00:05:12+08:00	1451	3386	4837	642	5479	11501	47.64%	12.62%	12	12
15	高雄市六龜區	2018-11-24T23:16:09+08:00	1313	3072	4385	584	4969	10498	47.33%	12.51%	11	12
15	高雄市六龜區	2018-11-24T22:45:15+08:00	1313	3072	4385	584	4969	10498	47.33%	12.51%	11	12
15	高雄市六龜區	2018-11-25T01:02:38+08:00	1451	3386	4837	642	5479	11501	47.64%	12.62%	12	12
15	高雄市六龜區	2018-11-25T00:57:44+08:00	1451	3386	4837	642	5479	11501	47.64%	12.62%	12	12
15	高雄市六龜區	2018-11-24T22:40:34+08:00	1313	3072	4385	584	4969	10498	47.33%	12.51%	11	12
15	高雄市六龜區	2018-11-25T06:09:01+08:00	1451	3386	4837	642	5479	11501	47.64%	12.62%	12	12
15	高雄市六龜區	2018-11-24T22:19:43+08:00	1168	2658	3826	476	4302	9116	47.19%	12.81%	10	12
15	高雄市六龜區	2018-11-24T23:55:54+08:00	1451	3386	4837	642	5479	11501	47.64%	12.62%	12	12
15	高雄市六龜區	2018-11-24T23:27:25+08:00	1313	3072	4385	584	4969	10498	47.33%	12.51%	11	12
15	高雄市六龜區	2018-11-24T23:19:59+08:00	1313	3072	4385	584	4969	10498	47.33%	12.51%	11	12
15	高雄市六龜區	2018-11-25T00:00:17+08:00	1451	3386	4837	642	5479	11501	47.64%	12.62%	12	12
15	高雄市六龜區	2018-11-25T01:07:33+08:00	1451	3386	4837	642	5479	11501	47.64%	12.62%	12	12
15	高雄市六龜區	2018-11-24T23:31:19+08:00	1313	3072	4385	584	4969	10498	47.33%	12.51%	11	12
15	高雄市六龜區	2018-11-24T23:12:24+08:00	1313	3072	4385	584	4969	10498	47.33%	12.51%	11	12
15	高雄市六龜區	2018-11-24T23:39:24+08:00	1451	3386	4837	642	5479	11501	47.64%	12.62%	12	12
15	高雄市六龜區	2018-11-24T23:01:38+08:00	1313	3072	4385	584	4969	10498	47.33%	12.51%	11	12
15	高雄市六龜區	2018-11-24T23:35:17+08:00	1313	3072	4385	584	4969	10498	47.33%	12.51%	11	12
15	高雄市六龜區	2018-11-25T04:02:59+08:00	1451	3386	4837	642	5479	11501	47.64%	12.62%	12	12
15	高雄市六龜區	2018-11-25T00:14:17+08:00	1451	3386	4837	642	5479	11501	47.64%	12.62%	12	12
15	高雄市六龜區	2018-11-24T23:43:23+08:00	1451	3386	4837	642	5479	11501	47.64%	12.62%	12	12
15	高雄市六龜區	2018-11-25T03:49:58+08:00	1451	3386	4837	642	5479	11501	47.64%	12.62%	12	12
15	高雄市六龜區	2018-11-24T23:05:11+08:00	1313	3072	4385	584	4969	10498	47.33%	12.51%	11	12
15	高雄市六龜區	2018-11-25T06:13:59+08:00	1451	3386	4837	642	5479	11501	47.64%	12.62%	12	12
15	高雄市六龜區	2018-11-24T22:41:43+08:00	1313	3072	4385	584	4969	10498	47.33%	12.51%	11	12
15	高雄市六龜區	2018-11-25T06:19:04+08:00	1451	3386	4837	642	5479	11501	47.64%	12.62%	12	12
15	高雄市六龜區	2018-11-25T06:29:24+08:00	1451	3386	4837	642	5479	11501	47.64%	12.62%	12	12
15	高雄市六龜區	2018-11-25T06:24:07+08:00	1451	3386	4837	642	5479	11501	47.64%	12.62%	12	12
15	高雄市六龜區	2018-11-24T22:30:17+08:00	1313	3072	4385	584	4969	10498	47.33%	12.51%	11	12
15	高雄市六龜區	2018-11-24T23:51:42+08:00	1451	3386	4837	642	5479	11501	47.64%	12.62%	12	12
15	高雄市六龜區	2018-11-24T23:23:45+08:00	1313	3072	4385	584	4969	10498	47.33%	12.51%	11	12
15	高雄市六龜區	2018-11-25T03:44:32+08:00	1451	3386	4837	642	5479	11501	47.64%	12.62%	12	12
15	高雄市六龜區	2018-11-24T23:08:44+08:00	1313	3072	4385	584	4969	10498	47.33%	12.51%	11	12
15	高雄市六龜區	2018-11-24T22:23:21+08:00	1313	3072	4385	584	4969	10498	47.33%	12.51%	11	12
15	高雄市六龜區	2018-11-25T03:32:44+08:00	1451	3386	4837	642	5479	11501	47.64%	12.62%	12	12
15	高雄市六龜區	2018-11-24T22:13:37+08:00	1168	2658	3826	476	4302	9116	47.19%	12.81%	10	12
15	高雄市六龜區	2018-11-25T00:23:11+08:00	1451	3386	4837	642	5479	11501	47.64%	12.62%	12	12
15	高雄市六龜區	2018-11-25T01:26:00+08:00	1451	3386	4837	642	5479	11501	47.64%	12.62%	12	12
15	高雄市六龜區	2018-11-24T23:47:36+08:00	1451	3386	4837	642	5479	11501	47.64%	12.62%	12	12
15	高雄市六龜區	2018-11-25T03:39:01+08:00	1451	3386	4837	642	5479	11501	47.64%	12.62%	12	12
15	高雄市六龜區	2018-11-24T22:33:45+08:00	1313	3072	4385	584	4969	10498	47.33%	12.51%	11	12
15	高雄市六龜區	2018-11-24T22:16:18+08:00	1168	2658	3826	476	4302	9116	47.19%	12.81%	10	12
15	嘉義縣新港鄉	2018-11-25T01:18:06+08:00	4330	8597	12927	1648	14575	27342	53.31%	15.84%	31	31
15	嘉義縣新港鄉	2018-11-25T06:29:28+08:00	4330	8597	12927	1648	14575	27342	53.31%	15.84%	31	31
15	嘉義縣新港鄉	2018-11-24T23:43:27+08:00	4330	8597	12927	1648	14575	27342	53.31%	15.84%	31	31
15	嘉義縣新港鄉	2018-11-25T01:12:55+08:00	4330	8597	12927	1648	14575	27342	53.31%	15.84%	31	31
15	嘉義縣新港鄉	2018-11-24T22:54:35+08:00	4086	8050	12136	1592	13728	25942	52.92%	15.75%	30	31
15	嘉義縣新港鄉	2018-11-24T23:05:13+08:00	4086	8050	12136	1592	13728	25942	52.92%	15.75%	30	31
15	嘉義縣新港鄉	2018-11-25T06:19:07+08:00	4330	8597	12927	1648	14575	27342	53.31%	15.84%	31	31
15	嘉義縣新港鄉	2018-11-25T00:05:15+08:00	4330	8597	12927	1648	14575	27342	53.31%	15.84%	31	31
15	嘉義縣新港鄉	2018-11-24T22:41:47+08:00	3886	7653	11539	1455	12994	24639	52.74%	15.77%	28	31
15	嘉義縣新港鄉	2018-11-24T23:51:46+08:00	4330	8597	12927	1648	14575	27342	53.31%	15.84%	31	31
15	嘉義縣新港鄉	2018-11-25T06:09:06+08:00	4330	8597	12927	1648	14575	27342	53.31%	15.84%	31	31
15	嘉義縣新港鄉	2018-11-25T01:02:41+08:00	4330	8597	12927	1648	14575	27342	53.31%	15.84%	31	31
15	嘉義縣新港鄉	2018-11-25T00:23:14+08:00	4330	8597	12927	1648	14575	27342	53.31%	15.84%	31	31
15	嘉義縣新港鄉	2018-11-25T03:32:48+08:00	4330	8597	12927	1648	14575	27342	53.31%	15.84%	31	31
15	嘉義縣新港鄉	2018-11-24T23:23:48+08:00	4330	8597	12927	1648	14575	27342	53.31%	15.84%	31	31
15	嘉義縣新港鄉	2018-11-25T06:24:10+08:00	4330	8597	12927	1648	14575	27342	53.31%	15.84%	31	31
15	嘉義縣新港鄉	2018-11-25T00:00:21+08:00	4330	8597	12927	1648	14575	27342	53.31%	15.84%	31	31
15	嘉義縣新港鄉	2018-11-24T22:23:25+08:00	3886	7653	11539	1455	12994	24639	52.74%	15.77%	28	31
15	嘉義縣新港鄉	2018-11-24T22:51:00+08:00	4086	8050	12136	1592	13728	25942	52.92%	15.75%	30	31
15	嘉義縣新港鄉	2018-11-25T03:44:37+08:00	4330	8597	12927	1648	14575	27342	53.31%	15.84%	31	31
15	嘉義縣新港鄉	2018-11-24T23:08:48+08:00	4330	8597	12927	1648	14575	27342	53.31%	15.84%	31	31
15	嘉義縣新港鄉	2018-11-24T22:16:22+08:00	3886	7653	11539	1455	12994	24639	52.74%	15.77%	28	31
15	嘉義縣新港鄉	2018-11-25T03:39:04+08:00	4330	8597	12927	1648	14575	27342	53.31%	15.84%	31	31
15	嘉義縣新港鄉	2018-11-25T01:26:04+08:00	4330	8597	12927	1648	14575	27342	53.31%	15.84%	31	31
15	嘉義縣新港鄉	2018-11-24T23:16:13+08:00	4330	8597	12927	1648	14575	27342	53.31%	15.84%	31	31
15	嘉義縣新港鄉	2018-11-24T23:35:20+08:00	4330	8597	12927	1648	14575	27342	53.31%	15.84%	31	31
15	嘉義縣新港鄉	2018-11-25T00:14:20+08:00	4330	8597	12927	1648	14575	27342	53.31%	15.84%	31	31
15	嘉義縣新港鄉	2018-11-24T22:33:48+08:00	3886	7653	11539	1455	12994	24639	52.74%	15.77%	28	31
15	嘉義縣新港鄉	2018-11-25T03:50:01+08:00	4330	8597	12927	1648	14575	27342	53.31%	15.84%	31	31
15	嘉義縣新港鄉	2018-11-24T23:47:40+08:00	4330	8597	12927	1648	14575	27342	53.31%	15.84%	31	31
15	嘉義縣新港鄉	2018-11-24T22:58:05+08:00	4086	8050	12136	1592	13728	25942	52.92%	15.75%	30	31
15	嘉義縣新港鄉	2018-11-25T00:09:46+08:00	4330	8597	12927	1648	14575	27342	53.31%	15.84%	31	31
15	嘉義縣新港鄉	2018-11-24T22:45:18+08:00	4022	7889	11911	1547	13458	25455	52.87%	15.8%	29	31
15	嘉義縣新港鄉	2018-11-25T03:56:24+08:00	4330	8597	12927	1648	14575	27342	53.31%	15.84%	31	31
15	嘉義縣新港鄉	2018-11-24T22:26:46+08:00	3886	7653	11539	1455	12994	24639	52.74%	15.77%	28	31
15	嘉義縣新港鄉	2018-11-24T23:01:42+08:00	4086	8050	12136	1592	13728	25942	52.92%	15.75%	30	31
15	嘉義縣新港鄉	2018-11-24T22:19:46+08:00	3886	7653	11539	1455	12994	24639	52.74%	15.77%	28	31
15	嘉義縣新港鄉	2018-11-24T22:13:41+08:00	3886	7653	11539	1455	12994	24639	52.74%	15.77%	28	31
15	嘉義縣新港鄉	2018-11-25T04:03:02+08:00	4330	8597	12927	1648	14575	27342	53.31%	15.84%	31	31
15	嘉義縣新港鄉	2018-11-25T00:57:48+08:00	4330	8597	12927	1648	14575	27342	53.31%	15.84%	31	31
15	嘉義縣新港鄉	2018-11-24T22:40:37+08:00	3886	7653	11539	1455	12994	24639	52.74%	15.77%	28	31
15	嘉義縣新港鄉	2018-11-24T22:30:20+08:00	3886	7653	11539	1455	12994	24639	52.74%	15.77%	28	31
15	嘉義縣新港鄉	2018-11-24T23:55:57+08:00	4330	8597	12927	1648	14575	27342	53.31%	15.84%	31	31
15	嘉義縣新港鄉	2018-11-24T23:27:27+08:00	4330	8597	12927	1648	14575	27342	53.31%	15.84%	31	31
15	嘉義縣新港鄉	2018-11-25T06:14:02+08:00	4330	8597	12927	1648	14575	27342	53.31%	15.84%	31	31
15	嘉義縣新港鄉	2018-11-25T00:18:43+08:00	4330	8597	12927	1648	14575	27342	53.31%	15.84%	31	31
15	嘉義縣新港鄉	2018-11-25T01:07:37+08:00	4330	8597	12927	1648	14575	27342	53.31%	15.84%	31	31
15	嘉義縣新港鄉	2018-11-24T23:12:27+08:00	4330	8597	12927	1648	14575	27342	53.31%	15.84%	31	31
15	嘉義縣新港鄉	2018-11-24T22:37:11+08:00	3886	7653	11539	1455	12994	24639	52.74%	15.77%	28	31
15	嘉義縣新港鄉	2018-11-24T23:39:29+08:00	4330	8597	12927	1648	14575	27342	53.31%	15.84%	31	31
15	嘉義縣新港鄉	2018-11-24T23:31:23+08:00	4330	8597	12927	1648	14575	27342	53.31%	15.84%	31	31
15	嘉義縣新港鄉	2018-11-24T23:20:02+08:00	4330	8597	12927	1648	14575	27342	53.31%	15.84%	31	31
15	金門縣	2018-11-25T03:56:28+08:00	10826	30970	41796	2118	43914	122695	35.79%	8.82%	78	78
15	金門縣	2018-11-24T23:47:43+08:00	10826	30970	41796	2118	43914	122695	35.79%	8.82%	78	78
15	金門縣	2018-11-24T22:58:09+08:00	10247	28936	39183	1955	41138	114933	35.79%	8.92%	74	78
15	金門縣	2018-11-24T23:56:01+08:00	10826	30970	41796	2118	43914	122695	35.79%	8.82%	78	78
15	金門縣	2018-11-24T23:01:46+08:00	10467	29550	40017	2003	42020	117450	35.78%	8.91%	75	78
15	金門縣	2018-11-24T23:12:30+08:00	10467	29550	40017	2003	42020	117450	35.78%	8.91%	75	78
15	金門縣	2018-11-25T03:32:53+08:00	10826	30970	41796	2118	43914	122695	35.79%	8.82%	78	78
15	金門縣	2018-11-24T23:51:49+08:00	10826	30970	41796	2118	43914	122695	35.79%	8.82%	78	78
15	金門縣	2018-11-24T22:13:45+08:00	8335	24958	33293	1700	34993	98697	35.45%	8.45%	64	78
15	金門縣	2018-11-25T03:44:41+08:00	10826	30970	41796	2118	43914	122695	35.79%	8.82%	78	78
15	金門縣	2018-11-25T04:03:06+08:00	10826	30970	41796	2118	43914	122695	35.79%	8.82%	78	78
15	金門縣	2018-11-24T23:27:31+08:00	10467	29550	40017	2003	42020	117450	35.78%	8.91%	75	78
15	金門縣	2018-11-24T22:30:23+08:00	8573	25680	34253	1761	36014	101611	35.44%	8.44%	66	78
15	金門縣	2018-11-25T00:57:51+08:00	10826	30970	41796	2118	43914	122695	35.79%	8.82%	78	78
15	金門縣	2018-11-24T22:19:50+08:00	8434	25317	33751	1735	35486	100211	35.41%	8.42%	65	78
15	金門縣	2018-11-25T00:09:50+08:00	10826	30970	41796	2118	43914	122695	35.79%	8.82%	78	78
15	金門縣	2018-11-25T00:18:47+08:00	10826	30970	41796	2118	43914	122695	35.79%	8.82%	78	78
15	金門縣	2018-11-24T22:37:14+08:00	8824	26525	35349	1808	37157	104705	35.49%	8.43%	68	78
15	金門縣	2018-11-24T23:20:08+08:00	10467	29550	40017	2003	42020	117450	35.78%	8.91%	75	78
15	金門縣	2018-11-24T23:31:27+08:00	10727	30588	41315	2064	43379	121185	35.8%	8.85%	77	78
15	金門縣	2018-11-24T22:45:21+08:00	9101	27387	36488	1863	38351	108383	35.38%	8.4%	70	78
15	金門縣	2018-11-24T22:54:38+08:00	10096	28516	38612	1939	40551	113608	35.69%	8.89%	73	78
15	金門縣	2018-11-24T22:33:51+08:00	8824	26525	35349	1808	37157	104705	35.49%	8.43%	68	78
15	金門縣	2018-11-24T23:39:33+08:00	10826	30970	41796	2118	43914	122695	35.79%	8.82%	78	78
15	金門縣	2018-11-24T23:05:16+08:00	10467	29550	40017	2003	42020	117450	35.78%	8.91%	75	78
15	金門縣	2018-11-24T22:26:49+08:00	8573	25680	34253	1761	36014	101611	35.44%	8.44%	66	78
15	金門縣	2018-11-25T01:07:40+08:00	10826	30970	41796	2118	43914	122695	35.79%	8.82%	78	78
15	金門縣	2018-11-25T01:12:59+08:00	10826	30970	41796	2118	43914	122695	35.79%	8.82%	78	78
15	金門縣	2018-11-25T00:05:18+08:00	10826	30970	41796	2118	43914	122695	35.79%	8.82%	78	78
15	金門縣	2018-11-24T23:08:51+08:00	10467	29550	40017	2003	42020	117450	35.78%	8.91%	75	78
15	金門縣	2018-11-24T23:23:51+08:00	10467	29550	40017	2003	42020	117450	35.78%	8.91%	75	78
15	金門縣	2018-11-24T22:23:29+08:00	8573	25680	34253	1761	36014	101611	35.44%	8.44%	66	78
15	金門縣	2018-11-25T00:23:17+08:00	10826	30970	41796	2118	43914	122695	35.79%	8.82%	78	78
15	金門縣	2018-11-25T00:00:24+08:00	10826	30970	41796	2118	43914	122695	35.79%	8.82%	78	78
15	金門縣	2018-11-25T01:02:45+08:00	10826	30970	41796	2118	43914	122695	35.79%	8.82%	78	78
15	金門縣	2018-11-24T22:51:04+08:00	9900	28100	38000	1909	39909	111828	35.69%	8.85%	72	78
15	金門縣	2018-11-25T06:09:10+08:00	10826	30970	41796	2118	43914	122695	35.79%	8.82%	78	78
15	金門縣	2018-11-25T06:24:14+08:00	10826	30970	41796	2118	43914	122695	35.79%	8.82%	78	78
15	金門縣	2018-11-24T22:40:40+08:00	8936	27041	35977	1838	37815	106708	35.44%	8.37%	69	78
15	金門縣	2018-11-25T06:14:05+08:00	10826	30970	41796	2118	43914	122695	35.79%	8.82%	78	78
15	金門縣	2018-11-24T23:35:23+08:00	10727	30588	41315	2064	43379	121185	35.8%	8.85%	77	78
15	金門縣	2018-11-25T00:14:24+08:00	10826	30970	41796	2118	43914	122695	35.79%	8.82%	78	78
15	金門縣	2018-11-25T01:18:10+08:00	10826	30970	41796	2118	43914	122695	35.79%	8.82%	78	78
15	金門縣	2018-11-25T03:50:04+08:00	10826	30970	41796	2118	43914	122695	35.79%	8.82%	78	78
15	金門縣	2018-11-24T22:16:26+08:00	8335	24958	33293	1700	34993	98697	35.45%	8.45%	64	78
15	金門縣	2018-11-24T23:43:31+08:00	10826	30970	41796	2118	43914	122695	35.79%	8.82%	78	78
15	金門縣	2018-11-25T06:29:31+08:00	10826	30970	41796	2118	43914	122695	35.79%	8.82%	78	78
15	金門縣	2018-11-24T23:16:16+08:00	10467	29550	40017	2003	42020	117450	35.78%	8.91%	75	78
15	金門縣	2018-11-25T06:19:11+08:00	10826	30970	41796	2118	43914	122695	35.79%	8.82%	78	78
15	金門縣	2018-11-24T22:41:51+08:00	8936	27041	35977	1838	37815	106708	35.44%	8.37%	69	78
15	金門縣	2018-11-25T03:39:08+08:00	10826	30970	41796	2118	43914	122695	35.79%	8.82%	78	78
15	金門縣	2018-11-25T01:26:08+08:00	10826	30970	41796	2118	43914	122695	35.79%	8.82%	78	78
15	嘉義縣大埔鄉	2018-11-24T22:58:06+08:00	300	679	979	51	1030	1962	52.5%	15.29%	7	9
15	嘉義縣大埔鄉	2018-11-25T06:19:08+08:00	634	1397	2031	157	2188	3999	54.71%	15.85%	9	9
15	嘉義縣大埔鄉	2018-11-25T01:18:06+08:00	385	913	1298	79	1377	2531	54.41%	15.21%	8	9
15	嘉義縣大埔鄉	2018-11-25T06:29:28+08:00	634	1397	2031	157	2188	3999	54.71%	15.85%	9	9
15	嘉義縣大埔鄉	2018-11-24T23:43:27+08:00	385	913	1298	79	1377	2531	54.41%	15.21%	8	9
15	嘉義縣大埔鄉	2018-11-24T22:54:35+08:00	300	679	979	51	1030	1962	52.5%	15.29%	7	9
15	嘉義縣大埔鄉	2018-11-24T23:05:14+08:00	385	913	1298	79	1377	2531	54.41%	15.21%	8	9
15	嘉義縣大埔鄉	2018-11-25T00:05:15+08:00	385	913	1298	79	1377	2531	54.41%	15.21%	8	9
15	嘉義縣大埔鄉	2018-11-24T22:41:47+08:00	300	679	979	51	1030	1962	52.5%	15.29%	7	9
15	嘉義縣大埔鄉	2018-11-24T22:13:42+08:00	300	679	979	51	1030	1962	52.5%	15.29%	7	9
15	嘉義縣大埔鄉	2018-11-24T23:51:46+08:00	385	913	1298	79	1377	2531	54.41%	15.21%	8	9
15	嘉義縣大埔鄉	2018-11-25T06:09:06+08:00	634	1397	2031	157	2188	3999	54.71%	15.85%	9	9
15	嘉義縣大埔鄉	2018-11-25T01:02:41+08:00	385	913	1298	79	1377	2531	54.41%	15.21%	8	9
15	嘉義縣大埔鄉	2018-11-25T00:23:14+08:00	385	913	1298	79	1377	2531	54.41%	15.21%	8	9
15	嘉義縣大埔鄉	2018-11-25T06:24:11+08:00	634	1397	2031	157	2188	3999	54.71%	15.85%	9	9
15	嘉義縣大埔鄉	2018-11-24T23:23:48+08:00	385	913	1298	79	1377	2531	54.41%	15.21%	8	9
15	嘉義縣大埔鄉	2018-11-25T00:00:21+08:00	385	913	1298	79	1377	2531	54.41%	15.21%	8	9
15	嘉義縣大埔鄉	2018-11-24T22:23:25+08:00	300	679	979	51	1030	1962	52.5%	15.29%	7	9
15	嘉義縣大埔鄉	2018-11-24T22:51:00+08:00	300	679	979	51	1030	1962	52.5%	15.29%	7	9
15	嘉義縣大埔鄉	2018-11-25T03:32:49+08:00	634	1397	2031	157	2188	3999	54.71%	15.85%	9	9
15	嘉義縣大埔鄉	2018-11-25T03:44:37+08:00	634	1397	2031	157	2188	3999	54.71%	15.85%	9	9
15	嘉義縣大埔鄉	2018-11-24T23:08:48+08:00	385	913	1298	79	1377	2531	54.41%	15.21%	8	9
15	嘉義縣大埔鄉	2018-11-24T22:16:22+08:00	300	679	979	51	1030	1962	52.5%	15.29%	7	9
15	嘉義縣大埔鄉	2018-11-25T01:26:04+08:00	385	913	1298	79	1377	2531	54.41%	15.21%	8	9
15	嘉義縣大埔鄉	2018-11-24T23:16:13+08:00	385	913	1298	79	1377	2531	54.41%	15.21%	8	9
15	嘉義縣大埔鄉	2018-11-24T23:35:20+08:00	385	913	1298	79	1377	2531	54.41%	15.21%	8	9
15	嘉義縣大埔鄉	2018-11-25T00:14:20+08:00	385	913	1298	79	1377	2531	54.41%	15.21%	8	9
15	嘉義縣大埔鄉	2018-11-25T03:39:05+08:00	634	1397	2031	157	2188	3999	54.71%	15.85%	9	9
15	嘉義縣大埔鄉	2018-11-24T22:33:48+08:00	300	679	979	51	1030	1962	52.5%	15.29%	7	9
15	嘉義縣大埔鄉	2018-11-25T03:50:01+08:00	634	1397	2031	157	2188	3999	54.71%	15.85%	9	9
15	嘉義縣大埔鄉	2018-11-25T01:12:56+08:00	385	913	1298	79	1377	2531	54.41%	15.21%	8	9
15	嘉義縣大埔鄉	2018-11-24T23:47:40+08:00	385	913	1298	79	1377	2531	54.41%	15.21%	8	9
15	嘉義縣大埔鄉	2018-11-24T23:01:43+08:00	385	913	1298	79	1377	2531	54.41%	15.21%	8	9
15	嘉義縣大埔鄉	2018-11-25T00:09:46+08:00	385	913	1298	79	1377	2531	54.41%	15.21%	8	9
15	嘉義縣大埔鄉	2018-11-25T03:56:25+08:00	634	1397	2031	157	2188	3999	54.71%	15.85%	9	9
15	嘉義縣大埔鄉	2018-11-24T22:45:18+08:00	300	679	979	51	1030	1962	52.5%	15.29%	7	9
15	嘉義縣大埔鄉	2018-11-24T22:26:46+08:00	300	679	979	51	1030	1962	52.5%	15.29%	7	9
15	嘉義縣大埔鄉	2018-11-24T22:40:38+08:00	300	679	979	51	1030	1962	52.5%	15.29%	7	9
15	嘉義縣大埔鄉	2018-11-25T04:03:03+08:00	634	1397	2031	157	2188	3999	54.71%	15.85%	9	9
15	嘉義縣大埔鄉	2018-11-25T00:57:48+08:00	385	913	1298	79	1377	2531	54.41%	15.21%	8	9
15	嘉義縣大埔鄉	2018-11-24T22:19:47+08:00	300	679	979	51	1030	1962	52.5%	15.29%	7	9
15	嘉義縣大埔鄉	2018-11-24T22:30:20+08:00	300	679	979	51	1030	1962	52.5%	15.29%	7	9
15	嘉義縣大埔鄉	2018-11-24T23:27:28+08:00	385	913	1298	79	1377	2531	54.41%	15.21%	8	9
15	嘉義縣大埔鄉	2018-11-24T23:55:58+08:00	385	913	1298	79	1377	2531	54.41%	15.21%	8	9
15	嘉義縣大埔鄉	2018-11-25T06:14:02+08:00	634	1397	2031	157	2188	3999	54.71%	15.85%	9	9
15	嘉義縣大埔鄉	2018-11-25T00:18:44+08:00	385	913	1298	79	1377	2531	54.41%	15.21%	8	9
15	嘉義縣大埔鄉	2018-11-24T23:20:03+08:00	385	913	1298	79	1377	2531	54.41%	15.21%	8	9
15	嘉義縣大埔鄉	2018-11-25T01:07:37+08:00	385	913	1298	79	1377	2531	54.41%	15.21%	8	9
15	嘉義縣大埔鄉	2018-11-24T23:12:27+08:00	385	913	1298	79	1377	2531	54.41%	15.21%	8	9
15	嘉義縣大埔鄉	2018-11-24T22:37:11+08:00	300	679	979	51	1030	1962	52.5%	15.29%	7	9
15	嘉義縣大埔鄉	2018-11-24T23:39:29+08:00	385	913	1298	79	1377	2531	54.41%	15.21%	8	9
15	嘉義縣大埔鄉	2018-11-24T23:31:24+08:00	385	913	1298	79	1377	2531	54.41%	15.21%	8	9
15	臺南市北門區	2018-11-24T23:16:08+08:00	1139	2677	3816	260	4076	9925	41.07%	11.48%	18	18
15	臺南市北門區	2018-11-24T22:41:41+08:00	1139	2677	3816	260	4076	9925	41.07%	11.48%	18	18
15	臺南市北門區	2018-11-25T00:18:37+08:00	1139	2677	3816	260	4076	9925	41.07%	11.48%	18	18
15	臺南市北門區	2018-11-24T22:45:13+08:00	1139	2677	3816	260	4076	9925	41.07%	11.48%	18	18
15	臺南市北門區	2018-11-25T03:56:18+08:00	1139	2677	3816	260	4076	9925	41.07%	11.48%	18	18
15	臺南市北門區	2018-11-24T22:58:00+08:00	1139	2677	3816	260	4076	9925	41.07%	11.48%	18	18
15	臺南市北門區	2018-11-24T23:51:40+08:00	1139	2677	3816	260	4076	9925	41.07%	11.48%	18	18
15	臺南市北門區	2018-11-24T22:40:32+08:00	1139	2677	3816	260	4076	9925	41.07%	11.48%	18	18
15	臺南市北門區	2018-11-25T01:02:36+08:00	1139	2677	3816	260	4076	9925	41.07%	11.48%	18	18
15	臺南市北門區	2018-11-24T22:19:42+08:00	1139	2677	3816	260	4076	9925	41.07%	11.48%	18	18
15	臺南市北門區	2018-11-25T01:25:58+08:00	1139	2677	3816	260	4076	9925	41.07%	11.48%	18	18
15	臺南市北門區	2018-11-24T22:30:15+08:00	1139	2677	3816	260	4076	9925	41.07%	11.48%	18	18
15	臺南市北門區	2018-11-25T00:23:09+08:00	1139	2677	3816	260	4076	9925	41.07%	11.48%	18	18
15	臺南市北門區	2018-11-25T00:57:42+08:00	1139	2677	3816	260	4076	9925	41.07%	11.48%	18	18
15	臺南市北門區	2018-11-25T06:24:05+08:00	1139	2677	3816	260	4076	9925	41.07%	11.48%	18	18
15	臺南市北門區	2018-11-25T00:00:16+08:00	1139	2677	3816	260	4076	9925	41.07%	11.48%	18	18
15	臺南市北門區	2018-11-25T01:17:59+08:00	1139	2677	3816	260	4076	9925	41.07%	11.48%	18	18
15	臺南市北門區	2018-11-24T23:19:57+08:00	1139	2677	3816	260	4076	9925	41.07%	11.48%	18	18
15	臺南市北門區	2018-11-24T23:55:52+08:00	1139	2677	3816	260	4076	9925	41.07%	11.48%	18	18
15	臺南市北門區	2018-11-24T22:13:34+08:00	1139	2677	3816	260	4076	9925	41.07%	11.48%	18	18
15	臺南市北門區	2018-11-24T23:27:23+08:00	1139	2677	3816	260	4076	9925	41.07%	11.48%	18	18
15	臺南市北門區	2018-11-24T23:39:22+08:00	1139	2677	3816	260	4076	9925	41.07%	11.48%	18	18
15	臺南市北門區	2018-11-25T01:12:49+08:00	1139	2677	3816	260	4076	9925	41.07%	11.48%	18	18
15	臺南市北門區	2018-11-25T06:08:59+08:00	1139	2677	3816	260	4076	9925	41.07%	11.48%	18	18
15	臺南市北門區	2018-11-24T23:31:17+08:00	1139	2677	3816	260	4076	9925	41.07%	11.48%	18	18
15	臺南市北門區	2018-11-24T23:47:34+08:00	1139	2677	3816	260	4076	9925	41.07%	11.48%	18	18
15	臺南市北門區	2018-11-24T23:05:09+08:00	1139	2677	3816	260	4076	9925	41.07%	11.48%	18	18
15	臺南市北門區	2018-11-24T23:01:36+08:00	1139	2677	3816	260	4076	9925	41.07%	11.48%	18	18
15	臺南市北門區	2018-11-25T04:02:57+08:00	1139	2677	3816	260	4076	9925	41.07%	11.48%	18	18
15	臺南市北門區	2018-11-25T00:05:10+08:00	1139	2677	3816	260	4076	9925	41.07%	11.48%	18	18
15	臺南市北門區	2018-11-25T06:19:02+08:00	1139	2677	3816	260	4076	9925	41.07%	11.48%	18	18
15	臺南市北門區	2018-11-25T06:29:22+08:00	1139	2677	3816	260	4076	9925	41.07%	11.48%	18	18
15	臺南市北門區	2018-11-25T03:49:56+08:00	1139	2677	3816	260	4076	9925	41.07%	11.48%	18	18
15	臺南市北門區	2018-11-24T22:54:30+08:00	1139	2677	3816	260	4076	9925	41.07%	11.48%	18	18
15	臺南市北門區	2018-11-24T22:50:54+08:00	1139	2677	3816	260	4076	9925	41.07%	11.48%	18	18
15	臺南市北門區	2018-11-25T06:13:57+08:00	1139	2677	3816	260	4076	9925	41.07%	11.48%	18	18
15	臺南市北門區	2018-11-24T22:37:05+08:00	1139	2677	3816	260	4076	9925	41.07%	11.48%	18	18
15	臺南市北門區	2018-11-24T23:43:22+08:00	1139	2677	3816	260	4076	9925	41.07%	11.48%	18	18
15	臺南市北門區	2018-11-25T00:09:40+08:00	1139	2677	3816	260	4076	9925	41.07%	11.48%	18	18
15	臺南市北門區	2018-11-24T22:26:41+08:00	1139	2677	3816	260	4076	9925	41.07%	11.48%	18	18
15	臺南市北門區	2018-11-25T03:44:29+08:00	1139	2677	3816	260	4076	9925	41.07%	11.48%	18	18
15	臺南市北門區	2018-11-25T03:32:42+08:00	1139	2677	3816	260	4076	9925	41.07%	11.48%	18	18
15	臺南市北門區	2018-11-24T23:08:42+08:00	1139	2677	3816	260	4076	9925	41.07%	11.48%	18	18
15	臺南市北門區	2018-11-24T22:23:19+08:00	1139	2677	3816	260	4076	9925	41.07%	11.48%	18	18
15	臺南市北門區	2018-11-24T23:23:43+08:00	1139	2677	3816	260	4076	9925	41.07%	11.48%	18	18
15	臺南市北門區	2018-11-25T00:14:15+08:00	1139	2677	3816	260	4076	9925	41.07%	11.48%	18	18
15	臺南市北門區	2018-11-24T23:35:15+08:00	1139	2677	3816	260	4076	9925	41.07%	11.48%	18	18
15	臺南市北門區	2018-11-24T22:33:43+08:00	1139	2677	3816	260	4076	9925	41.07%	11.48%	18	18
15	臺南市北門區	2018-11-25T03:39:00+08:00	1139	2677	3816	260	4076	9925	41.07%	11.48%	18	18
15	臺南市北門區	2018-11-24T23:12:21+08:00	1139	2677	3816	260	4076	9925	41.07%	11.48%	18	18
15	臺南市北門區	2018-11-24T22:16:16+08:00	1139	2677	3816	260	4076	9925	41.07%	11.48%	18	18
15	臺南市北門區	2018-11-25T01:07:31+08:00	1139	2677	3816	260	4076	9925	41.07%	11.48%	18	18
15	屏東縣牡丹鄉	2018-11-25T03:56:26+08:00	570	1137	1707	84	1791	4314	41.52%	13.21%	7	7
15	屏東縣牡丹鄉	2018-11-24T23:05:15+08:00	570	1137	1707	84	1791	4314	41.52%	13.21%	7	7
15	屏東縣牡丹鄉	2018-11-25T01:18:08+08:00	570	1137	1707	84	1791	4314	41.52%	13.21%	7	7
15	屏東縣牡丹鄉	2018-11-24T23:39:30+08:00	570	1137	1707	84	1791	4314	41.52%	13.21%	7	7
15	屏東縣牡丹鄉	2018-11-25T06:29:29+08:00	570	1137	1707	84	1791	4314	41.52%	13.21%	7	7
15	屏東縣牡丹鄉	2018-11-25T06:19:09+08:00	570	1137	1707	84	1791	4314	41.52%	13.21%	7	7
15	屏東縣牡丹鄉	2018-11-24T22:58:07+08:00	570	1137	1707	84	1791	4314	41.52%	13.21%	7	7
15	屏東縣牡丹鄉	2018-11-24T22:41:49+08:00	360	730	1090	38	1128	3008	37.5%	11.97%	6	7
15	屏東縣牡丹鄉	2018-11-24T23:43:28+08:00	570	1137	1707	84	1791	4314	41.52%	13.21%	7	7
15	屏東縣牡丹鄉	2018-11-25T06:09:07+08:00	570	1137	1707	84	1791	4314	41.52%	13.21%	7	7
15	屏東縣牡丹鄉	2018-11-24T22:30:22+08:00	315	609	924	28	952	2571	37.03%	12.25%	5	7
15	屏東縣牡丹鄉	2018-11-24T23:51:47+08:00	570	1137	1707	84	1791	4314	41.52%	13.21%	7	7
15	屏東縣牡丹鄉	2018-11-24T22:13:43+08:00	315	609	924	28	952	2571	37.03%	12.25%	5	7
15	屏東縣牡丹鄉	2018-11-24T23:08:49+08:00	570	1137	1707	84	1791	4314	41.52%	13.21%	7	7
15	屏東縣牡丹鄉	2018-11-25T00:23:15+08:00	570	1137	1707	84	1791	4314	41.52%	13.21%	7	7
15	屏東縣牡丹鄉	2018-11-25T03:44:39+08:00	570	1137	1707	84	1791	4314	41.52%	13.21%	7	7
15	屏東縣牡丹鄉	2018-11-24T23:23:49+08:00	570	1137	1707	84	1791	4314	41.52%	13.21%	7	7
15	屏東縣牡丹鄉	2018-11-24T22:33:49+08:00	315	609	924	28	952	2571	37.03%	12.25%	5	7
15	屏東縣牡丹鄉	2018-11-24T22:37:12+08:00	315	609	924	28	952	2571	37.03%	12.25%	5	7
15	屏東縣牡丹鄉	2018-11-24T23:16:14+08:00	570	1137	1707	84	1791	4314	41.52%	13.21%	7	7
15	屏東縣牡丹鄉	2018-11-24T22:16:24+08:00	315	609	924	28	952	2571	37.03%	12.25%	5	7
15	屏東縣牡丹鄉	2018-11-25T00:14:21+08:00	570	1137	1707	84	1791	4314	41.52%	13.21%	7	7
15	屏東縣牡丹鄉	2018-11-24T23:35:21+08:00	570	1137	1707	84	1791	4314	41.52%	13.21%	7	7
15	屏東縣牡丹鄉	2018-11-24T22:45:19+08:00	360	730	1090	38	1128	3008	37.5%	11.97%	6	7
15	屏東縣牡丹鄉	2018-11-24T22:54:36+08:00	570	1137	1707	84	1791	4314	41.52%	13.21%	7	7
15	屏東縣牡丹鄉	2018-11-25T00:09:48+08:00	570	1137	1707	84	1791	4314	41.52%	13.21%	7	7
15	屏東縣牡丹鄉	2018-11-24T23:01:44+08:00	570	1137	1707	84	1791	4314	41.52%	13.21%	7	7
15	屏東縣牡丹鄉	2018-11-24T22:26:47+08:00	315	609	924	28	952	2571	37.03%	12.25%	5	7
15	屏東縣牡丹鄉	2018-11-24T23:47:41+08:00	570	1137	1707	84	1791	4314	41.52%	13.21%	7	7
15	屏東縣牡丹鄉	2018-11-25T01:12:57+08:00	570	1137	1707	84	1791	4314	41.52%	13.21%	7	7
15	屏東縣牡丹鄉	2018-11-25T00:05:16+08:00	570	1137	1707	84	1791	4314	41.52%	13.21%	7	7
15	屏東縣牡丹鄉	2018-11-25T00:57:49+08:00	570	1137	1707	84	1791	4314	41.52%	13.21%	7	7
15	屏東縣牡丹鄉	2018-11-24T22:19:48+08:00	315	609	924	28	952	2571	37.03%	12.25%	5	7
15	屏東縣牡丹鄉	2018-11-25T03:32:50+08:00	570	1137	1707	84	1791	4314	41.52%	13.21%	7	7
15	屏東縣牡丹鄉	2018-11-25T04:03:04+08:00	570	1137	1707	84	1791	4314	41.52%	13.21%	7	7
15	屏東縣牡丹鄉	2018-11-24T22:40:39+08:00	360	730	1090	38	1128	3008	37.5%	11.97%	6	7
15	屏東縣牡丹鄉	2018-11-24T22:23:27+08:00	315	609	924	28	952	2571	37.03%	12.25%	5	7
15	屏東縣牡丹鄉	2018-11-24T22:51:02+08:00	570	1137	1707	84	1791	4314	41.52%	13.21%	7	7
15	屏東縣牡丹鄉	2018-11-25T06:14:04+08:00	570	1137	1707	84	1791	4314	41.52%	13.21%	7	7
15	屏東縣牡丹鄉	2018-11-24T23:55:59+08:00	570	1137	1707	84	1791	4314	41.52%	13.21%	7	7
15	屏東縣牡丹鄉	2018-11-25T06:24:12+08:00	570	1137	1707	84	1791	4314	41.52%	13.21%	7	7
15	屏東縣牡丹鄉	2018-11-24T23:27:29+08:00	570	1137	1707	84	1791	4314	41.52%	13.21%	7	7
15	屏東縣牡丹鄉	2018-11-25T00:00:22+08:00	570	1137	1707	84	1791	4314	41.52%	13.21%	7	7
15	屏東縣牡丹鄉	2018-11-25T01:02:43+08:00	570	1137	1707	84	1791	4314	41.52%	13.21%	7	7
15	屏東縣牡丹鄉	2018-11-24T23:12:29+08:00	570	1137	1707	84	1791	4314	41.52%	13.21%	7	7
15	屏東縣牡丹鄉	2018-11-24T23:31:25+08:00	570	1137	1707	84	1791	4314	41.52%	13.21%	7	7
15	屏東縣牡丹鄉	2018-11-24T23:20:04+08:00	570	1137	1707	84	1791	4314	41.52%	13.21%	7	7
15	屏東縣牡丹鄉	2018-11-25T00:18:45+08:00	570	1137	1707	84	1791	4314	41.52%	13.21%	7	7
15	屏東縣牡丹鄉	2018-11-25T01:07:38+08:00	570	1137	1707	84	1791	4314	41.52%	13.21%	7	7
15	屏東縣牡丹鄉	2018-11-25T03:39:06+08:00	570	1137	1707	84	1791	4314	41.52%	13.21%	7	7
15	屏東縣牡丹鄉	2018-11-25T01:26:06+08:00	570	1137	1707	84	1791	4314	41.52%	13.21%	7	7
15	屏東縣牡丹鄉	2018-11-25T03:50:02+08:00	570	1137	1707	84	1791	4314	41.52%	13.21%	7	7
15	臺南市麻豆區	2018-11-24T22:41:41+08:00	6621	10960	17581	1048	18629	37963	49.07%	17.44%	35	35
15	臺南市麻豆區	2018-11-24T22:45:13+08:00	6621	10960	17581	1048	18629	37963	49.07%	17.44%	35	35
15	臺南市麻豆區	2018-11-24T23:16:07+08:00	6621	10960	17581	1048	18629	37963	49.07%	17.44%	35	35
15	臺南市麻豆區	2018-11-25T03:56:18+08:00	6621	10960	17581	1048	18629	37963	49.07%	17.44%	35	35
15	臺南市麻豆區	2018-11-24T23:43:21+08:00	6621	10960	17581	1048	18629	37963	49.07%	17.44%	35	35
15	臺南市麻豆區	2018-11-25T00:18:36+08:00	6621	10960	17581	1048	18629	37963	49.07%	17.44%	35	35
15	臺南市麻豆區	2018-11-24T23:51:40+08:00	6621	10960	17581	1048	18629	37963	49.07%	17.44%	35	35
15	臺南市麻豆區	2018-11-24T22:40:32+08:00	6621	10960	17581	1048	18629	37963	49.07%	17.44%	35	35
15	臺南市麻豆區	2018-11-25T01:02:36+08:00	6621	10960	17581	1048	18629	37963	49.07%	17.44%	35	35
15	臺南市麻豆區	2018-11-24T22:30:14+08:00	6330	10493	16823	1015	17838	36366	49.05%	17.41%	34	35
15	臺南市麻豆區	2018-11-25T01:25:58+08:00	6621	10960	17581	1048	18629	37963	49.07%	17.44%	35	35
15	臺南市麻豆區	2018-11-25T00:23:09+08:00	6621	10960	17581	1048	18629	37963	49.07%	17.44%	35	35
15	臺南市麻豆區	2018-11-25T00:57:42+08:00	6621	10960	17581	1048	18629	37963	49.07%	17.44%	35	35
15	臺南市麻豆區	2018-11-25T06:24:05+08:00	6621	10960	17581	1048	18629	37963	49.07%	17.44%	35	35
15	臺南市麻豆區	2018-11-25T00:00:16+08:00	6621	10960	17581	1048	18629	37963	49.07%	17.44%	35	35
15	臺南市麻豆區	2018-11-25T01:17:59+08:00	6621	10960	17581	1048	18629	37963	49.07%	17.44%	35	35
15	臺南市麻豆區	2018-11-24T22:57:59+08:00	6621	10960	17581	1048	18629	37963	49.07%	17.44%	35	35
15	臺南市麻豆區	2018-11-24T23:19:57+08:00	6621	10960	17581	1048	18629	37963	49.07%	17.44%	35	35
15	臺南市麻豆區	2018-11-25T03:32:41+08:00	6621	10960	17581	1048	18629	37963	49.07%	17.44%	35	35
15	臺南市麻豆區	2018-11-24T23:55:52+08:00	6621	10960	17581	1048	18629	37963	49.07%	17.44%	35	35
15	臺南市麻豆區	2018-11-24T22:13:33+08:00	5351	8826	14177	896	15073	30796	48.94%	17.38%	30	35
15	臺南市麻豆區	2018-11-24T23:27:23+08:00	6621	10960	17581	1048	18629	37963	49.07%	17.44%	35	35
15	臺南市麻豆區	2018-11-24T23:39:22+08:00	6621	10960	17581	1048	18629	37963	49.07%	17.44%	35	35
15	臺南市麻豆區	2018-11-25T01:12:49+08:00	6621	10960	17581	1048	18629	37963	49.07%	17.44%	35	35
15	臺南市麻豆區	2018-11-25T06:08:59+08:00	6621	10960	17581	1048	18629	37963	49.07%	17.44%	35	35
15	臺南市麻豆區	2018-11-24T23:31:17+08:00	6621	10960	17581	1048	18629	37963	49.07%	17.44%	35	35
15	臺南市麻豆區	2018-11-24T23:47:34+08:00	6621	10960	17581	1048	18629	37963	49.07%	17.44%	35	35
15	臺南市麻豆區	2018-11-24T23:05:09+08:00	6621	10960	17581	1048	18629	37963	49.07%	17.44%	35	35
15	臺南市麻豆區	2018-11-24T23:01:36+08:00	6621	10960	17581	1048	18629	37963	49.07%	17.44%	35	35
15	臺南市麻豆區	2018-11-25T04:02:57+08:00	6621	10960	17581	1048	18629	37963	49.07%	17.44%	35	35
15	臺南市麻豆區	2018-11-25T00:05:10+08:00	6621	10960	17581	1048	18629	37963	49.07%	17.44%	35	35
15	臺南市麻豆區	2018-11-25T06:19:02+08:00	6621	10960	17581	1048	18629	37963	49.07%	17.44%	35	35
15	臺南市麻豆區	2018-11-25T06:29:22+08:00	6621	10960	17581	1048	18629	37963	49.07%	17.44%	35	35
15	臺南市麻豆區	2018-11-25T03:49:56+08:00	6621	10960	17581	1048	18629	37963	49.07%	17.44%	35	35
15	臺南市麻豆區	2018-11-24T22:54:30+08:00	6621	10960	17581	1048	18629	37963	49.07%	17.44%	35	35
15	臺南市麻豆區	2018-11-25T06:13:57+08:00	6621	10960	17581	1048	18629	37963	49.07%	17.44%	35	35
15	臺南市麻豆區	2018-11-24T22:50:53+08:00	6621	10960	17581	1048	18629	37963	49.07%	17.44%	35	35
15	臺南市麻豆區	2018-11-24T22:37:05+08:00	6621	10960	17581	1048	18629	37963	49.07%	17.44%	35	35
15	臺南市麻豆區	2018-11-25T00:09:40+08:00	6621	10960	17581	1048	18629	37963	49.07%	17.44%	35	35
15	臺南市麻豆區	2018-11-24T22:26:41+08:00	6330	10493	16823	1015	17838	36366	49.05%	17.41%	34	35
15	臺南市麻豆區	2018-11-24T22:19:41+08:00	5868	9697	15565	952	16517	33505	49.3%	17.51%	32	35
15	臺南市麻豆區	2018-11-25T03:38:59+08:00	6621	10960	17581	1048	18629	37963	49.07%	17.44%	35	35
15	臺南市麻豆區	2018-11-25T03:44:29+08:00	6621	10960	17581	1048	18629	37963	49.07%	17.44%	35	35
15	臺南市麻豆區	2018-11-24T23:08:42+08:00	6621	10960	17581	1048	18629	37963	49.07%	17.44%	35	35
15	臺南市麻豆區	2018-11-24T22:23:19+08:00	6330	10493	16823	1015	17838	36366	49.05%	17.41%	34	35
15	臺南市麻豆區	2018-11-24T23:23:43+08:00	6621	10960	17581	1048	18629	37963	49.07%	17.44%	35	35
15	臺南市麻豆區	2018-11-25T00:14:15+08:00	6621	10960	17581	1048	18629	37963	49.07%	17.44%	35	35
15	臺南市麻豆區	2018-11-24T23:35:15+08:00	6621	10960	17581	1048	18629	37963	49.07%	17.44%	35	35
15	臺南市麻豆區	2018-11-24T22:33:43+08:00	6621	10960	17581	1048	18629	37963	49.07%	17.44%	35	35
15	臺南市麻豆區	2018-11-24T23:12:21+08:00	6621	10960	17581	1048	18629	37963	49.07%	17.44%	35	35
15	臺南市麻豆區	2018-11-24T22:16:16+08:00	5603	9291	14894	927	15821	32121	49.25%	17.44%	31	35
15	臺南市麻豆區	2018-11-25T01:07:31+08:00	6621	10960	17581	1048	18629	37963	49.07%	17.44%	35	35
15	屏東縣車城鄉	2018-11-24T22:58:06+08:00	1020	1844	2864	269	3133	7595	41.25%	13.43%	13	13
15	屏東縣車城鄉	2018-11-25T03:56:26+08:00	1020	1844	2864	269	3133	7595	41.25%	13.43%	13	13
15	屏東縣車城鄉	2018-11-24T23:05:15+08:00	1020	1844	2864	269	3133	7595	41.25%	13.43%	13	13
15	屏東縣車城鄉	2018-11-24T23:39:30+08:00	1020	1844	2864	269	3133	7595	41.25%	13.43%	13	13
15	屏東縣車城鄉	2018-11-24T22:41:48+08:00	1020	1844	2864	269	3133	7595	41.25%	13.43%	13	13
15	屏東縣車城鄉	2018-11-25T06:29:29+08:00	1020	1844	2864	269	3133	7595	41.25%	13.43%	13	13
15	屏東縣車城鄉	2018-11-25T01:18:07+08:00	1020	1844	2864	269	3133	7595	41.25%	13.43%	13	13
15	屏東縣車城鄉	2018-11-25T06:19:09+08:00	1020	1844	2864	269	3133	7595	41.25%	13.43%	13	13
15	屏東縣車城鄉	2018-11-24T23:43:28+08:00	1020	1844	2864	269	3133	7595	41.25%	13.43%	13	13
15	屏東縣車城鄉	2018-11-25T06:09:07+08:00	1020	1844	2864	269	3133	7595	41.25%	13.43%	13	13
15	屏東縣車城鄉	2018-11-24T23:51:47+08:00	1020	1844	2864	269	3133	7595	41.25%	13.43%	13	13
15	屏東縣車城鄉	2018-11-24T22:13:43+08:00	1020	1844	2864	269	3133	7595	41.25%	13.43%	13	13
15	屏東縣車城鄉	2018-11-25T06:24:11+08:00	1020	1844	2864	269	3133	7595	41.25%	13.43%	13	13
15	屏東縣車城鄉	2018-11-24T23:08:49+08:00	1020	1844	2864	269	3133	7595	41.25%	13.43%	13	13
15	屏東縣車城鄉	2018-11-24T22:51:01+08:00	1020	1844	2864	269	3133	7595	41.25%	13.43%	13	13
15	屏東縣車城鄉	2018-11-25T03:44:38+08:00	1020	1844	2864	269	3133	7595	41.25%	13.43%	13	13
15	屏東縣車城鄉	2018-11-25T00:23:15+08:00	1020	1844	2864	269	3133	7595	41.25%	13.43%	13	13
15	屏東縣車城鄉	2018-11-24T23:23:49+08:00	1020	1844	2864	269	3133	7595	41.25%	13.43%	13	13
15	屏東縣車城鄉	2018-11-24T22:33:49+08:00	1020	1844	2864	269	3133	7595	41.25%	13.43%	13	13
15	屏東縣車城鄉	2018-11-24T22:37:12+08:00	1020	1844	2864	269	3133	7595	41.25%	13.43%	13	13
15	屏東縣車城鄉	2018-11-24T23:16:14+08:00	1020	1844	2864	269	3133	7595	41.25%	13.43%	13	13
15	屏東縣車城鄉	2018-11-25T01:26:05+08:00	1020	1844	2864	269	3133	7595	41.25%	13.43%	13	13
15	屏東縣車城鄉	2018-11-24T22:16:23+08:00	1020	1844	2864	269	3133	7595	41.25%	13.43%	13	13
15	屏東縣車城鄉	2018-11-25T00:14:21+08:00	1020	1844	2864	269	3133	7595	41.25%	13.43%	13	13
15	屏東縣車城鄉	2018-11-24T23:35:21+08:00	1020	1844	2864	269	3133	7595	41.25%	13.43%	13	13
15	屏東縣車城鄉	2018-11-24T22:45:19+08:00	1020	1844	2864	269	3133	7595	41.25%	13.43%	13	13
15	屏東縣車城鄉	2018-11-24T22:54:36+08:00	1020	1844	2864	269	3133	7595	41.25%	13.43%	13	13
15	屏東縣車城鄉	2018-11-25T00:09:48+08:00	1020	1844	2864	269	3133	7595	41.25%	13.43%	13	13
15	屏東縣車城鄉	2018-11-24T23:01:44+08:00	1020	1844	2864	269	3133	7595	41.25%	13.43%	13	13
15	屏東縣車城鄉	2018-11-24T22:26:47+08:00	1020	1844	2864	269	3133	7595	41.25%	13.43%	13	13
15	屏東縣車城鄉	2018-11-24T23:47:41+08:00	1020	1844	2864	269	3133	7595	41.25%	13.43%	13	13
15	屏東縣車城鄉	2018-11-25T01:12:57+08:00	1020	1844	2864	269	3133	7595	41.25%	13.43%	13	13
15	屏東縣車城鄉	2018-11-25T00:05:16+08:00	1020	1844	2864	269	3133	7595	41.25%	13.43%	13	13
15	屏東縣車城鄉	2018-11-25T00:57:49+08:00	1020	1844	2864	269	3133	7595	41.25%	13.43%	13	13
15	屏東縣車城鄉	2018-11-24T22:19:48+08:00	1020	1844	2864	269	3133	7595	41.25%	13.43%	13	13
15	屏東縣車城鄉	2018-11-24T22:30:21+08:00	1020	1844	2864	269	3133	7595	41.25%	13.43%	13	13
15	屏東縣車城鄉	2018-11-25T03:32:50+08:00	1020	1844	2864	269	3133	7595	41.25%	13.43%	13	13
15	屏東縣車城鄉	2018-11-24T22:40:38+08:00	1020	1844	2864	269	3133	7595	41.25%	13.43%	13	13
15	屏東縣車城鄉	2018-11-25T04:03:04+08:00	1020	1844	2864	269	3133	7595	41.25%	13.43%	13	13
15	屏東縣車城鄉	2018-11-25T01:02:42+08:00	1020	1844	2864	269	3133	7595	41.25%	13.43%	13	13
15	屏東縣車城鄉	2018-11-25T06:14:03+08:00	1020	1844	2864	269	3133	7595	41.25%	13.43%	13	13
15	屏東縣車城鄉	2018-11-24T23:55:59+08:00	1020	1844	2864	269	3133	7595	41.25%	13.43%	13	13
15	屏東縣車城鄉	2018-11-24T22:23:26+08:00	1020	1844	2864	269	3133	7595	41.25%	13.43%	13	13
15	屏東縣車城鄉	2018-11-24T23:27:29+08:00	1020	1844	2864	269	3133	7595	41.25%	13.43%	13	13
15	屏東縣車城鄉	2018-11-25T00:00:22+08:00	1020	1844	2864	269	3133	7595	41.25%	13.43%	13	13
15	屏東縣車城鄉	2018-11-24T23:31:25+08:00	1020	1844	2864	269	3133	7595	41.25%	13.43%	13	13
15	屏東縣車城鄉	2018-11-24T23:20:04+08:00	1020	1844	2864	269	3133	7595	41.25%	13.43%	13	13
15	屏東縣車城鄉	2018-11-25T00:18:45+08:00	1020	1844	2864	269	3133	7595	41.25%	13.43%	13	13
15	屏東縣車城鄉	2018-11-25T01:07:38+08:00	1020	1844	2864	269	3133	7595	41.25%	13.43%	13	13
15	屏東縣車城鄉	2018-11-25T03:39:06+08:00	1020	1844	2864	269	3133	7595	41.25%	13.43%	13	13
15	屏東縣車城鄉	2018-11-25T03:50:02+08:00	1020	1844	2864	269	3133	7595	41.25%	13.43%	13	13
15	屏東縣車城鄉	2018-11-24T23:12:28+08:00	1020	1844	2864	269	3133	7595	41.25%	13.43%	13	13
15	新竹市東區	2018-11-24T23:01:47+08:00	25198	44099	69297	2833	72130	126663	56.95%	19.89%	112	139
15	新竹市東區	2018-11-24T23:47:44+08:00	30864	53667	84531	3471	88002	154235	57.06%	20.01%	132	139
15	新竹市東區	2018-11-24T22:58:09+08:00	24527	42847	67374	2740	70114	122958	57.02%	19.95%	109	139
15	新竹市東區	2018-11-25T03:56:29+08:00	32753	57090	89843	3696	93539	163757	57.12%	20%	139	139
15	新竹市東區	2018-11-25T03:32:53+08:00	32753	57090	89843	3696	93539	163757	57.12%	20%	139	139
15	新竹市東區	2018-11-24T23:08:52+08:00	26404	45962	72366	2954	75320	131992	57.06%	20%	116	139
15	新竹市東區	2018-11-24T23:51:49+08:00	30864	53667	84531	3471	88002	154235	57.06%	20.01%	132	139
15	新竹市東區	2018-11-25T03:44:41+08:00	32753	57090	89843	3696	93539	163757	57.12%	20%	139	139
15	新竹市東區	2018-11-24T23:27:31+08:00	29032	50373	79405	3223	82628	144721	57.09%	20.06%	125	139
15	新竹市東區	2018-11-24T22:30:24+08:00	20165	35101	55266	2304	57570	101002	57%	19.96%	92	139
15	新竹市東區	2018-11-25T04:03:07+08:00	32753	57090	89843	3696	93539	163757	57.12%	20%	139	139
15	新竹市東區	2018-11-24T22:19:51+08:00	18064	31579	49643	2075	51718	91293	56.65%	19.79%	84	139
15	新竹市東區	2018-11-25T06:14:06+08:00	32753	57090	89843	3696	93539	163757	57.12%	20%	139	139
15	新竹市東區	2018-11-24T23:20:09+08:00	28478	48929	77407	3109	80516	141088	57.07%	20.18%	122	139
15	新竹市東區	2018-11-24T23:31:28+08:00	29631	51360	80991	3309	84300	147509	57.15%	20.09%	127	139
15	新竹市東區	2018-11-24T23:43:32+08:00	30257	52624	82881	3390	86271	151017	57.13%	20.04%	130	139
15	新竹市東區	2018-11-24T22:37:15+08:00	22040	38352	60392	2467	62859	110282	57%	19.99%	99	139
15	新竹市東區	2018-11-25T01:18:12+08:00	32753	57090	89843	3696	93539	163757	57.12%	20%	139	139
15	新竹市東區	2018-11-25T00:18:48+08:00	32029	55658	87687	3585	91272	159939	57.07%	20.03%	136	139
15	新竹市東區	2018-11-25T06:29:32+08:00	32753	57090	89843	3696	93539	163757	57.12%	20%	139	139
15	新竹市東區	2018-11-24T22:45:21+08:00	22228	38704	60932	2515	63447	111283	57.01%	19.97%	100	139
15	新竹市東區	2018-11-24T22:54:38+08:00	24269	42380	66649	2714	69363	121691	57%	19.94%	108	139
15	新竹市東區	2018-11-24T23:12:32+08:00	27176	47056	74232	3000	77232	135339	57.07%	20.08%	118	139
15	新竹市東區	2018-11-24T22:33:51+08:00	21479	37433	58912	2435	61347	107760	56.93%	19.93%	97	139
15	新竹市東區	2018-11-24T23:39:34+08:00	30257	52624	82881	3390	86271	151017	57.13%	20.04%	130	139
15	新竹市東區	2018-11-25T00:05:19+08:00	31206	54227	85433	3504	88937	155855	57.06%	20.02%	133	139
15	新竹市東區	2018-11-24T22:26:49+08:00	19060	33340	52400	2195	54595	96219	56.74%	19.81%	88	139
15	新竹市東區	2018-11-25T01:07:41+08:00	32753	57090	89843	3696	93539	163757	57.12%	20%	139	139
15	新竹市東區	2018-11-24T23:05:17+08:00	25737	44938	70675	2904	73579	129182	56.96%	19.92%	114	139
15	新竹市東區	2018-11-24T23:56:02+08:00	30864	53667	84531	3471	88002	154235	57.06%	20.01%	132	139
15	新竹市東區	2018-11-24T22:13:46+08:00	16854	29523	46377	1968	48345	85474	56.56%	19.72%	80	139
15	新竹市東區	2018-11-24T23:23:51+08:00	28843	49967	78810	3194	82004	143642	57.09%	20.08%	124	139
15	新竹市東區	2018-11-24T22:23:29+08:00	18614	32602	51216	2133	53349	94118	56.68%	19.78%	86	139
15	新竹市東區	2018-11-25T06:09:11+08:00	32753	57090	89843	3696	93539	163757	57.12%	20%	139	139
15	新竹市東區	2018-11-25T01:02:45+08:00	32753	57090	89843	3696	93539	163757	57.12%	20%	139	139
15	新竹市東區	2018-11-24T22:40:41+08:00	22228	38704	60932	2515	63447	111283	57.01%	19.97%	100	139
15	新竹市東區	2018-11-25T00:57:52+08:00	32753	57090	89843	3696	93539	163757	57.12%	20%	139	139
15	新竹市東區	2018-11-24T22:51:04+08:00	22727	39573	62300	2562	64862	113762	57.02%	19.98%	102	139
15	新竹市東區	2018-11-25T01:13:00+08:00	32753	57090	89843	3696	93539	163757	57.12%	20%	139	139
15	新竹市東區	2018-11-25T06:24:14+08:00	32753	57090	89843	3696	93539	163757	57.12%	20%	139	139
15	新竹市東區	2018-11-25T00:23:18+08:00	32029	55658	87687	3585	91272	159939	57.07%	20.03%	136	139
15	新竹市東區	2018-11-25T00:00:25+08:00	30864	53667	84531	3471	88002	154235	57.06%	20.01%	132	139
15	新竹市東區	2018-11-24T23:35:23+08:00	29849	51732	81581	3332	84913	148583	57.15%	20.09%	128	139
15	新竹市東區	2018-11-24T23:16:17+08:00	28198	48392	76590	3058	79648	139519	57.09%	20.21%	121	139
15	新竹市東區	2018-11-25T00:14:24+08:00	31771	55193	86964	3557	90521	158622	57.07%	20.03%	135	139
15	新竹市東區	2018-11-25T01:26:09+08:00	32753	57090	89843	3696	93539	163757	57.12%	20%	139	139
15	新竹市東區	2018-11-24T22:16:26+08:00	17351	30417	47768	2019	49787	88088	56.52%	19.7%	82	139
15	新竹市東區	2018-11-25T00:09:52+08:00	31507	54714	86221	3531	89752	157268	57.07%	20.03%	134	139
15	新竹市東區	2018-11-25T06:19:11+08:00	32753	57090	89843	3696	93539	163757	57.12%	20%	139	139
15	新竹市東區	2018-11-24T22:41:51+08:00	22228	38704	60932	2515	63447	111283	57.01%	19.97%	100	139
15	新竹市東區	2018-11-25T03:50:05+08:00	32753	57090	89843	3696	93539	163757	57.12%	20%	139	139
15	新竹市東區	2018-11-25T03:39:08+08:00	32753	57090	89843	3696	93539	163757	57.12%	20%	139	139
15	臺中市和平區	2018-11-25T03:49:55+08:00	1280	4348	5628	376	6004	9498	63.21%	13.48%	17	17
15	臺中市和平區	2018-11-24T22:41:41+08:00	958	3050	4008	259	4267	6811	62.65%	14.07%	14	17
15	臺中市和平區	2018-11-24T23:16:07+08:00	1280	4348	5628	376	6004	9498	63.21%	13.48%	17	17
15	臺中市和平區	2018-11-25T03:56:18+08:00	1280	4348	5628	376	6004	9498	63.21%	13.48%	17	17
15	臺中市和平區	2018-11-24T22:45:12+08:00	958	3050	4008	259	4267	6811	62.65%	14.07%	14	17
15	臺中市和平區	2018-11-24T23:43:21+08:00	1280	4348	5628	376	6004	9498	63.21%	13.48%	17	17
15	臺中市和平區	2018-11-25T00:18:36+08:00	1280	4348	5628	376	6004	9498	63.21%	13.48%	17	17
15	臺中市和平區	2018-11-24T23:51:40+08:00	1280	4348	5628	376	6004	9498	63.21%	13.48%	17	17
15	臺中市和平區	2018-11-24T22:40:32+08:00	958	3050	4008	259	4267	6811	62.65%	14.07%	14	17
15	臺中市和平區	2018-11-25T01:25:57+08:00	1280	4348	5628	376	6004	9498	63.21%	13.48%	17	17
15	臺中市和平區	2018-11-25T01:02:36+08:00	1280	4348	5628	376	6004	9498	63.21%	13.48%	17	17
15	臺中市和平區	2018-11-24T22:30:14+08:00	887	2752	3639	244	3883	6175	62.88%	14.36%	13	17
15	臺中市和平區	2018-11-25T00:23:08+08:00	1280	4348	5628	376	6004	9498	63.21%	13.48%	17	17
15	臺中市和平區	2018-11-25T00:57:42+08:00	1280	4348	5628	376	6004	9498	63.21%	13.48%	17	17
15	臺中市和平區	2018-11-25T06:24:05+08:00	1280	4348	5628	376	6004	9498	63.21%	13.48%	17	17
15	臺中市和平區	2018-11-24T23:27:22+08:00	1280	4348	5628	376	6004	9498	63.21%	13.48%	17	17
15	臺中市和平區	2018-11-24T22:57:59+08:00	958	3050	4008	259	4267	6811	62.65%	14.07%	14	17
15	臺中市和平區	2018-11-25T03:32:41+08:00	1280	4348	5628	376	6004	9498	63.21%	13.48%	17	17
15	臺中市和平區	2018-11-24T23:08:41+08:00	1162	3860	5022	322	5344	8487	62.97%	13.69%	16	17
15	臺中市和平區	2018-11-24T22:13:33+08:00	718	2353	3071	198	3269	5219	62.64%	13.76%	12	17
15	臺中市和平區	2018-11-24T23:19:56+08:00	1280	4348	5628	376	6004	9498	63.21%	13.48%	17	17
15	臺中市和平區	2018-11-25T01:17:58+08:00	1280	4348	5628	376	6004	9498	63.21%	13.48%	17	17
15	臺中市和平區	2018-11-24T23:39:22+08:00	1280	4348	5628	376	6004	9498	63.21%	13.48%	17	17
15	臺中市和平區	2018-11-25T01:12:49+08:00	1280	4348	5628	376	6004	9498	63.21%	13.48%	17	17
15	臺中市和平區	2018-11-25T06:08:59+08:00	1280	4348	5628	376	6004	9498	63.21%	13.48%	17	17
15	臺中市和平區	2018-11-24T23:31:17+08:00	1280	4348	5628	376	6004	9498	63.21%	13.48%	17	17
15	臺中市和平區	2018-11-24T23:47:33+08:00	1280	4348	5628	376	6004	9498	63.21%	13.48%	17	17
15	臺中市和平區	2018-11-24T23:05:09+08:00	1031	3393	4424	287	4711	7524	62.61%	13.7%	15	17
15	臺中市和平區	2018-11-24T23:01:36+08:00	1031	3393	4424	287	4711	7524	62.61%	13.7%	15	17
15	臺中市和平區	2018-11-25T04:02:57+08:00	1280	4348	5628	376	6004	9498	63.21%	13.48%	17	17
15	臺中市和平區	2018-11-25T00:05:10+08:00	1280	4348	5628	376	6004	9498	63.21%	13.48%	17	17
15	臺中市和平區	2018-11-25T06:19:02+08:00	1280	4348	5628	376	6004	9498	63.21%	13.48%	17	17
15	臺中市和平區	2018-11-25T06:29:22+08:00	1280	4348	5628	376	6004	9498	63.21%	13.48%	17	17
15	臺中市和平區	2018-11-24T22:54:30+08:00	958	3050	4008	259	4267	6811	62.65%	14.07%	14	17
15	臺中市和平區	2018-11-25T06:13:57+08:00	1280	4348	5628	376	6004	9498	63.21%	13.48%	17	17
15	臺中市和平區	2018-11-24T22:50:53+08:00	958	3050	4008	259	4267	6811	62.65%	14.07%	14	17
15	臺中市和平區	2018-11-24T22:37:05+08:00	958	3050	4008	259	4267	6811	62.65%	14.07%	14	17
15	臺中市和平區	2018-11-24T22:26:41+08:00	718	2353	3071	198	3269	5219	62.64%	13.76%	12	17
15	臺中市和平區	2018-11-24T22:19:41+08:00	718	2353	3071	198	3269	5219	62.64%	13.76%	12	17
15	臺中市和平區	2018-11-25T03:38:59+08:00	1280	4348	5628	376	6004	9498	63.21%	13.48%	17	17
15	臺中市和平區	2018-11-25T03:44:29+08:00	1280	4348	5628	376	6004	9498	63.21%	13.48%	17	17
15	臺中市和平區	2018-11-24T22:23:18+08:00	718	2353	3071	198	3269	5219	62.64%	13.76%	12	17
15	臺中市和平區	2018-11-25T00:00:15+08:00	1280	4348	5628	376	6004	9498	63.21%	13.48%	17	17
15	臺中市和平區	2018-11-24T23:23:43+08:00	1280	4348	5628	376	6004	9498	63.21%	13.48%	17	17
15	臺中市和平區	2018-11-24T23:55:51+08:00	1280	4348	5628	376	6004	9498	63.21%	13.48%	17	17
15	臺中市和平區	2018-11-24T23:35:15+08:00	1280	4348	5628	376	6004	9498	63.21%	13.48%	17	17
15	臺中市和平區	2018-11-24T23:12:20+08:00	1280	4348	5628	376	6004	9498	63.21%	13.48%	17	17
15	臺中市和平區	2018-11-25T00:14:14+08:00	1280	4348	5628	376	6004	9498	63.21%	13.48%	17	17
15	臺中市和平區	2018-11-24T22:16:16+08:00	718	2353	3071	198	3269	5219	62.64%	13.76%	12	17
15	臺中市和平區	2018-11-25T00:09:39+08:00	1280	4348	5628	376	6004	9498	63.21%	13.48%	17	17
15	臺中市和平區	2018-11-25T01:07:31+08:00	1280	4348	5628	376	6004	9498	63.21%	13.48%	17	17
15	臺中市和平區	2018-11-24T22:33:42+08:00	958	3050	4008	259	4267	6811	62.65%	14.07%	14	17
15	花蓮縣壽豐鄉	2018-11-24T23:56:00+08:00	2363	5703	8066	734	8800	15847	55.53%	14.91%	21	21
15	花蓮縣壽豐鄉	2018-11-24T22:58:08+08:00	1713	4347	6060	594	6654	12252	54.31%	13.98%	17	21
15	花蓮縣壽豐鄉	2018-11-24T23:43:29+08:00	2363	5703	8066	734	8800	15847	55.53%	14.91%	21	21
15	花蓮縣壽豐鄉	2018-11-25T01:18:09+08:00	2363	5703	8066	734	8800	15847	55.53%	14.91%	21	21
15	花蓮縣壽豐鄉	2018-11-25T03:56:27+08:00	2363	5703	8066	734	8800	15847	55.53%	14.91%	21	21
15	花蓮縣壽豐鄉	2018-11-24T22:41:49+08:00	1592	4071	5663	567	6230	11561	53.89%	13.77%	16	21
15	花蓮縣壽豐鄉	2018-11-24T23:39:31+08:00	2363	5703	8066	734	8800	15847	55.53%	14.91%	21	21
15	花蓮縣壽豐鄉	2018-11-24T23:47:42+08:00	2363	5703	8066	734	8800	15847	55.53%	14.91%	21	21
15	花蓮縣壽豐鄉	2018-11-24T22:30:22+08:00	1419	3642	5061	519	5580	10422	53.54%	13.62%	15	21
15	花蓮縣壽豐鄉	2018-11-24T23:27:30+08:00	2220	5331	7551	701	8252	14972	55.12%	14.83%	20	21
15	花蓮縣壽豐鄉	2018-11-24T23:51:48+08:00	2363	5703	8066	734	8800	15847	55.53%	14.91%	21	21
15	花蓮縣壽豐鄉	2018-11-25T06:09:08+08:00	2363	5703	8066	734	8800	15847	55.53%	14.91%	21	21
15	花蓮縣壽豐鄉	2018-11-24T22:13:44+08:00	1419	3642	5061	519	5580	10422	53.54%	13.62%	15	21
15	花蓮縣壽豐鄉	2018-11-25T00:57:50+08:00	2363	5703	8066	734	8800	15847	55.53%	14.91%	21	21
15	花蓮縣壽豐鄉	2018-11-25T03:44:39+08:00	2363	5703	8066	734	8800	15847	55.53%	14.91%	21	21
15	花蓮縣壽豐鄉	2018-11-24T23:31:26+08:00	2363	5703	8066	734	8800	15847	55.53%	14.91%	21	21
15	花蓮縣壽豐鄉	2018-11-24T22:37:13+08:00	1592	4071	5663	567	6230	11561	53.89%	13.77%	16	21
15	花蓮縣壽豐鄉	2018-11-24T22:16:24+08:00	1419	3642	5061	519	5580	10422	53.54%	13.62%	15	21
15	花蓮縣壽豐鄉	2018-11-24T23:20:06+08:00	2220	5331	7551	701	8252	14972	55.12%	14.83%	20	21
15	花蓮縣壽豐鄉	2018-11-25T00:18:46+08:00	2363	5703	8066	734	8800	15847	55.53%	14.91%	21	21
15	花蓮縣壽豐鄉	2018-11-24T23:16:15+08:00	2049	4959	7008	655	7663	13943	54.96%	14.7%	19	21
15	花蓮縣壽豐鄉	2018-11-25T01:12:58+08:00	2363	5703	8066	734	8800	15847	55.53%	14.91%	21	21
15	花蓮縣壽豐鄉	2018-11-25T00:05:17+08:00	2363	5703	8066	734	8800	15847	55.53%	14.91%	21	21
15	花蓮縣壽豐鄉	2018-11-24T23:05:16+08:00	1834	4634	6468	622	7090	12947	54.76%	14.17%	18	21
15	花蓮縣壽豐鄉	2018-11-24T22:54:37+08:00	1713	4347	6060	594	6654	12252	54.31%	13.98%	17	21
15	花蓮縣壽豐鄉	2018-11-24T22:33:50+08:00	1592	4071	5663	567	6230	11561	53.89%	13.77%	16	21
15	花蓮縣壽豐鄉	2018-11-24T22:45:20+08:00	1592	4071	5663	567	6230	11561	53.89%	13.77%	16	21
15	花蓮縣壽豐鄉	2018-11-24T22:26:48+08:00	1419	3642	5061	519	5580	10422	53.54%	13.62%	15	21
15	花蓮縣壽豐鄉	2018-11-24T23:01:45+08:00	1713	4347	6060	594	6654	12252	54.31%	13.98%	17	21
15	花蓮縣壽豐鄉	2018-11-25T00:09:49+08:00	2363	5703	8066	734	8800	15847	55.53%	14.91%	21	21
15	花蓮縣壽豐鄉	2018-11-25T04:03:05+08:00	2363	5703	8066	734	8800	15847	55.53%	14.91%	21	21
15	花蓮縣壽豐鄉	2018-11-24T23:23:50+08:00	2220	5331	7551	701	8252	14972	55.12%	14.83%	20	21
15	花蓮縣壽豐鄉	2018-11-24T22:19:49+08:00	1419	3642	5061	519	5580	10422	53.54%	13.62%	15	21
15	花蓮縣壽豐鄉	2018-11-24T22:40:39+08:00	1592	4071	5663	567	6230	11561	53.89%	13.77%	16	21
15	花蓮縣壽豐鄉	2018-11-25T03:32:51+08:00	2363	5703	8066	734	8800	15847	55.53%	14.91%	21	21
15	花蓮縣壽豐鄉	2018-11-24T23:08:50+08:00	2049	4959	7008	655	7663	13943	54.96%	14.7%	19	21
15	花蓮縣壽豐鄉	2018-11-24T22:23:27+08:00	1419	3642	5061	519	5580	10422	53.54%	13.62%	15	21
15	花蓮縣壽豐鄉	2018-11-24T22:51:02+08:00	1713	4347	6060	594	6654	12252	54.31%	13.98%	17	21
15	花蓮縣壽豐鄉	2018-11-25T06:14:04+08:00	2363	5703	8066	734	8800	15847	55.53%	14.91%	21	21
15	花蓮縣壽豐鄉	2018-11-25T00:00:23+08:00	2363	5703	8066	734	8800	15847	55.53%	14.91%	21	21
15	花蓮縣壽豐鄉	2018-11-25T06:24:13+08:00	2363	5703	8066	734	8800	15847	55.53%	14.91%	21	21
15	花蓮縣壽豐鄉	2018-11-25T00:23:16+08:00	2363	5703	8066	734	8800	15847	55.53%	14.91%	21	21
15	花蓮縣壽豐鄉	2018-11-25T01:02:43+08:00	2363	5703	8066	734	8800	15847	55.53%	14.91%	21	21
15	花蓮縣壽豐鄉	2018-11-25T06:19:10+08:00	2363	5703	8066	734	8800	15847	55.53%	14.91%	21	21
15	花蓮縣壽豐鄉	2018-11-25T06:29:30+08:00	2363	5703	8066	734	8800	15847	55.53%	14.91%	21	21
15	花蓮縣壽豐鄉	2018-11-24T23:12:29+08:00	2049	4959	7008	655	7663	13943	54.96%	14.7%	19	21
15	花蓮縣壽豐鄉	2018-11-25T03:50:03+08:00	2363	5703	8066	734	8800	15847	55.53%	14.91%	21	21
15	花蓮縣壽豐鄉	2018-11-25T01:07:39+08:00	2363	5703	8066	734	8800	15847	55.53%	14.91%	21	21
15	花蓮縣壽豐鄉	2018-11-25T01:26:07+08:00	2363	5703	8066	734	8800	15847	55.53%	14.91%	21	21
15	花蓮縣壽豐鄉	2018-11-25T03:39:07+08:00	2363	5703	8066	734	8800	15847	55.53%	14.91%	21	21
15	花蓮縣壽豐鄉	2018-11-25T00:14:22+08:00	2363	5703	8066	734	8800	15847	55.53%	14.91%	21	21
15	花蓮縣壽豐鄉	2018-11-24T23:35:22+08:00	2363	5703	8066	734	8800	15847	55.53%	14.91%	21	21
15	臺東縣太麻里鄉	2018-11-25T03:56:28+08:00	1147	3148	4295	480	4775	9666	49.4%	11.87%	15	15
15	臺東縣太麻里鄉	2018-11-24T23:56:00+08:00	1147	3148	4295	480	4775	9666	49.4%	11.87%	15	15
15	臺東縣太麻里鄉	2018-11-24T22:58:08+08:00	1147	3148	4295	480	4775	9666	49.4%	11.87%	15	15
15	臺東縣太麻里鄉	2018-11-24T23:47:43+08:00	1147	3148	4295	480	4775	9666	49.4%	11.87%	15	15
15	臺東縣太麻里鄉	2018-11-24T23:12:30+08:00	1147	3148	4295	480	4775	9666	49.4%	11.87%	15	15
15	臺東縣太麻里鄉	2018-11-24T23:27:30+08:00	1147	3148	4295	480	4775	9666	49.4%	11.87%	15	15
15	臺東縣太麻里鄉	2018-11-25T06:09:09+08:00	1147	3148	4295	480	4775	9666	49.4%	11.87%	15	15
15	臺東縣太麻里鄉	2018-11-24T23:51:48+08:00	1147	3148	4295	480	4775	9666	49.4%	11.87%	15	15
15	臺東縣太麻里鄉	2018-11-24T22:30:23+08:00	1147	3148	4295	480	4775	9666	49.4%	11.87%	15	15
15	臺東縣太麻里鄉	2018-11-25T03:32:52+08:00	1147	3148	4295	480	4775	9666	49.4%	11.87%	15	15
15	臺東縣太麻里鄉	2018-11-24T22:13:44+08:00	1058	2895	3953	442	4395	8929	49.22%	11.85%	14	15
15	臺東縣太麻里鄉	2018-11-25T03:44:40+08:00	1147	3148	4295	480	4775	9666	49.4%	11.87%	15	15
15	臺東縣太麻里鄉	2018-11-25T00:57:51+08:00	1147	3148	4295	480	4775	9666	49.4%	11.87%	15	15
15	臺東縣太麻里鄉	2018-11-24T22:16:25+08:00	1058	2895	3953	442	4395	8929	49.22%	11.85%	14	15
15	臺東縣太麻里鄉	2018-11-25T00:09:50+08:00	1147	3148	4295	480	4775	9666	49.4%	11.87%	15	15
15	臺東縣太麻里鄉	2018-11-25T00:18:47+08:00	1147	3148	4295	480	4775	9666	49.4%	11.87%	15	15
15	臺東縣太麻里鄉	2018-11-24T22:37:14+08:00	1147	3148	4295	480	4775	9666	49.4%	11.87%	15	15
15	臺東縣太麻里鄉	2018-11-24T23:20:08+08:00	1147	3148	4295	480	4775	9666	49.4%	11.87%	15	15
15	臺東縣太麻里鄉	2018-11-24T23:31:27+08:00	1147	3148	4295	480	4775	9666	49.4%	11.87%	15	15
15	臺東縣太麻里鄉	2018-11-24T23:16:15+08:00	1147	3148	4295	480	4775	9666	49.4%	11.87%	15	15
15	臺東縣太麻里鄉	2018-11-25T01:12:58+08:00	1147	3148	4295	480	4775	9666	49.4%	11.87%	15	15
15	臺東縣太麻里鄉	2018-11-25T00:05:17+08:00	1147	3148	4295	480	4775	9666	49.4%	11.87%	15	15
15	臺東縣太麻里鄉	2018-11-24T23:05:16+08:00	1147	3148	4295	480	4775	9666	49.4%	11.87%	15	15
15	臺東縣太麻里鄉	2018-11-24T23:39:32+08:00	1147	3148	4295	480	4775	9666	49.4%	11.87%	15	15
15	臺東縣太麻里鄉	2018-11-24T22:54:37+08:00	1147	3148	4295	480	4775	9666	49.4%	11.87%	15	15
15	臺東縣太麻里鄉	2018-11-24T22:33:50+08:00	1147	3148	4295	480	4775	9666	49.4%	11.87%	15	15
15	臺東縣太麻里鄉	2018-11-24T22:45:20+08:00	1147	3148	4295	480	4775	9666	49.4%	11.87%	15	15
15	臺東縣太麻里鄉	2018-11-24T22:26:48+08:00	1147	3148	4295	480	4775	9666	49.4%	11.87%	15	15
15	臺東縣太麻里鄉	2018-11-24T23:01:45+08:00	1147	3148	4295	480	4775	9666	49.4%	11.87%	15	15
15	臺東縣太麻里鄉	2018-11-25T04:03:05+08:00	1147	3148	4295	480	4775	9666	49.4%	11.87%	15	15
15	臺東縣太麻里鄉	2018-11-24T23:08:51+08:00	1147	3148	4295	480	4775	9666	49.4%	11.87%	15	15
15	臺東縣太麻里鄉	2018-11-24T23:23:50+08:00	1147	3148	4295	480	4775	9666	49.4%	11.87%	15	15
15	臺東縣太麻里鄉	2018-11-24T22:19:49+08:00	1147	3148	4295	480	4775	9666	49.4%	11.87%	15	15
15	臺東縣太麻里鄉	2018-11-25T00:23:17+08:00	1147	3148	4295	480	4775	9666	49.4%	11.87%	15	15
15	臺東縣太麻里鄉	2018-11-25T00:00:23+08:00	1147	3148	4295	480	4775	9666	49.4%	11.87%	15	15
15	臺東縣太麻里鄉	2018-11-24T22:51:03+08:00	1147	3148	4295	480	4775	9666	49.4%	11.87%	15	15
15	臺東縣太麻里鄉	2018-11-24T22:23:28+08:00	1147	3148	4295	480	4775	9666	49.4%	11.87%	15	15
15	臺東縣太麻里鄉	2018-11-24T22:40:40+08:00	1147	3148	4295	480	4775	9666	49.4%	11.87%	15	15
15	臺東縣太麻里鄉	2018-11-25T06:24:13+08:00	1147	3148	4295	480	4775	9666	49.4%	11.87%	15	15
15	臺東縣太麻里鄉	2018-11-25T01:02:44+08:00	1147	3148	4295	480	4775	9666	49.4%	11.87%	15	15
15	臺東縣太麻里鄉	2018-11-25T06:14:05+08:00	1147	3148	4295	480	4775	9666	49.4%	11.87%	15	15
15	臺東縣太麻里鄉	2018-11-25T06:19:10+08:00	1147	3148	4295	480	4775	9666	49.4%	11.87%	15	15
15	臺東縣太麻里鄉	2018-11-25T00:14:23+08:00	1147	3148	4295	480	4775	9666	49.4%	11.87%	15	15
15	臺東縣太麻里鄉	2018-11-25T01:18:10+08:00	1147	3148	4295	480	4775	9666	49.4%	11.87%	15	15
15	臺東縣太麻里鄉	2018-11-25T03:50:03+08:00	1147	3148	4295	480	4775	9666	49.4%	11.87%	15	15
15	臺東縣太麻里鄉	2018-11-25T01:07:39+08:00	1147	3148	4295	480	4775	9666	49.4%	11.87%	15	15
15	臺東縣太麻里鄉	2018-11-25T01:26:07+08:00	1147	3148	4295	480	4775	9666	49.4%	11.87%	15	15
15	臺東縣太麻里鄉	2018-11-25T03:39:07+08:00	1147	3148	4295	480	4775	9666	49.4%	11.87%	15	15
15	臺東縣太麻里鄉	2018-11-24T22:41:50+08:00	1147	3148	4295	480	4775	9666	49.4%	11.87%	15	15
15	臺東縣太麻里鄉	2018-11-25T06:29:31+08:00	1147	3148	4295	480	4775	9666	49.4%	11.87%	15	15
15	臺東縣太麻里鄉	2018-11-24T23:35:22+08:00	1147	3148	4295	480	4775	9666	49.4%	11.87%	15	15
15	臺東縣太麻里鄉	2018-11-24T23:43:30+08:00	1147	3148	4295	480	4775	9666	49.4%	11.87%	15	15
15	南投縣魚池鄉	2018-11-25T00:05:14+08:00	2123	4942	7065	546	7611	13958	54.53%	15.21%	25	25
15	南投縣魚池鄉	2018-11-25T06:19:06+08:00	2123	4942	7065	546	7611	13958	54.53%	15.21%	25	25
15	南投縣魚池鄉	2018-11-25T00:09:45+08:00	2123	4942	7065	546	7611	13958	54.53%	15.21%	25	25
15	南投縣魚池鄉	2018-11-24T22:50:58+08:00	2123	4942	7065	546	7611	13958	54.53%	15.21%	25	25
15	南投縣魚池鄉	2018-11-24T22:41:46+08:00	1968	4601	6569	511	7080	13036	54.31%	15.1%	24	25
15	南投縣魚池鄉	2018-11-24T22:37:09+08:00	1968	4601	6569	511	7080	13036	54.31%	15.1%	24	25
15	南投縣魚池鄉	2018-11-25T06:29:27+08:00	2123	4942	7065	546	7611	13958	54.53%	15.21%	25	25
15	南投縣魚池鄉	2018-11-24T23:05:13+08:00	2123	4942	7065	546	7611	13958	54.53%	15.21%	25	25
15	南投縣魚池鄉	2018-11-24T23:01:41+08:00	2123	4942	7065	546	7611	13958	54.53%	15.21%	25	25
15	南投縣魚池鄉	2018-11-24T22:26:45+08:00	1968	4601	6569	511	7080	13036	54.31%	15.1%	24	25
15	南投縣魚池鄉	2018-11-24T22:54:34+08:00	2123	4942	7065	546	7611	13958	54.53%	15.21%	25	25
15	南投縣魚池鄉	2018-11-25T01:12:54+08:00	2123	4942	7065	546	7611	13958	54.53%	15.21%	25	25
15	南投縣魚池鄉	2018-11-24T22:19:45+08:00	1777	4195	5972	459	6431	11938	53.87%	14.89%	23	25
15	南投縣魚池鄉	2018-11-25T04:03:01+08:00	2123	4942	7065	546	7611	13958	54.53%	15.21%	25	25
15	南投縣魚池鄉	2018-11-25T00:00:20+08:00	2123	4942	7065	546	7611	13958	54.53%	15.21%	25	25
15	南投縣魚池鄉	2018-11-25T00:23:13+08:00	2123	4942	7065	546	7611	13958	54.53%	15.21%	25	25
15	南投縣魚池鄉	2018-11-24T23:08:47+08:00	2123	4942	7065	546	7611	13958	54.53%	15.21%	25	25
15	南投縣魚池鄉	2018-11-24T22:23:24+08:00	1777	4195	5972	459	6431	11938	53.87%	14.89%	23	25
15	南投縣魚池鄉	2018-11-25T01:02:40+08:00	2123	4942	7065	546	7611	13958	54.53%	15.21%	25	25
15	南投縣魚池鄉	2018-11-25T06:14:01+08:00	2123	4942	7065	546	7611	13958	54.53%	15.21%	25	25
15	南投縣魚池鄉	2018-11-25T03:32:47+08:00	2123	4942	7065	546	7611	13958	54.53%	15.21%	25	25
15	南投縣魚池鄉	2018-11-24T23:23:47+08:00	2123	4942	7065	546	7611	13958	54.53%	15.21%	25	25
15	南投縣魚池鄉	2018-11-25T03:50:00+08:00	2123	4942	7065	546	7611	13958	54.53%	15.21%	25	25
15	南投縣魚池鄉	2018-11-24T22:33:47+08:00	1968	4601	6569	511	7080	13036	54.31%	15.1%	24	25
15	南投縣魚池鄉	2018-11-25T03:39:03+08:00	2123	4942	7065	546	7611	13958	54.53%	15.21%	25	25
15	南投縣魚池鄉	2018-11-25T01:26:02+08:00	2123	4942	7065	546	7611	13958	54.53%	15.21%	25	25
15	南投縣魚池鄉	2018-11-24T23:20:01+08:00	2123	4942	7065	546	7611	13958	54.53%	15.21%	25	25
15	南投縣魚池鄉	2018-11-25T01:07:35+08:00	2123	4942	7065	546	7611	13958	54.53%	15.21%	25	25
15	南投縣魚池鄉	2018-11-25T00:14:19+08:00	2123	4942	7065	546	7611	13958	54.53%	15.21%	25	25
15	南投縣魚池鄉	2018-11-24T23:16:12+08:00	2123	4942	7065	546	7611	13958	54.53%	15.21%	25	25
15	南投縣魚池鄉	2018-11-24T23:35:19+08:00	2123	4942	7065	546	7611	13958	54.53%	15.21%	25	25
15	南投縣魚池鄉	2018-11-24T22:45:17+08:00	1968	4601	6569	511	7080	13036	54.31%	15.1%	24	25
15	南投縣魚池鄉	2018-11-24T23:43:25+08:00	2123	4942	7065	546	7611	13958	54.53%	15.21%	25	25
15	南投縣魚池鄉	2018-11-25T03:56:23+08:00	2123	4942	7065	546	7611	13958	54.53%	15.21%	25	25
15	南投縣魚池鄉	2018-11-24T22:58:04+08:00	2123	4942	7065	546	7611	13958	54.53%	15.21%	25	25
15	南投縣魚池鄉	2018-11-25T01:18:04+08:00	2123	4942	7065	546	7611	13958	54.53%	15.21%	25	25
15	南投縣魚池鄉	2018-11-25T00:57:47+08:00	2123	4942	7065	546	7611	13958	54.53%	15.21%	25	25
15	南投縣魚池鄉	2018-11-25T06:24:09+08:00	2123	4942	7065	546	7611	13958	54.53%	15.21%	25	25
15	南投縣魚池鄉	2018-11-25T06:09:04+08:00	2123	4942	7065	546	7611	13958	54.53%	15.21%	25	25
15	南投縣魚池鄉	2018-11-24T23:51:44+08:00	2123	4942	7065	546	7611	13958	54.53%	15.21%	25	25
15	南投縣魚池鄉	2018-11-24T22:40:36+08:00	1968	4601	6569	511	7080	13036	54.31%	15.1%	24	25
15	南投縣魚池鄉	2018-11-24T22:30:19+08:00	1968	4601	6569	511	7080	13036	54.31%	15.1%	24	25
15	南投縣魚池鄉	2018-11-24T22:13:40+08:00	1777	4195	5972	459	6431	11938	53.87%	14.89%	23	25
15	南投縣魚池鄉	2018-11-25T03:44:35+08:00	2123	4942	7065	546	7611	13958	54.53%	15.21%	25	25
15	南投縣魚池鄉	2018-11-24T23:27:27+08:00	2123	4942	7065	546	7611	13958	54.53%	15.21%	25	25
15	南投縣魚池鄉	2018-11-24T23:55:56+08:00	2123	4942	7065	546	7611	13958	54.53%	15.21%	25	25
15	南投縣魚池鄉	2018-11-24T23:47:39+08:00	2123	4942	7065	546	7611	13958	54.53%	15.21%	25	25
15	南投縣魚池鄉	2018-11-24T23:31:22+08:00	2123	4942	7065	546	7611	13958	54.53%	15.21%	25	25
15	南投縣魚池鄉	2018-11-24T22:16:21+08:00	1777	4195	5972	459	6431	11938	53.87%	14.89%	23	25
15	南投縣魚池鄉	2018-11-25T00:18:42+08:00	2123	4942	7065	546	7611	13958	54.53%	15.21%	25	25
15	南投縣魚池鄉	2018-11-24T23:12:26+08:00	2123	4942	7065	546	7611	13958	54.53%	15.21%	25	25
15	南投縣魚池鄉	2018-11-24T23:39:27+08:00	2123	4942	7065	546	7611	13958	54.53%	15.21%	25	25
15	雲林縣臺西鄉	2018-11-25T00:05:14+08:00	2524	6237	8761	912	9673	21125	45.79%	11.95%	22	22
15	雲林縣臺西鄉	2018-11-25T01:12:55+08:00	2524	6237	8761	912	9673	21125	45.79%	11.95%	22	22
15	雲林縣臺西鄉	2018-11-25T06:29:27+08:00	2524	6237	8761	912	9673	21125	45.79%	11.95%	22	22
15	雲林縣臺西鄉	2018-11-24T23:05:13+08:00	2524	6237	8761	912	9673	21125	45.79%	11.95%	22	22
15	雲林縣臺西鄉	2018-11-25T06:19:07+08:00	2524	6237	8761	912	9673	21125	45.79%	11.95%	22	22
15	雲林縣臺西鄉	2018-11-24T22:26:45+08:00	2524	6237	8761	912	9673	21125	45.79%	11.95%	22	22
15	雲林縣臺西鄉	2018-11-24T22:54:34+08:00	2524	6237	8761	912	9673	21125	45.79%	11.95%	22	22
15	雲林縣臺西鄉	2018-11-24T22:41:47+08:00	2524	6237	8761	912	9673	21125	45.79%	11.95%	22	22
15	雲林縣臺西鄉	2018-11-24T23:43:26+08:00	2524	6237	8761	912	9673	21125	45.79%	11.95%	22	22
15	雲林縣臺西鄉	2018-11-24T22:50:59+08:00	2524	6237	8761	912	9673	21125	45.79%	11.95%	22	22
15	雲林縣臺西鄉	2018-11-25T00:00:20+08:00	2524	6237	8761	912	9673	21125	45.79%	11.95%	22	22
15	雲林縣臺西鄉	2018-11-25T01:02:41+08:00	2524	6237	8761	912	9673	21125	45.79%	11.95%	22	22
15	雲林縣臺西鄉	2018-11-25T00:23:14+08:00	2524	6237	8761	912	9673	21125	45.79%	11.95%	22	22
15	雲林縣臺西鄉	2018-11-25T03:32:48+08:00	2524	6237	8761	912	9673	21125	45.79%	11.95%	22	22
15	雲林縣臺西鄉	2018-11-25T03:44:36+08:00	2524	6237	8761	912	9673	21125	45.79%	11.95%	22	22
15	雲林縣臺西鄉	2018-11-24T23:08:47+08:00	2524	6237	8761	912	9673	21125	45.79%	11.95%	22	22
15	雲林縣臺西鄉	2018-11-25T06:24:10+08:00	2524	6237	8761	912	9673	21125	45.79%	11.95%	22	22
15	雲林縣臺西鄉	2018-11-24T22:23:25+08:00	2524	6237	8761	912	9673	21125	45.79%	11.95%	22	22
15	雲林縣臺西鄉	2018-11-24T23:23:47+08:00	2524	6237	8761	912	9673	21125	45.79%	11.95%	22	22
15	雲林縣臺西鄉	2018-11-25T03:50:00+08:00	2524	6237	8761	912	9673	21125	45.79%	11.95%	22	22
15	雲林縣臺西鄉	2018-11-24T22:33:47+08:00	2524	6237	8761	912	9673	21125	45.79%	11.95%	22	22
15	雲林縣臺西鄉	2018-11-25T01:26:03+08:00	2524	6237	8761	912	9673	21125	45.79%	11.95%	22	22
15	雲林縣臺西鄉	2018-11-25T03:39:04+08:00	2524	6237	8761	912	9673	21125	45.79%	11.95%	22	22
15	雲林縣臺西鄉	2018-11-25T00:14:20+08:00	2524	6237	8761	912	9673	21125	45.79%	11.95%	22	22
15	雲林縣臺西鄉	2018-11-24T23:16:12+08:00	2524	6237	8761	912	9673	21125	45.79%	11.95%	22	22
15	雲林縣臺西鄉	2018-11-24T23:35:19+08:00	2524	6237	8761	912	9673	21125	45.79%	11.95%	22	22
15	雲林縣臺西鄉	2018-11-24T22:45:17+08:00	2524	6237	8761	912	9673	21125	45.79%	11.95%	22	22
15	雲林縣臺西鄉	2018-11-25T01:18:05+08:00	2524	6237	8761	912	9673	21125	45.79%	11.95%	22	22
15	雲林縣臺西鄉	2018-11-24T22:58:05+08:00	2524	6237	8761	912	9673	21125	45.79%	11.95%	22	22
15	雲林縣臺西鄉	2018-11-25T00:09:46+08:00	2524	6237	8761	912	9673	21125	45.79%	11.95%	22	22
15	雲林縣臺西鄉	2018-11-25T03:56:24+08:00	2524	6237	8761	912	9673	21125	45.79%	11.95%	22	22
15	雲林縣臺西鄉	2018-11-24T23:01:42+08:00	2524	6237	8761	912	9673	21125	45.79%	11.95%	22	22
15	雲林縣臺西鄉	2018-11-25T00:57:47+08:00	2524	6237	8761	912	9673	21125	45.79%	11.95%	22	22
15	雲林縣臺西鄉	2018-11-24T22:19:46+08:00	2524	6237	8761	912	9673	21125	45.79%	11.95%	22	22
15	雲林縣臺西鄉	2018-11-24T22:13:41+08:00	2524	6237	8761	912	9673	21125	45.79%	11.95%	22	22
15	雲林縣臺西鄉	2018-11-25T04:03:02+08:00	2524	6237	8761	912	9673	21125	45.79%	11.95%	22	22
15	雲林縣臺西鄉	2018-11-24T22:40:37+08:00	2524	6237	8761	912	9673	21125	45.79%	11.95%	22	22
15	雲林縣臺西鄉	2018-11-24T23:51:45+08:00	2524	6237	8761	912	9673	21125	45.79%	11.95%	22	22
15	雲林縣臺西鄉	2018-11-24T22:30:20+08:00	2524	6237	8761	912	9673	21125	45.79%	11.95%	22	22
15	雲林縣臺西鄉	2018-11-25T06:09:05+08:00	2524	6237	8761	912	9673	21125	45.79%	11.95%	22	22
15	雲林縣臺西鄉	2018-11-24T23:55:57+08:00	2524	6237	8761	912	9673	21125	45.79%	11.95%	22	22
15	雲林縣臺西鄉	2018-11-24T23:27:27+08:00	2524	6237	8761	912	9673	21125	45.79%	11.95%	22	22
15	雲林縣臺西鄉	2018-11-25T06:14:02+08:00	2524	6237	8761	912	9673	21125	45.79%	11.95%	22	22
15	雲林縣臺西鄉	2018-11-24T23:47:39+08:00	2524	6237	8761	912	9673	21125	45.79%	11.95%	22	22
15	雲林縣臺西鄉	2018-11-25T00:18:43+08:00	2524	6237	8761	912	9673	21125	45.79%	11.95%	22	22
15	雲林縣臺西鄉	2018-11-24T22:16:21+08:00	2524	6237	8761	912	9673	21125	45.79%	11.95%	22	22
15	雲林縣臺西鄉	2018-11-24T23:12:27+08:00	2524	6237	8761	912	9673	21125	45.79%	11.95%	22	22
15	雲林縣臺西鄉	2018-11-24T23:39:28+08:00	2524	6237	8761	912	9673	21125	45.79%	11.95%	22	22
15	雲林縣臺西鄉	2018-11-24T22:37:10+08:00	2524	6237	8761	912	9673	21125	45.79%	11.95%	22	22
15	雲林縣臺西鄉	2018-11-24T23:31:23+08:00	2524	6237	8761	912	9673	21125	45.79%	11.95%	22	22
15	雲林縣臺西鄉	2018-11-24T23:20:02+08:00	2524	6237	8761	912	9673	21125	45.79%	11.95%	22	22
15	雲林縣臺西鄉	2018-11-25T01:07:36+08:00	2524	6237	8761	912	9673	21125	45.79%	11.95%	22	22
15	雲林縣北港鎮	2018-11-25T00:05:14+08:00	5486	11404	16890	1664	18554	33958	54.64%	16.16%	41	41
15	雲林縣北港鎮	2018-11-25T06:19:06+08:00	5486	11404	16890	1664	18554	33958	54.64%	16.16%	41	41
15	雲林縣北港鎮	2018-11-25T00:09:45+08:00	5486	11404	16890	1664	18554	33958	54.64%	16.16%	41	41
15	雲林縣北港鎮	2018-11-25T01:12:55+08:00	5486	11404	16890	1664	18554	33958	54.64%	16.16%	41	41
15	雲林縣北港鎮	2018-11-24T22:41:46+08:00	4441	9245	13686	1426	15112	27849	54.26%	15.95%	36	41
15	雲林縣北港鎮	2018-11-25T06:29:27+08:00	5486	11404	16890	1664	18554	33958	54.64%	16.16%	41	41
15	雲林縣北港鎮	2018-11-24T23:05:13+08:00	4820	10032	14852	1519	16371	30032	54.51%	16.05%	38	41
15	雲林縣北港鎮	2018-11-24T22:26:45+08:00	3354	7038	10392	1038	11430	20850	54.82%	16.09%	29	41
15	雲林縣北港鎮	2018-11-24T22:54:34+08:00	4820	10032	14852	1519	16371	30032	54.51%	16.05%	38	41
15	雲林縣北港鎮	2018-11-24T23:43:26+08:00	5486	11404	16890	1664	18554	33958	54.64%	16.16%	41	41
15	雲林縣北港鎮	2018-11-24T22:50:59+08:00	4820	10032	14852	1519	16371	30032	54.51%	16.05%	38	41
15	雲林縣北港鎮	2018-11-25T00:00:20+08:00	5486	11404	16890	1664	18554	33958	54.64%	16.16%	41	41
15	雲林縣北港鎮	2018-11-25T00:23:13+08:00	5486	11404	16890	1664	18554	33958	54.64%	16.16%	41	41
15	雲林縣北港鎮	2018-11-25T03:44:36+08:00	5486	11404	16890	1664	18554	33958	54.64%	16.16%	41	41
15	雲林縣北港鎮	2018-11-24T23:08:47+08:00	4820	10032	14852	1519	16371	30032	54.51%	16.05%	38	41
15	雲林縣北港鎮	2018-11-24T22:23:24+08:00	3354	7038	10392	1038	11430	20850	54.82%	16.09%	29	41
15	雲林縣北港鎮	2018-11-25T06:24:10+08:00	5486	11404	16890	1664	18554	33958	54.64%	16.16%	41	41
15	雲林縣北港鎮	2018-11-25T01:02:40+08:00	5486	11404	16890	1664	18554	33958	54.64%	16.16%	41	41
15	雲林縣北港鎮	2018-11-25T06:14:01+08:00	5486	11404	16890	1664	18554	33958	54.64%	16.16%	41	41
15	雲林縣北港鎮	2018-11-25T03:32:47+08:00	5486	11404	16890	1664	18554	33958	54.64%	16.16%	41	41
15	雲林縣北港鎮	2018-11-24T23:23:47+08:00	4985	10431	15416	1550	16966	31181	54.41%	15.99%	39	41
15	雲林縣北港鎮	2018-11-25T03:50:00+08:00	5486	11404	16890	1664	18554	33958	54.64%	16.16%	41	41
15	雲林縣北港鎮	2018-11-24T22:33:47+08:00	3942	8154	12096	1243	13339	24451	54.55%	16.12%	33	41
15	雲林縣北港鎮	2018-11-25T01:26:03+08:00	5486	11404	16890	1664	18554	33958	54.64%	16.16%	41	41
15	雲林縣北港鎮	2018-11-25T03:39:04+08:00	5486	11404	16890	1664	18554	33958	54.64%	16.16%	41	41
15	雲林縣北港鎮	2018-11-25T00:14:19+08:00	5486	11404	16890	1664	18554	33958	54.64%	16.16%	41	41
15	雲林縣北港鎮	2018-11-24T23:16:12+08:00	4820	10032	14852	1519	16371	30032	54.51%	16.05%	38	41
15	雲林縣北港鎮	2018-11-24T23:35:19+08:00	5486	11404	16890	1664	18554	33958	54.64%	16.16%	41	41
15	雲林縣北港鎮	2018-11-24T22:45:17+08:00	4636	9655	14291	1489	15780	29000	54.41%	15.99%	37	41
15	雲林縣北港鎮	2018-11-25T01:18:05+08:00	5486	11404	16890	1664	18554	33958	54.64%	16.16%	41	41
15	雲林縣北港鎮	2018-11-25T03:56:24+08:00	5486	11404	16890	1664	18554	33958	54.64%	16.16%	41	41
15	雲林縣北港鎮	2018-11-24T22:58:04+08:00	4820	10032	14852	1519	16371	30032	54.51%	16.05%	38	41
15	雲林縣北港鎮	2018-11-24T23:01:42+08:00	4820	10032	14852	1519	16371	30032	54.51%	16.05%	38	41
15	雲林縣北港鎮	2018-11-25T00:57:47+08:00	5486	11404	16890	1664	18554	33958	54.64%	16.16%	41	41
15	雲林縣北港鎮	2018-11-24T22:19:46+08:00	3354	7038	10392	1038	11430	20850	54.82%	16.09%	29	41
15	雲林縣北港鎮	2018-11-25T04:03:02+08:00	5486	11404	16890	1664	18554	33958	54.64%	16.16%	41	41
15	雲林縣北港鎮	2018-11-24T22:30:19+08:00	3354	7038	10392	1038	11430	20850	54.82%	16.09%	29	41
15	雲林縣北港鎮	2018-11-24T22:13:40+08:00	3099	6540	9639	934	10573	19438	54.39%	15.94%	27	41
15	雲林縣北港鎮	2018-11-24T22:40:37+08:00	4441	9245	13686	1426	15112	27849	54.26%	15.95%	36	41
15	雲林縣北港鎮	2018-11-24T23:51:45+08:00	5486	11404	16890	1664	18554	33958	54.64%	16.16%	41	41
15	雲林縣北港鎮	2018-11-25T06:09:05+08:00	5486	11404	16890	1664	18554	33958	54.64%	16.16%	41	41
15	雲林縣北港鎮	2018-11-24T23:55:57+08:00	5486	11404	16890	1664	18554	33958	54.64%	16.16%	41	41
15	雲林縣北港鎮	2018-11-24T23:27:27+08:00	5486	11404	16890	1664	18554	33958	54.64%	16.16%	41	41
15	雲林縣北港鎮	2018-11-24T23:47:39+08:00	5486	11404	16890	1664	18554	33958	54.64%	16.16%	41	41
15	雲林縣北港鎮	2018-11-24T23:31:22+08:00	5486	11404	16890	1664	18554	33958	54.64%	16.16%	41	41
15	雲林縣北港鎮	2018-11-24T22:16:21+08:00	3248	6772	10020	982	11002	20126	54.67%	16.14%	28	41
15	雲林縣北港鎮	2018-11-24T23:39:28+08:00	5486	11404	16890	1664	18554	33958	54.64%	16.16%	41	41
15	雲林縣北港鎮	2018-11-25T00:18:42+08:00	5486	11404	16890	1664	18554	33958	54.64%	16.16%	41	41
15	雲林縣北港鎮	2018-11-24T22:37:10+08:00	4113	8525	12638	1290	13928	25581	54.45%	16.08%	34	41
15	雲林縣北港鎮	2018-11-24T23:12:26+08:00	4820	10032	14852	1519	16371	30032	54.51%	16.05%	38	41
15	雲林縣北港鎮	2018-11-24T23:20:02+08:00	4985	10431	15416	1550	16966	31181	54.41%	15.99%	39	41
15	雲林縣北港鎮	2018-11-25T01:07:36+08:00	5486	11404	16890	1664	18554	33958	54.64%	16.16%	41	41
15	新竹縣峨眉鄉	2018-11-24T22:26:43+08:00	555	1449	2004	198	2202	3662	60.13%	15.16%	7	8
15	新竹縣峨眉鄉	2018-11-25T03:56:21+08:00	742	2039	2781	279	3060	5068	60.38%	14.64%	8	8
15	新竹縣峨眉鄉	2018-11-25T01:12:52+08:00	742	2039	2781	279	3060	5068	60.38%	14.64%	8	8
15	新竹縣峨眉鄉	2018-11-24T22:54:32+08:00	555	1449	2004	198	2202	3662	60.13%	15.16%	7	8
15	新竹縣峨眉鄉	2018-11-24T22:50:56+08:00	555	1449	2004	198	2202	3662	60.13%	15.16%	7	8
15	新竹縣峨眉鄉	2018-11-25T00:09:43+08:00	555	1449	2004	198	2202	3662	60.13%	15.16%	7	8
15	新竹縣峨眉鄉	2018-11-25T00:05:12+08:00	555	1449	2004	198	2202	3662	60.13%	15.16%	7	8
15	新竹縣峨眉鄉	2018-11-24T22:37:08+08:00	555	1449	2004	198	2202	3662	60.13%	15.16%	7	8
15	新竹縣峨眉鄉	2018-11-24T22:45:15+08:00	555	1449	2004	198	2202	3662	60.13%	15.16%	7	8
15	新竹縣峨眉鄉	2018-11-25T01:02:38+08:00	742	2039	2781	279	3060	5068	60.38%	14.64%	8	8
15	新竹縣峨眉鄉	2018-11-24T22:40:34+08:00	555	1449	2004	198	2202	3662	60.13%	15.16%	7	8
15	新竹縣峨眉鄉	2018-11-25T04:03:00+08:00	742	2039	2781	279	3060	5068	60.38%	14.64%	8	8
15	新竹縣峨眉鄉	2018-11-25T00:57:45+08:00	742	2039	2781	279	3060	5068	60.38%	14.64%	8	8
15	新竹縣峨眉鄉	2018-11-24T22:19:44+08:00	555	1449	2004	198	2202	3662	60.13%	15.16%	7	8
15	新竹縣峨眉鄉	2018-11-25T06:14:00+08:00	742	2039	2781	279	3060	5068	60.38%	14.64%	8	8
15	新竹縣峨眉鄉	2018-11-25T00:00:18+08:00	555	1449	2004	198	2202	3662	60.13%	15.16%	7	8
15	新竹縣峨眉鄉	2018-11-24T23:55:54+08:00	555	1449	2004	198	2202	3662	60.13%	15.16%	7	8
15	新竹縣峨眉鄉	2018-11-24T23:27:25+08:00	555	1449	2004	198	2202	3662	60.13%	15.16%	7	8
15	新竹縣峨眉鄉	2018-11-24T22:23:22+08:00	555	1449	2004	198	2202	3662	60.13%	15.16%	7	8
15	新竹縣峨眉鄉	2018-11-24T23:01:39+08:00	555	1449	2004	198	2202	3662	60.13%	15.16%	7	8
15	新竹縣峨眉鄉	2018-11-24T23:39:25+08:00	555	1449	2004	198	2202	3662	60.13%	15.16%	7	8
15	新竹縣峨眉鄉	2018-11-24T23:20:00+08:00	555	1449	2004	198	2202	3662	60.13%	15.16%	7	8
15	新竹縣峨眉鄉	2018-11-25T01:07:34+08:00	742	2039	2781	279	3060	5068	60.38%	14.64%	8	8
15	新竹縣峨眉鄉	2018-11-24T23:12:24+08:00	555	1449	2004	198	2202	3662	60.13%	15.16%	7	8
15	新竹縣峨眉鄉	2018-11-25T00:18:40+08:00	555	1449	2004	198	2202	3662	60.13%	15.16%	7	8
15	新竹縣峨眉鄉	2018-11-25T03:39:02+08:00	742	2039	2781	279	3060	5068	60.38%	14.64%	8	8
15	新竹縣峨眉鄉	2018-11-24T23:31:20+08:00	555	1449	2004	198	2202	3662	60.13%	15.16%	7	8
15	新竹縣峨眉鄉	2018-11-24T23:35:17+08:00	555	1449	2004	198	2202	3662	60.13%	15.16%	7	8
15	新竹縣峨眉鄉	2018-11-25T00:14:17+08:00	555	1449	2004	198	2202	3662	60.13%	15.16%	7	8
15	新竹縣峨眉鄉	2018-11-24T23:43:24+08:00	555	1449	2004	198	2202	3662	60.13%	15.16%	7	8
15	新竹縣峨眉鄉	2018-11-24T22:58:02+08:00	555	1449	2004	198	2202	3662	60.13%	15.16%	7	8
15	新竹縣峨眉鄉	2018-11-25T03:49:58+08:00	742	2039	2781	279	3060	5068	60.38%	14.64%	8	8
15	新竹縣峨眉鄉	2018-11-25T01:18:02+08:00	742	2039	2781	279	3060	5068	60.38%	14.64%	8	8
15	新竹縣峨眉鄉	2018-11-25T06:29:25+08:00	742	2039	2781	279	3060	5068	60.38%	14.64%	8	8
15	新竹縣峨眉鄉	2018-11-25T06:19:05+08:00	742	2039	2781	279	3060	5068	60.38%	14.64%	8	8
15	新竹縣峨眉鄉	2018-11-24T23:05:11+08:00	555	1449	2004	198	2202	3662	60.13%	15.16%	7	8
15	新竹縣峨眉鄉	2018-11-24T22:41:44+08:00	555	1449	2004	198	2202	3662	60.13%	15.16%	7	8
15	新竹縣峨眉鄉	2018-11-24T23:51:43+08:00	555	1449	2004	198	2202	3662	60.13%	15.16%	7	8
15	新竹縣峨眉鄉	2018-11-24T22:30:17+08:00	555	1449	2004	198	2202	3662	60.13%	15.16%	7	8
15	新竹縣峨眉鄉	2018-11-25T06:24:08+08:00	742	2039	2781	279	3060	5068	60.38%	14.64%	8	8
15	新竹縣峨眉鄉	2018-11-25T06:09:02+08:00	742	2039	2781	279	3060	5068	60.38%	14.64%	8	8
15	新竹縣峨眉鄉	2018-11-24T23:23:45+08:00	555	1449	2004	198	2202	3662	60.13%	15.16%	7	8
15	新竹縣峨眉鄉	2018-11-25T03:44:32+08:00	742	2039	2781	279	3060	5068	60.38%	14.64%	8	8
15	新竹縣峨眉鄉	2018-11-25T03:32:45+08:00	742	2039	2781	279	3060	5068	60.38%	14.64%	8	8
15	新竹縣峨眉鄉	2018-11-24T22:13:38+08:00	430	1185	1615	156	1771	2979	59.45%	14.43%	6	8
15	新竹縣峨眉鄉	2018-11-24T23:08:45+08:00	555	1449	2004	198	2202	3662	60.13%	15.16%	7	8
15	新竹縣峨眉鄉	2018-11-25T00:23:11+08:00	555	1449	2004	198	2202	3662	60.13%	15.16%	7	8
15	新竹縣峨眉鄉	2018-11-24T23:16:10+08:00	555	1449	2004	198	2202	3662	60.13%	15.16%	7	8
15	新竹縣峨眉鄉	2018-11-24T23:47:37+08:00	555	1449	2004	198	2202	3662	60.13%	15.16%	7	8
15	新竹縣峨眉鄉	2018-11-24T22:16:19+08:00	430	1185	1615	156	1771	2979	59.45%	14.43%	6	8
15	新竹縣峨眉鄉	2018-11-25T01:26:01+08:00	742	2039	2781	279	3060	5068	60.38%	14.64%	8	8
15	新竹縣峨眉鄉	2018-11-24T22:33:45+08:00	555	1449	2004	198	2202	3662	60.13%	15.16%	7	8
15	新竹縣竹北市	2018-11-24T22:26:43+08:00	4237	7491	11728	514	12242	21725	56.35%	19.5%	17	103
15	新竹縣竹北市	2018-11-25T00:09:42+08:00	18973	33212	52185	2042	54227	93805	57.81%	20.23%	72	103
15	新竹縣竹北市	2018-11-25T03:56:21+08:00	27936	49115	77051	2874	79925	137129	58.28%	20.37%	103	103
15	新竹縣竹北市	2018-11-25T01:12:52+08:00	27262	47911	75173	2820	77993	133850	58.27%	20.37%	101	103
15	新竹縣竹北市	2018-11-24T22:37:07+08:00	5422	9775	15197	658	15855	28048	56.53%	19.33%	22	103
15	新竹縣竹北市	2018-11-24T22:54:32+08:00	7895	13893	21788	926	22714	39812	57.05%	19.83%	31	103
15	新竹縣竹北市	2018-11-24T22:50:56+08:00	6793	12234	19027	813	19840	34711	57.16%	19.57%	27	103
15	新竹縣竹北市	2018-11-25T00:05:12+08:00	18032	31139	49171	1917	51088	88439	57.77%	20.39%	68	103
15	新竹縣竹北市	2018-11-24T22:45:15+08:00	5889	10687	16576	722	17298	30449	56.81%	19.34%	24	103
15	新竹縣竹北市	2018-11-25T01:02:38+08:00	26727	46930	73657	2772	76429	131132	58.28%	20.38%	99	103
15	新竹縣竹北市	2018-11-25T00:57:44+08:00	26727	46930	73657	2772	76429	131132	58.28%	20.38%	99	103
15	新竹縣竹北市	2018-11-24T22:40:34+08:00	5676	10246	15922	675	16597	29244	56.75%	19.41%	23	103
15	新竹縣竹北市	2018-11-24T22:19:44+08:00	3353	6044	9397	456	9853	17132	57.51%	19.57%	14	103
15	新竹縣竹北市	2018-11-25T00:00:18+08:00	17097	29556	46653	1850	48503	84034	57.72%	20.35%	65	103
15	新竹縣竹北市	2018-11-24T23:55:54+08:00	16378	28094	44472	1733	46205	79837	57.87%	20.51%	62	103
15	新竹縣竹北市	2018-11-24T23:27:25+08:00	13244	22502	35746	1465	37211	64400	57.78%	20.57%	50	103
15	新竹縣竹北市	2018-11-24T23:19:59+08:00	12756	21593	34349	1431	35780	61961	57.75%	20.59%	48	103
15	新竹縣竹北市	2018-11-25T01:07:33+08:00	27012	47376	74388	2797	77185	132344	58.32%	20.41%	100	103
15	新竹縣竹北市	2018-11-24T23:39:25+08:00	14922	25695	40617	1646	42263	73247	57.7%	20.37%	57	103
15	新竹縣竹北市	2018-11-24T23:12:24+08:00	11145	19089	30234	1257	31491	54646	57.63%	20.39%	42	103
15	新竹縣竹北市	2018-11-25T00:18:40+08:00	20153	35146	55299	2187	57486	99538	57.75%	20.25%	76	103
15	新竹縣竹北市	2018-11-24T23:01:38+08:00	9785	16592	26377	1090	27467	47707	57.57%	20.51%	37	103
15	新竹縣竹北市	2018-11-24T23:31:20+08:00	14197	24315	38512	1530	40042	69461	57.65%	20.44%	54	103
15	新竹縣竹北市	2018-11-24T23:35:17+08:00	14352	24693	39045	1597	40642	70438	57.7%	20.38%	55	103
15	新竹縣竹北市	2018-11-25T04:02:59+08:00	27936	49115	77051	2874	79925	137129	58.28%	20.37%	103	103
15	新竹縣竹北市	2018-11-25T00:14:17+08:00	19161	33595	52756	2074	54830	94863	57.8%	20.2%	73	103
15	新竹縣竹北市	2018-11-24T23:43:24+08:00	15320	26221	41541	1665	43206	74998	57.61%	20.43%	58	103
15	新竹縣竹北市	2018-11-24T22:58:02+08:00	8414	14230	22644	964	23608	41307	57.15%	20.37%	32	103
15	新竹縣竹北市	2018-11-25T03:49:58+08:00	27936	49115	77051	2874	79925	137129	58.28%	20.37%	103	103
15	新竹縣竹北市	2018-11-25T01:18:02+08:00	27595	48490	76085	2838	78923	135495	58.25%	20.37%	102	103
15	新竹縣竹北市	2018-11-25T06:29:25+08:00	27936	49115	77051	2874	79925	137129	58.28%	20.37%	103	103
15	新竹縣竹北市	2018-11-24T23:05:11+08:00	10347	17581	27928	1148	29076	50606	57.46%	20.45%	39	103
15	新竹縣竹北市	2018-11-25T06:13:59+08:00	27936	49115	77051	2874	79925	137129	58.28%	20.37%	103	103
15	新竹縣竹北市	2018-11-24T22:41:44+08:00	5676	10246	15922	675	16597	29244	56.75%	19.41%	23	103
15	新竹縣竹北市	2018-11-25T06:19:04+08:00	27936	49115	77051	2874	79925	137129	58.28%	20.37%	103	103
15	新竹縣竹北市	2018-11-25T06:24:07+08:00	27936	49115	77051	2874	79925	137129	58.28%	20.37%	103	103
15	新竹縣竹北市	2018-11-24T22:30:17+08:00	4716	8291	13007	577	13584	23986	56.63%	19.66%	19	103
15	新竹縣竹北市	2018-11-24T23:51:42+08:00	16111	27656	43767	1715	45482	78656	57.82%	20.48%	61	103
15	新竹縣竹北市	2018-11-25T06:09:02+08:00	27936	49115	77051	2874	79925	137129	58.28%	20.37%	103	103
15	新竹縣竹北市	2018-11-24T23:23:45+08:00	12756	21593	34349	1431	35780	61961	57.75%	20.59%	48	103
15	新竹縣竹北市	2018-11-25T03:44:32+08:00	27936	49115	77051	2874	79925	137129	58.28%	20.37%	103	103
15	新竹縣竹北市	2018-11-24T23:08:44+08:00	10877	18513	29390	1222	30612	53124	57.62%	20.47%	41	103
15	新竹縣竹北市	2018-11-24T22:23:21+08:00	3980	7047	11027	492	11519	20379	56.52%	19.53%	16	103
15	新竹縣竹北市	2018-11-25T03:32:44+08:00	27936	49115	77051	2874	79925	137129	58.28%	20.37%	103	103
15	新竹縣竹北市	2018-11-24T22:13:37+08:00	1933	3729	5662	288	5950	10409	57.16%	18.57%	9	103
15	新竹縣竹北市	2018-11-25T00:23:11+08:00	20445	35690	56135	2215	58350	100867	57.85%	20.27%	77	103
15	新竹縣竹北市	2018-11-24T23:16:10+08:00	12481	21023	33504	1380	34884	60495	57.66%	20.63%	47	103
15	新竹縣竹北市	2018-11-24T22:16:19+08:00	2494	4623	7117	337	7454	13143	56.71%	18.98%	11	103
15	新竹縣竹北市	2018-11-25T01:26:00+08:00	27595	48490	76085	2838	78923	135495	58.25%	20.37%	102	103
15	新竹縣竹北市	2018-11-24T23:47:36+08:00	15320	26221	41541	1665	43206	74998	57.61%	20.43%	58	103
15	新竹縣竹北市	2018-11-25T03:39:01+08:00	27936	49115	77051	2874	79925	137129	58.28%	20.37%	103	103
15	新竹縣竹北市	2018-11-24T22:33:45+08:00	5422	9775	15197	658	15855	28048	56.53%	19.33%	22	103
15	基隆市七堵區	2018-11-24T23:12:31+08:00	6528	12128	18656	1152	19808	37466	52.87%	17.42%	33	39
15	基隆市七堵區	2018-11-24T23:47:44+08:00	6937	12966	19903	1214	21117	39977	52.82%	17.35%	35	39
15	基隆市七堵區	2018-11-24T22:58:09+08:00	6033	11058	17091	1070	18161	34446	52.72%	17.51%	31	39
15	基隆市七堵區	2018-11-25T03:56:29+08:00	8017	15107	23124	1356	24480	46256	52.92%	17.33%	39	39
15	基隆市七堵區	2018-11-24T23:01:46+08:00	6033	11058	17091	1070	18161	34446	52.72%	17.51%	31	39
15	基隆市七堵區	2018-11-25T03:32:53+08:00	8017	15107	23124	1356	24480	46256	52.92%	17.33%	39	39
15	基隆市七堵區	2018-11-24T23:08:52+08:00	6258	11479	17737	1099	18836	35731	52.72%	17.51%	32	39
15	基隆市七堵區	2018-11-24T23:51:49+08:00	6937	12966	19903	1214	21117	39977	52.82%	17.35%	35	39
15	基隆市七堵區	2018-11-24T22:13:45+08:00	3857	7097	10954	709	11663	22182	52.58%	17.39%	22	39
15	基隆市七堵區	2018-11-25T03:44:41+08:00	8017	15107	23124	1356	24480	46256	52.92%	17.33%	39	39
15	基隆市七堵區	2018-11-25T04:03:06+08:00	8017	15107	23124	1356	24480	46256	52.92%	17.33%	39	39
15	基隆市七堵區	2018-11-24T23:27:31+08:00	6740	12595	19335	1184	20519	38784	52.91%	17.38%	34	39
15	基隆市七堵區	2018-11-24T22:30:24+08:00	4176	7830	12006	796	12802	24273	52.74%	17.2%	24	39
15	基隆市七堵區	2018-11-24T22:19:50+08:00	3857	7097	10954	709	11663	22182	52.58%	17.39%	22	39
15	基隆市七堵區	2018-11-25T06:14:06+08:00	8017	15107	23124	1356	24480	46256	52.92%	17.33%	39	39
15	基隆市七堵區	2018-11-24T23:20:09+08:00	6528	12128	18656	1152	19808	37466	52.87%	17.42%	33	39
15	基隆市七堵區	2018-11-24T23:31:28+08:00	6740	12595	19335	1184	20519	38784	52.91%	17.38%	34	39
15	基隆市七堵區	2018-11-24T22:37:14+08:00	4502	8342	12844	825	13669	25995	52.58%	17.32%	25	39
15	基隆市七堵區	2018-11-25T00:18:48+08:00	7376	13885	21261	1289	22550	42552	52.99%	17.33%	37	39
15	基隆市七堵區	2018-11-25T06:29:32+08:00	8017	15107	23124	1356	24480	46256	52.92%	17.33%	39	39
15	基隆市七堵區	2018-11-25T00:09:51+08:00	6937	12966	19903	1214	21117	39977	52.82%	17.35%	35	39
15	基隆市七堵區	2018-11-24T22:45:21+08:00	4982	9268	14250	941	15191	28731	52.87%	17.34%	27	39
15	基隆市七堵區	2018-11-24T22:54:38+08:00	5787	10597	16384	1052	17436	32960	52.9%	17.56%	30	39
15	基隆市七堵區	2018-11-24T22:33:51+08:00	4502	8342	12844	825	13669	25995	52.58%	17.32%	25	39
15	基隆市七堵區	2018-11-24T23:39:33+08:00	6937	12966	19903	1214	21117	39977	52.82%	17.35%	35	39
15	基隆市七堵區	2018-11-24T22:26:49+08:00	4176	7830	12006	796	12802	24273	52.74%	17.2%	24	39
15	基隆市七堵區	2018-11-25T01:12:59+08:00	8017	15107	23124	1356	24480	46256	52.92%	17.33%	39	39
15	基隆市七堵區	2018-11-25T00:05:18+08:00	6937	12966	19903	1214	21117	39977	52.82%	17.35%	35	39
15	基隆市七堵區	2018-11-25T01:07:41+08:00	8017	15107	23124	1356	24480	46256	52.92%	17.33%	39	39
15	基隆市七堵區	2018-11-24T23:05:17+08:00	6033	11058	17091	1070	18161	34446	52.72%	17.51%	31	39
15	基隆市七堵區	2018-11-24T23:56:02+08:00	6937	12966	19903	1214	21117	39977	52.82%	17.35%	35	39
15	基隆市七堵區	2018-11-24T23:23:51+08:00	6528	12128	18656	1152	19808	37466	52.87%	17.42%	33	39
15	基隆市七堵區	2018-11-24T22:23:29+08:00	4000	7478	11478	753	12231	23181	52.76%	17.26%	23	39
15	基隆市七堵區	2018-11-25T00:00:24+08:00	6937	12966	19903	1214	21117	39977	52.82%	17.35%	35	39
15	基隆市七堵區	2018-11-25T01:02:45+08:00	8017	15107	23124	1356	24480	46256	52.92%	17.33%	39	39
15	基隆市七堵區	2018-11-24T22:40:41+08:00	4675	8693	13368	873	14241	26957	52.83%	17.34%	26	39
15	基隆市七堵區	2018-11-25T00:57:52+08:00	8017	15107	23124	1356	24480	46256	52.92%	17.33%	39	39
15	基隆市七堵區	2018-11-24T22:51:04+08:00	5270	9707	14977	981	15958	30243	52.77%	17.43%	28	39
15	基隆市七堵區	2018-11-25T06:09:10+08:00	8017	15107	23124	1356	24480	46256	52.92%	17.33%	39	39
15	基隆市七堵區	2018-11-25T06:24:14+08:00	8017	15107	23124	1356	24480	46256	52.92%	17.33%	39	39
15	基隆市七堵區	2018-11-25T00:23:18+08:00	7376	13885	21261	1289	22550	42552	52.99%	17.33%	37	39
15	基隆市七堵區	2018-11-24T23:35:23+08:00	6740	12595	19335	1184	20519	38784	52.91%	17.38%	34	39
15	基隆市七堵區	2018-11-25T00:14:24+08:00	6937	12966	19903	1214	21117	39977	52.82%	17.35%	35	39
15	基隆市七堵區	2018-11-25T01:26:09+08:00	8017	15107	23124	1356	24480	46256	52.92%	17.33%	39	39
15	基隆市七堵區	2018-11-25T03:50:04+08:00	8017	15107	23124	1356	24480	46256	52.92%	17.33%	39	39
15	基隆市七堵區	2018-11-24T22:16:26+08:00	3857	7097	10954	709	11663	22182	52.58%	17.39%	22	39
15	基隆市七堵區	2018-11-24T23:43:31+08:00	6937	12966	19903	1214	21117	39977	52.82%	17.35%	35	39
15	基隆市七堵區	2018-11-25T01:18:11+08:00	8017	15107	23124	1356	24480	46256	52.92%	17.33%	39	39
15	基隆市七堵區	2018-11-24T23:16:16+08:00	6528	12128	18656	1152	19808	37466	52.87%	17.42%	33	39
15	基隆市七堵區	2018-11-25T06:19:11+08:00	8017	15107	23124	1356	24480	46256	52.92%	17.33%	39	39
15	基隆市七堵區	2018-11-24T22:41:51+08:00	4675	8693	13368	873	14241	26957	52.83%	17.34%	26	39
15	基隆市七堵區	2018-11-25T03:39:08+08:00	8017	15107	23124	1356	24480	46256	52.92%	17.33%	39	39
15	臺北市中山區	2018-11-25T06:29:19+08:00	42578	64018	106596	5211	111807	195148	57.29%	21.82%	133	133
15	臺北市中山區	2018-11-25T01:07:28+08:00	42578	64018	106596	5211	111807	195148	57.29%	21.82%	133	133
15	臺北市中山區	2018-11-25T06:13:55+08:00	42578	64018	106596	5211	111807	195148	57.29%	21.82%	133	133
15	臺北市中山區	2018-11-24T22:50:51+08:00	32488	48457	80945	3906	84851	148355	57.19%	21.9%	102	133
15	臺北市中山區	2018-11-25T06:19:00+08:00	42578	64018	106596	5211	111807	195148	57.29%	21.82%	133	133
15	臺北市中山區	2018-11-25T03:49:53+08:00	42578	64018	106596	5211	111807	195148	57.29%	21.82%	133	133
15	臺北市中山區	2018-11-24T22:50:50+08:00	32488	48457	80945	3906	84851	148355	57.19%	21.9%	102	133
15	臺北市中山區	2018-11-25T06:13:54+08:00	42578	64018	106596	5211	111807	195148	57.29%	21.82%	133	133
15	臺北市中山區	2018-11-24T23:43:19+08:00	39579	59425	99004	4783	103787	181328	57.24%	21.83%	124	133
15	臺北市中山區	2018-11-24T22:13:29+08:00	26806	40028	66834	3281	70115	123123	56.95%	21.77%	85	133
15	臺北市中山區	2018-11-25T06:24:03+08:00	42578	64018	106596	5211	111807	195148	57.29%	21.82%	133	133
15	臺北市中山區	2018-11-24T23:08:39+08:00	34667	51863	86530	4176	90706	158749	57.14%	21.84%	109	133
15	臺北市中山區	2018-11-25T00:23:06+08:00	41868	62898	104766	5108	109874	192014	57.22%	21.8%	131	133
15	臺北市中山區	2018-11-24T22:30:12+08:00	29520	44094	73614	3592	77206	135049	57.17%	21.86%	93	133
15	臺北市中山區	2018-11-24T23:08:38+08:00	34667	51863	86530	4176	90706	158749	57.14%	21.84%	109	133
15	臺北市中山區	2018-11-24T23:55:49+08:00	41296	62015	103311	5044	108355	189119	57.29%	21.84%	129	133
15	臺北市中山區	2018-11-25T03:32:37+08:00	42578	64018	106596	5211	111807	195148	57.29%	21.82%	133	133
15	臺北市中山區	2018-11-25T06:24:02+08:00	42578	64018	106596	5211	111807	195148	57.29%	21.82%	133	133
15	臺北市中山區	2018-11-24T23:51:37+08:00	40990	61448	102438	5024	107462	187534	57.3%	21.86%	128	133
15	臺北市中山區	2018-11-24T23:23:41+08:00	36307	54386	90693	4409	95102	166261	57.2%	21.84%	114	133
15	臺北市中山區	2018-11-24T22:23:15+08:00	28649	42686	71335	3502	74837	130885	57.18%	21.89%	90	133
15	臺北市中山區	2018-11-24T22:40:29+08:00	30996	46176	77172	3733	80905	141341	57.24%	21.93%	97	133
15	臺北市中山區	2018-11-24T22:57:57+08:00	32676	48865	81541	3933	85474	149353	57.23%	21.88%	103	133
15	臺北市中山區	2018-11-24T23:51:38+08:00	40990	61448	102438	5024	107462	187534	57.3%	21.86%	128	133
15	臺北市中山區	2018-11-25T06:18:59+08:00	42578	64018	106596	5211	111807	195148	57.29%	21.82%	133	133
15	臺北市中山區	2018-11-24T22:57:56+08:00	32676	48865	81541	3933	85474	149353	57.23%	21.88%	103	133
15	臺北市中山區	2018-11-25T01:17:56+08:00	42578	64018	106596	5211	111807	195148	57.29%	21.82%	133	133
15	臺北市中山區	2018-11-24T23:23:40+08:00	36307	54386	90693	4409	95102	166261	57.2%	21.84%	114	133
15	臺北市中山區	2018-11-24T22:33:40+08:00	30996	46176	77172	3733	80905	141341	57.24%	21.93%	97	133
15	臺北市中山區	2018-11-24T22:54:27+08:00	32676	48865	81541	3933	85474	149353	57.23%	21.88%	103	133
15	臺北市中山區	2018-11-24T22:16:13+08:00	27873	41638	69511	3406	72917	127734	57.09%	21.82%	88	133
15	臺北市中山區	2018-11-25T00:14:11+08:00	41868	62898	104766	5108	109874	192014	57.22%	21.8%	131	133
15	臺北市中山區	2018-11-24T23:05:07+08:00	34322	51345	85667	4125	89792	157096	57.16%	21.85%	108	133
15	臺北市中山區	2018-11-24T22:41:38+08:00	30996	46176	77172	3733	80905	141341	57.24%	21.93%	97	133
15	臺北市中山區	2018-11-24T22:54:28+08:00	32676	48865	81541	3933	85474	149353	57.23%	21.88%	103	133
15	臺北市中山區	2018-11-25T01:12:46+08:00	42578	64018	106596	5211	111807	195148	57.29%	21.82%	133	133
15	臺北市中山區	2018-11-25T06:08:56+08:00	42578	64018	106596	5211	111807	195148	57.29%	21.82%	133	133
15	臺北市中山區	2018-11-24T22:41:37+08:00	30996	46176	77172	3733	80905	141341	57.24%	21.93%	97	133
15	臺北市中山區	2018-11-25T00:05:07+08:00	41607	62493	104100	5086	109186	190699	57.26%	21.82%	130	133
15	臺北市中山區	2018-11-24T23:05:06+08:00	34322	51345	85667	4125	89792	157096	57.16%	21.85%	108	133
15	臺北市中山區	2018-11-25T00:18:33+08:00	41868	62898	104766	5108	109874	192014	57.22%	21.8%	131	133
15	臺北市中山區	2018-11-24T22:37:03+08:00	30996	46176	77172	3733	80905	141341	57.24%	21.93%	97	133
15	臺北市中山區	2018-11-24T22:45:10+08:00	31381	46713	78094	3775	81869	142928	57.28%	21.96%	98	133
15	臺北市中山區	2018-11-24T23:16:05+08:00	35638	53209	88847	4316	93163	162972	57.17%	21.87%	112	133
15	臺北市中山區	2018-11-24T22:45:11+08:00	31381	46713	78094	3775	81869	142928	57.28%	21.96%	98	133
15	臺北市中山區	2018-11-24T22:37:02+08:00	30996	46176	77172	3733	80905	141341	57.24%	21.93%	97	133
15	臺北市中山區	2018-11-25T03:56:15+08:00	42578	64018	106596	5211	111807	195148	57.29%	21.82%	133	133
15	臺北市中山區	2018-11-25T03:38:57+08:00	42578	64018	106596	5211	111807	195148	57.29%	21.82%	133	133
15	臺北市中山區	2018-11-25T03:44:26+08:00	42578	64018	106596	5211	111807	195148	57.29%	21.82%	133	133
15	臺北市中山區	2018-11-24T22:30:11+08:00	29520	44094	73614	3592	77206	135049	57.17%	21.86%	93	133
15	臺北市中山區	2018-11-25T01:02:33+08:00	42578	64018	106596	5211	111807	195148	57.29%	21.82%	133	133
15	臺北市中山區	2018-11-24T22:40:30+08:00	30996	46176	77172	3733	80905	141341	57.24%	21.93%	97	133
15	臺北市中山區	2018-11-25T01:25:55+08:00	42578	64018	106596	5211	111807	195148	57.29%	21.82%	133	133
15	臺北市中山區	2018-11-24T22:23:16+08:00	28649	42686	71335	3502	74837	130885	57.18%	21.89%	90	133
15	臺北市中山區	2018-11-24T23:19:54+08:00	35995	53830	89825	4366	94191	164676	57.2%	21.86%	113	133
15	臺北市中山區	2018-11-25T00:57:39+08:00	42578	64018	106596	5211	111807	195148	57.29%	21.82%	133	133
15	臺北市中山區	2018-11-24T23:27:21+08:00	36587	54780	91367	4444	95811	167628	57.16%	21.83%	115	133
15	臺北市中山區	2018-11-25T01:17:55+08:00	42578	64018	106596	5211	111807	195148	57.29%	21.82%	133	133
15	臺北市中山區	2018-11-24T22:19:39+08:00	28649	42686	71335	3502	74837	130885	57.18%	21.89%	90	133
15	臺北市中山區	2018-11-24T23:27:20+08:00	36587	54780	91367	4444	95811	167628	57.16%	21.83%	115	133
15	臺北市中山區	2018-11-24T22:13:30+08:00	26806	40028	66834	3281	70115	123123	56.95%	21.77%	85	133
15	臺北市中山區	2018-11-25T00:00:13+08:00	41296	62015	103311	5044	108355	189119	57.29%	21.84%	129	133
15	臺北市中山區	2018-11-25T00:14:12+08:00	41868	62898	104766	5108	109874	192014	57.22%	21.8%	131	133
15	臺北市中山區	2018-11-25T04:02:55+08:00	42578	64018	106596	5211	111807	195148	57.29%	21.82%	133	133
15	臺北市中山區	2018-11-25T00:09:36+08:00	41607	62493	104100	5086	109186	190699	57.26%	21.82%	130	133
15	臺北市中山區	2018-11-24T23:39:19+08:00	38157	57148	95305	4602	99907	174565	57.23%	21.86%	120	133
15	臺北市中山區	2018-11-24T22:26:39+08:00	29233	43596	72829	3549	76378	133613	57.16%	21.88%	92	133
15	臺北市中山區	2018-11-24T23:12:18+08:00	35316	52696	88012	4260	92272	161543	57.12%	21.86%	111	133
15	臺北市中山區	2018-11-24T23:31:14+08:00	37127	55827	92954	4500	97454	170364	57.2%	21.79%	117	133
15	臺北市中山區	2018-11-24T23:01:33+08:00	33606	50257	83863	4043	87906	153866	57.13%	21.84%	106	133
15	臺北市中山區	2018-11-24T23:01:34+08:00	33606	50257	83863	4043	87906	153866	57.13%	21.84%	106	133
15	臺北市中山區	2018-11-24T23:47:31+08:00	40617	60947	101564	4962	106526	185947	57.29%	21.84%	127	133
15	臺北市中山區	2018-11-24T23:35:13+08:00	37127	55827	92954	4500	97454	170364	57.2%	21.79%	117	133
15	臺北市中山區	2018-11-25T04:02:54+08:00	42578	64018	106596	5211	111807	195148	57.29%	21.82%	133	133
15	臺北市中山區	2018-11-25T00:09:37+08:00	41607	62493	104100	5086	109186	190699	57.26%	21.82%	130	133
15	臺北市中山區	2018-11-24T23:39:18+08:00	38157	57148	95305	4602	99907	174565	57.23%	21.86%	120	133
15	臺北市中山區	2018-11-25T06:08:55+08:00	42578	64018	106596	5211	111807	195148	57.29%	21.82%	133	133
15	臺中市西屯區	2018-11-25T03:56:17+08:00	35684	66785	102469	4496	106965	183814	58.19%	19.41%	120	120
15	臺中市西屯區	2018-11-24T23:16:06+08:00	30883	57184	88067	3839	91906	157576	58.32%	19.6%	104	120
15	臺中市西屯區	2018-11-25T06:29:21+08:00	35684	66785	102469	4496	106965	183814	58.19%	19.41%	120	120
15	臺中市西屯區	2018-11-25T03:49:55+08:00	35684	66785	102469	4496	106965	183814	58.19%	19.41%	120	120
15	臺中市西屯區	2018-11-25T06:19:01+08:00	35684	66785	102469	4496	106965	183814	58.19%	19.41%	120	120
15	臺中市西屯區	2018-11-24T22:45:12+08:00	25931	48407	74338	3296	77634	133086	58.33%	19.48%	89	120
15	臺中市西屯區	2018-11-24T23:43:21+08:00	33911	63156	97067	4254	101321	173894	58.27%	19.5%	114	120
15	臺中市西屯區	2018-11-24T22:41:40+08:00	25326	47272	72598	3228	75826	130090	58.29%	19.47%	87	120
15	臺中市西屯區	2018-11-25T01:25:57+08:00	35684	66785	102469	4496	106965	183814	58.19%	19.41%	120	120
15	臺中市西屯區	2018-11-24T22:30:13+08:00	23543	43823	67366	2985	70351	120959	58.16%	19.46%	81	120
15	臺中市西屯區	2018-11-25T06:24:04+08:00	35684	66785	102469	4496	106965	183814	58.19%	19.41%	120	120
15	臺中市西屯區	2018-11-25T00:23:07+08:00	35684	66785	102469	4496	106965	183814	58.19%	19.41%	120	120
15	臺中市西屯區	2018-11-25T03:32:39+08:00	35684	66785	102469	4496	106965	183814	58.19%	19.41%	120	120
15	臺中市西屯區	2018-11-24T23:51:39+08:00	34821	64982	99803	4357	104160	178710	58.28%	19.48%	117	120
15	臺中市西屯區	2018-11-24T23:27:22+08:00	31818	58982	90800	3980	94780	162341	58.38%	19.6%	107	120
15	臺中市西屯區	2018-11-24T22:13:32+08:00	20011	37317	57328	2618	59946	102837	58.29%	19.46%	70	120
15	臺中市西屯區	2018-11-25T01:17:57+08:00	35684	66785	102469	4496	106965	183814	58.19%	19.41%	120	120
15	臺中市西屯區	2018-11-24T23:08:40+08:00	29934	55506	85440	3735	89175	152664	58.41%	19.61%	101	120
15	臺中市西屯區	2018-11-24T22:57:58+08:00	29307	54338	83645	3683	87328	149511	58.41%	19.6%	99	120
15	臺中市西屯區	2018-11-24T23:19:56+08:00	31497	58342	89839	3940	93779	160675	58.37%	19.6%	106	120
15	臺中市西屯區	2018-11-24T22:54:29+08:00	27947	52081	80028	3518	83546	142983	58.43%	19.55%	95	120
15	臺中市西屯區	2018-11-25T04:02:56+08:00	35684	66785	102469	4496	106965	183814	58.19%	19.41%	120	120
15	臺中市西屯區	2018-11-25T06:08:58+08:00	35684	66785	102469	4496	106965	183814	58.19%	19.41%	120	120
15	臺中市西屯區	2018-11-24T22:16:15+08:00	20682	38545	59227	2695	61922	106090	58.37%	19.49%	72	120
15	臺中市西屯區	2018-11-24T23:31:16+08:00	32547	60748	93295	4098	97393	167054	58.3%	19.48%	110	120
15	臺中市西屯區	2018-11-25T01:12:48+08:00	35684	66785	102469	4496	106965	183814	58.19%	19.41%	120	120
15	臺中市西屯區	2018-11-24T23:05:08+08:00	29934	55506	85440	3735	89175	152664	58.41%	19.61%	101	120
15	臺中市西屯區	2018-11-24T23:47:32+08:00	34233	63723	97956	4291	102247	175550	58.24%	19.5%	115	120
15	臺中市西屯區	2018-11-25T00:05:09+08:00	35684	66785	102469	4496	106965	183814	58.19%	19.41%	120	120
15	臺中市西屯區	2018-11-24T22:37:04+08:00	24974	46581	71555	3190	74745	128155	58.32%	19.49%	86	120
15	臺中市西屯區	2018-11-24T22:50:52+08:00	26928	50205	77133	3420	80553	137896	58.42%	19.53%	92	120
15	臺中市西屯區	2018-11-25T06:13:56+08:00	35684	66785	102469	4496	106965	183814	58.19%	19.41%	120	120
15	臺中市西屯區	2018-11-24T22:26:40+08:00	22677	42135	64812	2897	67709	116076	58.33%	19.54%	78	120
15	臺中市西屯區	2018-11-25T00:18:35+08:00	35684	66785	102469	4496	106965	183814	58.19%	19.41%	120	120
15	臺中市西屯區	2018-11-24T22:40:31+08:00	25326	47272	72598	3228	75826	130090	58.29%	19.47%	87	120
15	臺中市西屯區	2018-11-25T01:02:35+08:00	35684	66785	102469	4496	106965	183814	58.19%	19.41%	120	120
15	臺中市西屯區	2018-11-25T00:57:41+08:00	35684	66785	102469	4496	106965	183814	58.19%	19.41%	120	120
15	臺中市西屯區	2018-11-24T22:19:40+08:00	20682	38545	59227	2695	61922	106090	58.37%	19.49%	72	120
15	臺中市西屯區	2018-11-25T03:38:58+08:00	35684	66785	102469	4496	106965	183814	58.19%	19.41%	120	120
15	臺中市西屯區	2018-11-25T03:44:28+08:00	35684	66785	102469	4496	106965	183814	58.19%	19.41%	120	120
15	臺中市西屯區	2018-11-24T23:23:42+08:00	31497	58342	89839	3940	93779	160675	58.37%	19.6%	106	120
15	臺中市西屯區	2018-11-24T22:23:18+08:00	21321	39803	61124	2776	63900	109423	58.4%	19.48%	74	120
15	臺中市西屯區	2018-11-24T23:55:51+08:00	34821	64982	99803	4357	104160	178710	58.28%	19.48%	117	120
15	臺中市西屯區	2018-11-25T00:00:14+08:00	34821	64982	99803	4357	104160	178710	58.28%	19.48%	117	120
15	臺中市西屯區	2018-11-24T23:39:21+08:00	33631	62610	96241	4220	100461	172374	58.28%	19.51%	113	120
15	臺中市西屯區	2018-11-25T01:07:30+08:00	35684	66785	102469	4496	106965	183814	58.19%	19.41%	120	120
15	臺中市西屯區	2018-11-25T00:09:38+08:00	35684	66785	102469	4496	106965	183814	58.19%	19.41%	120	120
15	臺中市西屯區	2018-11-24T23:35:14+08:00	32945	61360	94305	4157	98462	168831	58.32%	19.51%	111	120
15	臺中市西屯區	2018-11-25T00:14:14+08:00	35684	66785	102469	4496	106965	183814	58.19%	19.41%	120	120
15	臺中市西屯區	2018-11-24T23:01:35+08:00	29639	54918	84557	3711	88268	151005	58.45%	19.63%	100	120
15	臺中市西屯區	2018-11-24T23:12:19+08:00	30253	55993	86246	3762	90008	154166	58.38%	19.62%	102	120
15	臺中市西屯區	2018-11-24T22:33:42+08:00	24474	45589	70063	3102	73165	125627	58.24%	19.48%	84	120
15	臺中市神岡區	2018-11-25T03:56:17+08:00	9121	21157	30278	2144	32422	54565	59.42%	16.72%	42	42
15	臺中市神岡區	2018-11-25T06:29:21+08:00	9121	21157	30278	2144	32422	54565	59.42%	16.72%	42	42
15	臺中市神岡區	2018-11-25T03:49:55+08:00	9121	21157	30278	2144	32422	54565	59.42%	16.72%	42	42
15	臺中市神岡區	2018-11-25T06:19:01+08:00	9121	21157	30278	2144	32422	54565	59.42%	16.72%	42	42
15	臺中市神岡區	2018-11-24T23:16:07+08:00	8870	20651	29521	2113	31634	53150	59.52%	16.69%	41	42
15	臺中市神岡區	2018-11-24T22:45:12+08:00	8162	18951	27113	1952	29065	48789	59.57%	16.73%	38	42
15	臺中市神岡區	2018-11-24T23:43:21+08:00	9121	21157	30278	2144	32422	54565	59.42%	16.72%	42	42
15	臺中市神岡區	2018-11-24T22:41:40+08:00	7900	18413	26313	1891	28204	47222	59.73%	16.73%	37	42
15	臺中市神岡區	2018-11-25T01:25:57+08:00	9121	21157	30278	2144	32422	54565	59.42%	16.72%	42	42
15	臺中市神岡區	2018-11-24T22:30:14+08:00	7680	17904	25584	1855	27439	45820	59.88%	16.76%	36	42
15	臺中市神岡區	2018-11-25T06:24:04+08:00	9121	21157	30278	2144	32422	54565	59.42%	16.72%	42	42
15	臺中市神岡區	2018-11-25T00:23:08+08:00	9121	21157	30278	2144	32422	54565	59.42%	16.72%	42	42
15	臺中市神岡區	2018-11-25T03:32:39+08:00	9121	21157	30278	2144	32422	54565	59.42%	16.72%	42	42
15	臺中市神岡區	2018-11-24T23:51:39+08:00	9121	21157	30278	2144	32422	54565	59.42%	16.72%	42	42
15	臺中市神岡區	2018-11-24T23:27:22+08:00	9121	21157	30278	2144	32422	54565	59.42%	16.72%	42	42
15	臺中市神岡區	2018-11-24T22:13:32+08:00	6837	15794	22631	1630	24261	40579	59.79%	16.85%	32	42
15	臺中市神岡區	2018-11-24T22:57:59+08:00	8359	19418	27777	1993	29770	50077	59.45%	16.69%	39	42
15	臺中市神岡區	2018-11-24T23:08:41+08:00	8616	20007	28623	2054	30677	51667	59.37%	16.68%	40	42
15	臺中市神岡區	2018-11-24T23:19:56+08:00	8870	20651	29521	2113	31634	53150	59.52%	16.69%	41	42
15	臺中市神岡區	2018-11-25T01:17:58+08:00	9121	21157	30278	2144	32422	54565	59.42%	16.72%	42	42
15	臺中市神岡區	2018-11-24T22:54:29+08:00	8359	19418	27777	1993	29770	50077	59.45%	16.69%	39	42
15	臺中市神岡區	2018-11-24T23:47:33+08:00	9121	21157	30278	2144	32422	54565	59.42%	16.72%	42	42
15	臺中市神岡區	2018-11-25T04:02:56+08:00	9121	21157	30278	2144	32422	54565	59.42%	16.72%	42	42
15	臺中市神岡區	2018-11-25T06:08:58+08:00	9121	21157	30278	2144	32422	54565	59.42%	16.72%	42	42
15	臺中市神岡區	2018-11-24T22:16:15+08:00	6837	15794	22631	1630	24261	40579	59.79%	16.85%	32	42
15	臺中市神岡區	2018-11-24T23:31:16+08:00	9121	21157	30278	2144	32422	54565	59.42%	16.72%	42	42
15	臺中市神岡區	2018-11-25T01:12:48+08:00	9121	21157	30278	2144	32422	54565	59.42%	16.72%	42	42
15	臺中市神岡區	2018-11-24T23:05:08+08:00	8359	19418	27777	1993	29770	50077	59.45%	16.69%	39	42
15	臺中市神岡區	2018-11-25T00:05:09+08:00	9121	21157	30278	2144	32422	54565	59.42%	16.72%	42	42
15	臺中市神岡區	2018-11-24T22:37:04+08:00	7900	18413	26313	1891	28204	47222	59.73%	16.73%	37	42
15	臺中市神岡區	2018-11-25T06:13:56+08:00	9121	21157	30278	2144	32422	54565	59.42%	16.72%	42	42
15	臺中市神岡區	2018-11-24T22:26:40+08:00	7452	17402	24854	1825	26679	44476	59.99%	16.76%	35	42
15	臺中市神岡區	2018-11-24T22:50:53+08:00	8359	19418	27777	1993	29770	50077	59.45%	16.69%	39	42
15	臺中市神岡區	2018-11-25T00:18:35+08:00	9121	21157	30278	2144	32422	54565	59.42%	16.72%	42	42
15	臺中市神岡區	2018-11-24T22:19:41+08:00	7056	16352	23408	1708	25116	41889	59.96%	16.84%	33	42
15	臺中市神岡區	2018-11-25T03:38:59+08:00	9121	21157	30278	2144	32422	54565	59.42%	16.72%	42	42
15	臺中市神岡區	2018-11-24T22:40:31+08:00	7900	18413	26313	1891	28204	47222	59.73%	16.73%	37	42
15	臺中市神岡區	2018-11-25T01:02:35+08:00	9121	21157	30278	2144	32422	54565	59.42%	16.72%	42	42
15	臺中市神岡區	2018-11-25T00:57:41+08:00	9121	21157	30278	2144	32422	54565	59.42%	16.72%	42	42
15	臺中市神岡區	2018-11-25T03:44:28+08:00	9121	21157	30278	2144	32422	54565	59.42%	16.72%	42	42
15	臺中市神岡區	2018-11-24T23:23:42+08:00	9121	21157	30278	2144	32422	54565	59.42%	16.72%	42	42
15	臺中市神岡區	2018-11-24T22:23:18+08:00	7056	16352	23408	1708	25116	41889	59.96%	16.84%	33	42
15	臺中市神岡區	2018-11-25T00:00:15+08:00	9121	21157	30278	2144	32422	54565	59.42%	16.72%	42	42
15	臺中市神岡區	2018-11-24T23:55:51+08:00	9121	21157	30278	2144	32422	54565	59.42%	16.72%	42	42
15	臺中市神岡區	2018-11-24T23:39:21+08:00	9121	21157	30278	2144	32422	54565	59.42%	16.72%	42	42
15	臺中市神岡區	2018-11-25T01:07:30+08:00	9121	21157	30278	2144	32422	54565	59.42%	16.72%	42	42
15	臺中市神岡區	2018-11-24T23:12:20+08:00	8616	20007	28623	2054	30677	51667	59.37%	16.68%	40	42
15	臺中市神岡區	2018-11-24T23:35:14+08:00	9121	21157	30278	2144	32422	54565	59.42%	16.72%	42	42
15	臺中市神岡區	2018-11-25T00:14:14+08:00	9121	21157	30278	2144	32422	54565	59.42%	16.72%	42	42
15	臺中市神岡區	2018-11-24T23:01:35+08:00	8359	19418	27777	1993	29770	50077	59.45%	16.69%	39	42
15	臺中市神岡區	2018-11-25T00:09:39+08:00	9121	21157	30278	2144	32422	54565	59.42%	16.72%	42	42
15	臺中市神岡區	2018-11-24T22:33:42+08:00	7900	18413	26313	1891	28204	47222	59.73%	16.73%	37	42
15	臺南市歸仁區	2018-11-24T23:16:08+08:00	9988	18728	28716	1767	30483	57387	53.12%	17.4%	46	46
15	臺南市歸仁區	2018-11-25T03:56:19+08:00	9988	18728	28716	1767	30483	57387	53.12%	17.4%	46	46
15	臺南市歸仁區	2018-11-25T00:18:37+08:00	9988	18728	28716	1767	30483	57387	53.12%	17.4%	46	46
15	臺南市歸仁區	2018-11-24T22:45:13+08:00	9988	18728	28716	1767	30483	57387	53.12%	17.4%	46	46
15	臺南市歸仁區	2018-11-24T22:58:00+08:00	9988	18728	28716	1767	30483	57387	53.12%	17.4%	46	46
15	臺南市歸仁區	2018-11-24T22:26:42+08:00	9508	17859	27367	1713	29080	54646	53.22%	17.4%	44	46
15	臺南市歸仁區	2018-11-25T01:18:00+08:00	9988	18728	28716	1767	30483	57387	53.12%	17.4%	46	46
15	臺南市歸仁區	2018-11-24T22:37:06+08:00	9988	18728	28716	1767	30483	57387	53.12%	17.4%	46	46
15	臺南市歸仁區	2018-11-25T06:09:00+08:00	9988	18728	28716	1767	30483	57387	53.12%	17.4%	46	46
15	臺南市歸仁區	2018-11-25T00:57:43+08:00	9988	18728	28716	1767	30483	57387	53.12%	17.4%	46	46
15	臺南市歸仁區	2018-11-24T22:19:42+08:00	9196	17350	26546	1678	28224	53132	53.12%	17.31%	43	46
15	臺南市歸仁區	2018-11-25T01:25:58+08:00	9988	18728	28716	1767	30483	57387	53.12%	17.4%	46	46
15	臺南市歸仁區	2018-11-24T22:30:15+08:00	9508	17859	27367	1713	29080	54646	53.22%	17.4%	44	46
15	臺南市歸仁區	2018-11-25T01:02:37+08:00	9988	18728	28716	1767	30483	57387	53.12%	17.4%	46	46
15	臺南市歸仁區	2018-11-24T22:40:33+08:00	9988	18728	28716	1767	30483	57387	53.12%	17.4%	46	46
15	臺南市歸仁區	2018-11-24T23:51:41+08:00	9988	18728	28716	1767	30483	57387	53.12%	17.4%	46	46
15	臺南市歸仁區	2018-11-25T00:23:09+08:00	9988	18728	28716	1767	30483	57387	53.12%	17.4%	46	46
15	臺南市歸仁區	2018-11-25T00:00:16+08:00	9988	18728	28716	1767	30483	57387	53.12%	17.4%	46	46
15	臺南市歸仁區	2018-11-24T23:55:52+08:00	9988	18728	28716	1767	30483	57387	53.12%	17.4%	46	46
15	臺南市歸仁區	2018-11-24T23:19:58+08:00	9988	18728	28716	1767	30483	57387	53.12%	17.4%	46	46
15	臺南市歸仁區	2018-11-24T22:13:34+08:00	8995	16996	25991	1618	27609	52004	53.09%	17.3%	42	46
15	臺南市歸仁區	2018-11-24T23:27:23+08:00	9988	18728	28716	1767	30483	57387	53.12%	17.4%	46	46
15	臺南市歸仁區	2018-11-25T03:44:30+08:00	9988	18728	28716	1767	30483	57387	53.12%	17.4%	46	46
15	臺南市歸仁區	2018-11-24T23:01:37+08:00	9988	18728	28716	1767	30483	57387	53.12%	17.4%	46	46
15	臺南市歸仁區	2018-11-25T04:02:58+08:00	9988	18728	28716	1767	30483	57387	53.12%	17.4%	46	46
15	臺南市歸仁區	2018-11-24T23:35:16+08:00	9988	18728	28716	1767	30483	57387	53.12%	17.4%	46	46
15	臺南市歸仁區	2018-11-24T23:05:09+08:00	9988	18728	28716	1767	30483	57387	53.12%	17.4%	46	46
15	臺南市歸仁區	2018-11-24T23:31:18+08:00	9988	18728	28716	1767	30483	57387	53.12%	17.4%	46	46
15	臺南市歸仁區	2018-11-24T23:39:23+08:00	9988	18728	28716	1767	30483	57387	53.12%	17.4%	46	46
15	臺南市歸仁區	2018-11-25T01:07:32+08:00	9988	18728	28716	1767	30483	57387	53.12%	17.4%	46	46
15	臺南市歸仁區	2018-11-24T23:47:35+08:00	9988	18728	28716	1767	30483	57387	53.12%	17.4%	46	46
15	臺南市歸仁區	2018-11-24T22:41:42+08:00	9988	18728	28716	1767	30483	57387	53.12%	17.4%	46	46
15	臺南市歸仁區	2018-11-25T06:13:58+08:00	9988	18728	28716	1767	30483	57387	53.12%	17.4%	46	46
15	臺南市歸仁區	2018-11-25T06:19:02+08:00	9988	18728	28716	1767	30483	57387	53.12%	17.4%	46	46
15	臺南市歸仁區	2018-11-25T00:09:41+08:00	9988	18728	28716	1767	30483	57387	53.12%	17.4%	46	46
15	臺南市歸仁區	2018-11-25T03:49:56+08:00	9988	18728	28716	1767	30483	57387	53.12%	17.4%	46	46
15	臺南市歸仁區	2018-11-24T22:54:30+08:00	9988	18728	28716	1767	30483	57387	53.12%	17.4%	46	46
15	臺南市歸仁區	2018-11-24T22:50:54+08:00	9988	18728	28716	1767	30483	57387	53.12%	17.4%	46	46
15	臺南市歸仁區	2018-11-25T01:12:50+08:00	9988	18728	28716	1767	30483	57387	53.12%	17.4%	46	46
15	臺南市歸仁區	2018-11-24T23:43:22+08:00	9988	18728	28716	1767	30483	57387	53.12%	17.4%	46	46
15	臺南市歸仁區	2018-11-25T06:29:23+08:00	9988	18728	28716	1767	30483	57387	53.12%	17.4%	46	46
15	臺南市歸仁區	2018-11-25T00:05:11+08:00	9988	18728	28716	1767	30483	57387	53.12%	17.4%	46	46
15	臺南市歸仁區	2018-11-25T06:24:06+08:00	9988	18728	28716	1767	30483	57387	53.12%	17.4%	46	46
15	臺南市歸仁區	2018-11-24T22:23:20+08:00	9508	17859	27367	1713	29080	54646	53.22%	17.4%	44	46
15	臺南市歸仁區	2018-11-25T03:32:42+08:00	9988	18728	28716	1767	30483	57387	53.12%	17.4%	46	46
15	臺南市歸仁區	2018-11-24T23:08:42+08:00	9988	18728	28716	1767	30483	57387	53.12%	17.4%	46	46
15	臺南市歸仁區	2018-11-24T23:23:43+08:00	9988	18728	28716	1767	30483	57387	53.12%	17.4%	46	46
15	臺南市歸仁區	2018-11-25T00:14:15+08:00	9988	18728	28716	1767	30483	57387	53.12%	17.4%	46	46
15	臺南市歸仁區	2018-11-24T22:33:43+08:00	9508	17859	27367	1713	29080	54646	53.22%	17.4%	44	46
15	臺南市歸仁區	2018-11-24T22:16:17+08:00	9196	17350	26546	1678	28224	53132	53.12%	17.31%	43	46
15	臺南市歸仁區	2018-11-25T03:39:00+08:00	9988	18728	28716	1767	30483	57387	53.12%	17.4%	46	46
15	臺南市歸仁區	2018-11-24T23:12:21+08:00	9988	18728	28716	1767	30483	57387	53.12%	17.4%	46	46
15	臺中市石岡區	2018-11-25T03:56:17+08:00	2109	4964	7073	552	7625	12880	59.2%	16.37%	10	10
15	臺中市石岡區	2018-11-25T06:29:21+08:00	2109	4964	7073	552	7625	12880	59.2%	16.37%	10	10
15	臺中市石岡區	2018-11-25T03:49:55+08:00	2109	4964	7073	552	7625	12880	59.2%	16.37%	10	10
15	臺中市石岡區	2018-11-25T06:19:01+08:00	2109	4964	7073	552	7625	12880	59.2%	16.37%	10	10
15	臺中市石岡區	2018-11-24T23:16:07+08:00	2109	4964	7073	552	7625	12880	59.2%	16.37%	10	10
15	臺中市石岡區	2018-11-24T22:45:12+08:00	2109	4964	7073	552	7625	12880	59.2%	16.37%	10	10
15	臺中市石岡區	2018-11-24T23:43:21+08:00	2109	4964	7073	552	7625	12880	59.2%	16.37%	10	10
15	臺中市石岡區	2018-11-24T22:41:40+08:00	2109	4964	7073	552	7625	12880	59.2%	16.37%	10	10
15	臺中市石岡區	2018-11-25T00:18:36+08:00	2109	4964	7073	552	7625	12880	59.2%	16.37%	10	10
15	臺中市石岡區	2018-11-24T23:51:40+08:00	2109	4964	7073	552	7625	12880	59.2%	16.37%	10	10
15	臺中市石岡區	2018-11-25T01:25:57+08:00	2109	4964	7073	552	7625	12880	59.2%	16.37%	10	10
15	臺中市石岡區	2018-11-24T22:30:14+08:00	2109	4964	7073	552	7625	12880	59.2%	16.37%	10	10
15	臺中市石岡區	2018-11-25T06:24:04+08:00	2109	4964	7073	552	7625	12880	59.2%	16.37%	10	10
15	臺中市石岡區	2018-11-25T00:23:08+08:00	2109	4964	7073	552	7625	12880	59.2%	16.37%	10	10
15	臺中市石岡區	2018-11-25T03:32:39+08:00	2109	4964	7073	552	7625	12880	59.2%	16.37%	10	10
15	臺中市石岡區	2018-11-24T23:27:22+08:00	2109	4964	7073	552	7625	12880	59.2%	16.37%	10	10
15	臺中市石岡區	2018-11-24T22:57:59+08:00	2109	4964	7073	552	7625	12880	59.2%	16.37%	10	10
15	臺中市石岡區	2018-11-24T23:08:41+08:00	2109	4964	7073	552	7625	12880	59.2%	16.37%	10	10
15	臺中市石岡區	2018-11-24T22:13:33+08:00	2109	4964	7073	552	7625	12880	59.2%	16.37%	10	10
15	臺中市石岡區	2018-11-24T23:19:56+08:00	2109	4964	7073	552	7625	12880	59.2%	16.37%	10	10
15	臺中市石岡區	2018-11-25T01:17:58+08:00	2109	4964	7073	552	7625	12880	59.2%	16.37%	10	10
15	臺中市石岡區	2018-11-24T22:54:29+08:00	2109	4964	7073	552	7625	12880	59.2%	16.37%	10	10
15	臺中市石岡區	2018-11-24T23:47:33+08:00	2109	4964	7073	552	7625	12880	59.2%	16.37%	10	10
15	臺中市石岡區	2018-11-25T04:02:56+08:00	2109	4964	7073	552	7625	12880	59.2%	16.37%	10	10
15	臺中市石岡區	2018-11-25T06:08:58+08:00	2109	4964	7073	552	7625	12880	59.2%	16.37%	10	10
15	臺中市石岡區	2018-11-24T22:16:15+08:00	2109	4964	7073	552	7625	12880	59.2%	16.37%	10	10
15	臺中市石岡區	2018-11-24T23:31:16+08:00	2109	4964	7073	552	7625	12880	59.2%	16.37%	10	10
15	臺中市石岡區	2018-11-25T01:12:48+08:00	2109	4964	7073	552	7625	12880	59.2%	16.37%	10	10
15	臺中市石岡區	2018-11-24T23:05:08+08:00	2109	4964	7073	552	7625	12880	59.2%	16.37%	10	10
15	臺中市石岡區	2018-11-25T00:05:09+08:00	2109	4964	7073	552	7625	12880	59.2%	16.37%	10	10
15	臺中市石岡區	2018-11-25T06:13:56+08:00	2109	4964	7073	552	7625	12880	59.2%	16.37%	10	10
15	臺中市石岡區	2018-11-24T22:26:40+08:00	2109	4964	7073	552	7625	12880	59.2%	16.37%	10	10
15	臺中市石岡區	2018-11-24T22:50:53+08:00	2109	4964	7073	552	7625	12880	59.2%	16.37%	10	10
15	臺中市石岡區	2018-11-24T22:37:05+08:00	2109	4964	7073	552	7625	12880	59.2%	16.37%	10	10
15	臺中市石岡區	2018-11-24T22:19:41+08:00	2109	4964	7073	552	7625	12880	59.2%	16.37%	10	10
15	臺中市石岡區	2018-11-25T03:38:59+08:00	2109	4964	7073	552	7625	12880	59.2%	16.37%	10	10
15	臺中市石岡區	2018-11-24T22:40:31+08:00	2109	4964	7073	552	7625	12880	59.2%	16.37%	10	10
15	臺中市石岡區	2018-11-25T01:02:35+08:00	2109	4964	7073	552	7625	12880	59.2%	16.37%	10	10
15	臺中市石岡區	2018-11-25T00:57:41+08:00	2109	4964	7073	552	7625	12880	59.2%	16.37%	10	10
15	臺中市石岡區	2018-11-25T03:44:28+08:00	2109	4964	7073	552	7625	12880	59.2%	16.37%	10	10
15	臺中市石岡區	2018-11-24T23:23:42+08:00	2109	4964	7073	552	7625	12880	59.2%	16.37%	10	10
15	臺中市石岡區	2018-11-24T22:23:18+08:00	2109	4964	7073	552	7625	12880	59.2%	16.37%	10	10
15	臺中市石岡區	2018-11-25T00:00:15+08:00	2109	4964	7073	552	7625	12880	59.2%	16.37%	10	10
15	臺中市石岡區	2018-11-24T23:55:51+08:00	2109	4964	7073	552	7625	12880	59.2%	16.37%	10	10
15	臺中市石岡區	2018-11-24T23:39:21+08:00	2109	4964	7073	552	7625	12880	59.2%	16.37%	10	10
15	臺中市石岡區	2018-11-25T01:07:30+08:00	2109	4964	7073	552	7625	12880	59.2%	16.37%	10	10
15	臺中市石岡區	2018-11-24T23:12:20+08:00	2109	4964	7073	552	7625	12880	59.2%	16.37%	10	10
15	臺中市石岡區	2018-11-24T23:35:14+08:00	2109	4964	7073	552	7625	12880	59.2%	16.37%	10	10
15	臺中市石岡區	2018-11-25T00:14:14+08:00	2109	4964	7073	552	7625	12880	59.2%	16.37%	10	10
15	臺中市石岡區	2018-11-24T23:01:35+08:00	2109	4964	7073	552	7625	12880	59.2%	16.37%	10	10
15	臺中市石岡區	2018-11-25T00:09:39+08:00	2109	4964	7073	552	7625	12880	59.2%	16.37%	10	10
15	臺中市石岡區	2018-11-24T22:33:42+08:00	2109	4964	7073	552	7625	12880	59.2%	16.37%	10	10
15	臺東縣大武鄉	2018-11-25T03:56:28+08:00	636	1670	2306	399	2705	5266	51.37%	12.08%	6	6
15	臺東縣大武鄉	2018-11-24T22:58:08+08:00	307	928	1235	208	1443	2658	54.29%	11.55%	4	6
15	臺東縣大武鄉	2018-11-24T23:47:43+08:00	636	1670	2306	399	2705	5266	51.37%	12.08%	6	6
15	臺東縣大武鄉	2018-11-24T23:56:01+08:00	636	1670	2306	399	2705	5266	51.37%	12.08%	6	6
15	臺東縣大武鄉	2018-11-24T23:12:30+08:00	486	1364	1850	323	2173	4132	52.59%	11.76%	5	6
15	臺東縣大武鄉	2018-11-24T23:27:30+08:00	486	1364	1850	323	2173	4132	52.59%	11.76%	5	6
15	臺東縣大武鄉	2018-11-25T06:09:09+08:00	636	1670	2306	399	2705	5266	51.37%	12.08%	6	6
15	臺東縣大武鄉	2018-11-24T23:51:48+08:00	636	1670	2306	399	2705	5266	51.37%	12.08%	6	6
15	臺東縣大武鄉	2018-11-24T22:30:23+08:00	70	242	312	80	392	763	51.38%	9.17%	2	6
15	臺東縣大武鄉	2018-11-25T03:32:52+08:00	636	1670	2306	399	2705	5266	51.37%	12.08%	6	6
15	臺東縣大武鄉	2018-11-24T22:13:44+08:00	70	242	312	80	392	763	51.38%	9.17%	2	6
15	臺東縣大武鄉	2018-11-25T03:44:40+08:00	636	1670	2306	399	2705	5266	51.37%	12.08%	6	6
15	臺東縣大武鄉	2018-11-25T00:57:51+08:00	636	1670	2306	399	2705	5266	51.37%	12.08%	6	6
15	臺東縣大武鄉	2018-11-24T22:16:25+08:00	70	242	312	80	392	763	51.38%	9.17%	2	6
15	臺東縣大武鄉	2018-11-25T00:09:50+08:00	636	1670	2306	399	2705	5266	51.37%	12.08%	6	6
15	臺東縣大武鄉	2018-11-25T00:18:47+08:00	636	1670	2306	399	2705	5266	51.37%	12.08%	6	6
15	臺東縣大武鄉	2018-11-24T22:37:14+08:00	247	686	933	167	1100	2090	52.63%	11.82%	3	6
15	臺東縣大武鄉	2018-11-24T23:20:08+08:00	486	1364	1850	323	2173	4132	52.59%	11.76%	5	6
15	臺東縣大武鄉	2018-11-24T23:31:27+08:00	486	1364	1850	323	2173	4132	52.59%	11.76%	5	6
15	臺東縣大武鄉	2018-11-24T23:16:15+08:00	486	1364	1850	323	2173	4132	52.59%	11.76%	5	6
15	臺東縣大武鄉	2018-11-25T01:12:58+08:00	636	1670	2306	399	2705	5266	51.37%	12.08%	6	6
15	臺東縣大武鄉	2018-11-25T00:05:17+08:00	636	1670	2306	399	2705	5266	51.37%	12.08%	6	6
15	臺東縣大武鄉	2018-11-24T23:05:16+08:00	486	1364	1850	323	2173	4132	52.59%	11.76%	5	6
15	臺東縣大武鄉	2018-11-25T01:07:40+08:00	636	1670	2306	399	2705	5266	51.37%	12.08%	6	6
15	臺東縣大武鄉	2018-11-24T23:39:32+08:00	486	1364	1850	323	2173	4132	52.59%	11.76%	5	6
15	臺東縣大武鄉	2018-11-24T22:54:37+08:00	307	928	1235	208	1443	2658	54.29%	11.55%	4	6
15	臺東縣大武鄉	2018-11-24T22:33:50+08:00	247	686	933	167	1100	2090	52.63%	11.82%	3	6
15	臺東縣大武鄉	2018-11-24T22:45:20+08:00	247	686	933	167	1100	2090	52.63%	11.82%	3	6
15	臺東縣大武鄉	2018-11-24T22:26:48+08:00	70	242	312	80	392	763	51.38%	9.17%	2	6
15	臺東縣大武鄉	2018-11-24T23:01:45+08:00	307	928	1235	208	1443	2658	54.29%	11.55%	4	6
15	臺東縣大武鄉	2018-11-25T04:03:05+08:00	636	1670	2306	399	2705	5266	51.37%	12.08%	6	6
15	臺東縣大武鄉	2018-11-24T23:08:51+08:00	486	1364	1850	323	2173	4132	52.59%	11.76%	5	6
15	臺東縣大武鄉	2018-11-24T23:23:50+08:00	486	1364	1850	323	2173	4132	52.59%	11.76%	5	6
15	臺東縣大武鄉	2018-11-24T22:19:49+08:00	70	242	312	80	392	763	51.38%	9.17%	2	6
15	臺東縣大武鄉	2018-11-25T00:23:17+08:00	636	1670	2306	399	2705	5266	51.37%	12.08%	6	6
15	臺東縣大武鄉	2018-11-25T00:00:23+08:00	636	1670	2306	399	2705	5266	51.37%	12.08%	6	6
15	臺東縣大武鄉	2018-11-24T22:51:03+08:00	307	928	1235	208	1443	2658	54.29%	11.55%	4	6
15	臺東縣大武鄉	2018-11-24T22:23:28+08:00	70	242	312	80	392	763	51.38%	9.17%	2	6
15	臺東縣大武鄉	2018-11-24T22:40:40+08:00	247	686	933	167	1100	2090	52.63%	11.82%	3	6
15	臺東縣大武鄉	2018-11-25T06:24:13+08:00	636	1670	2306	399	2705	5266	51.37%	12.08%	6	6
15	臺東縣大武鄉	2018-11-25T01:02:44+08:00	636	1670	2306	399	2705	5266	51.37%	12.08%	6	6
15	臺東縣大武鄉	2018-11-25T06:14:05+08:00	636	1670	2306	399	2705	5266	51.37%	12.08%	6	6
15	臺東縣大武鄉	2018-11-25T06:19:10+08:00	636	1670	2306	399	2705	5266	51.37%	12.08%	6	6
15	臺東縣大武鄉	2018-11-25T00:14:23+08:00	636	1670	2306	399	2705	5266	51.37%	12.08%	6	6
15	臺東縣大武鄉	2018-11-25T01:18:10+08:00	636	1670	2306	399	2705	5266	51.37%	12.08%	6	6
15	臺東縣大武鄉	2018-11-25T03:50:03+08:00	636	1670	2306	399	2705	5266	51.37%	12.08%	6	6
15	臺東縣大武鄉	2018-11-25T01:26:07+08:00	636	1670	2306	399	2705	5266	51.37%	12.08%	6	6
15	臺東縣大武鄉	2018-11-25T03:39:07+08:00	636	1670	2306	399	2705	5266	51.37%	12.08%	6	6
15	臺東縣大武鄉	2018-11-24T22:41:50+08:00	247	686	933	167	1100	2090	52.63%	11.82%	3	6
15	臺東縣大武鄉	2018-11-25T06:29:31+08:00	636	1670	2306	399	2705	5266	51.37%	12.08%	6	6
15	臺東縣大武鄉	2018-11-24T23:35:22+08:00	486	1364	1850	323	2173	4132	52.59%	11.76%	5	6
15	臺東縣大武鄉	2018-11-24T23:43:30+08:00	636	1670	2306	399	2705	5266	51.37%	12.08%	6	6
15	臺東縣	2018-11-24T23:56:00+08:00	21951	55894	77845	7433	85278	165584	51.5%	13.26%	199	213
15	臺東縣	2018-11-24T22:58:08+08:00	15887	41128	57015	5596	62611	123649	50.64%	12.85%	168	213
15	臺東縣	2018-11-25T01:18:09+08:00	24045	60982	85027	7932	92959	180678	51.45%	13.31%	210	213
15	臺東縣	2018-11-25T03:56:27+08:00	24813	62900	87713	8135	95848	185996	51.53%	13.34%	213	213
15	臺東縣	2018-11-24T23:47:42+08:00	20972	53914	74886	7251	82137	159258	51.57%	13.17%	195	213
15	臺東縣	2018-11-24T23:12:30+08:00	17299	45051	62350	6278	68628	134646	50.97%	12.85%	176	213
15	臺東縣	2018-11-24T23:27:30+08:00	17903	46799	64702	6522	71224	138994	51.24%	12.88%	180	213
15	臺東縣	2018-11-25T06:09:09+08:00	24813	62900	87713	8135	95848	185996	51.53%	13.34%	213	213
15	臺東縣	2018-11-24T23:51:48+08:00	21227	54565	75792	7299	83091	160896	51.64%	13.19%	196	213
15	臺東縣	2018-11-24T22:30:23+08:00	12741	33113	45854	4691	50545	101405	49.84%	12.56%	147	213
15	臺東縣	2018-11-25T03:32:52+08:00	24813	62900	87713	8135	95848	185996	51.53%	13.34%	213	213
15	臺東縣	2018-11-24T22:13:44+08:00	11473	29742	41215	4235	45450	91505	49.67%	12.54%	137	213
15	臺東縣	2018-11-25T03:44:40+08:00	24813	62900	87713	8135	95848	185996	51.53%	13.34%	213	213
15	臺東縣	2018-11-25T00:57:50+08:00	24045	60982	85027	7932	92959	180678	51.45%	13.31%	210	213
15	臺東縣	2018-11-24T23:20:07+08:00	17794	46555	64349	6482	70831	138474	51.15%	12.85%	179	213
15	臺東縣	2018-11-24T22:16:25+08:00	11762	30510	42272	4298	46570	93681	49.71%	12.56%	139	213
15	臺東縣	2018-11-24T23:31:26+08:00	18908	49037	67945	6741	74686	145133	51.46%	13.03%	184	213
15	臺東縣	2018-11-24T22:37:13+08:00	13988	36084	50072	5039	55111	110051	50.08%	12.71%	155	213
15	臺東縣	2018-11-25T00:18:46+08:00	23284	58810	82094	7731	89825	174939	51.35%	13.31%	206	213
15	臺東縣	2018-11-24T23:16:15+08:00	17548	45866	63414	6423	69837	136879	51.02%	12.82%	178	213
15	臺東縣	2018-11-25T01:12:58+08:00	24045	60982	85027	7932	92959	180678	51.45%	13.31%	210	213
15	臺東縣	2018-11-25T00:05:17+08:00	22917	58041	80958	7682	88640	172351	51.43%	13.3%	204	213
15	臺東縣	2018-11-24T23:05:16+08:00	17027	44053	61080	6076	67156	131776	50.96%	12.92%	174	213
15	臺東縣	2018-11-24T23:39:32+08:00	19875	51421	71296	6972	78268	151801	51.56%	13.09%	189	213
15	臺東縣	2018-11-24T22:54:37+08:00	15835	40933	56768	5546	62314	123223	50.57%	12.85%	167	213
15	臺東縣	2018-11-24T22:33:50+08:00	13317	34410	47727	4853	52580	105140	50.01%	12.67%	150	213
15	臺東縣	2018-11-24T22:45:20+08:00	14491	37331	51822	5172	56994	113483	50.22%	12.77%	159	213
15	臺東縣	2018-11-24T22:26:48+08:00	12510	32528	45038	4557	49595	99633	49.78%	12.56%	145	213
15	臺東縣	2018-11-24T23:01:45+08:00	16301	42141	58442	5718	64160	126359	50.78%	12.9%	170	213
15	臺東縣	2018-11-25T00:09:49+08:00	22917	58041	80958	7682	88640	172351	51.43%	13.3%	204	213
15	臺東縣	2018-11-25T04:03:05+08:00	24813	62900	87713	8135	95848	185996	51.53%	13.34%	213	213
15	臺東縣	2018-11-24T23:08:51+08:00	17299	45051	62350	6278	68628	134646	50.97%	12.85%	176	213
15	臺東縣	2018-11-24T23:23:50+08:00	17903	46799	64702	6522	71224	138994	51.24%	12.88%	180	213
15	臺東縣	2018-11-24T22:19:49+08:00	12000	31147	43147	4399	47546	95534	49.77%	12.56%	141	213
15	臺東縣	2018-11-25T00:00:23+08:00	22538	57173	79711	7529	87240	169594	51.44%	13.29%	202	213
15	臺東縣	2018-11-24T22:51:03+08:00	15158	39172	54330	5366	59696	118396	50.42%	12.8%	163	213
15	臺東縣	2018-11-24T22:23:28+08:00	12000	31147	43147	4399	47546	95534	49.77%	12.56%	141	213
15	臺東縣	2018-11-24T22:40:40+08:00	14092	36344	50436	5071	55507	110652	50.16%	12.74%	156	213
15	臺東縣	2018-11-25T06:24:13+08:00	24813	62900	87713	8135	95848	185996	51.53%	13.34%	213	213
15	臺東縣	2018-11-25T01:02:44+08:00	24045	60982	85027	7932	92959	180678	51.45%	13.31%	210	213
15	臺東縣	2018-11-25T06:14:05+08:00	24813	62900	87713	8135	95848	185996	51.53%	13.34%	213	213
15	臺東縣	2018-11-25T00:23:16+08:00	23284	58810	82094	7731	89825	174939	51.35%	13.31%	206	213
15	臺東縣	2018-11-25T06:19:10+08:00	24813	62900	87713	8135	95848	185996	51.53%	13.34%	213	213
15	臺東縣	2018-11-25T06:29:30+08:00	24813	62900	87713	8135	95848	185996	51.53%	13.34%	213	213
15	臺東縣	2018-11-25T03:50:03+08:00	24813	62900	87713	8135	95848	185996	51.53%	13.34%	213	213
15	臺東縣	2018-11-25T01:07:39+08:00	24045	60982	85027	7932	92959	180678	51.45%	13.31%	210	213
15	臺東縣	2018-11-25T01:26:07+08:00	24157	61318	85475	7981	93456	181736	51.42%	13.29%	211	213
15	臺東縣	2018-11-25T03:39:07+08:00	24813	62900	87713	8135	95848	185996	51.53%	13.34%	213	213
15	臺東縣	2018-11-24T22:41:50+08:00	14092	36344	50436	5071	55507	110652	50.16%	12.74%	156	213
15	臺東縣	2018-11-25T00:14:22+08:00	22917	58041	80958	7682	88640	172351	51.43%	13.3%	204	213
15	臺東縣	2018-11-24T23:35:22+08:00	19313	50153	69466	6840	76306	148314	51.45%	13.02%	186	213
15	臺東縣	2018-11-24T23:43:30+08:00	20811	53545	74356	7203	81559	158026	51.61%	13.17%	194	213
15	連江縣	2018-11-24T23:12:31+08:00	365	957	1322	40	1362	2619	52%	13.94%	3	9
15	連江縣	2018-11-24T23:47:44+08:00	631	1768	2399	73	2472	4744	52.11%	13.3%	5	9
15	連江縣	2018-11-24T22:58:09+08:00	365	957	1322	40	1362	2619	52%	13.94%	3	9
15	連江縣	2018-11-24T23:56:01+08:00	631	1768	2399	73	2472	4744	52.11%	13.3%	5	9
15	連江縣	2018-11-25T03:56:29+08:00	1480	4110	5590	171	5761	11205	51.41%	13.21%	9	9
15	連江縣	2018-11-24T23:01:46+08:00	365	957	1322	40	1362	2619	52%	13.94%	3	9
15	連江縣	2018-11-25T03:32:53+08:00	1480	4110	5590	171	5761	11205	51.41%	13.21%	9	9
15	連江縣	2018-11-24T23:08:52+08:00	365	957	1322	40	1362	2619	52%	13.94%	3	9
15	連江縣	2018-11-24T23:51:49+08:00	631	1768	2399	73	2472	4744	52.11%	13.3%	5	9
15	連江縣	2018-11-24T22:13:45+08:00	0	0	0	0	0	0	0%	0%	0	9
15	連江縣	2018-11-25T03:44:41+08:00	1480	4110	5590	171	5761	11205	51.41%	13.21%	9	9
15	連江縣	2018-11-25T04:03:06+08:00	1480	4110	5590	171	5761	11205	51.41%	13.21%	9	9
15	連江縣	2018-11-24T23:27:31+08:00	631	1768	2399	73	2472	4744	52.11%	13.3%	5	9
15	連江縣	2018-11-24T22:30:24+08:00	96	235	331	11	342	698	49%	13.75%	1	9
15	連江縣	2018-11-24T22:19:50+08:00	0	0	0	0	0	0	0%	0%	0	9
15	連江縣	2018-11-25T06:14:06+08:00	1480	4110	5590	171	5761	11205	51.41%	13.21%	9	9
15	連江縣	2018-11-24T23:20:09+08:00	554	1556	2110	66	2176	4134	52.64%	13.4%	4	9
15	連江縣	2018-11-24T22:37:14+08:00	200	560	760	25	785	1481	53%	13.5%	2	9
15	連江縣	2018-11-24T23:31:27+08:00	631	1768	2399	73	2472	4744	52.11%	13.3%	5	9
15	連江縣	2018-11-25T00:18:48+08:00	631	1768	2399	73	2472	4744	52.11%	13.3%	5	9
15	連江縣	2018-11-25T06:29:32+08:00	1480	4110	5590	171	5761	11205	51.41%	13.21%	9	9
15	連江縣	2018-11-25T00:09:51+08:00	631	1768	2399	73	2472	4744	52.11%	13.3%	5	9
15	連江縣	2018-11-24T22:45:21+08:00	365	957	1322	40	1362	2619	52%	13.94%	3	9
15	連江縣	2018-11-24T22:54:38+08:00	365	957	1322	40	1362	2619	52%	13.94%	3	9
15	連江縣	2018-11-24T22:33:51+08:00	200	560	760	25	785	1481	53%	13.5%	2	9
15	連江縣	2018-11-24T23:39:33+08:00	631	1768	2399	73	2472	4744	52.11%	13.3%	5	9
15	連江縣	2018-11-24T22:26:49+08:00	0	0	0	0	0	0	0%	0%	0	9
15	連江縣	2018-11-25T01:07:40+08:00	1480	4110	5590	171	5761	11205	51.41%	13.21%	9	9
15	連江縣	2018-11-25T01:12:59+08:00	1480	4110	5590	171	5761	11205	51.41%	13.21%	9	9
15	連江縣	2018-11-25T00:05:18+08:00	631	1768	2399	73	2472	4744	52.11%	13.3%	5	9
15	連江縣	2018-11-24T23:05:17+08:00	365	957	1322	40	1362	2619	52%	13.94%	3	9
15	連江縣	2018-11-24T23:23:51+08:00	631	1768	2399	73	2472	4744	52.11%	13.3%	5	9
15	連江縣	2018-11-24T22:23:29+08:00	0	0	0	0	0	0	0%	0%	0	9
15	連江縣	2018-11-25T00:00:24+08:00	631	1768	2399	73	2472	4744	52.11%	13.3%	5	9
15	連江縣	2018-11-25T01:02:45+08:00	1314	3487	4801	157	4958	9662	51.31%	13.6%	8	9
15	連江縣	2018-11-24T22:40:41+08:00	200	560	760	25	785	1481	53%	13.5%	2	9
15	連江縣	2018-11-25T00:57:52+08:00	1151	3080	4231	139	4370	8548	51.12%	13.47%	7	9
15	連江縣	2018-11-24T22:51:04+08:00	365	957	1322	40	1362	2619	52%	13.94%	3	9
15	連江縣	2018-11-25T06:09:10+08:00	1480	4110	5590	171	5761	11205	51.41%	13.21%	9	9
15	連江縣	2018-11-25T06:24:14+08:00	1480	4110	5590	171	5761	11205	51.41%	13.21%	9	9
15	連江縣	2018-11-25T00:23:18+08:00	631	1768	2399	73	2472	4744	52.11%	13.3%	5	9
15	連江縣	2018-11-24T23:35:23+08:00	631	1768	2399	73	2472	4744	52.11%	13.3%	5	9
15	連江縣	2018-11-25T00:14:24+08:00	631	1768	2399	73	2472	4744	52.11%	13.3%	5	9
15	連江縣	2018-11-25T03:50:04+08:00	1480	4110	5590	171	5761	11205	51.41%	13.21%	9	9
15	連江縣	2018-11-24T22:16:26+08:00	0	0	0	0	0	0	0%	0%	0	9
15	連江縣	2018-11-24T23:43:31+08:00	631	1768	2399	73	2472	4744	52.11%	13.3%	5	9
15	連江縣	2018-11-25T01:18:11+08:00	1480	4110	5590	171	5761	11205	51.41%	13.21%	9	9
15	連江縣	2018-11-24T23:16:16+08:00	554	1556	2110	66	2176	4134	52.64%	13.4%	4	9
15	連江縣	2018-11-25T06:19:11+08:00	1480	4110	5590	171	5761	11205	51.41%	13.21%	9	9
15	連江縣	2018-11-24T22:41:51+08:00	200	560	760	25	785	1481	53%	13.5%	2	9
15	連江縣	2018-11-25T03:39:08+08:00	1480	4110	5590	171	5761	11205	51.41%	13.21%	9	9
15	連江縣	2018-11-25T01:26:08+08:00	1480	4110	5590	171	5761	11205	51.41%	13.21%	9	9
15	雲林縣水林鄉	2018-11-25T01:18:06+08:00	2689	6034	8723	1040	9763	22508	43.38%	11.95%	26	26
15	雲林縣水林鄉	2018-11-25T06:29:28+08:00	2689	6034	8723	1040	9763	22508	43.38%	11.95%	26	26
15	雲林縣水林鄉	2018-11-25T01:12:55+08:00	2689	6034	8723	1040	9763	22508	43.38%	11.95%	26	26
15	雲林縣水林鄉	2018-11-24T23:05:13+08:00	2689	6034	8723	1040	9763	22508	43.38%	11.95%	26	26
15	雲林縣水林鄉	2018-11-25T06:19:07+08:00	2689	6034	8723	1040	9763	22508	43.38%	11.95%	26	26
15	雲林縣水林鄉	2018-11-25T00:05:15+08:00	2689	6034	8723	1040	9763	22508	43.38%	11.95%	26	26
15	雲林縣水林鄉	2018-11-24T22:26:45+08:00	2689	6034	8723	1040	9763	22508	43.38%	11.95%	26	26
15	雲林縣水林鄉	2018-11-24T22:54:34+08:00	2689	6034	8723	1040	9763	22508	43.38%	11.95%	26	26
15	雲林縣水林鄉	2018-11-24T22:41:47+08:00	2689	6034	8723	1040	9763	22508	43.38%	11.95%	26	26
15	雲林縣水林鄉	2018-11-24T23:43:26+08:00	2689	6034	8723	1040	9763	22508	43.38%	11.95%	26	26
15	雲林縣水林鄉	2018-11-24T22:50:59+08:00	2689	6034	8723	1040	9763	22508	43.38%	11.95%	26	26
15	雲林縣水林鄉	2018-11-25T00:00:20+08:00	2689	6034	8723	1040	9763	22508	43.38%	11.95%	26	26
15	雲林縣水林鄉	2018-11-25T01:02:41+08:00	2689	6034	8723	1040	9763	22508	43.38%	11.95%	26	26
15	雲林縣水林鄉	2018-11-25T00:23:14+08:00	2689	6034	8723	1040	9763	22508	43.38%	11.95%	26	26
15	雲林縣水林鄉	2018-11-25T03:32:48+08:00	2689	6034	8723	1040	9763	22508	43.38%	11.95%	26	26
15	雲林縣水林鄉	2018-11-25T03:44:36+08:00	2689	6034	8723	1040	9763	22508	43.38%	11.95%	26	26
15	雲林縣水林鄉	2018-11-24T23:08:47+08:00	2689	6034	8723	1040	9763	22508	43.38%	11.95%	26	26
15	雲林縣水林鄉	2018-11-25T06:24:10+08:00	2689	6034	8723	1040	9763	22508	43.38%	11.95%	26	26
15	雲林縣水林鄉	2018-11-24T22:23:25+08:00	2689	6034	8723	1040	9763	22508	43.38%	11.95%	26	26
15	雲林縣水林鄉	2018-11-24T23:23:47+08:00	2689	6034	8723	1040	9763	22508	43.38%	11.95%	26	26
15	雲林縣水林鄉	2018-11-25T03:50:00+08:00	2689	6034	8723	1040	9763	22508	43.38%	11.95%	26	26
15	雲林縣水林鄉	2018-11-24T22:33:47+08:00	2689	6034	8723	1040	9763	22508	43.38%	11.95%	26	26
15	雲林縣水林鄉	2018-11-24T22:16:22+08:00	2689	6034	8723	1040	9763	22508	43.38%	11.95%	26	26
15	雲林縣水林鄉	2018-11-25T01:26:03+08:00	2689	6034	8723	1040	9763	22508	43.38%	11.95%	26	26
15	雲林縣水林鄉	2018-11-25T03:39:04+08:00	2689	6034	8723	1040	9763	22508	43.38%	11.95%	26	26
15	雲林縣水林鄉	2018-11-24T23:16:13+08:00	2689	6034	8723	1040	9763	22508	43.38%	11.95%	26	26
15	雲林縣水林鄉	2018-11-25T00:14:20+08:00	2689	6034	8723	1040	9763	22508	43.38%	11.95%	26	26
15	雲林縣水林鄉	2018-11-24T23:35:19+08:00	2689	6034	8723	1040	9763	22508	43.38%	11.95%	26	26
15	雲林縣水林鄉	2018-11-24T23:47:40+08:00	2689	6034	8723	1040	9763	22508	43.38%	11.95%	26	26
15	雲林縣水林鄉	2018-11-24T22:45:17+08:00	2689	6034	8723	1040	9763	22508	43.38%	11.95%	26	26
15	雲林縣水林鄉	2018-11-24T22:58:05+08:00	2689	6034	8723	1040	9763	22508	43.38%	11.95%	26	26
15	雲林縣水林鄉	2018-11-25T00:09:46+08:00	2689	6034	8723	1040	9763	22508	43.38%	11.95%	26	26
15	雲林縣水林鄉	2018-11-25T03:56:24+08:00	2689	6034	8723	1040	9763	22508	43.38%	11.95%	26	26
15	雲林縣水林鄉	2018-11-24T23:01:42+08:00	2689	6034	8723	1040	9763	22508	43.38%	11.95%	26	26
15	雲林縣水林鄉	2018-11-25T00:57:47+08:00	2689	6034	8723	1040	9763	22508	43.38%	11.95%	26	26
15	雲林縣水林鄉	2018-11-24T22:19:46+08:00	2689	6034	8723	1040	9763	22508	43.38%	11.95%	26	26
15	雲林縣水林鄉	2018-11-24T22:13:41+08:00	2577	5747	8324	940	9264	21453	43.18%	12.01%	25	26
15	雲林縣水林鄉	2018-11-25T04:03:02+08:00	2689	6034	8723	1040	9763	22508	43.38%	11.95%	26	26
15	雲林縣水林鄉	2018-11-24T22:40:37+08:00	2689	6034	8723	1040	9763	22508	43.38%	11.95%	26	26
15	雲林縣水林鄉	2018-11-24T23:51:45+08:00	2689	6034	8723	1040	9763	22508	43.38%	11.95%	26	26
15	雲林縣水林鄉	2018-11-24T22:30:20+08:00	2689	6034	8723	1040	9763	22508	43.38%	11.95%	26	26
15	雲林縣水林鄉	2018-11-25T06:09:05+08:00	2689	6034	8723	1040	9763	22508	43.38%	11.95%	26	26
15	雲林縣水林鄉	2018-11-24T23:55:57+08:00	2689	6034	8723	1040	9763	22508	43.38%	11.95%	26	26
15	雲林縣水林鄉	2018-11-24T23:27:27+08:00	2689	6034	8723	1040	9763	22508	43.38%	11.95%	26	26
15	雲林縣水林鄉	2018-11-25T06:14:02+08:00	2689	6034	8723	1040	9763	22508	43.38%	11.95%	26	26
15	雲林縣水林鄉	2018-11-25T00:18:43+08:00	2689	6034	8723	1040	9763	22508	43.38%	11.95%	26	26
15	雲林縣水林鄉	2018-11-24T23:12:27+08:00	2689	6034	8723	1040	9763	22508	43.38%	11.95%	26	26
15	雲林縣水林鄉	2018-11-24T23:39:28+08:00	2689	6034	8723	1040	9763	22508	43.38%	11.95%	26	26
15	雲林縣水林鄉	2018-11-24T22:37:11+08:00	2689	6034	8723	1040	9763	22508	43.38%	11.95%	26	26
15	雲林縣水林鄉	2018-11-24T23:31:23+08:00	2689	6034	8723	1040	9763	22508	43.38%	11.95%	26	26
15	雲林縣水林鄉	2018-11-24T23:20:02+08:00	2689	6034	8723	1040	9763	22508	43.38%	11.95%	26	26
15	雲林縣水林鄉	2018-11-25T01:07:36+08:00	2689	6034	8723	1040	9763	22508	43.38%	11.95%	26	26
15	宜蘭縣南澳鄉	2018-11-24T23:56:00+08:00	430	1613	2043	122	2165	3682	58.8%	11.68%	6	7
15	宜蘭縣南澳鄉	2018-11-24T23:05:15+08:00	292	1149	1441	98	1539	2472	62.26%	11.81%	5	7
15	宜蘭縣南澳鄉	2018-11-25T01:18:08+08:00	538	2088	2626	183	2809	4644	60.49%	11.58%	7	7
15	宜蘭縣南澳鄉	2018-11-24T23:43:29+08:00	430	1613	2043	122	2165	3682	58.8%	11.68%	6	7
15	宜蘭縣南澳鄉	2018-11-25T03:56:27+08:00	538	2088	2626	183	2809	4644	60.49%	11.58%	7	7
15	宜蘭縣南澳鄉	2018-11-25T06:19:09+08:00	538	2088	2626	183	2809	4644	60.49%	11.58%	7	7
15	宜蘭縣南澳鄉	2018-11-24T22:58:07+08:00	292	1149	1441	98	1539	2472	62.26%	11.81%	5	7
15	宜蘭縣南澳鄉	2018-11-24T22:41:49+08:00	127	451	578	42	620	919	67.46%	13.82%	2	7
15	宜蘭縣南澳鄉	2018-11-24T23:39:31+08:00	430	1613	2043	122	2165	3682	58.8%	11.68%	6	7
15	宜蘭縣南澳鄉	2018-11-24T23:47:42+08:00	430	1613	2043	122	2165	3682	58.8%	11.68%	6	7
15	宜蘭縣南澳鄉	2018-11-24T22:30:22+08:00	127	451	578	42	620	919	67.46%	13.82%	2	7
15	宜蘭縣南澳鄉	2018-11-24T23:51:47+08:00	430	1613	2043	122	2165	3682	58.8%	11.68%	6	7
15	宜蘭縣南澳鄉	2018-11-25T06:09:08+08:00	538	2088	2626	183	2809	4644	60.49%	11.58%	7	7
15	宜蘭縣南澳鄉	2018-11-24T22:13:43+08:00	127	451	578	42	620	919	67.46%	13.82%	2	7
15	宜蘭縣南澳鄉	2018-11-25T00:57:50+08:00	538	2088	2626	183	2809	4644	60.49%	11.58%	7	7
15	宜蘭縣南澳鄉	2018-11-25T03:44:39+08:00	538	2088	2626	183	2809	4644	60.49%	11.58%	7	7
15	宜蘭縣南澳鄉	2018-11-24T23:31:26+08:00	430	1613	2043	122	2165	3682	58.8%	11.68%	6	7
15	宜蘭縣南澳鄉	2018-11-24T22:33:49+08:00	127	451	578	42	620	919	67.46%	13.82%	2	7
15	宜蘭縣南澳鄉	2018-11-24T22:37:13+08:00	127	451	578	42	620	919	67.46%	13.82%	2	7
15	宜蘭縣南澳鄉	2018-11-24T22:16:24+08:00	127	451	578	42	620	919	67.46%	13.82%	2	7
15	宜蘭縣南澳鄉	2018-11-25T00:18:46+08:00	538	2088	2626	183	2809	4644	60.49%	11.58%	7	7
15	宜蘭縣南澳鄉	2018-11-24T23:35:21+08:00	430	1613	2043	122	2165	3682	58.8%	11.68%	6	7
15	宜蘭縣南澳鄉	2018-11-24T23:16:15+08:00	292	1149	1441	98	1539	2472	62.26%	11.81%	5	7
15	宜蘭縣南澳鄉	2018-11-24T22:45:19+08:00	163	603	766	47	813	1330	61.13%	12.26%	3	7
15	宜蘭縣南澳鄉	2018-11-24T22:54:36+08:00	292	1149	1441	98	1539	2472	62.26%	11.81%	5	7
15	宜蘭縣南澳鄉	2018-11-24T23:01:44+08:00	292	1149	1441	98	1539	2472	62.26%	11.81%	5	7
15	宜蘭縣南澳鄉	2018-11-25T00:05:17+08:00	430	1613	2043	122	2165	3682	58.8%	11.68%	6	7
15	宜蘭縣南澳鄉	2018-11-25T01:12:57+08:00	538	2088	2626	183	2809	4644	60.49%	11.58%	7	7
15	宜蘭縣南澳鄉	2018-11-24T22:26:48+08:00	127	451	578	42	620	919	67.46%	13.82%	2	7
15	宜蘭縣南澳鄉	2018-11-25T00:09:49+08:00	430	1613	2043	122	2165	3682	58.8%	11.68%	6	7
15	宜蘭縣南澳鄉	2018-11-24T23:23:50+08:00	292	1149	1441	98	1539	2472	62.26%	11.81%	5	7
15	宜蘭縣南澳鄉	2018-11-24T22:19:49+08:00	127	451	578	42	620	919	67.46%	13.82%	2	7
15	宜蘭縣南澳鄉	2018-11-25T04:03:04+08:00	538	2088	2626	183	2809	4644	60.49%	11.58%	7	7
15	宜蘭縣南澳鄉	2018-11-24T22:40:39+08:00	127	451	578	42	620	919	67.46%	13.82%	2	7
15	宜蘭縣南澳鄉	2018-11-25T03:32:51+08:00	538	2088	2626	183	2809	4644	60.49%	11.58%	7	7
15	宜蘭縣南澳鄉	2018-11-24T23:08:50+08:00	292	1149	1441	98	1539	2472	62.26%	11.81%	5	7
15	宜蘭縣南澳鄉	2018-11-24T22:23:27+08:00	127	451	578	42	620	919	67.46%	13.82%	2	7
15	宜蘭縣南澳鄉	2018-11-24T22:51:02+08:00	292	1149	1441	98	1539	2472	62.26%	11.81%	5	7
15	宜蘭縣南澳鄉	2018-11-25T06:14:04+08:00	538	2088	2626	183	2809	4644	60.49%	11.58%	7	7
15	宜蘭縣南澳鄉	2018-11-25T00:00:23+08:00	430	1613	2043	122	2165	3682	58.8%	11.68%	6	7
15	宜蘭縣南澳鄉	2018-11-25T06:24:12+08:00	538	2088	2626	183	2809	4644	60.49%	11.58%	7	7
15	宜蘭縣南澳鄉	2018-11-24T23:27:29+08:00	292	1149	1441	98	1539	2472	62.26%	11.81%	5	7
15	宜蘭縣南澳鄉	2018-11-25T00:23:16+08:00	538	2088	2626	183	2809	4644	60.49%	11.58%	7	7
15	宜蘭縣南澳鄉	2018-11-25T01:02:43+08:00	538	2088	2626	183	2809	4644	60.49%	11.58%	7	7
15	宜蘭縣南澳鄉	2018-11-25T06:29:30+08:00	538	2088	2626	183	2809	4644	60.49%	11.58%	7	7
15	宜蘭縣南澳鄉	2018-11-24T23:12:29+08:00	292	1149	1441	98	1539	2472	62.26%	11.81%	5	7
15	宜蘭縣南澳鄉	2018-11-25T03:50:03+08:00	538	2088	2626	183	2809	4644	60.49%	11.58%	7	7
15	宜蘭縣南澳鄉	2018-11-25T01:07:39+08:00	538	2088	2626	183	2809	4644	60.49%	11.58%	7	7
15	宜蘭縣南澳鄉	2018-11-25T01:26:07+08:00	538	2088	2626	183	2809	4644	60.49%	11.58%	7	7
15	宜蘭縣南澳鄉	2018-11-25T00:14:22+08:00	538	2088	2626	183	2809	4644	60.49%	11.58%	7	7
15	宜蘭縣南澳鄉	2018-11-25T03:39:06+08:00	538	2088	2626	183	2809	4644	60.49%	11.58%	7	7
15	宜蘭縣南澳鄉	2018-11-24T23:20:05+08:00	292	1149	1441	98	1539	2472	62.26%	11.81%	5	7
15	宜蘭縣羅東鎮	2018-11-25T03:56:26+08:00	11312	19797	31109	2002	33111	57686	57.4%	19.61%	50	50
15	宜蘭縣羅東鎮	2018-11-24T23:05:15+08:00	9907	17263	27170	1743	28913	50137	57.67%	19.76%	45	50
15	宜蘭縣羅東鎮	2018-11-25T01:18:08+08:00	11312	19797	31109	2002	33111	57686	57.4%	19.61%	50	50
15	宜蘭縣羅東鎮	2018-11-24T23:43:29+08:00	11312	19797	31109	2002	33111	57686	57.4%	19.61%	50	50
15	宜蘭縣羅東鎮	2018-11-25T06:19:09+08:00	11312	19797	31109	2002	33111	57686	57.4%	19.61%	50	50
15	宜蘭縣羅東鎮	2018-11-24T22:58:07+08:00	9907	17263	27170	1743	28913	50137	57.67%	19.76%	45	50
15	宜蘭縣羅東鎮	2018-11-24T22:41:49+08:00	8933	15595	24528	1505	26033	45149	57.66%	19.79%	41	50
15	宜蘭縣羅東鎮	2018-11-24T23:39:31+08:00	10728	18755	29483	1898	31381	54440	57.64%	19.71%	48	50
15	宜蘭縣羅東鎮	2018-11-24T23:47:42+08:00	11312	19797	31109	2002	33111	57686	57.4%	19.61%	50	50
15	宜蘭縣羅東鎮	2018-11-24T22:30:22+08:00	8201	14193	22394	1393	23787	41448	57.39%	19.79%	38	50
15	宜蘭縣羅東鎮	2018-11-24T23:51:47+08:00	11312	19797	31109	2002	33111	57686	57.4%	19.61%	50	50
15	宜蘭縣羅東鎮	2018-11-25T06:09:08+08:00	11312	19797	31109	2002	33111	57686	57.4%	19.61%	50	50
15	宜蘭縣羅東鎮	2018-11-24T22:13:43+08:00	6623	11423	18046	1105	19151	33471	57.22%	19.79%	32	50
15	宜蘭縣羅東鎮	2018-11-25T03:44:39+08:00	11312	19797	31109	2002	33111	57686	57.4%	19.61%	50	50
15	宜蘭縣羅東鎮	2018-11-24T23:23:49+08:00	10458	18249	28707	1855	30562	53010	57.65%	19.73%	47	50
15	宜蘭縣羅東鎮	2018-11-24T22:33:49+08:00	8703	15151	23854	1465	25319	44010	57.53%	19.78%	40	50
15	宜蘭縣羅東鎮	2018-11-24T22:37:12+08:00	8703	15151	23854	1465	25319	44010	57.53%	19.78%	40	50
15	宜蘭縣羅東鎮	2018-11-24T23:16:14+08:00	10458	18249	28707	1855	30562	53010	57.65%	19.73%	47	50
15	宜蘭縣羅東鎮	2018-11-24T22:16:24+08:00	6623	11423	18046	1105	19151	33471	57.22%	19.79%	32	50
15	宜蘭縣羅東鎮	2018-11-24T23:35:21+08:00	10728	18755	29483	1898	31381	54440	57.64%	19.71%	48	50
15	宜蘭縣羅東鎮	2018-11-24T22:45:19+08:00	9401	16329	25730	1604	27334	47452	57.6%	19.81%	43	50
15	宜蘭縣羅東鎮	2018-11-24T22:54:36+08:00	9907	17263	27170	1743	28913	50137	57.67%	19.76%	45	50
15	宜蘭縣羅東鎮	2018-11-25T00:09:48+08:00	11312	19797	31109	2002	33111	57686	57.4%	19.61%	50	50
15	宜蘭縣羅東鎮	2018-11-24T23:01:44+08:00	9907	17263	27170	1743	28913	50137	57.67%	19.76%	45	50
15	宜蘭縣羅東鎮	2018-11-24T22:26:47+08:00	7964	13798	21762	1330	23092	40160	57.5%	19.83%	37	50
15	宜蘭縣羅東鎮	2018-11-25T01:12:57+08:00	11312	19797	31109	2002	33111	57686	57.4%	19.61%	50	50
15	宜蘭縣羅東鎮	2018-11-25T00:05:16+08:00	11312	19797	31109	2002	33111	57686	57.4%	19.61%	50	50
15	宜蘭縣羅東鎮	2018-11-25T00:57:49+08:00	11312	19797	31109	2002	33111	57686	57.4%	19.61%	50	50
15	宜蘭縣羅東鎮	2018-11-24T22:19:48+08:00	6823	11769	18592	1151	19743	34456	57.3%	19.8%	33	50
15	宜蘭縣羅東鎮	2018-11-25T03:32:50+08:00	11312	19797	31109	2002	33111	57686	57.4%	19.61%	50	50
15	宜蘭縣羅東鎮	2018-11-25T04:03:04+08:00	11312	19797	31109	2002	33111	57686	57.4%	19.61%	50	50
15	宜蘭縣羅東鎮	2018-11-24T22:40:39+08:00	8933	15595	24528	1505	26033	45149	57.66%	19.79%	41	50
15	宜蘭縣羅東鎮	2018-11-24T23:08:50+08:00	9907	17263	27170	1743	28913	50137	57.67%	19.76%	45	50
15	宜蘭縣羅東鎮	2018-11-24T22:23:27+08:00	7391	12790	20181	1258	21439	37242	57.57%	19.85%	35	50
15	宜蘭縣羅東鎮	2018-11-24T22:51:02+08:00	9401	16329	25730	1604	27334	47452	57.6%	19.81%	43	50
15	宜蘭縣羅東鎮	2018-11-25T06:14:04+08:00	11312	19797	31109	2002	33111	57686	57.4%	19.61%	50	50
15	宜蘭縣羅東鎮	2018-11-24T23:55:59+08:00	11312	19797	31109	2002	33111	57686	57.4%	19.61%	50	50
15	宜蘭縣羅東鎮	2018-11-25T06:24:12+08:00	11312	19797	31109	2002	33111	57686	57.4%	19.61%	50	50
15	宜蘭縣羅東鎮	2018-11-24T23:27:29+08:00	10458	18249	28707	1855	30562	53010	57.65%	19.73%	47	50
15	宜蘭縣羅東鎮	2018-11-25T00:00:22+08:00	11312	19797	31109	2002	33111	57686	57.4%	19.61%	50	50
15	宜蘭縣羅東鎮	2018-11-25T00:23:16+08:00	11312	19797	31109	2002	33111	57686	57.4%	19.61%	50	50
15	宜蘭縣羅東鎮	2018-11-25T01:02:43+08:00	11312	19797	31109	2002	33111	57686	57.4%	19.61%	50	50
15	宜蘭縣羅東鎮	2018-11-25T06:29:30+08:00	11312	19797	31109	2002	33111	57686	57.4%	19.61%	50	50
15	宜蘭縣羅東鎮	2018-11-24T23:12:29+08:00	9907	17263	27170	1743	28913	50137	57.67%	19.76%	45	50
15	宜蘭縣羅東鎮	2018-11-24T23:31:25+08:00	10728	18755	29483	1898	31381	54440	57.64%	19.71%	48	50
15	宜蘭縣羅東鎮	2018-11-24T23:20:04+08:00	10458	18249	28707	1855	30562	53010	57.65%	19.73%	47	50
15	宜蘭縣羅東鎮	2018-11-25T00:14:22+08:00	11312	19797	31109	2002	33111	57686	57.4%	19.61%	50	50
15	宜蘭縣羅東鎮	2018-11-25T00:18:45+08:00	11312	19797	31109	2002	33111	57686	57.4%	19.61%	50	50
15	宜蘭縣羅東鎮	2018-11-25T01:07:38+08:00	11312	19797	31109	2002	33111	57686	57.4%	19.61%	50	50
15	宜蘭縣羅東鎮	2018-11-25T03:39:06+08:00	11312	19797	31109	2002	33111	57686	57.4%	19.61%	50	50
15	宜蘭縣羅東鎮	2018-11-25T01:26:06+08:00	11312	19797	31109	2002	33111	57686	57.4%	19.61%	50	50
15	宜蘭縣羅東鎮	2018-11-25T03:50:02+08:00	11312	19797	31109	2002	33111	57686	57.4%	19.61%	50	50
15	桃園市龜山區	2018-11-24T23:16:06+08:00	11444	21680	33124	1807	34931	71603	48.78%	15.98%	46	78
15	桃園市龜山區	2018-11-24T23:43:20+08:00	13793	25598	39391	2037	41428	84540	49%	16.32%	53	78
15	桃園市龜山區	2018-11-25T06:19:00+08:00	22419	39443	61862	3057	64919	131702	49.29%	17.02%	78	78
15	桃園市龜山區	2018-11-25T06:29:20+08:00	22419	39443	61862	3057	64919	131702	49.29%	17.02%	78	78
15	桃園市龜山區	2018-11-25T03:49:54+08:00	22419	39443	61862	3057	64919	131702	49.29%	17.02%	78	78
15	桃園市龜山區	2018-11-25T03:56:16+08:00	22419	39443	61862	3057	64919	131702	49.29%	17.02%	78	78
15	桃園市龜山區	2018-11-24T22:30:13+08:00	8174	15591	23765	1302	25067	51777	48.41%	15.79%	35	78
15	桃園市龜山區	2018-11-25T06:24:03+08:00	22419	39443	61862	3057	64919	131702	49.29%	17.02%	78	78
15	桃園市龜山區	2018-11-25T03:32:38+08:00	22419	39443	61862	3057	64919	131702	49.29%	17.02%	78	78
15	桃園市龜山區	2018-11-25T01:25:56+08:00	20478	35828	56306	2841	59147	119685	49.42%	17.11%	72	78
15	桃園市龜山區	2018-11-25T00:23:07+08:00	15819	29227	45046	2283	47329	96298	49.15%	16.43%	59	78
15	桃園市龜山區	2018-11-24T23:51:39+08:00	13793	25598	39391	2037	41428	84540	49%	16.32%	53	78
15	桃園市龜山區	2018-11-24T22:13:32+08:00	7060	13659	20719	1168	21887	45054	48.58%	15.67%	31	78
15	桃園市龜山區	2018-11-24T23:23:41+08:00	12596	23570	36166	1919	38085	78114	48.76%	16.13%	49	78
15	桃園市龜山區	2018-11-25T01:17:57+08:00	20478	35828	56306	2841	59147	119685	49.42%	17.11%	72	78
15	桃園市龜山區	2018-11-24T23:08:40+08:00	10874	20592	31466	1697	33163	67737	48.96%	16.05%	44	78
15	桃園市龜山區	2018-11-24T22:57:58+08:00	10217	19225	29442	1591	31033	63486	48.88%	16.09%	42	78
15	桃園市龜山區	2018-11-25T06:08:57+08:00	22419	39443	61862	3057	64919	131702	49.29%	17.02%	78	78
15	桃園市龜山區	2018-11-24T22:54:29+08:00	9966	18519	28485	1531	30016	61601	48.73%	16.18%	41	78
15	桃園市龜山區	2018-11-25T01:12:47+08:00	19716	34880	54596	2770	57366	116297	49.33%	16.95%	70	78
15	桃園市龜山區	2018-11-24T22:16:14+08:00	7060	13659	20719	1168	21887	45054	48.58%	15.67%	31	78
15	桃園市龜山區	2018-11-25T00:05:08+08:00	15025	27920	42945	2184	45129	91998	49.05%	16.33%	57	78
15	桃園市龜山區	2018-11-24T23:05:07+08:00	10874	20592	31466	1697	33163	67737	48.96%	16.05%	44	78
15	桃園市龜山區	2018-11-25T04:02:56+08:00	22419	39443	61862	3057	64919	131702	49.29%	17.02%	78	78
15	桃園市龜山區	2018-11-24T22:33:41+08:00	8420	16014	24434	1359	25793	53275	48.41%	15.8%	36	78
15	桃園市龜山區	2018-11-24T23:47:32+08:00	13793	25598	39391	2037	41428	84540	49%	16.32%	53	78
15	桃園市龜山區	2018-11-24T22:41:39+08:00	8727	16582	25309	1385	26694	54815	48.7%	15.92%	37	78
15	桃園市龜山區	2018-11-24T22:37:04+08:00	8420	16014	24434	1359	25793	53275	48.41%	15.8%	36	78
15	桃園市龜山區	2018-11-24T22:50:52+08:00	9067	17149	26216	1427	27643	56774	48.69%	15.97%	38	78
15	桃園市龜山區	2018-11-25T06:13:56+08:00	22419	39443	61862	3057	64919	131702	49.29%	17.02%	78	78
15	桃園市龜山區	2018-11-24T22:26:40+08:00	7676	14616	22292	1213	23505	48191	48.77%	15.93%	33	78
15	桃園市龜山區	2018-11-24T22:45:11+08:00	9067	17149	26216	1427	27643	56774	48.69%	15.97%	38	78
15	桃園市龜山區	2018-11-25T00:18:35+08:00	15435	28675	44110	2242	46352	94278	49.17%	16.37%	58	78
15	桃園市龜山區	2018-11-25T00:57:40+08:00	18810	33355	52165	2662	54827	110981	49.4%	16.95%	67	78
15	桃園市龜山區	2018-11-24T22:40:31+08:00	8727	16582	25309	1385	26694	54815	48.7%	15.92%	37	78
15	桃園市龜山區	2018-11-25T03:44:27+08:00	22419	39443	61862	3057	64919	131702	49.29%	17.02%	78	78
15	桃園市龜山區	2018-11-24T22:19:40+08:00	7060	13659	20719	1168	21887	45054	48.58%	15.67%	31	78
15	桃園市龜山區	2018-11-25T01:02:34+08:00	19123	33838	52961	2704	55665	112924	49.29%	16.93%	68	78
15	桃園市龜山區	2018-11-25T03:38:58+08:00	22419	39443	61862	3057	64919	131702	49.29%	17.02%	78	78
15	桃園市龜山區	2018-11-24T23:27:21+08:00	12596	23570	36166	1919	38085	78114	48.76%	16.13%	49	78
15	桃園市龜山區	2018-11-24T23:55:50+08:00	14689	27189	41878	2123	44001	89820	48.99%	16.35%	56	78
15	桃園市龜山區	2018-11-24T22:23:17+08:00	7335	14085	21420	1196	22616	46373	48.77%	15.82%	32	78
15	桃園市龜山區	2018-11-24T23:19:55+08:00	11880	22392	34272	1843	36115	73832	48.92%	16.09%	47	78
15	桃園市龜山區	2018-11-25T00:00:14+08:00	14689	27189	41878	2123	44001	89820	48.99%	16.35%	56	78
15	桃園市龜山區	2018-11-25T01:07:30+08:00	19323	34245	53568	2748	56316	114152	49.33%	16.93%	69	78
15	桃園市龜山區	2018-11-25T00:09:38+08:00	15435	28675	44110	2242	46352	94278	49.17%	16.37%	58	78
15	桃園市龜山區	2018-11-24T23:01:34+08:00	10599	19858	30457	1632	32089	65723	48.82%	16.13%	43	78
15	桃園市龜山區	2018-11-24T23:35:14+08:00	12862	24029	36891	1940	38831	79569	48.8%	16.16%	50	78
15	桃園市龜山區	2018-11-25T00:14:13+08:00	15435	28675	44110	2242	46352	94278	49.17%	16.37%	58	78
15	桃園市龜山區	2018-11-24T23:12:19+08:00	11172	21124	32296	1745	34041	69851	48.73%	15.99%	45	78
15	桃園市龜山區	2018-11-24T23:31:15+08:00	12862	24029	36891	1940	38831	79569	48.8%	16.16%	50	78
15	桃園市龜山區	2018-11-24T23:39:20+08:00	13189	24592	37781	1976	39757	81373	48.86%	16.21%	51	78
15	臺南市永康區	2018-11-24T23:16:08+08:00	33619	61909	95528	4434	99962	191857	52.1%	17.52%	140	142
15	臺南市永康區	2018-11-25T03:56:19+08:00	34171	62863	97034	4478	101512	195001	52.06%	17.52%	142	142
15	臺南市永康區	2018-11-25T00:18:37+08:00	33875	62403	96278	4453	100731	193411	52.08%	17.51%	141	142
15	臺南市永康區	2018-11-24T22:45:13+08:00	31709	58131	89840	4193	94033	180346	52.14%	17.58%	132	142
15	臺南市永康區	2018-11-24T22:58:00+08:00	32615	59555	92170	4260	96430	185206	52.07%	17.61%	135	142
15	臺南市永康區	2018-11-24T22:26:42+08:00	28763	52959	81722	3757	85479	163535	52.27%	17.59%	121	142
15	臺南市永康區	2018-11-25T01:18:00+08:00	34171	62863	97034	4478	101512	195001	52.06%	17.52%	142	142
15	臺南市永康區	2018-11-24T22:37:06+08:00	30936	56678	87614	4080	91694	175753	52.17%	17.6%	129	142
15	臺南市永康區	2018-11-25T06:09:00+08:00	34171	62863	97034	4478	101512	195001	52.06%	17.52%	142	142
15	臺南市永康區	2018-11-25T00:57:43+08:00	34171	62863	97034	4478	101512	195001	52.06%	17.52%	142	142
15	臺南市永康區	2018-11-24T22:19:42+08:00	27346	50406	77752	3598	81350	155304	52.38%	17.61%	116	142
15	臺南市永康區	2018-11-25T01:25:58+08:00	34171	62863	97034	4478	101512	195001	52.06%	17.52%	142	142
15	臺南市永康區	2018-11-24T22:30:15+08:00	29259	53801	83060	3840	86900	166223	52.28%	17.6%	123	142
15	臺南市永康區	2018-11-25T01:02:37+08:00	34171	62863	97034	4478	101512	195001	52.06%	17.52%	142	142
15	臺南市永康區	2018-11-24T22:40:33+08:00	30936	56678	87614	4080	91694	175753	52.17%	17.6%	129	142
15	臺南市永康區	2018-11-24T23:51:41+08:00	33619	61909	95528	4434	99962	191857	52.1%	17.52%	140	142
15	臺南市永康區	2018-11-25T00:23:09+08:00	33875	62403	96278	4453	100731	193411	52.08%	17.51%	141	142
15	臺南市永康區	2018-11-25T00:00:16+08:00	33875	62403	96278	4453	100731	193411	52.08%	17.51%	141	142
15	臺南市永康區	2018-11-24T22:13:35+08:00	25300	46944	72244	3357	75601	144377	52.36%	17.52%	109	142
15	臺南市永康區	2018-11-24T23:55:52+08:00	33619	61909	95528	4434	99962	191857	52.1%	17.52%	140	142
15	臺南市永康區	2018-11-24T23:19:58+08:00	33619	61909	95528	4434	99962	191857	52.1%	17.52%	140	142
15	臺南市永康區	2018-11-24T23:27:23+08:00	33619	61909	95528	4434	99962	191857	52.1%	17.52%	140	142
15	臺南市永康區	2018-11-25T03:44:30+08:00	34171	62863	97034	4478	101512	195001	52.06%	17.52%	142	142
15	臺南市永康區	2018-11-24T23:01:37+08:00	33004	60645	93649	4348	97997	187919	52.15%	17.56%	137	142
15	臺南市永康區	2018-11-25T04:02:58+08:00	34171	62863	97034	4478	101512	195001	52.06%	17.52%	142	142
15	臺南市永康區	2018-11-25T00:14:16+08:00	33875	62403	96278	4453	100731	193411	52.08%	17.51%	141	142
15	臺南市永康區	2018-11-24T23:35:16+08:00	33619	61909	95528	4434	99962	191857	52.1%	17.52%	140	142
15	臺南市永康區	2018-11-24T23:31:18+08:00	33619	61909	95528	4434	99962	191857	52.1%	17.52%	140	142
15	臺南市永康區	2018-11-24T23:39:23+08:00	33619	61909	95528	4434	99962	191857	52.1%	17.52%	140	142
15	臺南市永康區	2018-11-25T01:07:32+08:00	34171	62863	97034	4478	101512	195001	52.06%	17.52%	142	142
15	臺南市永康區	2018-11-24T23:47:35+08:00	33619	61909	95528	4434	99962	191857	52.1%	17.52%	140	142
15	臺南市永康區	2018-11-24T22:41:42+08:00	30936	56678	87614	4080	91694	175753	52.17%	17.6%	129	142
15	臺南市永康區	2018-11-25T06:13:58+08:00	34171	62863	97034	4478	101512	195001	52.06%	17.52%	142	142
15	臺南市永康區	2018-11-24T22:54:31+08:00	32356	59115	91471	4232	95703	183845	52.06%	17.6%	134	142
15	臺南市永康區	2018-11-25T00:09:41+08:00	33875	62403	96278	4453	100731	193411	52.08%	17.51%	141	142
15	臺南市永康區	2018-11-25T03:49:56+08:00	34171	62863	97034	4478	101512	195001	52.06%	17.52%	142	142
15	臺南市永康區	2018-11-24T22:50:54+08:00	31709	58131	89840	4193	94033	180346	52.14%	17.58%	132	142
15	臺南市永康區	2018-11-25T01:12:50+08:00	34171	62863	97034	4478	101512	195001	52.06%	17.52%	142	142
15	臺南市永康區	2018-11-24T23:43:22+08:00	33619	61909	95528	4434	99962	191857	52.1%	17.52%	140	142
15	臺南市永康區	2018-11-25T06:29:23+08:00	34171	62863	97034	4478	101512	195001	52.06%	17.52%	142	142
15	臺南市永康區	2018-11-24T23:05:10+08:00	33227	61185	94412	4382	98794	189484	52.14%	17.54%	138	142
15	臺南市永康區	2018-11-25T06:19:03+08:00	34171	62863	97034	4478	101512	195001	52.06%	17.52%	142	142
15	臺南市永康區	2018-11-25T00:05:11+08:00	33875	62403	96278	4453	100731	193411	52.08%	17.51%	141	142
15	臺南市永康區	2018-11-25T06:24:06+08:00	34171	62863	97034	4478	101512	195001	52.06%	17.52%	142	142
15	臺南市永康區	2018-11-24T23:08:43+08:00	33347	61418	94765	4396	99161	190156	52.15%	17.54%	139	142
15	臺南市永康區	2018-11-24T22:23:20+08:00	28186	51958	80144	3687	83831	160253	52.31%	17.59%	119	142
15	臺南市永康區	2018-11-25T03:32:42+08:00	34171	62863	97034	4478	101512	195001	52.06%	17.52%	142	142
15	臺南市永康區	2018-11-24T23:23:44+08:00	33619	61909	95528	4434	99962	191857	52.1%	17.52%	140	142
15	臺南市永康區	2018-11-24T22:33:43+08:00	30707	56269	86976	4055	91031	174275	52.23%	17.62%	128	142
15	臺南市永康區	2018-11-24T22:16:17+08:00	26221	48349	74570	3458	78028	148825	52.43%	17.62%	112	142
15	臺南市永康區	2018-11-25T03:39:00+08:00	34171	62863	97034	4478	101512	195001	52.06%	17.52%	142	142
15	臺南市永康區	2018-11-24T23:12:21+08:00	33619	61909	95528	4434	99962	191857	52.1%	17.52%	140	142
15	屏東縣新埤鄉	2018-11-24T22:58:06+08:00	1153	2486	3639	374	4013	7710	52.05%	14.95%	11	12
15	屏東縣新埤鄉	2018-11-25T06:19:08+08:00	1301	2812	4113	445	4558	9033	50.46%	14.4%	12	12
15	屏東縣新埤鄉	2018-11-24T23:39:30+08:00	1301	2812	4113	445	4558	9033	50.46%	14.4%	12	12
15	屏東縣新埤鄉	2018-11-24T22:54:35+08:00	1153	2486	3639	374	4013	7710	52.05%	14.95%	11	12
15	屏東縣新埤鄉	2018-11-24T22:41:48+08:00	1153	2486	3639	374	4013	7710	52.05%	14.95%	11	12
15	屏東縣新埤鄉	2018-11-24T23:05:14+08:00	1153	2486	3639	374	4013	7710	52.05%	14.95%	11	12
15	屏東縣新埤鄉	2018-11-25T06:29:29+08:00	1301	2812	4113	445	4558	9033	50.46%	14.4%	12	12
15	屏東縣新埤鄉	2018-11-25T01:18:07+08:00	1301	2812	4113	445	4558	9033	50.46%	14.4%	12	12
15	屏東縣新埤鄉	2018-11-24T23:43:28+08:00	1301	2812	4113	445	4558	9033	50.46%	14.4%	12	12
15	屏東縣新埤鄉	2018-11-25T06:09:07+08:00	1301	2812	4113	445	4558	9033	50.46%	14.4%	12	12
15	屏東縣新埤鄉	2018-11-24T22:13:42+08:00	1153	2486	3639	374	4013	7710	52.05%	14.95%	11	12
15	屏東縣新埤鄉	2018-11-24T23:51:46+08:00	1301	2812	4113	445	4558	9033	50.46%	14.4%	12	12
15	屏東縣新埤鄉	2018-11-25T06:24:11+08:00	1301	2812	4113	445	4558	9033	50.46%	14.4%	12	12
15	屏東縣新埤鄉	2018-11-24T23:08:49+08:00	1301	2812	4113	445	4558	9033	50.46%	14.4%	12	12
15	屏東縣新埤鄉	2018-11-24T22:51:01+08:00	1153	2486	3639	374	4013	7710	52.05%	14.95%	11	12
15	屏東縣新埤鄉	2018-11-25T03:44:38+08:00	1301	2812	4113	445	4558	9033	50.46%	14.4%	12	12
15	屏東縣新埤鄉	2018-11-25T00:23:15+08:00	1301	2812	4113	445	4558	9033	50.46%	14.4%	12	12
15	屏東縣新埤鄉	2018-11-24T23:23:49+08:00	1301	2812	4113	445	4558	9033	50.46%	14.4%	12	12
15	屏東縣新埤鄉	2018-11-24T22:37:12+08:00	1153	2486	3639	374	4013	7710	52.05%	14.95%	11	12
15	屏東縣新埤鄉	2018-11-24T23:16:14+08:00	1301	2812	4113	445	4558	9033	50.46%	14.4%	12	12
15	屏東縣新埤鄉	2018-11-24T23:35:20+08:00	1301	2812	4113	445	4558	9033	50.46%	14.4%	12	12
15	屏東縣新埤鄉	2018-11-25T01:26:05+08:00	1301	2812	4113	445	4558	9033	50.46%	14.4%	12	12
15	屏東縣新埤鄉	2018-11-25T03:39:05+08:00	1301	2812	4113	445	4558	9033	50.46%	14.4%	12	12
15	屏東縣新埤鄉	2018-11-24T22:33:48+08:00	1153	2486	3639	374	4013	7710	52.05%	14.95%	11	12
15	屏東縣新埤鄉	2018-11-24T22:16:23+08:00	1153	2486	3639	374	4013	7710	52.05%	14.95%	11	12
15	屏東縣新埤鄉	2018-11-25T00:14:21+08:00	1301	2812	4113	445	4558	9033	50.46%	14.4%	12	12
15	屏東縣新埤鄉	2018-11-25T01:12:56+08:00	1301	2812	4113	445	4558	9033	50.46%	14.4%	12	12
15	屏東縣新埤鄉	2018-11-24T23:01:43+08:00	1153	2486	3639	374	4013	7710	52.05%	14.95%	11	12
15	屏東縣新埤鄉	2018-11-24T22:26:47+08:00	1153	2486	3639	374	4013	7710	52.05%	14.95%	11	12
15	屏東縣新埤鄉	2018-11-25T03:56:25+08:00	1301	2812	4113	445	4558	9033	50.46%	14.4%	12	12
15	屏東縣新埤鄉	2018-11-24T23:47:41+08:00	1301	2812	4113	445	4558	9033	50.46%	14.4%	12	12
15	屏東縣新埤鄉	2018-11-24T22:45:18+08:00	1153	2486	3639	374	4013	7710	52.05%	14.95%	11	12
15	屏東縣新埤鄉	2018-11-25T00:09:47+08:00	1301	2812	4113	445	4558	9033	50.46%	14.4%	12	12
15	屏東縣新埤鄉	2018-11-25T00:05:16+08:00	1301	2812	4113	445	4558	9033	50.46%	14.4%	12	12
15	屏東縣新埤鄉	2018-11-25T00:57:49+08:00	1301	2812	4113	445	4558	9033	50.46%	14.4%	12	12
15	屏東縣新埤鄉	2018-11-24T22:19:48+08:00	1153	2486	3639	374	4013	7710	52.05%	14.95%	11	12
15	屏東縣新埤鄉	2018-11-24T22:30:21+08:00	1153	2486	3639	374	4013	7710	52.05%	14.95%	11	12
15	屏東縣新埤鄉	2018-11-25T03:32:50+08:00	1301	2812	4113	445	4558	9033	50.46%	14.4%	12	12
15	屏東縣新埤鄉	2018-11-24T22:40:38+08:00	1153	2486	3639	374	4013	7710	52.05%	14.95%	11	12
15	屏東縣新埤鄉	2018-11-25T04:03:03+08:00	1301	2812	4113	445	4558	9033	50.46%	14.4%	12	12
15	屏東縣新埤鄉	2018-11-24T23:27:28+08:00	1301	2812	4113	445	4558	9033	50.46%	14.4%	12	12
15	屏東縣新埤鄉	2018-11-25T01:02:42+08:00	1301	2812	4113	445	4558	9033	50.46%	14.4%	12	12
15	屏東縣新埤鄉	2018-11-25T06:14:03+08:00	1301	2812	4113	445	4558	9033	50.46%	14.4%	12	12
15	屏東縣新埤鄉	2018-11-24T22:23:26+08:00	1153	2486	3639	374	4013	7710	52.05%	14.95%	11	12
15	屏東縣新埤鄉	2018-11-24T23:55:58+08:00	1301	2812	4113	445	4558	9033	50.46%	14.4%	12	12
15	屏東縣新埤鄉	2018-11-25T00:00:22+08:00	1301	2812	4113	445	4558	9033	50.46%	14.4%	12	12
15	屏東縣新埤鄉	2018-11-25T00:18:44+08:00	1301	2812	4113	445	4558	9033	50.46%	14.4%	12	12
15	屏東縣新埤鄉	2018-11-24T23:20:03+08:00	1301	2812	4113	445	4558	9033	50.46%	14.4%	12	12
15	屏東縣新埤鄉	2018-11-25T01:07:38+08:00	1301	2812	4113	445	4558	9033	50.46%	14.4%	12	12
15	屏東縣新埤鄉	2018-11-25T03:50:02+08:00	1301	2812	4113	445	4558	9033	50.46%	14.4%	12	12
15	屏東縣新埤鄉	2018-11-24T23:12:28+08:00	1301	2812	4113	445	4558	9033	50.46%	14.4%	12	12
15	屏東縣新埤鄉	2018-11-24T23:31:24+08:00	1301	2812	4113	445	4558	9033	50.46%	14.4%	12	12
15	臺南市安定區	2018-11-24T23:16:08+08:00	4337	8389	12726	919	13645	26104	52.27%	16.61%	24	24
15	臺南市安定區	2018-11-25T03:56:19+08:00	4337	8389	12726	919	13645	26104	52.27%	16.61%	24	24
15	臺南市安定區	2018-11-24T22:41:41+08:00	4337	8389	12726	919	13645	26104	52.27%	16.61%	24	24
15	臺南市安定區	2018-11-25T00:18:37+08:00	4337	8389	12726	919	13645	26104	52.27%	16.61%	24	24
15	臺南市安定區	2018-11-24T22:45:13+08:00	4337	8389	12726	919	13645	26104	52.27%	16.61%	24	24
15	臺南市安定區	2018-11-24T22:58:00+08:00	4337	8389	12726	919	13645	26104	52.27%	16.61%	24	24
15	臺南市安定區	2018-11-24T22:37:06+08:00	4337	8389	12726	919	13645	26104	52.27%	16.61%	24	24
15	臺南市安定區	2018-11-24T22:40:32+08:00	4337	8389	12726	919	13645	26104	52.27%	16.61%	24	24
15	臺南市安定區	2018-11-25T01:02:36+08:00	4337	8389	12726	919	13645	26104	52.27%	16.61%	24	24
15	臺南市安定區	2018-11-24T22:19:42+08:00	4337	8389	12726	919	13645	26104	52.27%	16.61%	24	24
15	臺南市安定區	2018-11-25T01:25:58+08:00	4337	8389	12726	919	13645	26104	52.27%	16.61%	24	24
15	臺南市安定區	2018-11-24T22:30:15+08:00	4337	8389	12726	919	13645	26104	52.27%	16.61%	24	24
15	臺南市安定區	2018-11-24T23:51:41+08:00	4337	8389	12726	919	13645	26104	52.27%	16.61%	24	24
15	臺南市安定區	2018-11-25T00:23:09+08:00	4337	8389	12726	919	13645	26104	52.27%	16.61%	24	24
15	臺南市安定區	2018-11-25T00:57:42+08:00	4337	8389	12726	919	13645	26104	52.27%	16.61%	24	24
15	臺南市安定區	2018-11-25T06:24:05+08:00	4337	8389	12726	919	13645	26104	52.27%	16.61%	24	24
15	臺南市安定區	2018-11-25T00:00:16+08:00	4337	8389	12726	919	13645	26104	52.27%	16.61%	24	24
15	臺南市安定區	2018-11-25T01:17:59+08:00	4337	8389	12726	919	13645	26104	52.27%	16.61%	24	24
15	臺南市安定區	2018-11-24T23:19:57+08:00	4337	8389	12726	919	13645	26104	52.27%	16.61%	24	24
15	臺南市安定區	2018-11-24T23:55:52+08:00	4337	8389	12726	919	13645	26104	52.27%	16.61%	24	24
15	臺南市安定區	2018-11-24T22:13:34+08:00	4337	8389	12726	919	13645	26104	52.27%	16.61%	24	24
15	臺南市安定區	2018-11-24T23:27:23+08:00	4337	8389	12726	919	13645	26104	52.27%	16.61%	24	24
15	臺南市安定區	2018-11-25T03:44:30+08:00	4337	8389	12726	919	13645	26104	52.27%	16.61%	24	24
15	臺南市安定區	2018-11-24T23:39:22+08:00	4337	8389	12726	919	13645	26104	52.27%	16.61%	24	24
15	臺南市安定區	2018-11-25T06:08:59+08:00	4337	8389	12726	919	13645	26104	52.27%	16.61%	24	24
15	臺南市安定區	2018-11-24T23:31:17+08:00	4337	8389	12726	919	13645	26104	52.27%	16.61%	24	24
15	臺南市安定區	2018-11-25T04:02:58+08:00	4337	8389	12726	919	13645	26104	52.27%	16.61%	24	24
15	臺南市安定區	2018-11-24T23:47:34+08:00	4337	8389	12726	919	13645	26104	52.27%	16.61%	24	24
15	臺南市安定區	2018-11-24T23:05:09+08:00	4337	8389	12726	919	13645	26104	52.27%	16.61%	24	24
15	臺南市安定區	2018-11-24T23:01:36+08:00	4337	8389	12726	919	13645	26104	52.27%	16.61%	24	24
15	臺南市安定區	2018-11-25T00:05:10+08:00	4337	8389	12726	919	13645	26104	52.27%	16.61%	24	24
15	臺南市安定區	2018-11-25T06:19:02+08:00	4337	8389	12726	919	13645	26104	52.27%	16.61%	24	24
15	臺南市安定區	2018-11-25T06:29:22+08:00	4337	8389	12726	919	13645	26104	52.27%	16.61%	24	24
15	臺南市安定區	2018-11-25T03:49:56+08:00	4337	8389	12726	919	13645	26104	52.27%	16.61%	24	24
15	臺南市安定區	2018-11-24T22:54:30+08:00	4337	8389	12726	919	13645	26104	52.27%	16.61%	24	24
15	臺南市安定區	2018-11-24T22:50:54+08:00	4337	8389	12726	919	13645	26104	52.27%	16.61%	24	24
15	臺南市安定區	2018-11-25T06:13:57+08:00	4337	8389	12726	919	13645	26104	52.27%	16.61%	24	24
15	臺南市安定區	2018-11-25T01:12:50+08:00	4337	8389	12726	919	13645	26104	52.27%	16.61%	24	24
15	臺南市安定區	2018-11-24T23:43:22+08:00	4337	8389	12726	919	13645	26104	52.27%	16.61%	24	24
15	臺南市安定區	2018-11-25T00:09:40+08:00	4337	8389	12726	919	13645	26104	52.27%	16.61%	24	24
15	臺南市安定區	2018-11-24T22:26:41+08:00	4337	8389	12726	919	13645	26104	52.27%	16.61%	24	24
15	臺南市安定區	2018-11-25T03:32:42+08:00	4337	8389	12726	919	13645	26104	52.27%	16.61%	24	24
15	臺南市安定區	2018-11-24T23:08:42+08:00	4337	8389	12726	919	13645	26104	52.27%	16.61%	24	24
15	臺南市安定區	2018-11-24T22:23:19+08:00	4337	8389	12726	919	13645	26104	52.27%	16.61%	24	24
15	臺南市安定區	2018-11-24T23:23:43+08:00	4337	8389	12726	919	13645	26104	52.27%	16.61%	24	24
15	臺南市安定區	2018-11-25T00:14:15+08:00	4337	8389	12726	919	13645	26104	52.27%	16.61%	24	24
15	臺南市安定區	2018-11-24T23:35:15+08:00	4337	8389	12726	919	13645	26104	52.27%	16.61%	24	24
15	臺南市安定區	2018-11-24T22:33:43+08:00	4337	8389	12726	919	13645	26104	52.27%	16.61%	24	24
15	臺南市安定區	2018-11-25T03:39:00+08:00	4337	8389	12726	919	13645	26104	52.27%	16.61%	24	24
15	臺南市安定區	2018-11-24T23:12:21+08:00	4337	8389	12726	919	13645	26104	52.27%	16.61%	24	24
15	臺南市安定區	2018-11-24T22:16:16+08:00	4337	8389	12726	919	13645	26104	52.27%	16.61%	24	24
15	臺南市安定區	2018-11-25T01:07:31+08:00	4337	8389	12726	919	13645	26104	52.27%	16.61%	24	24
15	屏東縣萬丹鄉	2018-11-24T22:58:06+08:00	6708	13753	20461	1932	22393	42075	53.22%	15.94%	38	39
15	屏東縣萬丹鄉	2018-11-25T06:19:08+08:00	7211	14001	21212	1988	23200	43478	53.36%	16.59%	39	39
15	屏東縣萬丹鄉	2018-11-25T06:29:28+08:00	7211	14001	21212	1988	23200	43478	53.36%	16.59%	39	39
15	屏東縣萬丹鄉	2018-11-24T23:43:27+08:00	7211	14001	21212	1988	23200	43478	53.36%	16.59%	39	39
15	屏東縣萬丹鄉	2018-11-24T22:54:35+08:00	6708	13753	20461	1932	22393	42075	53.22%	15.94%	38	39
15	屏東縣萬丹鄉	2018-11-24T22:41:48+08:00	6708	13753	20461	1932	22393	42075	53.22%	15.94%	38	39
15	屏東縣萬丹鄉	2018-11-24T23:05:14+08:00	6708	13753	20461	1932	22393	42075	53.22%	15.94%	38	39
15	屏東縣萬丹鄉	2018-11-25T01:18:07+08:00	7211	14001	21212	1988	23200	43478	53.36%	16.59%	39	39
15	屏東縣萬丹鄉	2018-11-25T00:05:15+08:00	7211	14001	21212	1988	23200	43478	53.36%	16.59%	39	39
15	屏東縣萬丹鄉	2018-11-24T22:13:42+08:00	6524	13313	19837	1859	21696	40664	53.35%	16.04%	37	39
15	屏東縣萬丹鄉	2018-11-24T23:51:46+08:00	7211	14001	21212	1988	23200	43478	53.36%	16.59%	39	39
15	屏東縣萬丹鄉	2018-11-25T06:09:06+08:00	7211	14001	21212	1988	23200	43478	53.36%	16.59%	39	39
15	屏東縣萬丹鄉	2018-11-25T00:23:14+08:00	7211	14001	21212	1988	23200	43478	53.36%	16.59%	39	39
15	屏東縣萬丹鄉	2018-11-25T06:24:11+08:00	7211	14001	21212	1988	23200	43478	53.36%	16.59%	39	39
15	屏東縣萬丹鄉	2018-11-24T23:23:48+08:00	7211	14001	21212	1988	23200	43478	53.36%	16.59%	39	39
15	屏東縣萬丹鄉	2018-11-25T00:00:21+08:00	7211	14001	21212	1988	23200	43478	53.36%	16.59%	39	39
15	屏東縣萬丹鄉	2018-11-24T22:51:00+08:00	6708	13753	20461	1932	22393	42075	53.22%	15.94%	38	39
15	屏東縣萬丹鄉	2018-11-25T03:32:49+08:00	7211	14001	21212	1988	23200	43478	53.36%	16.59%	39	39
15	屏東縣萬丹鄉	2018-11-25T03:44:37+08:00	7211	14001	21212	1988	23200	43478	53.36%	16.59%	39	39
15	屏東縣萬丹鄉	2018-11-24T23:08:48+08:00	6708	13753	20461	1932	22393	42075	53.22%	15.94%	38	39
15	屏東縣萬丹鄉	2018-11-24T23:16:13+08:00	7211	14001	21212	1988	23200	43478	53.36%	16.59%	39	39
15	屏東縣萬丹鄉	2018-11-24T23:35:20+08:00	7211	14001	21212	1988	23200	43478	53.36%	16.59%	39	39
15	屏東縣萬丹鄉	2018-11-25T00:14:20+08:00	7211	14001	21212	1988	23200	43478	53.36%	16.59%	39	39
15	屏東縣萬丹鄉	2018-11-25T01:26:05+08:00	7211	14001	21212	1988	23200	43478	53.36%	16.59%	39	39
15	屏東縣萬丹鄉	2018-11-25T03:39:05+08:00	7211	14001	21212	1988	23200	43478	53.36%	16.59%	39	39
15	屏東縣萬丹鄉	2018-11-24T22:33:48+08:00	6708	13753	20461	1932	22393	42075	53.22%	15.94%	38	39
15	屏東縣萬丹鄉	2018-11-25T03:50:01+08:00	7211	14001	21212	1988	23200	43478	53.36%	16.59%	39	39
15	屏東縣萬丹鄉	2018-11-24T22:16:23+08:00	6524	13313	19837	1859	21696	40664	53.35%	16.04%	37	39
15	屏東縣萬丹鄉	2018-11-25T01:12:56+08:00	7211	14001	21212	1988	23200	43478	53.36%	16.59%	39	39
15	屏東縣萬丹鄉	2018-11-24T23:47:40+08:00	7211	14001	21212	1988	23200	43478	53.36%	16.59%	39	39
15	屏東縣萬丹鄉	2018-11-24T23:01:43+08:00	6708	13753	20461	1932	22393	42075	53.22%	15.94%	38	39
15	屏東縣萬丹鄉	2018-11-25T03:56:25+08:00	7211	14001	21212	1988	23200	43478	53.36%	16.59%	39	39
15	屏東縣萬丹鄉	2018-11-24T22:45:18+08:00	6708	13753	20461	1932	22393	42075	53.22%	15.94%	38	39
15	屏東縣萬丹鄉	2018-11-25T00:09:47+08:00	7211	14001	21212	1988	23200	43478	53.36%	16.59%	39	39
15	屏東縣萬丹鄉	2018-11-24T22:26:46+08:00	6524	13313	19837	1859	21696	40664	53.35%	16.04%	37	39
15	屏東縣萬丹鄉	2018-11-24T22:30:21+08:00	6524	13313	19837	1859	21696	40664	53.35%	16.04%	37	39
15	屏東縣萬丹鄉	2018-11-24T22:40:38+08:00	6708	13753	20461	1932	22393	42075	53.22%	15.94%	38	39
15	屏東縣萬丹鄉	2018-11-25T04:03:03+08:00	7211	14001	21212	1988	23200	43478	53.36%	16.59%	39	39
15	屏東縣萬丹鄉	2018-11-25T00:57:48+08:00	7211	14001	21212	1988	23200	43478	53.36%	16.59%	39	39
15	屏東縣萬丹鄉	2018-11-24T22:19:47+08:00	6524	13313	19837	1859	21696	40664	53.35%	16.04%	37	39
15	屏東縣萬丹鄉	2018-11-24T23:27:28+08:00	7211	14001	21212	1988	23200	43478	53.36%	16.59%	39	39
15	屏東縣萬丹鄉	2018-11-25T01:02:42+08:00	7211	14001	21212	1988	23200	43478	53.36%	16.59%	39	39
15	屏東縣萬丹鄉	2018-11-25T06:14:03+08:00	7211	14001	21212	1988	23200	43478	53.36%	16.59%	39	39
15	屏東縣萬丹鄉	2018-11-24T22:23:26+08:00	6524	13313	19837	1859	21696	40664	53.35%	16.04%	37	39
15	屏東縣萬丹鄉	2018-11-24T23:55:58+08:00	7211	14001	21212	1988	23200	43478	53.36%	16.59%	39	39
15	屏東縣萬丹鄉	2018-11-25T00:18:44+08:00	7211	14001	21212	1988	23200	43478	53.36%	16.59%	39	39
15	屏東縣萬丹鄉	2018-11-24T23:20:03+08:00	7211	14001	21212	1988	23200	43478	53.36%	16.59%	39	39
15	屏東縣萬丹鄉	2018-11-25T01:07:37+08:00	7211	14001	21212	1988	23200	43478	53.36%	16.59%	39	39
15	屏東縣萬丹鄉	2018-11-24T22:37:11+08:00	6708	13753	20461	1932	22393	42075	53.22%	15.94%	38	39
15	屏東縣萬丹鄉	2018-11-24T23:39:29+08:00	7211	14001	21212	1988	23200	43478	53.36%	16.59%	39	39
15	屏東縣萬丹鄉	2018-11-24T23:12:28+08:00	6708	13753	20461	1932	22393	42075	53.22%	15.94%	38	39
15	屏東縣萬丹鄉	2018-11-24T23:31:24+08:00	7211	14001	21212	1988	23200	43478	53.36%	16.59%	39	39
15	南投縣國姓鄉	2018-11-25T00:05:14+08:00	2268	6510	8778	625	9403	16597	56.65%	13.67%	20	20
15	南投縣國姓鄉	2018-11-25T06:19:06+08:00	2268	6510	8778	625	9403	16597	56.65%	13.67%	20	20
15	南投縣國姓鄉	2018-11-25T00:09:45+08:00	2268	6510	8778	625	9403	16597	56.65%	13.67%	20	20
15	南投縣國姓鄉	2018-11-24T22:50:58+08:00	2268	6510	8778	625	9403	16597	56.65%	13.67%	20	20
15	南投縣國姓鄉	2018-11-24T22:41:46+08:00	2268	6510	8778	625	9403	16597	56.65%	13.67%	20	20
15	南投縣國姓鄉	2018-11-24T22:37:09+08:00	2268	6510	8778	625	9403	16597	56.65%	13.67%	20	20
15	南投縣國姓鄉	2018-11-25T06:29:27+08:00	2268	6510	8778	625	9403	16597	56.65%	13.67%	20	20
15	南投縣國姓鄉	2018-11-24T23:05:13+08:00	2268	6510	8778	625	9403	16597	56.65%	13.67%	20	20
15	南投縣國姓鄉	2018-11-24T23:01:41+08:00	2268	6510	8778	625	9403	16597	56.65%	13.67%	20	20
15	南投縣國姓鄉	2018-11-24T22:26:45+08:00	2268	6510	8778	625	9403	16597	56.65%	13.67%	20	20
15	南投縣國姓鄉	2018-11-24T22:54:34+08:00	2268	6510	8778	625	9403	16597	56.65%	13.67%	20	20
15	南投縣國姓鄉	2018-11-25T01:12:54+08:00	2268	6510	8778	625	9403	16597	56.65%	13.67%	20	20
15	南投縣國姓鄉	2018-11-25T04:03:01+08:00	2268	6510	8778	625	9403	16597	56.65%	13.67%	20	20
15	南投縣國姓鄉	2018-11-25T00:00:20+08:00	2268	6510	8778	625	9403	16597	56.65%	13.67%	20	20
15	南投縣國姓鄉	2018-11-25T00:23:13+08:00	2268	6510	8778	625	9403	16597	56.65%	13.67%	20	20
15	南投縣國姓鄉	2018-11-25T03:44:36+08:00	2268	6510	8778	625	9403	16597	56.65%	13.67%	20	20
15	南投縣國姓鄉	2018-11-24T23:08:47+08:00	2268	6510	8778	625	9403	16597	56.65%	13.67%	20	20
15	南投縣國姓鄉	2018-11-24T22:23:24+08:00	2268	6510	8778	625	9403	16597	56.65%	13.67%	20	20
15	南投縣國姓鄉	2018-11-25T01:02:40+08:00	2268	6510	8778	625	9403	16597	56.65%	13.67%	20	20
15	南投縣國姓鄉	2018-11-25T06:14:01+08:00	2268	6510	8778	625	9403	16597	56.65%	13.67%	20	20
15	南投縣國姓鄉	2018-11-25T03:32:47+08:00	2268	6510	8778	625	9403	16597	56.65%	13.67%	20	20
15	南投縣國姓鄉	2018-11-24T23:23:47+08:00	2268	6510	8778	625	9403	16597	56.65%	13.67%	20	20
15	南投縣國姓鄉	2018-11-25T03:50:00+08:00	2268	6510	8778	625	9403	16597	56.65%	13.67%	20	20
15	南投縣國姓鄉	2018-11-24T22:33:47+08:00	2268	6510	8778	625	9403	16597	56.65%	13.67%	20	20
15	南投縣國姓鄉	2018-11-25T03:39:03+08:00	2268	6510	8778	625	9403	16597	56.65%	13.67%	20	20
15	南投縣國姓鄉	2018-11-25T01:26:02+08:00	2268	6510	8778	625	9403	16597	56.65%	13.67%	20	20
15	南投縣國姓鄉	2018-11-24T23:20:01+08:00	2268	6510	8778	625	9403	16597	56.65%	13.67%	20	20
15	南投縣國姓鄉	2018-11-25T01:07:35+08:00	2268	6510	8778	625	9403	16597	56.65%	13.67%	20	20
15	南投縣國姓鄉	2018-11-25T00:14:19+08:00	2268	6510	8778	625	9403	16597	56.65%	13.67%	20	20
15	南投縣國姓鄉	2018-11-24T23:16:12+08:00	2268	6510	8778	625	9403	16597	56.65%	13.67%	20	20
15	南投縣國姓鄉	2018-11-24T23:35:19+08:00	2268	6510	8778	625	9403	16597	56.65%	13.67%	20	20
15	南投縣國姓鄉	2018-11-24T22:45:17+08:00	2268	6510	8778	625	9403	16597	56.65%	13.67%	20	20
15	南投縣國姓鄉	2018-11-24T23:43:25+08:00	2268	6510	8778	625	9403	16597	56.65%	13.67%	20	20
15	南投縣國姓鄉	2018-11-25T03:56:23+08:00	2268	6510	8778	625	9403	16597	56.65%	13.67%	20	20
15	南投縣國姓鄉	2018-11-24T22:58:04+08:00	2268	6510	8778	625	9403	16597	56.65%	13.67%	20	20
15	南投縣國姓鄉	2018-11-25T01:18:04+08:00	2268	6510	8778	625	9403	16597	56.65%	13.67%	20	20
15	南投縣國姓鄉	2018-11-25T00:57:47+08:00	2268	6510	8778	625	9403	16597	56.65%	13.67%	20	20
15	南投縣國姓鄉	2018-11-24T22:19:46+08:00	2268	6510	8778	625	9403	16597	56.65%	13.67%	20	20
15	南投縣國姓鄉	2018-11-25T06:24:09+08:00	2268	6510	8778	625	9403	16597	56.65%	13.67%	20	20
15	南投縣國姓鄉	2018-11-25T06:09:04+08:00	2268	6510	8778	625	9403	16597	56.65%	13.67%	20	20
15	南投縣國姓鄉	2018-11-24T22:40:36+08:00	2268	6510	8778	625	9403	16597	56.65%	13.67%	20	20
15	南投縣國姓鄉	2018-11-24T22:30:19+08:00	2268	6510	8778	625	9403	16597	56.65%	13.67%	20	20
15	南投縣國姓鄉	2018-11-24T22:13:40+08:00	2094	6078	8172	583	8755	15502	56.48%	13.51%	19	20
15	南投縣國姓鄉	2018-11-24T23:51:45+08:00	2268	6510	8778	625	9403	16597	56.65%	13.67%	20	20
15	南投縣國姓鄉	2018-11-24T23:27:27+08:00	2268	6510	8778	625	9403	16597	56.65%	13.67%	20	20
15	南投縣國姓鄉	2018-11-24T23:55:56+08:00	2268	6510	8778	625	9403	16597	56.65%	13.67%	20	20
15	南投縣國姓鄉	2018-11-24T23:47:39+08:00	2268	6510	8778	625	9403	16597	56.65%	13.67%	20	20
15	南投縣國姓鄉	2018-11-24T23:31:22+08:00	2268	6510	8778	625	9403	16597	56.65%	13.67%	20	20
15	南投縣國姓鄉	2018-11-24T22:16:21+08:00	2094	6078	8172	583	8755	15502	56.48%	13.51%	19	20
15	南投縣國姓鄉	2018-11-25T00:18:42+08:00	2268	6510	8778	625	9403	16597	56.65%	13.67%	20	20
15	南投縣國姓鄉	2018-11-24T23:12:26+08:00	2268	6510	8778	625	9403	16597	56.65%	13.67%	20	20
15	南投縣國姓鄉	2018-11-24T23:39:27+08:00	2268	6510	8778	625	9403	16597	56.65%	13.67%	20	20
15	南投縣	2018-11-25T00:05:14+08:00	67738	161762	229500	14258	243758	420255	58%	16.12%	482	488
15	南投縣	2018-11-24T22:26:44+08:00	50402	121914	172316	11089	183405	317661	57.74%	15.87%	388	488
15	南投縣	2018-11-24T23:01:40+08:00	59857	143066	202923	12826	215749	372578	57.91%	16.07%	441	488
15	南投縣	2018-11-25T06:19:06+08:00	68393	165077	233470	14440	247910	427089	58.05%	16.01%	488	488
15	南投縣	2018-11-24T23:05:12+08:00	61143	146100	207243	13056	220299	380581	57.88%	16.07%	448	488
15	南投縣	2018-11-25T06:29:26+08:00	68393	165077	233470	14440	247910	427089	58.05%	16.01%	488	488
15	南投縣	2018-11-24T22:50:58+08:00	56179	136427	192606	12300	204906	353954	57.89%	15.87%	424	488
15	南投縣	2018-11-24T22:37:09+08:00	53545	129791	183336	11789	195125	337090	57.89%	15.88%	407	488
15	南投縣	2018-11-25T00:09:44+08:00	67649	162705	230354	14316	244670	421567	58.04%	16.05%	483	488
15	南投縣	2018-11-24T22:54:33+08:00	56975	138113	195088	12423	207511	358519	57.88%	15.89%	428	488
15	南投縣	2018-11-25T01:12:54+08:00	68393	165077	233470	14440	247910	427089	58.05%	16.01%	488	488
15	南投縣	2018-11-24T22:19:45+08:00	49210	118957	168167	10807	178974	309682	57.79%	15.89%	381	488
15	南投縣	2018-11-25T04:03:01+08:00	68393	165077	233470	14440	247910	427089	58.05%	16.01%	488	488
15	南投縣	2018-11-25T00:23:13+08:00	68084	164205	232289	14376	246665	425257	58%	16.01%	486	488
15	南投縣	2018-11-24T23:23:46+08:00	65308	155745	221053	13842	234895	405532	57.92%	16.1%	469	488
15	南投縣	2018-11-24T22:23:23+08:00	49824	120616	170440	10960	181400	314097	57.75%	15.86%	385	488
15	南投縣	2018-11-25T00:00:19+08:00	67444	160968	228412	14225	242637	418277	58.01%	16.12%	480	488
15	南投縣	2018-11-25T01:02:40+08:00	68393	165077	233470	14440	247910	427089	58.05%	16.01%	488	488
15	南投縣	2018-11-25T06:14:01+08:00	68393	165077	233470	14440	247910	427089	58.05%	16.01%	488	488
15	南投縣	2018-11-25T03:32:47+08:00	68393	165077	233470	14440	247910	427089	58.05%	16.01%	488	488
15	南投縣	2018-11-24T23:08:46+08:00	62146	148392	210538	13279	223817	386599	57.89%	16.08%	453	488
15	南投縣	2018-11-25T03:39:03+08:00	68393	165077	233470	14440	247910	427089	58.05%	16.01%	488	488
15	南投縣	2018-11-24T23:35:18+08:00	66499	158708	225207	14065	239272	412773	57.97%	16.11%	475	488
15	南投縣	2018-11-25T01:26:02+08:00	68393	165077	233470	14440	247910	427089	58.05%	16.01%	488	488
15	南投縣	2018-11-24T23:20:01+08:00	64920	154710	219630	13760	233390	403074	57.9%	16.11%	467	488
15	南投縣	2018-11-25T01:07:35+08:00	68393	165077	233470	14440	247910	427089	58.05%	16.01%	488	488
15	南投縣	2018-11-24T22:33:46+08:00	52757	127965	180722	11669	192391	332624	57.84%	15.86%	402	488
15	南投縣	2018-11-25T00:14:19+08:00	67802	163094	230896	14350	245246	422557	58.04%	16.05%	484	488
15	南投縣	2018-11-24T22:41:45+08:00	54435	132224	186659	12017	198676	343015	57.92%	15.87%	413	488
15	南投縣	2018-11-24T22:45:16+08:00	54923	133394	188317	12094	200411	346026	57.92%	15.87%	416	488
15	南投縣	2018-11-24T23:43:25+08:00	66886	159747	226633	14127	240760	415142	57.99%	16.11%	477	488
15	南投縣	2018-11-25T03:56:23+08:00	68393	165077	233470	14440	247910	427089	58.05%	16.01%	488	488
15	南投縣	2018-11-25T03:49:59+08:00	68393	165077	233470	14440	247910	427089	58.05%	16.01%	488	488
15	南投縣	2018-11-25T01:18:04+08:00	68393	165077	233470	14440	247910	427089	58.05%	16.01%	488	488
15	南投縣	2018-11-24T22:58:03+08:00	59674	142665	202339	12807	215146	371578	57.9%	16.06%	440	488
15	南投縣	2018-11-25T06:24:09+08:00	68393	165077	233470	14440	247910	427089	58.05%	16.01%	488	488
15	南投縣	2018-11-25T06:09:04+08:00	68393	165077	233470	14440	247910	427089	58.05%	16.01%	488	488
15	南投縣	2018-11-24T23:51:44+08:00	67444	160968	228412	14225	242637	418277	58.01%	16.12%	480	488
15	南投縣	2018-11-24T22:40:36+08:00	54435	132224	186659	12017	198676	343015	57.92%	15.87%	413	488
15	南投縣	2018-11-24T22:30:19+08:00	50797	122777	173574	11168	184742	319923	57.75%	15.88%	390	488
15	南投縣	2018-11-25T00:57:46+08:00	68393	165077	233470	14440	247910	427089	58.05%	16.01%	488	488
15	南投縣	2018-11-24T23:27:26+08:00	66054	157614	223668	13958	237626	410112	57.94%	16.11%	473	488
15	南投縣	2018-11-25T03:44:35+08:00	68393	165077	233470	14440	247910	427089	58.05%	16.01%	488	488
15	南投縣	2018-11-24T22:13:39+08:00	46922	113686	160608	10422	171030	295999	57.78%	15.85%	368	488
15	南投縣	2018-11-24T23:55:56+08:00	67444	160968	228412	14225	242637	418277	58.01%	16.12%	480	488
15	南投縣	2018-11-24T23:31:22+08:00	66499	158708	225207	14065	239272	412773	57.97%	16.11%	475	488
15	南投縣	2018-11-25T00:18:42+08:00	67974	163594	231568	14350	245918	423881	58.02%	16.04%	485	488
15	南投縣	2018-11-24T23:16:11+08:00	64721	154278	218999	13708	232707	401698	57.93%	16.11%	466	488
15	南投縣	2018-11-24T23:47:38+08:00	66987	160004	226991	14150	241141	415756	58%	16.11%	478	488
15	南投縣	2018-11-24T23:12:26+08:00	63185	150855	214040	13489	227529	393149	57.87%	16.07%	459	488
15	南投縣	2018-11-24T22:16:20+08:00	47708	115658	163366	10538	173904	300951	57.78%	15.85%	373	488
15	南投縣	2018-11-24T23:39:27+08:00	66765	159577	226342	14120	240462	414686	57.99%	16.1%	477	488
15	新竹縣橫山鄉	2018-11-24T22:26:43+08:00	1159	3022	4181	329	4510	7785	57.93%	14.89%	13	16
15	新竹縣橫山鄉	2018-11-25T03:56:21+08:00	1742	4507	6249	452	6701	11346	59.06%	15.35%	16	16
15	新竹縣橫山鄉	2018-11-25T01:12:52+08:00	1742	4507	6249	452	6701	11346	59.06%	15.35%	16	16
15	新竹縣橫山鄉	2018-11-24T22:54:32+08:00	1742	4507	6249	452	6701	11346	59.06%	15.35%	16	16
15	新竹縣橫山鄉	2018-11-24T22:50:56+08:00	1406	3686	5092	385	5477	9346	58.6%	15.04%	14	16
15	新竹縣橫山鄉	2018-11-25T00:09:43+08:00	1742	4507	6249	452	6701	11346	59.06%	15.35%	16	16
15	新竹縣橫山鄉	2018-11-25T00:05:12+08:00	1742	4507	6249	452	6701	11346	59.06%	15.35%	16	16
15	新竹縣橫山鄉	2018-11-24T22:37:08+08:00	1406	3686	5092	385	5477	9346	58.6%	15.04%	14	16
15	新竹縣橫山鄉	2018-11-24T22:45:15+08:00	1406	3686	5092	385	5477	9346	58.6%	15.04%	14	16
15	新竹縣橫山鄉	2018-11-25T01:02:38+08:00	1742	4507	6249	452	6701	11346	59.06%	15.35%	16	16
15	新竹縣橫山鄉	2018-11-24T22:40:34+08:00	1406	3686	5092	385	5477	9346	58.6%	15.04%	14	16
15	新竹縣橫山鄉	2018-11-25T04:03:00+08:00	1742	4507	6249	452	6701	11346	59.06%	15.35%	16	16
15	新竹縣橫山鄉	2018-11-25T00:57:45+08:00	1742	4507	6249	452	6701	11346	59.06%	15.35%	16	16
15	新竹縣橫山鄉	2018-11-24T22:19:44+08:00	1159	3022	4181	329	4510	7785	57.93%	14.89%	13	16
15	新竹縣橫山鄉	2018-11-25T00:00:18+08:00	1742	4507	6249	452	6701	11346	59.06%	15.35%	16	16
15	新竹縣橫山鄉	2018-11-24T23:55:54+08:00	1742	4507	6249	452	6701	11346	59.06%	15.35%	16	16
15	新竹縣橫山鄉	2018-11-24T23:27:25+08:00	1742	4507	6249	452	6701	11346	59.06%	15.35%	16	16
15	新竹縣橫山鄉	2018-11-24T22:23:22+08:00	1159	3022	4181	329	4510	7785	57.93%	14.89%	13	16
15	新竹縣橫山鄉	2018-11-24T23:01:39+08:00	1742	4507	6249	452	6701	11346	59.06%	15.35%	16	16
15	新竹縣橫山鄉	2018-11-24T23:39:25+08:00	1742	4507	6249	452	6701	11346	59.06%	15.35%	16	16
15	新竹縣橫山鄉	2018-11-24T23:20:00+08:00	1742	4507	6249	452	6701	11346	59.06%	15.35%	16	16
15	新竹縣橫山鄉	2018-11-25T01:07:34+08:00	1742	4507	6249	452	6701	11346	59.06%	15.35%	16	16
15	新竹縣橫山鄉	2018-11-24T23:12:24+08:00	1742	4507	6249	452	6701	11346	59.06%	15.35%	16	16
15	新竹縣橫山鄉	2018-11-25T00:18:40+08:00	1742	4507	6249	452	6701	11346	59.06%	15.35%	16	16
15	新竹縣橫山鄉	2018-11-25T03:39:02+08:00	1742	4507	6249	452	6701	11346	59.06%	15.35%	16	16
15	新竹縣橫山鄉	2018-11-24T23:31:20+08:00	1742	4507	6249	452	6701	11346	59.06%	15.35%	16	16
15	新竹縣橫山鄉	2018-11-24T23:35:17+08:00	1742	4507	6249	452	6701	11346	59.06%	15.35%	16	16
15	新竹縣橫山鄉	2018-11-25T00:14:17+08:00	1742	4507	6249	452	6701	11346	59.06%	15.35%	16	16
15	新竹縣橫山鄉	2018-11-24T23:43:24+08:00	1742	4507	6249	452	6701	11346	59.06%	15.35%	16	16
15	新竹縣橫山鄉	2018-11-24T22:58:02+08:00	1742	4507	6249	452	6701	11346	59.06%	15.35%	16	16
15	新竹縣橫山鄉	2018-11-25T03:49:58+08:00	1742	4507	6249	452	6701	11346	59.06%	15.35%	16	16
15	新竹縣橫山鄉	2018-11-25T01:18:02+08:00	1742	4507	6249	452	6701	11346	59.06%	15.35%	16	16
15	新竹縣橫山鄉	2018-11-25T06:29:25+08:00	1742	4507	6249	452	6701	11346	59.06%	15.35%	16	16
15	新竹縣橫山鄉	2018-11-24T23:05:11+08:00	1742	4507	6249	452	6701	11346	59.06%	15.35%	16	16
15	新竹縣橫山鄉	2018-11-25T06:13:59+08:00	1742	4507	6249	452	6701	11346	59.06%	15.35%	16	16
15	新竹縣橫山鄉	2018-11-24T22:41:44+08:00	1406	3686	5092	385	5477	9346	58.6%	15.04%	14	16
15	新竹縣橫山鄉	2018-11-25T06:19:04+08:00	1742	4507	6249	452	6701	11346	59.06%	15.35%	16	16
15	新竹縣橫山鄉	2018-11-24T22:30:17+08:00	1159	3022	4181	329	4510	7785	57.93%	14.89%	13	16
15	新竹縣橫山鄉	2018-11-25T06:24:08+08:00	1742	4507	6249	452	6701	11346	59.06%	15.35%	16	16
15	新竹縣橫山鄉	2018-11-24T23:51:42+08:00	1742	4507	6249	452	6701	11346	59.06%	15.35%	16	16
15	新竹縣橫山鄉	2018-11-25T06:09:02+08:00	1742	4507	6249	452	6701	11346	59.06%	15.35%	16	16
15	新竹縣橫山鄉	2018-11-24T23:23:45+08:00	1742	4507	6249	452	6701	11346	59.06%	15.35%	16	16
15	新竹縣橫山鄉	2018-11-25T03:44:32+08:00	1742	4507	6249	452	6701	11346	59.06%	15.35%	16	16
15	新竹縣橫山鄉	2018-11-25T03:32:45+08:00	1742	4507	6249	452	6701	11346	59.06%	15.35%	16	16
15	新竹縣橫山鄉	2018-11-24T22:13:38+08:00	1159	3022	4181	329	4510	7785	57.93%	14.89%	13	16
15	新竹縣橫山鄉	2018-11-24T23:08:45+08:00	1742	4507	6249	452	6701	11346	59.06%	15.35%	16	16
15	新竹縣橫山鄉	2018-11-25T00:23:11+08:00	1742	4507	6249	452	6701	11346	59.06%	15.35%	16	16
15	新竹縣橫山鄉	2018-11-24T23:16:10+08:00	1742	4507	6249	452	6701	11346	59.06%	15.35%	16	16
15	新竹縣橫山鄉	2018-11-24T23:47:37+08:00	1742	4507	6249	452	6701	11346	59.06%	15.35%	16	16
15	新竹縣橫山鄉	2018-11-24T22:16:19+08:00	1159	3022	4181	329	4510	7785	57.93%	14.89%	13	16
15	新竹縣橫山鄉	2018-11-25T01:26:00+08:00	1742	4507	6249	452	6701	11346	59.06%	15.35%	16	16
15	新竹縣橫山鄉	2018-11-24T22:33:45+08:00	1406	3686	5092	385	5477	9346	58.6%	15.04%	14	16
15	澎湖縣西嶼鄉	2018-11-25T03:56:28+08:00	684	1598	2282	276	2558	7382	34.65%	9.27%	12	12
15	澎湖縣西嶼鄉	2018-11-24T23:47:43+08:00	684	1598	2282	276	2558	7382	34.65%	9.27%	12	12
15	澎湖縣西嶼鄉	2018-11-24T22:58:09+08:00	684	1598	2282	276	2558	7382	34.65%	9.27%	12	12
15	澎湖縣西嶼鄉	2018-11-24T23:56:01+08:00	684	1598	2282	276	2558	7382	34.65%	9.27%	12	12
15	澎湖縣西嶼鄉	2018-11-24T23:01:46+08:00	684	1598	2282	276	2558	7382	34.65%	9.27%	12	12
15	澎湖縣西嶼鄉	2018-11-24T23:12:30+08:00	684	1598	2282	276	2558	7382	34.65%	9.27%	12	12
15	澎湖縣西嶼鄉	2018-11-24T23:51:49+08:00	684	1598	2282	276	2558	7382	34.65%	9.27%	12	12
15	澎湖縣西嶼鄉	2018-11-24T22:13:45+08:00	684	1598	2282	276	2558	7382	34.65%	9.27%	12	12
15	澎湖縣西嶼鄉	2018-11-25T03:44:41+08:00	684	1598	2282	276	2558	7382	34.65%	9.27%	12	12
15	澎湖縣西嶼鄉	2018-11-25T04:03:06+08:00	684	1598	2282	276	2558	7382	34.65%	9.27%	12	12
15	澎湖縣西嶼鄉	2018-11-24T23:27:31+08:00	684	1598	2282	276	2558	7382	34.65%	9.27%	12	12
15	澎湖縣西嶼鄉	2018-11-24T22:30:23+08:00	684	1598	2282	276	2558	7382	34.65%	9.27%	12	12
15	澎湖縣西嶼鄉	2018-11-25T03:32:52+08:00	684	1598	2282	276	2558	7382	34.65%	9.27%	12	12
15	澎湖縣西嶼鄉	2018-11-25T00:57:51+08:00	684	1598	2282	276	2558	7382	34.65%	9.27%	12	12
15	澎湖縣西嶼鄉	2018-11-24T22:19:50+08:00	684	1598	2282	276	2558	7382	34.65%	9.27%	12	12
15	澎湖縣西嶼鄉	2018-11-24T22:16:25+08:00	684	1598	2282	276	2558	7382	34.65%	9.27%	12	12
15	澎湖縣西嶼鄉	2018-11-25T00:09:50+08:00	684	1598	2282	276	2558	7382	34.65%	9.27%	12	12
15	澎湖縣西嶼鄉	2018-11-25T00:18:47+08:00	684	1598	2282	276	2558	7382	34.65%	9.27%	12	12
15	澎湖縣西嶼鄉	2018-11-24T22:37:14+08:00	684	1598	2282	276	2558	7382	34.65%	9.27%	12	12
15	澎湖縣西嶼鄉	2018-11-24T23:20:08+08:00	684	1598	2282	276	2558	7382	34.65%	9.27%	12	12
15	澎湖縣西嶼鄉	2018-11-24T23:31:27+08:00	684	1598	2282	276	2558	7382	34.65%	9.27%	12	12
15	澎湖縣西嶼鄉	2018-11-24T22:45:21+08:00	684	1598	2282	276	2558	7382	34.65%	9.27%	12	12
15	澎湖縣西嶼鄉	2018-11-24T22:33:51+08:00	684	1598	2282	276	2558	7382	34.65%	9.27%	12	12
15	澎湖縣西嶼鄉	2018-11-24T23:39:33+08:00	684	1598	2282	276	2558	7382	34.65%	9.27%	12	12
15	澎湖縣西嶼鄉	2018-11-24T23:05:16+08:00	684	1598	2282	276	2558	7382	34.65%	9.27%	12	12
15	澎湖縣西嶼鄉	2018-11-24T22:26:49+08:00	684	1598	2282	276	2558	7382	34.65%	9.27%	12	12
15	澎湖縣西嶼鄉	2018-11-25T01:07:40+08:00	684	1598	2282	276	2558	7382	34.65%	9.27%	12	12
15	澎湖縣西嶼鄉	2018-11-24T22:54:37+08:00	684	1598	2282	276	2558	7382	34.65%	9.27%	12	12
15	澎湖縣西嶼鄉	2018-11-25T01:12:59+08:00	684	1598	2282	276	2558	7382	34.65%	9.27%	12	12
15	澎湖縣西嶼鄉	2018-11-25T00:05:18+08:00	684	1598	2282	276	2558	7382	34.65%	9.27%	12	12
15	澎湖縣西嶼鄉	2018-11-24T23:08:51+08:00	684	1598	2282	276	2558	7382	34.65%	9.27%	12	12
15	澎湖縣西嶼鄉	2018-11-24T23:23:51+08:00	684	1598	2282	276	2558	7382	34.65%	9.27%	12	12
15	澎湖縣西嶼鄉	2018-11-24T22:23:29+08:00	684	1598	2282	276	2558	7382	34.65%	9.27%	12	12
15	澎湖縣西嶼鄉	2018-11-25T00:23:17+08:00	684	1598	2282	276	2558	7382	34.65%	9.27%	12	12
15	澎湖縣西嶼鄉	2018-11-25T00:00:24+08:00	684	1598	2282	276	2558	7382	34.65%	9.27%	12	12
15	澎湖縣西嶼鄉	2018-11-24T22:51:04+08:00	684	1598	2282	276	2558	7382	34.65%	9.27%	12	12
15	澎湖縣西嶼鄉	2018-11-25T06:09:10+08:00	684	1598	2282	276	2558	7382	34.65%	9.27%	12	12
15	澎湖縣西嶼鄉	2018-11-24T22:40:40+08:00	684	1598	2282	276	2558	7382	34.65%	9.27%	12	12
15	澎湖縣西嶼鄉	2018-11-25T06:24:13+08:00	684	1598	2282	276	2558	7382	34.65%	9.27%	12	12
15	澎湖縣西嶼鄉	2018-11-25T01:02:44+08:00	684	1598	2282	276	2558	7382	34.65%	9.27%	12	12
15	澎湖縣西嶼鄉	2018-11-25T06:14:05+08:00	684	1598	2282	276	2558	7382	34.65%	9.27%	12	12
15	澎湖縣西嶼鄉	2018-11-25T06:19:10+08:00	684	1598	2282	276	2558	7382	34.65%	9.27%	12	12
15	澎湖縣西嶼鄉	2018-11-25T00:14:23+08:00	684	1598	2282	276	2558	7382	34.65%	9.27%	12	12
15	澎湖縣西嶼鄉	2018-11-25T01:18:10+08:00	684	1598	2282	276	2558	7382	34.65%	9.27%	12	12
15	澎湖縣西嶼鄉	2018-11-25T03:50:04+08:00	684	1598	2282	276	2558	7382	34.65%	9.27%	12	12
15	澎湖縣西嶼鄉	2018-11-24T23:43:31+08:00	684	1598	2282	276	2558	7382	34.65%	9.27%	12	12
15	澎湖縣西嶼鄉	2018-11-25T06:29:31+08:00	684	1598	2282	276	2558	7382	34.65%	9.27%	12	12
15	澎湖縣西嶼鄉	2018-11-24T23:16:16+08:00	684	1598	2282	276	2558	7382	34.65%	9.27%	12	12
15	澎湖縣西嶼鄉	2018-11-24T23:35:22+08:00	684	1598	2282	276	2558	7382	34.65%	9.27%	12	12
15	澎湖縣西嶼鄉	2018-11-24T22:41:51+08:00	684	1598	2282	276	2558	7382	34.65%	9.27%	12	12
15	澎湖縣西嶼鄉	2018-11-25T03:39:08+08:00	684	1598	2282	276	2558	7382	34.65%	9.27%	12	12
15	澎湖縣西嶼鄉	2018-11-25T01:26:08+08:00	684	1598	2282	276	2558	7382	34.65%	9.27%	12	12
15	苗栗縣獅潭鄉	2018-11-24T22:26:44+08:00	497	1381	1878	161	2039	3968	51.39%	12.53%	7	7
15	苗栗縣獅潭鄉	2018-11-25T00:05:13+08:00	497	1381	1878	161	2039	3968	51.39%	12.53%	7	7
15	苗栗縣獅潭鄉	2018-11-24T23:01:40+08:00	497	1381	1878	161	2039	3968	51.39%	12.53%	7	7
15	苗栗縣獅潭鄉	2018-11-24T23:05:12+08:00	497	1381	1878	161	2039	3968	51.39%	12.53%	7	7
15	苗栗縣獅潭鄉	2018-11-25T06:29:26+08:00	497	1381	1878	161	2039	3968	51.39%	12.53%	7	7
15	苗栗縣獅潭鄉	2018-11-25T00:09:43+08:00	497	1381	1878	161	2039	3968	51.39%	12.53%	7	7
15	苗栗縣獅潭鄉	2018-11-24T22:37:08+08:00	497	1381	1878	161	2039	3968	51.39%	12.53%	7	7
15	苗栗縣獅潭鄉	2018-11-24T22:54:33+08:00	497	1381	1878	161	2039	3968	51.39%	12.53%	7	7
15	苗栗縣獅潭鄉	2018-11-24T22:50:57+08:00	497	1381	1878	161	2039	3968	51.39%	12.53%	7	7
15	苗栗縣獅潭鄉	2018-11-25T01:12:53+08:00	497	1381	1878	161	2039	3968	51.39%	12.53%	7	7
15	苗栗縣獅潭鄉	2018-11-24T22:40:35+08:00	497	1381	1878	161	2039	3968	51.39%	12.53%	7	7
15	苗栗縣獅潭鄉	2018-11-24T22:19:45+08:00	497	1381	1878	161	2039	3968	51.39%	12.53%	7	7
15	苗栗縣獅潭鄉	2018-11-25T01:02:39+08:00	497	1381	1878	161	2039	3968	51.39%	12.53%	7	7
15	苗栗縣獅潭鄉	2018-11-25T04:03:00+08:00	497	1381	1878	161	2039	3968	51.39%	12.53%	7	7
15	苗栗縣獅潭鄉	2018-11-25T06:14:00+08:00	497	1381	1878	161	2039	3968	51.39%	12.53%	7	7
15	苗栗縣獅潭鄉	2018-11-24T23:23:46+08:00	497	1381	1878	161	2039	3968	51.39%	12.53%	7	7
15	苗栗縣獅潭鄉	2018-11-24T22:23:23+08:00	497	1381	1878	161	2039	3968	51.39%	12.53%	7	7
15	苗栗縣獅潭鄉	2018-11-25T03:32:46+08:00	497	1381	1878	161	2039	3968	51.39%	12.53%	7	7
15	苗栗縣獅潭鄉	2018-11-24T23:55:55+08:00	497	1381	1878	161	2039	3968	51.39%	12.53%	7	7
15	苗栗縣獅潭鄉	2018-11-25T00:00:19+08:00	497	1381	1878	161	2039	3968	51.39%	12.53%	7	7
15	苗栗縣獅潭鄉	2018-11-25T00:23:12+08:00	497	1381	1878	161	2039	3968	51.39%	12.53%	7	7
15	苗栗縣獅潭鄉	2018-11-24T23:08:46+08:00	497	1381	1878	161	2039	3968	51.39%	12.53%	7	7
15	苗栗縣獅潭鄉	2018-11-24T23:31:21+08:00	497	1381	1878	161	2039	3968	51.39%	12.53%	7	7
15	苗栗縣獅潭鄉	2018-11-24T23:20:00+08:00	497	1381	1878	161	2039	3968	51.39%	12.53%	7	7
15	苗栗縣獅潭鄉	2018-11-25T01:07:34+08:00	497	1381	1878	161	2039	3968	51.39%	12.53%	7	7
15	苗栗縣獅潭鄉	2018-11-24T23:35:18+08:00	497	1381	1878	161	2039	3968	51.39%	12.53%	7	7
15	苗栗縣獅潭鄉	2018-11-25T00:14:18+08:00	497	1381	1878	161	2039	3968	51.39%	12.53%	7	7
15	苗栗縣獅潭鄉	2018-11-24T23:12:25+08:00	497	1381	1878	161	2039	3968	51.39%	12.53%	7	7
15	苗栗縣獅潭鄉	2018-11-25T03:39:02+08:00	497	1381	1878	161	2039	3968	51.39%	12.53%	7	7
15	苗栗縣獅潭鄉	2018-11-24T22:33:46+08:00	497	1381	1878	161	2039	3968	51.39%	12.53%	7	7
15	苗栗縣獅潭鄉	2018-11-25T00:18:41+08:00	497	1381	1878	161	2039	3968	51.39%	12.53%	7	7
15	苗栗縣獅潭鄉	2018-11-24T22:41:45+08:00	497	1381	1878	161	2039	3968	51.39%	12.53%	7	7
15	苗栗縣獅潭鄉	2018-11-25T03:56:22+08:00	497	1381	1878	161	2039	3968	51.39%	12.53%	7	7
15	苗栗縣獅潭鄉	2018-11-25T06:19:05+08:00	497	1381	1878	161	2039	3968	51.39%	12.53%	7	7
15	苗栗縣獅潭鄉	2018-11-24T22:45:16+08:00	497	1381	1878	161	2039	3968	51.39%	12.53%	7	7
15	苗栗縣獅潭鄉	2018-11-24T23:43:25+08:00	497	1381	1878	161	2039	3968	51.39%	12.53%	7	7
15	苗栗縣獅潭鄉	2018-11-25T01:18:03+08:00	497	1381	1878	161	2039	3968	51.39%	12.53%	7	7
15	苗栗縣獅潭鄉	2018-11-25T03:49:59+08:00	497	1381	1878	161	2039	3968	51.39%	12.53%	7	7
15	苗栗縣獅潭鄉	2018-11-24T22:58:03+08:00	497	1381	1878	161	2039	3968	51.39%	12.53%	7	7
15	苗栗縣獅潭鄉	2018-11-25T06:09:03+08:00	497	1381	1878	161	2039	3968	51.39%	12.53%	7	7
15	苗栗縣獅潭鄉	2018-11-24T23:51:43+08:00	497	1381	1878	161	2039	3968	51.39%	12.53%	7	7
15	苗栗縣獅潭鄉	2018-11-25T06:24:08+08:00	497	1381	1878	161	2039	3968	51.39%	12.53%	7	7
15	苗栗縣獅潭鄉	2018-11-25T00:57:46+08:00	497	1381	1878	161	2039	3968	51.39%	12.53%	7	7
15	苗栗縣獅潭鄉	2018-11-24T22:30:18+08:00	497	1381	1878	161	2039	3968	51.39%	12.53%	7	7
15	苗栗縣獅潭鄉	2018-11-24T23:27:26+08:00	497	1381	1878	161	2039	3968	51.39%	12.53%	7	7
15	苗栗縣獅潭鄉	2018-11-24T22:13:39+08:00	497	1381	1878	161	2039	3968	51.39%	12.53%	7	7
15	苗栗縣獅潭鄉	2018-11-25T03:44:33+08:00	497	1381	1878	161	2039	3968	51.39%	12.53%	7	7
15	苗栗縣獅潭鄉	2018-11-24T23:39:26+08:00	497	1381	1878	161	2039	3968	51.39%	12.53%	7	7
15	苗栗縣獅潭鄉	2018-11-24T23:16:11+08:00	497	1381	1878	161	2039	3968	51.39%	12.53%	7	7
15	苗栗縣獅潭鄉	2018-11-24T23:47:38+08:00	497	1381	1878	161	2039	3968	51.39%	12.53%	7	7
15	苗栗縣獅潭鄉	2018-11-25T01:26:01+08:00	497	1381	1878	161	2039	3968	51.39%	12.53%	7	7
15	苗栗縣獅潭鄉	2018-11-24T22:16:20+08:00	497	1381	1878	161	2039	3968	51.39%	12.53%	7	7
15	苗栗縣卓蘭鎮	2018-11-24T22:26:44+08:00	2004	4929	6933	529	7462	12737	58.59%	15.73%	17	19
15	苗栗縣卓蘭鎮	2018-11-25T00:05:13+08:00	2137	5302	7439	545	7984	13677	58.38%	15.62%	18	19
15	苗栗縣卓蘭鎮	2018-11-25T00:09:43+08:00	2341	5742	8083	604	8687	14772	58.81%	15.85%	19	19
15	苗栗縣卓蘭鎮	2018-11-24T22:37:08+08:00	2137	5302	7439	545	7984	13677	58.38%	15.62%	18	19
15	苗栗縣卓蘭鎮	2018-11-24T22:45:15+08:00	2137	5302	7439	545	7984	13677	58.38%	15.62%	18	19
15	苗栗縣卓蘭鎮	2018-11-24T22:54:33+08:00	2137	5302	7439	545	7984	13677	58.38%	15.62%	18	19
15	苗栗縣卓蘭鎮	2018-11-24T22:50:57+08:00	2137	5302	7439	545	7984	13677	58.38%	15.62%	18	19
15	苗栗縣卓蘭鎮	2018-11-25T01:12:53+08:00	2341	5742	8083	604	8687	14772	58.81%	15.85%	19	19
15	苗栗縣卓蘭鎮	2018-11-24T22:40:35+08:00	2137	5302	7439	545	7984	13677	58.38%	15.62%	18	19
15	苗栗縣卓蘭鎮	2018-11-25T01:02:39+08:00	2341	5742	8083	604	8687	14772	58.81%	15.85%	19	19
15	苗栗縣卓蘭鎮	2018-11-25T04:03:00+08:00	2341	5742	8083	604	8687	14772	58.81%	15.85%	19	19
15	苗栗縣卓蘭鎮	2018-11-25T00:57:45+08:00	2341	5742	8083	604	8687	14772	58.81%	15.85%	19	19
15	苗栗縣卓蘭鎮	2018-11-24T22:19:44+08:00	2004	4929	6933	529	7462	12737	58.59%	15.73%	17	19
15	苗栗縣卓蘭鎮	2018-11-25T06:14:00+08:00	2341	5742	8083	604	8687	14772	58.81%	15.85%	19	19
15	苗栗縣卓蘭鎮	2018-11-25T00:00:18+08:00	2137	5302	7439	545	7984	13677	58.38%	15.62%	18	19
15	苗栗縣卓蘭鎮	2018-11-24T23:23:46+08:00	2137	5302	7439	545	7984	13677	58.38%	15.62%	18	19
15	苗栗縣卓蘭鎮	2018-11-24T23:27:25+08:00	2137	5302	7439	545	7984	13677	58.38%	15.62%	18	19
15	苗栗縣卓蘭鎮	2018-11-24T23:55:55+08:00	2137	5302	7439	545	7984	13677	58.38%	15.62%	18	19
15	苗栗縣卓蘭鎮	2018-11-25T00:23:12+08:00	2341	5742	8083	604	8687	14772	58.81%	15.85%	19	19
15	苗栗縣卓蘭鎮	2018-11-24T22:23:22+08:00	2004	4929	6933	529	7462	12737	58.59%	15.73%	17	19
15	苗栗縣卓蘭鎮	2018-11-24T23:01:39+08:00	2137	5302	7439	545	7984	13677	58.38%	15.62%	18	19
15	苗栗縣卓蘭鎮	2018-11-24T23:20:00+08:00	2137	5302	7439	545	7984	13677	58.38%	15.62%	18	19
15	苗栗縣卓蘭鎮	2018-11-25T01:07:34+08:00	2341	5742	8083	604	8687	14772	58.81%	15.85%	19	19
15	苗栗縣卓蘭鎮	2018-11-24T23:35:18+08:00	2137	5302	7439	545	7984	13677	58.38%	15.62%	18	19
15	苗栗縣卓蘭鎮	2018-11-25T00:18:40+08:00	2341	5742	8083	604	8687	14772	58.81%	15.85%	19	19
15	苗栗縣卓蘭鎮	2018-11-25T00:14:18+08:00	2341	5742	8083	604	8687	14772	58.81%	15.85%	19	19
15	苗栗縣卓蘭鎮	2018-11-24T23:12:25+08:00	2137	5302	7439	545	7984	13677	58.38%	15.62%	18	19
15	苗栗縣卓蘭鎮	2018-11-25T03:39:02+08:00	2341	5742	8083	604	8687	14772	58.81%	15.85%	19	19
15	苗栗縣卓蘭鎮	2018-11-24T23:31:20+08:00	2137	5302	7439	545	7984	13677	58.38%	15.62%	18	19
15	苗栗縣卓蘭鎮	2018-11-24T23:43:24+08:00	2137	5302	7439	545	7984	13677	58.38%	15.62%	18	19
15	苗栗縣卓蘭鎮	2018-11-24T22:58:02+08:00	2137	5302	7439	545	7984	13677	58.38%	15.62%	18	19
15	苗栗縣卓蘭鎮	2018-11-25T03:56:22+08:00	2341	5742	8083	604	8687	14772	58.81%	15.85%	19	19
15	苗栗縣卓蘭鎮	2018-11-25T06:29:25+08:00	2341	5742	8083	604	8687	14772	58.81%	15.85%	19	19
15	苗栗縣卓蘭鎮	2018-11-25T06:19:05+08:00	2341	5742	8083	604	8687	14772	58.81%	15.85%	19	19
15	苗栗縣卓蘭鎮	2018-11-24T23:05:11+08:00	2137	5302	7439	545	7984	13677	58.38%	15.62%	18	19
15	苗栗縣卓蘭鎮	2018-11-24T22:41:44+08:00	2137	5302	7439	545	7984	13677	58.38%	15.62%	18	19
15	苗栗縣卓蘭鎮	2018-11-25T01:18:03+08:00	2341	5742	8083	604	8687	14772	58.81%	15.85%	19	19
15	苗栗縣卓蘭鎮	2018-11-25T03:49:59+08:00	2341	5742	8083	604	8687	14772	58.81%	15.85%	19	19
15	苗栗縣卓蘭鎮	2018-11-25T06:09:03+08:00	2341	5742	8083	604	8687	14772	58.81%	15.85%	19	19
15	苗栗縣卓蘭鎮	2018-11-24T23:51:43+08:00	2137	5302	7439	545	7984	13677	58.38%	15.62%	18	19
15	苗栗縣卓蘭鎮	2018-11-25T06:24:08+08:00	2341	5742	8083	604	8687	14772	58.81%	15.85%	19	19
15	苗栗縣卓蘭鎮	2018-11-24T22:30:18+08:00	2004	4929	6933	529	7462	12737	58.59%	15.73%	17	19
15	苗栗縣卓蘭鎮	2018-11-25T03:32:45+08:00	2341	5742	8083	604	8687	14772	58.81%	15.85%	19	19
15	苗栗縣卓蘭鎮	2018-11-24T22:13:38+08:00	2004	4929	6933	529	7462	12737	58.59%	15.73%	17	19
15	苗栗縣卓蘭鎮	2018-11-24T23:08:45+08:00	2137	5302	7439	545	7984	13677	58.38%	15.62%	18	19
15	苗栗縣卓蘭鎮	2018-11-25T03:44:33+08:00	2341	5742	8083	604	8687	14772	58.81%	15.85%	19	19
15	苗栗縣卓蘭鎮	2018-11-24T23:16:10+08:00	2137	5302	7439	545	7984	13677	58.38%	15.62%	18	19
15	苗栗縣卓蘭鎮	2018-11-24T23:47:37+08:00	2137	5302	7439	545	7984	13677	58.38%	15.62%	18	19
15	苗栗縣卓蘭鎮	2018-11-24T22:16:19+08:00	2004	4929	6933	529	7462	12737	58.59%	15.73%	17	19
15	苗栗縣卓蘭鎮	2018-11-24T23:39:26+08:00	2137	5302	7439	545	7984	13677	58.38%	15.62%	18	19
15	苗栗縣卓蘭鎮	2018-11-25T01:26:01+08:00	2341	5742	8083	604	8687	14772	58.81%	15.85%	19	19
15	苗栗縣卓蘭鎮	2018-11-24T22:33:45+08:00	2004	4929	6933	529	7462	12737	58.59%	15.73%	17	19
15	高雄市楠梓區	2018-11-25T03:56:19+08:00	28585	57582	86167	5512	91679	153132	59.87%	18.67%	99	99
15	高雄市楠梓區	2018-11-24T22:45:14+08:00	18071	36019	54090	3512	57602	95686	60.2%	18.89%	65	99
15	高雄市楠梓區	2018-11-24T22:58:00+08:00	19638	39198	58836	3812	62648	104172	60.14%	18.85%	70	99
15	高雄市楠梓區	2018-11-24T22:26:42+08:00	14987	29997	44984	2810	47794	79328	60.25%	18.89%	54	99
15	高雄市楠梓區	2018-11-25T01:18:00+08:00	28585	57582	86167	5512	91679	153132	59.87%	18.67%	99	99
15	高雄市楠梓區	2018-11-24T23:16:09+08:00	22243	44241	66484	4258	70742	118186	59.86%	18.82%	78	99
15	高雄市楠梓區	2018-11-25T00:18:38+08:00	28585	57582	86167	5512	91679	153132	59.87%	18.67%	99	99
15	高雄市楠梓區	2018-11-24T22:37:06+08:00	16970	33873	50843	3215	54058	89724	60.25%	18.91%	61	99
15	高雄市楠梓區	2018-11-25T06:09:00+08:00	28585	57582	86167	5512	91679	153132	59.87%	18.67%	99	99
15	高雄市楠梓區	2018-11-25T01:25:59+08:00	28585	57582	86167	5512	91679	153132	59.87%	18.67%	99	99
15	高雄市楠梓區	2018-11-25T00:57:43+08:00	28585	57582	86167	5512	91679	153132	59.87%	18.67%	99	99
15	高雄市楠梓區	2018-11-25T01:02:37+08:00	28585	57582	86167	5512	91679	153132	59.87%	18.67%	99	99
15	高雄市楠梓區	2018-11-24T22:40:33+08:00	17231	34365	51596	3346	54942	91217	60.23%	18.89%	62	99
15	高雄市楠梓區	2018-11-24T23:51:41+08:00	27250	54804	82054	5171	87225	145669	59.88%	18.71%	94	99
15	高雄市楠梓區	2018-11-24T22:19:43+08:00	13421	26810	40231	2563	42794	70893	60.36%	18.93%	49	99
15	高雄市楠梓區	2018-11-24T23:55:53+08:00	27250	54804	82054	5171	87225	145669	59.88%	18.71%	94	99
15	高雄市楠梓區	2018-11-24T22:13:35+08:00	12262	24588	36850	2371	39221	65007	60.33%	18.86%	45	99
15	高雄市楠梓區	2018-11-25T00:00:17+08:00	27588	55457	83045	5218	88263	147315	59.91%	18.73%	95	99
15	高雄市楠梓區	2018-11-24T23:19:58+08:00	22553	44831	67384	4321	71705	119682	59.91%	18.84%	79	99
15	高雄市楠梓區	2018-11-24T23:27:24+08:00	23193	46253	69446	4461	73907	123370	59.91%	18.8%	81	99
15	高雄市楠梓區	2018-11-25T03:44:30+08:00	28585	57582	86167	5512	91679	153132	59.87%	18.67%	99	99
15	高雄市楠梓區	2018-11-24T23:01:37+08:00	19638	39198	58836	3812	62648	104172	60.14%	18.85%	70	99
15	高雄市楠梓區	2018-11-25T04:02:58+08:00	28585	57582	86167	5512	91679	153132	59.87%	18.67%	99	99
15	高雄市楠梓區	2018-11-25T00:14:16+08:00	28399	57231	85630	5437	91067	152218	59.83%	18.66%	98	99
15	高雄市楠梓區	2018-11-24T23:35:16+08:00	24538	49094	73632	4678	78310	131001	59.78%	18.73%	85	99
15	高雄市楠梓區	2018-11-24T23:12:22+08:00	20556	40896	61452	3998	65450	109124	59.98%	18.84%	73	99
15	高雄市楠梓區	2018-11-24T23:31:18+08:00	24259	48478	72737	4651	77388	129252	59.87%	18.77%	84	99
15	高雄市楠梓區	2018-11-24T23:39:23+08:00	25161	50447	75608	4813	80421	134698	59.7%	18.68%	87	99
15	高雄市楠梓區	2018-11-25T01:07:32+08:00	28585	57582	86167	5512	91679	153132	59.87%	18.67%	99	99
15	高雄市楠梓區	2018-11-24T23:47:35+08:00	26657	53444	80101	5045	85146	142545	59.73%	18.7%	92	99
15	高雄市楠梓區	2018-11-24T23:43:23+08:00	26657	53444	80101	5045	85146	142545	59.73%	18.7%	92	99
15	高雄市楠梓區	2018-11-24T22:41:42+08:00	17231	34365	51596	3346	54942	91217	60.23%	18.89%	62	99
15	高雄市楠梓區	2018-11-25T06:13:58+08:00	28585	57582	86167	5512	91679	153132	59.87%	18.67%	99	99
15	高雄市楠梓區	2018-11-24T22:54:31+08:00	19638	39198	58836	3812	62648	104172	60.14%	18.85%	70	99
15	高雄市楠梓區	2018-11-24T22:50:55+08:00	18407	36609	55016	3553	58569	97277	60.21%	18.92%	66	99
15	高雄市楠梓區	2018-11-25T00:09:41+08:00	28399	57231	85630	5437	91067	152218	59.83%	18.66%	98	99
15	高雄市楠梓區	2018-11-25T01:12:50+08:00	28585	57582	86167	5512	91679	153132	59.87%	18.67%	99	99
15	高雄市楠梓區	2018-11-25T06:29:23+08:00	28585	57582	86167	5512	91679	153132	59.87%	18.67%	99	99
15	高雄市楠梓區	2018-11-25T03:49:57+08:00	28585	57582	86167	5512	91679	153132	59.87%	18.67%	99	99
15	高雄市楠梓區	2018-11-24T23:05:10+08:00	20246	40430	60676	3926	64602	107596	60.04%	18.82%	72	99
15	高雄市楠梓區	2018-11-25T06:19:03+08:00	28585	57582	86167	5512	91679	153132	59.87%	18.67%	99	99
15	高雄市楠梓區	2018-11-25T00:05:11+08:00	27782	56021	83803	5285	89088	148754	59.89%	18.68%	96	99
15	高雄市楠梓區	2018-11-25T06:24:06+08:00	28585	57582	86167	5512	91679	153132	59.87%	18.67%	99	99
15	高雄市楠梓區	2018-11-24T22:30:16+08:00	15532	31032	46564	2932	49496	82103	60.29%	18.92%	56	99
15	高雄市楠梓區	2018-11-24T23:08:43+08:00	20556	40896	61452	3998	65450	109124	59.98%	18.84%	73	99
15	高雄市楠梓區	2018-11-24T22:23:20+08:00	14377	28744	43121	2714	45835	75938	60.36%	18.93%	52	99
15	高雄市楠梓區	2018-11-25T00:23:10+08:00	28585	57582	86167	5512	91679	153132	59.87%	18.67%	99	99
15	高雄市楠梓區	2018-11-25T03:32:43+08:00	28585	57582	86167	5512	91679	153132	59.87%	18.67%	99	99
15	高雄市楠梓區	2018-11-24T23:23:44+08:00	22553	44831	67384	4321	71705	119682	59.91%	18.84%	79	99
15	高雄市楠梓區	2018-11-24T22:33:44+08:00	16071	32060	48131	3010	51141	84880	60.25%	18.93%	58	99
15	高雄市楠梓區	2018-11-24T22:16:17+08:00	12858	25878	38736	2480	41216	68271	60.37%	18.83%	47	99
15	高雄市楠梓區	2018-11-25T03:39:00+08:00	28585	57582	86167	5512	91679	153132	59.87%	18.67%	99	99
15	高雄市大寮區	2018-11-25T01:18:01+08:00	16588	35551	52139	3391	55530	97309	57.07%	17.05%	81	81
15	高雄市大寮區	2018-11-24T22:58:01+08:00	14473	30859	45332	2966	48298	84698	57.02%	17.09%	72	81
15	高雄市大寮區	2018-11-24T22:37:07+08:00	13766	29400	43166	2828	45994	80777	56.94%	17.04%	69	81
15	高雄市大寮區	2018-11-24T22:45:14+08:00	14217	30362	44579	2899	47478	83440	56.9%	17.04%	71	81
15	高雄市大寮區	2018-11-25T03:56:20+08:00	16588	35551	52139	3391	55530	97309	57.07%	17.05%	81	81
15	高雄市大寮區	2018-11-24T22:26:42+08:00	12976	27684	40660	2624	43284	75997	56.95%	17.07%	66	81
15	高雄市大寮區	2018-11-24T23:16:09+08:00	15368	32759	48127	3125	51252	89861	57.03%	17.1%	76	81
15	高雄市大寮區	2018-11-25T00:18:38+08:00	16314	34925	51239	3364	54603	95680	57.07%	17.05%	80	81
15	高雄市大寮區	2018-11-25T01:25:59+08:00	16588	35551	52139	3391	55530	97309	57.07%	17.05%	81	81
15	高雄市大寮區	2018-11-25T00:57:43+08:00	16588	35551	52139	3391	55530	97309	57.07%	17.05%	81	81
15	高雄市大寮區	2018-11-25T01:02:37+08:00	16588	35551	52139	3391	55530	97309	57.07%	17.05%	81	81
15	高雄市大寮區	2018-11-24T22:40:33+08:00	13766	29400	43166	2828	45994	80777	56.94%	17.04%	69	81
15	高雄市大寮區	2018-11-25T06:09:01+08:00	16588	35551	52139	3391	55530	97309	57.07%	17.05%	81	81
15	高雄市大寮區	2018-11-24T22:19:43+08:00	12976	27684	40660	2624	43284	75997	56.95%	17.07%	66	81
15	高雄市大寮區	2018-11-24T23:55:53+08:00	15870	33814	49684	3245	52929	92882	56.99%	17.09%	78	81
15	高雄市大寮區	2018-11-25T03:44:31+08:00	16588	35551	52139	3391	55530	97309	57.07%	17.05%	81	81
15	高雄市大寮區	2018-11-25T00:00:17+08:00	15870	33814	49684	3245	52929	92882	56.99%	17.09%	78	81
15	高雄市大寮區	2018-11-24T23:19:58+08:00	15368	32759	48127	3125	51252	89861	57.03%	17.1%	76	81
15	高雄市大寮區	2018-11-24T23:27:24+08:00	15368	32759	48127	3125	51252	89861	57.03%	17.1%	76	81
15	高雄市大寮區	2018-11-25T01:07:33+08:00	16588	35551	52139	3391	55530	97309	57.07%	17.05%	81	81
15	高雄市大寮區	2018-11-24T23:31:19+08:00	15368	32759	48127	3125	51252	89861	57.03%	17.1%	76	81
15	高雄市大寮區	2018-11-24T23:01:37+08:00	14679	31293	45972	3012	48984	85818	57.08%	17.1%	73	81
15	高雄市大寮區	2018-11-24T23:12:23+08:00	15144	32251	47395	3096	50491	88471	57.07%	17.12%	75	81
15	高雄市大寮區	2018-11-25T00:14:16+08:00	16099	34420	50519	3287	53806	94400	57%	17.05%	79	81
15	高雄市大寮區	2018-11-24T23:35:16+08:00	15640	33318	48958	3189	52147	91481	57%	17.1%	77	81
15	高雄市大寮區	2018-11-24T23:39:24+08:00	15640	33318	48958	3189	52147	91481	57%	17.1%	77	81
15	高雄市大寮區	2018-11-25T04:02:59+08:00	16588	35551	52139	3391	55530	97309	57.07%	17.05%	81	81
15	高雄市大寮區	2018-11-24T23:43:23+08:00	15640	33318	48958	3189	52147	91481	57%	17.1%	77	81
15	高雄市大寮區	2018-11-25T01:12:51+08:00	16588	35551	52139	3391	55530	97309	57.07%	17.05%	81	81
15	高雄市大寮區	2018-11-25T06:13:58+08:00	16588	35551	52139	3391	55530	97309	57.07%	17.05%	81	81
15	高雄市大寮區	2018-11-24T22:54:31+08:00	14217	30362	44579	2899	47478	83440	56.9%	17.04%	71	81
15	高雄市大寮區	2018-11-24T22:50:55+08:00	14217	30362	44579	2899	47478	83440	56.9%	17.04%	71	81
15	高雄市大寮區	2018-11-25T00:09:41+08:00	16099	34420	50519	3287	53806	94400	57%	17.05%	79	81
15	高雄市大寮區	2018-11-24T22:41:43+08:00	13766	29400	43166	2828	45994	80777	56.94%	17.04%	69	81
15	高雄市大寮區	2018-11-25T03:49:57+08:00	16588	35551	52139	3391	55530	97309	57.07%	17.05%	81	81
15	高雄市大寮區	2018-11-24T23:05:10+08:00	14679	31293	45972	3012	48984	85818	57.08%	17.1%	73	81
15	高雄市大寮區	2018-11-25T06:19:03+08:00	16588	35551	52139	3391	55530	97309	57.07%	17.05%	81	81
15	高雄市大寮區	2018-11-25T06:29:24+08:00	16588	35551	52139	3391	55530	97309	57.07%	17.05%	81	81
15	高雄市大寮區	2018-11-25T00:05:11+08:00	15870	33814	49684	3245	52929	92882	56.99%	17.09%	78	81
15	高雄市大寮區	2018-11-25T06:24:06+08:00	16588	35551	52139	3391	55530	97309	57.07%	17.05%	81	81
15	高雄市大寮區	2018-11-24T22:30:16+08:00	13255	28261	41516	2682	44198	77632	56.93%	17.07%	67	81
15	高雄市大寮區	2018-11-24T23:51:42+08:00	15870	33814	49684	3245	52929	92882	56.99%	17.09%	78	81
15	高雄市大寮區	2018-11-24T22:13:36+08:00	12596	26856	39452	2499	41951	73712	56.91%	17.09%	64	81
15	高雄市大寮區	2018-11-24T23:08:43+08:00	14679	31293	45972	3012	48984	85818	57.08%	17.1%	73	81
15	高雄市大寮區	2018-11-24T22:23:20+08:00	12976	27684	40660	2624	43284	75997	56.95%	17.07%	66	81
15	高雄市大寮區	2018-11-25T00:23:10+08:00	16314	34925	51239	3364	54603	95680	57.07%	17.05%	80	81
15	高雄市大寮區	2018-11-25T03:32:43+08:00	16588	35551	52139	3391	55530	97309	57.07%	17.05%	81	81
15	高雄市大寮區	2018-11-24T23:23:44+08:00	15368	32759	48127	3125	51252	89861	57.03%	17.1%	76	81
15	高雄市大寮區	2018-11-24T22:33:44+08:00	13255	28261	41516	2682	44198	77632	56.93%	17.07%	67	81
15	高雄市大寮區	2018-11-24T22:16:17+08:00	12794	27263	40057	2591	42648	74891	56.95%	17.08%	65	81
15	高雄市大寮區	2018-11-24T23:47:36+08:00	15640	33318	48958	3189	52147	91481	57%	17.1%	77	81
15	高雄市大寮區	2018-11-25T03:39:01+08:00	16588	35551	52139	3391	55530	97309	57.07%	17.05%	81	81
