案	區	時間	同意票數	不同意票數	有效票數	無效票數	投票數	投票權人數	投票率(%)	有效同意票數對投票權人數百分比(%)	已送	應送
14	基隆市安樂區	2018-11-24T22:33:39+08:00	4844	9055	13899	700	14599	27794	52.53%	17.43%	23	49
14	基隆市安樂區	2018-11-25T06:29:19+08:00	12394	22700	35094	1570	36664	70396	52.08%	17.61%	49	49
14	基隆市安樂區	2018-11-25T01:07:28+08:00	12156	22247	34403	1536	35939	68996	52.09%	17.62%	48	49
14	基隆市安樂區	2018-11-25T03:49:53+08:00	12394	22700	35094	1570	36664	70396	52.08%	17.61%	49	49
14	基隆市安樂區	2018-11-24T22:50:50+08:00	5833	11057	16890	831	17721	33386	53.08%	17.47%	27	49
14	基隆市安樂區	2018-11-25T06:13:54+08:00	12394	22700	35094	1570	36664	70396	52.08%	17.61%	49	49
14	基隆市安樂區	2018-11-24T23:43:19+08:00	9303	18072	27375	1200	28575	55379	51.6%	16.8%	40	49
14	基隆市安樂區	2018-11-24T22:13:29+08:00	3986	7438	11424	586	12010	22830	52.61%	17.46%	20	49
14	基隆市安樂區	2018-11-25T03:32:36+08:00	12394	22700	35094	1570	36664	70396	52.08%	17.61%	49	49
14	基隆市安樂區	2018-11-25T03:44:25+08:00	12394	22700	35094	1570	36664	70396	52.08%	17.61%	49	49
14	基隆市安樂區	2018-11-24T23:08:38+08:00	6773	12867	19640	944	20584	39337	52.33%	17.22%	31	49
14	基隆市安樂區	2018-11-24T23:55:49+08:00	10043	19641	29684	1365	31049	59885	51.85%	16.77%	43	49
14	基隆市安樂區	2018-11-25T06:24:02+08:00	12394	22700	35094	1570	36664	70396	52.08%	17.61%	49	49
14	基隆市安樂區	2018-11-24T23:51:37+08:00	10043	19641	29684	1365	31049	59885	51.85%	16.77%	43	49
14	基隆市安樂區	2018-11-24T22:23:15+08:00	4573	8586	13159	676	13835	26395	52.42%	17.33%	22	49
14	基隆市安樂區	2018-11-24T22:40:29+08:00	4844	9055	13899	700	14599	27794	52.53%	17.43%	23	49
14	基隆市安樂區	2018-11-25T06:18:59+08:00	12394	22700	35094	1570	36664	70396	52.08%	17.61%	49	49
14	基隆市安樂區	2018-11-24T23:23:40+08:00	7943	15106	23049	1050	24099	46237	52.12%	17.18%	35	49
14	基隆市安樂區	2018-11-24T22:54:27+08:00	5833	11057	16890	831	17721	33386	53.08%	17.47%	27	49
14	基隆市安樂區	2018-11-25T00:14:11+08:00	10637	20723	31360	1425	32785	63094	51.96%	16.86%	45	49
14	基隆市安樂區	2018-11-24T22:16:12+08:00	4573	8586	13159	676	13835	26395	52.42%	17.33%	22	49
14	基隆市安樂區	2018-11-24T22:41:37+08:00	4844	9055	13899	700	14599	27794	52.53%	17.43%	23	49
14	基隆市安樂區	2018-11-25T00:05:07+08:00	10043	19641	29684	1365	31049	59885	51.85%	16.77%	43	49
14	基隆市安樂區	2018-11-24T23:05:06+08:00	6547	12441	18988	921	19909	37780	52.7%	17.33%	30	49
14	基隆市安樂區	2018-11-24T22:45:10+08:00	5033	9495	14528	711	15239	28934	52.67%	17.39%	24	49
14	基隆市安樂區	2018-11-25T03:56:14+08:00	12394	22700	35094	1570	36664	70396	52.08%	17.61%	49	49
14	基隆市安樂區	2018-11-24T22:37:02+08:00	4844	9055	13899	700	14599	27794	52.53%	17.43%	23	49
14	基隆市安樂區	2018-11-25T00:18:32+08:00	10984	21349	32333	1467	33800	64996	52%	16.9%	46	49
14	基隆市安樂區	2018-11-24T23:16:04+08:00	7651	14519	22170	1012	23182	44336	52.29%	17.26%	34	49
14	基隆市安樂區	2018-11-25T00:23:05+08:00	11497	21911	33408	1480	34888	67036	52.04%	17.15%	47	49
14	基隆市安樂區	2018-11-25T01:25:54+08:00	12394	22700	35094	1570	36664	70396	52.08%	17.61%	49	49
14	基隆市安樂區	2018-11-24T22:30:11+08:00	4844	9055	13899	700	14599	27794	52.53%	17.43%	23	49
14	基隆市安樂區	2018-11-25T03:38:56+08:00	12394	22700	35094	1570	36664	70396	52.08%	17.61%	49	49
14	基隆市安樂區	2018-11-25T01:02:33+08:00	12156	22247	34403	1536	35939	68996	52.09%	17.62%	48	49
14	基隆市安樂區	2018-11-24T22:19:38+08:00	4573	8586	13159	676	13835	26395	52.42%	17.33%	22	49
14	基隆市安樂區	2018-11-24T23:19:53+08:00	7651	14519	22170	1012	23182	44336	52.29%	17.26%	34	49
14	基隆市安樂區	2018-11-25T01:17:54+08:00	12394	22700	35094	1570	36664	70396	52.08%	17.61%	49	49
14	基隆市安樂區	2018-11-25T00:00:12+08:00	10043	19641	29684	1365	31049	59885	51.85%	16.77%	43	49
14	基隆市安樂區	2018-11-24T22:57:55+08:00	6104	11590	17694	846	18540	35059	52.88%	17.41%	28	49
14	基隆市安樂區	2018-11-24T23:27:20+08:00	7943	15106	23049	1050	24099	46237	52.12%	17.18%	35	49
14	基隆市安樂區	2018-11-25T00:57:38+08:00	12156	22247	34403	1536	35939	68996	52.09%	17.62%	48	49
14	基隆市安樂區	2018-11-24T23:35:12+08:00	8604	16636	25240	1127	26367	50712	51.99%	16.97%	37	49
14	基隆市安樂區	2018-11-24T23:47:30+08:00	9624	18791	28415	1257	29672	57496	51.61%	16.74%	41	49
14	基隆市安樂區	2018-11-25T00:09:36+08:00	10637	20723	31360	1425	32785	63094	51.96%	16.86%	45	49
14	基隆市安樂區	2018-11-24T23:01:33+08:00	6104	11590	17694	846	18540	35059	52.88%	17.41%	28	49
14	基隆市安樂區	2018-11-24T23:31:13+08:00	8303	16002	24305	1084	25389	48750	52.08%	17.03%	36	49
14	基隆市安樂區	2018-11-25T04:02:54+08:00	12394	22700	35094	1570	36664	70396	52.08%	17.61%	49	49
14	基隆市安樂區	2018-11-25T01:12:45+08:00	12156	22247	34403	1536	35939	68996	52.09%	17.62%	48	49
14	基隆市安樂區	2018-11-24T22:26:38+08:00	4573	8586	13159	676	13835	26395	52.42%	17.33%	22	49
14	基隆市安樂區	2018-11-24T23:12:17+08:00	6773	12867	19640	944	20584	39337	52.33%	17.22%	31	49
14	基隆市安樂區	2018-11-24T23:39:18+08:00	8765	17039	25804	1153	26957	51925	51.92%	16.88%	38	49
14	基隆市安樂區	2018-11-25T06:08:55+08:00	12394	22700	35094	1570	36664	70396	52.08%	17.61%	49	49
14	高雄市前鎮區	2018-11-25T06:29:10+08:00	29186	60498	89684	5513	95197	161797	58.84%	18.04%	119	119
14	高雄市前鎮區	2018-11-24T23:35:04+08:00	22144	45666	67810	4242	72052	122421	58.86%	18.09%	92	119
14	高雄市前鎮區	2018-11-25T00:14:03+08:00	27181	56417	83598	5137	88735	150498	58.96%	18.06%	111	119
14	高雄市前鎮區	2018-11-24T23:12:09+08:00	18580	38318	56898	3582	60480	102121	59.22%	18.19%	79	119
14	高雄市前鎮區	2018-11-25T06:08:45+08:00	29186	60498	89684	5513	95197	161797	58.84%	18.04%	119	119
14	高雄市前鎮區	2018-11-24T23:43:11+08:00	24258	50626	74884	4585	79469	134173	59.23%	18.08%	101	119
14	高雄市前鎮區	2018-11-24T23:39:08+08:00	23134	47924	71058	4389	75447	128086	58.9%	18.06%	96	119
14	高雄市前鎮區	2018-11-25T00:09:27+08:00	26799	55707	82506	5067	87573	148628	58.92%	18.03%	110	119
14	高雄市前鎮區	2018-11-24T22:33:31+08:00	13189	26847	40036	2549	42585	71901	59.23%	18.34%	58	119
14	高雄市前鎮區	2018-11-25T01:12:36+08:00	28629	59352	87981	5416	93397	158629	58.88%	18.05%	116	119
14	高雄市前鎮區	2018-11-25T04:02:42+08:00	29186	60498	89684	5513	95197	161797	58.84%	18.04%	119	119
14	高雄市前鎮區	2018-11-25T01:07:20+08:00	28629	59352	87981	5416	93397	158629	58.88%	18.05%	116	119
14	高雄市前鎮區	2018-11-24T23:31:03+08:00	21682	44727	66409	4139	70548	119877	58.85%	18.09%	90	119
14	高雄市前鎮區	2018-11-24T23:01:24+08:00	16201	33557	49758	3195	52953	89500	59.17%	18.1%	70	119
14	高雄市前鎮區	2018-11-25T03:44:15+08:00	29186	60498	89684	5513	95197	161797	58.84%	18.04%	119	119
14	高雄市前鎮區	2018-11-24T22:13:20+08:00	10106	20830	30936	2003	32939	55499	59.35%	18.21%	47	119
14	高雄市前鎮區	2018-11-24T23:55:41+08:00	25644	53537	79181	4842	84023	142519	58.96%	17.99%	106	119
14	高雄市前鎮區	2018-11-24T22:23:06+08:00	11430	23539	34969	2306	37275	62643	59.5%	18.25%	52	119
14	高雄市前鎮區	2018-11-24T23:19:43+08:00	19781	41162	60943	3812	64755	109355	59.22%	18.09%	84	119
14	高雄市前鎮區	2018-11-25T01:17:44+08:00	28629	59352	87981	5416	93397	158629	58.88%	18.05%	116	119
14	高雄市前鎮區	2018-11-24T23:04:58+08:00	17143	35274	52417	3279	55696	93896	59.32%	18.26%	73	119
14	高雄市前鎮區	2018-11-25T00:00:02+08:00	25893	54004	79897	4883	84780	143903	58.91%	17.99%	107	119
14	高雄市前鎮區	2018-11-25T00:04:59+08:00	25893	54004	79897	4883	84780	143903	58.91%	17.99%	107	119
14	高雄市前鎮區	2018-11-25T06:18:51+08:00	29186	60498	89684	5513	95197	161797	58.84%	18.04%	119	119
14	高雄市前鎮區	2018-11-25T01:02:24+08:00	28629	59352	87981	5416	93397	158629	58.88%	18.05%	116	119
14	高雄市前鎮區	2018-11-24T23:27:13+08:00	21035	43436	64471	4019	68490	116217	58.93%	18.1%	88	119
14	高雄市前鎮區	2018-11-25T03:38:49+08:00	29186	60498	89684	5513	95197	161797	58.84%	18.04%	119	119
14	高雄市前鎮區	2018-11-24T22:54:20+08:00	15520	31984	47504	3028	50532	85285	59.25%	18.2%	67	119
14	高雄市前鎮區	2018-11-25T03:56:05+08:00	29186	60498	89684	5513	95197	161797	58.84%	18.04%	119	119
14	高雄市前鎮區	2018-11-25T00:18:23+08:00	27181	56417	83598	5137	88735	150498	58.96%	18.06%	111	119
14	高雄市前鎮區	2018-11-25T06:13:46+08:00	29186	60498	89684	5513	95197	161797	58.84%	18.04%	119	119
14	高雄市前鎮區	2018-11-25T00:22:57+08:00	27470	57071	84541	5197	89738	152333	58.91%	18.03%	112	119
14	高雄市前鎮區	2018-11-24T23:47:22+08:00	24754	51835	76589	4671	81260	137010	59.31%	18.07%	103	119
14	高雄市前鎮區	2018-11-24T22:41:29+08:00	13736	28056	41792	2674	44466	75055	59.24%	18.3%	60	119
14	高雄市前鎮區	2018-11-24T22:16:03+08:00	10958	22502	33460	2163	35623	59883	59.49%	18.3%	50	119
14	高雄市前鎮區	2018-11-24T22:29:59+08:00	12045	24612	36657	2358	39015	65545	59.52%	18.38%	54	119
14	高雄市前鎮區	2018-11-24T23:23:32+08:00	20357	42167	62524	3892	66416	112841	58.86%	18.04%	86	119
14	高雄市前鎮區	2018-11-24T23:51:28+08:00	25644	53537	79181	4842	84023	142519	58.96%	17.99%	106	119
14	高雄市前鎮區	2018-11-24T22:57:47+08:00	15773	32577	48350	3088	51438	86888	59.2%	18.15%	68	119
14	高雄市前鎮區	2018-11-25T01:25:46+08:00	28812	59729	88541	5438	93979	159711	58.84%	18.04%	117	119
14	高雄市前鎮區	2018-11-24T22:19:31+08:00	10958	22502	33460	2163	35623	59883	59.49%	18.3%	50	119
14	高雄市前鎮區	2018-11-25T00:57:30+08:00	28629	59352	87981	5416	93397	158629	58.88%	18.05%	116	119
14	高雄市前鎮區	2018-11-24T22:40:22+08:00	13736	28056	41792	2674	44466	75055	59.24%	18.3%	60	119
14	高雄市前鎮區	2018-11-24T22:36:55+08:00	13736	28056	41792	2674	44466	75055	59.24%	18.3%	60	119
14	高雄市前鎮區	2018-11-24T23:08:29+08:00	17824	36755	54579	3436	58015	97752	59.35%	18.23%	76	119
14	高雄市前鎮區	2018-11-24T23:15:57+08:00	19480	40520	60000	3775	63775	107842	59.14%	18.06%	83	119
14	高雄市前鎮區	2018-11-25T03:32:28+08:00	29186	60498	89684	5513	95197	161797	58.84%	18.04%	119	119
14	高雄市前鎮區	2018-11-25T03:49:45+08:00	29186	60498	89684	5513	95197	161797	58.84%	18.04%	119	119
14	高雄市前鎮區	2018-11-25T06:23:54+08:00	29186	60498	89684	5513	95197	161797	58.84%	18.04%	119	119
14	高雄市前鎮區	2018-11-24T22:26:31+08:00	11802	24106	35908	2341	38249	64238	59.54%	18.37%	53	119
14	高雄市前鎮區	2018-11-24T22:50:41+08:00	15024	30987	46011	2899	48910	82521	59.27%	18.21%	65	119
14	高雄市前鎮區	2018-11-24T22:45:03+08:00	13736	28056	41792	2674	44466	75055	59.24%	18.3%	60	119
14	高雄市岡山區	2018-11-25T04:02:43+08:00	14572	32998	47570	2532	50102	81244	61.67%	17.94%	72	72
14	高雄市岡山區	2018-11-25T06:29:10+08:00	14572	32998	47570	2532	50102	81244	61.67%	17.94%	72	72
14	高雄市岡山區	2018-11-25T00:14:03+08:00	13468	30150	43618	2381	45999	74724	61.56%	18.02%	67	72
14	高雄市岡山區	2018-11-24T23:01:25+08:00	10195	22265	32460	1783	34243	55473	61.73%	18.38%	52	72
14	高雄市岡山區	2018-11-24T23:12:09+08:00	10403	22809	33212	1824	35036	56710	61.78%	18.34%	53	72
14	高雄市岡山區	2018-11-24T23:43:11+08:00	12376	27418	39794	2152	41946	68267	61.44%	18.13%	62	72
14	高雄市岡山區	2018-11-24T23:39:08+08:00	12376	27418	39794	2152	41946	68267	61.44%	18.13%	62	72
14	高雄市岡山區	2018-11-25T00:09:27+08:00	13468	30150	43618	2381	45999	74724	61.56%	18.02%	67	72
14	高雄市岡山區	2018-11-25T01:12:36+08:00	14572	32998	47570	2532	50102	81244	61.67%	17.94%	72	72
14	高雄市岡山區	2018-11-24T23:35:05+08:00	12126	26907	39033	2126	41159	66854	61.57%	18.14%	61	72
14	高雄市岡山區	2018-11-25T01:07:20+08:00	14572	32998	47570	2532	50102	81244	61.67%	17.94%	72	72
14	高雄市岡山區	2018-11-24T23:31:04+08:00	12126	26907	39033	2126	41159	66854	61.57%	18.14%	61	72
14	高雄市岡山區	2018-11-25T01:17:45+08:00	14572	32998	47570	2532	50102	81244	61.67%	17.94%	72	72
14	高雄市岡山區	2018-11-24T22:13:20+08:00	6517	14682	21199	1246	22445	36297	61.84%	17.95%	37	72
14	高雄市岡山區	2018-11-24T23:55:41+08:00	13195	29522	42717	2323	45040	73131	61.59%	18.04%	66	72
14	高雄市岡山區	2018-11-24T22:23:06+08:00	7594	16022	23616	1359	24975	40365	61.87%	18.81%	40	72
14	高雄市岡山區	2018-11-24T23:19:43+08:00	11319	24719	36038	1979	38017	61583	61.73%	18.38%	57	72
14	高雄市岡山區	2018-11-24T23:04:58+08:00	10195	22265	32460	1783	34243	55473	61.73%	18.38%	52	72
14	高雄市岡山區	2018-11-25T00:00:02+08:00	13195	29522	42717	2323	45040	73131	61.59%	18.04%	66	72
14	高雄市岡山區	2018-11-25T00:04:59+08:00	13468	30150	43618	2381	45999	74724	61.56%	18.02%	67	72
14	高雄市岡山區	2018-11-25T01:02:24+08:00	14572	32998	47570	2532	50102	81244	61.67%	17.94%	72	72
14	高雄市岡山區	2018-11-24T23:27:13+08:00	11767	25919	37686	2027	39713	64580	61.49%	18.22%	59	72
14	高雄市岡山區	2018-11-25T03:38:49+08:00	14572	32998	47570	2532	50102	81244	61.67%	17.94%	72	72
14	高雄市岡山區	2018-11-24T22:30:00+08:00	7806	16542	24348	1399	25747	41524	62.01%	18.8%	41	72
14	高雄市岡山區	2018-11-25T06:13:47+08:00	14572	32998	47570	2532	50102	81244	61.67%	17.94%	72	72
14	高雄市岡山區	2018-11-24T22:54:20+08:00	9702	21182	30884	1701	32585	52634	61.91%	18.43%	50	72
14	高雄市岡山區	2018-11-25T00:22:58+08:00	13711	30716	44427	2419	46846	76149	61.52%	18.01%	68	72
14	高雄市岡山區	2018-11-25T03:56:05+08:00	14572	32998	47570	2532	50102	81244	61.67%	17.94%	72	72
14	高雄市岡山區	2018-11-25T00:18:24+08:00	13468	30150	43618	2381	45999	74724	61.56%	18.02%	67	72
14	高雄市岡山區	2018-11-25T03:49:46+08:00	14572	32998	47570	2532	50102	81244	61.67%	17.94%	72	72
14	高雄市岡山區	2018-11-25T06:08:46+08:00	14572	32998	47570	2532	50102	81244	61.67%	17.94%	72	72
14	高雄市岡山區	2018-11-24T23:47:22+08:00	12791	28472	41263	2255	43518	70670	61.58%	18.1%	64	72
14	高雄市岡山區	2018-11-24T22:41:29+08:00	8492	18059	26551	1500	28051	45293	61.93%	18.75%	44	72
14	高雄市岡山區	2018-11-24T22:16:04+08:00	7357	15494	22851	1317	24168	39070	61.86%	18.83%	39	72
14	高雄市岡山區	2018-11-24T22:33:32+08:00	8009	16956	24965	1456	26421	42562	62.08%	18.82%	42	72
14	高雄市岡山區	2018-11-25T03:44:16+08:00	14572	32998	47570	2532	50102	81244	61.67%	17.94%	72	72
14	高雄市岡山區	2018-11-24T23:23:33+08:00	11767	25919	37686	2027	39713	64580	61.49%	18.22%	59	72
14	高雄市岡山區	2018-11-24T23:51:29+08:00	13195	29522	42717	2323	45040	73131	61.59%	18.04%	66	72
14	高雄市岡山區	2018-11-24T22:57:47+08:00	9958	21750	31708	1734	33442	54146	61.76%	18.39%	51	72
14	高雄市岡山區	2018-11-24T22:19:31+08:00	7357	15494	22851	1317	24168	39070	61.86%	18.83%	39	72
14	高雄市岡山區	2018-11-25T00:57:30+08:00	14572	32998	47570	2532	50102	81244	61.67%	17.94%	72	72
14	高雄市岡山區	2018-11-25T03:32:29+08:00	14572	32998	47570	2532	50102	81244	61.67%	17.94%	72	72
14	高雄市岡山區	2018-11-25T06:18:52+08:00	14572	32998	47570	2532	50102	81244	61.67%	17.94%	72	72
14	高雄市岡山區	2018-11-24T22:40:22+08:00	8492	18059	26551	1500	28051	45293	61.93%	18.75%	44	72
14	高雄市岡山區	2018-11-25T01:25:47+08:00	14572	32998	47570	2532	50102	81244	61.67%	17.94%	72	72
14	高雄市岡山區	2018-11-24T22:36:55+08:00	8492	18059	26551	1500	28051	45293	61.93%	18.75%	44	72
14	高雄市岡山區	2018-11-24T23:08:29+08:00	10195	22265	32460	1783	34243	55473	61.73%	18.38%	52	72
14	高雄市岡山區	2018-11-24T23:15:57+08:00	11083	24244	35327	1915	37242	60301	61.76%	18.38%	56	72
14	高雄市岡山區	2018-11-25T06:23:54+08:00	14572	32998	47570	2532	50102	81244	61.67%	17.94%	72	72
14	高雄市岡山區	2018-11-24T22:26:31+08:00	7594	16022	23616	1359	24975	40365	61.87%	18.81%	40	72
14	高雄市岡山區	2018-11-24T22:50:41+08:00	9209	20161	29370	1620	30990	49858	62.16%	18.47%	48	72
14	高雄市岡山區	2018-11-24T22:45:03+08:00	8849	19092	27941	1542	29483	47488	62.09%	18.63%	46	72
14	新竹縣湖口鄉	2018-11-25T04:02:43+08:00	9767	24243	34010	1712	35722	63511	56.25%	15.38%	47	47
14	新竹縣湖口鄉	2018-11-25T01:12:37+08:00	9767	24243	34010	1712	35722	63511	56.25%	15.38%	47	47
14	新竹縣湖口鄉	2018-11-25T00:14:04+08:00	8292	20286	28578	1452	30030	53446	56.19%	15.51%	40	47
14	新竹縣湖口鄉	2018-11-24T23:31:05+08:00	7014	16668	23682	1230	24912	44282	56.26%	15.84%	34	47
14	新竹縣湖口鄉	2018-11-25T01:07:21+08:00	9767	24243	34010	1712	35722	63511	56.25%	15.38%	47	47
14	新竹縣湖口鄉	2018-11-24T23:35:05+08:00	7014	16668	23682	1230	24912	44282	56.26%	15.84%	34	47
14	新竹縣湖口鄉	2018-11-25T06:29:11+08:00	9767	24243	34010	1712	35722	63511	56.25%	15.38%	47	47
14	新竹縣湖口鄉	2018-11-24T23:39:09+08:00	7486	18105	25591	1310	26901	48062	55.97%	15.58%	36	47
14	新竹縣湖口鄉	2018-11-25T00:09:28+08:00	8292	20286	28578	1452	30030	53446	56.19%	15.51%	40	47
14	新竹縣湖口鄉	2018-11-24T22:23:07+08:00	3492	7800	11292	638	11930	21251	56.14%	16.43%	17	47
14	新竹縣湖口鄉	2018-11-25T00:00:03+08:00	8076	19708	27784	1411	29195	52099	56.04%	15.5%	39	47
14	新竹縣湖口鄉	2018-11-24T23:08:30+08:00	6080	14406	20486	1111	21597	38123	56.65%	15.95%	30	47
14	新竹縣湖口鄉	2018-11-24T23:19:44+08:00	6312	14895	21207	1141	22348	39456	56.64%	16%	31	47
14	新竹縣湖口鄉	2018-11-24T22:13:21+08:00	2862	6359	9221	504	9725	17196	56.55%	16.64%	14	47
14	新竹縣湖口鄉	2018-11-24T23:51:30+08:00	7874	19192	27066	1378	28444	50605	56.21%	15.56%	38	47
14	新竹縣湖口鄉	2018-11-24T22:30:01+08:00	3652	8269	11921	681	12602	22333	56.43%	16.35%	18	47
14	新竹縣湖口鄉	2018-11-24T23:27:14+08:00	6552	15486	22038	1181	23219	40961	56.69%	16%	32	47
14	新竹縣湖口鄉	2018-11-24T22:19:32+08:00	3293	7311	10604	611	11215	19745	56.8%	16.68%	16	47
14	新竹縣湖口鄉	2018-11-24T22:36:56+08:00	4460	10392	14852	849	15701	27506	57.08%	16.21%	22	47
14	新竹縣湖口鄉	2018-11-25T01:02:25+08:00	9767	24243	34010	1712	35722	63511	56.25%	15.38%	47	47
14	新竹縣湖口鄉	2018-11-25T06:13:47+08:00	9767	24243	34010	1712	35722	63511	56.25%	15.38%	47	47
14	新竹縣湖口鄉	2018-11-25T00:18:25+08:00	8532	20989	29521	1489	31010	55175	56.2%	15.46%	41	47
14	新竹縣湖口鄉	2018-11-24T23:05:00+08:00	5893	13891	19784	1074	20858	36848	56.61%	15.99%	29	47
14	新竹縣湖口鄉	2018-11-24T22:26:32+08:00	3492	7800	11292	638	11930	21251	56.14%	16.43%	17	47
14	新竹縣湖口鄉	2018-11-24T22:50:42+08:00	5273	12285	17558	972	18530	32686	56.69%	16.13%	26	47
14	新竹縣湖口鄉	2018-11-24T22:54:21+08:00	5273	12285	17558	972	18530	32686	56.69%	16.13%	26	47
14	新竹縣湖口鄉	2018-11-25T00:05:00+08:00	8076	19708	27784	1411	29195	52099	56.04%	15.5%	39	47
14	新竹縣湖口鄉	2018-11-24T22:41:30+08:00	4652	10911	15563	870	16433	28708	57.24%	16.2%	23	47
14	新竹縣湖口鄉	2018-11-25T00:22:59+08:00	8694	21402	30096	1515	31611	56233	56.21%	15.46%	42	47
14	新竹縣湖口鄉	2018-11-25T03:49:46+08:00	9767	24243	34010	1712	35722	63511	56.25%	15.38%	47	47
14	新竹縣湖口鄉	2018-11-24T22:16:05+08:00	3101	6832	9933	547	10480	18598	56.35%	16.67%	15	47
14	新竹縣湖口鄉	2018-11-24T23:01:26+08:00	5684	13334	19018	1052	20070	35419	56.66%	16.05%	28	47
14	新竹縣湖口鄉	2018-11-24T23:43:12+08:00	7626	18543	26169	1344	27513	49112	56.02%	15.53%	37	47
14	新竹縣湖口鄉	2018-11-24T22:33:33+08:00	4292	9925	14217	804	15021	26403	56.89%	16.26%	21	47
14	新竹縣湖口鄉	2018-11-25T06:08:47+08:00	9767	24243	34010	1712	35722	63511	56.25%	15.38%	47	47
14	新竹縣湖口鄉	2018-11-24T23:47:23+08:00	7626	18543	26169	1344	27513	49112	56.02%	15.53%	37	47
14	新竹縣湖口鄉	2018-11-24T23:55:42+08:00	8076	19708	27784	1411	29195	52099	56.04%	15.5%	39	47
14	新竹縣湖口鄉	2018-11-25T01:17:46+08:00	9767	24243	34010	1712	35722	63511	56.25%	15.38%	47	47
14	新竹縣湖口鄉	2018-11-24T22:57:48+08:00	5684	13334	19018	1052	20070	35419	56.66%	16.05%	28	47
14	新竹縣湖口鄉	2018-11-25T03:38:50+08:00	9767	24243	34010	1712	35722	63511	56.25%	15.38%	47	47
14	新竹縣湖口鄉	2018-11-24T23:23:33+08:00	6552	15486	22038	1181	23219	40961	56.69%	16%	32	47
14	新竹縣湖口鄉	2018-11-25T03:44:17+08:00	9767	24243	34010	1712	35722	63511	56.25%	15.38%	47	47
14	新竹縣湖口鄉	2018-11-24T22:40:23+08:00	4652	10911	15563	870	16433	28708	57.24%	16.2%	23	47
14	新竹縣湖口鄉	2018-11-25T03:32:29+08:00	9767	24243	34010	1712	35722	63511	56.25%	15.38%	47	47
14	新竹縣湖口鄉	2018-11-25T06:18:52+08:00	9767	24243	34010	1712	35722	63511	56.25%	15.38%	47	47
14	新竹縣湖口鄉	2018-11-24T23:15:58+08:00	6312	14895	21207	1141	22348	39456	56.64%	16%	31	47
14	新竹縣湖口鄉	2018-11-25T00:57:31+08:00	9767	24243	34010	1712	35722	63511	56.25%	15.38%	47	47
14	新竹縣湖口鄉	2018-11-25T01:25:47+08:00	9767	24243	34010	1712	35722	63511	56.25%	15.38%	47	47
14	新竹縣湖口鄉	2018-11-25T03:56:06+08:00	9767	24243	34010	1712	35722	63511	56.25%	15.38%	47	47
14	新竹縣湖口鄉	2018-11-25T06:23:55+08:00	9767	24243	34010	1712	35722	63511	56.25%	15.38%	47	47
14	新竹縣湖口鄉	2018-11-24T22:45:04+08:00	4867	11446	16313	906	17219	30342	56.75%	16.04%	24	47
14	新竹縣湖口鄉	2018-11-24T23:12:10+08:00	6080	14406	20486	1111	21597	38123	56.65%	15.95%	30	47
14	雲林縣斗南鎮	2018-11-24T23:16:00+08:00	5472	12345	17817	1228	19045	33644	56.61%	16.26%	30	33
14	雲林縣斗南鎮	2018-11-24T22:16:07+08:00	4205	9219	13424	918	14342	25737	55.73%	16.34%	25	33
14	雲林縣斗南鎮	2018-11-24T22:23:09+08:00	4205	9219	13424	918	14342	25737	55.73%	16.34%	25	33
14	雲林縣斗南鎮	2018-11-25T03:32:31+08:00	6245	14041	20286	1395	21681	38138	56.85%	16.37%	33	33
14	雲林縣斗南鎮	2018-11-25T00:23:01+08:00	6245	14041	20286	1395	21681	38138	56.85%	16.37%	33	33
14	雲林縣斗南鎮	2018-11-25T03:38:52+08:00	6245	14041	20286	1395	21681	38138	56.85%	16.37%	33	33
14	雲林縣斗南鎮	2018-11-24T22:36:57+08:00	4459	9847	14306	992	15298	27446	55.74%	16.25%	26	33
14	雲林縣斗南鎮	2018-11-24T22:57:50+08:00	4979	11146	16125	1126	17251	30712	56.17%	16.21%	28	33
14	雲林縣斗南鎮	2018-11-25T00:57:33+08:00	6245	14041	20286	1395	21681	38138	56.85%	16.37%	33	33
14	雲林縣斗南鎮	2018-11-24T23:27:15+08:00	5754	12912	18666	1271	19937	35275	56.52%	16.31%	31	33
14	雲林縣斗南鎮	2018-11-24T22:19:34+08:00	4205	9219	13424	918	14342	25737	55.73%	16.34%	25	33
14	雲林縣斗南鎮	2018-11-24T22:50:44+08:00	4459	9847	14306	992	15298	27446	55.74%	16.25%	26	33
14	雲林縣斗南鎮	2018-11-24T23:12:12+08:00	4979	11146	16125	1126	17251	30712	56.17%	16.21%	28	33
14	雲林縣斗南鎮	2018-11-24T22:45:06+08:00	4459	9847	14306	992	15298	27446	55.74%	16.25%	26	33
14	雲林縣斗南鎮	2018-11-25T06:13:49+08:00	6245	14041	20286	1395	21681	38138	56.85%	16.37%	33	33
14	雲林縣斗南鎮	2018-11-25T01:12:40+08:00	6245	14041	20286	1395	21681	38138	56.85%	16.37%	33	33
14	雲林縣斗南鎮	2018-11-24T22:26:34+08:00	4205	9219	13424	918	14342	25737	55.73%	16.34%	25	33
14	雲林縣斗南鎮	2018-11-25T06:23:57+08:00	6245	14041	20286	1395	21681	38138	56.85%	16.37%	33	33
14	雲林縣斗南鎮	2018-11-24T23:39:12+08:00	5979	13437	19416	1324	20740	36552	56.74%	16.36%	32	33
14	雲林縣斗南鎮	2018-11-25T03:49:48+08:00	6245	14041	20286	1395	21681	38138	56.85%	16.37%	33	33
14	雲林縣斗南鎮	2018-11-24T23:01:28+08:00	4979	11146	16125	1126	17251	30712	56.17%	16.21%	28	33
14	雲林縣斗南鎮	2018-11-25T04:02:47+08:00	6245	14041	20286	1395	21681	38138	56.85%	16.37%	33	33
14	雲林縣斗南鎮	2018-11-24T23:47:25+08:00	6245	14041	20286	1395	21681	38138	56.85%	16.37%	33	33
14	雲林縣斗南鎮	2018-11-25T06:29:14+08:00	6245	14041	20286	1395	21681	38138	56.85%	16.37%	33	33
14	雲林縣斗南鎮	2018-11-24T23:35:07+08:00	5979	13437	19416	1324	20740	36552	56.74%	16.36%	32	33
14	雲林縣斗南鎮	2018-11-25T01:07:23+08:00	6245	14041	20286	1395	21681	38138	56.85%	16.37%	33	33
14	雲林縣斗南鎮	2018-11-24T23:43:14+08:00	6245	14041	20286	1395	21681	38138	56.85%	16.37%	33	33
14	雲林縣斗南鎮	2018-11-24T23:31:07+08:00	5754	12912	18666	1271	19937	35275	56.52%	16.31%	31	33
14	雲林縣斗南鎮	2018-11-25T06:08:49+08:00	6245	14041	20286	1395	21681	38138	56.85%	16.37%	33	33
14	雲林縣斗南鎮	2018-11-24T22:33:35+08:00	4459	9847	14306	992	15298	27446	55.74%	16.25%	26	33
14	雲林縣斗南鎮	2018-11-25T00:14:06+08:00	6245	14041	20286	1395	21681	38138	56.85%	16.37%	33	33
14	雲林縣斗南鎮	2018-11-24T23:23:35+08:00	5754	12912	18666	1271	19937	35275	56.52%	16.31%	31	33
14	雲林縣斗南鎮	2018-11-24T22:13:23+08:00	4205	9219	13424	918	14342	25737	55.73%	16.34%	25	33
14	雲林縣斗南鎮	2018-11-25T01:17:48+08:00	6245	14041	20286	1395	21681	38138	56.85%	16.37%	33	33
14	雲林縣斗南鎮	2018-11-24T23:55:44+08:00	6245	14041	20286	1395	21681	38138	56.85%	16.37%	33	33
14	雲林縣斗南鎮	2018-11-25T00:00:06+08:00	6245	14041	20286	1395	21681	38138	56.85%	16.37%	33	33
14	雲林縣斗南鎮	2018-11-24T23:08:32+08:00	4979	11146	16125	1126	17251	30712	56.17%	16.21%	28	33
14	雲林縣斗南鎮	2018-11-24T23:19:47+08:00	5754	12912	18666	1271	19937	35275	56.52%	16.31%	31	33
14	雲林縣斗南鎮	2018-11-25T03:44:19+08:00	6245	14041	20286	1395	21681	38138	56.85%	16.37%	33	33
14	雲林縣斗南鎮	2018-11-25T01:02:27+08:00	6245	14041	20286	1395	21681	38138	56.85%	16.37%	33	33
14	雲林縣斗南鎮	2018-11-24T22:40:25+08:00	4459	9847	14306	992	15298	27446	55.74%	16.25%	26	33
14	雲林縣斗南鎮	2018-11-24T22:30:03+08:00	4205	9219	13424	918	14342	25737	55.73%	16.34%	25	33
14	雲林縣斗南鎮	2018-11-25T01:25:49+08:00	6245	14041	20286	1395	21681	38138	56.85%	16.37%	33	33
14	雲林縣斗南鎮	2018-11-25T06:18:54+08:00	6245	14041	20286	1395	21681	38138	56.85%	16.37%	33	33
14	雲林縣斗南鎮	2018-11-24T23:51:32+08:00	6245	14041	20286	1395	21681	38138	56.85%	16.37%	33	33
14	雲林縣斗南鎮	2018-11-25T00:05:02+08:00	6245	14041	20286	1395	21681	38138	56.85%	16.37%	33	33
14	雲林縣斗南鎮	2018-11-24T22:41:32+08:00	4459	9847	14306	992	15298	27446	55.74%	16.25%	26	33
14	雲林縣斗南鎮	2018-11-25T00:09:31+08:00	6245	14041	20286	1395	21681	38138	56.85%	16.37%	33	33
14	雲林縣斗南鎮	2018-11-24T22:54:23+08:00	4459	9847	14306	992	15298	27446	55.74%	16.25%	26	33
14	雲林縣斗南鎮	2018-11-24T23:05:02+08:00	4979	11146	16125	1126	17251	30712	56.17%	16.21%	28	33
14	雲林縣斗南鎮	2018-11-25T03:56:09+08:00	6245	14041	20286	1395	21681	38138	56.85%	16.37%	33	33
14	雲林縣斗南鎮	2018-11-25T00:18:27+08:00	6245	14041	20286	1395	21681	38138	56.85%	16.37%	33	33
14	雲林縣崙背鄉	2018-11-24T23:16:00+08:00	2900	6510	9410	829	10239	21050	48.64%	13.78%	20	20
14	雲林縣崙背鄉	2018-11-24T22:16:07+08:00	2486	5417	7903	657	8560	17468	49%	14.23%	17	20
14	雲林縣崙背鄉	2018-11-25T01:25:50+08:00	2900	6510	9410	829	10239	21050	48.64%	13.78%	20	20
14	雲林縣崙背鄉	2018-11-25T00:23:01+08:00	2900	6510	9410	829	10239	21050	48.64%	13.78%	20	20
14	雲林縣崙背鄉	2018-11-24T23:23:36+08:00	2900	6510	9410	829	10239	21050	48.64%	13.78%	20	20
14	雲林縣崙背鄉	2018-11-25T03:38:52+08:00	2900	6510	9410	829	10239	21050	48.64%	13.78%	20	20
14	雲林縣崙背鄉	2018-11-24T22:57:50+08:00	2900	6510	9410	829	10239	21050	48.64%	13.78%	20	20
14	雲林縣崙背鄉	2018-11-25T00:57:34+08:00	2900	6510	9410	829	10239	21050	48.64%	13.78%	20	20
14	雲林縣崙背鄉	2018-11-24T22:36:58+08:00	2722	6061	8783	763	9546	19830	48.14%	13.73%	19	20
14	雲林縣崙背鄉	2018-11-24T22:19:34+08:00	2486	5417	7903	657	8560	17468	49%	14.23%	17	20
14	雲林縣崙背鄉	2018-11-24T22:45:06+08:00	2722	6061	8783	763	9546	19830	48.14%	13.73%	19	20
14	雲林縣崙背鄉	2018-11-25T06:08:50+08:00	2900	6510	9410	829	10239	21050	48.64%	13.78%	20	20
14	雲林縣崙背鄉	2018-11-25T01:12:40+08:00	2900	6510	9410	829	10239	21050	48.64%	13.78%	20	20
14	雲林縣崙背鄉	2018-11-24T22:26:34+08:00	2584	5660	8244	686	8930	18354	48.65%	14.08%	18	20
14	雲林縣崙背鄉	2018-11-25T06:23:57+08:00	2900	6510	9410	829	10239	21050	48.64%	13.78%	20	20
14	雲林縣崙背鄉	2018-11-24T23:39:12+08:00	2900	6510	9410	829	10239	21050	48.64%	13.78%	20	20
14	雲林縣崙背鄉	2018-11-24T22:50:45+08:00	2900	6510	9410	829	10239	21050	48.64%	13.78%	20	20
14	雲林縣崙背鄉	2018-11-24T23:12:13+08:00	2900	6510	9410	829	10239	21050	48.64%	13.78%	20	20
14	雲林縣崙背鄉	2018-11-25T03:49:48+08:00	2900	6510	9410	829	10239	21050	48.64%	13.78%	20	20
14	雲林縣崙背鄉	2018-11-24T23:31:08+08:00	2900	6510	9410	829	10239	21050	48.64%	13.78%	20	20
14	雲林縣崙背鄉	2018-11-24T23:01:28+08:00	2900	6510	9410	829	10239	21050	48.64%	13.78%	20	20
14	雲林縣崙背鄉	2018-11-24T23:47:25+08:00	2900	6510	9410	829	10239	21050	48.64%	13.78%	20	20
14	雲林縣崙背鄉	2018-11-25T06:29:14+08:00	2900	6510	9410	829	10239	21050	48.64%	13.78%	20	20
14	雲林縣崙背鄉	2018-11-25T04:02:49+08:00	2900	6510	9410	829	10239	21050	48.64%	13.78%	20	20
14	雲林縣崙背鄉	2018-11-25T01:07:23+08:00	2900	6510	9410	829	10239	21050	48.64%	13.78%	20	20
14	雲林縣崙背鄉	2018-11-24T23:43:14+08:00	2900	6510	9410	829	10239	21050	48.64%	13.78%	20	20
14	雲林縣崙背鄉	2018-11-25T06:13:50+08:00	2900	6510	9410	829	10239	21050	48.64%	13.78%	20	20
14	雲林縣崙背鄉	2018-11-24T23:35:08+08:00	2900	6510	9410	829	10239	21050	48.64%	13.78%	20	20
14	雲林縣崙背鄉	2018-11-24T22:33:35+08:00	2722	6061	8783	763	9546	19830	48.14%	13.73%	19	20
14	雲林縣崙背鄉	2018-11-25T00:14:06+08:00	2900	6510	9410	829	10239	21050	48.64%	13.78%	20	20
14	雲林縣崙背鄉	2018-11-25T00:00:07+08:00	2900	6510	9410	829	10239	21050	48.64%	13.78%	20	20
14	雲林縣崙背鄉	2018-11-24T23:08:33+08:00	2900	6510	9410	829	10239	21050	48.64%	13.78%	20	20
14	雲林縣崙背鄉	2018-11-25T03:32:32+08:00	2900	6510	9410	829	10239	21050	48.64%	13.78%	20	20
14	雲林縣崙背鄉	2018-11-25T03:44:20+08:00	2900	6510	9410	829	10239	21050	48.64%	13.78%	20	20
14	雲林縣崙背鄉	2018-11-24T22:13:24+08:00	2486	5417	7903	657	8560	17468	49%	14.23%	17	20
14	雲林縣崙背鄉	2018-11-24T23:55:44+08:00	2900	6510	9410	829	10239	21050	48.64%	13.78%	20	20
14	雲林縣崙背鄉	2018-11-25T01:17:49+08:00	2900	6510	9410	829	10239	21050	48.64%	13.78%	20	20
14	雲林縣崙背鄉	2018-11-24T23:19:47+08:00	2900	6510	9410	829	10239	21050	48.64%	13.78%	20	20
14	雲林縣崙背鄉	2018-11-25T06:18:55+08:00	2900	6510	9410	829	10239	21050	48.64%	13.78%	20	20
14	雲林縣崙背鄉	2018-11-25T01:02:28+08:00	2900	6510	9410	829	10239	21050	48.64%	13.78%	20	20
14	雲林縣崙背鄉	2018-11-24T23:27:16+08:00	2900	6510	9410	829	10239	21050	48.64%	13.78%	20	20
14	雲林縣崙背鄉	2018-11-24T22:40:25+08:00	2722	6061	8783	763	9546	19830	48.14%	13.73%	19	20
14	雲林縣崙背鄉	2018-11-24T22:23:10+08:00	2486	5417	7903	657	8560	17468	49%	14.23%	17	20
14	雲林縣崙背鄉	2018-11-24T22:30:03+08:00	2722	6061	8783	763	9546	19830	48.14%	13.73%	19	20
14	雲林縣崙背鄉	2018-11-24T23:51:32+08:00	2900	6510	9410	829	10239	21050	48.64%	13.78%	20	20
14	雲林縣崙背鄉	2018-11-25T00:05:02+08:00	2900	6510	9410	829	10239	21050	48.64%	13.78%	20	20
14	雲林縣崙背鄉	2018-11-24T22:41:32+08:00	2722	6061	8783	763	9546	19830	48.14%	13.73%	19	20
14	雲林縣崙背鄉	2018-11-25T00:09:31+08:00	2900	6510	9410	829	10239	21050	48.64%	13.78%	20	20
14	雲林縣崙背鄉	2018-11-24T22:54:23+08:00	2900	6510	9410	829	10239	21050	48.64%	13.78%	20	20
14	雲林縣崙背鄉	2018-11-24T23:05:02+08:00	2900	6510	9410	829	10239	21050	48.64%	13.78%	20	20
14	雲林縣崙背鄉	2018-11-25T03:56:09+08:00	2900	6510	9410	829	10239	21050	48.64%	13.78%	20	20
14	雲林縣崙背鄉	2018-11-25T00:18:27+08:00	2900	6510	9410	829	10239	21050	48.64%	13.78%	20	20
14	屏東縣崁頂鄉	2018-11-24T22:33:37+08:00	1381	2794	4175	422	4597	8823	52.1%	15.65%	9	12
14	屏東縣崁頂鄉	2018-11-24T23:43:16+08:00	1904	3962	5866	570	6436	12270	52.45%	15.52%	12	12
14	屏東縣崁頂鄉	2018-11-25T03:56:11+08:00	1904	3962	5866	570	6436	12270	52.45%	15.52%	12	12
14	屏東縣崁頂鄉	2018-11-25T06:29:16+08:00	1904	3962	5866	570	6436	12270	52.45%	15.52%	12	12
14	屏東縣崁頂鄉	2018-11-24T23:47:27+08:00	1904	3962	5866	570	6436	12270	52.45%	15.52%	12	12
14	屏東縣崁頂鄉	2018-11-24T22:16:09+08:00	1381	2794	4175	422	4597	8823	52.1%	15.65%	9	12
14	屏東縣崁頂鄉	2018-11-25T03:38:54+08:00	1904	3962	5866	570	6436	12270	52.45%	15.52%	12	12
14	屏東縣崁頂鄉	2018-11-24T23:55:46+08:00	1904	3962	5866	570	6436	12270	52.45%	15.52%	12	12
14	屏東縣崁頂鄉	2018-11-24T22:13:26+08:00	1381	2794	4175	422	4597	8823	52.1%	15.65%	9	12
14	屏東縣崁頂鄉	2018-11-25T01:25:51+08:00	1904	3962	5866	570	6436	12270	52.45%	15.52%	12	12
14	屏東縣崁頂鄉	2018-11-24T23:23:37+08:00	1692	3517	5209	517	5726	11017	51.97%	15.36%	11	12
14	屏東縣崁頂鄉	2018-11-25T06:18:56+08:00	1904	3962	5866	570	6436	12270	52.45%	15.52%	12	12
14	屏東縣崁頂鄉	2018-11-24T22:23:12+08:00	1381	2794	4175	422	4597	8823	52.1%	15.65%	9	12
14	屏東縣崁頂鄉	2018-11-24T22:40:27+08:00	1381	2794	4175	422	4597	8823	52.1%	15.65%	9	12
14	屏東縣崁頂鄉	2018-11-24T22:36:59+08:00	1381	2794	4175	422	4597	8823	52.1%	15.65%	9	12
14	屏東縣崁頂鄉	2018-11-25T00:00:10+08:00	1904	3962	5866	570	6436	12270	52.45%	15.52%	12	12
14	屏東縣崁頂鄉	2018-11-25T01:17:51+08:00	1904	3962	5866	570	6436	12270	52.45%	15.52%	12	12
14	屏東縣崁頂鄉	2018-11-24T22:30:07+08:00	1381	2794	4175	422	4597	8823	52.1%	15.65%	9	12
14	屏東縣崁頂鄉	2018-11-24T23:31:10+08:00	1904	3962	5866	570	6436	12270	52.45%	15.52%	12	12
14	屏東縣崁頂鄉	2018-11-24T23:39:14+08:00	1904	3962	5866	570	6436	12270	52.45%	15.52%	12	12
14	屏東縣崁頂鄉	2018-11-24T23:01:30+08:00	1528	3137	4665	464	5129	9827	52.19%	15.55%	10	12
14	屏東縣崁頂鄉	2018-11-25T04:02:51+08:00	1904	3962	5866	570	6436	12270	52.45%	15.52%	12	12
14	屏東縣崁頂鄉	2018-11-24T23:12:14+08:00	1528	3137	4665	464	5129	9827	52.19%	15.55%	10	12
14	屏東縣崁頂鄉	2018-11-25T06:23:59+08:00	1904	3962	5866	570	6436	12270	52.45%	15.52%	12	12
14	屏東縣崁頂鄉	2018-11-25T00:09:33+08:00	1904	3962	5866	570	6436	12270	52.45%	15.52%	12	12
14	屏東縣崁頂鄉	2018-11-24T22:45:07+08:00	1528	3137	4665	464	5129	9827	52.19%	15.55%	10	12
14	屏東縣崁頂鄉	2018-11-25T06:08:51+08:00	1904	3962	5866	570	6436	12270	52.45%	15.52%	12	12
14	屏東縣崁頂鄉	2018-11-25T01:07:25+08:00	1904	3962	5866	570	6436	12270	52.45%	15.52%	12	12
14	屏東縣崁頂鄉	2018-11-25T06:13:51+08:00	1904	3962	5866	570	6436	12270	52.45%	15.52%	12	12
14	屏東縣崁頂鄉	2018-11-24T23:16:02+08:00	1692	3517	5209	517	5726	11017	51.97%	15.36%	11	12
14	屏東縣崁頂鄉	2018-11-24T23:35:09+08:00	1904	3962	5866	570	6436	12270	52.45%	15.52%	12	12
14	屏東縣崁頂鄉	2018-11-25T03:49:50+08:00	1904	3962	5866	570	6436	12270	52.45%	15.52%	12	12
14	屏東縣崁頂鄉	2018-11-25T00:14:08+08:00	1904	3962	5866	570	6436	12270	52.45%	15.52%	12	12
14	屏東縣崁頂鄉	2018-11-25T00:23:02+08:00	1904	3962	5866	570	6436	12270	52.45%	15.52%	12	12
14	屏東縣崁頂鄉	2018-11-24T23:08:35+08:00	1528	3137	4665	464	5129	9827	52.19%	15.55%	10	12
14	屏東縣崁頂鄉	2018-11-25T03:32:33+08:00	1904	3962	5866	570	6436	12270	52.45%	15.52%	12	12
14	屏東縣崁頂鄉	2018-11-25T03:44:21+08:00	1904	3962	5866	570	6436	12270	52.45%	15.52%	12	12
14	屏東縣崁頂鄉	2018-11-24T23:19:49+08:00	1692	3517	5209	517	5726	11017	51.97%	15.36%	11	12
14	屏東縣崁頂鄉	2018-11-24T23:27:17+08:00	1904	3962	5866	570	6436	12270	52.45%	15.52%	12	12
14	屏東縣崁頂鄉	2018-11-24T22:19:36+08:00	1381	2794	4175	422	4597	8823	52.1%	15.65%	9	12
14	屏東縣崁頂鄉	2018-11-25T01:02:29+08:00	1904	3962	5866	570	6436	12270	52.45%	15.52%	12	12
14	屏東縣崁頂鄉	2018-11-24T23:51:34+08:00	1904	3962	5866	570	6436	12270	52.45%	15.52%	12	12
14	屏東縣崁頂鄉	2018-11-24T22:57:52+08:00	1528	3137	4665	464	5129	9827	52.19%	15.55%	10	12
14	屏東縣崁頂鄉	2018-11-25T00:57:36+08:00	1904	3962	5866	570	6436	12270	52.45%	15.52%	12	12
14	屏東縣崁頂鄉	2018-11-24T23:05:03+08:00	1528	3137	4665	464	5129	9827	52.19%	15.55%	10	12
14	屏東縣崁頂鄉	2018-11-24T22:50:47+08:00	1528	3137	4665	464	5129	9827	52.19%	15.55%	10	12
14	屏東縣崁頂鄉	2018-11-25T00:05:04+08:00	1904	3962	5866	570	6436	12270	52.45%	15.52%	12	12
14	屏東縣崁頂鄉	2018-11-24T22:41:34+08:00	1381	2794	4175	422	4597	8823	52.1%	15.65%	9	12
14	屏東縣崁頂鄉	2018-11-25T01:12:42+08:00	1904	3962	5866	570	6436	12270	52.45%	15.52%	12	12
14	屏東縣崁頂鄉	2018-11-24T22:26:36+08:00	1381	2794	4175	422	4597	8823	52.1%	15.65%	9	12
14	屏東縣崁頂鄉	2018-11-25T00:18:29+08:00	1904	3962	5866	570	6436	12270	52.45%	15.52%	12	12
14	屏東縣崁頂鄉	2018-11-24T22:54:25+08:00	1528	3137	4665	464	5129	9827	52.19%	15.55%	10	12
14	屏東縣九如鄉	2018-11-25T03:56:10+08:00	2870	6438	9308	1113	10421	19132	54.47%	15%	14	14
14	屏東縣九如鄉	2018-11-24T23:16:01+08:00	2567	5788	8355	973	9328	17133	54.44%	14.98%	13	14
14	屏東縣九如鄉	2018-11-24T23:43:16+08:00	2870	6438	9308	1113	10421	19132	54.47%	15%	14	14
14	屏東縣九如鄉	2018-11-24T22:33:36+08:00	1723	3763	5486	676	6162	11207	54.98%	15.37%	9	14
14	屏東縣九如鄉	2018-11-24T23:47:27+08:00	2870	6438	9308	1113	10421	19132	54.47%	15%	14	14
14	屏東縣九如鄉	2018-11-24T22:16:09+08:00	1723	3763	5486	676	6162	11207	54.98%	15.37%	9	14
14	屏東縣九如鄉	2018-11-25T03:38:54+08:00	2870	6438	9308	1113	10421	19132	54.47%	15%	14	14
14	屏東縣九如鄉	2018-11-25T01:25:51+08:00	2870	6438	9308	1113	10421	19132	54.47%	15%	14	14
14	屏東縣九如鄉	2018-11-24T23:23:37+08:00	2567	5788	8355	973	9328	17133	54.44%	14.98%	13	14
14	屏東縣九如鄉	2018-11-25T06:18:56+08:00	2870	6438	9308	1113	10421	19132	54.47%	15%	14	14
14	屏東縣九如鄉	2018-11-24T22:30:06+08:00	1723	3763	5486	676	6162	11207	54.98%	15.37%	9	14
14	屏東縣九如鄉	2018-11-24T22:19:35+08:00	1723	3763	5486	676	6162	11207	54.98%	15.37%	9	14
14	屏東縣九如鄉	2018-11-25T01:17:50+08:00	2870	6438	9308	1113	10421	19132	54.47%	15%	14	14
14	屏東縣九如鄉	2018-11-24T22:36:59+08:00	1723	3763	5486	676	6162	11207	54.98%	15.37%	9	14
14	屏東縣九如鄉	2018-11-24T22:40:26+08:00	1723	3763	5486	676	6162	11207	54.98%	15.37%	9	14
14	屏東縣九如鄉	2018-11-25T00:57:35+08:00	2870	6438	9308	1113	10421	19132	54.47%	15%	14	14
14	屏東縣九如鄉	2018-11-25T00:09:32+08:00	2870	6438	9308	1113	10421	19132	54.47%	15%	14	14
14	屏東縣九如鄉	2018-11-24T23:39:14+08:00	2870	6438	9308	1113	10421	19132	54.47%	15%	14	14
14	屏東縣九如鄉	2018-11-25T04:02:51+08:00	2870	6438	9308	1113	10421	19132	54.47%	15%	14	14
14	屏東縣九如鄉	2018-11-24T22:26:35+08:00	1723	3763	5486	676	6162	11207	54.98%	15.37%	9	14
14	屏東縣九如鄉	2018-11-24T23:12:14+08:00	2373	5368	7741	902	8643	15967	54.13%	14.86%	12	14
14	屏東縣九如鄉	2018-11-25T06:23:59+08:00	2870	6438	9308	1113	10421	19132	54.47%	15%	14	14
14	屏東縣九如鄉	2018-11-24T22:45:07+08:00	1723	3763	5486	676	6162	11207	54.98%	15.37%	9	14
14	屏東縣九如鄉	2018-11-25T06:08:51+08:00	2870	6438	9308	1113	10421	19132	54.47%	15%	14	14
14	屏東縣九如鄉	2018-11-25T01:07:25+08:00	2870	6438	9308	1113	10421	19132	54.47%	15%	14	14
14	屏東縣九如鄉	2018-11-25T06:13:51+08:00	2870	6438	9308	1113	10421	19132	54.47%	15%	14	14
14	屏東縣九如鄉	2018-11-24T23:35:09+08:00	2567	5788	8355	973	9328	17133	54.44%	14.98%	13	14
14	屏東縣九如鄉	2018-11-24T23:01:29+08:00	1977	4253	6230	765	6995	12807	54.62%	15.44%	10	14
14	屏東縣九如鄉	2018-11-24T23:31:09+08:00	2567	5788	8355	973	9328	17133	54.44%	14.98%	13	14
14	屏東縣九如鄉	2018-11-25T03:49:50+08:00	2870	6438	9308	1113	10421	19132	54.47%	15%	14	14
14	屏東縣九如鄉	2018-11-25T00:14:08+08:00	2870	6438	9308	1113	10421	19132	54.47%	15%	14	14
14	屏東縣九如鄉	2018-11-25T06:29:15+08:00	2870	6438	9308	1113	10421	19132	54.47%	15%	14	14
14	屏東縣九如鄉	2018-11-24T23:55:45+08:00	2870	6438	9308	1113	10421	19132	54.47%	15%	14	14
14	屏東縣九如鄉	2018-11-24T23:08:34+08:00	2201	4803	7004	822	7826	14485	54.03%	15.2%	11	14
14	屏東縣九如鄉	2018-11-25T00:00:09+08:00	2870	6438	9308	1113	10421	19132	54.47%	15%	14	14
14	屏東縣九如鄉	2018-11-25T00:23:02+08:00	2870	6438	9308	1113	10421	19132	54.47%	15%	14	14
14	屏東縣九如鄉	2018-11-25T03:32:33+08:00	2870	6438	9308	1113	10421	19132	54.47%	15%	14	14
14	屏東縣九如鄉	2018-11-25T03:44:21+08:00	2870	6438	9308	1113	10421	19132	54.47%	15%	14	14
14	屏東縣九如鄉	2018-11-24T22:13:25+08:00	1723	3763	5486	676	6162	11207	54.98%	15.37%	9	14
14	屏東縣九如鄉	2018-11-24T23:19:49+08:00	2567	5788	8355	973	9328	17133	54.44%	14.98%	13	14
14	屏東縣九如鄉	2018-11-24T22:23:11+08:00	1723	3763	5486	676	6162	11207	54.98%	15.37%	9	14
14	屏東縣九如鄉	2018-11-24T23:27:17+08:00	2567	5788	8355	973	9328	17133	54.44%	14.98%	13	14
14	屏東縣九如鄉	2018-11-25T01:02:29+08:00	2870	6438	9308	1113	10421	19132	54.47%	15%	14	14
14	屏東縣九如鄉	2018-11-24T23:51:33+08:00	2870	6438	9308	1113	10421	19132	54.47%	15%	14	14
14	屏東縣九如鄉	2018-11-24T22:57:52+08:00	1977	4253	6230	765	6995	12807	54.62%	15.44%	10	14
14	屏東縣九如鄉	2018-11-24T23:05:03+08:00	2201	4803	7004	822	7826	14485	54.03%	15.2%	11	14
14	屏東縣九如鄉	2018-11-24T22:54:24+08:00	1977	4253	6230	765	6995	12807	54.62%	15.44%	10	14
14	屏東縣九如鄉	2018-11-25T00:18:28+08:00	2870	6438	9308	1113	10421	19132	54.47%	15%	14	14
14	屏東縣九如鄉	2018-11-24T22:41:33+08:00	1723	3763	5486	676	6162	11207	54.98%	15.37%	9	14
14	屏東縣九如鄉	2018-11-25T00:05:03+08:00	2870	6438	9308	1113	10421	19132	54.47%	15%	14	14
14	屏東縣九如鄉	2018-11-25T01:12:42+08:00	2870	6438	9308	1113	10421	19132	54.47%	15%	14	14
14	屏東縣九如鄉	2018-11-24T22:50:46+08:00	1977	4253	6230	765	6995	12807	54.62%	15.44%	10	14
14	臺中市清水區	2018-11-24T23:47:19+08:00	12030	27156	39186	2752	41938	71528	58.63%	16.82%	59	59
14	臺中市清水區	2018-11-24T22:16:01+08:00	10905	24461	35366	2602	37968	64732	58.65%	16.85%	54	59
14	臺中市清水區	2018-11-24T23:01:22+08:00	11841	26781	38622	2729	41351	70452	58.69%	16.81%	58	59
14	臺中市清水區	2018-11-24T23:35:02+08:00	12030	27156	39186	2752	41938	71528	58.63%	16.82%	59	59
14	臺中市清水區	2018-11-24T23:12:06+08:00	11841	26781	38622	2729	41351	70452	58.69%	16.81%	58	59
14	臺中市清水區	2018-11-25T01:07:18+08:00	12030	27156	39186	2752	41938	71528	58.63%	16.82%	59	59
14	臺中市清水區	2018-11-25T06:08:43+08:00	12030	27156	39186	2752	41938	71528	58.63%	16.82%	59	59
14	臺中市清水區	2018-11-24T22:26:29+08:00	11186	25014	36200	2630	38830	66108	58.74%	16.92%	55	59
14	臺中市清水區	2018-11-25T03:44:12+08:00	12030	27156	39186	2752	41938	71528	58.63%	16.82%	59	59
14	臺中市清水區	2018-11-25T01:17:42+08:00	12030	27156	39186	2752	41938	71528	58.63%	16.82%	59	59
14	臺中市清水區	2018-11-24T22:19:29+08:00	10905	24461	35366	2602	37968	64732	58.65%	16.85%	54	59
14	臺中市清水區	2018-11-25T00:57:28+08:00	12030	27156	39186	2752	41938	71528	58.63%	16.82%	59	59
14	臺中市清水區	2018-11-25T00:04:56+08:00	12030	27156	39186	2752	41938	71528	58.63%	16.82%	59	59
14	臺中市清水區	2018-11-24T22:57:44+08:00	11841	26781	38622	2729	41351	70452	58.69%	16.81%	58	59
14	臺中市清水區	2018-11-24T22:13:17+08:00	10905	24461	35366	2602	37968	64732	58.65%	16.85%	54	59
14	臺中市清水區	2018-11-24T23:23:30+08:00	12030	27156	39186	2752	41938	71528	58.63%	16.82%	59	59
14	臺中市清水區	2018-11-24T23:04:56+08:00	11841	26781	38622	2729	41351	70452	58.69%	16.81%	58	59
14	臺中市清水區	2018-11-24T22:40:20+08:00	11405	25476	36881	2689	39570	67319	58.78%	16.94%	56	59
14	臺中市清水區	2018-11-24T23:15:54+08:00	11841	26781	38622	2729	41351	70452	58.69%	16.81%	58	59
14	臺中市清水區	2018-11-25T01:25:44+08:00	12030	27156	39186	2752	41938	71528	58.63%	16.82%	59	59
14	臺中市清水區	2018-11-24T23:59:59+08:00	12030	27156	39186	2752	41938	71528	58.63%	16.82%	59	59
14	臺中市清水區	2018-11-25T01:02:22+08:00	12030	27156	39186	2752	41938	71528	58.63%	16.82%	59	59
14	臺中市清水區	2018-11-25T03:38:47+08:00	12030	27156	39186	2752	41938	71528	58.63%	16.82%	59	59
14	臺中市清水區	2018-11-24T23:55:39+08:00	12030	27156	39186	2752	41938	71528	58.63%	16.82%	59	59
14	臺中市清水區	2018-11-24T22:54:18+08:00	11841	26781	38622	2729	41351	70452	58.69%	16.81%	58	59
14	臺中市清水區	2018-11-24T22:45:01+08:00	11640	26049	37689	2697	40386	68843	58.66%	16.91%	57	59
14	臺中市清水區	2018-11-25T03:56:02+08:00	12030	27156	39186	2752	41938	71528	58.63%	16.82%	59	59
14	臺中市清水區	2018-11-24T23:39:05+08:00	12030	27156	39186	2752	41938	71528	58.63%	16.82%	59	59
14	臺中市清水區	2018-11-24T23:31:01+08:00	12030	27156	39186	2752	41938	71528	58.63%	16.82%	59	59
14	臺中市清水區	2018-11-25T00:09:24+08:00	12030	27156	39186	2752	41938	71528	58.63%	16.82%	59	59
14	臺中市清水區	2018-11-24T22:41:27+08:00	11405	25476	36881	2689	39570	67319	58.78%	16.94%	56	59
14	臺中市清水區	2018-11-25T04:02:40+08:00	12030	27156	39186	2752	41938	71528	58.63%	16.82%	59	59
14	臺中市清水區	2018-11-25T01:12:33+08:00	12030	27156	39186	2752	41938	71528	58.63%	16.82%	59	59
14	臺中市清水區	2018-11-25T00:14:01+08:00	12030	27156	39186	2752	41938	71528	58.63%	16.82%	59	59
14	臺中市清水區	2018-11-24T22:50:38+08:00	11841	26781	38622	2729	41351	70452	58.69%	16.81%	58	59
14	臺中市清水區	2018-11-24T23:51:26+08:00	12030	27156	39186	2752	41938	71528	58.63%	16.82%	59	59
14	臺中市清水區	2018-11-25T06:18:49+08:00	12030	27156	39186	2752	41938	71528	58.63%	16.82%	59	59
14	臺中市清水區	2018-11-24T22:23:03+08:00	11186	25014	36200	2630	38830	66108	58.74%	16.92%	55	59
14	臺中市清水區	2018-11-24T22:29:56+08:00	11186	25014	36200	2630	38830	66108	58.74%	16.92%	55	59
14	臺中市清水區	2018-11-24T23:19:40+08:00	12030	27156	39186	2752	41938	71528	58.63%	16.82%	59	59
14	臺中市清水區	2018-11-24T22:36:53+08:00	11186	25014	36200	2630	38830	66108	58.74%	16.92%	55	59
14	臺中市清水區	2018-11-24T23:08:26+08:00	11841	26781	38622	2729	41351	70452	58.69%	16.81%	58	59
14	臺中市清水區	2018-11-24T23:27:11+08:00	12030	27156	39186	2752	41938	71528	58.63%	16.82%	59	59
14	臺中市清水區	2018-11-25T03:32:26+08:00	12030	27156	39186	2752	41938	71528	58.63%	16.82%	59	59
14	臺中市清水區	2018-11-25T03:49:43+08:00	12030	27156	39186	2752	41938	71528	58.63%	16.82%	59	59
14	臺中市清水區	2018-11-25T06:29:08+08:00	12030	27156	39186	2752	41938	71528	58.63%	16.82%	59	59
14	臺中市清水區	2018-11-25T00:22:55+08:00	12030	27156	39186	2752	41938	71528	58.63%	16.82%	59	59
14	臺中市清水區	2018-11-25T06:13:44+08:00	12030	27156	39186	2752	41938	71528	58.63%	16.82%	59	59
14	臺中市清水區	2018-11-25T00:18:21+08:00	12030	27156	39186	2752	41938	71528	58.63%	16.82%	59	59
14	臺中市清水區	2018-11-25T06:23:52+08:00	12030	27156	39186	2752	41938	71528	58.63%	16.82%	59	59
14	臺中市清水區	2018-11-24T23:43:09+08:00	12030	27156	39186	2752	41938	71528	58.63%	16.82%	59	59
14	臺中市清水區	2018-11-24T22:33:29+08:00	11186	25014	36200	2630	38830	66108	58.74%	16.92%	55	59
14	臺中市東區	2018-11-24T23:47:19+08:00	11499	23547	35046	1945	36991	62441	59.24%	18.42%	48	49
14	臺中市東區	2018-11-24T22:16:01+08:00	9324	18839	28163	1551	29714	50060	59.36%	18.63%	39	49
14	臺中市東區	2018-11-25T01:07:17+08:00	11817	24192	36009	2003	38012	64291	59.12%	18.38%	49	49
14	臺中市東區	2018-11-24T23:01:22+08:00	11069	22487	33556	1851	35407	59642	59.37%	18.56%	46	49
14	臺中市東區	2018-11-25T06:08:42+08:00	11817	24192	36009	2003	38012	64291	59.12%	18.38%	49	49
14	臺中市東區	2018-11-24T23:35:02+08:00	11499	23547	35046	1945	36991	62441	59.24%	18.42%	48	49
14	臺中市東區	2018-11-24T23:12:06+08:00	11069	22487	33556	1851	35407	59642	59.37%	18.56%	46	49
14	臺中市東區	2018-11-24T22:26:29+08:00	9854	19890	29744	1631	31375	52698	59.54%	18.7%	41	49
14	臺中市東區	2018-11-25T03:44:12+08:00	11817	24192	36009	2003	38012	64291	59.12%	18.38%	49	49
14	臺中市東區	2018-11-24T22:19:29+08:00	9324	18839	28163	1551	29714	50060	59.36%	18.63%	39	49
14	臺中市東區	2018-11-25T00:04:56+08:00	11499	23547	35046	1945	36991	62441	59.24%	18.42%	48	49
14	臺中市東區	2018-11-24T22:57:44+08:00	11069	22487	33556	1851	35407	59642	59.37%	18.56%	46	49
14	臺中市東區	2018-11-25T00:57:27+08:00	11817	24192	36009	2003	38012	64291	59.12%	18.38%	49	49
14	臺中市東區	2018-11-24T22:13:17+08:00	9063	18315	27378	1526	28904	48579	59.5%	18.66%	38	49
14	臺中市東區	2018-11-24T23:23:30+08:00	11276	22921	34197	1898	36095	60748	59.42%	18.56%	47	49
14	臺中市東區	2018-11-24T23:55:38+08:00	11499	23547	35046	1945	36991	62441	59.24%	18.42%	48	49
14	臺中市東區	2018-11-24T22:40:20+08:00	10898	22126	33024	1804	34828	58689	59.34%	18.57%	45	49
14	臺中市東區	2018-11-24T23:15:54+08:00	11069	22487	33556	1851	35407	59642	59.37%	18.56%	46	49
14	臺中市東區	2018-11-25T01:25:43+08:00	11817	24192	36009	2003	38012	64291	59.12%	18.38%	49	49
14	臺中市東區	2018-11-24T23:59:59+08:00	11499	23547	35046	1945	36991	62441	59.24%	18.42%	48	49
14	臺中市東區	2018-11-25T03:38:47+08:00	11817	24192	36009	2003	38012	64291	59.12%	18.38%	49	49
14	臺中市東區	2018-11-24T22:54:18+08:00	11069	22487	33556	1851	35407	59642	59.37%	18.56%	46	49
14	臺中市東區	2018-11-25T06:23:51+08:00	11817	24192	36009	2003	38012	64291	59.12%	18.38%	49	49
14	臺中市東區	2018-11-24T22:45:00+08:00	10898	22126	33024	1804	34828	58689	59.34%	18.57%	45	49
14	臺中市東區	2018-11-24T23:31:01+08:00	11499	23547	35046	1945	36991	62441	59.24%	18.42%	48	49
14	臺中市東區	2018-11-25T00:09:24+08:00	11499	23547	35046	1945	36991	62441	59.24%	18.42%	48	49
14	臺中市東區	2018-11-24T22:41:27+08:00	10898	22126	33024	1804	34828	58689	59.34%	18.57%	45	49
14	臺中市東區	2018-11-25T04:02:40+08:00	11817	24192	36009	2003	38012	64291	59.12%	18.38%	49	49
14	臺中市東區	2018-11-25T01:12:33+08:00	11817	24192	36009	2003	38012	64291	59.12%	18.38%	49	49
14	臺中市東區	2018-11-24T22:50:37+08:00	10898	22126	33024	1804	34828	58689	59.34%	18.57%	45	49
14	臺中市東區	2018-11-25T00:14:00+08:00	11499	23547	35046	1945	36991	62441	59.24%	18.42%	48	49
14	臺中市東區	2018-11-24T23:39:04+08:00	11499	23547	35046	1945	36991	62441	59.24%	18.42%	48	49
14	臺中市東區	2018-11-24T23:51:26+08:00	11499	23547	35046	1945	36991	62441	59.24%	18.42%	48	49
14	臺中市東區	2018-11-25T06:18:49+08:00	11817	24192	36009	2003	38012	64291	59.12%	18.38%	49	49
14	臺中市東區	2018-11-25T01:17:41+08:00	11817	24192	36009	2003	38012	64291	59.12%	18.38%	49	49
14	臺中市東區	2018-11-24T22:23:03+08:00	9854	19890	29744	1631	31375	52698	59.54%	18.7%	41	49
14	臺中市東區	2018-11-24T22:29:56+08:00	9854	19890	29744	1631	31375	52698	59.54%	18.7%	41	49
14	臺中市東區	2018-11-24T23:04:55+08:00	11069	22487	33556	1851	35407	59642	59.37%	18.56%	46	49
14	臺中市東區	2018-11-24T23:19:40+08:00	11276	22921	34197	1898	36095	60748	59.42%	18.56%	47	49
14	臺中市東區	2018-11-24T23:27:10+08:00	11276	22921	34197	1898	36095	60748	59.42%	18.56%	47	49
14	臺中市東區	2018-11-24T23:08:26+08:00	11069	22487	33556	1851	35407	59642	59.37%	18.56%	46	49
14	臺中市東區	2018-11-24T22:36:52+08:00	10331	20934	31265	1727	32992	55575	59.36%	18.59%	43	49
14	臺中市東區	2018-11-25T01:02:21+08:00	11817	24192	36009	2003	38012	64291	59.12%	18.38%	49	49
14	臺中市東區	2018-11-25T03:32:26+08:00	11817	24192	36009	2003	38012	64291	59.12%	18.38%	49	49
14	臺中市東區	2018-11-25T03:49:43+08:00	11817	24192	36009	2003	38012	64291	59.12%	18.38%	49	49
14	臺中市東區	2018-11-25T00:22:55+08:00	11499	23547	35046	1945	36991	62441	59.24%	18.42%	48	49
14	臺中市東區	2018-11-25T03:56:01+08:00	11817	24192	36009	2003	38012	64291	59.12%	18.38%	49	49
14	臺中市東區	2018-11-25T06:13:44+08:00	11817	24192	36009	2003	38012	64291	59.12%	18.38%	49	49
14	臺中市東區	2018-11-25T00:18:21+08:00	11499	23547	35046	1945	36991	62441	59.24%	18.42%	48	49
14	臺中市東區	2018-11-24T22:33:29+08:00	10097	20428	30525	1692	32217	54189	59.45%	18.63%	42	49
14	臺中市東區	2018-11-25T06:29:07+08:00	11817	24192	36009	2003	38012	64291	59.12%	18.38%	49	49
14	臺中市東區	2018-11-24T23:43:08+08:00	11499	23547	35046	1945	36991	62441	59.24%	18.42%	48	49
14	臺北市	2018-11-24T23:47:17+08:00	337330	547689	885019	42773	927792	1599653	58%	21.09%	146	1
14	臺北市	2018-11-24T22:50:35+08:00	233844	378778	612622	30153	642775	1109090	57.96%	21.08%	812	1
14	臺北市	2018-11-25T01:12:31+08:00	429299	696856	1126155	53930	1180085	2034086	58.02%	21.11%	437	1
14	臺北市	2018-11-24T22:26:27+08:00	199940	322691	522631	25703	548334	944434	58.06%	21.17%	697	1
14	臺北市	2018-11-24T22:19:27+08:00	188931	304425	493356	24379	517735	892714	58%	21.16%	661	1
14	臺北市	2018-11-24T22:57:42+08:00	250463	406377	656840	32283	689123	1189496	57.93%	21.06%	867	1
14	臺北市	2018-11-25T00:57:26+08:00	417194	677288	1094482	52599	1147081	1978368	57.98%	21.09%	400	1
14	臺北市	2018-11-24T22:29:54+08:00	203784	329442	533226	26288	559514	963764	58.06%	21.14%	711	1
14	臺北市	2018-11-24T23:27:09+08:00	305128	495938	801066	39005	840071	1450340	57.92%	21.04%	046	1
14	臺北市	2018-11-24T22:44:59+08:00	222470	360152	582622	28757	611379	1054108	58%	21.11%	773	1
14	臺北市	2018-11-24T22:23:01+08:00	195160	314725	509885	25169	535054	921994	58.03%	21.17%	681	1
14	臺北市	2018-11-25T03:55:59+08:00	469793	762277	1232070	59045	1291115	2228430	57.94%	21.08%	563	1
14	臺北市	2018-11-24T23:51:24+08:00	339352	551104	890456	43032	933488	1609443	58%	21.09%	153	1
14	臺北市	2018-11-24T23:15:52+08:00	287267	466159	753426	36857	790283	1362857	57.99%	21.08%	988	1
14	臺北市	2018-11-25T03:32:24+08:00	469570	761899	1231469	59030	1290499	2227286	57.94%	21.08%	562	1
14	臺北市	2018-11-25T01:25:42+08:00	434837	705648	1140485	54672	1195157	2060408	58.01%	21.1%	454	1
14	臺北市	2018-11-24T23:55:36+08:00	349090	567329	916419	44260	960679	1656615	57.99%	21.07%	186	1
14	臺北市	2018-11-25T00:13:58+08:00	371520	603795	975315	46964	1022279	1763189	57.98%	21.07%	257	1
14	臺北市	2018-11-24T22:40:18+08:00	219588	355558	575146	28351	603497	1039484	58.06%	21.12%	763	1
14	臺北市	2018-11-24T23:08:24+08:00	272400	442117	714517	35028	749545	1293279	57.96%	21.06%	939	1
14	臺北市	2018-11-24T23:59:57+08:00	354366	576026	930392	44928	975320	1681711	58%	21.07%	203	1
14	臺北市	2018-11-24T22:36:51+08:00	215410	348796	564206	27843	592049	1020231	58.03%	21.11%	750	1
14	臺北市	2018-11-24T22:54:16+08:00	238601	386652	625253	30775	656028	1131842	57.96%	21.08%	828	1
14	臺北市	2018-11-25T06:29:05+08:00	469793	762277	1232070	59045	1291115	2228430	57.94%	21.08%	563	1
14	臺北市	2018-11-25T06:23:50+08:00	469793	762277	1232070	59045	1291115	2228430	57.94%	21.08%	563	1
14	臺北市	2018-11-25T03:49:41+08:00	469793	762277	1232070	59045	1291115	2228430	57.94%	21.08%	563	1
14	臺北市	2018-11-24T23:39:02+08:00	321952	523131	845083	40973	886056	1529120	57.95%	21.05%	099	1
14	臺北市	2018-11-24T23:12:04+08:00	277029	449651	726680	35532	762212	1315223	57.95%	21.06%	954	1
14	臺北市	2018-11-25T06:08:40+08:00	469793	762277	1232070	59045	1291115	2228430	57.94%	21.08%	563	1
14	臺北市	2018-11-25T00:09:22+08:00	362313	588991	951304	46001	997305	1719904	57.99%	21.07%	228	1
14	臺北市	2018-11-25T01:07:15+08:00	425943	690775	1116718	53590	1170308	2017544	58.01%	21.11%	426	1
14	臺北市	2018-11-24T23:01:20+08:00	257933	418649	676582	33253	709835	1224905	57.95%	21.06%	892	1
14	臺北市	2018-11-24T22:41:26+08:00	219588	355558	575146	28351	603497	1039484	58.06%	21.12%	763	1
14	臺北市	2018-11-24T23:35:01+08:00	316858	515023	831881	40333	872214	1505618	57.93%	21.05%	083	1
14	臺北市	2018-11-24T23:04:54+08:00	264803	429753	694556	34119	728675	1256913	57.97%	21.07%	914	1
14	臺北市	2018-11-25T06:18:47+08:00	469793	762277	1232070	59045	1291115	2228430	57.94%	21.08%	563	1
14	臺北市	2018-11-25T00:04:55+08:00	361435	587493	948928	45898	994826	1715665	57.98%	21.07%	225	1
14	臺北市	2018-11-24T22:13:15+08:00	178009	286975	464984	23106	488090	842430	57.94%	21.13%	626	1
14	臺北市	2018-11-25T03:44:10+08:00	469793	762277	1232070	59045	1291115	2228430	57.94%	21.08%	563	1
14	臺北市	2018-11-25T01:02:20+08:00	422658	685555	1108213	53199	1161412	2002888	57.99%	21.1%	416	1
14	臺北市	2018-11-25T03:38:45+08:00	469793	762277	1232070	59045	1291115	2228430	57.94%	21.08%	563	1
14	臺北市	2018-11-24T23:19:38+08:00	293333	476431	769764	37545	807309	1392992	57.96%	21.06%	007	1
14	臺北市	2018-11-24T23:23:29+08:00	298460	484932	783392	38205	821597	1417619	57.96%	21.05%	024	1
14	臺北市	2018-11-24T23:30:59+08:00	313660	510294	823954	39933	863887	1491170	57.93%	21.03%	073	1
14	臺北市	2018-11-24T22:15:59+08:00	183148	295205	478353	23752	502105	866102	57.97%	21.15%	643	1
14	臺北市	2018-11-25T01:17:39+08:00	431024	699472	1130496	54173	1184669	2042051	58.01%	21.11%	442	1
14	臺北市	2018-11-24T23:43:07+08:00	332103	539415	871518	42180	913698	1575570	57.99%	21.08%	130	1
14	臺北市	2018-11-25T00:18:19+08:00	377952	614005	991957	47747	1039704	1793986	57.95%	21.07%	277	1
14	臺北市	2018-11-25T00:22:53+08:00	386125	627177	1013302	48769	1062071	1832172	57.97%	21.07%	302	1
14	臺北市	2018-11-24T22:33:27+08:00	208937	337799	546736	26989	573725	988075	58.06%	21.15%	728	1
14	臺北市	2018-11-25T06:13:42+08:00	469793	762277	1232070	59045	1291115	2228430	57.94%	21.08%	563	1
14	臺北市	2018-11-25T04:02:38+08:00	469793	762277	1232070	59045	1291115	2228430	57.94%	21.08%	563	1
14	臺北市內湖區	2018-11-24T23:47:17+08:00	39555	61502	101057	3987	105044	179448	58.54%	22.04%	115	150
14	臺北市內湖區	2018-11-24T22:26:28+08:00	19361	30458	49819	2019	51838	87782	59.05%	22.06%	59	150
14	臺北市內湖區	2018-11-25T01:12:31+08:00	50133	78236	128369	5123	133492	228383	58.45%	21.95%	145	150
14	臺北市內湖區	2018-11-25T01:07:16+08:00	50133	78236	128369	5123	133492	228383	58.45%	21.95%	145	150
14	臺北市內湖區	2018-11-24T22:19:27+08:00	18734	29415	48149	1951	50100	84950	58.98%	22.05%	57	150
14	臺北市內湖區	2018-11-24T22:13:16+08:00	17268	27269	44537	1816	46353	78643	58.94%	21.96%	53	150
14	臺北市內湖區	2018-11-24T22:57:42+08:00	24154	38244	62398	2520	64918	110787	58.6%	21.8%	73	150
14	臺北市內湖區	2018-11-25T00:57:26+08:00	49805	77633	127438	5077	132515	226651	58.47%	21.97%	144	150
14	臺北市內湖區	2018-11-24T23:51:25+08:00	39948	62103	102051	4039	106090	181176	58.56%	22.05%	116	150
14	臺北市內湖區	2018-11-24T22:29:54+08:00	19361	30458	49819	2019	51838	87782	59.05%	22.06%	59	150
14	臺北市內湖區	2018-11-24T23:27:09+08:00	34554	54255	88809	3516	92325	157661	58.56%	21.92%	102	150
14	臺北市內湖區	2018-11-24T22:44:59+08:00	20368	32035	52403	2136	54539	92226	59.14%	22.08%	62	150
14	臺北市內湖區	2018-11-24T22:19:28+08:00	18734	29415	48149	1951	50100	84950	58.98%	22.05%	57	150
14	臺北市內湖區	2018-11-24T22:23:01+08:00	19361	30458	49819	2019	51838	87782	59.05%	22.06%	59	150
14	臺北市內湖區	2018-11-24T23:51:24+08:00	39948	62103	102051	4039	106090	181176	58.56%	22.05%	116	150
14	臺北市內湖區	2018-11-24T23:15:52+08:00	30061	47103	77164	3084	80248	136996	58.58%	21.94%	90	150
14	臺北市內湖區	2018-11-25T03:32:24+08:00	52075	81158	133233	5297	138530	236824	58.49%	21.99%	150	150
14	臺北市內湖區	2018-11-25T03:38:46+08:00	52075	81158	133233	5297	138530	236824	58.49%	21.99%	150	150
14	臺北市內湖區	2018-11-24T23:59:58+08:00	40711	63199	103910	4105	108015	184365	58.59%	22.08%	118	150
14	臺北市內湖區	2018-11-25T01:25:42+08:00	50867	79368	130235	5189	135424	231674	58.45%	21.96%	147	150
14	臺北市內湖區	2018-11-24T23:55:36+08:00	40301	62619	102920	4067	106987	182622	58.58%	22.07%	117	150
14	臺北市內湖區	2018-11-24T22:40:18+08:00	20368	32035	52403	2136	54539	92226	59.14%	22.08%	62	150
14	臺北市內湖區	2018-11-25T03:32:25+08:00	52075	81158	133233	5297	138530	236824	58.49%	21.99%	150	150
14	臺北市內湖區	2018-11-24T23:08:24+08:00	27251	42840	70091	2825	72916	124486	58.57%	21.89%	82	150
14	臺北市內湖區	2018-11-24T23:15:53+08:00	30061	47103	77164	3084	80248	136996	58.58%	21.94%	90	150
14	臺北市內湖區	2018-11-24T23:59:57+08:00	40711	63199	103910	4105	108015	184365	58.59%	22.08%	118	150
14	臺北市內湖區	2018-11-24T22:40:19+08:00	20368	32035	52403	2136	54539	92226	59.14%	22.08%	62	150
14	臺北市內湖區	2018-11-24T23:55:37+08:00	40301	62619	102920	4067	106987	182622	58.58%	22.07%	117	150
14	臺北市內湖區	2018-11-25T00:13:59+08:00	42813	66581	109394	4292	113686	194036	58.59%	22.06%	124	150
14	臺北市內湖區	2018-11-24T22:36:51+08:00	20368	32035	52403	2136	54539	92226	59.14%	22.08%	62	150
14	臺北市內湖區	2018-11-25T06:29:05+08:00	52075	81158	133233	5297	138530	236824	58.49%	21.99%	150	150
14	臺北市內湖區	2018-11-24T22:54:17+08:00	23765	37698	61463	2487	63950	109038	58.65%	21.8%	72	150
14	臺北市內湖區	2018-11-25T06:23:50+08:00	52075	81158	133233	5297	138530	236824	58.49%	21.99%	150	150
14	臺北市內湖區	2018-11-24T23:01:21+08:00	24524	38787	63311	2550	65861	112220	58.69%	21.85%	74	150
14	臺北市內湖區	2018-11-24T23:39:02+08:00	38465	59683	98148	3868	102016	174344	58.51%	22.06%	112	150
14	臺北市內湖區	2018-11-24T23:12:04+08:00	27976	43863	71839	2886	74725	127531	58.59%	21.94%	84	150
14	臺北市內湖區	2018-11-25T06:08:41+08:00	52075	81158	133233	5297	138530	236824	58.49%	21.99%	150	150
14	臺北市內湖區	2018-11-25T00:09:22+08:00	41375	64417	105792	4187	109979	187810	58.56%	22.03%	120	150
14	臺北市內湖區	2018-11-24T23:31:00+08:00	36016	56588	92604	3646	96250	164482	58.52%	21.9%	106	150
14	臺北市內湖區	2018-11-24T23:39:03+08:00	38465	59683	98148	3868	102016	174344	58.51%	22.06%	112	150
14	臺北市內湖區	2018-11-24T23:01:20+08:00	24524	38787	63311	2550	65861	112220	58.69%	21.85%	74	150
14	臺北市內湖區	2018-11-24T22:50:36+08:00	22234	34976	57210	2313	59523	101583	58.6%	21.89%	67	150
14	臺北市內湖區	2018-11-25T01:12:32+08:00	50133	78236	128369	5123	133492	228383	58.45%	21.95%	145	150
14	臺北市內湖區	2018-11-24T22:41:26+08:00	20368	32035	52403	2136	54539	92226	59.14%	22.08%	62	150
14	臺北市內湖區	2018-11-24T23:35:01+08:00	36991	57500	94491	3743	98234	167803	58.54%	22.04%	108	150
14	臺北市內湖區	2018-11-24T23:04:54+08:00	25552	40414	65966	2647	68613	116786	58.75%	21.88%	77	150
14	臺北市內湖區	2018-11-25T00:04:55+08:00	41780	64956	106736	4223	110959	189399	58.58%	22.06%	121	150
14	臺北市內湖區	2018-11-25T03:44:11+08:00	52075	81158	133233	5297	138530	236824	58.49%	21.99%	150	150
14	臺北市內湖區	2018-11-25T06:18:48+08:00	52075	81158	133233	5297	138530	236824	58.49%	21.99%	150	150
14	臺北市內湖區	2018-11-24T22:23:02+08:00	19361	30458	49819	2019	51838	87782	59.05%	22.06%	59	150
14	臺北市內湖區	2018-11-25T03:44:10+08:00	52075	81158	133233	5297	138530	236824	58.49%	21.99%	150	150
14	臺北市內湖區	2018-11-25T01:17:40+08:00	50133	78236	128369	5123	133492	228383	58.45%	21.95%	145	150
14	臺北市內湖區	2018-11-25T01:02:20+08:00	50133	78236	128369	5123	133492	228383	58.45%	21.95%	145	150
14	臺北市內湖區	2018-11-25T03:38:45+08:00	52075	81158	133233	5297	138530	236824	58.49%	21.99%	150	150
14	臺北市內湖區	2018-11-24T23:19:38+08:00	32266	50698	82964	3279	86243	147438	58.49%	21.88%	96	150
14	臺北市內湖區	2018-11-24T23:23:29+08:00	33452	52366	85818	3375	89193	152475	58.5%	21.94%	99	150
14	臺北市內湖區	2018-11-24T22:36:52+08:00	20368	32035	52403	2136	54539	92226	59.14%	22.08%	62	150
14	臺北市內湖區	2018-11-24T22:15:59+08:00	18028	28308	46336	1908	48244	81714	59.04%	22.06%	55	150
14	臺北市內湖區	2018-11-24T23:19:39+08:00	32266	50698	82964	3279	86243	147438	58.49%	21.88%	96	150
14	臺北市內湖區	2018-11-25T01:17:39+08:00	50133	78236	128369	5123	133492	228383	58.45%	21.95%	145	150
14	臺北市內湖區	2018-11-25T06:29:06+08:00	52075	81158	133233	5297	138530	236824	58.49%	21.99%	150	150
14	臺北市內湖區	2018-11-24T22:33:28+08:00	20027	31463	51490	2098	53588	90572	59.17%	22.11%	61	150
14	臺北市內湖區	2018-11-25T06:13:43+08:00	52075	81158	133233	5297	138530	236824	58.49%	21.99%	150	150
14	臺北市內湖區	2018-11-24T23:43:07+08:00	39555	61502	101057	3987	105044	179448	58.54%	22.04%	115	150
14	臺北市內湖區	2018-11-25T00:22:53+08:00	44979	70002	114981	4533	119514	204213	58.52%	22.03%	130	150
14	臺北市內湖區	2018-11-25T03:56:00+08:00	52075	81158	133233	5297	138530	236824	58.49%	21.99%	150	150
14	臺北市內湖區	2018-11-24T22:33:27+08:00	20027	31463	51490	2098	53588	90572	59.17%	22.11%	61	150
14	臺北市內湖區	2018-11-25T03:49:42+08:00	52075	81158	133233	5297	138530	236824	58.49%	21.99%	150	150
14	臺北市內湖區	2018-11-25T00:18:20+08:00	43480	67713	111193	4379	115572	197486	58.52%	22.02%	126	150
14	臺北市內湖區	2018-11-25T04:02:38+08:00	52075	81158	133233	5297	138530	236824	58.49%	21.99%	150	150
14	金門縣金寧鄉	2018-11-24T22:33:39+08:00	2266	6024	8290	386	8676	24407	35.55%	9.28%	15	17
14	金門縣金寧鄉	2018-11-25T03:49:52+08:00	3026	6725	9751	438	10189	28162	36.18%	10.74%	17	17
14	金門縣金寧鄉	2018-11-24T23:43:18+08:00	3026	6725	9751	438	10189	28162	36.18%	10.74%	17	17
14	金門縣金寧鄉	2018-11-25T06:29:18+08:00	3026	6725	9751	438	10189	28162	36.18%	10.74%	17	17
14	金門縣金寧鄉	2018-11-25T01:07:27+08:00	3026	6725	9751	438	10189	28162	36.18%	10.74%	17	17
14	金門縣金寧鄉	2018-11-25T06:13:53+08:00	3026	6725	9751	438	10189	28162	36.18%	10.74%	17	17
14	金門縣金寧鄉	2018-11-24T23:08:37+08:00	2929	6280	9209	400	9609	26328	36.5%	11.13%	16	17
14	金門縣金寧鄉	2018-11-25T03:32:36+08:00	3026	6725	9751	438	10189	28162	36.18%	10.74%	17	17
14	金門縣金寧鄉	2018-11-24T23:55:48+08:00	3026	6725	9751	438	10189	28162	36.18%	10.74%	17	17
14	金門縣金寧鄉	2018-11-25T03:44:25+08:00	3026	6725	9751	438	10189	28162	36.18%	10.74%	17	17
14	金門縣金寧鄉	2018-11-24T22:13:28+08:00	2159	5617	7776	362	8138	22716	35.82%	9.5%	14	17
14	金門縣金寧鄉	2018-11-24T23:23:39+08:00	2929	6280	9209	400	9609	26328	36.5%	11.13%	16	17
14	金門縣金寧鄉	2018-11-25T06:18:58+08:00	3026	6725	9751	438	10189	28162	36.18%	10.74%	17	17
14	金門縣金寧鄉	2018-11-24T22:40:29+08:00	2266	6024	8290	386	8676	24407	35.55%	9.28%	15	17
14	金門縣金寧鄉	2018-11-24T23:51:36+08:00	3026	6725	9751	438	10189	28162	36.18%	10.74%	17	17
14	金門縣金寧鄉	2018-11-24T22:23:14+08:00	2159	5617	7776	362	8138	22716	35.82%	9.5%	14	17
14	金門縣金寧鄉	2018-11-24T22:54:27+08:00	2929	6280	9209	400	9609	26328	36.5%	11.13%	16	17
14	金門縣金寧鄉	2018-11-25T00:14:11+08:00	3026	6725	9751	438	10189	28162	36.18%	10.74%	17	17
14	金門縣金寧鄉	2018-11-25T00:05:06+08:00	3026	6725	9751	438	10189	28162	36.18%	10.74%	17	17
14	金門縣金寧鄉	2018-11-24T22:41:36+08:00	2266	6024	8290	386	8676	24407	35.55%	9.28%	15	17
14	金門縣金寧鄉	2018-11-24T22:16:12+08:00	2159	5617	7776	362	8138	22716	35.82%	9.5%	14	17
14	金門縣金寧鄉	2018-11-24T22:45:10+08:00	2266	6024	8290	386	8676	24407	35.55%	9.28%	15	17
14	金門縣金寧鄉	2018-11-25T03:56:14+08:00	3026	6725	9751	438	10189	28162	36.18%	10.74%	17	17
14	金門縣金寧鄉	2018-11-24T22:37:02+08:00	2266	6024	8290	386	8676	24407	35.55%	9.28%	15	17
14	金門縣金寧鄉	2018-11-25T00:18:32+08:00	3026	6725	9751	438	10189	28162	36.18%	10.74%	17	17
14	金門縣金寧鄉	2018-11-24T23:16:04+08:00	2929	6280	9209	400	9609	26328	36.5%	11.13%	16	17
14	金門縣金寧鄉	2018-11-25T00:23:05+08:00	3026	6725	9751	438	10189	28162	36.18%	10.74%	17	17
14	金門縣金寧鄉	2018-11-25T01:25:54+08:00	3026	6725	9751	438	10189	28162	36.18%	10.74%	17	17
14	金門縣金寧鄉	2018-11-25T01:02:32+08:00	3026	6725	9751	438	10189	28162	36.18%	10.74%	17	17
14	金門縣金寧鄉	2018-11-24T22:30:10+08:00	2159	5617	7776	362	8138	22716	35.82%	9.5%	14	17
14	金門縣金寧鄉	2018-11-25T06:24:01+08:00	3026	6725	9751	438	10189	28162	36.18%	10.74%	17	17
14	金門縣金寧鄉	2018-11-25T03:38:56+08:00	3026	6725	9751	438	10189	28162	36.18%	10.74%	17	17
14	金門縣金寧鄉	2018-11-24T23:27:19+08:00	2929	6280	9209	400	9609	26328	36.5%	11.13%	16	17
14	金門縣金寧鄉	2018-11-24T22:19:38+08:00	2159	5617	7776	362	8138	22716	35.82%	9.5%	14	17
14	金門縣金寧鄉	2018-11-24T23:19:53+08:00	2929	6280	9209	400	9609	26328	36.5%	11.13%	16	17
14	金門縣金寧鄉	2018-11-25T01:17:54+08:00	3026	6725	9751	438	10189	28162	36.18%	10.74%	17	17
14	金門縣金寧鄉	2018-11-25T00:00:12+08:00	3026	6725	9751	438	10189	28162	36.18%	10.74%	17	17
14	金門縣金寧鄉	2018-11-24T22:57:55+08:00	2929	6280	9209	400	9609	26328	36.5%	11.13%	16	17
14	金門縣金寧鄉	2018-11-25T00:57:38+08:00	3026	6725	9751	438	10189	28162	36.18%	10.74%	17	17
14	金門縣金寧鄉	2018-11-24T23:35:12+08:00	3026	6725	9751	438	10189	28162	36.18%	10.74%	17	17
14	金門縣金寧鄉	2018-11-24T23:47:30+08:00	3026	6725	9751	438	10189	28162	36.18%	10.74%	17	17
14	金門縣金寧鄉	2018-11-25T00:09:36+08:00	3026	6725	9751	438	10189	28162	36.18%	10.74%	17	17
14	金門縣金寧鄉	2018-11-25T06:08:54+08:00	3026	6725	9751	438	10189	28162	36.18%	10.74%	17	17
14	金門縣金寧鄉	2018-11-24T23:39:17+08:00	3026	6725	9751	438	10189	28162	36.18%	10.74%	17	17
14	金門縣金寧鄉	2018-11-24T22:50:49+08:00	2929	6280	9209	400	9609	26328	36.5%	11.13%	16	17
14	金門縣金寧鄉	2018-11-24T23:31:13+08:00	3026	6725	9751	438	10189	28162	36.18%	10.74%	17	17
14	金門縣金寧鄉	2018-11-25T04:02:53+08:00	3026	6725	9751	438	10189	28162	36.18%	10.74%	17	17
14	金門縣金寧鄉	2018-11-24T23:05:05+08:00	2929	6280	9209	400	9609	26328	36.5%	11.13%	16	17
14	金門縣金寧鄉	2018-11-24T23:01:32+08:00	2929	6280	9209	400	9609	26328	36.5%	11.13%	16	17
14	金門縣金寧鄉	2018-11-25T01:12:45+08:00	3026	6725	9751	438	10189	28162	36.18%	10.74%	17	17
14	金門縣金寧鄉	2018-11-24T22:26:38+08:00	2159	5617	7776	362	8138	22716	35.82%	9.5%	14	17
14	金門縣金寧鄉	2018-11-24T23:12:17+08:00	2929	6280	9209	400	9609	26328	36.5%	11.13%	16	17
14	嘉義縣中埔鄉	2018-11-25T03:56:10+08:00	5013	11948	16961	1386	18347	39139	46.88%	12.81%	34	34
14	嘉義縣中埔鄉	2018-11-24T23:47:26+08:00	4260	10239	14499	1236	15735	33980	46.31%	12.54%	30	34
14	嘉義縣中埔鄉	2018-11-24T23:16:01+08:00	3872	9353	13225	1126	14351	30701	46.74%	12.61%	28	34
14	嘉義縣中埔鄉	2018-11-24T22:16:08+08:00	1761	4102	5863	523	6386	13335	47.89%	13.21%	16	34
14	嘉義縣中埔鄉	2018-11-24T22:33:36+08:00	2400	5696	8096	742	8838	18732	47.18%	12.81%	21	34
14	嘉義縣中埔鄉	2018-11-25T03:38:53+08:00	5013	11948	16961	1386	18347	39139	46.88%	12.81%	34	34
14	嘉義縣中埔鄉	2018-11-24T23:23:36+08:00	3872	9353	13225	1126	14351	30701	46.74%	12.61%	28	34
14	嘉義縣中埔鄉	2018-11-25T01:25:51+08:00	5013	11948	16961	1386	18347	39139	46.88%	12.81%	34	34
14	嘉義縣中埔鄉	2018-11-24T22:19:35+08:00	1827	4232	6059	533	6592	14005	47.07%	13.05%	17	34
14	嘉義縣中埔鄉	2018-11-25T01:17:50+08:00	5013	11948	16961	1386	18347	39139	46.88%	12.81%	34	34
14	嘉義縣中埔鄉	2018-11-24T22:40:26+08:00	2580	6132	8712	797	9509	20173	47.14%	12.79%	22	34
14	嘉義縣中埔鄉	2018-11-25T00:57:35+08:00	5013	11948	16961	1386	18347	39139	46.88%	12.81%	34	34
14	嘉義縣中埔鄉	2018-11-24T22:36:58+08:00	2580	6132	8712	797	9509	20173	47.14%	12.79%	22	34
14	嘉義縣中埔鄉	2018-11-24T22:57:51+08:00	3200	7750	10950	931	11881	25452	46.68%	12.57%	25	34
14	嘉義縣中埔鄉	2018-11-25T00:09:32+08:00	5013	11948	16961	1386	18347	39139	46.88%	12.81%	34	34
14	嘉義縣中埔鄉	2018-11-25T06:08:50+08:00	5013	11948	16961	1386	18347	39139	46.88%	12.81%	34	34
14	嘉義縣中埔鄉	2018-11-25T06:23:58+08:00	5013	11948	16961	1386	18347	39139	46.88%	12.81%	34	34
14	嘉義縣中埔鄉	2018-11-24T23:39:13+08:00	4260	10239	14499	1236	15735	33980	46.31%	12.54%	30	34
14	嘉義縣中埔鄉	2018-11-25T03:49:49+08:00	5013	11948	16961	1386	18347	39139	46.88%	12.81%	34	34
14	嘉義縣中埔鄉	2018-11-25T01:12:41+08:00	5013	11948	16961	1386	18347	39139	46.88%	12.81%	34	34
14	嘉義縣中埔鄉	2018-11-24T22:26:35+08:00	2089	4935	7024	635	7659	16154	47.41%	12.93%	19	34
14	嘉義縣中埔鄉	2018-11-24T23:12:14+08:00	3636	8734	12370	1071	13441	28839	46.61%	12.61%	27	34
14	嘉義縣中埔鄉	2018-11-24T22:45:07+08:00	2580	6132	8712	797	9509	20173	47.14%	12.79%	22	34
14	嘉義縣中埔鄉	2018-11-25T04:02:50+08:00	5013	11948	16961	1386	18347	39139	46.88%	12.81%	34	34
14	嘉義縣中埔鄉	2018-11-24T23:43:15+08:00	4260	10239	14499	1236	15735	33980	46.31%	12.54%	30	34
14	嘉義縣中埔鄉	2018-11-25T00:14:07+08:00	5013	11948	16961	1386	18347	39139	46.88%	12.81%	34	34
14	嘉義縣中埔鄉	2018-11-24T23:01:29+08:00	3200	7750	10950	931	11881	25452	46.68%	12.57%	25	34
14	嘉義縣中埔鄉	2018-11-25T01:07:24+08:00	5013	11948	16961	1386	18347	39139	46.88%	12.81%	34	34
14	嘉義縣中埔鄉	2018-11-24T23:31:09+08:00	4032	9731	13763	1144	14907	32171	46.34%	12.53%	29	34
14	嘉義縣中埔鄉	2018-11-25T06:13:50+08:00	5013	11948	16961	1386	18347	39139	46.88%	12.81%	34	34
14	嘉義縣中埔鄉	2018-11-24T23:35:08+08:00	4032	9731	13763	1144	14907	32171	46.34%	12.53%	29	34
14	嘉義縣中埔鄉	2018-11-25T06:29:15+08:00	5013	11948	16961	1386	18347	39139	46.88%	12.81%	34	34
14	嘉義縣中埔鄉	2018-11-24T23:55:45+08:00	4260	10239	14499	1236	15735	33980	46.31%	12.54%	30	34
14	嘉義縣中埔鄉	2018-11-24T23:08:34+08:00	3452	8260	11712	1013	12725	27240	46.71%	12.67%	26	34
14	嘉義縣中埔鄉	2018-11-25T00:00:09+08:00	4471	10745	15216	1290	16506	35461	46.55%	12.61%	31	34
14	嘉義縣中埔鄉	2018-11-25T00:23:02+08:00	5013	11948	16961	1386	18347	39139	46.88%	12.81%	34	34
14	嘉義縣中埔鄉	2018-11-24T23:19:48+08:00	3872	9353	13225	1126	14351	30701	46.74%	12.61%	28	34
14	嘉義縣中埔鄉	2018-11-25T03:32:33+08:00	5013	11948	16961	1386	18347	39139	46.88%	12.81%	34	34
14	嘉義縣中埔鄉	2018-11-25T03:44:21+08:00	5013	11948	16961	1386	18347	39139	46.88%	12.81%	34	34
14	嘉義縣中埔鄉	2018-11-24T22:13:25+08:00	1536	3580	5116	481	5597	11605	48.23%	13.24%	15	34
14	嘉義縣中埔鄉	2018-11-24T22:23:11+08:00	1970	4610	6580	573	7153	15273	46.83%	12.9%	18	34
14	嘉義縣中埔鄉	2018-11-24T23:27:17+08:00	4032	9731	13763	1144	14907	32171	46.34%	12.53%	29	34
14	嘉義縣中埔鄉	2018-11-24T23:51:33+08:00	4260	10239	14499	1236	15735	33980	46.31%	12.54%	30	34
14	嘉義縣中埔鄉	2018-11-25T06:18:55+08:00	5013	11948	16961	1386	18347	39139	46.88%	12.81%	34	34
14	嘉義縣中埔鄉	2018-11-25T01:02:28+08:00	5013	11948	16961	1386	18347	39139	46.88%	12.81%	34	34
14	嘉義縣中埔鄉	2018-11-24T22:30:04+08:00	2214	5202	7416	666	8082	17033	47.45%	13%	20	34
14	嘉義縣中埔鄉	2018-11-24T23:05:03+08:00	3452	8260	11712	1013	12725	27240	46.71%	12.67%	26	34
14	嘉義縣中埔鄉	2018-11-24T22:54:24+08:00	2998	7153	10151	864	11015	23570	46.73%	12.72%	24	34
14	嘉義縣中埔鄉	2018-11-25T00:18:28+08:00	5013	11948	16961	1386	18347	39139	46.88%	12.81%	34	34
14	嘉義縣中埔鄉	2018-11-24T22:41:33+08:00	2580	6132	8712	797	9509	20173	47.14%	12.79%	22	34
14	嘉義縣中埔鄉	2018-11-25T00:05:03+08:00	4695	11245	15940	1342	17282	37042	46.66%	12.67%	32	34
14	嘉義縣中埔鄉	2018-11-24T22:50:46+08:00	2809	6700	9509	825	10334	21976	47.02%	12.78%	23	34
14	嘉義縣布袋鎮	2018-11-24T23:47:26+08:00	2878	7679	10557	1111	11668	23965	48.69%	12.01%	29	29
14	嘉義縣布袋鎮	2018-11-24T22:16:08+08:00	2349	6191	8540	835	9375	18970	49.42%	12.38%	24	29
14	嘉義縣布袋鎮	2018-11-24T23:16:00+08:00	2878	7679	10557	1111	11668	23965	48.69%	12.01%	29	29
14	嘉義縣布袋鎮	2018-11-25T01:25:50+08:00	2878	7679	10557	1111	11668	23965	48.69%	12.01%	29	29
14	嘉義縣布袋鎮	2018-11-25T03:38:53+08:00	2878	7679	10557	1111	11668	23965	48.69%	12.01%	29	29
14	嘉義縣布袋鎮	2018-11-25T00:23:01+08:00	2878	7679	10557	1111	11668	23965	48.69%	12.01%	29	29
14	嘉義縣布袋鎮	2018-11-24T23:23:36+08:00	2878	7679	10557	1111	11668	23965	48.69%	12.01%	29	29
14	嘉義縣布袋鎮	2018-11-24T22:19:35+08:00	2349	6191	8540	835	9375	18970	49.42%	12.38%	24	29
14	嘉義縣布袋鎮	2018-11-25T00:57:34+08:00	2878	7679	10557	1111	11668	23965	48.69%	12.01%	29	29
14	嘉義縣布袋鎮	2018-11-24T22:40:26+08:00	2755	7323	10078	1056	11134	22781	48.87%	12.09%	28	29
14	嘉義縣布袋鎮	2018-11-24T22:36:58+08:00	2755	7323	10078	1056	11134	22781	48.87%	12.09%	28	29
14	嘉義縣布袋鎮	2018-11-24T22:57:51+08:00	2755	7323	10078	1056	11134	22781	48.87%	12.09%	28	29
14	嘉義縣布袋鎮	2018-11-25T00:09:32+08:00	2878	7679	10557	1111	11668	23965	48.69%	12.01%	29	29
14	嘉義縣布袋鎮	2018-11-24T22:45:06+08:00	2755	7323	10078	1056	11134	22781	48.87%	12.09%	28	29
14	嘉義縣布袋鎮	2018-11-25T06:08:50+08:00	2878	7679	10557	1111	11668	23965	48.69%	12.01%	29	29
14	嘉義縣布袋鎮	2018-11-25T06:23:58+08:00	2878	7679	10557	1111	11668	23965	48.69%	12.01%	29	29
14	嘉義縣布袋鎮	2018-11-24T23:39:13+08:00	2878	7679	10557	1111	11668	23965	48.69%	12.01%	29	29
14	嘉義縣布袋鎮	2018-11-25T03:49:49+08:00	2878	7679	10557	1111	11668	23965	48.69%	12.01%	29	29
14	嘉義縣布袋鎮	2018-11-25T01:12:41+08:00	2878	7679	10557	1111	11668	23965	48.69%	12.01%	29	29
14	嘉義縣布袋鎮	2018-11-24T22:26:35+08:00	2534	6766	9300	962	10262	20744	49.47%	12.22%	26	29
14	嘉義縣布袋鎮	2018-11-24T22:50:45+08:00	2755	7323	10078	1056	11134	22781	48.87%	12.09%	28	29
14	嘉義縣布袋鎮	2018-11-24T23:12:13+08:00	2878	7679	10557	1111	11668	23965	48.69%	12.01%	29	29
14	嘉義縣布袋鎮	2018-11-25T04:02:50+08:00	2878	7679	10557	1111	11668	23965	48.69%	12.01%	29	29
14	嘉義縣布袋鎮	2018-11-24T23:43:15+08:00	2878	7679	10557	1111	11668	23965	48.69%	12.01%	29	29
14	嘉義縣布袋鎮	2018-11-25T06:29:14+08:00	2878	7679	10557	1111	11668	23965	48.69%	12.01%	29	29
14	嘉義縣布袋鎮	2018-11-25T00:14:07+08:00	2878	7679	10557	1111	11668	23965	48.69%	12.01%	29	29
14	嘉義縣布袋鎮	2018-11-24T23:01:29+08:00	2755	7323	10078	1056	11134	22781	48.87%	12.09%	28	29
14	嘉義縣布袋鎮	2018-11-25T01:07:24+08:00	2878	7679	10557	1111	11668	23965	48.69%	12.01%	29	29
14	嘉義縣布袋鎮	2018-11-24T23:31:09+08:00	2878	7679	10557	1111	11668	23965	48.69%	12.01%	29	29
14	嘉義縣布袋鎮	2018-11-25T06:13:50+08:00	2878	7679	10557	1111	11668	23965	48.69%	12.01%	29	29
14	嘉義縣布袋鎮	2018-11-24T23:35:08+08:00	2878	7679	10557	1111	11668	23965	48.69%	12.01%	29	29
14	嘉義縣布袋鎮	2018-11-24T22:33:35+08:00	2755	7323	10078	1056	11134	22781	48.87%	12.09%	28	29
14	嘉義縣布袋鎮	2018-11-24T23:08:33+08:00	2878	7679	10557	1111	11668	23965	48.69%	12.01%	29	29
14	嘉義縣布袋鎮	2018-11-25T03:32:32+08:00	2878	7679	10557	1111	11668	23965	48.69%	12.01%	29	29
14	嘉義縣布袋鎮	2018-11-24T23:19:48+08:00	2878	7679	10557	1111	11668	23965	48.69%	12.01%	29	29
14	嘉義縣布袋鎮	2018-11-25T03:44:20+08:00	2878	7679	10557	1111	11668	23965	48.69%	12.01%	29	29
14	嘉義縣布袋鎮	2018-11-24T22:13:24+08:00	2253	5933	8186	807	8993	18239	49.31%	12.35%	23	29
14	嘉義縣布袋鎮	2018-11-25T00:00:08+08:00	2878	7679	10557	1111	11668	23965	48.69%	12.01%	29	29
14	嘉義縣布袋鎮	2018-11-24T23:55:44+08:00	2878	7679	10557	1111	11668	23965	48.69%	12.01%	29	29
14	嘉義縣布袋鎮	2018-11-25T01:17:49+08:00	2878	7679	10557	1111	11668	23965	48.69%	12.01%	29	29
14	嘉義縣布袋鎮	2018-11-25T06:18:55+08:00	2878	7679	10557	1111	11668	23965	48.69%	12.01%	29	29
14	嘉義縣布袋鎮	2018-11-25T01:02:28+08:00	2878	7679	10557	1111	11668	23965	48.69%	12.01%	29	29
14	嘉義縣布袋鎮	2018-11-24T23:27:16+08:00	2878	7679	10557	1111	11668	23965	48.69%	12.01%	29	29
14	嘉義縣布袋鎮	2018-11-24T22:30:04+08:00	2534	6766	9300	962	10262	20744	49.47%	12.22%	26	29
14	嘉義縣布袋鎮	2018-11-24T22:23:10+08:00	2426	6401	8827	911	9738	19631	49.61%	12.36%	25	29
14	嘉義縣布袋鎮	2018-11-24T23:51:32+08:00	2878	7679	10557	1111	11668	23965	48.69%	12.01%	29	29
14	嘉義縣布袋鎮	2018-11-25T00:05:02+08:00	2878	7679	10557	1111	11668	23965	48.69%	12.01%	29	29
14	嘉義縣布袋鎮	2018-11-24T22:54:23+08:00	2755	7323	10078	1056	11134	22781	48.87%	12.09%	28	29
14	嘉義縣布袋鎮	2018-11-24T22:41:33+08:00	2755	7323	10078	1056	11134	22781	48.87%	12.09%	28	29
14	嘉義縣布袋鎮	2018-11-24T23:05:02+08:00	2878	7679	10557	1111	11668	23965	48.69%	12.01%	29	29
14	嘉義縣布袋鎮	2018-11-25T03:56:09+08:00	2878	7679	10557	1111	11668	23965	48.69%	12.01%	29	29
14	嘉義縣布袋鎮	2018-11-25T00:18:27+08:00	2878	7679	10557	1111	11668	23965	48.69%	12.01%	29	29
14	高雄市茂林區	2018-11-25T04:02:43+08:00	233	837	1070	43	1113	1615	68.92%	14.43%	3	3
14	高雄市茂林區	2018-11-25T01:12:37+08:00	233	837	1070	43	1113	1615	68.92%	14.43%	3	3
14	高雄市茂林區	2018-11-25T00:14:04+08:00	233	837	1070	43	1113	1615	68.92%	14.43%	3	3
14	高雄市茂林區	2018-11-24T23:31:05+08:00	154	573	727	30	757	1108	68.32%	13.9%	2	3
14	高雄市茂林區	2018-11-25T01:07:21+08:00	233	837	1070	43	1113	1615	68.92%	14.43%	3	3
14	高雄市茂林區	2018-11-24T23:35:05+08:00	154	573	727	30	757	1108	68.32%	13.9%	2	3
14	高雄市茂林區	2018-11-25T06:29:11+08:00	233	837	1070	43	1113	1615	68.92%	14.43%	3	3
14	高雄市茂林區	2018-11-24T23:39:09+08:00	154	573	727	30	757	1108	68.32%	13.9%	2	3
14	高雄市茂林區	2018-11-25T00:09:28+08:00	233	837	1070	43	1113	1615	68.92%	14.43%	3	3
14	高雄市茂林區	2018-11-25T01:17:45+08:00	233	837	1070	43	1113	1615	68.92%	14.43%	3	3
14	高雄市茂林區	2018-11-24T22:23:07+08:00	154	573	727	30	757	1108	68.32%	13.9%	2	3
14	高雄市茂林區	2018-11-24T23:55:41+08:00	233	837	1070	43	1113	1615	68.92%	14.43%	3	3
14	高雄市茂林區	2018-11-24T23:08:30+08:00	154	573	727	30	757	1108	68.32%	13.9%	2	3
14	高雄市茂林區	2018-11-24T23:04:59+08:00	154	573	727	30	757	1108	68.32%	13.9%	2	3
14	高雄市茂林區	2018-11-24T23:19:44+08:00	154	573	727	30	757	1108	68.32%	13.9%	2	3
14	高雄市茂林區	2018-11-24T22:13:21+08:00	66	189	255	15	270	382	70.68%	17.28%	1	3
14	高雄市茂林區	2018-11-25T00:00:02+08:00	233	837	1070	43	1113	1615	68.92%	14.43%	3	3
14	高雄市茂林區	2018-11-24T23:27:13+08:00	154	573	727	30	757	1108	68.32%	13.9%	2	3
14	高雄市茂林區	2018-11-24T22:19:32+08:00	66	189	255	15	270	382	70.68%	17.28%	1	3
14	高雄市茂林區	2018-11-24T22:30:00+08:00	154	573	727	30	757	1108	68.32%	13.9%	2	3
14	高雄市茂林區	2018-11-25T01:02:25+08:00	233	837	1070	43	1113	1615	68.92%	14.43%	3	3
14	高雄市茂林區	2018-11-25T06:13:47+08:00	233	837	1070	43	1113	1615	68.92%	14.43%	3	3
14	高雄市茂林區	2018-11-25T00:22:58+08:00	233	837	1070	43	1113	1615	68.92%	14.43%	3	3
14	高雄市茂林區	2018-11-24T22:26:32+08:00	154	573	727	30	757	1108	68.32%	13.9%	2	3
14	高雄市茂林區	2018-11-25T00:18:24+08:00	233	837	1070	43	1113	1615	68.92%	14.43%	3	3
14	高雄市茂林區	2018-11-24T22:50:42+08:00	154	573	727	30	757	1108	68.32%	13.9%	2	3
14	高雄市茂林區	2018-11-24T22:54:21+08:00	154	573	727	30	757	1108	68.32%	13.9%	2	3
14	高雄市茂林區	2018-11-25T00:05:00+08:00	233	837	1070	43	1113	1615	68.92%	14.43%	3	3
14	高雄市茂林區	2018-11-24T22:41:30+08:00	154	573	727	30	757	1108	68.32%	13.9%	2	3
14	高雄市茂林區	2018-11-25T03:49:46+08:00	233	837	1070	43	1113	1615	68.92%	14.43%	3	3
14	高雄市茂林區	2018-11-24T23:01:26+08:00	154	573	727	30	757	1108	68.32%	13.9%	2	3
14	高雄市茂林區	2018-11-25T06:08:46+08:00	233	837	1070	43	1113	1615	68.92%	14.43%	3	3
14	高雄市茂林區	2018-11-24T23:43:12+08:00	154	573	727	30	757	1108	68.32%	13.9%	2	3
14	高雄市茂林區	2018-11-24T22:16:04+08:00	66	189	255	15	270	382	70.68%	17.28%	1	3
14	高雄市茂林區	2018-11-24T22:33:32+08:00	154	573	727	30	757	1108	68.32%	13.9%	2	3
14	高雄市茂林區	2018-11-24T23:47:23+08:00	154	573	727	30	757	1108	68.32%	13.9%	2	3
14	高雄市茂林區	2018-11-25T03:44:16+08:00	233	837	1070	43	1113	1615	68.92%	14.43%	3	3
14	高雄市茂林區	2018-11-25T03:38:50+08:00	233	837	1070	43	1113	1615	68.92%	14.43%	3	3
14	高雄市茂林區	2018-11-24T23:23:33+08:00	154	573	727	30	757	1108	68.32%	13.9%	2	3
14	高雄市茂林區	2018-11-24T23:51:29+08:00	233	837	1070	43	1113	1615	68.92%	14.43%	3	3
14	高雄市茂林區	2018-11-24T22:57:47+08:00	154	573	727	30	757	1108	68.32%	13.9%	2	3
14	高雄市茂林區	2018-11-24T22:40:23+08:00	154	573	727	30	757	1108	68.32%	13.9%	2	3
14	高雄市茂林區	2018-11-25T03:32:29+08:00	233	837	1070	43	1113	1615	68.92%	14.43%	3	3
14	高雄市茂林區	2018-11-25T06:18:52+08:00	233	837	1070	43	1113	1615	68.92%	14.43%	3	3
14	高雄市茂林區	2018-11-24T23:15:58+08:00	154	573	727	30	757	1108	68.32%	13.9%	2	3
14	高雄市茂林區	2018-11-25T00:57:31+08:00	233	837	1070	43	1113	1615	68.92%	14.43%	3	3
14	高雄市茂林區	2018-11-25T01:25:47+08:00	233	837	1070	43	1113	1615	68.92%	14.43%	3	3
14	高雄市茂林區	2018-11-24T22:36:55+08:00	154	573	727	30	757	1108	68.32%	13.9%	2	3
14	高雄市茂林區	2018-11-25T03:56:06+08:00	233	837	1070	43	1113	1615	68.92%	14.43%	3	3
14	高雄市茂林區	2018-11-25T06:23:55+08:00	233	837	1070	43	1113	1615	68.92%	14.43%	3	3
14	高雄市茂林區	2018-11-24T23:12:10+08:00	154	573	727	30	757	1108	68.32%	13.9%	2	3
14	高雄市茂林區	2018-11-24T22:45:03+08:00	154	573	727	30	757	1108	68.32%	13.9%	2	3
14	高雄市茄萣區	2018-11-25T04:02:43+08:00	4092	9081	13173	1016	14189	26212	54.13%	15.61%	21	21
14	高雄市茄萣區	2018-11-25T01:12:37+08:00	4092	9081	13173	1016	14189	26212	54.13%	15.61%	21	21
14	高雄市茄萣區	2018-11-25T00:14:03+08:00	4092	9081	13173	1016	14189	26212	54.13%	15.61%	21	21
14	高雄市茄萣區	2018-11-24T23:01:25+08:00	4092	9081	13173	1016	14189	26212	54.13%	15.61%	21	21
14	高雄市茄萣區	2018-11-25T00:09:27+08:00	4092	9081	13173	1016	14189	26212	54.13%	15.61%	21	21
14	高雄市茄萣區	2018-11-24T23:35:05+08:00	4092	9081	13173	1016	14189	26212	54.13%	15.61%	21	21
14	高雄市茄萣區	2018-11-25T06:29:11+08:00	4092	9081	13173	1016	14189	26212	54.13%	15.61%	21	21
14	高雄市茄萣區	2018-11-24T23:39:09+08:00	4092	9081	13173	1016	14189	26212	54.13%	15.61%	21	21
14	高雄市茄萣區	2018-11-25T01:07:20+08:00	4092	9081	13173	1016	14189	26212	54.13%	15.61%	21	21
14	高雄市茄萣區	2018-11-24T23:31:04+08:00	4092	9081	13173	1016	14189	26212	54.13%	15.61%	21	21
14	高雄市茄萣區	2018-11-25T01:17:45+08:00	4092	9081	13173	1016	14189	26212	54.13%	15.61%	21	21
14	高雄市茄萣區	2018-11-24T22:13:20+08:00	3817	8451	12268	933	13201	24427	54.04%	15.63%	20	21
14	高雄市茄萣區	2018-11-24T23:55:41+08:00	4092	9081	13173	1016	14189	26212	54.13%	15.61%	21	21
14	高雄市茄萣區	2018-11-24T23:19:44+08:00	4092	9081	13173	1016	14189	26212	54.13%	15.61%	21	21
14	高雄市茄萣區	2018-11-24T22:23:06+08:00	4092	9081	13173	1016	14189	26212	54.13%	15.61%	21	21
14	高雄市茄萣區	2018-11-24T23:04:58+08:00	4092	9081	13173	1016	14189	26212	54.13%	15.61%	21	21
14	高雄市茄萣區	2018-11-25T00:00:02+08:00	4092	9081	13173	1016	14189	26212	54.13%	15.61%	21	21
14	高雄市茄萣區	2018-11-25T00:04:59+08:00	4092	9081	13173	1016	14189	26212	54.13%	15.61%	21	21
14	高雄市茄萣區	2018-11-24T23:27:13+08:00	4092	9081	13173	1016	14189	26212	54.13%	15.61%	21	21
14	高雄市茄萣區	2018-11-24T22:30:00+08:00	4092	9081	13173	1016	14189	26212	54.13%	15.61%	21	21
14	高雄市茄萣區	2018-11-25T01:02:25+08:00	4092	9081	13173	1016	14189	26212	54.13%	15.61%	21	21
14	高雄市茄萣區	2018-11-25T06:13:47+08:00	4092	9081	13173	1016	14189	26212	54.13%	15.61%	21	21
14	高雄市茄萣區	2018-11-24T22:54:20+08:00	4092	9081	13173	1016	14189	26212	54.13%	15.61%	21	21
14	高雄市茄萣區	2018-11-25T00:22:58+08:00	4092	9081	13173	1016	14189	26212	54.13%	15.61%	21	21
14	高雄市茄萣區	2018-11-25T03:56:05+08:00	4092	9081	13173	1016	14189	26212	54.13%	15.61%	21	21
14	高雄市茄萣區	2018-11-24T22:26:32+08:00	4092	9081	13173	1016	14189	26212	54.13%	15.61%	21	21
14	高雄市茄萣區	2018-11-25T00:18:24+08:00	4092	9081	13173	1016	14189	26212	54.13%	15.61%	21	21
14	高雄市茄萣區	2018-11-24T22:41:30+08:00	4092	9081	13173	1016	14189	26212	54.13%	15.61%	21	21
14	高雄市茄萣區	2018-11-25T03:49:46+08:00	4092	9081	13173	1016	14189	26212	54.13%	15.61%	21	21
14	高雄市茄萣區	2018-11-25T06:08:46+08:00	4092	9081	13173	1016	14189	26212	54.13%	15.61%	21	21
14	高雄市茄萣區	2018-11-24T23:43:12+08:00	4092	9081	13173	1016	14189	26212	54.13%	15.61%	21	21
14	高雄市茄萣區	2018-11-24T23:47:22+08:00	4092	9081	13173	1016	14189	26212	54.13%	15.61%	21	21
14	高雄市茄萣區	2018-11-24T22:16:04+08:00	3817	8451	12268	933	13201	24427	54.04%	15.63%	20	21
14	高雄市茄萣區	2018-11-24T22:33:32+08:00	4092	9081	13173	1016	14189	26212	54.13%	15.61%	21	21
14	高雄市茄萣區	2018-11-25T03:44:16+08:00	4092	9081	13173	1016	14189	26212	54.13%	15.61%	21	21
14	高雄市茄萣區	2018-11-25T03:38:50+08:00	4092	9081	13173	1016	14189	26212	54.13%	15.61%	21	21
14	高雄市茄萣區	2018-11-24T23:23:33+08:00	4092	9081	13173	1016	14189	26212	54.13%	15.61%	21	21
14	高雄市茄萣區	2018-11-24T23:51:29+08:00	4092	9081	13173	1016	14189	26212	54.13%	15.61%	21	21
14	高雄市茄萣區	2018-11-24T22:57:47+08:00	4092	9081	13173	1016	14189	26212	54.13%	15.61%	21	21
14	高雄市茄萣區	2018-11-24T22:19:31+08:00	4092	9081	13173	1016	14189	26212	54.13%	15.61%	21	21
14	高雄市茄萣區	2018-11-24T22:40:23+08:00	4092	9081	13173	1016	14189	26212	54.13%	15.61%	21	21
14	高雄市茄萣區	2018-11-25T03:32:29+08:00	4092	9081	13173	1016	14189	26212	54.13%	15.61%	21	21
14	高雄市茄萣區	2018-11-25T06:18:52+08:00	4092	9081	13173	1016	14189	26212	54.13%	15.61%	21	21
14	高雄市茄萣區	2018-11-25T00:57:31+08:00	4092	9081	13173	1016	14189	26212	54.13%	15.61%	21	21
14	高雄市茄萣區	2018-11-25T01:25:47+08:00	4092	9081	13173	1016	14189	26212	54.13%	15.61%	21	21
14	高雄市茄萣區	2018-11-24T22:36:55+08:00	4092	9081	13173	1016	14189	26212	54.13%	15.61%	21	21
14	高雄市茄萣區	2018-11-24T23:08:29+08:00	4092	9081	13173	1016	14189	26212	54.13%	15.61%	21	21
14	高雄市茄萣區	2018-11-24T23:15:57+08:00	4092	9081	13173	1016	14189	26212	54.13%	15.61%	21	21
14	高雄市茄萣區	2018-11-25T06:23:55+08:00	4092	9081	13173	1016	14189	26212	54.13%	15.61%	21	21
14	高雄市茄萣區	2018-11-24T23:12:10+08:00	4092	9081	13173	1016	14189	26212	54.13%	15.61%	21	21
14	高雄市茄萣區	2018-11-24T22:50:41+08:00	4092	9081	13173	1016	14189	26212	54.13%	15.61%	21	21
14	高雄市茄萣區	2018-11-24T22:45:03+08:00	4092	9081	13173	1016	14189	26212	54.13%	15.61%	21	21
14	花蓮縣鳳林鎮	2018-11-25T06:29:17+08:00	1242	3638	4880	468	5348	9676	55.27%	12.84%	15	15
14	花蓮縣鳳林鎮	2018-11-24T23:47:28+08:00	1086	3112	4198	417	4615	8484	54.4%	12.8%	14	15
14	花蓮縣鳳林鎮	2018-11-24T22:37:00+08:00	796	2270	3066	300	3366	6157	54.67%	12.93%	11	15
14	花蓮縣鳳林鎮	2018-11-25T00:18:30+08:00	1242	3638	4880	468	5348	9676	55.27%	12.84%	15	15
14	花蓮縣鳳林鎮	2018-11-25T01:07:26+08:00	1242	3638	4880	468	5348	9676	55.27%	12.84%	15	15
14	花蓮縣鳳林鎮	2018-11-25T06:13:52+08:00	1242	3638	4880	468	5348	9676	55.27%	12.84%	15	15
14	花蓮縣鳳林鎮	2018-11-24T22:33:38+08:00	796	2270	3066	300	3366	6157	54.67%	12.93%	11	15
14	花蓮縣鳳林鎮	2018-11-24T23:43:17+08:00	1086	3112	4198	417	4615	8484	54.4%	12.8%	14	15
14	花蓮縣鳳林鎮	2018-11-25T03:44:23+08:00	1242	3638	4880	468	5348	9676	55.27%	12.84%	15	15
14	花蓮縣鳳林鎮	2018-11-24T22:13:27+08:00	796	2270	3066	300	3366	6157	54.67%	12.93%	11	15
14	花蓮縣鳳林鎮	2018-11-25T01:02:31+08:00	1242	3638	4880	468	5348	9676	55.27%	12.84%	15	15
14	花蓮縣鳳林鎮	2018-11-24T23:23:38+08:00	985	2836	3821	376	4197	7742	54.21%	12.72%	13	15
14	花蓮縣鳳林鎮	2018-11-25T03:38:55+08:00	1242	3638	4880	468	5348	9676	55.27%	12.84%	15	15
14	花蓮縣鳳林鎮	2018-11-24T23:55:47+08:00	1086	3112	4198	417	4615	8484	54.4%	12.8%	14	15
14	花蓮縣鳳林鎮	2018-11-24T23:08:36+08:00	985	2836	3821	376	4197	7742	54.21%	12.72%	13	15
14	花蓮縣鳳林鎮	2018-11-25T00:00:11+08:00	1086	3112	4198	417	4615	8484	54.4%	12.8%	14	15
14	花蓮縣鳳林鎮	2018-11-24T22:40:27+08:00	892	2540	3432	335	3767	6758	55.74%	13.2%	12	15
14	花蓮縣鳳林鎮	2018-11-25T06:18:57+08:00	1242	3638	4880	468	5348	9676	55.27%	12.84%	15	15
14	花蓮縣鳳林鎮	2018-11-24T22:30:09+08:00	796	2270	3066	300	3366	6157	54.67%	12.93%	11	15
14	花蓮縣鳳林鎮	2018-11-24T22:23:13+08:00	796	2270	3066	300	3366	6157	54.67%	12.93%	11	15
14	花蓮縣鳳林鎮	2018-11-24T23:19:51+08:00	985	2836	3821	376	4197	7742	54.21%	12.72%	13	15
14	花蓮縣鳳林鎮	2018-11-24T23:12:15+08:00	985	2836	3821	376	4197	7742	54.21%	12.72%	13	15
14	花蓮縣鳳林鎮	2018-11-24T22:45:08+08:00	892	2540	3432	335	3767	6758	55.74%	13.2%	12	15
14	花蓮縣鳳林鎮	2018-11-24T23:35:11+08:00	1086	3112	4198	417	4615	8484	54.4%	12.8%	14	15
14	花蓮縣鳳林鎮	2018-11-24T23:01:31+08:00	985	2836	3821	376	4197	7742	54.21%	12.72%	13	15
14	花蓮縣鳳林鎮	2018-11-24T23:31:11+08:00	1086	3112	4198	417	4615	8484	54.4%	12.8%	14	15
14	花蓮縣鳳林鎮	2018-11-25T00:09:34+08:00	1086	3112	4198	417	4615	8484	54.4%	12.8%	14	15
14	花蓮縣鳳林鎮	2018-11-25T00:14:09+08:00	1086	3112	4198	417	4615	8484	54.4%	12.8%	14	15
14	花蓮縣鳳林鎮	2018-11-25T03:49:51+08:00	1242	3638	4880	468	5348	9676	55.27%	12.84%	15	15
14	花蓮縣鳳林鎮	2018-11-24T23:16:03+08:00	985	2836	3821	376	4197	7742	54.21%	12.72%	13	15
14	花蓮縣鳳林鎮	2018-11-25T03:56:12+08:00	1242	3638	4880	468	5348	9676	55.27%	12.84%	15	15
14	花蓮縣鳳林鎮	2018-11-25T06:24:00+08:00	1242	3638	4880	468	5348	9676	55.27%	12.84%	15	15
14	花蓮縣鳳林鎮	2018-11-25T00:23:03+08:00	1242	3638	4880	468	5348	9676	55.27%	12.84%	15	15
14	花蓮縣鳳林鎮	2018-11-25T03:32:34+08:00	1242	3638	4880	468	5348	9676	55.27%	12.84%	15	15
14	花蓮縣鳳林鎮	2018-11-25T01:25:52+08:00	1242	3638	4880	468	5348	9676	55.27%	12.84%	15	15
14	花蓮縣鳳林鎮	2018-11-25T00:57:37+08:00	1242	3638	4880	468	5348	9676	55.27%	12.84%	15	15
14	花蓮縣鳳林鎮	2018-11-24T22:57:53+08:00	985	2836	3821	376	4197	7742	54.21%	12.72%	13	15
14	花蓮縣鳳林鎮	2018-11-24T22:19:37+08:00	796	2270	3066	300	3366	6157	54.67%	12.93%	11	15
14	花蓮縣鳳林鎮	2018-11-25T01:17:52+08:00	1242	3638	4880	468	5348	9676	55.27%	12.84%	15	15
14	花蓮縣鳳林鎮	2018-11-24T23:27:18+08:00	985	2836	3821	376	4197	7742	54.21%	12.72%	13	15
14	花蓮縣鳳林鎮	2018-11-24T23:51:35+08:00	1086	3112	4198	417	4615	8484	54.4%	12.8%	14	15
14	花蓮縣鳳林鎮	2018-11-24T23:05:04+08:00	985	2836	3821	376	4197	7742	54.21%	12.72%	13	15
14	花蓮縣鳳林鎮	2018-11-24T22:41:35+08:00	892	2540	3432	335	3767	6758	55.74%	13.2%	12	15
14	花蓮縣鳳林鎮	2018-11-25T00:05:05+08:00	1086	3112	4198	417	4615	8484	54.4%	12.8%	14	15
14	花蓮縣鳳林鎮	2018-11-25T04:02:52+08:00	1242	3638	4880	468	5348	9676	55.27%	12.84%	15	15
14	花蓮縣鳳林鎮	2018-11-25T06:08:53+08:00	1242	3638	4880	468	5348	9676	55.27%	12.84%	15	15
14	花蓮縣鳳林鎮	2018-11-24T22:16:10+08:00	796	2270	3066	300	3366	6157	54.67%	12.93%	11	15
14	花蓮縣鳳林鎮	2018-11-25T01:12:43+08:00	1242	3638	4880	468	5348	9676	55.27%	12.84%	15	15
14	花蓮縣鳳林鎮	2018-11-24T22:26:37+08:00	796	2270	3066	300	3366	6157	54.67%	12.93%	11	15
14	花蓮縣鳳林鎮	2018-11-24T22:50:48+08:00	985	2836	3821	376	4197	7742	54.21%	12.72%	13	15
14	花蓮縣鳳林鎮	2018-11-24T23:39:16+08:00	1086	3112	4198	417	4615	8484	54.4%	12.8%	14	15
14	花蓮縣鳳林鎮	2018-11-24T22:54:25+08:00	985	2836	3821	376	4197	7742	54.21%	12.72%	13	15
14	花蓮縣萬榮鄉	2018-11-25T06:29:17+08:00	667	2014	2681	262	2943	5269	55.86%	12.66%	7	7
14	花蓮縣萬榮鄉	2018-11-25T00:18:30+08:00	495	1533	2028	175	2203	4183	52.67%	11.83%	6	7
14	花蓮縣萬榮鄉	2018-11-25T01:07:26+08:00	495	1533	2028	175	2203	4183	52.67%	11.83%	6	7
14	花蓮縣萬榮鄉	2018-11-24T23:47:29+08:00	495	1533	2028	175	2203	4183	52.67%	11.83%	6	7
14	花蓮縣萬榮鄉	2018-11-24T22:33:38+08:00	340	1154	1494	108	1602	3111	51.49%	10.93%	5	7
14	花蓮縣萬榮鄉	2018-11-25T06:13:53+08:00	667	2014	2681	262	2943	5269	55.86%	12.66%	7	7
14	花蓮縣萬榮鄉	2018-11-24T23:43:17+08:00	495	1533	2028	175	2203	4183	52.67%	11.83%	6	7
14	花蓮縣萬榮鄉	2018-11-24T22:37:01+08:00	340	1154	1494	108	1602	3111	51.49%	10.93%	5	7
14	花蓮縣萬榮鄉	2018-11-25T03:44:23+08:00	667	2014	2681	262	2943	5269	55.86%	12.66%	7	7
14	花蓮縣萬榮鄉	2018-11-24T22:13:27+08:00	163	623	786	65	851	1677	50.75%	9.72%	3	7
14	花蓮縣萬榮鄉	2018-11-25T01:02:31+08:00	495	1533	2028	175	2203	4183	52.67%	11.83%	6	7
14	花蓮縣萬榮鄉	2018-11-25T03:38:55+08:00	667	2014	2681	262	2943	5269	55.86%	12.66%	7	7
14	花蓮縣萬榮鄉	2018-11-24T23:55:47+08:00	495	1533	2028	175	2203	4183	52.67%	11.83%	6	7
14	花蓮縣萬榮鄉	2018-11-24T23:08:36+08:00	340	1154	1494	108	1602	3111	51.49%	10.93%	5	7
14	花蓮縣萬榮鄉	2018-11-24T23:23:39+08:00	495	1533	2028	175	2203	4183	52.67%	11.83%	6	7
14	花蓮縣萬榮鄉	2018-11-25T00:00:11+08:00	495	1533	2028	175	2203	4183	52.67%	11.83%	6	7
14	花蓮縣萬榮鄉	2018-11-24T23:51:36+08:00	495	1533	2028	175	2203	4183	52.67%	11.83%	6	7
14	花蓮縣萬榮鄉	2018-11-25T06:18:57+08:00	667	2014	2681	262	2943	5269	55.86%	12.66%	7	7
14	花蓮縣萬榮鄉	2018-11-24T22:30:09+08:00	340	1154	1494	108	1602	3111	51.49%	10.93%	5	7
14	花蓮縣萬榮鄉	2018-11-24T22:40:28+08:00	340	1154	1494	108	1602	3111	51.49%	10.93%	5	7
14	花蓮縣萬榮鄉	2018-11-24T22:23:13+08:00	233	815	1048	80	1128	2338	48.25%	9.97%	4	7
14	花蓮縣萬榮鄉	2018-11-24T23:35:11+08:00	495	1533	2028	175	2203	4183	52.67%	11.83%	6	7
14	花蓮縣萬榮鄉	2018-11-24T23:01:31+08:00	340	1154	1494	108	1602	3111	51.49%	10.93%	5	7
14	花蓮縣萬榮鄉	2018-11-24T22:45:09+08:00	340	1154	1494	108	1602	3111	51.49%	10.93%	5	7
14	花蓮縣萬榮鄉	2018-11-24T23:31:11+08:00	495	1533	2028	175	2203	4183	52.67%	11.83%	6	7
14	花蓮縣萬榮鄉	2018-11-25T00:09:34+08:00	495	1533	2028	175	2203	4183	52.67%	11.83%	6	7
14	花蓮縣萬榮鄉	2018-11-24T22:54:26+08:00	340	1154	1494	108	1602	3111	51.49%	10.93%	5	7
14	花蓮縣萬榮鄉	2018-11-25T00:14:10+08:00	495	1533	2028	175	2203	4183	52.67%	11.83%	6	7
14	花蓮縣萬榮鄉	2018-11-25T03:56:13+08:00	667	2014	2681	262	2943	5269	55.86%	12.66%	7	7
14	花蓮縣萬榮鄉	2018-11-25T03:49:51+08:00	667	2014	2681	262	2943	5269	55.86%	12.66%	7	7
14	花蓮縣萬榮鄉	2018-11-24T23:16:03+08:00	495	1533	2028	175	2203	4183	52.67%	11.83%	6	7
14	花蓮縣萬榮鄉	2018-11-25T03:32:35+08:00	667	2014	2681	262	2943	5269	55.86%	12.66%	7	7
14	花蓮縣萬榮鄉	2018-11-25T06:24:00+08:00	667	2014	2681	262	2943	5269	55.86%	12.66%	7	7
14	花蓮縣萬榮鄉	2018-11-25T01:25:53+08:00	495	1533	2028	175	2203	4183	52.67%	11.83%	6	7
14	花蓮縣萬榮鄉	2018-11-25T00:23:04+08:00	495	1533	2028	175	2203	4183	52.67%	11.83%	6	7
14	花蓮縣萬榮鄉	2018-11-24T23:27:19+08:00	495	1533	2028	175	2203	4183	52.67%	11.83%	6	7
14	花蓮縣萬榮鄉	2018-11-25T00:57:37+08:00	495	1533	2028	175	2203	4183	52.67%	11.83%	6	7
14	花蓮縣萬榮鄉	2018-11-24T22:57:54+08:00	340	1154	1494	108	1602	3111	51.49%	10.93%	5	7
14	花蓮縣萬榮鄉	2018-11-24T22:19:37+08:00	163	623	786	65	851	1677	50.75%	9.72%	3	7
14	花蓮縣萬榮鄉	2018-11-25T01:17:52+08:00	495	1533	2028	175	2203	4183	52.67%	11.83%	6	7
14	花蓮縣萬榮鄉	2018-11-24T23:19:52+08:00	495	1533	2028	175	2203	4183	52.67%	11.83%	6	7
14	花蓮縣萬榮鄉	2018-11-24T22:41:35+08:00	340	1154	1494	108	1602	3111	51.49%	10.93%	5	7
14	花蓮縣萬榮鄉	2018-11-25T00:05:05+08:00	495	1533	2028	175	2203	4183	52.67%	11.83%	6	7
14	花蓮縣萬榮鄉	2018-11-25T04:02:52+08:00	667	2014	2681	262	2943	5269	55.86%	12.66%	7	7
14	花蓮縣萬榮鄉	2018-11-24T23:12:16+08:00	340	1154	1494	108	1602	3111	51.49%	10.93%	5	7
14	花蓮縣萬榮鄉	2018-11-25T06:08:53+08:00	667	2014	2681	262	2943	5269	55.86%	12.66%	7	7
14	花蓮縣萬榮鄉	2018-11-25T01:12:43+08:00	495	1533	2028	175	2203	4183	52.67%	11.83%	6	7
14	花蓮縣萬榮鄉	2018-11-24T22:26:37+08:00	340	1154	1494	108	1602	3111	51.49%	10.93%	5	7
14	花蓮縣萬榮鄉	2018-11-24T23:05:05+08:00	340	1154	1494	108	1602	3111	51.49%	10.93%	5	7
14	花蓮縣萬榮鄉	2018-11-24T22:50:48+08:00	340	1154	1494	108	1602	3111	51.49%	10.93%	5	7
14	花蓮縣萬榮鄉	2018-11-24T22:16:11+08:00	163	623	786	65	851	1677	50.75%	9.72%	3	7
14	花蓮縣萬榮鄉	2018-11-24T23:39:16+08:00	495	1533	2028	175	2203	4183	52.67%	11.83%	6	7
14	臺南市白河區	2018-11-24T23:35:03+08:00	3182	6671	9853	901	10754	24894	43.2%	12.78%	32	32
14	臺南市白河區	2018-11-24T22:33:30+08:00	3182	6671	9853	901	10754	24894	43.2%	12.78%	32	32
14	臺南市白河區	2018-11-24T23:31:02+08:00	3182	6671	9853	901	10754	24894	43.2%	12.78%	32	32
14	臺南市白河區	2018-11-24T23:39:06+08:00	3182	6671	9853	901	10754	24894	43.2%	12.78%	32	32
14	臺南市白河區	2018-11-24T23:12:07+08:00	3182	6671	9853	901	10754	24894	43.2%	12.78%	32	32
14	臺南市白河區	2018-11-24T23:47:20+08:00	3182	6671	9853	901	10754	24894	43.2%	12.78%	32	32
14	臺南市白河區	2018-11-25T01:07:18+08:00	3182	6671	9853	901	10754	24894	43.2%	12.78%	32	32
14	臺南市白河區	2018-11-25T06:08:43+08:00	3182	6671	9853	901	10754	24894	43.2%	12.78%	32	32
14	臺南市白河區	2018-11-24T23:01:23+08:00	3182	6671	9853	901	10754	24894	43.2%	12.78%	32	32
14	臺南市白河區	2018-11-24T22:57:45+08:00	3182	6671	9853	901	10754	24894	43.2%	12.78%	32	32
14	臺南市白河區	2018-11-25T01:17:42+08:00	3182	6671	9853	901	10754	24894	43.2%	12.78%	32	32
14	臺南市白河區	2018-11-24T22:13:18+08:00	3182	6671	9853	901	10754	24894	43.2%	12.78%	32	32
14	臺南市白河區	2018-11-24T22:19:29+08:00	3182	6671	9853	901	10754	24894	43.2%	12.78%	32	32
14	臺南市白河區	2018-11-25T00:57:28+08:00	3182	6671	9853	901	10754	24894	43.2%	12.78%	32	32
14	臺南市白河區	2018-11-24T23:23:31+08:00	3182	6671	9853	901	10754	24894	43.2%	12.78%	32	32
14	臺南市白河區	2018-11-25T03:44:13+08:00	3182	6671	9853	901	10754	24894	43.2%	12.78%	32	32
14	臺南市白河區	2018-11-25T00:04:57+08:00	3182	6671	9853	901	10754	24894	43.2%	12.78%	32	32
14	臺南市白河區	2018-11-24T23:04:56+08:00	3182	6671	9853	901	10754	24894	43.2%	12.78%	32	32
14	臺南市白河區	2018-11-24T23:15:55+08:00	3182	6671	9853	901	10754	24894	43.2%	12.78%	32	32
14	臺南市白河區	2018-11-25T03:38:48+08:00	3182	6671	9853	901	10754	24894	43.2%	12.78%	32	32
14	臺南市白河區	2018-11-25T06:18:50+08:00	3182	6671	9853	901	10754	24894	43.2%	12.78%	32	32
14	臺南市白河區	2018-11-25T01:25:44+08:00	3182	6671	9853	901	10754	24894	43.2%	12.78%	32	32
14	臺南市白河區	2018-11-24T22:40:21+08:00	3182	6671	9853	901	10754	24894	43.2%	12.78%	32	32
14	臺南市白河區	2018-11-25T01:02:22+08:00	3182	6671	9853	901	10754	24894	43.2%	12.78%	32	32
14	臺南市白河區	2018-11-24T23:55:39+08:00	3182	6671	9853	901	10754	24894	43.2%	12.78%	32	32
14	臺南市白河區	2018-11-24T22:45:01+08:00	3182	6671	9853	901	10754	24894	43.2%	12.78%	32	32
14	臺南市白河區	2018-11-25T00:18:22+08:00	3182	6671	9853	901	10754	24894	43.2%	12.78%	32	32
14	臺南市白河區	2018-11-25T00:22:56+08:00	3182	6671	9853	901	10754	24894	43.2%	12.78%	32	32
14	臺南市白河區	2018-11-24T22:54:19+08:00	3182	6671	9853	901	10754	24894	43.2%	12.78%	32	32
14	臺南市白河區	2018-11-25T03:56:03+08:00	3182	6671	9853	901	10754	24894	43.2%	12.78%	32	32
14	臺南市白河區	2018-11-24T22:16:02+08:00	3182	6671	9853	901	10754	24894	43.2%	12.78%	32	32
14	臺南市白河區	2018-11-25T01:12:34+08:00	3182	6671	9853	901	10754	24894	43.2%	12.78%	32	32
14	臺南市白河區	2018-11-24T22:50:39+08:00	3182	6671	9853	901	10754	24894	43.2%	12.78%	32	32
14	臺南市白河區	2018-11-25T00:09:25+08:00	3182	6671	9853	901	10754	24894	43.2%	12.78%	32	32
14	臺南市白河區	2018-11-25T00:14:01+08:00	3182	6671	9853	901	10754	24894	43.2%	12.78%	32	32
14	臺南市白河區	2018-11-24T22:41:28+08:00	3182	6671	9853	901	10754	24894	43.2%	12.78%	32	32
14	臺南市白河區	2018-11-25T04:02:41+08:00	3182	6671	9853	901	10754	24894	43.2%	12.78%	32	32
14	臺南市白河區	2018-11-25T00:00:00+08:00	3182	6671	9853	901	10754	24894	43.2%	12.78%	32	32
14	臺南市白河區	2018-11-24T22:23:04+08:00	3182	6671	9853	901	10754	24894	43.2%	12.78%	32	32
14	臺南市白河區	2018-11-24T23:19:41+08:00	3182	6671	9853	901	10754	24894	43.2%	12.78%	32	32
14	臺南市白河區	2018-11-24T23:51:27+08:00	3182	6671	9853	901	10754	24894	43.2%	12.78%	32	32
14	臺南市白河區	2018-11-24T22:29:58+08:00	3182	6671	9853	901	10754	24894	43.2%	12.78%	32	32
14	臺南市白河區	2018-11-24T22:36:53+08:00	3182	6671	9853	901	10754	24894	43.2%	12.78%	32	32
14	臺南市白河區	2018-11-25T03:32:27+08:00	3182	6671	9853	901	10754	24894	43.2%	12.78%	32	32
14	臺南市白河區	2018-11-24T23:27:11+08:00	3182	6671	9853	901	10754	24894	43.2%	12.78%	32	32
14	臺南市白河區	2018-11-24T23:08:27+08:00	3182	6671	9853	901	10754	24894	43.2%	12.78%	32	32
14	臺南市白河區	2018-11-25T06:29:08+08:00	3182	6671	9853	901	10754	24894	43.2%	12.78%	32	32
14	臺南市白河區	2018-11-25T03:49:44+08:00	3182	6671	9853	901	10754	24894	43.2%	12.78%	32	32
14	臺南市白河區	2018-11-24T22:26:30+08:00	3182	6671	9853	901	10754	24894	43.2%	12.78%	32	32
14	臺南市白河區	2018-11-25T06:23:52+08:00	3182	6671	9853	901	10754	24894	43.2%	12.78%	32	32
14	臺南市白河區	2018-11-24T23:43:09+08:00	3182	6671	9853	901	10754	24894	43.2%	12.78%	32	32
14	臺南市白河區	2018-11-25T06:13:45+08:00	3182	6671	9853	901	10754	24894	43.2%	12.78%	32	32
14	屏東縣霧臺鄉	2018-11-24T22:33:37+08:00	292	849	1141	73	1214	1977	61.41%	14.77%	6	8
14	屏東縣霧臺鄉	2018-11-24T22:37:00+08:00	292	849	1141	73	1214	1977	61.41%	14.77%	6	8
14	屏東縣霧臺鄉	2018-11-24T23:43:16+08:00	414	1291	1705	111	1816	2950	61.56%	14.03%	8	8
14	屏東縣霧臺鄉	2018-11-25T03:56:11+08:00	414	1291	1705	111	1816	2950	61.56%	14.03%	8	8
14	屏東縣霧臺鄉	2018-11-25T06:29:16+08:00	414	1291	1705	111	1816	2950	61.56%	14.03%	8	8
14	屏東縣霧臺鄉	2018-11-24T23:47:27+08:00	414	1291	1705	111	1816	2950	61.56%	14.03%	8	8
14	屏東縣霧臺鄉	2018-11-25T03:38:54+08:00	414	1291	1705	111	1816	2950	61.56%	14.03%	8	8
14	屏東縣霧臺鄉	2018-11-24T23:55:46+08:00	414	1291	1705	111	1816	2950	61.56%	14.03%	8	8
14	屏東縣霧臺鄉	2018-11-25T01:02:30+08:00	414	1291	1705	111	1816	2950	61.56%	14.03%	8	8
14	屏東縣霧臺鄉	2018-11-25T03:44:22+08:00	414	1291	1705	111	1816	2950	61.56%	14.03%	8	8
14	屏東縣霧臺鄉	2018-11-24T22:13:26+08:00	222	605	827	59	886	1494	59.3%	14.86%	5	8
14	屏東縣霧臺鄉	2018-11-24T23:23:37+08:00	414	1291	1705	111	1816	2950	61.56%	14.03%	8	8
14	屏東縣霧臺鄉	2018-11-25T06:18:56+08:00	414	1291	1705	111	1816	2950	61.56%	14.03%	8	8
14	屏東縣霧臺鄉	2018-11-24T22:23:12+08:00	222	605	827	59	886	1494	59.3%	14.86%	5	8
14	屏東縣霧臺鄉	2018-11-24T23:19:50+08:00	414	1291	1705	111	1816	2950	61.56%	14.03%	8	8
14	屏東縣霧臺鄉	2018-11-24T22:40:27+08:00	292	849	1141	73	1214	1977	61.41%	14.77%	6	8
14	屏東縣霧臺鄉	2018-11-25T00:00:10+08:00	414	1291	1705	111	1816	2950	61.56%	14.03%	8	8
14	屏東縣霧臺鄉	2018-11-25T01:17:51+08:00	414	1291	1705	111	1816	2950	61.56%	14.03%	8	8
14	屏東縣霧臺鄉	2018-11-24T22:30:07+08:00	222	605	827	59	886	1494	59.3%	14.86%	5	8
14	屏東縣霧臺鄉	2018-11-24T23:12:15+08:00	377	1142	1519	84	1603	2654	60.4%	14.2%	7	8
14	屏東縣霧臺鄉	2018-11-24T22:45:08+08:00	292	849	1141	73	1214	1977	61.41%	14.77%	6	8
14	屏東縣霧臺鄉	2018-11-24T23:31:10+08:00	414	1291	1705	111	1816	2950	61.56%	14.03%	8	8
14	屏東縣霧臺鄉	2018-11-24T23:01:30+08:00	292	849	1141	73	1214	1977	61.41%	14.77%	6	8
14	屏東縣霧臺鄉	2018-11-25T04:02:51+08:00	414	1291	1705	111	1816	2950	61.56%	14.03%	8	8
14	屏東縣霧臺鄉	2018-11-24T23:39:15+08:00	414	1291	1705	111	1816	2950	61.56%	14.03%	8	8
14	屏東縣霧臺鄉	2018-11-25T06:23:59+08:00	414	1291	1705	111	1816	2950	61.56%	14.03%	8	8
14	屏東縣霧臺鄉	2018-11-25T00:09:33+08:00	414	1291	1705	111	1816	2950	61.56%	14.03%	8	8
14	屏東縣霧臺鄉	2018-11-25T01:07:25+08:00	414	1291	1705	111	1816	2950	61.56%	14.03%	8	8
14	屏東縣霧臺鄉	2018-11-25T06:13:51+08:00	414	1291	1705	111	1816	2950	61.56%	14.03%	8	8
14	屏東縣霧臺鄉	2018-11-24T23:16:02+08:00	414	1291	1705	111	1816	2950	61.56%	14.03%	8	8
14	屏東縣霧臺鄉	2018-11-24T23:35:09+08:00	414	1291	1705	111	1816	2950	61.56%	14.03%	8	8
14	屏東縣霧臺鄉	2018-11-25T03:49:50+08:00	414	1291	1705	111	1816	2950	61.56%	14.03%	8	8
14	屏東縣霧臺鄉	2018-11-25T00:14:08+08:00	414	1291	1705	111	1816	2950	61.56%	14.03%	8	8
14	屏東縣霧臺鄉	2018-11-25T00:23:03+08:00	414	1291	1705	111	1816	2950	61.56%	14.03%	8	8
14	屏東縣霧臺鄉	2018-11-24T23:08:35+08:00	377	1142	1519	84	1603	2654	60.4%	14.2%	7	8
14	屏東縣霧臺鄉	2018-11-25T03:32:34+08:00	414	1291	1705	111	1816	2950	61.56%	14.03%	8	8
14	屏東縣霧臺鄉	2018-11-25T01:25:52+08:00	414	1291	1705	111	1816	2950	61.56%	14.03%	8	8
14	屏東縣霧臺鄉	2018-11-24T22:19:36+08:00	222	605	827	59	886	1494	59.3%	14.86%	5	8
14	屏東縣霧臺鄉	2018-11-24T23:51:34+08:00	414	1291	1705	111	1816	2950	61.56%	14.03%	8	8
14	屏東縣霧臺鄉	2018-11-24T22:57:52+08:00	292	849	1141	73	1214	1977	61.41%	14.77%	6	8
14	屏東縣霧臺鄉	2018-11-25T00:57:36+08:00	414	1291	1705	111	1816	2950	61.56%	14.03%	8	8
14	屏東縣霧臺鄉	2018-11-24T23:27:18+08:00	414	1291	1705	111	1816	2950	61.56%	14.03%	8	8
14	屏東縣霧臺鄉	2018-11-24T23:05:04+08:00	292	849	1141	73	1214	1977	61.41%	14.77%	6	8
14	屏東縣霧臺鄉	2018-11-24T22:50:47+08:00	292	849	1141	73	1214	1977	61.41%	14.77%	6	8
14	屏東縣霧臺鄉	2018-11-24T22:16:10+08:00	222	605	827	59	886	1494	59.3%	14.86%	5	8
14	屏東縣霧臺鄉	2018-11-25T00:05:04+08:00	414	1291	1705	111	1816	2950	61.56%	14.03%	8	8
14	屏東縣霧臺鄉	2018-11-24T22:41:34+08:00	292	849	1141	73	1214	1977	61.41%	14.77%	6	8
14	屏東縣霧臺鄉	2018-11-25T01:12:42+08:00	414	1291	1705	111	1816	2950	61.56%	14.03%	8	8
14	屏東縣霧臺鄉	2018-11-24T22:26:36+08:00	222	605	827	59	886	1494	59.3%	14.86%	5	8
14	屏東縣霧臺鄉	2018-11-25T00:18:29+08:00	414	1291	1705	111	1816	2950	61.56%	14.03%	8	8
14	屏東縣霧臺鄉	2018-11-25T06:08:52+08:00	414	1291	1705	111	1816	2950	61.56%	14.03%	8	8
14	屏東縣霧臺鄉	2018-11-24T22:54:25+08:00	292	849	1141	73	1214	1977	61.41%	14.77%	6	8
14	臺南市學甲區	2018-11-24T23:35:03+08:00	3070	6899	9969	739	10708	22567	47.45%	13.6%	26	26
14	臺南市學甲區	2018-11-24T22:33:30+08:00	3070	6899	9969	739	10708	22567	47.45%	13.6%	26	26
14	臺南市學甲區	2018-11-24T23:31:02+08:00	3070	6899	9969	739	10708	22567	47.45%	13.6%	26	26
14	臺南市學甲區	2018-11-24T23:39:06+08:00	3070	6899	9969	739	10708	22567	47.45%	13.6%	26	26
14	臺南市學甲區	2018-11-24T23:12:07+08:00	3070	6899	9969	739	10708	22567	47.45%	13.6%	26	26
14	臺南市學甲區	2018-11-25T00:14:02+08:00	3070	6899	9969	739	10708	22567	47.45%	13.6%	26	26
14	臺南市學甲區	2018-11-24T23:47:20+08:00	3070	6899	9969	739	10708	22567	47.45%	13.6%	26	26
14	臺南市學甲區	2018-11-24T23:43:10+08:00	3070	6899	9969	739	10708	22567	47.45%	13.6%	26	26
14	臺南市學甲區	2018-11-25T06:08:44+08:00	3070	6899	9969	739	10708	22567	47.45%	13.6%	26	26
14	臺南市學甲區	2018-11-25T01:07:18+08:00	3070	6899	9969	739	10708	22567	47.45%	13.6%	26	26
14	臺南市學甲區	2018-11-24T23:01:23+08:00	3070	6899	9969	739	10708	22567	47.45%	13.6%	26	26
14	臺南市學甲區	2018-11-24T22:57:45+08:00	3070	6899	9969	739	10708	22567	47.45%	13.6%	26	26
14	臺南市學甲區	2018-11-24T23:04:57+08:00	3070	6899	9969	739	10708	22567	47.45%	13.6%	26	26
14	臺南市學甲區	2018-11-24T23:23:31+08:00	3070	6899	9969	739	10708	22567	47.45%	13.6%	26	26
14	臺南市學甲區	2018-11-25T00:57:29+08:00	3070	6899	9969	739	10708	22567	47.45%	13.6%	26	26
14	臺南市學甲區	2018-11-24T22:13:19+08:00	3070	6899	9969	739	10708	22567	47.45%	13.6%	26	26
14	臺南市學甲區	2018-11-25T03:44:14+08:00	3070	6899	9969	739	10708	22567	47.45%	13.6%	26	26
14	臺南市學甲區	2018-11-25T01:17:43+08:00	3070	6899	9969	739	10708	22567	47.45%	13.6%	26	26
14	臺南市學甲區	2018-11-25T00:04:57+08:00	3070	6899	9969	739	10708	22567	47.45%	13.6%	26	26
14	臺南市學甲區	2018-11-24T23:55:40+08:00	3070	6899	9969	739	10708	22567	47.45%	13.6%	26	26
14	臺南市學甲區	2018-11-24T23:15:55+08:00	3070	6899	9969	739	10708	22567	47.45%	13.6%	26	26
14	臺南市學甲區	2018-11-25T01:02:23+08:00	3070	6899	9969	739	10708	22567	47.45%	13.6%	26	26
14	臺南市學甲區	2018-11-25T01:25:45+08:00	3070	6899	9969	739	10708	22567	47.45%	13.6%	26	26
14	臺南市學甲區	2018-11-25T03:38:48+08:00	3070	6899	9969	739	10708	22567	47.45%	13.6%	26	26
14	臺南市學甲區	2018-11-25T06:18:50+08:00	3070	6899	9969	739	10708	22567	47.45%	13.6%	26	26
14	臺南市學甲區	2018-11-24T22:40:21+08:00	3070	6899	9969	739	10708	22567	47.45%	13.6%	26	26
14	臺南市學甲區	2018-11-24T22:45:01+08:00	3070	6899	9969	739	10708	22567	47.45%	13.6%	26	26
14	臺南市學甲區	2018-11-25T00:18:22+08:00	3070	6899	9969	739	10708	22567	47.45%	13.6%	26	26
14	臺南市學甲區	2018-11-25T00:22:56+08:00	3070	6899	9969	739	10708	22567	47.45%	13.6%	26	26
14	臺南市學甲區	2018-11-24T22:54:19+08:00	3070	6899	9969	739	10708	22567	47.45%	13.6%	26	26
14	臺南市學甲區	2018-11-25T03:56:03+08:00	3070	6899	9969	739	10708	22567	47.45%	13.6%	26	26
14	臺南市學甲區	2018-11-24T22:16:02+08:00	3070	6899	9969	739	10708	22567	47.45%	13.6%	26	26
14	臺南市學甲區	2018-11-25T01:12:34+08:00	3070	6899	9969	739	10708	22567	47.45%	13.6%	26	26
14	臺南市學甲區	2018-11-24T22:50:39+08:00	3070	6899	9969	739	10708	22567	47.45%	13.6%	26	26
14	臺南市學甲區	2018-11-25T00:09:25+08:00	3070	6899	9969	739	10708	22567	47.45%	13.6%	26	26
14	臺南市學甲區	2018-11-24T22:41:28+08:00	3070	6899	9969	739	10708	22567	47.45%	13.6%	26	26
14	臺南市學甲區	2018-11-25T04:02:41+08:00	3070	6899	9969	739	10708	22567	47.45%	13.6%	26	26
14	臺南市學甲區	2018-11-25T00:00:00+08:00	3070	6899	9969	739	10708	22567	47.45%	13.6%	26	26
14	臺南市學甲區	2018-11-24T22:23:04+08:00	3070	6899	9969	739	10708	22567	47.45%	13.6%	26	26
14	臺南市學甲區	2018-11-24T23:19:41+08:00	3070	6899	9969	739	10708	22567	47.45%	13.6%	26	26
14	臺南市學甲區	2018-11-24T23:51:27+08:00	3070	6899	9969	739	10708	22567	47.45%	13.6%	26	26
14	臺南市學甲區	2018-11-24T22:29:58+08:00	3070	6899	9969	739	10708	22567	47.45%	13.6%	26	26
14	臺南市學甲區	2018-11-24T22:36:54+08:00	3070	6899	9969	739	10708	22567	47.45%	13.6%	26	26
14	臺南市學甲區	2018-11-25T03:32:27+08:00	3070	6899	9969	739	10708	22567	47.45%	13.6%	26	26
14	臺南市學甲區	2018-11-24T23:27:11+08:00	3070	6899	9969	739	10708	22567	47.45%	13.6%	26	26
14	臺南市學甲區	2018-11-24T22:19:30+08:00	3070	6899	9969	739	10708	22567	47.45%	13.6%	26	26
14	臺南市學甲區	2018-11-24T23:08:27+08:00	3070	6899	9969	739	10708	22567	47.45%	13.6%	26	26
14	臺南市學甲區	2018-11-25T03:49:44+08:00	3070	6899	9969	739	10708	22567	47.45%	13.6%	26	26
14	臺南市學甲區	2018-11-24T22:26:30+08:00	3070	6899	9969	739	10708	22567	47.45%	13.6%	26	26
14	臺南市學甲區	2018-11-25T06:29:09+08:00	3070	6899	9969	739	10708	22567	47.45%	13.6%	26	26
14	臺南市學甲區	2018-11-25T06:23:53+08:00	3070	6899	9969	739	10708	22567	47.45%	13.6%	26	26
14	臺南市學甲區	2018-11-25T06:13:45+08:00	3070	6899	9969	739	10708	22567	47.45%	13.6%	26	26
14	臺南市南化區	2018-11-24T23:35:04+08:00	974	2417	3391	327	3718	7786	47.75%	12.51%	10	10
14	臺南市南化區	2018-11-24T23:47:21+08:00	974	2417	3391	327	3718	7786	47.75%	12.51%	10	10
14	臺南市南化區	2018-11-25T01:07:19+08:00	974	2417	3391	327	3718	7786	47.75%	12.51%	10	10
14	臺南市南化區	2018-11-24T22:33:31+08:00	974	2417	3391	327	3718	7786	47.75%	12.51%	10	10
14	臺南市南化區	2018-11-25T00:14:02+08:00	974	2417	3391	327	3718	7786	47.75%	12.51%	10	10
14	臺南市南化區	2018-11-24T23:43:10+08:00	974	2417	3391	327	3718	7786	47.75%	12.51%	10	10
14	臺南市南化區	2018-11-25T06:08:44+08:00	974	2417	3391	327	3718	7786	47.75%	12.51%	10	10
14	臺南市南化區	2018-11-25T00:09:26+08:00	974	2417	3391	327	3718	7786	47.75%	12.51%	10	10
14	臺南市南化區	2018-11-24T23:12:08+08:00	974	2417	3391	327	3718	7786	47.75%	12.51%	10	10
14	臺南市南化區	2018-11-24T23:39:07+08:00	974	2417	3391	327	3718	7786	47.75%	12.51%	10	10
14	臺南市南化區	2018-11-24T23:31:03+08:00	974	2417	3391	327	3718	7786	47.75%	12.51%	10	10
14	臺南市南化區	2018-11-24T23:01:24+08:00	974	2417	3391	327	3718	7786	47.75%	12.51%	10	10
14	臺南市南化區	2018-11-24T23:19:42+08:00	974	2417	3391	327	3718	7786	47.75%	12.51%	10	10
14	臺南市南化區	2018-11-25T00:04:58+08:00	974	2417	3391	327	3718	7786	47.75%	12.51%	10	10
14	臺南市南化區	2018-11-24T23:04:57+08:00	974	2417	3391	327	3718	7786	47.75%	12.51%	10	10
14	臺南市南化區	2018-11-25T00:57:29+08:00	974	2417	3391	327	3718	7786	47.75%	12.51%	10	10
14	臺南市南化區	2018-11-24T22:13:19+08:00	974	2417	3391	327	3718	7786	47.75%	12.51%	10	10
14	臺南市南化區	2018-11-25T03:44:14+08:00	974	2417	3391	327	3718	7786	47.75%	12.51%	10	10
14	臺南市南化區	2018-11-25T01:17:43+08:00	974	2417	3391	327	3718	7786	47.75%	12.51%	10	10
14	臺南市南化區	2018-11-24T23:55:40+08:00	974	2417	3391	327	3718	7786	47.75%	12.51%	10	10
14	臺南市南化區	2018-11-25T06:18:51+08:00	974	2417	3391	327	3718	7786	47.75%	12.51%	10	10
14	臺南市南化區	2018-11-25T01:02:23+08:00	974	2417	3391	327	3718	7786	47.75%	12.51%	10	10
14	臺南市南化區	2018-11-25T01:25:45+08:00	974	2417	3391	327	3718	7786	47.75%	12.51%	10	10
14	臺南市南化區	2018-11-25T03:38:48+08:00	974	2417	3391	327	3718	7786	47.75%	12.51%	10	10
14	臺南市南化區	2018-11-24T22:40:21+08:00	974	2417	3391	327	3718	7786	47.75%	12.51%	10	10
14	臺南市南化區	2018-11-24T23:27:12+08:00	974	2417	3391	327	3718	7786	47.75%	12.51%	10	10
14	臺南市南化區	2018-11-25T00:18:23+08:00	974	2417	3391	327	3718	7786	47.75%	12.51%	10	10
14	臺南市南化區	2018-11-24T22:54:19+08:00	974	2417	3391	327	3718	7786	47.75%	12.51%	10	10
14	臺南市南化區	2018-11-25T06:13:46+08:00	974	2417	3391	327	3718	7786	47.75%	12.51%	10	10
14	臺南市南化區	2018-11-25T00:22:57+08:00	974	2417	3391	327	3718	7786	47.75%	12.51%	10	10
14	臺南市南化區	2018-11-25T03:56:04+08:00	974	2417	3391	327	3718	7786	47.75%	12.51%	10	10
14	臺南市南化區	2018-11-24T22:16:02+08:00	974	2417	3391	327	3718	7786	47.75%	12.51%	10	10
14	臺南市南化區	2018-11-24T22:41:28+08:00	974	2417	3391	327	3718	7786	47.75%	12.51%	10	10
14	臺南市南化區	2018-11-25T04:02:41+08:00	974	2417	3391	327	3718	7786	47.75%	12.51%	10	10
14	臺南市南化區	2018-11-25T01:12:35+08:00	974	2417	3391	327	3718	7786	47.75%	12.51%	10	10
14	臺南市南化區	2018-11-24T22:29:59+08:00	974	2417	3391	327	3718	7786	47.75%	12.51%	10	10
14	臺南市南化區	2018-11-24T23:23:32+08:00	974	2417	3391	327	3718	7786	47.75%	12.51%	10	10
14	臺南市南化區	2018-11-24T22:57:46+08:00	974	2417	3391	327	3718	7786	47.75%	12.51%	10	10
14	臺南市南化區	2018-11-25T00:00:01+08:00	974	2417	3391	327	3718	7786	47.75%	12.51%	10	10
14	臺南市南化區	2018-11-24T23:51:27+08:00	974	2417	3391	327	3718	7786	47.75%	12.51%	10	10
14	臺南市南化區	2018-11-24T22:23:05+08:00	974	2417	3391	327	3718	7786	47.75%	12.51%	10	10
14	臺南市南化區	2018-11-24T22:36:54+08:00	974	2417	3391	327	3718	7786	47.75%	12.51%	10	10
14	臺南市南化區	2018-11-24T23:15:56+08:00	974	2417	3391	327	3718	7786	47.75%	12.51%	10	10
14	臺南市南化區	2018-11-24T23:08:28+08:00	974	2417	3391	327	3718	7786	47.75%	12.51%	10	10
14	臺南市南化區	2018-11-25T03:32:27+08:00	974	2417	3391	327	3718	7786	47.75%	12.51%	10	10
14	臺南市南化區	2018-11-24T22:19:30+08:00	974	2417	3391	327	3718	7786	47.75%	12.51%	10	10
14	臺南市南化區	2018-11-25T03:49:44+08:00	974	2417	3391	327	3718	7786	47.75%	12.51%	10	10
14	臺南市南化區	2018-11-24T22:45:02+08:00	974	2417	3391	327	3718	7786	47.75%	12.51%	10	10
14	臺南市南化區	2018-11-24T22:50:40+08:00	974	2417	3391	327	3718	7786	47.75%	12.51%	10	10
14	臺南市南化區	2018-11-24T22:26:30+08:00	974	2417	3391	327	3718	7786	47.75%	12.51%	10	10
14	臺南市南化區	2018-11-25T06:29:09+08:00	974	2417	3391	327	3718	7786	47.75%	12.51%	10	10
14	臺南市南化區	2018-11-25T06:23:53+08:00	974	2417	3391	327	3718	7786	47.75%	12.51%	10	10
14	屏東縣屏東市	2018-11-25T03:56:10+08:00	26847	59054	85901	4615	90516	170148	53.2%	15.78%	149	149
14	屏東縣屏東市	2018-11-24T23:47:26+08:00	25253	55158	80411	4389	84800	159392	53.2%	15.84%	142	149
14	屏東縣屏東市	2018-11-24T23:16:01+08:00	22704	49150	71854	4044	75898	142250	53.36%	15.96%	130	149
14	屏東縣屏東市	2018-11-24T23:43:16+08:00	24771	54246	79017	4326	83343	156871	53.13%	15.79%	140	149
14	屏東縣屏東市	2018-11-24T22:33:36+08:00	16628	35304	51932	3106	55038	103354	53.25%	16.09%	100	149
14	屏東縣屏東市	2018-11-24T22:16:09+08:00	13813	29217	43030	2609	45639	85786	53.2%	16.1%	86	149
14	屏東縣屏東市	2018-11-25T03:38:53+08:00	26847	59054	85901	4615	90516	170148	53.2%	15.78%	149	149
14	屏東縣屏東市	2018-11-24T23:23:36+08:00	23484	51109	74593	4124	78717	147673	53.3%	15.9%	134	149
14	屏東縣屏東市	2018-11-25T01:25:51+08:00	26847	59054	85901	4615	90516	170148	53.2%	15.78%	149	149
14	屏東縣屏東市	2018-11-25T06:18:56+08:00	26847	59054	85901	4615	90516	170148	53.2%	15.78%	149	149
14	屏東縣屏東市	2018-11-24T22:19:35+08:00	14615	30925	45540	2775	48315	90893	53.16%	16.08%	90	149
14	屏東縣屏東市	2018-11-25T01:17:50+08:00	26847	59054	85901	4615	90516	170148	53.2%	15.78%	149	149
14	屏東縣屏東市	2018-11-24T22:36:59+08:00	18209	39003	57212	3353	60565	113340	53.44%	16.07%	108	149
14	屏東縣屏東市	2018-11-24T22:40:26+08:00	19008	40744	59752	3468	63220	118425	53.38%	16.05%	112	149
14	屏東縣屏東市	2018-11-25T00:57:35+08:00	26847	59054	85901	4615	90516	170148	53.2%	15.78%	149	149
14	屏東縣屏東市	2018-11-24T22:57:51+08:00	20990	45009	65999	3743	69742	130654	53.38%	16.07%	121	149
14	屏東縣屏東市	2018-11-25T00:09:32+08:00	25984	56884	82868	4478	87346	164304	53.16%	15.81%	145	149
14	屏東縣屏東市	2018-11-25T06:23:58+08:00	26847	59054	85901	4615	90516	170148	53.2%	15.78%	149	149
14	屏東縣屏東市	2018-11-24T23:39:14+08:00	24771	54246	79017	4326	83343	156871	53.13%	15.79%	140	149
14	屏東縣屏東市	2018-11-25T03:49:49+08:00	26847	59054	85901	4615	90516	170148	53.2%	15.78%	149	149
14	屏東縣屏東市	2018-11-25T01:12:41+08:00	26847	59054	85901	4615	90516	170148	53.2%	15.78%	149	149
14	屏東縣屏東市	2018-11-24T22:26:35+08:00	15165	32282	47447	2874	50321	94712	53.13%	16.01%	93	149
14	屏東縣屏東市	2018-11-24T23:12:14+08:00	22158	47920	70078	3978	74056	138764	53.37%	15.97%	127	149
14	屏東縣屏東市	2018-11-24T22:45:07+08:00	19461	41834	61295	3508	64803	121431	53.37%	16.03%	114	149
14	屏東縣屏東市	2018-11-25T06:08:51+08:00	26847	59054	85901	4615	90516	170148	53.2%	15.78%	149	149
14	屏東縣屏東市	2018-11-25T04:02:50+08:00	26847	59054	85901	4615	90516	170148	53.2%	15.78%	149	149
14	屏東縣屏東市	2018-11-25T06:13:51+08:00	26847	59054	85901	4615	90516	170148	53.2%	15.78%	149	149
14	屏東縣屏東市	2018-11-25T00:14:07+08:00	25984	56884	82868	4478	87346	164304	53.16%	15.81%	145	149
14	屏東縣屏東市	2018-11-24T23:35:09+08:00	24771	54246	79017	4326	83343	156871	53.13%	15.79%	140	149
14	屏東縣屏東市	2018-11-24T23:01:29+08:00	21166	45521	66687	3829	70516	132122	53.37%	16.02%	122	149
14	屏東縣屏東市	2018-11-25T01:07:24+08:00	26847	59054	85901	4615	90516	170148	53.2%	15.78%	149	149
14	屏東縣屏東市	2018-11-24T23:31:09+08:00	24327	53279	77606	4214	81820	154071	53.11%	15.79%	138	149
14	屏東縣屏東市	2018-11-25T06:29:15+08:00	26847	59054	85901	4615	90516	170148	53.2%	15.78%	149	149
14	屏東縣屏東市	2018-11-24T23:55:45+08:00	25453	55654	81107	4419	85526	160762	53.2%	15.83%	143	149
14	屏東縣屏東市	2018-11-24T23:08:34+08:00	21961	47526	69487	3946	73433	137446	53.43%	15.98%	126	149
14	屏東縣屏東市	2018-11-25T00:00:09+08:00	25453	55654	81107	4419	85526	160762	53.2%	15.83%	143	149
14	屏東縣屏東市	2018-11-25T00:23:02+08:00	26138	57119	83257	4513	87770	164972	53.2%	15.84%	146	149
14	屏東縣屏東市	2018-11-24T23:19:48+08:00	23119	50103	73222	4083	77305	145022	53.31%	15.94%	132	149
14	屏東縣屏東市	2018-11-25T03:32:33+08:00	26847	59054	85901	4615	90516	170148	53.2%	15.78%	149	149
14	屏東縣屏東市	2018-11-25T03:44:21+08:00	26847	59054	85901	4615	90516	170148	53.2%	15.78%	149	149
14	屏東縣屏東市	2018-11-24T22:13:25+08:00	12977	27505	40482	2475	42957	80711	53.22%	16.08%	82	149
14	屏東縣屏東市	2018-11-24T22:23:11+08:00	14981	31896	46877	2850	49727	93497	53.19%	16.02%	92	149
14	屏東縣屏東市	2018-11-24T22:30:05+08:00	15571	33271	48842	2925	51767	97456	53.12%	15.98%	95	149
14	屏東縣屏東市	2018-11-24T23:27:17+08:00	23821	52172	75993	4177	80170	150845	53.15%	15.79%	136	149
14	屏東縣屏東市	2018-11-25T01:02:29+08:00	26847	59054	85901	4615	90516	170148	53.2%	15.78%	149	149
14	屏東縣屏東市	2018-11-24T23:51:33+08:00	25453	55654	81107	4419	85526	160762	53.2%	15.83%	143	149
14	屏東縣屏東市	2018-11-24T23:05:03+08:00	21520	46522	68042	3880	71922	134677	53.4%	15.98%	124	149
14	屏東縣屏東市	2018-11-24T22:54:24+08:00	20536	44071	64607	3688	68295	127771	53.45%	16.07%	119	149
14	屏東縣屏東市	2018-11-25T00:18:28+08:00	25984	56884	82868	4478	87346	164304	53.16%	15.81%	145	149
14	屏東縣屏東市	2018-11-24T22:41:33+08:00	19008	40744	59752	3468	63220	118425	53.38%	16.05%	112	149
14	屏東縣屏東市	2018-11-25T00:05:03+08:00	25692	56204	81896	4443	86339	162354	53.18%	15.82%	144	149
14	屏東縣屏東市	2018-11-24T22:50:46+08:00	20114	43172	63286	3618	66904	125191	53.44%	16.07%	117	149
14	臺南市安南區	2018-11-25T06:29:10+08:00	26267	52189	78456	5141	83597	159654	52.36%	16.45%	90	90
14	臺南市安南區	2018-11-24T23:35:04+08:00	21012	41990	63002	4237	67239	128707	52.24%	16.33%	74	90
14	臺南市安南區	2018-11-24T23:47:21+08:00	22462	44690	67152	4427	71579	136628	52.39%	16.44%	78	90
14	臺南市安南區	2018-11-25T06:08:45+08:00	26267	52189	78456	5141	83597	159654	52.36%	16.45%	90	90
14	臺南市安南區	2018-11-24T23:43:11+08:00	22091	44005	66096	4396	70492	134615	52.37%	16.41%	77	90
14	臺南市安南區	2018-11-25T01:07:19+08:00	26267	52189	78456	5141	83597	159654	52.36%	16.45%	90	90
14	臺南市安南區	2018-11-24T22:33:31+08:00	13067	26271	39338	2669	42007	79992	52.51%	16.34%	50	90
14	臺南市安南區	2018-11-25T00:14:02+08:00	24891	49649	74540	4896	79436	151590	52.4%	16.42%	86	90
14	臺南市安南區	2018-11-25T04:02:42+08:00	26267	52189	78456	5141	83597	159654	52.36%	16.45%	90	90
14	臺南市安南區	2018-11-25T00:09:26+08:00	24891	49649	74540	4896	79436	151590	52.4%	16.42%	86	90
14	臺南市安南區	2018-11-24T23:12:08+08:00	17242	34623	51865	3412	55277	105817	52.24%	16.29%	63	90
14	臺南市安南區	2018-11-24T23:39:07+08:00	21581	43211	64792	4357	69149	132066	52.36%	16.34%	76	90
14	臺南市安南區	2018-11-24T23:31:03+08:00	20303	40664	60967	4067	65034	124467	52.25%	16.31%	72	90
14	臺南市安南區	2018-11-24T23:01:24+08:00	16589	33272	49861	3290	53151	101881	52.17%	16.28%	61	90
14	臺南市安南區	2018-11-25T03:44:15+08:00	26267	52189	78456	5141	83597	159654	52.36%	16.45%	90	90
14	臺南市安南區	2018-11-24T23:19:42+08:00	18320	36598	54918	3627	58545	112310	52.13%	16.31%	66	90
14	臺南市安南區	2018-11-25T00:04:58+08:00	24891	49649	74540	4896	79436	151590	52.4%	16.42%	86	90
14	臺南市安南區	2018-11-24T23:04:57+08:00	16589	33272	49861	3290	53151	101881	52.17%	16.28%	61	90
14	臺南市安南區	2018-11-24T22:13:19+08:00	10920	21876	32796	2226	35022	65982	53.08%	16.55%	42	90
14	臺南市安南區	2018-11-25T01:17:44+08:00	26267	52189	78456	5141	83597	159654	52.36%	16.45%	90	90
14	臺南市安南區	2018-11-24T23:55:40+08:00	23937	47702	71639	4701	76340	145866	52.34%	16.41%	83	90
14	臺南市安南區	2018-11-25T06:18:51+08:00	26267	52189	78456	5141	83597	159654	52.36%	16.45%	90	90
14	臺南市安南區	2018-11-25T01:02:24+08:00	26267	52189	78456	5141	83597	159654	52.36%	16.45%	90	90
14	臺南市安南區	2018-11-25T03:38:49+08:00	26267	52189	78456	5141	83597	159654	52.36%	16.45%	90	90
14	臺南市安南區	2018-11-24T23:27:12+08:00	19200	38470	57670	3833	61503	117522	52.33%	16.34%	69	90
14	臺南市安南區	2018-11-24T22:54:20+08:00	15892	31945	47837	3157	50994	97938	52.07%	16.23%	59	90
14	臺南市安南區	2018-11-25T00:18:23+08:00	24891	49649	74540	4896	79436	151590	52.4%	16.42%	86	90
14	臺南市安南區	2018-11-25T06:13:46+08:00	26267	52189	78456	5141	83597	159654	52.36%	16.45%	90	90
14	臺南市安南區	2018-11-25T00:22:57+08:00	24891	49649	74540	4896	79436	151590	52.4%	16.42%	86	90
14	臺南市安南區	2018-11-25T03:56:04+08:00	26267	52189	78456	5141	83597	159654	52.36%	16.45%	90	90
14	臺南市安南區	2018-11-24T22:41:29+08:00	13964	28097	42061	2815	44876	85685	52.37%	16.3%	53	90
14	臺南市安南區	2018-11-24T22:16:03+08:00	11158	22315	33473	2272	35745	67429	53.01%	16.55%	43	90
14	臺南市安南區	2018-11-25T01:12:35+08:00	26267	52189	78456	5141	83597	159654	52.36%	16.45%	90	90
14	臺南市安南區	2018-11-24T22:29:59+08:00	12572	25305	37877	2570	40447	77009	52.52%	16.33%	48	90
14	臺南市安南區	2018-11-24T23:23:32+08:00	18617	37191	55808	3685	59493	114073	52.15%	16.32%	67	90
14	臺南市安南區	2018-11-24T23:51:28+08:00	23309	46356	69665	4589	74254	141566	52.45%	16.47%	81	90
14	臺南市安南區	2018-11-24T22:57:46+08:00	16589	33272	49861	3290	53151	101881	52.17%	16.28%	61	90
14	臺南市安南區	2018-11-25T00:00:01+08:00	23937	47702	71639	4701	76340	145866	52.34%	16.41%	83	90
14	臺南市安南區	2018-11-24T22:23:05+08:00	12001	24052	36053	2421	38474	73081	52.65%	16.42%	46	90
14	臺南市安南區	2018-11-24T22:36:54+08:00	13269	26733	40002	2687	42689	81372	52.46%	16.31%	51	90
14	臺南市安南區	2018-11-25T01:25:46+08:00	26267	52189	78456	5141	83597	159654	52.36%	16.45%	90	90
14	臺南市安南區	2018-11-25T00:57:30+08:00	26267	52189	78456	5141	83597	159654	52.36%	16.45%	90	90
14	臺南市安南區	2018-11-24T23:08:28+08:00	17000	34114	51114	3345	54459	104324	52.2%	16.3%	62	90
14	臺南市安南區	2018-11-24T22:40:22+08:00	13964	28097	42061	2815	44876	85685	52.37%	16.3%	53	90
14	臺南市安南區	2018-11-24T22:19:30+08:00	11712	23492	35204	2367	37571	71297	52.7%	16.43%	45	90
14	臺南市安南區	2018-11-24T23:15:57+08:00	17979	35953	53932	3557	57489	110507	52.02%	16.27%	65	90
14	臺南市安南區	2018-11-25T03:32:28+08:00	26267	52189	78456	5141	83597	159654	52.36%	16.45%	90	90
14	臺南市安南區	2018-11-24T22:45:02+08:00	14302	28640	42942	2869	45811	87594	52.3%	16.33%	54	90
14	臺南市安南區	2018-11-24T22:50:40+08:00	15295	30702	45997	3056	49053	93972	52.2%	16.28%	57	90
14	臺南市安南區	2018-11-25T03:49:45+08:00	26267	52189	78456	5141	83597	159654	52.36%	16.45%	90	90
14	臺南市安南區	2018-11-25T06:23:54+08:00	26267	52189	78456	5141	83597	159654	52.36%	16.45%	90	90
14	臺南市安南區	2018-11-24T22:26:31+08:00	12001	24052	36053	2421	38474	73081	52.65%	16.42%	46	90
14	屏東縣高樹鄉	2018-11-24T23:16:01+08:00	2886	6145	9031	1050	10081	20438	49.32%	14.12%	21	22
14	屏東縣高樹鄉	2018-11-24T23:43:16+08:00	3064	6504	9568	1117	10685	21697	49.25%	14.12%	22	22
14	屏東縣高樹鄉	2018-11-24T22:33:36+08:00	2713	5787	8500	979	9479	19322	49.06%	14.04%	20	22
14	屏東縣高樹鄉	2018-11-25T03:56:11+08:00	3064	6504	9568	1117	10685	21697	49.25%	14.12%	22	22
14	屏東縣高樹鄉	2018-11-24T23:47:27+08:00	3064	6504	9568	1117	10685	21697	49.25%	14.12%	22	22
14	屏東縣高樹鄉	2018-11-24T22:16:09+08:00	2713	5787	8500	979	9479	19322	49.06%	14.04%	20	22
14	屏東縣高樹鄉	2018-11-25T03:38:54+08:00	3064	6504	9568	1117	10685	21697	49.25%	14.12%	22	22
14	屏東縣高樹鄉	2018-11-25T01:25:51+08:00	3064	6504	9568	1117	10685	21697	49.25%	14.12%	22	22
14	屏東縣高樹鄉	2018-11-24T23:23:37+08:00	2886	6145	9031	1050	10081	20438	49.32%	14.12%	21	22
14	屏東縣高樹鄉	2018-11-25T06:18:56+08:00	3064	6504	9568	1117	10685	21697	49.25%	14.12%	22	22
14	屏東縣高樹鄉	2018-11-24T22:30:06+08:00	2713	5787	8500	979	9479	19322	49.06%	14.04%	20	22
14	屏東縣高樹鄉	2018-11-25T01:17:50+08:00	3064	6504	9568	1117	10685	21697	49.25%	14.12%	22	22
14	屏東縣高樹鄉	2018-11-24T22:36:59+08:00	2713	5787	8500	979	9479	19322	49.06%	14.04%	20	22
14	屏東縣高樹鄉	2018-11-24T22:40:26+08:00	2713	5787	8500	979	9479	19322	49.06%	14.04%	20	22
14	屏東縣高樹鄉	2018-11-25T00:57:35+08:00	3064	6504	9568	1117	10685	21697	49.25%	14.12%	22	22
14	屏東縣高樹鄉	2018-11-24T23:31:10+08:00	3064	6504	9568	1117	10685	21697	49.25%	14.12%	22	22
14	屏東縣高樹鄉	2018-11-24T23:39:14+08:00	3064	6504	9568	1117	10685	21697	49.25%	14.12%	22	22
14	屏東縣高樹鄉	2018-11-25T04:02:51+08:00	3064	6504	9568	1117	10685	21697	49.25%	14.12%	22	22
14	屏東縣高樹鄉	2018-11-24T22:26:35+08:00	2713	5787	8500	979	9479	19322	49.06%	14.04%	20	22
14	屏東縣高樹鄉	2018-11-24T23:12:14+08:00	2713	5787	8500	979	9479	19322	49.06%	14.04%	20	22
14	屏東縣高樹鄉	2018-11-25T06:23:59+08:00	3064	6504	9568	1117	10685	21697	49.25%	14.12%	22	22
14	屏東縣高樹鄉	2018-11-25T00:09:33+08:00	3064	6504	9568	1117	10685	21697	49.25%	14.12%	22	22
14	屏東縣高樹鄉	2018-11-24T22:45:07+08:00	2713	5787	8500	979	9479	19322	49.06%	14.04%	20	22
14	屏東縣高樹鄉	2018-11-25T06:08:51+08:00	3064	6504	9568	1117	10685	21697	49.25%	14.12%	22	22
14	屏東縣高樹鄉	2018-11-25T01:07:25+08:00	3064	6504	9568	1117	10685	21697	49.25%	14.12%	22	22
14	屏東縣高樹鄉	2018-11-25T06:13:51+08:00	3064	6504	9568	1117	10685	21697	49.25%	14.12%	22	22
14	屏東縣高樹鄉	2018-11-24T23:35:09+08:00	3064	6504	9568	1117	10685	21697	49.25%	14.12%	22	22
14	屏東縣高樹鄉	2018-11-24T23:01:29+08:00	2713	5787	8500	979	9479	19322	49.06%	14.04%	20	22
14	屏東縣高樹鄉	2018-11-25T03:49:50+08:00	3064	6504	9568	1117	10685	21697	49.25%	14.12%	22	22
14	屏東縣高樹鄉	2018-11-25T00:14:08+08:00	3064	6504	9568	1117	10685	21697	49.25%	14.12%	22	22
14	屏東縣高樹鄉	2018-11-25T06:29:15+08:00	3064	6504	9568	1117	10685	21697	49.25%	14.12%	22	22
14	屏東縣高樹鄉	2018-11-24T23:55:45+08:00	3064	6504	9568	1117	10685	21697	49.25%	14.12%	22	22
14	屏東縣高樹鄉	2018-11-24T23:08:34+08:00	2713	5787	8500	979	9479	19322	49.06%	14.04%	20	22
14	屏東縣高樹鄉	2018-11-25T00:00:09+08:00	3064	6504	9568	1117	10685	21697	49.25%	14.12%	22	22
14	屏東縣高樹鄉	2018-11-25T00:23:02+08:00	3064	6504	9568	1117	10685	21697	49.25%	14.12%	22	22
14	屏東縣高樹鄉	2018-11-25T03:32:33+08:00	3064	6504	9568	1117	10685	21697	49.25%	14.12%	22	22
14	屏東縣高樹鄉	2018-11-25T03:44:21+08:00	3064	6504	9568	1117	10685	21697	49.25%	14.12%	22	22
14	屏東縣高樹鄉	2018-11-24T22:13:25+08:00	2591	5488	8079	922	9001	18400	48.92%	14.08%	19	22
14	屏東縣高樹鄉	2018-11-24T23:19:49+08:00	2886	6145	9031	1050	10081	20438	49.32%	14.12%	21	22
14	屏東縣高樹鄉	2018-11-24T22:23:11+08:00	2713	5787	8500	979	9479	19322	49.06%	14.04%	20	22
14	屏東縣高樹鄉	2018-11-24T23:27:17+08:00	2886	6145	9031	1050	10081	20438	49.32%	14.12%	21	22
14	屏東縣高樹鄉	2018-11-24T22:19:36+08:00	2713	5787	8500	979	9479	19322	49.06%	14.04%	20	22
14	屏東縣高樹鄉	2018-11-25T01:02:29+08:00	3064	6504	9568	1117	10685	21697	49.25%	14.12%	22	22
14	屏東縣高樹鄉	2018-11-24T23:51:33+08:00	3064	6504	9568	1117	10685	21697	49.25%	14.12%	22	22
14	屏東縣高樹鄉	2018-11-24T22:57:52+08:00	2713	5787	8500	979	9479	19322	49.06%	14.04%	20	22
14	屏東縣高樹鄉	2018-11-24T23:05:03+08:00	2713	5787	8500	979	9479	19322	49.06%	14.04%	20	22
14	屏東縣高樹鄉	2018-11-24T22:54:24+08:00	2713	5787	8500	979	9479	19322	49.06%	14.04%	20	22
14	屏東縣高樹鄉	2018-11-25T00:18:28+08:00	3064	6504	9568	1117	10685	21697	49.25%	14.12%	22	22
14	屏東縣高樹鄉	2018-11-24T22:41:33+08:00	2713	5787	8500	979	9479	19322	49.06%	14.04%	20	22
14	屏東縣高樹鄉	2018-11-25T00:05:03+08:00	3064	6504	9568	1117	10685	21697	49.25%	14.12%	22	22
14	屏東縣高樹鄉	2018-11-25T01:12:42+08:00	3064	6504	9568	1117	10685	21697	49.25%	14.12%	22	22
14	屏東縣高樹鄉	2018-11-24T22:50:46+08:00	2713	5787	8500	979	9479	19322	49.06%	14.04%	20	22
14	全國	2018-11-24T23:47:17+08:00	2956595	6118090	9074685	546449	9621134	17387690	55.33%	17%	339	15
14	全國	2018-11-24T22:50:35+08:00	2361954	4911591	7273545	450136	7723681	13991234	55.2%	16.88%	989	15
14	全國	2018-11-25T01:12:31+08:00	3300963	6798446	10099409	597436	10696845	19320073	55.37%	17.09%	609	15
14	全國	2018-11-24T22:26:27+08:00	2031793	4229654	6261447	393639	6655086	12075423	55.11%	16.83%	590	15
14	全國	2018-11-24T22:19:27+08:00	1936717	4031859	5968576	377099	6345675	11519747	55.09%	16.81%	189	15
14	全國	2018-11-24T22:57:42+08:00	2475669	5141131	7616800	468555	8085355	14638602	55.23%	16.91%	445	15
14	全國	2018-11-25T00:57:26+08:00	3273813	6746632	10020445	593709	10614154	19170291	55.37%	17.08%	515	15
14	全國	2018-11-24T22:29:54+08:00	2075524	4320122	6395646	401305	6796951	12328706	55.13%	16.83%	776	15
14	全國	2018-11-24T23:27:09+08:00	2772390	5746086	8518476	517141	9035617	16339839	55.3%	16.97%	633	15
14	全國	2018-11-24T22:44:59+08:00	2279279	4742968	7022247	436596	7458843	13518440	55.18%	16.86%	651	15
14	全國	2018-11-24T22:23:01+08:00	1987090	4138290	6125380	385875	6511255	11817097	55.1%	16.82%	403	15
14	全國	2018-11-25T03:55:59+08:00	3382286	6949697	10331983	608484	10940467	19757067	55.37%	17.12%	887	15
14	全國	2018-11-24T23:51:24+08:00	2975037	6156120	9131157	549312	9680469	17495029	55.33%	17.01%	414	15
14	全國	2018-11-24T23:15:52+08:00	2644486	5483452	8127938	496068	8624006	15600566	55.28%	16.95%	127	15
14	全國	2018-11-25T03:32:24+08:00	3381775	6948558	10330333	608404	10938737	19753878	55.38%	17.12%	885	15
14	全國	2018-11-25T01:25:42+08:00	3320925	6836295	10157220	600125	10757345	19429484	55.37%	17.09%	677	15
14	全國	2018-11-24T23:55:36+08:00	3015015	6236441	9251456	555395	9806851	17723147	55.33%	17.01%	563	15
14	全國	2018-11-25T00:13:58+08:00	3117732	6441694	9559426	570852	10130278	18307476	55.33%	17.03%	948	15
14	全國	2018-11-24T22:40:18+08:00	2240325	4661397	6901722	430154	7331876	13287063	55.18%	16.86%	481	15
14	全國	2018-11-24T23:08:24+08:00	2584960	5362820	7947780	486305	8434085	15260068	55.27%	16.94%	885	15
14	全國	2018-11-24T23:59:57+08:00	3036915	6279657	9316572	558702	9875274	17848468	55.33%	17.01%	644	15
14	全國	2018-11-24T22:36:51+08:00	2159810	4492770	6652580	416209	7068789	12815992	55.16%	16.85%	134	15
14	全國	2018-11-24T22:54:16+08:00	2398565	4988037	7386602	456291	7842893	14205809	55.21%	16.88%	142	15
14	全國	2018-11-25T06:29:05+08:00	3382286	6949697	10331983	608484	10940467	19757067	55.37%	17.12%	887	15
14	全國	2018-11-25T06:23:50+08:00	3382286	6949697	10331983	608484	10940467	19757067	55.37%	17.12%	887	15
14	全國	2018-11-25T03:49:41+08:00	3382286	6949697	10331983	608484	10940467	19757067	55.37%	17.12%	887	15
14	全國	2018-11-24T23:39:02+08:00	2881836	5971252	8853088	534672	9387760	16972887	55.31%	16.98%	058	15
14	全國	2018-11-24T23:12:04+08:00	2613186	5419766	8032952	491141	8524093	15422249	55.27%	16.94%	002	15
14	全國	2018-11-25T06:08:40+08:00	3382286	6949697	10331983	608484	10940467	19757067	55.37%	17.12%	887	15
14	全國	2018-11-25T00:09:22+08:00	3083923	6374858	9458781	565742	10024523	18118770	55.33%	17.02%	822	15
14	全國	2018-11-25T01:07:15+08:00	3296245	6788495	10084740	596834	10681574	19293289	55.36%	17.08%	593	15
14	全國	2018-11-24T23:01:20+08:00	2514613	5221066	7735679	474819	8210498	14862285	55.24%	16.92%	603	15
14	全國	2018-11-24T22:41:26+08:00	2240325	4661397	6901722	430154	7331876	13287063	55.18%	16.86%	481	15
14	全國	2018-11-24T23:35:01+08:00	2851365	5909409	8760774	529808	9290582	16799513	55.3%	16.97%	940	15
14	全國	2018-11-24T23:04:54+08:00	2551737	5295741	7847478	481103	8328581	15071760	55.26%	16.93%	752	15
14	全國	2018-11-25T06:18:47+08:00	3382286	6949697	10331983	608484	10940467	19757067	55.37%	17.12%	887	15
14	全國	2018-11-25T00:04:55+08:00	3072243	6350514	9422757	563906	9986663	18049785	55.33%	17.02%	778	15
14	全國	2018-11-24T22:13:15+08:00	1836551	3828513	5665064	359676	6024740	10944016	55.05%	16.78%	766	15
14	全國	2018-11-25T03:44:10+08:00	3381998	6948936	10330934	608419	10939353	19755022	55.38%	17.12%	886	15
14	全國	2018-11-25T01:02:20+08:00	3286274	6768716	10054990	595348	10650338	19236707	55.36%	17.08%	556	15
14	全國	2018-11-25T03:38:45+08:00	3381998	6948936	10330934	608419	10939353	19755022	55.38%	17.12%	886	15
14	全國	2018-11-24T23:19:38+08:00	2713049	5625694	8338743	507687	8846430	15998727	55.29%	16.96%	405	15
14	全國	2018-11-24T23:23:29+08:00	2743668	5687925	8431593	512607	8944200	16173251	55.3%	16.96%	522	15
14	全國	2018-11-24T23:30:59+08:00	2825416	5855420	8680836	525627	9206463	16646893	55.3%	16.97%	837	15
14	全國	2018-11-24T22:15:59+08:00	1887043	3931101	5818144	368380	6186524	11235773	55.06%	16.79%	979	15
14	全國	2018-11-25T01:17:39+08:00	3310883	6816460	10127343	598629	10725972	19372749	55.37%	17.09%	640	15
14	全國	2018-11-24T23:43:07+08:00	2931123	6066802	8997925	542495	9540420	17243920	55.33%	17%	241	15
14	全國	2018-11-25T00:18:19+08:00	3135689	6477483	9613172	573582	10186754	18408849	55.34%	17.03%	013	15
14	全國	2018-11-25T00:22:53+08:00	3163011	6531512	9694523	577817	10272340	18563955	55.33%	17.04%	115	15
14	全國	2018-11-24T22:33:27+08:00	2113748	4397952	6511700	408099	6919799	12548089	55.15%	16.85%	940	15
14	全國	2018-11-25T06:13:42+08:00	3382286	6949697	10331983	608484	10940467	19757067	55.37%	17.12%	887	15
14	全國	2018-11-25T04:02:38+08:00	3382286	6949697	10331983	608484	10940467	19757067	55.37%	17.12%	887	15
14	桃園市復興區	2018-11-24T23:47:19+08:00	839	3280	4119	253	4372	7859	55.63%	10.68%	8	10
14	桃園市復興區	2018-11-25T01:07:17+08:00	881	3495	4376	260	4636	8542	54.27%	10.31%	9	10
14	桃園市復興區	2018-11-24T23:01:22+08:00	642	2446	3088	168	3256	5868	55.49%	10.94%	7	10
14	桃園市復興區	2018-11-25T06:08:42+08:00	967	4060	5027	291	5318	9766	54.45%	9.9%	10	10
14	桃園市復興區	2018-11-24T23:35:02+08:00	839	3280	4119	253	4372	7859	55.63%	10.68%	8	10
14	桃園市復興區	2018-11-24T23:12:06+08:00	642	2446	3088	168	3256	5868	55.49%	10.94%	7	10
14	桃園市復興區	2018-11-24T22:26:29+08:00	385	1333	1718	93	1811	3341	54.21%	11.52%	4	10
14	桃園市復興區	2018-11-24T22:16:00+08:00	292	1054	1346	75	1421	2625	54.13%	11.12%	3	10
14	桃園市復興區	2018-11-25T03:44:12+08:00	967	4060	5027	291	5318	9766	54.45%	9.9%	10	10
14	桃園市復興區	2018-11-25T00:04:56+08:00	881	3495	4376	260	4636	8542	54.27%	10.31%	9	10
14	桃園市復興區	2018-11-24T22:19:28+08:00	385	1333	1718	93	1811	3341	54.21%	11.52%	4	10
14	桃園市復興區	2018-11-24T22:57:44+08:00	510	1982	2492	119	2611	4852	53.81%	10.51%	6	10
14	桃園市復興區	2018-11-25T00:57:27+08:00	881	3495	4376	260	4636	8542	54.27%	10.31%	9	10
14	桃園市復興區	2018-11-24T22:13:17+08:00	292	1054	1346	75	1421	2625	54.13%	11.12%	3	10
14	桃園市復興區	2018-11-24T23:23:30+08:00	642	2446	3088	168	3256	5868	55.49%	10.94%	7	10
14	桃園市復興區	2018-11-24T23:55:38+08:00	839	3280	4119	253	4372	7859	55.63%	10.68%	8	10
14	桃園市復興區	2018-11-24T22:40:20+08:00	456	1638	2094	102	2196	4101	53.55%	11.12%	5	10
14	桃園市復興區	2018-11-25T03:32:25+08:00	967	4060	5027	291	5318	9766	54.45%	9.9%	10	10
14	桃園市復興區	2018-11-24T23:15:54+08:00	642	2446	3088	168	3256	5868	55.49%	10.94%	7	10
14	桃園市復興區	2018-11-25T01:25:43+08:00	967	4060	5027	291	5318	9766	54.45%	9.9%	10	10
14	桃園市復興區	2018-11-24T23:59:59+08:00	839	3280	4119	253	4372	7859	55.63%	10.68%	8	10
14	桃園市復興區	2018-11-25T03:38:47+08:00	967	4060	5027	291	5318	9766	54.45%	9.9%	10	10
14	桃園市復興區	2018-11-24T22:54:18+08:00	456	1638	2094	102	2196	4101	53.55%	11.12%	5	10
14	桃園市復興區	2018-11-25T06:23:51+08:00	967	4060	5027	291	5318	9766	54.45%	9.9%	10	10
14	桃園市復興區	2018-11-24T22:45:00+08:00	456	1638	2094	102	2196	4101	53.55%	11.12%	5	10
14	桃園市復興區	2018-11-24T23:31:01+08:00	839	3280	4119	253	4372	7859	55.63%	10.68%	8	10
14	桃園市復興區	2018-11-25T00:09:24+08:00	881	3495	4376	260	4636	8542	54.27%	10.31%	9	10
14	桃園市復興區	2018-11-24T22:41:27+08:00	456	1638	2094	102	2196	4101	53.55%	11.12%	5	10
14	桃園市復興區	2018-11-25T01:12:33+08:00	881	3495	4376	260	4636	8542	54.27%	10.31%	9	10
14	桃園市復興區	2018-11-24T22:50:37+08:00	456	1638	2094	102	2196	4101	53.55%	11.12%	5	10
14	桃園市復興區	2018-11-25T00:14:00+08:00	881	3495	4376	260	4636	8542	54.27%	10.31%	9	10
14	桃園市復興區	2018-11-24T23:39:04+08:00	839	3280	4119	253	4372	7859	55.63%	10.68%	8	10
14	桃園市復興區	2018-11-24T23:51:26+08:00	839	3280	4119	253	4372	7859	55.63%	10.68%	8	10
14	桃園市復興區	2018-11-25T06:18:49+08:00	967	4060	5027	291	5318	9766	54.45%	9.9%	10	10
14	桃園市復興區	2018-11-25T01:17:41+08:00	881	3495	4376	260	4636	8542	54.27%	10.31%	9	10
14	桃園市復興區	2018-11-24T22:23:03+08:00	385	1333	1718	93	1811	3341	54.21%	11.52%	4	10
14	桃園市復興區	2018-11-24T22:29:56+08:00	385	1333	1718	93	1811	3341	54.21%	11.52%	4	10
14	桃園市復興區	2018-11-24T23:04:55+08:00	642	2446	3088	168	3256	5868	55.49%	10.94%	7	10
14	桃園市復興區	2018-11-24T23:19:40+08:00	642	2446	3088	168	3256	5868	55.49%	10.94%	7	10
14	桃園市復興區	2018-11-24T23:27:10+08:00	642	2446	3088	168	3256	5868	55.49%	10.94%	7	10
14	桃園市復興區	2018-11-24T23:08:26+08:00	642	2446	3088	168	3256	5868	55.49%	10.94%	7	10
14	桃園市復興區	2018-11-24T22:36:52+08:00	456	1638	2094	102	2196	4101	53.55%	11.12%	5	10
14	桃園市復興區	2018-11-25T01:02:21+08:00	881	3495	4376	260	4636	8542	54.27%	10.31%	9	10
14	桃園市復興區	2018-11-25T03:49:43+08:00	967	4060	5027	291	5318	9766	54.45%	9.9%	10	10
14	桃園市復興區	2018-11-25T00:22:55+08:00	881	3495	4376	260	4636	8542	54.27%	10.31%	9	10
14	桃園市復興區	2018-11-25T03:56:01+08:00	967	4060	5027	291	5318	9766	54.45%	9.9%	10	10
14	桃園市復興區	2018-11-25T04:02:39+08:00	967	4060	5027	291	5318	9766	54.45%	9.9%	10	10
14	桃園市復興區	2018-11-25T06:13:44+08:00	967	4060	5027	291	5318	9766	54.45%	9.9%	10	10
14	桃園市復興區	2018-11-25T00:18:21+08:00	881	3495	4376	260	4636	8542	54.27%	10.31%	9	10
14	桃園市復興區	2018-11-24T22:33:29+08:00	385	1333	1718	93	1811	3341	54.21%	11.52%	4	10
14	桃園市復興區	2018-11-25T06:29:07+08:00	967	4060	5027	291	5318	9766	54.45%	9.9%	10	10
14	桃園市復興區	2018-11-24T23:43:08+08:00	839	3280	4119	253	4372	7859	55.63%	10.68%	8	10
14	臺北市南港區	2018-11-24T23:47:17+08:00	21854	35073	56927	2530	59457	101907	58.34%	21.45%	72	72
14	臺北市南港區	2018-11-24T22:26:28+08:00	21552	34645	56197	2498	58695	100518	58.39%	21.44%	71	72
14	臺北市南港區	2018-11-25T01:12:31+08:00	21854	35073	56927	2530	59457	101907	58.34%	21.45%	72	72
14	臺北市南港區	2018-11-25T01:07:16+08:00	21854	35073	56927	2530	59457	101907	58.34%	21.45%	72	72
14	臺北市南港區	2018-11-24T22:19:27+08:00	21552	34645	56197	2498	58695	100518	58.39%	21.44%	71	72
14	臺北市南港區	2018-11-24T22:13:16+08:00	21552	34645	56197	2498	58695	100518	58.39%	21.44%	71	72
14	臺北市南港區	2018-11-24T22:57:42+08:00	21854	35073	56927	2530	59457	101907	58.34%	21.45%	72	72
14	臺北市南港區	2018-11-25T00:57:26+08:00	21854	35073	56927	2530	59457	101907	58.34%	21.45%	72	72
14	臺北市南港區	2018-11-24T23:51:25+08:00	21854	35073	56927	2530	59457	101907	58.34%	21.45%	72	72
14	臺北市南港區	2018-11-24T22:29:54+08:00	21552	34645	56197	2498	58695	100518	58.39%	21.44%	71	72
14	臺北市南港區	2018-11-24T23:27:09+08:00	21854	35073	56927	2530	59457	101907	58.34%	21.45%	72	72
14	臺北市南港區	2018-11-24T22:44:59+08:00	21552	34645	56197	2498	58695	100518	58.39%	21.44%	71	72
14	臺北市南港區	2018-11-24T22:19:28+08:00	21552	34645	56197	2498	58695	100518	58.39%	21.44%	71	72
14	臺北市南港區	2018-11-24T22:23:01+08:00	21552	34645	56197	2498	58695	100518	58.39%	21.44%	71	72
14	臺北市南港區	2018-11-24T23:51:24+08:00	21854	35073	56927	2530	59457	101907	58.34%	21.45%	72	72
14	臺北市南港區	2018-11-24T23:15:52+08:00	21854	35073	56927	2530	59457	101907	58.34%	21.45%	72	72
14	臺北市南港區	2018-11-25T03:32:24+08:00	21854	35073	56927	2530	59457	101907	58.34%	21.45%	72	72
14	臺北市南港區	2018-11-25T03:38:46+08:00	21854	35073	56927	2530	59457	101907	58.34%	21.45%	72	72
14	臺北市南港區	2018-11-24T23:59:58+08:00	21854	35073	56927	2530	59457	101907	58.34%	21.45%	72	72
14	臺北市南港區	2018-11-25T01:25:42+08:00	21854	35073	56927	2530	59457	101907	58.34%	21.45%	72	72
14	臺北市南港區	2018-11-24T23:55:36+08:00	21854	35073	56927	2530	59457	101907	58.34%	21.45%	72	72
14	臺北市南港區	2018-11-24T22:40:18+08:00	21552	34645	56197	2498	58695	100518	58.39%	21.44%	71	72
14	臺北市南港區	2018-11-25T03:32:25+08:00	21854	35073	56927	2530	59457	101907	58.34%	21.45%	72	72
14	臺北市南港區	2018-11-24T23:08:24+08:00	21854	35073	56927	2530	59457	101907	58.34%	21.45%	72	72
14	臺北市南港區	2018-11-24T23:15:53+08:00	21854	35073	56927	2530	59457	101907	58.34%	21.45%	72	72
14	臺北市南港區	2018-11-24T23:59:57+08:00	21854	35073	56927	2530	59457	101907	58.34%	21.45%	72	72
14	臺北市南港區	2018-11-24T22:40:19+08:00	21552	34645	56197	2498	58695	100518	58.39%	21.44%	71	72
14	臺北市南港區	2018-11-24T23:55:37+08:00	21854	35073	56927	2530	59457	101907	58.34%	21.45%	72	72
14	臺北市南港區	2018-11-25T00:13:59+08:00	21854	35073	56927	2530	59457	101907	58.34%	21.45%	72	72
14	臺北市南港區	2018-11-24T22:36:51+08:00	21552	34645	56197	2498	58695	100518	58.39%	21.44%	71	72
14	臺北市南港區	2018-11-25T06:29:05+08:00	21854	35073	56927	2530	59457	101907	58.34%	21.45%	72	72
14	臺北市南港區	2018-11-24T22:54:17+08:00	21854	35073	56927	2530	59457	101907	58.34%	21.45%	72	72
14	臺北市南港區	2018-11-25T06:23:50+08:00	21854	35073	56927	2530	59457	101907	58.34%	21.45%	72	72
14	臺北市南港區	2018-11-24T23:01:21+08:00	21854	35073	56927	2530	59457	101907	58.34%	21.45%	72	72
14	臺北市南港區	2018-11-24T23:39:02+08:00	21854	35073	56927	2530	59457	101907	58.34%	21.45%	72	72
14	臺北市南港區	2018-11-24T23:12:04+08:00	21854	35073	56927	2530	59457	101907	58.34%	21.45%	72	72
14	臺北市南港區	2018-11-25T06:08:41+08:00	21854	35073	56927	2530	59457	101907	58.34%	21.45%	72	72
14	臺北市南港區	2018-11-25T06:08:40+08:00	21854	35073	56927	2530	59457	101907	58.34%	21.45%	72	72
14	臺北市南港區	2018-11-25T00:09:22+08:00	21854	35073	56927	2530	59457	101907	58.34%	21.45%	72	72
14	臺北市南港區	2018-11-24T23:31:00+08:00	21854	35073	56927	2530	59457	101907	58.34%	21.45%	72	72
14	臺北市南港區	2018-11-24T23:39:03+08:00	21854	35073	56927	2530	59457	101907	58.34%	21.45%	72	72
14	臺北市南港區	2018-11-24T23:01:20+08:00	21854	35073	56927	2530	59457	101907	58.34%	21.45%	72	72
14	臺北市南港區	2018-11-24T22:50:36+08:00	21552	34645	56197	2498	58695	100518	58.39%	21.44%	71	72
14	臺北市南港區	2018-11-25T01:12:32+08:00	21854	35073	56927	2530	59457	101907	58.34%	21.45%	72	72
14	臺北市南港區	2018-11-24T22:41:26+08:00	21552	34645	56197	2498	58695	100518	58.39%	21.44%	71	72
14	臺北市南港區	2018-11-24T23:35:01+08:00	21854	35073	56927	2530	59457	101907	58.34%	21.45%	72	72
14	臺北市南港區	2018-11-24T23:04:54+08:00	21854	35073	56927	2530	59457	101907	58.34%	21.45%	72	72
14	臺北市南港區	2018-11-25T00:04:55+08:00	21854	35073	56927	2530	59457	101907	58.34%	21.45%	72	72
14	臺北市南港區	2018-11-25T06:18:48+08:00	21854	35073	56927	2530	59457	101907	58.34%	21.45%	72	72
14	臺北市南港區	2018-11-24T22:23:02+08:00	21552	34645	56197	2498	58695	100518	58.39%	21.44%	71	72
14	臺北市南港區	2018-11-25T03:44:10+08:00	21854	35073	56927	2530	59457	101907	58.34%	21.45%	72	72
14	臺北市南港區	2018-11-25T01:17:40+08:00	21854	35073	56927	2530	59457	101907	58.34%	21.45%	72	72
14	臺北市南港區	2018-11-25T01:02:20+08:00	21854	35073	56927	2530	59457	101907	58.34%	21.45%	72	72
14	臺北市南港區	2018-11-25T03:38:45+08:00	21854	35073	56927	2530	59457	101907	58.34%	21.45%	72	72
14	臺北市南港區	2018-11-24T23:19:38+08:00	21854	35073	56927	2530	59457	101907	58.34%	21.45%	72	72
14	臺北市南港區	2018-11-24T23:23:29+08:00	21854	35073	56927	2530	59457	101907	58.34%	21.45%	72	72
14	臺北市南港區	2018-11-24T22:15:59+08:00	21552	34645	56197	2498	58695	100518	58.39%	21.44%	71	72
14	臺北市南港區	2018-11-24T23:19:39+08:00	21854	35073	56927	2530	59457	101907	58.34%	21.45%	72	72
14	臺北市南港區	2018-11-25T01:17:39+08:00	21854	35073	56927	2530	59457	101907	58.34%	21.45%	72	72
14	臺北市南港區	2018-11-25T06:29:06+08:00	21854	35073	56927	2530	59457	101907	58.34%	21.45%	72	72
14	臺北市南港區	2018-11-24T22:33:28+08:00	21552	34645	56197	2498	58695	100518	58.39%	21.44%	71	72
14	臺北市南港區	2018-11-25T06:13:43+08:00	21854	35073	56927	2530	59457	101907	58.34%	21.45%	72	72
14	臺北市南港區	2018-11-24T23:43:07+08:00	21854	35073	56927	2530	59457	101907	58.34%	21.45%	72	72
14	臺北市南港區	2018-11-25T00:22:53+08:00	21854	35073	56927	2530	59457	101907	58.34%	21.45%	72	72
14	臺北市南港區	2018-11-25T03:56:00+08:00	21854	35073	56927	2530	59457	101907	58.34%	21.45%	72	72
14	臺北市南港區	2018-11-24T22:33:27+08:00	21552	34645	56197	2498	58695	100518	58.39%	21.44%	71	72
14	臺北市南港區	2018-11-25T03:49:42+08:00	21854	35073	56927	2530	59457	101907	58.34%	21.45%	72	72
14	臺北市南港區	2018-11-25T00:18:20+08:00	21854	35073	56927	2530	59457	101907	58.34%	21.45%	72	72
14	臺北市南港區	2018-11-25T04:02:38+08:00	21854	35073	56927	2530	59457	101907	58.34%	21.45%	72	72
14	桃園市大溪區	2018-11-25T01:07:17+08:00	11844	26711	38555	2818	41373	78285	52.85%	15.13%	59	59
14	桃園市大溪區	2018-11-25T06:08:42+08:00	11844	26711	38555	2818	41373	78285	52.85%	15.13%	59	59
14	桃園市大溪區	2018-11-24T23:47:18+08:00	11844	26711	38555	2818	41373	78285	52.85%	15.13%	59	59
14	桃園市大溪區	2018-11-24T23:35:02+08:00	11411	25645	37056	2719	39775	75496	52.68%	15.11%	57	59
14	桃園市大溪區	2018-11-24T22:26:29+08:00	8573	18918	27491	2086	29577	56242	52.59%	15.24%	43	59
14	桃園市大溪區	2018-11-24T22:16:00+08:00	7363	16105	23468	1741	25209	47868	52.66%	15.38%	37	59
14	桃園市大溪區	2018-11-24T23:51:25+08:00	11844	26711	38555	2818	41373	78285	52.85%	15.13%	59	59
14	桃園市大溪區	2018-11-25T00:04:56+08:00	11844	26711	38555	2818	41373	78285	52.85%	15.13%	59	59
14	桃園市大溪區	2018-11-24T22:19:28+08:00	7920	17384	25304	1889	27193	51628	52.67%	15.34%	40	59
14	桃園市大溪區	2018-11-25T00:57:27+08:00	11844	26711	38555	2818	41373	78285	52.85%	15.13%	59	59
14	桃園市大溪區	2018-11-24T22:57:43+08:00	10527	23546	34073	2561	36634	69564	52.66%	15.13%	53	59
14	桃園市大溪區	2018-11-24T22:13:17+08:00	7146	15589	22735	1694	24429	46461	52.58%	15.38%	36	59
14	桃園市大溪區	2018-11-24T23:23:30+08:00	11411	25645	37056	2719	39775	75496	52.68%	15.11%	57	59
14	桃園市大溪區	2018-11-24T22:29:55+08:00	9070	19927	28997	2155	31152	59368	52.47%	15.28%	45	59
14	桃園市大溪區	2018-11-24T23:08:25+08:00	10947	24646	35593	2605	38198	72525	52.67%	15.09%	55	59
14	桃園市大溪區	2018-11-24T23:55:38+08:00	11844	26711	38555	2818	41373	78285	52.85%	15.13%	59	59
14	桃園市大溪區	2018-11-25T03:38:46+08:00	11844	26711	38555	2818	41373	78285	52.85%	15.13%	59	59
14	桃園市大溪區	2018-11-24T23:59:58+08:00	11844	26711	38555	2818	41373	78285	52.85%	15.13%	59	59
14	桃園市大溪區	2018-11-25T03:32:25+08:00	11844	26711	38555	2818	41373	78285	52.85%	15.13%	59	59
14	桃園市大溪區	2018-11-24T23:15:53+08:00	11212	25162	36374	2656	39030	74002	52.74%	15.15%	56	59
14	桃園市大溪區	2018-11-24T22:40:19+08:00	9238	20284	29522	2189	31711	60374	52.52%	15.3%	46	59
14	桃園市大溪區	2018-11-25T01:25:43+08:00	11844	26711	38555	2818	41373	78285	52.85%	15.13%	59	59
14	桃園市大溪區	2018-11-25T06:23:51+08:00	11844	26711	38555	2818	41373	78285	52.85%	15.13%	59	59
14	桃園市大溪區	2018-11-24T22:54:17+08:00	9980	22014	31994	2445	34439	65433	52.63%	15.25%	50	59
14	桃園市大溪區	2018-11-24T22:45:00+08:00	9399	20613	30012	2230	32242	61430	52.49%	15.3%	47	59
14	桃園市大溪區	2018-11-24T23:01:21+08:00	10709	24046	34755	2583	37338	70933	52.64%	15.1%	54	59
14	桃園市大溪區	2018-11-24T23:31:01+08:00	11411	25645	37056	2719	39775	75496	52.68%	15.11%	57	59
14	桃園市大溪區	2018-11-25T00:09:23+08:00	11844	26711	38555	2818	41373	78285	52.85%	15.13%	59	59
14	桃園市大溪區	2018-11-24T22:41:27+08:00	9238	20284	29522	2189	31711	60374	52.52%	15.3%	46	59
14	桃園市大溪區	2018-11-24T22:50:37+08:00	9769	21516	31285	2376	33661	64064	52.54%	15.25%	49	59
14	桃園市大溪區	2018-11-25T00:14:00+08:00	11844	26711	38555	2818	41373	78285	52.85%	15.13%	59	59
14	桃園市大溪區	2018-11-24T23:12:05+08:00	10947	24646	35593	2605	38198	72525	52.67%	15.09%	55	59
14	桃園市大溪區	2018-11-24T23:39:04+08:00	11411	25645	37056	2719	39775	75496	52.68%	15.11%	57	59
14	桃園市大溪區	2018-11-25T01:12:32+08:00	11844	26711	38555	2818	41373	78285	52.85%	15.13%	59	59
14	桃園市大溪區	2018-11-25T01:17:41+08:00	11844	26711	38555	2818	41373	78285	52.85%	15.13%	59	59
14	桃園市大溪區	2018-11-25T03:44:11+08:00	11844	26711	38555	2818	41373	78285	52.85%	15.13%	59	59
14	桃園市大溪區	2018-11-24T22:23:03+08:00	8133	17887	26020	1966	27986	53345	52.46%	15.25%	41	59
14	桃園市大溪區	2018-11-25T06:18:48+08:00	11844	26711	38555	2818	41373	78285	52.85%	15.13%	59	59
14	桃園市大溪區	2018-11-24T23:04:55+08:00	10947	24646	35593	2605	38198	72525	52.67%	15.09%	55	59
14	桃園市大溪區	2018-11-24T23:27:10+08:00	11411	25645	37056	2719	39775	75496	52.68%	15.11%	57	59
14	桃園市大溪區	2018-11-24T22:36:52+08:00	9238	20284	29522	2189	31711	60374	52.52%	15.3%	46	59
14	桃園市大溪區	2018-11-25T01:02:21+08:00	11844	26711	38555	2818	41373	78285	52.85%	15.13%	59	59
14	桃園市大溪區	2018-11-24T23:19:39+08:00	11411	25645	37056	2719	39775	75496	52.68%	15.11%	57	59
14	桃園市大溪區	2018-11-25T00:22:55+08:00	11844	26711	38555	2818	41373	78285	52.85%	15.13%	59	59
14	桃園市大溪區	2018-11-25T06:29:06+08:00	11844	26711	38555	2818	41373	78285	52.85%	15.13%	59	59
14	桃園市大溪區	2018-11-25T03:56:01+08:00	11844	26711	38555	2818	41373	78285	52.85%	15.13%	59	59
14	桃園市大溪區	2018-11-24T22:33:28+08:00	9238	20284	29522	2189	31711	60374	52.52%	15.3%	46	59
14	桃園市大溪區	2018-11-25T06:13:43+08:00	11844	26711	38555	2818	41373	78285	52.85%	15.13%	59	59
14	桃園市大溪區	2018-11-25T04:02:39+08:00	11844	26711	38555	2818	41373	78285	52.85%	15.13%	59	59
14	桃園市大溪區	2018-11-25T00:18:21+08:00	11844	26711	38555	2818	41373	78285	52.85%	15.13%	59	59
14	桃園市大溪區	2018-11-25T03:49:42+08:00	11844	26711	38555	2818	41373	78285	52.85%	15.13%	59	59
14	桃園市大溪區	2018-11-24T23:43:08+08:00	11844	26711	38555	2818	41373	78285	52.85%	15.13%	59	59
14	苗栗縣通霄鎮	2018-11-25T04:02:44+08:00	4317	10427	14744	1336	16080	29709	54.13%	14.53%	34	34
14	苗栗縣通霄鎮	2018-11-24T23:31:05+08:00	4317	10427	14744	1336	16080	29709	54.13%	14.53%	34	34
14	苗栗縣通霄鎮	2018-11-25T00:09:29+08:00	4317	10427	14744	1336	16080	29709	54.13%	14.53%	34	34
14	苗栗縣通霄鎮	2018-11-25T01:07:21+08:00	4317	10427	14744	1336	16080	29709	54.13%	14.53%	34	34
14	苗栗縣通霄鎮	2018-11-25T01:12:38+08:00	4317	10427	14744	1336	16080	29709	54.13%	14.53%	34	34
14	苗栗縣通霄鎮	2018-11-25T00:14:05+08:00	4317	10427	14744	1336	16080	29709	54.13%	14.53%	34	34
14	苗栗縣通霄鎮	2018-11-24T23:19:45+08:00	4317	10427	14744	1336	16080	29709	54.13%	14.53%	34	34
14	苗栗縣通霄鎮	2018-11-24T22:23:07+08:00	3533	8486	12019	1068	13087	24253	53.96%	14.57%	29	34
14	苗栗縣通霄鎮	2018-11-25T00:00:03+08:00	4317	10427	14744	1336	16080	29709	54.13%	14.53%	34	34
14	苗栗縣通霄鎮	2018-11-24T23:08:31+08:00	3963	9479	13442	1218	14660	27281	53.74%	14.53%	32	34
14	苗栗縣通霄鎮	2018-11-25T03:32:30+08:00	4317	10427	14744	1336	16080	29709	54.13%	14.53%	34	34
14	苗栗縣通霄鎮	2018-11-24T23:51:30+08:00	4317	10427	14744	1336	16080	29709	54.13%	14.53%	34	34
14	苗栗縣通霄鎮	2018-11-24T22:30:01+08:00	3533	8486	12019	1068	13087	24253	53.96%	14.57%	29	34
14	苗栗縣通霄鎮	2018-11-24T23:27:14+08:00	4317	10427	14744	1336	16080	29709	54.13%	14.53%	34	34
14	苗栗縣通霄鎮	2018-11-24T22:19:32+08:00	3533	8486	12019	1068	13087	24253	53.96%	14.57%	29	34
14	苗栗縣通霄鎮	2018-11-25T00:57:32+08:00	4317	10427	14744	1336	16080	29709	54.13%	14.53%	34	34
14	苗栗縣通霄鎮	2018-11-24T22:36:56+08:00	3533	8486	12019	1068	13087	24253	53.96%	14.57%	29	34
14	苗栗縣通霄鎮	2018-11-25T00:18:25+08:00	4317	10427	14744	1336	16080	29709	54.13%	14.53%	34	34
14	苗栗縣通霄鎮	2018-11-24T23:05:00+08:00	3963	9479	13442	1218	14660	27281	53.74%	14.53%	32	34
14	苗栗縣通霄鎮	2018-11-25T03:49:47+08:00	4317	10427	14744	1336	16080	29709	54.13%	14.53%	34	34
14	苗栗縣通霄鎮	2018-11-24T22:26:32+08:00	3533	8486	12019	1068	13087	24253	53.96%	14.57%	29	34
14	苗栗縣通霄鎮	2018-11-25T06:13:48+08:00	4317	10427	14744	1336	16080	29709	54.13%	14.53%	34	34
14	苗栗縣通霄鎮	2018-11-24T22:50:42+08:00	3805	9135	12940	1144	14084	26143	53.87%	14.55%	31	34
14	苗栗縣通霄鎮	2018-11-24T22:54:21+08:00	3963	9479	13442	1218	14660	27281	53.74%	14.53%	32	34
14	苗栗縣通霄鎮	2018-11-25T00:05:00+08:00	4317	10427	14744	1336	16080	29709	54.13%	14.53%	34	34
14	苗栗縣通霄鎮	2018-11-24T22:41:30+08:00	3533	8486	12019	1068	13087	24253	53.96%	14.57%	29	34
14	苗栗縣通霄鎮	2018-11-25T00:22:59+08:00	4317	10427	14744	1336	16080	29709	54.13%	14.53%	34	34
14	苗栗縣通霄鎮	2018-11-24T22:16:05+08:00	3533	8486	12019	1068	13087	24253	53.96%	14.57%	29	34
14	苗栗縣通霄鎮	2018-11-24T23:01:26+08:00	3963	9479	13442	1218	14660	27281	53.74%	14.53%	32	34
14	苗栗縣通霄鎮	2018-11-24T22:33:33+08:00	3533	8486	12019	1068	13087	24253	53.96%	14.57%	29	34
14	苗栗縣通霄鎮	2018-11-24T23:43:13+08:00	4317	10427	14744	1336	16080	29709	54.13%	14.53%	34	34
14	苗栗縣通霄鎮	2018-11-25T06:08:47+08:00	4317	10427	14744	1336	16080	29709	54.13%	14.53%	34	34
14	苗栗縣通霄鎮	2018-11-24T23:35:06+08:00	4317	10427	14744	1336	16080	29709	54.13%	14.53%	34	34
14	苗栗縣通霄鎮	2018-11-24T23:47:23+08:00	4317	10427	14744	1336	16080	29709	54.13%	14.53%	34	34
14	苗栗縣通霄鎮	2018-11-25T06:29:12+08:00	4317	10427	14744	1336	16080	29709	54.13%	14.53%	34	34
14	苗栗縣通霄鎮	2018-11-24T23:55:42+08:00	4317	10427	14744	1336	16080	29709	54.13%	14.53%	34	34
14	苗栗縣通霄鎮	2018-11-25T01:17:46+08:00	4317	10427	14744	1336	16080	29709	54.13%	14.53%	34	34
14	苗栗縣通霄鎮	2018-11-24T22:57:48+08:00	3963	9479	13442	1218	14660	27281	53.74%	14.53%	32	34
14	苗栗縣通霄鎮	2018-11-25T03:38:50+08:00	4317	10427	14744	1336	16080	29709	54.13%	14.53%	34	34
14	苗栗縣通霄鎮	2018-11-24T23:23:34+08:00	4317	10427	14744	1336	16080	29709	54.13%	14.53%	34	34
14	苗栗縣通霄鎮	2018-11-24T22:13:22+08:00	3533	8486	12019	1068	13087	24253	53.96%	14.57%	29	34
14	苗栗縣通霄鎮	2018-11-25T03:44:17+08:00	4317	10427	14744	1336	16080	29709	54.13%	14.53%	34	34
14	苗栗縣通霄鎮	2018-11-25T01:25:48+08:00	4317	10427	14744	1336	16080	29709	54.13%	14.53%	34	34
14	苗栗縣通霄鎮	2018-11-24T22:40:23+08:00	3533	8486	12019	1068	13087	24253	53.96%	14.57%	29	34
14	苗栗縣通霄鎮	2018-11-24T23:15:58+08:00	4317	10427	14744	1336	16080	29709	54.13%	14.53%	34	34
14	苗栗縣通霄鎮	2018-11-25T01:02:26+08:00	4317	10427	14744	1336	16080	29709	54.13%	14.53%	34	34
14	苗栗縣通霄鎮	2018-11-25T06:18:53+08:00	4317	10427	14744	1336	16080	29709	54.13%	14.53%	34	34
14	苗栗縣通霄鎮	2018-11-25T06:23:55+08:00	4317	10427	14744	1336	16080	29709	54.13%	14.53%	34	34
14	苗栗縣通霄鎮	2018-11-24T23:39:10+08:00	4317	10427	14744	1336	16080	29709	54.13%	14.53%	34	34
14	苗栗縣通霄鎮	2018-11-25T03:56:07+08:00	4317	10427	14744	1336	16080	29709	54.13%	14.53%	34	34
14	苗栗縣通霄鎮	2018-11-24T22:45:04+08:00	3646	8773	12419	1095	13514	25022	54.01%	14.57%	30	34
14	苗栗縣通霄鎮	2018-11-24T23:12:10+08:00	3963	9479	13442	1218	14660	27281	53.74%	14.53%	32	34
14	苗栗縣三義鄉	2018-11-25T04:02:44+08:00	1971	5796	7767	381	8148	13889	58.67%	14.19%	16	16
14	苗栗縣三義鄉	2018-11-25T00:09:29+08:00	1971	5796	7767	381	8148	13889	58.67%	14.19%	16	16
14	苗栗縣三義鄉	2018-11-25T01:12:38+08:00	1971	5796	7767	381	8148	13889	58.67%	14.19%	16	16
14	苗栗縣三義鄉	2018-11-25T00:14:05+08:00	1971	5796	7767	381	8148	13889	58.67%	14.19%	16	16
14	苗栗縣三義鄉	2018-11-24T23:19:45+08:00	1971	5796	7767	381	8148	13889	58.67%	14.19%	16	16
14	苗栗縣三義鄉	2018-11-25T00:00:03+08:00	1971	5796	7767	381	8148	13889	58.67%	14.19%	16	16
14	苗栗縣三義鄉	2018-11-24T22:23:08+08:00	1620	4850	6470	343	6813	11475	59.37%	14.12%	14	16
14	苗栗縣三義鄉	2018-11-24T23:08:31+08:00	1971	5796	7767	381	8148	13889	58.67%	14.19%	16	16
14	苗栗縣三義鄉	2018-11-25T03:32:30+08:00	1971	5796	7767	381	8148	13889	58.67%	14.19%	16	16
14	苗栗縣三義鄉	2018-11-24T23:51:30+08:00	1971	5796	7767	381	8148	13889	58.67%	14.19%	16	16
14	苗栗縣三義鄉	2018-11-24T22:30:01+08:00	1797	5307	7104	360	7464	12691	58.81%	14.16%	15	16
14	苗栗縣三義鄉	2018-11-24T23:27:14+08:00	1971	5796	7767	381	8148	13889	58.67%	14.19%	16	16
14	苗栗縣三義鄉	2018-11-24T22:19:33+08:00	1545	4421	5966	325	6291	10622	59.23%	14.55%	13	16
14	苗栗縣三義鄉	2018-11-25T00:57:32+08:00	1971	5796	7767	381	8148	13889	58.67%	14.19%	16	16
14	苗栗縣三義鄉	2018-11-24T22:36:56+08:00	1797	5307	7104	360	7464	12691	58.81%	14.16%	15	16
14	苗栗縣三義鄉	2018-11-24T22:50:43+08:00	1971	5796	7767	381	8148	13889	58.67%	14.19%	16	16
14	苗栗縣三義鄉	2018-11-25T00:18:25+08:00	1971	5796	7767	381	8148	13889	58.67%	14.19%	16	16
14	苗栗縣三義鄉	2018-11-25T06:23:56+08:00	1971	5796	7767	381	8148	13889	58.67%	14.19%	16	16
14	苗栗縣三義鄉	2018-11-24T22:26:33+08:00	1797	5307	7104	360	7464	12691	58.81%	14.16%	15	16
14	苗栗縣三義鄉	2018-11-25T03:49:47+08:00	1971	5796	7767	381	8148	13889	58.67%	14.19%	16	16
14	苗栗縣三義鄉	2018-11-24T22:41:31+08:00	1971	5796	7767	381	8148	13889	58.67%	14.19%	16	16
14	苗栗縣三義鄉	2018-11-25T00:05:01+08:00	1971	5796	7767	381	8148	13889	58.67%	14.19%	16	16
14	苗栗縣三義鄉	2018-11-25T06:13:48+08:00	1971	5796	7767	381	8148	13889	58.67%	14.19%	16	16
14	苗栗縣三義鄉	2018-11-25T00:22:59+08:00	1971	5796	7767	381	8148	13889	58.67%	14.19%	16	16
14	苗栗縣三義鄉	2018-11-24T23:05:01+08:00	1971	5796	7767	381	8148	13889	58.67%	14.19%	16	16
14	苗栗縣三義鄉	2018-11-24T23:31:06+08:00	1971	5796	7767	381	8148	13889	58.67%	14.19%	16	16
14	苗栗縣三義鄉	2018-11-24T22:16:05+08:00	1545	4421	5966	325	6291	10622	59.23%	14.55%	13	16
14	苗栗縣三義鄉	2018-11-25T06:08:48+08:00	1971	5796	7767	381	8148	13889	58.67%	14.19%	16	16
14	苗栗縣三義鄉	2018-11-25T01:07:22+08:00	1971	5796	7767	381	8148	13889	58.67%	14.19%	16	16
14	苗栗縣三義鄉	2018-11-24T22:33:33+08:00	1797	5307	7104	360	7464	12691	58.81%	14.16%	15	16
14	苗栗縣三義鄉	2018-11-24T23:43:13+08:00	1971	5796	7767	381	8148	13889	58.67%	14.19%	16	16
14	苗栗縣三義鄉	2018-11-24T23:01:27+08:00	1971	5796	7767	381	8148	13889	58.67%	14.19%	16	16
14	苗栗縣三義鄉	2018-11-24T23:35:06+08:00	1971	5796	7767	381	8148	13889	58.67%	14.19%	16	16
14	苗栗縣三義鄉	2018-11-25T06:29:12+08:00	1971	5796	7767	381	8148	13889	58.67%	14.19%	16	16
14	苗栗縣三義鄉	2018-11-24T23:47:24+08:00	1971	5796	7767	381	8148	13889	58.67%	14.19%	16	16
14	苗栗縣三義鄉	2018-11-24T23:55:42+08:00	1971	5796	7767	381	8148	13889	58.67%	14.19%	16	16
14	苗栗縣三義鄉	2018-11-24T22:57:48+08:00	1971	5796	7767	381	8148	13889	58.67%	14.19%	16	16
14	苗栗縣三義鄉	2018-11-24T23:23:34+08:00	1971	5796	7767	381	8148	13889	58.67%	14.19%	16	16
14	苗栗縣三義鄉	2018-11-25T03:38:51+08:00	1971	5796	7767	381	8148	13889	58.67%	14.19%	16	16
14	苗栗縣三義鄉	2018-11-24T22:13:22+08:00	1545	4421	5966	325	6291	10622	59.23%	14.55%	13	16
14	苗栗縣三義鄉	2018-11-25T01:17:47+08:00	1971	5796	7767	381	8148	13889	58.67%	14.19%	16	16
14	苗栗縣三義鄉	2018-11-25T03:44:17+08:00	1971	5796	7767	381	8148	13889	58.67%	14.19%	16	16
14	苗栗縣三義鄉	2018-11-25T01:25:48+08:00	1971	5796	7767	381	8148	13889	58.67%	14.19%	16	16
14	苗栗縣三義鄉	2018-11-24T22:40:24+08:00	1971	5796	7767	381	8148	13889	58.67%	14.19%	16	16
14	苗栗縣三義鄉	2018-11-25T01:02:26+08:00	1971	5796	7767	381	8148	13889	58.67%	14.19%	16	16
14	苗栗縣三義鄉	2018-11-24T23:15:59+08:00	1971	5796	7767	381	8148	13889	58.67%	14.19%	16	16
14	苗栗縣三義鄉	2018-11-25T06:18:53+08:00	1971	5796	7767	381	8148	13889	58.67%	14.19%	16	16
14	苗栗縣三義鄉	2018-11-24T23:12:11+08:00	1971	5796	7767	381	8148	13889	58.67%	14.19%	16	16
14	苗栗縣三義鄉	2018-11-24T23:39:10+08:00	1971	5796	7767	381	8148	13889	58.67%	14.19%	16	16
14	苗栗縣三義鄉	2018-11-25T03:56:07+08:00	1971	5796	7767	381	8148	13889	58.67%	14.19%	16	16
14	苗栗縣三義鄉	2018-11-24T22:45:04+08:00	1971	5796	7767	381	8148	13889	58.67%	14.19%	16	16
14	苗栗縣三義鄉	2018-11-24T22:54:22+08:00	1971	5796	7767	381	8148	13889	58.67%	14.19%	16	16
14	高雄市旗津區	2018-11-25T06:29:10+08:00	3934	8078	12012	969	12981	24860	52.22%	15.82%	18	18
14	高雄市旗津區	2018-11-24T23:35:04+08:00	3693	7328	11021	870	11891	22815	52.12%	16.19%	17	18
14	高雄市旗津區	2018-11-25T00:14:03+08:00	3934	8078	12012	969	12981	24860	52.22%	15.82%	18	18
14	高雄市旗津區	2018-11-24T23:01:25+08:00	3693	7328	11021	870	11891	22815	52.12%	16.19%	17	18
14	高雄市旗津區	2018-11-24T23:12:09+08:00	3693	7328	11021	870	11891	22815	52.12%	16.19%	17	18
14	高雄市旗津區	2018-11-25T06:08:45+08:00	3934	8078	12012	969	12981	24860	52.22%	15.82%	18	18
14	高雄市旗津區	2018-11-24T23:43:11+08:00	3934	8078	12012	969	12981	24860	52.22%	15.82%	18	18
14	高雄市旗津區	2018-11-24T23:39:08+08:00	3693	7328	11021	870	11891	22815	52.12%	16.19%	17	18
14	高雄市旗津區	2018-11-25T00:09:27+08:00	3934	8078	12012	969	12981	24860	52.22%	15.82%	18	18
14	高雄市旗津區	2018-11-24T22:33:31+08:00	3693	7328	11021	870	11891	22815	52.12%	16.19%	17	18
14	高雄市旗津區	2018-11-25T01:12:36+08:00	3934	8078	12012	969	12981	24860	52.22%	15.82%	18	18
14	高雄市旗津區	2018-11-25T04:02:42+08:00	3934	8078	12012	969	12981	24860	52.22%	15.82%	18	18
14	高雄市旗津區	2018-11-25T01:07:20+08:00	3934	8078	12012	969	12981	24860	52.22%	15.82%	18	18
14	高雄市旗津區	2018-11-24T23:31:04+08:00	3693	7328	11021	870	11891	22815	52.12%	16.19%	17	18
14	高雄市旗津區	2018-11-25T03:44:15+08:00	3934	8078	12012	969	12981	24860	52.22%	15.82%	18	18
14	高雄市旗津區	2018-11-24T22:13:20+08:00	3693	7328	11021	870	11891	22815	52.12%	16.19%	17	18
14	高雄市旗津區	2018-11-24T23:55:41+08:00	3934	8078	12012	969	12981	24860	52.22%	15.82%	18	18
14	高雄市旗津區	2018-11-24T22:23:06+08:00	3693	7328	11021	870	11891	22815	52.12%	16.19%	17	18
14	高雄市旗津區	2018-11-24T23:19:43+08:00	3693	7328	11021	870	11891	22815	52.12%	16.19%	17	18
14	高雄市旗津區	2018-11-25T01:17:44+08:00	3934	8078	12012	969	12981	24860	52.22%	15.82%	18	18
14	高雄市旗津區	2018-11-24T23:04:58+08:00	3693	7328	11021	870	11891	22815	52.12%	16.19%	17	18
14	高雄市旗津區	2018-11-25T00:00:02+08:00	3934	8078	12012	969	12981	24860	52.22%	15.82%	18	18
14	高雄市旗津區	2018-11-25T00:04:59+08:00	3934	8078	12012	969	12981	24860	52.22%	15.82%	18	18
14	高雄市旗津區	2018-11-25T06:18:51+08:00	3934	8078	12012	969	12981	24860	52.22%	15.82%	18	18
14	高雄市旗津區	2018-11-25T01:02:24+08:00	3934	8078	12012	969	12981	24860	52.22%	15.82%	18	18
14	高雄市旗津區	2018-11-24T23:27:13+08:00	3693	7328	11021	870	11891	22815	52.12%	16.19%	17	18
14	高雄市旗津區	2018-11-25T03:38:49+08:00	3934	8078	12012	969	12981	24860	52.22%	15.82%	18	18
14	高雄市旗津區	2018-11-24T22:30:00+08:00	3693	7328	11021	870	11891	22815	52.12%	16.19%	17	18
14	高雄市旗津區	2018-11-24T22:54:20+08:00	3693	7328	11021	870	11891	22815	52.12%	16.19%	17	18
14	高雄市旗津區	2018-11-25T03:56:05+08:00	3934	8078	12012	969	12981	24860	52.22%	15.82%	18	18
14	高雄市旗津區	2018-11-25T00:18:23+08:00	3934	8078	12012	969	12981	24860	52.22%	15.82%	18	18
14	高雄市旗津區	2018-11-25T06:13:46+08:00	3934	8078	12012	969	12981	24860	52.22%	15.82%	18	18
14	高雄市旗津區	2018-11-25T00:22:57+08:00	3934	8078	12012	969	12981	24860	52.22%	15.82%	18	18
14	高雄市旗津區	2018-11-24T23:47:22+08:00	3934	8078	12012	969	12981	24860	52.22%	15.82%	18	18
14	高雄市旗津區	2018-11-24T22:41:29+08:00	3693	7328	11021	870	11891	22815	52.12%	16.19%	17	18
14	高雄市旗津區	2018-11-24T22:16:03+08:00	3693	7328	11021	870	11891	22815	52.12%	16.19%	17	18
14	高雄市旗津區	2018-11-24T23:23:32+08:00	3693	7328	11021	870	11891	22815	52.12%	16.19%	17	18
14	高雄市旗津區	2018-11-24T23:51:28+08:00	3934	8078	12012	969	12981	24860	52.22%	15.82%	18	18
14	高雄市旗津區	2018-11-24T22:57:47+08:00	3693	7328	11021	870	11891	22815	52.12%	16.19%	17	18
14	高雄市旗津區	2018-11-25T01:25:46+08:00	3934	8078	12012	969	12981	24860	52.22%	15.82%	18	18
14	高雄市旗津區	2018-11-24T22:19:31+08:00	3693	7328	11021	870	11891	22815	52.12%	16.19%	17	18
14	高雄市旗津區	2018-11-25T00:57:30+08:00	3934	8078	12012	969	12981	24860	52.22%	15.82%	18	18
14	高雄市旗津區	2018-11-24T22:40:22+08:00	3693	7328	11021	870	11891	22815	52.12%	16.19%	17	18
14	高雄市旗津區	2018-11-24T22:36:55+08:00	3693	7328	11021	870	11891	22815	52.12%	16.19%	17	18
14	高雄市旗津區	2018-11-24T23:08:29+08:00	3693	7328	11021	870	11891	22815	52.12%	16.19%	17	18
14	高雄市旗津區	2018-11-24T23:15:57+08:00	3693	7328	11021	870	11891	22815	52.12%	16.19%	17	18
14	高雄市旗津區	2018-11-25T03:32:28+08:00	3934	8078	12012	969	12981	24860	52.22%	15.82%	18	18
14	高雄市旗津區	2018-11-25T03:49:45+08:00	3934	8078	12012	969	12981	24860	52.22%	15.82%	18	18
14	高雄市旗津區	2018-11-25T06:23:54+08:00	3934	8078	12012	969	12981	24860	52.22%	15.82%	18	18
14	高雄市旗津區	2018-11-24T22:26:31+08:00	3693	7328	11021	870	11891	22815	52.12%	16.19%	17	18
14	高雄市旗津區	2018-11-24T22:50:41+08:00	3693	7328	11021	870	11891	22815	52.12%	16.19%	17	18
14	高雄市旗津區	2018-11-24T22:45:03+08:00	3693	7328	11021	870	11891	22815	52.12%	16.19%	17	18
14	高雄市	2018-11-25T06:29:10+08:00	427186	885698	1312884	74414	1387298	2353342	58.95%	18.15%	823	1
14	高雄市	2018-11-24T23:35:04+08:00	351591	727755	1079346	63250	1142596	1941069	58.86%	18.11%	574	1
14	高雄市	2018-11-24T23:47:21+08:00	368549	762652	1131201	65962	1197163	2031385	58.93%	18.14%	631	1
14	高雄市	2018-11-24T23:12:09+08:00	318659	659331	977990	58509	1036499	1761834	58.83%	18.09%	462	1
14	高雄市	2018-11-25T06:08:45+08:00	427186	885698	1312884	74414	1387298	2353342	58.95%	18.15%	823	1
14	高雄市	2018-11-24T23:43:11+08:00	364443	753736	1118179	65348	1183527	2008795	58.92%	18.14%	617	1
14	高雄市	2018-11-25T01:07:19+08:00	417238	864539	1281777	73048	1354825	2297680	58.96%	18.16%	791	1
14	高雄市	2018-11-24T22:33:31+08:00	259144	538972	798116	49043	847159	1443964	58.67%	17.95%	246	1
14	高雄市	2018-11-25T00:14:02+08:00	391472	811625	1203097	69417	1272514	2158266	58.96%	18.14%	711	1
14	高雄市	2018-11-25T04:02:42+08:00	427186	885698	1312884	74414	1387298	2353342	58.95%	18.15%	823	1
14	高雄市	2018-11-25T00:09:26+08:00	385826	799048	1184874	68480	1253354	2125935	58.96%	18.15%	691	1
14	高雄市	2018-11-24T23:39:07+08:00	355424	735503	1090927	63802	1154729	1961557	58.87%	18.12%	588	1
14	高雄市	2018-11-24T23:31:03+08:00	347763	719674	1067437	62700	1130137	1920178	58.86%	18.11%	561	1
14	高雄市	2018-11-24T23:01:24+08:00	308362	639149	947511	56870	1004381	1708565	58.79%	18.05%	425	1
14	高雄市	2018-11-25T03:44:15+08:00	426898	884937	1311835	74349	1386184	2351297	58.95%	18.16%	822	1
14	高雄市	2018-11-24T23:19:42+08:00	330560	684269	1014829	60214	1075043	1827255	58.83%	18.09%	504	1
14	高雄市	2018-11-24T22:13:20+08:00	224461	468582	693043	43447	736490	1256056	58.64%	17.87%	116	1
14	高雄市	2018-11-25T00:04:58+08:00	383448	794169	1177617	68170	1245787	2113128	58.95%	18.15%	683	1
14	高雄市	2018-11-24T23:04:57+08:00	313296	648189	961485	57560	1019045	1732723	58.81%	18.08%	441	1
14	高雄市	2018-11-25T01:17:44+08:00	418932	868341	1287273	73281	1360554	2307433	58.96%	18.16%	796	1
14	高雄市	2018-11-24T23:55:40+08:00	377045	780874	1157919	67245	1225164	2078415	58.95%	18.14%	660	1
14	高雄市	2018-11-25T06:18:51+08:00	427186	885698	1312884	74414	1387298	2353342	58.95%	18.15%	823	1
14	高雄市	2018-11-25T01:02:24+08:00	415826	861380	1277206	72895	1350101	2289722	58.96%	18.16%	787	1
14	高雄市	2018-11-25T03:38:49+08:00	426898	884937	1311835	74349	1386184	2351297	58.95%	18.16%	822	1
14	高雄市	2018-11-24T23:27:12+08:00	339756	703256	1043012	61485	1104497	1877212	58.84%	18.1%	534	1
14	高雄市	2018-11-24T22:54:20+08:00	294549	611287	905836	54851	960687	1635995	58.72%	18%	377	1
14	高雄市	2018-11-25T00:18:23+08:00	393355	815730	1209085	69723	1278808	2168596	58.97%	18.14%	717	1
14	高雄市	2018-11-25T06:13:46+08:00	427186	885698	1312884	74414	1387298	2353342	58.95%	18.15%	823	1
14	高雄市	2018-11-25T00:22:57+08:00	396569	822221	1218790	70334	1289124	2186209	58.97%	18.14%	728	1
14	高雄市	2018-11-25T03:56:04+08:00	427186	885698	1312884	74414	1387298	2353342	58.95%	18.15%	823	1
14	高雄市	2018-11-24T22:41:29+08:00	275541	573536	849077	51882	900959	1535290	58.68%	17.95%	309	1
14	高雄市	2018-11-24T22:16:03+08:00	230559	480436	710995	44375	755370	1289218	58.59%	17.88%	137	1
14	高雄市	2018-11-25T01:12:35+08:00	417794	866071	1283865	73159	1357024	2301497	58.96%	18.15%	793	1
14	高雄市	2018-11-24T22:29:59+08:00	255012	530112	785124	48396	833520	1420927	58.66%	17.95%	230	1
14	高雄市	2018-11-24T23:23:32+08:00	336376	696235	1032611	60924	1093535	1858739	58.83%	18.1%	523	1
14	高雄市	2018-11-24T23:51:28+08:00	371143	768350	1139493	66428	1205921	2046399	58.93%	18.14%	641	1
14	高雄市	2018-11-24T22:57:46+08:00	302423	626657	929080	55918	984998	1675772	58.78%	18.05%	403	1
14	高雄市	2018-11-25T00:00:01+08:00	379892	786633	1166525	67653	1234178	2093370	58.96%	18.15%	670	1
14	高雄市	2018-11-24T22:23:05+08:00	244934	509644	754578	46832	801410	1366874	58.63%	17.92%	191	1
14	高雄市	2018-11-24T22:36:54+08:00	271324	564915	836239	51180	887419	1512997	58.65%	17.93%	293	1
14	高雄市	2018-11-25T01:25:46+08:00	420322	871288	1291610	73499	1365109	2316269	58.94%	18.15%	801	1
14	高雄市	2018-11-24T22:19:31+08:00	238768	495963	734731	45572	780303	1331568	58.6%	17.93%	167	1
14	高雄市	2018-11-25T00:57:30+08:00	414912	859556	1274468	72771	1347239	2284386	58.98%	18.16%	784	1
14	高雄市	2018-11-24T23:08:28+08:00	316288	654282	970570	58074	1028644	1748430	58.83%	18.09%	452	1
14	高雄市	2018-11-24T22:40:22+08:00	275541	573536	849077	51882	900959	1535290	58.68%	17.95%	309	1
14	高雄市	2018-11-24T23:15:57+08:00	327233	677924	1005157	59790	1064947	1810225	58.83%	18.08%	493	1
14	高雄市	2018-11-25T03:32:28+08:00	426898	884937	1311835	74349	1386184	2351297	58.95%	18.16%	822	1
14	高雄市	2018-11-24T22:45:02+08:00	279772	582456	862228	52577	914805	1558652	58.69%	17.95%	325	1
14	高雄市	2018-11-24T22:50:40+08:00	290673	603629	894302	54117	948419	1615267	58.72%	18%	363	1
14	高雄市	2018-11-25T03:49:45+08:00	427186	885698	1312884	74414	1387298	2353342	58.95%	18.15%	823	1
14	高雄市	2018-11-25T06:23:54+08:00	427186	885698	1312884	74414	1387298	2353342	58.95%	18.15%	823	1
14	高雄市	2018-11-24T22:26:31+08:00	250410	521521	771931	47705	819636	1397507	58.65%	17.92%	213	1
14	澎湖縣	2018-11-24T22:33:39+08:00	6669	16922	23591	1835	25426	57958	43.87%	11.51%	90	116
14	澎湖縣	2018-11-25T03:49:52+08:00	11008	27052	38060	2692	40752	90405	45.08%	12.18%	116	116
14	澎湖縣	2018-11-24T23:43:18+08:00	9203	23677	32880	2439	35319	79372	44.5%	11.59%	108	116
14	澎湖縣	2018-11-24T23:47:29+08:00	9203	23677	32880	2439	35319	79372	44.5%	11.59%	108	116
14	澎湖縣	2018-11-25T06:29:18+08:00	11008	27052	38060	2692	40752	90405	45.08%	12.18%	116	116
14	澎湖縣	2018-11-25T01:07:27+08:00	11008	27052	38060	2692	40752	90405	45.08%	12.18%	116	116
14	澎湖縣	2018-11-25T06:13:53+08:00	11008	27052	38060	2692	40752	90405	45.08%	12.18%	116	116
14	澎湖縣	2018-11-25T00:18:31+08:00	10846	26582	37428	2648	40076	89057	45%	12.18%	115	116
14	澎湖縣	2018-11-24T22:37:01+08:00	7113	18092	25205	1943	27148	62047	43.75%	11.46%	94	116
14	澎湖縣	2018-11-25T03:44:24+08:00	11008	27052	38060	2692	40752	90405	45.08%	12.18%	116	116
14	澎湖縣	2018-11-24T23:08:37+08:00	7611	19388	26999	2071	29070	65840	44.15%	11.56%	97	116
14	澎湖縣	2018-11-24T23:55:48+08:00	9203	23677	32880	2439	35319	79372	44.5%	11.59%	108	116
14	澎湖縣	2018-11-24T22:13:28+08:00	5579	14072	19651	1552	21203	49263	43.04%	11.32%	81	116
14	澎湖縣	2018-11-24T23:23:39+08:00	8490	21851	30341	2328	32669	73617	44.38%	11.53%	103	116
14	澎湖縣	2018-11-25T06:18:58+08:00	11008	27052	38060	2692	40752	90405	45.08%	12.18%	116	116
14	澎湖縣	2018-11-24T23:51:36+08:00	9203	23677	32880	2439	35319	79372	44.5%	11.59%	108	116
14	澎湖縣	2018-11-24T22:23:14+08:00	6119	15487	21606	1660	23266	53148	43.78%	11.51%	84	116
14	澎湖縣	2018-11-24T22:40:28+08:00	7325	18655	25980	1979	27959	63601	43.96%	11.52%	95	116
14	澎湖縣	2018-11-25T00:09:35+08:00	9897	25408	35305	2539	37844	84247	44.92%	11.75%	112	116
14	澎湖縣	2018-11-25T00:05:06+08:00	9897	25408	35305	2539	37844	84247	44.92%	11.75%	112	116
14	澎湖縣	2018-11-24T23:35:11+08:00	9203	23677	32880	2439	35319	79372	44.5%	11.59%	108	116
14	澎湖縣	2018-11-24T22:41:36+08:00	7325	18655	25980	1979	27959	63601	43.96%	11.52%	95	116
14	澎湖縣	2018-11-24T22:45:09+08:00	7325	18655	25980	1979	27959	63601	43.96%	11.52%	95	116
14	澎湖縣	2018-11-24T22:54:26+08:00	7325	18655	25980	1979	27959	63601	43.96%	11.52%	95	116
14	澎湖縣	2018-11-25T00:14:10+08:00	10701	26141	36842	2602	39444	87773	44.94%	12.19%	114	116
14	澎湖縣	2018-11-25T03:56:13+08:00	11008	27052	38060	2692	40752	90405	45.08%	12.18%	116	116
14	澎湖縣	2018-11-24T23:16:04+08:00	8073	20811	28884	2172	31056	69980	44.38%	11.54%	100	116
14	澎湖縣	2018-11-25T03:32:35+08:00	11008	27052	38060	2692	40752	90405	45.08%	12.18%	116	116
14	澎湖縣	2018-11-25T01:25:53+08:00	11008	27052	38060	2692	40752	90405	45.08%	12.18%	116	116
14	澎湖縣	2018-11-25T01:02:32+08:00	11008	27052	38060	2692	40752	90405	45.08%	12.18%	116	116
14	澎湖縣	2018-11-24T22:30:10+08:00	6571	16584	23155	1816	24971	56785	43.97%	11.57%	89	116
14	澎湖縣	2018-11-25T00:23:04+08:00	10846	26582	37428	2648	40076	89057	45%	12.18%	115	116
14	澎湖縣	2018-11-25T06:24:01+08:00	11008	27052	38060	2692	40752	90405	45.08%	12.18%	116	116
14	澎湖縣	2018-11-25T03:38:56+08:00	11008	27052	38060	2692	40752	90405	45.08%	12.18%	116	116
14	澎湖縣	2018-11-24T23:27:19+08:00	8635	22189	30824	2349	33173	74618	44.46%	11.57%	104	116
14	澎湖縣	2018-11-24T22:19:38+08:00	6001	15177	21178	1636	22814	52256	43.66%	11.48%	83	116
14	澎湖縣	2018-11-25T01:17:53+08:00	11008	27052	38060	2692	40752	90405	45.08%	12.18%	116	116
14	澎湖縣	2018-11-25T00:00:12+08:00	9410	24197	33607	2466	36073	80812	44.64%	11.64%	109	116
14	澎湖縣	2018-11-24T22:57:55+08:00	7325	18655	25980	1979	27959	63601	43.96%	11.52%	95	116
14	澎湖縣	2018-11-24T23:19:52+08:00	8350	21567	29917	2251	32168	72188	44.56%	11.57%	102	116
14	澎湖縣	2018-11-25T00:57:38+08:00	11008	27052	38060	2692	40752	90405	45.08%	12.18%	116	116
14	澎湖縣	2018-11-25T06:08:54+08:00	11008	27052	38060	2692	40752	90405	45.08%	12.18%	116	116
14	澎湖縣	2018-11-24T23:12:16+08:00	7611	19388	26999	2071	29070	65840	44.15%	11.56%	97	116
14	澎湖縣	2018-11-24T23:39:17+08:00	9203	23677	32880	2439	35319	79372	44.5%	11.59%	108	116
14	澎湖縣	2018-11-25T01:12:44+08:00	11008	27052	38060	2692	40752	90405	45.08%	12.18%	116	116
14	澎湖縣	2018-11-24T22:50:49+08:00	7325	18655	25980	1979	27959	63601	43.96%	11.52%	95	116
14	澎湖縣	2018-11-24T22:26:37+08:00	6344	16069	22413	1749	24162	55006	43.93%	11.53%	86	116
14	澎湖縣	2018-11-25T04:02:53+08:00	11008	27052	38060	2692	40752	90405	45.08%	12.18%	116	116
14	澎湖縣	2018-11-24T23:05:05+08:00	7611	19388	26999	2071	29070	65840	44.15%	11.56%	97	116
14	澎湖縣	2018-11-24T23:31:12+08:00	9139	23542	32681	2437	35118	78896	44.51%	11.58%	107	116
14	澎湖縣	2018-11-24T22:16:11+08:00	5805	14677	20482	1583	22065	50744	43.48%	11.44%	82	116
14	澎湖縣	2018-11-24T23:01:32+08:00	7325	18655	25980	1979	27959	63601	43.96%	11.52%	95	116
14	南投縣竹山鎮	2018-11-25T01:12:39+08:00	6548	17847	24395	1714	26109	47034	55.51%	13.92%	53	53
14	南投縣竹山鎮	2018-11-24T22:16:06+08:00	5321	14574	19895	1345	21240	38285	55.48%	13.9%	45	53
14	南投縣竹山鎮	2018-11-25T04:02:45+08:00	6548	17847	24395	1714	26109	47034	55.51%	13.92%	53	53
14	南投縣竹山鎮	2018-11-24T22:23:09+08:00	5425	14880	20305	1368	21673	39193	55.3%	13.84%	46	53
14	南投縣竹山鎮	2018-11-25T03:32:31+08:00	6548	17847	24395	1714	26109	47034	55.51%	13.92%	53	53
14	南投縣竹山鎮	2018-11-25T00:00:04+08:00	6548	17847	24395	1714	26109	47034	55.51%	13.92%	53	53
14	南投縣竹山鎮	2018-11-25T03:38:52+08:00	6548	17847	24395	1714	26109	47034	55.51%	13.92%	53	53
14	南投縣竹山鎮	2018-11-25T00:23:00+08:00	6548	17847	24395	1714	26109	47034	55.51%	13.92%	53	53
14	南投縣竹山鎮	2018-11-24T22:36:57+08:00	5568	15316	20884	1421	22305	40415	55.19%	13.78%	47	53
14	南投縣竹山鎮	2018-11-25T00:57:33+08:00	6548	17847	24395	1714	26109	47034	55.51%	13.92%	53	53
14	南投縣竹山鎮	2018-11-24T23:51:31+08:00	6548	17847	24395	1714	26109	47034	55.51%	13.92%	53	53
14	南投縣竹山鎮	2018-11-24T23:27:15+08:00	6548	17847	24395	1714	26109	47034	55.51%	13.92%	53	53
14	南投縣竹山鎮	2018-11-24T22:19:34+08:00	5425	14880	20305	1368	21673	39193	55.3%	13.84%	46	53
14	南投縣竹山鎮	2018-11-24T22:50:44+08:00	5691	15560	21251	1476	22727	41236	55.11%	13.8%	48	53
14	南投縣竹山鎮	2018-11-24T23:12:12+08:00	6374	17360	23734	1672	25406	45864	55.39%	13.9%	52	53
14	南投縣竹山鎮	2018-11-25T06:13:49+08:00	6548	17847	24395	1714	26109	47034	55.51%	13.92%	53	53
14	南投縣竹山鎮	2018-11-24T22:26:33+08:00	5425	14880	20305	1368	21673	39193	55.3%	13.84%	46	53
14	南投縣竹山鎮	2018-11-25T00:05:01+08:00	6548	17847	24395	1714	26109	47034	55.51%	13.92%	53	53
14	南投縣竹山鎮	2018-11-25T06:23:57+08:00	6548	17847	24395	1714	26109	47034	55.51%	13.92%	53	53
14	南投縣竹山鎮	2018-11-25T03:49:48+08:00	6548	17847	24395	1714	26109	47034	55.51%	13.92%	53	53
14	南投縣竹山鎮	2018-11-24T23:05:01+08:00	5890	16097	21987	1515	23502	42522	55.27%	13.85%	49	53
14	南投縣竹山鎮	2018-11-24T23:01:28+08:00	5691	15560	21251	1476	22727	41236	55.11%	13.8%	48	53
14	南投縣竹山鎮	2018-11-24T23:47:25+08:00	6548	17847	24395	1714	26109	47034	55.51%	13.92%	53	53
14	南投縣竹山鎮	2018-11-25T06:29:13+08:00	6548	17847	24395	1714	26109	47034	55.51%	13.92%	53	53
14	南投縣竹山鎮	2018-11-24T23:35:07+08:00	6548	17847	24395	1714	26109	47034	55.51%	13.92%	53	53
14	南投縣竹山鎮	2018-11-24T22:33:34+08:00	5568	15316	20884	1421	22305	40415	55.19%	13.78%	47	53
14	南投縣竹山鎮	2018-11-25T01:07:23+08:00	6548	17847	24395	1714	26109	47034	55.51%	13.92%	53	53
14	南投縣竹山鎮	2018-11-24T23:43:14+08:00	6548	17847	24395	1714	26109	47034	55.51%	13.92%	53	53
14	南投縣竹山鎮	2018-11-24T23:31:07+08:00	6548	17847	24395	1714	26109	47034	55.51%	13.92%	53	53
14	南投縣竹山鎮	2018-11-25T06:08:49+08:00	6548	17847	24395	1714	26109	47034	55.51%	13.92%	53	53
14	南投縣竹山鎮	2018-11-25T00:14:06+08:00	6548	17847	24395	1714	26109	47034	55.51%	13.92%	53	53
14	南投縣竹山鎮	2018-11-24T23:23:35+08:00	6548	17847	24395	1714	26109	47034	55.51%	13.92%	53	53
14	南投縣竹山鎮	2018-11-24T23:19:46+08:00	6374	17360	23734	1672	25406	45864	55.39%	13.9%	52	53
14	南投縣竹山鎮	2018-11-24T22:13:23+08:00	5321	14574	19895	1345	21240	38285	55.48%	13.9%	45	53
14	南投縣竹山鎮	2018-11-25T01:17:48+08:00	6548	17847	24395	1714	26109	47034	55.51%	13.92%	53	53
14	南投縣竹山鎮	2018-11-24T23:55:43+08:00	6548	17847	24395	1714	26109	47034	55.51%	13.92%	53	53
14	南投縣竹山鎮	2018-11-24T23:08:32+08:00	6263	17049	23312	1617	24929	45005	55.39%	13.92%	51	53
14	南投縣竹山鎮	2018-11-24T22:57:49+08:00	5691	15560	21251	1476	22727	41236	55.11%	13.8%	48	53
14	南投縣竹山鎮	2018-11-25T03:44:19+08:00	6548	17847	24395	1714	26109	47034	55.51%	13.92%	53	53
14	南投縣竹山鎮	2018-11-24T22:30:02+08:00	5425	14880	20305	1368	21673	39193	55.3%	13.84%	46	53
14	南投縣竹山鎮	2018-11-25T01:02:27+08:00	6548	17847	24395	1714	26109	47034	55.51%	13.92%	53	53
14	南投縣竹山鎮	2018-11-24T22:40:25+08:00	5691	15560	21251	1476	22727	41236	55.11%	13.8%	48	53
14	南投縣竹山鎮	2018-11-25T01:25:49+08:00	6548	17847	24395	1714	26109	47034	55.51%	13.92%	53	53
14	南投縣竹山鎮	2018-11-24T23:15:59+08:00	6374	17360	23734	1672	25406	45864	55.39%	13.9%	52	53
14	南投縣竹山鎮	2018-11-25T06:18:54+08:00	6548	17847	24395	1714	26109	47034	55.51%	13.92%	53	53
14	南投縣竹山鎮	2018-11-25T03:56:08+08:00	6548	17847	24395	1714	26109	47034	55.51%	13.92%	53	53
14	南投縣竹山鎮	2018-11-24T22:41:32+08:00	5691	15560	21251	1476	22727	41236	55.11%	13.8%	48	53
14	南投縣竹山鎮	2018-11-24T22:45:05+08:00	5691	15560	21251	1476	22727	41236	55.11%	13.8%	48	53
14	南投縣竹山鎮	2018-11-25T00:18:26+08:00	6548	17847	24395	1714	26109	47034	55.51%	13.92%	53	53
14	南投縣竹山鎮	2018-11-24T23:39:11+08:00	6548	17847	24395	1714	26109	47034	55.51%	13.92%	53	53
14	南投縣竹山鎮	2018-11-25T00:09:30+08:00	6548	17847	24395	1714	26109	47034	55.51%	13.92%	53	53
14	南投縣竹山鎮	2018-11-24T22:54:22+08:00	5691	15560	21251	1476	22727	41236	55.11%	13.8%	48	53
14	臺東縣卑南鄉	2018-11-25T06:29:17+08:00	1956	5204	7160	708	7868	14976	52.54%	13.06%	22	22
14	臺東縣卑南鄉	2018-11-24T23:47:29+08:00	1956	5204	7160	708	7868	14976	52.54%	13.06%	22	22
14	臺東縣卑南鄉	2018-11-24T22:33:38+08:00	1664	4479	6143	622	6765	12903	52.43%	12.9%	20	22
14	臺東縣卑南鄉	2018-11-25T01:07:27+08:00	1956	5204	7160	708	7868	14976	52.54%	13.06%	22	22
14	臺東縣卑南鄉	2018-11-25T06:13:53+08:00	1956	5204	7160	708	7868	14976	52.54%	13.06%	22	22
14	臺東縣卑南鄉	2018-11-24T23:43:17+08:00	1956	5204	7160	708	7868	14976	52.54%	13.06%	22	22
14	臺東縣卑南鄉	2018-11-25T00:18:31+08:00	1956	5204	7160	708	7868	14976	52.54%	13.06%	22	22
14	臺東縣卑南鄉	2018-11-24T22:37:01+08:00	1664	4479	6143	622	6765	12903	52.43%	12.9%	20	22
14	臺東縣卑南鄉	2018-11-24T22:13:27+08:00	1664	4479	6143	622	6765	12903	52.43%	12.9%	20	22
14	臺東縣卑南鄉	2018-11-25T03:44:24+08:00	1956	5204	7160	708	7868	14976	52.54%	13.06%	22	22
14	臺東縣卑南鄉	2018-11-25T01:02:31+08:00	1956	5204	7160	708	7868	14976	52.54%	13.06%	22	22
14	臺東縣卑南鄉	2018-11-25T03:38:55+08:00	1956	5204	7160	708	7868	14976	52.54%	13.06%	22	22
14	臺東縣卑南鄉	2018-11-24T23:55:47+08:00	1956	5204	7160	708	7868	14976	52.54%	13.06%	22	22
14	臺東縣卑南鄉	2018-11-24T23:08:36+08:00	1781	4786	6567	669	7236	13871	52.17%	12.84%	21	22
14	臺東縣卑南鄉	2018-11-24T23:23:39+08:00	1781	4786	6567	669	7236	13871	52.17%	12.84%	21	22
14	臺東縣卑南鄉	2018-11-25T06:18:58+08:00	1956	5204	7160	708	7868	14976	52.54%	13.06%	22	22
14	臺東縣卑南鄉	2018-11-25T00:00:11+08:00	1956	5204	7160	708	7868	14976	52.54%	13.06%	22	22
14	臺東縣卑南鄉	2018-11-24T23:51:36+08:00	1956	5204	7160	708	7868	14976	52.54%	13.06%	22	22
14	臺東縣卑南鄉	2018-11-24T22:30:09+08:00	1664	4479	6143	622	6765	12903	52.43%	12.9%	20	22
14	臺東縣卑南鄉	2018-11-24T22:40:28+08:00	1664	4479	6143	622	6765	12903	52.43%	12.9%	20	22
14	臺東縣卑南鄉	2018-11-24T22:23:13+08:00	1664	4479	6143	622	6765	12903	52.43%	12.9%	20	22
14	臺東縣卑南鄉	2018-11-25T00:09:35+08:00	1956	5204	7160	708	7868	14976	52.54%	13.06%	22	22
14	臺東縣卑南鄉	2018-11-24T23:35:11+08:00	1781	4786	6567	669	7236	13871	52.17%	12.84%	21	22
14	臺東縣卑南鄉	2018-11-24T23:01:31+08:00	1781	4786	6567	669	7236	13871	52.17%	12.84%	21	22
14	臺東縣卑南鄉	2018-11-24T22:45:09+08:00	1664	4479	6143	622	6765	12903	52.43%	12.9%	20	22
14	臺東縣卑南鄉	2018-11-24T22:54:26+08:00	1664	4479	6143	622	6765	12903	52.43%	12.9%	20	22
14	臺東縣卑南鄉	2018-11-25T00:14:10+08:00	1956	5204	7160	708	7868	14976	52.54%	13.06%	22	22
14	臺東縣卑南鄉	2018-11-25T03:56:13+08:00	1956	5204	7160	708	7868	14976	52.54%	13.06%	22	22
14	臺東縣卑南鄉	2018-11-25T03:49:51+08:00	1956	5204	7160	708	7868	14976	52.54%	13.06%	22	22
14	臺東縣卑南鄉	2018-11-24T23:16:03+08:00	1781	4786	6567	669	7236	13871	52.17%	12.84%	21	22
14	臺東縣卑南鄉	2018-11-25T03:32:35+08:00	1956	5204	7160	708	7868	14976	52.54%	13.06%	22	22
14	臺東縣卑南鄉	2018-11-25T06:24:00+08:00	1956	5204	7160	708	7868	14976	52.54%	13.06%	22	22
14	臺東縣卑南鄉	2018-11-25T01:25:53+08:00	1956	5204	7160	708	7868	14976	52.54%	13.06%	22	22
14	臺東縣卑南鄉	2018-11-25T00:23:04+08:00	1956	5204	7160	708	7868	14976	52.54%	13.06%	22	22
14	臺東縣卑南鄉	2018-11-24T23:27:19+08:00	1781	4786	6567	669	7236	13871	52.17%	12.84%	21	22
14	臺東縣卑南鄉	2018-11-25T00:57:37+08:00	1956	5204	7160	708	7868	14976	52.54%	13.06%	22	22
14	臺東縣卑南鄉	2018-11-24T22:57:54+08:00	1781	4786	6567	669	7236	13871	52.17%	12.84%	21	22
14	臺東縣卑南鄉	2018-11-25T01:17:53+08:00	1956	5204	7160	708	7868	14976	52.54%	13.06%	22	22
14	臺東縣卑南鄉	2018-11-24T22:19:37+08:00	1664	4479	6143	622	6765	12903	52.43%	12.9%	20	22
14	臺東縣卑南鄉	2018-11-24T23:19:52+08:00	1781	4786	6567	669	7236	13871	52.17%	12.84%	21	22
14	臺東縣卑南鄉	2018-11-24T22:41:35+08:00	1664	4479	6143	622	6765	12903	52.43%	12.9%	20	22
14	臺東縣卑南鄉	2018-11-25T00:05:05+08:00	1956	5204	7160	708	7868	14976	52.54%	13.06%	22	22
14	臺東縣卑南鄉	2018-11-25T04:02:52+08:00	1956	5204	7160	708	7868	14976	52.54%	13.06%	22	22
14	臺東縣卑南鄉	2018-11-24T23:12:16+08:00	1781	4786	6567	669	7236	13871	52.17%	12.84%	21	22
14	臺東縣卑南鄉	2018-11-25T06:08:53+08:00	1956	5204	7160	708	7868	14976	52.54%	13.06%	22	22
14	臺東縣卑南鄉	2018-11-25T01:12:44+08:00	1956	5204	7160	708	7868	14976	52.54%	13.06%	22	22
14	臺東縣卑南鄉	2018-11-24T22:26:37+08:00	1664	4479	6143	622	6765	12903	52.43%	12.9%	20	22
14	臺東縣卑南鄉	2018-11-24T23:05:05+08:00	1781	4786	6567	669	7236	13871	52.17%	12.84%	21	22
14	臺東縣卑南鄉	2018-11-24T22:50:48+08:00	1664	4479	6143	622	6765	12903	52.43%	12.9%	20	22
14	臺東縣卑南鄉	2018-11-24T23:31:12+08:00	1781	4786	6567	669	7236	13871	52.17%	12.84%	21	22
14	臺東縣卑南鄉	2018-11-24T22:16:11+08:00	1664	4479	6143	622	6765	12903	52.43%	12.9%	20	22
14	臺東縣卑南鄉	2018-11-24T23:39:16+08:00	1781	4786	6567	669	7236	13871	52.17%	12.84%	21	22
14	臺東縣金峰鄉	2018-11-25T03:49:52+08:00	453	1217	1670	145	1815	3028	59.94%	14.96%	5	5
14	臺東縣金峰鄉	2018-11-24T23:43:18+08:00	299	811	1110	102	1212	1787	67.82%	16.73%	4	5
14	臺東縣金峰鄉	2018-11-24T23:47:29+08:00	299	811	1110	102	1212	1787	67.82%	16.73%	4	5
14	臺東縣金峰鄉	2018-11-25T06:29:18+08:00	453	1217	1670	145	1815	3028	59.94%	14.96%	5	5
14	臺東縣金峰鄉	2018-11-24T22:33:38+08:00	79	292	371	49	420	666	63.06%	11.86%	2	5
14	臺東縣金峰鄉	2018-11-25T01:07:27+08:00	453	1217	1670	145	1815	3028	59.94%	14.96%	5	5
14	臺東縣金峰鄉	2018-11-25T06:13:53+08:00	453	1217	1670	145	1815	3028	59.94%	14.96%	5	5
14	臺東縣金峰鄉	2018-11-25T00:18:31+08:00	299	811	1110	102	1212	1787	67.82%	16.73%	4	5
14	臺東縣金峰鄉	2018-11-24T22:37:01+08:00	79	292	371	49	420	666	63.06%	11.86%	2	5
14	臺東縣金峰鄉	2018-11-25T03:44:24+08:00	453	1217	1670	145	1815	3028	59.94%	14.96%	5	5
14	臺東縣金峰鄉	2018-11-24T23:08:37+08:00	174	570	744	75	819	1267	64.64%	13.73%	3	5
14	臺東縣金峰鄉	2018-11-24T23:55:48+08:00	299	811	1110	102	1212	1787	67.82%	16.73%	4	5
14	臺東縣金峰鄉	2018-11-24T22:13:28+08:00	45	154	199	28	227	330	68.79%	13.64%	1	5
14	臺東縣金峰鄉	2018-11-24T23:23:39+08:00	299	811	1110	102	1212	1787	67.82%	16.73%	4	5
14	臺東縣金峰鄉	2018-11-25T06:18:58+08:00	453	1217	1670	145	1815	3028	59.94%	14.96%	5	5
14	臺東縣金峰鄉	2018-11-25T00:00:11+08:00	299	811	1110	102	1212	1787	67.82%	16.73%	4	5
14	臺東縣金峰鄉	2018-11-24T23:51:36+08:00	299	811	1110	102	1212	1787	67.82%	16.73%	4	5
14	臺東縣金峰鄉	2018-11-24T22:23:14+08:00	45	154	199	28	227	330	68.79%	13.64%	1	5
14	臺東縣金峰鄉	2018-11-24T22:40:28+08:00	174	570	744	75	819	1267	64.64%	13.73%	3	5
14	臺東縣金峰鄉	2018-11-25T00:09:35+08:00	299	811	1110	102	1212	1787	67.82%	16.73%	4	5
14	臺東縣金峰鄉	2018-11-25T00:05:06+08:00	299	811	1110	102	1212	1787	67.82%	16.73%	4	5
14	臺東縣金峰鄉	2018-11-24T23:35:11+08:00	299	811	1110	102	1212	1787	67.82%	16.73%	4	5
14	臺東縣金峰鄉	2018-11-24T22:41:36+08:00	174	570	744	75	819	1267	64.64%	13.73%	3	5
14	臺東縣金峰鄉	2018-11-24T23:01:31+08:00	174	570	744	75	819	1267	64.64%	13.73%	3	5
14	臺東縣金峰鄉	2018-11-24T22:45:09+08:00	174	570	744	75	819	1267	64.64%	13.73%	3	5
14	臺東縣金峰鄉	2018-11-24T22:54:26+08:00	174	570	744	75	819	1267	64.64%	13.73%	3	5
14	臺東縣金峰鄉	2018-11-25T00:14:10+08:00	299	811	1110	102	1212	1787	67.82%	16.73%	4	5
14	臺東縣金峰鄉	2018-11-25T03:56:13+08:00	453	1217	1670	145	1815	3028	59.94%	14.96%	5	5
14	臺東縣金峰鄉	2018-11-24T23:16:03+08:00	174	570	744	75	819	1267	64.64%	13.73%	3	5
14	臺東縣金峰鄉	2018-11-25T03:32:35+08:00	453	1217	1670	145	1815	3028	59.94%	14.96%	5	5
14	臺東縣金峰鄉	2018-11-25T01:25:53+08:00	453	1217	1670	145	1815	3028	59.94%	14.96%	5	5
14	臺東縣金峰鄉	2018-11-25T01:02:32+08:00	453	1217	1670	145	1815	3028	59.94%	14.96%	5	5
14	臺東縣金峰鄉	2018-11-24T22:30:10+08:00	79	292	371	49	420	666	63.06%	11.86%	2	5
14	臺東縣金峰鄉	2018-11-25T00:23:04+08:00	299	811	1110	102	1212	1787	67.82%	16.73%	4	5
14	臺東縣金峰鄉	2018-11-25T06:24:01+08:00	453	1217	1670	145	1815	3028	59.94%	14.96%	5	5
14	臺東縣金峰鄉	2018-11-25T03:38:56+08:00	453	1217	1670	145	1815	3028	59.94%	14.96%	5	5
14	臺東縣金峰鄉	2018-11-24T23:27:19+08:00	299	811	1110	102	1212	1787	67.82%	16.73%	4	5
14	臺東縣金峰鄉	2018-11-24T22:19:38+08:00	45	154	199	28	227	330	68.79%	13.64%	1	5
14	臺東縣金峰鄉	2018-11-25T00:57:37+08:00	453	1217	1670	145	1815	3028	59.94%	14.96%	5	5
14	臺東縣金峰鄉	2018-11-24T22:57:54+08:00	174	570	744	75	819	1267	64.64%	13.73%	3	5
14	臺東縣金峰鄉	2018-11-25T01:17:53+08:00	453	1217	1670	145	1815	3028	59.94%	14.96%	5	5
14	臺東縣金峰鄉	2018-11-24T23:19:52+08:00	174	570	744	75	819	1267	64.64%	13.73%	3	5
14	臺東縣金峰鄉	2018-11-25T06:08:54+08:00	453	1217	1670	145	1815	3028	59.94%	14.96%	5	5
14	臺東縣金峰鄉	2018-11-24T23:12:16+08:00	174	570	744	75	819	1267	64.64%	13.73%	3	5
14	臺東縣金峰鄉	2018-11-24T23:39:17+08:00	299	811	1110	102	1212	1787	67.82%	16.73%	4	5
14	臺東縣金峰鄉	2018-11-25T01:12:44+08:00	453	1217	1670	145	1815	3028	59.94%	14.96%	5	5
14	臺東縣金峰鄉	2018-11-24T22:50:49+08:00	174	570	744	75	819	1267	64.64%	13.73%	3	5
14	臺東縣金峰鄉	2018-11-24T22:26:37+08:00	79	292	371	49	420	666	63.06%	11.86%	2	5
14	臺東縣金峰鄉	2018-11-25T04:02:53+08:00	453	1217	1670	145	1815	3028	59.94%	14.96%	5	5
14	臺東縣金峰鄉	2018-11-24T23:05:05+08:00	174	570	744	75	819	1267	64.64%	13.73%	3	5
14	臺東縣金峰鄉	2018-11-24T23:31:12+08:00	299	811	1110	102	1212	1787	67.82%	16.73%	4	5
14	臺東縣金峰鄉	2018-11-24T22:16:11+08:00	45	154	199	28	227	330	68.79%	13.64%	1	5
14	臺中市大肚區	2018-11-24T23:35:03+08:00	7265	17141	24406	1634	26040	44572	58.42%	16.3%	31	33
14	臺中市大肚區	2018-11-24T22:33:30+08:00	4286	9746	14032	889	14921	25611	58.26%	16.73%	19	33
14	臺中市大肚區	2018-11-24T22:16:01+08:00	3656	8966	12622	763	13385	22996	58.21%	15.9%	17	33
14	臺中市大肚區	2018-11-24T23:31:02+08:00	7265	17141	24406	1634	26040	44572	58.42%	16.3%	31	33
14	臺中市大肚區	2018-11-24T23:01:22+08:00	5956	14067	20023	1294	21317	36571	58.29%	16.29%	26	33
14	臺中市大肚區	2018-11-24T23:12:07+08:00	6698	15797	22495	1492	23987	41080	58.39%	16.3%	29	33
14	臺中市大肚區	2018-11-24T23:47:20+08:00	7265	17141	24406	1634	26040	44572	58.42%	16.3%	31	33
14	臺中市大肚區	2018-11-25T01:07:18+08:00	7711	18322	26033	1711	27744	47457	58.46%	16.25%	33	33
14	臺中市大肚區	2018-11-25T06:08:43+08:00	7711	18322	26033	1711	27744	47457	58.46%	16.25%	33	33
14	臺中市大肚區	2018-11-24T22:57:45+08:00	5956	14067	20023	1294	21317	36571	58.29%	16.29%	26	33
14	臺中市大肚區	2018-11-25T01:17:42+08:00	7711	18322	26033	1711	27744	47457	58.46%	16.25%	33	33
14	臺中市大肚區	2018-11-24T22:13:18+08:00	3656	8966	12622	763	13385	22996	58.21%	15.9%	17	33
14	臺中市大肚區	2018-11-24T22:19:29+08:00	3921	9595	13516	822	14338	24749	57.93%	15.84%	18	33
14	臺中市大肚區	2018-11-25T00:57:28+08:00	7711	18322	26033	1711	27744	47457	58.46%	16.25%	33	33
14	臺中市大肚區	2018-11-24T23:23:31+08:00	7265	17141	24406	1634	26040	44572	58.42%	16.3%	31	33
14	臺中市大肚區	2018-11-25T03:44:13+08:00	7711	18322	26033	1711	27744	47457	58.46%	16.25%	33	33
14	臺中市大肚區	2018-11-25T00:04:57+08:00	7506	17786	25292	1670	26962	46201	58.36%	16.25%	32	33
14	臺中市大肚區	2018-11-24T23:04:56+08:00	6227	14733	20960	1375	22335	38301	58.31%	16.26%	27	33
14	臺中市大肚區	2018-11-24T23:15:55+08:00	6698	15797	22495	1492	23987	41080	58.39%	16.3%	29	33
14	臺中市大肚區	2018-11-24T22:40:20+08:00	4796	11014	15810	1026	16836	28914	58.23%	16.59%	21	33
14	臺中市大肚區	2018-11-25T06:18:50+08:00	7711	18322	26033	1711	27744	47457	58.46%	16.25%	33	33
14	臺中市大肚區	2018-11-25T01:25:44+08:00	7711	18322	26033	1711	27744	47457	58.46%	16.25%	33	33
14	臺中市大肚區	2018-11-25T01:02:22+08:00	7711	18322	26033	1711	27744	47457	58.46%	16.25%	33	33
14	臺中市大肚區	2018-11-25T03:38:47+08:00	7711	18322	26033	1711	27744	47457	58.46%	16.25%	33	33
14	臺中市大肚區	2018-11-24T23:55:39+08:00	7265	17141	24406	1634	26040	44572	58.42%	16.3%	31	33
14	臺中市大肚區	2018-11-24T22:54:18+08:00	5432	12698	18130	1189	19319	33162	58.26%	16.38%	24	33
14	臺中市大肚區	2018-11-24T22:45:01+08:00	5031	11645	16676	1082	17758	30434	58.35%	16.53%	22	33
14	臺中市大肚區	2018-11-25T00:18:22+08:00	7506	17786	25292	1670	26962	46201	58.36%	16.25%	32	33
14	臺中市大肚區	2018-11-25T00:22:56+08:00	7506	17786	25292	1670	26962	46201	58.36%	16.25%	32	33
14	臺中市大肚區	2018-11-25T03:56:02+08:00	7711	18322	26033	1711	27744	47457	58.46%	16.25%	33	33
14	臺中市大肚區	2018-11-24T23:39:05+08:00	7265	17141	24406	1634	26040	44572	58.42%	16.3%	31	33
14	臺中市大肚區	2018-11-25T01:12:34+08:00	7711	18322	26033	1711	27744	47457	58.46%	16.25%	33	33
14	臺中市大肚區	2018-11-25T04:02:40+08:00	7711	18322	26033	1711	27744	47457	58.46%	16.25%	33	33
14	臺中市大肚區	2018-11-25T00:09:25+08:00	7506	17786	25292	1670	26962	46201	58.36%	16.25%	32	33
14	臺中市大肚區	2018-11-25T00:14:01+08:00	7506	17786	25292	1670	26962	46201	58.36%	16.25%	32	33
14	臺中市大肚區	2018-11-24T22:41:28+08:00	4796	11014	15810	1026	16836	28914	58.23%	16.59%	21	33
14	臺中市大肚區	2018-11-24T22:50:38+08:00	5237	12200	17437	1135	18572	31770	58.46%	16.48%	23	33
14	臺中市大肚區	2018-11-24T23:51:26+08:00	7265	17141	24406	1634	26040	44572	58.42%	16.3%	31	33
14	臺中市大肚區	2018-11-25T00:00:00+08:00	7506	17786	25292	1670	26962	46201	58.36%	16.25%	32	33
14	臺中市大肚區	2018-11-24T22:23:04+08:00	3921	9595	13516	822	14338	24749	57.93%	15.84%	18	33
14	臺中市大肚區	2018-11-24T23:19:41+08:00	7002	16466	23468	1542	25010	42902	58.3%	16.32%	30	33
14	臺中市大肚區	2018-11-24T22:29:58+08:00	3921	9595	13516	822	14338	24749	57.93%	15.84%	18	33
14	臺中市大肚區	2018-11-24T22:36:53+08:00	4796	11014	15810	1026	16836	28914	58.23%	16.59%	21	33
14	臺中市大肚區	2018-11-24T23:27:11+08:00	7265	17141	24406	1634	26040	44572	58.42%	16.3%	31	33
14	臺中市大肚區	2018-11-24T23:08:27+08:00	6439	15216	21655	1414	23069	39595	58.26%	16.26%	28	33
14	臺中市大肚區	2018-11-25T03:32:26+08:00	7711	18322	26033	1711	27744	47457	58.46%	16.25%	33	33
14	臺中市大肚區	2018-11-25T06:29:08+08:00	7711	18322	26033	1711	27744	47457	58.46%	16.25%	33	33
14	臺中市大肚區	2018-11-25T03:49:44+08:00	7711	18322	26033	1711	27744	47457	58.46%	16.25%	33	33
14	臺中市大肚區	2018-11-24T22:26:30+08:00	3921	9595	13516	822	14338	24749	57.93%	15.84%	18	33
14	臺中市大肚區	2018-11-25T06:23:52+08:00	7711	18322	26033	1711	27744	47457	58.46%	16.25%	33	33
14	臺中市大肚區	2018-11-24T23:43:09+08:00	7265	17141	24406	1634	26040	44572	58.42%	16.3%	31	33
14	臺中市大肚區	2018-11-25T06:13:45+08:00	7711	18322	26033	1711	27744	47457	58.46%	16.25%	33	33
14	宜蘭縣壯圍鄉	2018-11-24T22:33:37+08:00	3671	6829	10500	1036	11536	20012	57.65%	18.34%	22	23
14	宜蘭縣壯圍鄉	2018-11-24T23:47:28+08:00	3966	7329	11295	1116	12411	21447	57.87%	18.49%	23	23
14	宜蘭縣壯圍鄉	2018-11-24T22:37:00+08:00	3671	6829	10500	1036	11536	20012	57.65%	18.34%	22	23
14	宜蘭縣壯圍鄉	2018-11-25T01:07:26+08:00	3966	7329	11295	1116	12411	21447	57.87%	18.49%	23	23
14	宜蘭縣壯圍鄉	2018-11-25T06:13:52+08:00	3966	7329	11295	1116	12411	21447	57.87%	18.49%	23	23
14	宜蘭縣壯圍鄉	2018-11-25T06:29:16+08:00	3966	7329	11295	1116	12411	21447	57.87%	18.49%	23	23
14	宜蘭縣壯圍鄉	2018-11-24T23:43:17+08:00	3966	7329	11295	1116	12411	21447	57.87%	18.49%	23	23
14	宜蘭縣壯圍鄉	2018-11-25T01:02:31+08:00	3966	7329	11295	1116	12411	21447	57.87%	18.49%	23	23
14	宜蘭縣壯圍鄉	2018-11-24T23:55:46+08:00	3966	7329	11295	1116	12411	21447	57.87%	18.49%	23	23
14	宜蘭縣壯圍鄉	2018-11-24T23:23:38+08:00	3966	7329	11295	1116	12411	21447	57.87%	18.49%	23	23
14	宜蘭縣壯圍鄉	2018-11-25T03:38:55+08:00	3966	7329	11295	1116	12411	21447	57.87%	18.49%	23	23
14	宜蘭縣壯圍鄉	2018-11-25T03:44:22+08:00	3966	7329	11295	1116	12411	21447	57.87%	18.49%	23	23
14	宜蘭縣壯圍鄉	2018-11-24T22:13:26+08:00	3488	6542	10030	961	10991	19101	57.54%	18.26%	21	23
14	宜蘭縣壯圍鄉	2018-11-24T22:23:12+08:00	3671	6829	10500	1036	11536	20012	57.65%	18.34%	22	23
14	宜蘭縣壯圍鄉	2018-11-24T22:30:08+08:00	3671	6829	10500	1036	11536	20012	57.65%	18.34%	22	23
14	宜蘭縣壯圍鄉	2018-11-24T22:40:27+08:00	3671	6829	10500	1036	11536	20012	57.65%	18.34%	22	23
14	宜蘭縣壯圍鄉	2018-11-25T00:00:10+08:00	3966	7329	11295	1116	12411	21447	57.87%	18.49%	23	23
14	宜蘭縣壯圍鄉	2018-11-25T06:18:57+08:00	3966	7329	11295	1116	12411	21447	57.87%	18.49%	23	23
14	宜蘭縣壯圍鄉	2018-11-24T23:19:51+08:00	3966	7329	11295	1116	12411	21447	57.87%	18.49%	23	23
14	宜蘭縣壯圍鄉	2018-11-24T23:12:15+08:00	3966	7329	11295	1116	12411	21447	57.87%	18.49%	23	23
14	宜蘭縣壯圍鄉	2018-11-24T22:45:08+08:00	3671	6829	10500	1036	11536	20012	57.65%	18.34%	22	23
14	宜蘭縣壯圍鄉	2018-11-24T23:01:30+08:00	3671	6829	10500	1036	11536	20012	57.65%	18.34%	22	23
14	宜蘭縣壯圍鄉	2018-11-24T23:39:15+08:00	3966	7329	11295	1116	12411	21447	57.87%	18.49%	23	23
14	宜蘭縣壯圍鄉	2018-11-24T23:31:11+08:00	3966	7329	11295	1116	12411	21447	57.87%	18.49%	23	23
14	宜蘭縣壯圍鄉	2018-11-25T00:09:34+08:00	3966	7329	11295	1116	12411	21447	57.87%	18.49%	23	23
14	宜蘭縣壯圍鄉	2018-11-24T23:35:10+08:00	3966	7329	11295	1116	12411	21447	57.87%	18.49%	23	23
14	宜蘭縣壯圍鄉	2018-11-25T00:14:09+08:00	3966	7329	11295	1116	12411	21447	57.87%	18.49%	23	23
14	宜蘭縣壯圍鄉	2018-11-25T03:49:51+08:00	3966	7329	11295	1116	12411	21447	57.87%	18.49%	23	23
14	宜蘭縣壯圍鄉	2018-11-24T23:16:02+08:00	3966	7329	11295	1116	12411	21447	57.87%	18.49%	23	23
14	宜蘭縣壯圍鄉	2018-11-25T03:56:12+08:00	3966	7329	11295	1116	12411	21447	57.87%	18.49%	23	23
14	宜蘭縣壯圍鄉	2018-11-25T06:24:00+08:00	3966	7329	11295	1116	12411	21447	57.87%	18.49%	23	23
14	宜蘭縣壯圍鄉	2018-11-25T00:23:03+08:00	3966	7329	11295	1116	12411	21447	57.87%	18.49%	23	23
14	宜蘭縣壯圍鄉	2018-11-24T23:08:35+08:00	3966	7329	11295	1116	12411	21447	57.87%	18.49%	23	23
14	宜蘭縣壯圍鄉	2018-11-25T03:32:34+08:00	3966	7329	11295	1116	12411	21447	57.87%	18.49%	23	23
14	宜蘭縣壯圍鄉	2018-11-25T01:25:52+08:00	3966	7329	11295	1116	12411	21447	57.87%	18.49%	23	23
14	宜蘭縣壯圍鄉	2018-11-24T22:57:53+08:00	3671	6829	10500	1036	11536	20012	57.65%	18.34%	22	23
14	宜蘭縣壯圍鄉	2018-11-24T22:19:36+08:00	3671	6829	10500	1036	11536	20012	57.65%	18.34%	22	23
14	宜蘭縣壯圍鄉	2018-11-25T00:57:36+08:00	3966	7329	11295	1116	12411	21447	57.87%	18.49%	23	23
14	宜蘭縣壯圍鄉	2018-11-25T01:17:52+08:00	3966	7329	11295	1116	12411	21447	57.87%	18.49%	23	23
14	宜蘭縣壯圍鄉	2018-11-24T23:27:18+08:00	3966	7329	11295	1116	12411	21447	57.87%	18.49%	23	23
14	宜蘭縣壯圍鄉	2018-11-24T23:51:35+08:00	3966	7329	11295	1116	12411	21447	57.87%	18.49%	23	23
14	宜蘭縣壯圍鄉	2018-11-24T23:05:04+08:00	3966	7329	11295	1116	12411	21447	57.87%	18.49%	23	23
14	宜蘭縣壯圍鄉	2018-11-25T04:02:52+08:00	3966	7329	11295	1116	12411	21447	57.87%	18.49%	23	23
14	宜蘭縣壯圍鄉	2018-11-24T22:50:47+08:00	3671	6829	10500	1036	11536	20012	57.65%	18.34%	22	23
14	宜蘭縣壯圍鄉	2018-11-24T22:16:10+08:00	3488	6542	10030	961	10991	19101	57.54%	18.26%	21	23
14	宜蘭縣壯圍鄉	2018-11-25T01:12:43+08:00	3966	7329	11295	1116	12411	21447	57.87%	18.49%	23	23
14	宜蘭縣壯圍鄉	2018-11-25T00:05:04+08:00	3966	7329	11295	1116	12411	21447	57.87%	18.49%	23	23
14	宜蘭縣壯圍鄉	2018-11-24T22:41:34+08:00	3671	6829	10500	1036	11536	20012	57.65%	18.34%	22	23
14	宜蘭縣壯圍鄉	2018-11-24T22:26:36+08:00	3671	6829	10500	1036	11536	20012	57.65%	18.34%	22	23
14	宜蘭縣壯圍鄉	2018-11-25T00:18:29+08:00	3966	7329	11295	1116	12411	21447	57.87%	18.49%	23	23
14	宜蘭縣壯圍鄉	2018-11-25T06:08:52+08:00	3966	7329	11295	1116	12411	21447	57.87%	18.49%	23	23
14	宜蘭縣壯圍鄉	2018-11-24T22:54:25+08:00	3671	6829	10500	1036	11536	20012	57.65%	18.34%	22	23
14	新北市板橋區	2018-11-24T23:47:17+08:00	85427	153057	238484	14810	253294	445451	56.86%	19.18%	328	338
14	新北市板橋區	2018-11-24T22:26:28+08:00	69525	124709	194234	11994	206228	360836	57.15%	19.27%	274	338
14	新北市板橋區	2018-11-25T01:12:31+08:00	88512	158751	247263	15343	262606	463411	56.67%	19.1%	338	338
14	新北市板橋區	2018-11-25T01:07:16+08:00	88512	158751	247263	15343	262606	463411	56.67%	19.1%	338	338
14	新北市板橋區	2018-11-24T22:19:27+08:00	67453	120757	188210	11576	199786	349022	57.24%	19.33%	266	338
14	新北市板橋區	2018-11-24T22:13:16+08:00	63846	114563	178409	10900	189309	330204	57.33%	19.34%	254	338
14	新北市板橋區	2018-11-24T22:57:42+08:00	78668	141308	219976	13593	233569	409623	57.02%	19.2%	305	338
14	新北市板橋區	2018-11-25T00:57:26+08:00	88512	158751	247263	15343	262606	463411	56.67%	19.1%	338	338
14	新北市板橋區	2018-11-24T23:51:25+08:00	85727	153645	239372	14878	254250	447251	56.85%	19.17%	329	338
14	新北市板橋區	2018-11-24T22:29:54+08:00	70804	127209	198013	12269	210282	367959	57.15%	19.24%	279	338
14	新北市板橋區	2018-11-24T23:27:09+08:00	82845	148420	231265	14243	245508	431406	56.91%	19.2%	319	338
14	新北市板橋區	2018-11-24T22:44:59+08:00	75965	136416	212381	13142	225523	395522	57.02%	19.21%	296	338
14	新北市板橋區	2018-11-24T22:23:01+08:00	67998	121683	189681	11635	201316	351871	57.21%	19.32%	268	338
14	新北市板橋區	2018-11-25T03:32:24+08:00	88512	158751	247263	15343	262606	463411	56.67%	19.1%	338	338
14	新北市板橋區	2018-11-25T03:38:46+08:00	88512	158751	247263	15343	262606	463411	56.67%	19.1%	338	338
14	新北市板橋區	2018-11-25T01:25:42+08:00	88512	158751	247263	15343	262606	463411	56.67%	19.1%	338	338
14	新北市板橋區	2018-11-24T22:40:18+08:00	75075	134819	209894	13027	222921	390747	57.05%	19.21%	293	338
14	新北市板橋區	2018-11-24T23:08:24+08:00	79794	143180	222974	13721	236695	415206	57.01%	19.22%	309	338
14	新北市板橋區	2018-11-24T23:15:53+08:00	81105	145409	226514	13906	240420	421906	56.98%	19.22%	313	338
14	新北市板橋區	2018-11-24T23:59:57+08:00	87523	156942	244465	15174	259639	458223	56.66%	19.1%	335	338
14	新北市板橋區	2018-11-24T23:55:37+08:00	86696	155506	242202	15015	257217	453851	56.67%	19.1%	332	338
14	新北市板橋區	2018-11-25T00:13:59+08:00	87849	157584	245433	15228	260661	459984	56.67%	19.1%	336	338
14	新北市板橋區	2018-11-24T22:36:51+08:00	74060	132940	207000	12753	219753	385158	57.06%	19.23%	289	338
14	新北市板橋區	2018-11-24T22:54:17+08:00	77728	139588	217316	13413	230729	404740	57.01%	19.2%	302	338
14	新北市板橋區	2018-11-25T06:23:50+08:00	88512	158751	247263	15343	262606	463411	56.67%	19.1%	338	338
14	新北市板橋區	2018-11-24T23:12:04+08:00	80424	144192	224616	13823	238439	418516	56.97%	19.22%	311	338
14	新北市板橋區	2018-11-25T06:08:41+08:00	88512	158751	247263	15343	262606	463411	56.67%	19.1%	338	338
14	新北市板橋區	2018-11-25T00:09:22+08:00	87849	157584	245433	15228	260661	459984	56.67%	19.1%	336	338
14	新北市板橋區	2018-11-24T23:31:00+08:00	83720	149997	233717	14361	248078	436127	56.88%	19.2%	322	338
14	新北市板橋區	2018-11-24T23:39:03+08:00	84838	152083	236921	14653	251574	442199	56.89%	19.19%	326	338
14	新北市板橋區	2018-11-24T23:01:20+08:00	78859	141640	220499	13615	234114	410553	57.02%	19.21%	306	338
14	新北市板橋區	2018-11-24T22:50:36+08:00	77244	138571	215815	13295	229110	401891	57.01%	19.22%	300	338
14	新北市板橋區	2018-11-24T22:41:26+08:00	75075	134819	209894	13027	222921	390747	57.05%	19.21%	293	338
14	新北市板橋區	2018-11-24T23:35:01+08:00	84305	151085	235390	14492	249882	439305	56.88%	19.19%	324	338
14	新北市板橋區	2018-11-24T23:04:54+08:00	78859	141640	220499	13615	234114	410553	57.02%	19.21%	306	338
14	新北市板橋區	2018-11-25T00:04:55+08:00	87849	157584	245433	15228	260661	459984	56.67%	19.1%	336	338
14	新北市板橋區	2018-11-25T06:18:48+08:00	88512	158751	247263	15343	262606	463411	56.67%	19.1%	338	338
14	新北市板橋區	2018-11-25T03:44:10+08:00	88512	158751	247263	15343	262606	463411	56.67%	19.1%	338	338
14	新北市板橋區	2018-11-25T01:02:20+08:00	88512	158751	247263	15343	262606	463411	56.67%	19.1%	338	338
14	新北市板橋區	2018-11-24T23:19:38+08:00	82192	147258	229450	14120	243570	427785	56.94%	19.21%	317	338
14	新北市板橋區	2018-11-24T23:23:29+08:00	82563	147959	230522	14184	244706	429875	56.92%	19.21%	318	338
14	新北市板橋區	2018-11-24T22:15:59+08:00	65502	117179	182681	11208	193889	338360	57.3%	19.36%	259	338
14	新北市板橋區	2018-11-25T01:17:39+08:00	88512	158751	247263	15343	262606	463411	56.67%	19.1%	338	338
14	新北市板橋區	2018-11-25T06:29:06+08:00	88512	158751	247263	15343	262606	463411	56.67%	19.1%	338	338
14	新北市板橋區	2018-11-24T22:33:28+08:00	72193	129642	201835	12474	214309	375042	57.14%	19.25%	283	338
14	新北市板橋區	2018-11-25T06:13:43+08:00	88512	158751	247263	15343	262606	463411	56.67%	19.1%	338	338
14	新北市板橋區	2018-11-24T23:43:07+08:00	85427	153057	238484	14810	253294	445451	56.86%	19.18%	328	338
14	新北市板橋區	2018-11-25T00:22:53+08:00	87849	157584	245433	15228	260661	459984	56.67%	19.1%	336	338
14	新北市板橋區	2018-11-25T03:56:00+08:00	88512	158751	247263	15343	262606	463411	56.67%	19.1%	338	338
14	新北市板橋區	2018-11-25T03:49:42+08:00	88512	158751	247263	15343	262606	463411	56.67%	19.1%	338	338
14	新北市板橋區	2018-11-25T00:18:20+08:00	87849	157584	245433	15228	260661	459984	56.67%	19.1%	336	338
14	新北市板橋區	2018-11-25T04:02:38+08:00	88512	158751	247263	15343	262606	463411	56.67%	19.1%	338	338
14	連江縣東引鄉	2018-11-24T22:33:39+08:00	0	0	0	0	0	0	0%	0%	0	1
14	連江縣東引鄉	2018-11-25T03:49:52+08:00	271	285	556	21	577	1138	50.7%	23.81%	1	1
14	連江縣東引鄉	2018-11-24T23:43:18+08:00	271	285	556	21	577	1138	50.7%	23.81%	1	1
14	連江縣東引鄉	2018-11-25T01:07:28+08:00	271	285	556	21	577	1138	50.7%	23.81%	1	1
14	連江縣東引鄉	2018-11-25T06:29:18+08:00	271	285	556	21	577	1138	50.7%	23.81%	1	1
14	連江縣東引鄉	2018-11-24T22:50:50+08:00	271	285	556	21	577	1138	50.7%	23.81%	1	1
14	連江縣東引鄉	2018-11-25T06:13:54+08:00	271	285	556	21	577	1138	50.7%	23.81%	1	1
14	連江縣東引鄉	2018-11-25T03:32:36+08:00	271	285	556	21	577	1138	50.7%	23.81%	1	1
14	連江縣東引鄉	2018-11-24T23:55:48+08:00	271	285	556	21	577	1138	50.7%	23.81%	1	1
14	連江縣東引鄉	2018-11-25T03:44:25+08:00	271	285	556	21	577	1138	50.7%	23.81%	1	1
14	連江縣東引鄉	2018-11-24T22:13:28+08:00	0	0	0	0	0	0	0%	0%	0	1
14	連江縣東引鄉	2018-11-24T23:08:38+08:00	271	285	556	21	577	1138	50.7%	23.81%	1	1
14	連江縣東引鄉	2018-11-24T23:51:37+08:00	271	285	556	21	577	1138	50.7%	23.81%	1	1
14	連江縣東引鄉	2018-11-24T22:23:15+08:00	0	0	0	0	0	0	0%	0%	0	1
14	連江縣東引鄉	2018-11-24T22:40:29+08:00	0	0	0	0	0	0	0%	0%	0	1
14	連江縣東引鄉	2018-11-25T06:18:59+08:00	271	285	556	21	577	1138	50.7%	23.81%	1	1
14	連江縣東引鄉	2018-11-24T23:23:40+08:00	271	285	556	21	577	1138	50.7%	23.81%	1	1
14	連江縣東引鄉	2018-11-24T22:54:27+08:00	271	285	556	21	577	1138	50.7%	23.81%	1	1
14	連江縣東引鄉	2018-11-25T00:14:11+08:00	271	285	556	21	577	1138	50.7%	23.81%	1	1
14	連江縣東引鄉	2018-11-25T00:05:06+08:00	271	285	556	21	577	1138	50.7%	23.81%	1	1
14	連江縣東引鄉	2018-11-24T22:16:12+08:00	0	0	0	0	0	0	0%	0%	0	1
14	連江縣東引鄉	2018-11-24T22:41:37+08:00	0	0	0	0	0	0	0%	0%	0	1
14	連江縣東引鄉	2018-11-24T23:05:06+08:00	271	285	556	21	577	1138	50.7%	23.81%	1	1
14	連江縣東引鄉	2018-11-24T22:45:10+08:00	271	285	556	21	577	1138	50.7%	23.81%	1	1
14	連江縣東引鄉	2018-11-25T03:56:14+08:00	271	285	556	21	577	1138	50.7%	23.81%	1	1
14	連江縣東引鄉	2018-11-24T22:37:02+08:00	0	0	0	0	0	0	0%	0%	0	1
14	連江縣東引鄉	2018-11-25T00:18:32+08:00	271	285	556	21	577	1138	50.7%	23.81%	1	1
14	連江縣東引鄉	2018-11-24T23:16:04+08:00	271	285	556	21	577	1138	50.7%	23.81%	1	1
14	連江縣東引鄉	2018-11-25T00:23:05+08:00	271	285	556	21	577	1138	50.7%	23.81%	1	1
14	連江縣東引鄉	2018-11-25T01:25:54+08:00	271	285	556	21	577	1138	50.7%	23.81%	1	1
14	連江縣東引鄉	2018-11-25T01:02:32+08:00	271	285	556	21	577	1138	50.7%	23.81%	1	1
14	連江縣東引鄉	2018-11-25T06:24:01+08:00	271	285	556	21	577	1138	50.7%	23.81%	1	1
14	連江縣東引鄉	2018-11-24T22:30:11+08:00	0	0	0	0	0	0	0%	0%	0	1
14	連江縣東引鄉	2018-11-25T03:38:56+08:00	271	285	556	21	577	1138	50.7%	23.81%	1	1
14	連江縣東引鄉	2018-11-24T22:19:38+08:00	0	0	0	0	0	0	0%	0%	0	1
14	連江縣東引鄉	2018-11-24T23:19:53+08:00	271	285	556	21	577	1138	50.7%	23.81%	1	1
14	連江縣東引鄉	2018-11-25T01:17:54+08:00	271	285	556	21	577	1138	50.7%	23.81%	1	1
14	連江縣東引鄉	2018-11-25T00:00:12+08:00	271	285	556	21	577	1138	50.7%	23.81%	1	1
14	連江縣東引鄉	2018-11-24T22:57:55+08:00	271	285	556	21	577	1138	50.7%	23.81%	1	1
14	連江縣東引鄉	2018-11-24T23:27:20+08:00	271	285	556	21	577	1138	50.7%	23.81%	1	1
14	連江縣東引鄉	2018-11-25T00:57:38+08:00	271	285	556	21	577	1138	50.7%	23.81%	1	1
14	連江縣東引鄉	2018-11-24T23:35:12+08:00	271	285	556	21	577	1138	50.7%	23.81%	1	1
14	連江縣東引鄉	2018-11-24T23:47:30+08:00	271	285	556	21	577	1138	50.7%	23.81%	1	1
14	連江縣東引鄉	2018-11-25T00:09:36+08:00	271	285	556	21	577	1138	50.7%	23.81%	1	1
14	連江縣東引鄉	2018-11-24T23:31:13+08:00	271	285	556	21	577	1138	50.7%	23.81%	1	1
14	連江縣東引鄉	2018-11-25T04:02:54+08:00	271	285	556	21	577	1138	50.7%	23.81%	1	1
14	連江縣東引鄉	2018-11-24T23:01:32+08:00	271	285	556	21	577	1138	50.7%	23.81%	1	1
14	連江縣東引鄉	2018-11-25T01:12:45+08:00	271	285	556	21	577	1138	50.7%	23.81%	1	1
14	連江縣東引鄉	2018-11-24T22:26:38+08:00	0	0	0	0	0	0	0%	0%	0	1
14	連江縣東引鄉	2018-11-24T23:12:17+08:00	271	285	556	21	577	1138	50.7%	23.81%	1	1
14	連江縣東引鄉	2018-11-24T23:39:18+08:00	271	285	556	21	577	1138	50.7%	23.81%	1	1
14	連江縣東引鄉	2018-11-25T06:08:55+08:00	271	285	556	21	577	1138	50.7%	23.81%	1	1
14	桃園市中壢區	2018-11-25T01:07:17+08:00	46415	101182	147597	6720	154317	291574	52.93%	15.92%	186	210
14	桃園市中壢區	2018-11-25T06:08:42+08:00	53274	115313	168587	7636	176223	334402	52.7%	15.93%	210	210
14	桃園市中壢區	2018-11-24T22:26:28+08:00	15362	34004	49366	2311	51677	96997	53.28%	15.84%	68	210
14	桃園市中壢區	2018-11-24T23:47:18+08:00	34992	77129	112121	5120	117241	220717	53.12%	15.85%	145	210
14	桃園市中壢區	2018-11-24T23:35:02+08:00	31752	70329	102081	4658	106739	200895	53.13%	15.81%	133	210
14	桃園市中壢區	2018-11-24T22:16:00+08:00	12721	27937	40658	1950	42608	79582	53.54%	15.98%	57	210
14	桃園市中壢區	2018-11-24T23:51:25+08:00	35508	78330	113838	5182	119020	223842	53.17%	15.86%	147	210
14	桃園市中壢區	2018-11-25T00:04:56+08:00	38696	84887	123583	5575	129158	243505	53.04%	15.89%	158	210
14	桃園市中壢區	2018-11-24T22:19:28+08:00	13457	29493	42950	2042	44992	84012	53.55%	16.02%	60	210
14	桃園市中壢區	2018-11-25T00:57:27+08:00	45648	99329	144977	6577	151554	286152	52.96%	15.95%	183	210
14	桃園市中壢區	2018-11-24T22:57:43+08:00	22138	48852	70990	3198	74188	139686	53.11%	15.85%	95	210
14	桃園市中壢區	2018-11-24T22:13:17+08:00	12271	26961	39232	1872	41104	76622	53.65%	16.01%	55	210
14	桃園市中壢區	2018-11-24T23:23:30+08:00	29416	64855	94271	4290	98561	185661	53.09%	15.84%	124	210
14	桃園市中壢區	2018-11-24T22:29:55+08:00	15950	35231	51181	2382	53563	100474	53.31%	15.87%	70	210
14	桃園市中壢區	2018-11-24T23:08:25+08:00	25627	56498	82125	3737	85862	161051	53.31%	15.91%	109	210
14	桃園市中壢區	2018-11-24T23:55:38+08:00	36731	80682	117413	5310	122723	230790	53.18%	15.92%	151	210
14	桃園市中壢區	2018-11-25T03:38:46+08:00	53274	115313	168587	7636	176223	334402	52.7%	15.93%	210	210
14	桃園市中壢區	2018-11-24T23:59:58+08:00	37585	82652	120237	5452	125689	236734	53.09%	15.88%	154	210
14	桃園市中壢區	2018-11-25T03:32:25+08:00	53274	115313	168587	7636	176223	334402	52.7%	15.93%	210	210
14	桃園市中壢區	2018-11-24T23:15:53+08:00	28459	62393	90852	4126	94978	178876	53.1%	15.91%	120	210
14	桃園市中壢區	2018-11-24T22:40:19+08:00	18939	41023	59962	2758	62720	118018	53.14%	16.05%	82	210
14	桃園市中壢區	2018-11-25T01:25:43+08:00	48566	105817	154383	6992	161375	304771	52.95%	15.94%	194	210
14	桃園市中壢區	2018-11-25T06:23:51+08:00	53274	115313	168587	7636	176223	334402	52.7%	15.93%	210	210
14	桃園市中壢區	2018-11-24T22:54:17+08:00	21553	47087	68640	3124	71764	135229	53.07%	15.94%	92	210
14	桃園市中壢區	2018-11-24T22:45:00+08:00	19418	42352	61770	2806	64576	121650	53.08%	15.96%	84	210
14	桃園市中壢區	2018-11-24T23:01:21+08:00	23953	52671	76624	3478	80102	150132	53.35%	15.95%	102	210
14	桃園市中壢區	2018-11-24T23:31:01+08:00	30786	67871	98657	4494	103151	194098	53.14%	15.86%	129	210
14	桃園市中壢區	2018-11-25T00:09:23+08:00	38696	84887	123583	5575	129158	243505	53.04%	15.89%	158	210
14	桃園市中壢區	2018-11-24T22:41:27+08:00	18939	41023	59962	2758	62720	118018	53.14%	16.05%	82	210
14	桃園市中壢區	2018-11-24T22:50:37+08:00	20730	45291	66021	3000	69021	129908	53.13%	15.96%	89	210
14	桃園市中壢區	2018-11-25T00:14:00+08:00	39433	86619	126052	5683	131735	248285	53.06%	15.88%	161	210
14	桃園市中壢區	2018-11-24T23:12:05+08:00	26641	58596	85237	3859	89096	167379	53.23%	15.92%	113	210
14	桃園市中壢區	2018-11-24T23:39:04+08:00	32480	71968	104448	4774	109222	205558	53.13%	15.8%	136	210
14	桃園市中壢區	2018-11-25T01:12:32+08:00	47573	103669	151242	6856	158098	298565	52.95%	15.93%	190	210
14	桃園市中壢區	2018-11-25T01:17:41+08:00	47573	103669	151242	6856	158098	298565	52.95%	15.93%	190	210
14	桃園市中壢區	2018-11-25T03:44:11+08:00	53274	115313	168587	7636	176223	334402	52.7%	15.93%	210	210
14	桃園市中壢區	2018-11-25T06:18:48+08:00	53274	115313	168587	7636	176223	334402	52.7%	15.93%	210	210
14	桃園市中壢區	2018-11-24T23:04:55+08:00	25138	55288	80426	3653	84079	157868	53.26%	15.92%	107	210
14	桃園市中壢區	2018-11-24T22:23:02+08:00	14112	31138	45250	2117	47367	89287	53.05%	15.81%	63	210
14	桃園市中壢區	2018-11-24T23:27:10+08:00	29971	66053	96024	4371	100395	188996	53.12%	15.86%	126	210
14	桃園市中壢區	2018-11-24T22:36:52+08:00	18279	39523	57802	2679	60481	113524	53.28%	16.1%	79	210
14	桃園市中壢區	2018-11-25T01:02:21+08:00	45648	99329	144977	6577	151554	286152	52.96%	15.95%	183	210
14	桃園市中壢區	2018-11-24T23:19:39+08:00	29140	64210	93350	4256	97606	183993	53.05%	15.84%	123	210
14	桃園市中壢區	2018-11-25T00:22:55+08:00	41490	91109	132599	5970	138569	261367	53.02%	15.87%	168	210
14	桃園市中壢區	2018-11-25T06:29:06+08:00	53274	115313	168587	7636	176223	334402	52.7%	15.93%	210	210
14	桃園市中壢區	2018-11-25T03:56:01+08:00	53274	115313	168587	7636	176223	334402	52.7%	15.93%	210	210
14	桃園市中壢區	2018-11-24T22:33:28+08:00	17427	37434	54861	2551	57412	107608	53.35%	16.19%	75	210
14	桃園市中壢區	2018-11-25T06:13:43+08:00	53274	115313	168587	7636	176223	334402	52.7%	15.93%	210	210
14	桃園市中壢區	2018-11-25T04:02:39+08:00	53274	115313	168587	7636	176223	334402	52.7%	15.93%	210	210
14	桃園市中壢區	2018-11-25T00:18:21+08:00	40033	87832	127865	5752	133617	251631	53.1%	15.91%	163	210
14	桃園市中壢區	2018-11-25T03:49:42+08:00	53274	115313	168587	7636	176223	334402	52.7%	15.93%	210	210
14	桃園市中壢區	2018-11-24T23:43:08+08:00	33972	74775	108747	4946	113693	213972	53.13%	15.88%	141	210
14	臺北市文山區	2018-11-24T23:47:17+08:00	30573	52771	83344	3913	87257	144522	60.38%	21.15%	107	162
14	臺北市文山區	2018-11-24T22:26:28+08:00	16634	28732	45366	2222	47588	78688	60.48%	21.14%	60	162
14	臺北市文山區	2018-11-25T01:12:31+08:00	44348	76585	120933	5490	126423	209841	60.25%	21.13%	151	162
14	臺北市文山區	2018-11-25T01:07:16+08:00	44074	76021	120095	5460	125555	208397	60.25%	21.15%	150	162
14	臺北市文山區	2018-11-24T22:19:27+08:00	14905	25508	40413	1975	42388	69961	60.59%	21.3%	54	162
14	臺北市文山區	2018-11-24T22:13:16+08:00	14034	23906	37940	1877	39817	65689	60.61%	21.36%	51	162
14	臺北市文山區	2018-11-24T22:57:42+08:00	21242	36578	57820	2779	60599	100475	60.31%	21.14%	76	162
14	臺北市文山區	2018-11-25T00:57:26+08:00	43385	74831	118216	5388	123604	205300	60.21%	21.13%	148	162
14	臺北市文山區	2018-11-24T23:51:25+08:00	31111	53798	84909	3970	88879	147283	60.35%	21.12%	109	162
14	臺北市文山區	2018-11-24T22:29:54+08:00	16634	28732	45366	2222	47588	78688	60.48%	21.14%	60	162
14	臺北市文山區	2018-11-24T23:27:09+08:00	26179	45283	71462	3390	74852	124055	60.34%	21.1%	93	162
14	臺北市文山區	2018-11-24T22:44:59+08:00	17965	30910	48875	2381	51256	84742	60.48%	21.2%	64	162
14	臺北市文山區	2018-11-24T22:19:28+08:00	14905	25508	40413	1975	42388	69961	60.59%	21.3%	54	162
14	臺北市文山區	2018-11-24T22:23:01+08:00	16381	28173	44554	2175	46729	77244	60.5%	21.21%	59	162
14	臺北市文山區	2018-11-24T23:51:24+08:00	31111	53798	84909	3970	88879	147283	60.35%	21.12%	109	162
14	臺北市文山區	2018-11-24T23:15:52+08:00	24915	43267	68182	3250	71432	118561	60.25%	21.01%	89	162
14	臺北市文山區	2018-11-25T03:32:24+08:00	47668	82459	130127	5924	136051	227211	59.88%	20.98%	162	162
14	臺北市文山區	2018-11-25T03:38:46+08:00	47668	82459	130127	5924	136051	227211	59.88%	20.98%	162	162
14	臺北市文山區	2018-11-24T23:59:58+08:00	33538	58111	91649	4255	95904	158960	60.33%	21.1%	117	162
14	臺北市文山區	2018-11-25T01:25:42+08:00	45535	78788	124323	5638	129961	215677	60.26%	21.11%	155	162
14	臺北市文山區	2018-11-24T23:55:36+08:00	32990	57094	90084	4180	94264	156326	60.3%	21.1%	115	162
14	臺北市文山區	2018-11-24T22:40:18+08:00	17965	30910	48875	2381	51256	84742	60.48%	21.2%	64	162
14	臺北市文山區	2018-11-25T03:32:25+08:00	47668	82459	130127	5924	136051	227211	59.88%	20.98%	162	162
14	臺北市文山區	2018-11-24T23:08:24+08:00	24138	41770	65908	3158	69066	114518	60.31%	21.08%	86	162
14	臺北市文山區	2018-11-24T23:15:53+08:00	24915	43267	68182	3250	71432	118561	60.25%	21.01%	89	162
14	臺北市文山區	2018-11-24T23:59:57+08:00	33538	58111	91649	4255	95904	158960	60.33%	21.1%	117	162
14	臺北市文山區	2018-11-24T22:40:19+08:00	17965	30910	48875	2381	51256	84742	60.48%	21.2%	64	162
14	臺北市文山區	2018-11-24T23:55:37+08:00	32990	57094	90084	4180	94264	156326	60.3%	21.1%	115	162
14	臺北市文山區	2018-11-25T00:13:59+08:00	36290	62355	98645	4486	103131	171048	60.29%	21.22%	125	162
14	臺北市文山區	2018-11-24T22:36:51+08:00	16962	29223	46185	2265	48450	80104	60.48%	21.17%	61	162
14	臺北市文山區	2018-11-25T06:29:05+08:00	47668	82459	130127	5924	136051	227211	59.88%	20.98%	162	162
14	臺北市文山區	2018-11-24T22:54:17+08:00	19500	33690	53190	2558	55748	92291	60.4%	21.13%	70	162
14	臺北市文山區	2018-11-25T06:23:50+08:00	47668	82459	130127	5924	136051	227211	59.88%	20.98%	162	162
14	臺北市文山區	2018-11-24T23:01:21+08:00	22347	38646	60993	2941	63934	105960	60.34%	21.09%	80	162
14	臺北市文山區	2018-11-24T23:39:02+08:00	28009	48409	76418	3587	80005	132692	60.29%	21.11%	99	162
14	臺北市文山區	2018-11-24T23:12:04+08:00	24138	41770	65908	3158	69066	114518	60.31%	21.08%	86	162
14	臺北市文山區	2018-11-25T06:08:41+08:00	47668	82459	130127	5924	136051	227211	59.88%	20.98%	162	162
14	臺北市文山區	2018-11-25T06:08:40+08:00	47668	82459	130127	5924	136051	227211	59.88%	20.98%	162	162
14	臺北市文山區	2018-11-25T00:09:22+08:00	35183	60761	95944	4395	100339	166489	60.27%	21.13%	122	162
14	臺北市文山區	2018-11-24T23:31:00+08:00	27144	46867	74011	3464	77475	128357	60.36%	21.15%	96	162
14	臺北市文山區	2018-11-24T23:39:03+08:00	28009	48409	76418	3587	80005	132692	60.29%	21.11%	99	162
14	臺北市文山區	2018-11-24T23:01:20+08:00	22347	38646	60993	2941	63934	105960	60.34%	21.09%	80	162
14	臺北市文山區	2018-11-24T22:50:36+08:00	19500	33690	53190	2558	55748	92291	60.4%	21.13%	70	162
14	臺北市文山區	2018-11-25T01:12:32+08:00	44348	76585	120933	5490	126423	209841	60.25%	21.13%	151	162
14	臺北市文山區	2018-11-24T22:41:26+08:00	17965	30910	48875	2381	51256	84742	60.48%	21.2%	64	162
14	臺北市文山區	2018-11-24T23:35:01+08:00	27430	47348	74778	3508	78286	129822	60.3%	21.13%	97	162
14	臺北市文山區	2018-11-24T23:04:54+08:00	23604	40785	64389	3076	67465	111870	60.31%	21.1%	84	162
14	臺北市文山區	2018-11-25T00:04:55+08:00	34514	59690	94204	4343	98547	163504	60.27%	21.11%	120	162
14	臺北市文山區	2018-11-25T06:18:48+08:00	47668	82459	130127	5924	136051	227211	59.88%	20.98%	162	162
14	臺北市文山區	2018-11-24T22:23:02+08:00	16381	28173	44554	2175	46729	77244	60.5%	21.21%	59	162
14	臺北市文山區	2018-11-25T03:44:10+08:00	47668	82459	130127	5924	136051	227211	59.88%	20.98%	162	162
14	臺北市文山區	2018-11-25T01:17:40+08:00	44682	77196	121878	5532	127410	211563	60.22%	21.12%	152	162
14	臺北市文山區	2018-11-25T01:02:20+08:00	43736	75385	119121	5419	124540	206781	60.23%	21.15%	149	162
14	臺北市文山區	2018-11-25T03:38:45+08:00	47668	82459	130127	5924	136051	227211	59.88%	20.98%	162	162
14	臺北市文山區	2018-11-24T23:19:38+08:00	25915	44854	70769	3364	74133	122936	60.3%	21.08%	92	162
14	臺北市文山區	2018-11-24T23:23:29+08:00	25915	44854	70769	3364	74133	122936	60.3%	21.08%	92	162
14	臺北市文山區	2018-11-24T22:15:59+08:00	14297	24357	38654	1900	40554	66960	60.56%	21.35%	52	162
14	臺北市文山區	2018-11-24T23:19:39+08:00	25915	44854	70769	3364	74133	122936	60.3%	21.08%	92	162
14	臺北市文山區	2018-11-25T01:17:39+08:00	44682	77196	121878	5532	127410	211563	60.22%	21.12%	152	162
14	臺北市文山區	2018-11-25T06:29:06+08:00	47668	82459	130127	5924	136051	227211	59.88%	20.98%	162	162
14	臺北市文山區	2018-11-24T22:33:28+08:00	16634	28732	45366	2222	47588	78688	60.48%	21.14%	60	162
14	臺北市文山區	2018-11-25T06:13:43+08:00	47668	82459	130127	5924	136051	227211	59.88%	20.98%	162	162
14	臺北市文山區	2018-11-24T23:43:07+08:00	29899	51729	81628	3845	85473	141526	60.39%	21.13%	105	162
14	臺北市文山區	2018-11-25T00:22:53+08:00	37752	65124	102876	4707	107583	178359	60.32%	21.17%	130	162
14	臺北市文山區	2018-11-25T03:56:00+08:00	47668	82459	130127	5924	136051	227211	59.88%	20.98%	162	162
14	臺北市文山區	2018-11-24T22:33:27+08:00	16634	28732	45366	2222	47588	78688	60.48%	21.14%	60	162
14	臺北市文山區	2018-11-25T03:49:42+08:00	47668	82459	130127	5924	136051	227211	59.88%	20.98%	162	162
14	臺北市文山區	2018-11-25T00:18:20+08:00	37233	63904	101137	4643	105780	175489	60.28%	21.22%	128	162
14	臺北市文山區	2018-11-25T06:13:42+08:00	47668	82459	130127	5924	136051	227211	59.88%	20.98%	162	162
14	臺北市文山區	2018-11-25T04:02:38+08:00	47668	82459	130127	5924	136051	227211	59.88%	20.98%	162	162
14	桃園市觀音區	2018-11-25T01:07:17+08:00	8076	18134	26210	1669	27879	55149	50.55%	14.64%	41	41
14	桃園市觀音區	2018-11-24T23:01:22+08:00	7272	16293	23565	1534	25099	49500	50.71%	14.69%	37	41
14	桃園市觀音區	2018-11-25T06:08:42+08:00	8076	18134	26210	1669	27879	55149	50.55%	14.64%	41	41
14	桃園市觀音區	2018-11-24T23:47:18+08:00	8076	18134	26210	1669	27879	55149	50.55%	14.64%	41	41
14	桃園市觀音區	2018-11-24T23:35:02+08:00	8076	18134	26210	1669	27879	55149	50.55%	14.64%	41	41
14	桃園市觀音區	2018-11-24T23:12:06+08:00	7438	16696	24134	1567	25701	50851	50.54%	14.63%	38	41
14	桃園市觀音區	2018-11-24T22:26:29+08:00	5596	12593	18189	1278	19467	38598	50.44%	14.5%	29	41
14	桃園市觀音區	2018-11-24T22:16:00+08:00	4488	10184	14672	1014	15686	31382	49.98%	14.3%	24	41
14	桃園市觀音區	2018-11-25T03:44:12+08:00	8076	18134	26210	1669	27879	55149	50.55%	14.64%	41	41
14	桃園市觀音區	2018-11-25T00:04:56+08:00	8076	18134	26210	1669	27879	55149	50.55%	14.64%	41	41
14	桃園市觀音區	2018-11-24T22:19:28+08:00	4732	10718	15450	1072	16522	33073	49.96%	14.31%	25	41
14	桃園市觀音區	2018-11-24T22:57:44+08:00	7093	15832	22925	1502	24427	48221	50.66%	14.71%	36	41
14	桃園市觀音區	2018-11-25T00:57:27+08:00	8076	18134	26210	1669	27879	55149	50.55%	14.64%	41	41
14	桃園市觀音區	2018-11-24T22:13:17+08:00	4221	9578	13799	982	14781	29513	50.08%	14.3%	23	41
14	桃園市觀音區	2018-11-24T23:23:30+08:00	8076	18134	26210	1669	27879	55149	50.55%	14.64%	41	41
14	桃園市觀音區	2018-11-24T22:29:55+08:00	5596	12593	18189	1278	19467	38598	50.44%	14.5%	29	41
14	桃園市觀音區	2018-11-24T23:55:38+08:00	8076	18134	26210	1669	27879	55149	50.55%	14.64%	41	41
14	桃園市觀音區	2018-11-25T03:32:25+08:00	8076	18134	26210	1669	27879	55149	50.55%	14.64%	41	41
14	桃園市觀音區	2018-11-24T23:15:54+08:00	7914	17708	25622	1632	27254	54037	50.44%	14.65%	40	41
14	桃園市觀音區	2018-11-24T22:40:19+08:00	6072	13677	19749	1354	21103	41745	50.55%	14.55%	31	41
14	桃園市觀音區	2018-11-25T01:25:43+08:00	8076	18134	26210	1669	27879	55149	50.55%	14.64%	41	41
14	桃園市觀音區	2018-11-24T23:59:59+08:00	8076	18134	26210	1669	27879	55149	50.55%	14.64%	41	41
14	桃園市觀音區	2018-11-25T03:38:47+08:00	8076	18134	26210	1669	27879	55149	50.55%	14.64%	41	41
14	桃園市觀音區	2018-11-24T22:54:18+08:00	6792	15122	21914	1466	23380	45985	50.84%	14.77%	34	41
14	桃園市觀音區	2018-11-25T06:23:51+08:00	8076	18134	26210	1669	27879	55149	50.55%	14.64%	41	41
14	桃園市觀音區	2018-11-24T22:45:00+08:00	6309	14184	20493	1384	21877	43262	50.57%	14.58%	32	41
14	桃園市觀音區	2018-11-24T23:31:01+08:00	8076	18134	26210	1669	27879	55149	50.55%	14.64%	41	41
14	桃園市觀音區	2018-11-25T00:09:24+08:00	8076	18134	26210	1669	27879	55149	50.55%	14.64%	41	41
14	桃園市觀音區	2018-11-24T22:41:27+08:00	6072	13677	19749	1354	21103	41745	50.55%	14.55%	31	41
14	桃園市觀音區	2018-11-25T01:12:33+08:00	8076	18134	26210	1669	27879	55149	50.55%	14.64%	41	41
14	桃園市觀音區	2018-11-24T22:50:37+08:00	6556	14667	21223	1428	22651	44723	50.65%	14.66%	33	41
14	桃園市觀音區	2018-11-25T00:14:00+08:00	8076	18134	26210	1669	27879	55149	50.55%	14.64%	41	41
14	桃園市觀音區	2018-11-24T23:39:04+08:00	8076	18134	26210	1669	27879	55149	50.55%	14.64%	41	41
14	桃園市觀音區	2018-11-24T23:51:26+08:00	8076	18134	26210	1669	27879	55149	50.55%	14.64%	41	41
14	桃園市觀音區	2018-11-25T06:18:49+08:00	8076	18134	26210	1669	27879	55149	50.55%	14.64%	41	41
14	桃園市觀音區	2018-11-25T01:17:41+08:00	8076	18134	26210	1669	27879	55149	50.55%	14.64%	41	41
14	桃園市觀音區	2018-11-24T22:23:03+08:00	5181	11655	16836	1148	17984	35813	50.22%	14.47%	27	41
14	桃園市觀音區	2018-11-24T23:04:55+08:00	7272	16293	23565	1534	25099	49500	50.71%	14.69%	37	41
14	桃園市觀音區	2018-11-24T23:19:40+08:00	8076	18134	26210	1669	27879	55149	50.55%	14.64%	41	41
14	桃園市觀音區	2018-11-24T23:27:10+08:00	8076	18134	26210	1669	27879	55149	50.55%	14.64%	41	41
14	桃園市觀音區	2018-11-24T23:08:26+08:00	7438	16696	24134	1567	25701	50851	50.54%	14.63%	38	41
14	桃園市觀音區	2018-11-24T22:36:52+08:00	6072	13677	19749	1354	21103	41745	50.55%	14.55%	31	41
14	桃園市觀音區	2018-11-25T01:02:21+08:00	8076	18134	26210	1669	27879	55149	50.55%	14.64%	41	41
14	桃園市觀音區	2018-11-25T03:49:43+08:00	8076	18134	26210	1669	27879	55149	50.55%	14.64%	41	41
14	桃園市觀音區	2018-11-25T00:22:55+08:00	8076	18134	26210	1669	27879	55149	50.55%	14.64%	41	41
14	桃園市觀音區	2018-11-25T03:56:01+08:00	8076	18134	26210	1669	27879	55149	50.55%	14.64%	41	41
14	桃園市觀音區	2018-11-25T04:02:39+08:00	8076	18134	26210	1669	27879	55149	50.55%	14.64%	41	41
14	桃園市觀音區	2018-11-25T06:13:44+08:00	8076	18134	26210	1669	27879	55149	50.55%	14.64%	41	41
14	桃園市觀音區	2018-11-25T00:18:21+08:00	8076	18134	26210	1669	27879	55149	50.55%	14.64%	41	41
14	桃園市觀音區	2018-11-24T22:33:29+08:00	5596	12593	18189	1278	19467	38598	50.44%	14.5%	29	41
14	桃園市觀音區	2018-11-25T06:29:07+08:00	8076	18134	26210	1669	27879	55149	50.55%	14.64%	41	41
14	桃園市觀音區	2018-11-24T23:43:08+08:00	8076	18134	26210	1669	27879	55149	50.55%	14.64%	41	41
14	屏東縣鹽埔鄉	2018-11-24T23:16:01+08:00	3263	7500	10763	880	11643	22402	51.97%	14.57%	20	20
14	屏東縣鹽埔鄉	2018-11-24T23:43:16+08:00	3263	7500	10763	880	11643	22402	51.97%	14.57%	20	20
14	屏東縣鹽埔鄉	2018-11-24T22:33:36+08:00	3115	7129	10244	807	11051	21418	51.6%	14.54%	19	20
14	屏東縣鹽埔鄉	2018-11-25T03:56:11+08:00	3263	7500	10763	880	11643	22402	51.97%	14.57%	20	20
14	屏東縣鹽埔鄉	2018-11-24T23:47:27+08:00	3263	7500	10763	880	11643	22402	51.97%	14.57%	20	20
14	屏東縣鹽埔鄉	2018-11-24T22:16:09+08:00	2593	6122	8715	746	9461	18432	51.33%	14.07%	17	20
14	屏東縣鹽埔鄉	2018-11-25T03:38:54+08:00	3263	7500	10763	880	11643	22402	51.97%	14.57%	20	20
14	屏東縣鹽埔鄉	2018-11-25T01:25:51+08:00	3263	7500	10763	880	11643	22402	51.97%	14.57%	20	20
14	屏東縣鹽埔鄉	2018-11-24T23:23:37+08:00	3263	7500	10763	880	11643	22402	51.97%	14.57%	20	20
14	屏東縣鹽埔鄉	2018-11-25T06:18:56+08:00	3263	7500	10763	880	11643	22402	51.97%	14.57%	20	20
14	屏東縣鹽埔鄉	2018-11-24T22:30:06+08:00	3115	7129	10244	807	11051	21418	51.6%	14.54%	19	20
14	屏東縣鹽埔鄉	2018-11-25T01:17:50+08:00	3263	7500	10763	880	11643	22402	51.97%	14.57%	20	20
14	屏東縣鹽埔鄉	2018-11-24T22:36:59+08:00	3115	7129	10244	807	11051	21418	51.6%	14.54%	19	20
14	屏東縣鹽埔鄉	2018-11-24T22:40:26+08:00	3115	7129	10244	807	11051	21418	51.6%	14.54%	19	20
14	屏東縣鹽埔鄉	2018-11-25T00:57:35+08:00	3263	7500	10763	880	11643	22402	51.97%	14.57%	20	20
14	屏東縣鹽埔鄉	2018-11-24T23:31:10+08:00	3263	7500	10763	880	11643	22402	51.97%	14.57%	20	20
14	屏東縣鹽埔鄉	2018-11-24T23:39:14+08:00	3263	7500	10763	880	11643	22402	51.97%	14.57%	20	20
14	屏東縣鹽埔鄉	2018-11-25T04:02:51+08:00	3263	7500	10763	880	11643	22402	51.97%	14.57%	20	20
14	屏東縣鹽埔鄉	2018-11-24T22:26:35+08:00	3115	7129	10244	807	11051	21418	51.6%	14.54%	19	20
14	屏東縣鹽埔鄉	2018-11-24T23:12:14+08:00	3263	7500	10763	880	11643	22402	51.97%	14.57%	20	20
14	屏東縣鹽埔鄉	2018-11-25T06:23:59+08:00	3263	7500	10763	880	11643	22402	51.97%	14.57%	20	20
14	屏東縣鹽埔鄉	2018-11-25T00:09:33+08:00	3263	7500	10763	880	11643	22402	51.97%	14.57%	20	20
14	屏東縣鹽埔鄉	2018-11-24T22:45:07+08:00	3263	7500	10763	880	11643	22402	51.97%	14.57%	20	20
14	屏東縣鹽埔鄉	2018-11-25T06:08:51+08:00	3263	7500	10763	880	11643	22402	51.97%	14.57%	20	20
14	屏東縣鹽埔鄉	2018-11-25T01:07:25+08:00	3263	7500	10763	880	11643	22402	51.97%	14.57%	20	20
14	屏東縣鹽埔鄉	2018-11-25T06:13:51+08:00	3263	7500	10763	880	11643	22402	51.97%	14.57%	20	20
14	屏東縣鹽埔鄉	2018-11-24T23:35:09+08:00	3263	7500	10763	880	11643	22402	51.97%	14.57%	20	20
14	屏東縣鹽埔鄉	2018-11-24T23:01:29+08:00	3263	7500	10763	880	11643	22402	51.97%	14.57%	20	20
14	屏東縣鹽埔鄉	2018-11-25T03:49:50+08:00	3263	7500	10763	880	11643	22402	51.97%	14.57%	20	20
14	屏東縣鹽埔鄉	2018-11-25T00:14:08+08:00	3263	7500	10763	880	11643	22402	51.97%	14.57%	20	20
14	屏東縣鹽埔鄉	2018-11-25T06:29:15+08:00	3263	7500	10763	880	11643	22402	51.97%	14.57%	20	20
14	屏東縣鹽埔鄉	2018-11-24T23:55:45+08:00	3263	7500	10763	880	11643	22402	51.97%	14.57%	20	20
14	屏東縣鹽埔鄉	2018-11-24T23:08:34+08:00	3263	7500	10763	880	11643	22402	51.97%	14.57%	20	20
14	屏東縣鹽埔鄉	2018-11-25T00:00:09+08:00	3263	7500	10763	880	11643	22402	51.97%	14.57%	20	20
14	屏東縣鹽埔鄉	2018-11-25T00:23:02+08:00	3263	7500	10763	880	11643	22402	51.97%	14.57%	20	20
14	屏東縣鹽埔鄉	2018-11-25T03:32:33+08:00	3263	7500	10763	880	11643	22402	51.97%	14.57%	20	20
14	屏東縣鹽埔鄉	2018-11-25T03:44:21+08:00	3263	7500	10763	880	11643	22402	51.97%	14.57%	20	20
14	屏東縣鹽埔鄉	2018-11-24T22:13:25+08:00	2593	6122	8715	746	9461	18432	51.33%	14.07%	17	20
14	屏東縣鹽埔鄉	2018-11-24T23:19:49+08:00	3263	7500	10763	880	11643	22402	51.97%	14.57%	20	20
14	屏東縣鹽埔鄉	2018-11-24T22:23:11+08:00	3115	7129	10244	807	11051	21418	51.6%	14.54%	19	20
14	屏東縣鹽埔鄉	2018-11-24T23:27:17+08:00	3263	7500	10763	880	11643	22402	51.97%	14.57%	20	20
14	屏東縣鹽埔鄉	2018-11-24T22:19:36+08:00	2861	6553	9414	755	10169	19799	51.36%	14.45%	18	20
14	屏東縣鹽埔鄉	2018-11-25T01:02:29+08:00	3263	7500	10763	880	11643	22402	51.97%	14.57%	20	20
14	屏東縣鹽埔鄉	2018-11-24T23:51:33+08:00	3263	7500	10763	880	11643	22402	51.97%	14.57%	20	20
14	屏東縣鹽埔鄉	2018-11-24T22:57:52+08:00	3263	7500	10763	880	11643	22402	51.97%	14.57%	20	20
14	屏東縣鹽埔鄉	2018-11-24T23:05:03+08:00	3263	7500	10763	880	11643	22402	51.97%	14.57%	20	20
14	屏東縣鹽埔鄉	2018-11-24T22:54:24+08:00	3263	7500	10763	880	11643	22402	51.97%	14.57%	20	20
14	屏東縣鹽埔鄉	2018-11-25T00:18:28+08:00	3263	7500	10763	880	11643	22402	51.97%	14.57%	20	20
14	屏東縣鹽埔鄉	2018-11-24T22:41:33+08:00	3115	7129	10244	807	11051	21418	51.6%	14.54%	19	20
14	屏東縣鹽埔鄉	2018-11-25T00:05:03+08:00	3263	7500	10763	880	11643	22402	51.97%	14.57%	20	20
14	屏東縣鹽埔鄉	2018-11-25T01:12:42+08:00	3263	7500	10763	880	11643	22402	51.97%	14.57%	20	20
14	屏東縣鹽埔鄉	2018-11-24T22:50:46+08:00	3263	7500	10763	880	11643	22402	51.97%	14.57%	20	20
14	臺南市北區	2018-11-24T23:35:04+08:00	19475	36080	55555	2703	58258	107932	53.98%	18.04%	79	81
14	臺南市北區	2018-11-24T23:47:21+08:00	19670	36588	56258	2735	58993	109322	53.96%	17.99%	80	81
14	臺南市北區	2018-11-25T06:08:45+08:00	19963	37147	57110	2775	59885	110906	54%	18%	81	81
14	臺南市北區	2018-11-24T23:43:11+08:00	19670	36588	56258	2735	58993	109322	53.96%	17.99%	80	81
14	臺南市北區	2018-11-25T01:07:19+08:00	19963	37147	57110	2775	59885	110906	54%	18%	81	81
14	臺南市北區	2018-11-24T22:33:31+08:00	15159	27735	42894	2077	44971	83167	54.07%	18.23%	63	81
14	臺南市北區	2018-11-25T00:14:02+08:00	19670	36588	56258	2735	58993	109322	53.96%	17.99%	80	81
14	臺南市北區	2018-11-25T04:02:42+08:00	19963	37147	57110	2775	59885	110906	54%	18%	81	81
14	臺南市北區	2018-11-25T00:09:26+08:00	19670	36588	56258	2735	58993	109322	53.96%	17.99%	80	81
14	臺南市北區	2018-11-24T23:12:08+08:00	18106	33512	51618	2508	54126	99541	54.38%	18.19%	74	81
14	臺南市北區	2018-11-24T23:39:07+08:00	19475	36080	55555	2703	58258	107932	53.98%	18.04%	79	81
14	臺南市北區	2018-11-24T23:31:03+08:00	19148	35449	54597	2646	57243	106058	53.97%	18.05%	78	81
14	臺南市北區	2018-11-24T23:01:24+08:00	16943	31316	48259	2343	50602	93271	54.25%	18.17%	70	81
14	臺南市北區	2018-11-25T03:44:15+08:00	19963	37147	57110	2775	59885	110906	54%	18%	81	81
14	臺南市北區	2018-11-24T23:19:42+08:00	18842	34868	53710	2630	56340	104338	54%	18.06%	77	81
14	臺南市北區	2018-11-25T00:04:58+08:00	19670	36588	56258	2735	58993	109322	53.96%	17.99%	80	81
14	臺南市北區	2018-11-24T23:04:57+08:00	16943	31316	48259	2343	50602	93271	54.25%	18.17%	70	81
14	臺南市北區	2018-11-24T22:13:19+08:00	12752	23127	35879	1753	37632	69726	53.97%	18.29%	53	81
14	臺南市北區	2018-11-25T01:17:44+08:00	19963	37147	57110	2775	59885	110906	54%	18%	81	81
14	臺南市北區	2018-11-24T23:55:40+08:00	19670	36588	56258	2735	58993	109322	53.96%	17.99%	80	81
14	臺南市北區	2018-11-25T06:18:51+08:00	19963	37147	57110	2775	59885	110906	54%	18%	81	81
14	臺南市北區	2018-11-25T01:02:24+08:00	19963	37147	57110	2775	59885	110906	54%	18%	81	81
14	臺南市北區	2018-11-25T03:38:49+08:00	19963	37147	57110	2775	59885	110906	54%	18%	81	81
14	臺南市北區	2018-11-24T23:27:12+08:00	19148	35449	54597	2646	57243	106058	53.97%	18.05%	78	81
14	臺南市北區	2018-11-24T22:54:20+08:00	16748	30897	47645	2323	49968	92082	54.26%	18.19%	69	81
14	臺南市北區	2018-11-25T00:18:23+08:00	19670	36588	56258	2735	58993	109322	53.96%	17.99%	80	81
14	臺南市北區	2018-11-25T06:13:46+08:00	19963	37147	57110	2775	59885	110906	54%	18%	81	81
14	臺南市北區	2018-11-25T00:22:57+08:00	19670	36588	56258	2735	58993	109322	53.96%	17.99%	80	81
14	臺南市北區	2018-11-25T03:56:04+08:00	19963	37147	57110	2775	59885	110906	54%	18%	81	81
14	臺南市北區	2018-11-24T22:41:29+08:00	15703	28785	44488	2143	46631	86024	54.21%	18.25%	65	81
14	臺南市北區	2018-11-24T22:16:03+08:00	13217	24120	37337	1841	39178	72626	53.94%	18.2%	55	81
14	臺南市北區	2018-11-25T01:12:35+08:00	19963	37147	57110	2775	59885	110906	54%	18%	81	81
14	臺南市北區	2018-11-24T22:29:59+08:00	14838	27210	42048	2034	44082	81505	54.09%	18.21%	62	81
14	臺南市北區	2018-11-24T23:23:32+08:00	19148	35449	54597	2646	57243	106058	53.97%	18.05%	78	81
14	臺南市北區	2018-11-24T23:51:28+08:00	19670	36588	56258	2735	58993	109322	53.96%	17.99%	80	81
14	臺南市北區	2018-11-24T22:57:46+08:00	16748	30897	47645	2323	49968	92082	54.26%	18.19%	69	81
14	臺南市北區	2018-11-25T00:00:01+08:00	19670	36588	56258	2735	58993	109322	53.96%	17.99%	80	81
14	臺南市北區	2018-11-24T22:23:05+08:00	13946	25495	39441	1928	41369	76540	54.05%	18.22%	58	81
14	臺南市北區	2018-11-24T22:36:54+08:00	15415	28218	43633	2108	45741	84429	54.18%	18.26%	64	81
14	臺南市北區	2018-11-25T01:25:46+08:00	19963	37147	57110	2775	59885	110906	54%	18%	81	81
14	臺南市北區	2018-11-25T00:57:30+08:00	19963	37147	57110	2775	59885	110906	54%	18%	81	81
14	臺南市北區	2018-11-24T23:15:56+08:00	18313	33863	52176	2545	54721	101108	54.12%	18.11%	75	81
14	臺南市北區	2018-11-24T23:08:28+08:00	17562	32378	49940	2423	52363	96390	54.32%	18.22%	72	81
14	臺南市北區	2018-11-24T22:40:22+08:00	15703	28785	44488	2143	46631	86024	54.21%	18.25%	65	81
14	臺南市北區	2018-11-24T22:19:30+08:00	13731	24998	38729	1896	40625	75222	54.01%	18.25%	57	81
14	臺南市北區	2018-11-25T03:32:28+08:00	19963	37147	57110	2775	59885	110906	54%	18%	81	81
14	臺南市北區	2018-11-24T22:45:02+08:00	16158	29744	45902	2230	48132	88870	54.16%	18.18%	67	81
14	臺南市北區	2018-11-24T22:50:40+08:00	16399	30246	46645	2281	48926	90210	54.24%	18.18%	68	81
14	臺南市北區	2018-11-25T03:49:45+08:00	19963	37147	57110	2775	59885	110906	54%	18%	81	81
14	臺南市北區	2018-11-25T06:29:09+08:00	19963	37147	57110	2775	59885	110906	54%	18%	81	81
14	臺南市北區	2018-11-25T06:23:53+08:00	19963	37147	57110	2775	59885	110906	54%	18%	81	81
14	臺南市北區	2018-11-24T22:26:31+08:00	14371	26360	40731	1985	42716	79092	54.01%	18.17%	60	81
14	屏東縣	2018-11-25T03:56:10+08:00	105349	238235	343584	28287	371871	711720	52.25%	14.8%	689	689
14	屏東縣	2018-11-24T23:47:26+08:00	101492	229702	331194	27606	358800	686506	52.26%	14.78%	671	689
14	屏東縣	2018-11-24T23:16:01+08:00	95535	215871	311406	26329	337735	645314	52.34%	14.8%	640	689
14	屏東縣	2018-11-24T22:33:36+08:00	79957	178554	258511	22831	281342	538303	52.26%	14.85%	551	689
14	屏東縣	2018-11-24T22:16:09+08:00	71911	161480	233391	20964	254355	486619	52.27%	14.78%	508	689
14	屏東縣	2018-11-25T03:38:53+08:00	105349	238235	343584	28287	371871	711720	52.25%	14.8%	689	689
14	屏東縣	2018-11-24T23:23:36+08:00	97090	219583	316673	26656	343329	655936	52.34%	14.8%	648	689
14	屏東縣	2018-11-25T01:25:51+08:00	105349	238235	343584	28287	371871	711720	52.25%	14.8%	689	689
14	屏東縣	2018-11-24T22:19:35+08:00	73767	165426	239193	21475	260668	498665	52.27%	14.79%	519	689
14	屏東縣	2018-11-25T01:17:50+08:00	105349	238235	343584	28287	371871	711720	52.25%	14.8%	689	689
14	屏東縣	2018-11-24T22:36:59+08:00	83621	187679	271300	23654	294954	564344	52.26%	14.82%	572	689
14	屏東縣	2018-11-24T22:40:26+08:00	85099	191136	276235	23955	300190	574326	52.27%	14.82%	581	689
14	屏東縣	2018-11-25T00:57:35+08:00	105142	237755	342897	28234	371131	710201	52.26%	14.8%	688	689
14	屏東縣	2018-11-24T22:57:51+08:00	91495	205804	297299	25384	322683	616838	52.31%	14.83%	616	689
14	屏東縣	2018-11-25T00:09:32+08:00	103154	233069	336223	27844	364067	696528	52.27%	14.81%	678	689
14	屏東縣	2018-11-25T06:23:58+08:00	105349	238235	343584	28287	371871	711720	52.25%	14.8%	689	689
14	屏東縣	2018-11-24T23:39:14+08:00	100254	226899	327153	27367	354520	678178	52.28%	14.78%	664	689
14	屏東縣	2018-11-25T03:49:49+08:00	105349	238235	343584	28287	371871	711720	52.25%	14.8%	689	689
14	屏東縣	2018-11-25T01:12:41+08:00	105349	238235	343584	28287	371871	711720	52.25%	14.8%	689	689
14	屏東縣	2018-11-24T22:26:35+08:00	76944	172015	248959	22197	271156	518774	52.27%	14.83%	535	689
14	屏東縣	2018-11-24T23:12:14+08:00	93784	211860	305644	25924	331568	633828	52.31%	14.8%	630	689
14	屏東縣	2018-11-24T22:45:07+08:00	87069	195824	282893	24394	307287	588099	52.25%	14.81%	592	689
14	屏東縣	2018-11-25T06:08:51+08:00	105349	238235	343584	28287	371871	711720	52.25%	14.8%	689	689
14	屏東縣	2018-11-25T04:02:50+08:00	105349	238235	343584	28287	371871	711720	52.25%	14.8%	689	689
14	屏東縣	2018-11-25T06:13:51+08:00	105349	238235	343584	28287	371871	711720	52.25%	14.8%	689	689
14	屏東縣	2018-11-24T23:43:15+08:00	100504	227557	328061	27432	355493	680046	52.27%	14.78%	666	689
14	屏東縣	2018-11-25T00:14:07+08:00	103497	233880	337377	27954	365331	699240	52.25%	14.8%	680	689
14	屏東縣	2018-11-24T23:35:09+08:00	99741	225647	325388	27183	352571	674368	52.28%	14.79%	661	689
14	屏東縣	2018-11-24T23:01:29+08:00	91999	207013	299012	25537	324549	620475	52.31%	14.83%	619	689
14	屏東縣	2018-11-25T01:07:24+08:00	105349	238235	343584	28287	371871	711720	52.25%	14.8%	689	689
14	屏東縣	2018-11-24T23:31:09+08:00	99146	224406	323552	27050	350602	670644	52.28%	14.78%	658	689
14	屏東縣	2018-11-25T06:29:15+08:00	105349	238235	343584	28287	371871	711720	52.25%	14.8%	689	689
14	屏東縣	2018-11-24T23:55:45+08:00	101692	230198	331890	27636	359526	687876	52.27%	14.78%	672	689
14	屏東縣	2018-11-24T23:08:34+08:00	93415	210901	304316	25812	330128	631028	52.32%	14.8%	628	689
14	屏東縣	2018-11-25T00:00:09+08:00	101692	230198	331890	27636	359526	687876	52.27%	14.78%	672	689
14	屏東縣	2018-11-25T00:23:02+08:00	103651	234115	337766	27989	365755	699908	52.26%	14.81%	681	689
14	屏東縣	2018-11-24T23:19:48+08:00	96190	217411	313601	26434	340035	649744	52.33%	14.8%	643	689
14	屏東縣	2018-11-25T03:32:33+08:00	105349	238235	343584	28287	371871	711720	52.25%	14.8%	689	689
14	屏東縣	2018-11-25T03:44:21+08:00	105349	238235	343584	28287	371871	711720	52.25%	14.8%	689	689
14	屏東縣	2018-11-24T22:13:25+08:00	69807	156939	226746	20423	247169	472960	52.26%	14.76%	497	689
14	屏東縣	2018-11-24T22:23:11+08:00	75977	170756	246733	22048	268781	513816	52.31%	14.79%	531	689
14	屏東縣	2018-11-24T22:30:05+08:00	77951	174327	252278	22365	274643	525587	52.25%	14.83%	540	689
14	屏東縣	2018-11-24T23:27:17+08:00	97848	221525	319373	26802	346175	661895	52.3%	14.78%	652	689
14	屏東縣	2018-11-25T01:02:29+08:00	105349	238235	343584	28287	371871	711720	52.25%	14.8%	689	689
14	屏東縣	2018-11-24T23:51:33+08:00	101692	230198	331890	27636	359526	687876	52.27%	14.78%	672	689
14	屏東縣	2018-11-25T06:18:55+08:00	105349	238235	343584	28287	371871	711720	52.25%	14.8%	689	689
14	屏東縣	2018-11-24T23:05:03+08:00	92640	208826	301466	25653	327119	625419	52.3%	14.81%	623	689
14	屏東縣	2018-11-24T22:54:24+08:00	89763	201860	291623	25008	316631	605578	52.29%	14.82%	607	689
14	屏東縣	2018-11-25T00:18:28+08:00	103497	233880	337377	27954	365331	699240	52.25%	14.8%	680	689
14	屏東縣	2018-11-24T22:41:33+08:00	85099	191136	276235	23955	300190	574326	52.27%	14.82%	581	689
14	屏東縣	2018-11-25T00:05:03+08:00	102862	232389	335251	27809	363060	694578	52.27%	14.81%	677	689
14	屏東縣	2018-11-24T22:50:46+08:00	89291	200719	290010	24922	314932	602382	52.28%	14.82%	604	689
14	臺南市楠西區	2018-11-24T23:35:04+08:00	892	2621	3513	334	3847	8528	45.11%	10.46%	9	9
14	臺南市楠西區	2018-11-24T23:47:21+08:00	892	2621	3513	334	3847	8528	45.11%	10.46%	9	9
14	臺南市楠西區	2018-11-25T01:07:19+08:00	892	2621	3513	334	3847	8528	45.11%	10.46%	9	9
14	臺南市楠西區	2018-11-24T22:33:31+08:00	892	2621	3513	334	3847	8528	45.11%	10.46%	9	9
14	臺南市楠西區	2018-11-25T00:14:02+08:00	892	2621	3513	334	3847	8528	45.11%	10.46%	9	9
14	臺南市楠西區	2018-11-24T23:43:10+08:00	892	2621	3513	334	3847	8528	45.11%	10.46%	9	9
14	臺南市楠西區	2018-11-25T06:08:44+08:00	892	2621	3513	334	3847	8528	45.11%	10.46%	9	9
14	臺南市楠西區	2018-11-25T00:09:26+08:00	892	2621	3513	334	3847	8528	45.11%	10.46%	9	9
14	臺南市楠西區	2018-11-24T23:12:08+08:00	892	2621	3513	334	3847	8528	45.11%	10.46%	9	9
14	臺南市楠西區	2018-11-24T23:39:07+08:00	892	2621	3513	334	3847	8528	45.11%	10.46%	9	9
14	臺南市楠西區	2018-11-24T23:31:03+08:00	892	2621	3513	334	3847	8528	45.11%	10.46%	9	9
14	臺南市楠西區	2018-11-24T23:01:24+08:00	892	2621	3513	334	3847	8528	45.11%	10.46%	9	9
14	臺南市楠西區	2018-11-24T23:19:42+08:00	892	2621	3513	334	3847	8528	45.11%	10.46%	9	9
14	臺南市楠西區	2018-11-25T00:04:58+08:00	892	2621	3513	334	3847	8528	45.11%	10.46%	9	9
14	臺南市楠西區	2018-11-24T23:04:57+08:00	892	2621	3513	334	3847	8528	45.11%	10.46%	9	9
14	臺南市楠西區	2018-11-25T00:57:29+08:00	892	2621	3513	334	3847	8528	45.11%	10.46%	9	9
14	臺南市楠西區	2018-11-24T22:13:19+08:00	892	2621	3513	334	3847	8528	45.11%	10.46%	9	9
14	臺南市楠西區	2018-11-25T03:44:14+08:00	892	2621	3513	334	3847	8528	45.11%	10.46%	9	9
14	臺南市楠西區	2018-11-25T01:17:43+08:00	892	2621	3513	334	3847	8528	45.11%	10.46%	9	9
14	臺南市楠西區	2018-11-24T23:55:40+08:00	892	2621	3513	334	3847	8528	45.11%	10.46%	9	9
14	臺南市楠西區	2018-11-25T01:02:23+08:00	892	2621	3513	334	3847	8528	45.11%	10.46%	9	9
14	臺南市楠西區	2018-11-25T01:25:45+08:00	892	2621	3513	334	3847	8528	45.11%	10.46%	9	9
14	臺南市楠西區	2018-11-25T03:38:48+08:00	892	2621	3513	334	3847	8528	45.11%	10.46%	9	9
14	臺南市楠西區	2018-11-25T06:18:50+08:00	892	2621	3513	334	3847	8528	45.11%	10.46%	9	9
14	臺南市楠西區	2018-11-24T22:40:21+08:00	892	2621	3513	334	3847	8528	45.11%	10.46%	9	9
14	臺南市楠西區	2018-11-24T23:27:12+08:00	892	2621	3513	334	3847	8528	45.11%	10.46%	9	9
14	臺南市楠西區	2018-11-25T00:18:23+08:00	892	2621	3513	334	3847	8528	45.11%	10.46%	9	9
14	臺南市楠西區	2018-11-24T22:54:19+08:00	892	2621	3513	334	3847	8528	45.11%	10.46%	9	9
14	臺南市楠西區	2018-11-25T00:22:57+08:00	892	2621	3513	334	3847	8528	45.11%	10.46%	9	9
14	臺南市楠西區	2018-11-25T03:56:04+08:00	892	2621	3513	334	3847	8528	45.11%	10.46%	9	9
14	臺南市楠西區	2018-11-24T22:16:02+08:00	892	2621	3513	334	3847	8528	45.11%	10.46%	9	9
14	臺南市楠西區	2018-11-24T22:41:28+08:00	892	2621	3513	334	3847	8528	45.11%	10.46%	9	9
14	臺南市楠西區	2018-11-25T04:02:41+08:00	892	2621	3513	334	3847	8528	45.11%	10.46%	9	9
14	臺南市楠西區	2018-11-25T01:12:35+08:00	892	2621	3513	334	3847	8528	45.11%	10.46%	9	9
14	臺南市楠西區	2018-11-24T22:29:59+08:00	892	2621	3513	334	3847	8528	45.11%	10.46%	9	9
14	臺南市楠西區	2018-11-24T23:23:32+08:00	892	2621	3513	334	3847	8528	45.11%	10.46%	9	9
14	臺南市楠西區	2018-11-24T22:57:46+08:00	892	2621	3513	334	3847	8528	45.11%	10.46%	9	9
14	臺南市楠西區	2018-11-25T00:00:01+08:00	892	2621	3513	334	3847	8528	45.11%	10.46%	9	9
14	臺南市楠西區	2018-11-24T23:51:27+08:00	892	2621	3513	334	3847	8528	45.11%	10.46%	9	9
14	臺南市楠西區	2018-11-24T22:23:05+08:00	892	2621	3513	334	3847	8528	45.11%	10.46%	9	9
14	臺南市楠西區	2018-11-24T22:36:54+08:00	892	2621	3513	334	3847	8528	45.11%	10.46%	9	9
14	臺南市楠西區	2018-11-24T23:15:56+08:00	892	2621	3513	334	3847	8528	45.11%	10.46%	9	9
14	臺南市楠西區	2018-11-24T23:08:28+08:00	892	2621	3513	334	3847	8528	45.11%	10.46%	9	9
14	臺南市楠西區	2018-11-25T03:32:27+08:00	892	2621	3513	334	3847	8528	45.11%	10.46%	9	9
14	臺南市楠西區	2018-11-24T22:19:30+08:00	892	2621	3513	334	3847	8528	45.11%	10.46%	9	9
14	臺南市楠西區	2018-11-25T03:49:44+08:00	892	2621	3513	334	3847	8528	45.11%	10.46%	9	9
14	臺南市楠西區	2018-11-24T22:45:02+08:00	892	2621	3513	334	3847	8528	45.11%	10.46%	9	9
14	臺南市楠西區	2018-11-24T22:50:40+08:00	892	2621	3513	334	3847	8528	45.11%	10.46%	9	9
14	臺南市楠西區	2018-11-24T22:26:30+08:00	892	2621	3513	334	3847	8528	45.11%	10.46%	9	9
14	臺南市楠西區	2018-11-25T06:29:09+08:00	892	2621	3513	334	3847	8528	45.11%	10.46%	9	9
14	臺南市楠西區	2018-11-25T06:23:53+08:00	892	2621	3513	334	3847	8528	45.11%	10.46%	9	9
14	臺南市楠西區	2018-11-25T06:13:45+08:00	892	2621	3513	334	3847	8528	45.11%	10.46%	9	9
14	南投縣集集鎮	2018-11-25T01:12:39+08:00	1468	3726	5194	385	5579	9611	58.05%	15.27%	13	13
14	南投縣集集鎮	2018-11-24T22:16:06+08:00	1167	2973	4140	321	4461	7708	57.87%	15.14%	11	13
14	南投縣集集鎮	2018-11-25T04:02:45+08:00	1468	3726	5194	385	5579	9611	58.05%	15.27%	13	13
14	南投縣集集鎮	2018-11-24T22:23:09+08:00	1167	2973	4140	321	4461	7708	57.87%	15.14%	11	13
14	南投縣集集鎮	2018-11-25T03:32:31+08:00	1468	3726	5194	385	5579	9611	58.05%	15.27%	13	13
14	南投縣集集鎮	2018-11-25T00:00:04+08:00	1468	3726	5194	385	5579	9611	58.05%	15.27%	13	13
14	南投縣集集鎮	2018-11-25T03:38:52+08:00	1468	3726	5194	385	5579	9611	58.05%	15.27%	13	13
14	南投縣集集鎮	2018-11-25T00:23:00+08:00	1468	3726	5194	385	5579	9611	58.05%	15.27%	13	13
14	南投縣集集鎮	2018-11-24T22:36:57+08:00	1292	3234	4526	337	4863	8417	57.78%	15.35%	12	13
14	南投縣集集鎮	2018-11-25T00:57:33+08:00	1468	3726	5194	385	5579	9611	58.05%	15.27%	13	13
14	南投縣集集鎮	2018-11-24T23:51:31+08:00	1468	3726	5194	385	5579	9611	58.05%	15.27%	13	13
14	南投縣集集鎮	2018-11-24T23:27:15+08:00	1292	3234	4526	337	4863	8417	57.78%	15.35%	12	13
14	南投縣集集鎮	2018-11-24T22:19:34+08:00	1167	2973	4140	321	4461	7708	57.87%	15.14%	11	13
14	南投縣集集鎮	2018-11-24T22:50:44+08:00	1292	3234	4526	337	4863	8417	57.78%	15.35%	12	13
14	南投縣集集鎮	2018-11-24T23:12:12+08:00	1292	3234	4526	337	4863	8417	57.78%	15.35%	12	13
14	南投縣集集鎮	2018-11-25T06:13:49+08:00	1468	3726	5194	385	5579	9611	58.05%	15.27%	13	13
14	南投縣集集鎮	2018-11-24T22:26:34+08:00	1167	2973	4140	321	4461	7708	57.87%	15.14%	11	13
14	南投縣集集鎮	2018-11-25T00:05:01+08:00	1468	3726	5194	385	5579	9611	58.05%	15.27%	13	13
14	南投縣集集鎮	2018-11-25T06:23:57+08:00	1468	3726	5194	385	5579	9611	58.05%	15.27%	13	13
14	南投縣集集鎮	2018-11-25T03:49:48+08:00	1468	3726	5194	385	5579	9611	58.05%	15.27%	13	13
14	南投縣集集鎮	2018-11-24T23:05:01+08:00	1292	3234	4526	337	4863	8417	57.78%	15.35%	12	13
14	南投縣集集鎮	2018-11-24T23:01:28+08:00	1292	3234	4526	337	4863	8417	57.78%	15.35%	12	13
14	南投縣集集鎮	2018-11-24T23:47:25+08:00	1292	3234	4526	337	4863	8417	57.78%	15.35%	12	13
14	南投縣集集鎮	2018-11-25T06:29:13+08:00	1468	3726	5194	385	5579	9611	58.05%	15.27%	13	13
14	南投縣集集鎮	2018-11-24T23:35:07+08:00	1292	3234	4526	337	4863	8417	57.78%	15.35%	12	13
14	南投縣集集鎮	2018-11-24T22:33:34+08:00	1167	2973	4140	321	4461	7708	57.87%	15.14%	11	13
14	南投縣集集鎮	2018-11-25T01:07:23+08:00	1468	3726	5194	385	5579	9611	58.05%	15.27%	13	13
14	南投縣集集鎮	2018-11-24T23:43:14+08:00	1292	3234	4526	337	4863	8417	57.78%	15.35%	12	13
14	南投縣集集鎮	2018-11-24T23:31:07+08:00	1292	3234	4526	337	4863	8417	57.78%	15.35%	12	13
14	南投縣集集鎮	2018-11-25T06:08:49+08:00	1468	3726	5194	385	5579	9611	58.05%	15.27%	13	13
14	南投縣集集鎮	2018-11-25T00:14:06+08:00	1468	3726	5194	385	5579	9611	58.05%	15.27%	13	13
14	南投縣集集鎮	2018-11-24T23:23:35+08:00	1292	3234	4526	337	4863	8417	57.78%	15.35%	12	13
14	南投縣集集鎮	2018-11-24T22:13:23+08:00	1033	2662	3695	285	3980	6935	57.39%	14.9%	10	13
14	南投縣集集鎮	2018-11-25T01:17:48+08:00	1468	3726	5194	385	5579	9611	58.05%	15.27%	13	13
14	南投縣集集鎮	2018-11-24T23:55:43+08:00	1468	3726	5194	385	5579	9611	58.05%	15.27%	13	13
14	南投縣集集鎮	2018-11-24T23:08:32+08:00	1292	3234	4526	337	4863	8417	57.78%	15.35%	12	13
14	南投縣集集鎮	2018-11-24T23:19:47+08:00	1292	3234	4526	337	4863	8417	57.78%	15.35%	12	13
14	南投縣集集鎮	2018-11-24T22:57:49+08:00	1292	3234	4526	337	4863	8417	57.78%	15.35%	12	13
14	南投縣集集鎮	2018-11-25T03:44:19+08:00	1468	3726	5194	385	5579	9611	58.05%	15.27%	13	13
14	南投縣集集鎮	2018-11-24T22:30:02+08:00	1167	2973	4140	321	4461	7708	57.87%	15.14%	11	13
14	南投縣集集鎮	2018-11-25T01:02:27+08:00	1468	3726	5194	385	5579	9611	58.05%	15.27%	13	13
14	南投縣集集鎮	2018-11-24T22:40:25+08:00	1292	3234	4526	337	4863	8417	57.78%	15.35%	12	13
14	南投縣集集鎮	2018-11-25T01:25:49+08:00	1468	3726	5194	385	5579	9611	58.05%	15.27%	13	13
14	南投縣集集鎮	2018-11-24T23:15:59+08:00	1292	3234	4526	337	4863	8417	57.78%	15.35%	12	13
14	南投縣集集鎮	2018-11-25T06:18:54+08:00	1468	3726	5194	385	5579	9611	58.05%	15.27%	13	13
14	南投縣集集鎮	2018-11-25T03:56:08+08:00	1468	3726	5194	385	5579	9611	58.05%	15.27%	13	13
14	南投縣集集鎮	2018-11-24T22:41:32+08:00	1292	3234	4526	337	4863	8417	57.78%	15.35%	12	13
14	南投縣集集鎮	2018-11-24T22:45:05+08:00	1292	3234	4526	337	4863	8417	57.78%	15.35%	12	13
14	南投縣集集鎮	2018-11-25T00:18:26+08:00	1468	3726	5194	385	5579	9611	58.05%	15.27%	13	13
14	南投縣集集鎮	2018-11-24T23:39:11+08:00	1292	3234	4526	337	4863	8417	57.78%	15.35%	12	13
14	南投縣集集鎮	2018-11-25T00:09:30+08:00	1468	3726	5194	385	5579	9611	58.05%	15.27%	13	13
14	南投縣集集鎮	2018-11-24T22:54:22+08:00	1292	3234	4526	337	4863	8417	57.78%	15.35%	12	13
14	高雄市鹽埕區	2018-11-25T06:29:10+08:00	4601	7454	12055	501	12556	21617	58.08%	21.28%	24	24
14	高雄市鹽埕區	2018-11-24T23:35:04+08:00	4601	7454	12055	501	12556	21617	58.08%	21.28%	24	24
14	高雄市鹽埕區	2018-11-24T23:47:21+08:00	4601	7454	12055	501	12556	21617	58.08%	21.28%	24	24
14	高雄市鹽埕區	2018-11-24T23:12:09+08:00	4601	7454	12055	501	12556	21617	58.08%	21.28%	24	24
14	高雄市鹽埕區	2018-11-25T06:08:45+08:00	4601	7454	12055	501	12556	21617	58.08%	21.28%	24	24
14	高雄市鹽埕區	2018-11-24T23:43:11+08:00	4601	7454	12055	501	12556	21617	58.08%	21.28%	24	24
14	高雄市鹽埕區	2018-11-25T01:07:19+08:00	4601	7454	12055	501	12556	21617	58.08%	21.28%	24	24
14	高雄市鹽埕區	2018-11-24T22:33:31+08:00	4371	7059	11430	477	11907	20487	58.12%	21.34%	23	24
14	高雄市鹽埕區	2018-11-25T00:14:02+08:00	4601	7454	12055	501	12556	21617	58.08%	21.28%	24	24
14	高雄市鹽埕區	2018-11-25T01:12:36+08:00	4601	7454	12055	501	12556	21617	58.08%	21.28%	24	24
14	高雄市鹽埕區	2018-11-25T04:02:42+08:00	4601	7454	12055	501	12556	21617	58.08%	21.28%	24	24
14	高雄市鹽埕區	2018-11-25T00:09:26+08:00	4601	7454	12055	501	12556	21617	58.08%	21.28%	24	24
14	高雄市鹽埕區	2018-11-24T23:39:07+08:00	4601	7454	12055	501	12556	21617	58.08%	21.28%	24	24
14	高雄市鹽埕區	2018-11-24T23:31:03+08:00	4601	7454	12055	501	12556	21617	58.08%	21.28%	24	24
14	高雄市鹽埕區	2018-11-24T23:01:24+08:00	4601	7454	12055	501	12556	21617	58.08%	21.28%	24	24
14	高雄市鹽埕區	2018-11-25T03:44:15+08:00	4601	7454	12055	501	12556	21617	58.08%	21.28%	24	24
14	高雄市鹽埕區	2018-11-24T23:19:42+08:00	4601	7454	12055	501	12556	21617	58.08%	21.28%	24	24
14	高雄市鹽埕區	2018-11-24T22:13:20+08:00	4077	6639	10716	450	11166	19090	58.49%	21.36%	22	24
14	高雄市鹽埕區	2018-11-25T00:04:58+08:00	4601	7454	12055	501	12556	21617	58.08%	21.28%	24	24
14	高雄市鹽埕區	2018-11-24T23:04:57+08:00	4601	7454	12055	501	12556	21617	58.08%	21.28%	24	24
14	高雄市鹽埕區	2018-11-25T01:17:44+08:00	4601	7454	12055	501	12556	21617	58.08%	21.28%	24	24
14	高雄市鹽埕區	2018-11-24T23:55:40+08:00	4601	7454	12055	501	12556	21617	58.08%	21.28%	24	24
14	高雄市鹽埕區	2018-11-25T06:18:51+08:00	4601	7454	12055	501	12556	21617	58.08%	21.28%	24	24
14	高雄市鹽埕區	2018-11-25T01:02:24+08:00	4601	7454	12055	501	12556	21617	58.08%	21.28%	24	24
14	高雄市鹽埕區	2018-11-25T03:38:49+08:00	4601	7454	12055	501	12556	21617	58.08%	21.28%	24	24
14	高雄市鹽埕區	2018-11-24T23:27:12+08:00	4601	7454	12055	501	12556	21617	58.08%	21.28%	24	24
14	高雄市鹽埕區	2018-11-24T22:54:20+08:00	4371	7059	11430	477	11907	20487	58.12%	21.34%	23	24
14	高雄市鹽埕區	2018-11-25T00:18:23+08:00	4601	7454	12055	501	12556	21617	58.08%	21.28%	24	24
14	高雄市鹽埕區	2018-11-25T06:13:46+08:00	4601	7454	12055	501	12556	21617	58.08%	21.28%	24	24
14	高雄市鹽埕區	2018-11-25T00:22:57+08:00	4601	7454	12055	501	12556	21617	58.08%	21.28%	24	24
14	高雄市鹽埕區	2018-11-25T03:56:04+08:00	4601	7454	12055	501	12556	21617	58.08%	21.28%	24	24
14	高雄市鹽埕區	2018-11-24T22:41:29+08:00	4371	7059	11430	477	11907	20487	58.12%	21.34%	23	24
14	高雄市鹽埕區	2018-11-24T22:16:03+08:00	4077	6639	10716	450	11166	19090	58.49%	21.36%	22	24
14	高雄市鹽埕區	2018-11-24T22:29:59+08:00	4371	7059	11430	477	11907	20487	58.12%	21.34%	23	24
14	高雄市鹽埕區	2018-11-24T23:23:32+08:00	4601	7454	12055	501	12556	21617	58.08%	21.28%	24	24
14	高雄市鹽埕區	2018-11-24T23:51:28+08:00	4601	7454	12055	501	12556	21617	58.08%	21.28%	24	24
14	高雄市鹽埕區	2018-11-24T22:57:46+08:00	4601	7454	12055	501	12556	21617	58.08%	21.28%	24	24
14	高雄市鹽埕區	2018-11-25T00:00:01+08:00	4601	7454	12055	501	12556	21617	58.08%	21.28%	24	24
14	高雄市鹽埕區	2018-11-24T22:23:05+08:00	4371	7059	11430	477	11907	20487	58.12%	21.34%	23	24
14	高雄市鹽埕區	2018-11-24T22:36:54+08:00	4371	7059	11430	477	11907	20487	58.12%	21.34%	23	24
14	高雄市鹽埕區	2018-11-25T01:25:46+08:00	4601	7454	12055	501	12556	21617	58.08%	21.28%	24	24
14	高雄市鹽埕區	2018-11-24T22:19:31+08:00	4371	7059	11430	477	11907	20487	58.12%	21.34%	23	24
14	高雄市鹽埕區	2018-11-25T00:57:30+08:00	4601	7454	12055	501	12556	21617	58.08%	21.28%	24	24
14	高雄市鹽埕區	2018-11-24T23:08:28+08:00	4601	7454	12055	501	12556	21617	58.08%	21.28%	24	24
14	高雄市鹽埕區	2018-11-24T22:40:22+08:00	4371	7059	11430	477	11907	20487	58.12%	21.34%	23	24
14	高雄市鹽埕區	2018-11-24T23:15:57+08:00	4601	7454	12055	501	12556	21617	58.08%	21.28%	24	24
14	高雄市鹽埕區	2018-11-25T03:32:28+08:00	4601	7454	12055	501	12556	21617	58.08%	21.28%	24	24
14	高雄市鹽埕區	2018-11-24T22:45:02+08:00	4371	7059	11430	477	11907	20487	58.12%	21.34%	23	24
14	高雄市鹽埕區	2018-11-24T22:50:40+08:00	4371	7059	11430	477	11907	20487	58.12%	21.34%	23	24
14	高雄市鹽埕區	2018-11-25T03:49:45+08:00	4601	7454	12055	501	12556	21617	58.08%	21.28%	24	24
14	高雄市鹽埕區	2018-11-25T06:23:54+08:00	4601	7454	12055	501	12556	21617	58.08%	21.28%	24	24
14	高雄市鹽埕區	2018-11-24T22:26:31+08:00	4371	7059	11430	477	11907	20487	58.12%	21.34%	23	24
14	高雄市小港區	2018-11-25T06:29:10+08:00	24368	49715	74083	3952	78035	132733	58.79%	18.36%	89	89
14	高雄市小港區	2018-11-24T23:35:04+08:00	21830	43810	65640	3414	69054	117054	58.99%	18.65%	80	89
14	高雄市小港區	2018-11-25T00:14:03+08:00	23460	47598	71058	3769	74827	126706	59.06%	18.52%	86	89
14	高雄市小港區	2018-11-24T23:01:25+08:00	19893	39876	59769	3177	62946	106566	59.07%	18.67%	73	89
14	高雄市小港區	2018-11-24T23:12:09+08:00	20149	40456	60605	3222	63827	108079	59.06%	18.64%	74	89
14	高雄市小港區	2018-11-25T06:08:45+08:00	24368	49715	74083	3952	78035	132733	58.79%	18.36%	89	89
14	高雄市小港區	2018-11-24T23:43:11+08:00	22807	46054	68861	3575	72436	122634	59.07%	18.6%	84	89
14	高雄市小港區	2018-11-24T23:39:08+08:00	22051	44288	66339	3443	69782	118293	58.99%	18.64%	81	89
14	高雄市小港區	2018-11-25T00:09:27+08:00	23158	46835	69993	3678	73671	124849	59.01%	18.55%	85	89
14	高雄市小港區	2018-11-24T22:33:31+08:00	16010	32571	48581	2613	51194	86295	59.32%	18.55%	60	89
14	高雄市小港區	2018-11-25T01:12:36+08:00	24087	48945	73032	3904	76936	130750	58.84%	18.42%	88	89
14	高雄市小港區	2018-11-25T04:02:42+08:00	24368	49715	74083	3952	78035	132733	58.79%	18.36%	89	89
14	高雄市小港區	2018-11-25T01:07:20+08:00	23830	48263	72093	3851	75944	129106	58.82%	18.46%	87	89
14	高雄市小港區	2018-11-24T23:31:04+08:00	21830	43810	65640	3414	69054	117054	58.99%	18.65%	80	89
14	高雄市小港區	2018-11-25T03:44:15+08:00	24368	49715	74083	3952	78035	132733	58.79%	18.36%	89	89
14	高雄市小港區	2018-11-24T22:13:20+08:00	12706	26392	39098	2144	41242	68740	60%	18.48%	49	89
14	高雄市小港區	2018-11-24T23:55:41+08:00	23158	46835	69993	3678	73671	124849	59.01%	18.55%	85	89
14	高雄市小港區	2018-11-24T22:23:06+08:00	14442	29133	43575	2395	45970	76933	59.75%	18.77%	54	89
14	高雄市小港區	2018-11-24T23:19:43+08:00	21279	42716	63995	3364	67359	114137	59.02%	18.64%	78	89
14	高雄市小港區	2018-11-25T01:17:44+08:00	24087	48945	73032	3904	76936	130750	58.84%	18.42%	88	89
14	高雄市小港區	2018-11-24T23:04:58+08:00	20149	40456	60605	3222	63827	108079	59.06%	18.64%	74	89
14	高雄市小港區	2018-11-25T00:00:02+08:00	23158	46835	69993	3678	73671	124849	59.01%	18.55%	85	89
14	高雄市小港區	2018-11-25T00:04:59+08:00	23158	46835	69993	3678	73671	124849	59.01%	18.55%	85	89
14	高雄市小港區	2018-11-25T06:18:51+08:00	24368	49715	74083	3952	78035	132733	58.79%	18.36%	89	89
14	高雄市小港區	2018-11-25T01:02:24+08:00	23830	48263	72093	3851	75944	129106	58.82%	18.46%	87	89
14	高雄市小港區	2018-11-24T23:27:13+08:00	21540	43288	64828	3387	68215	115621	59%	18.63%	79	89
14	高雄市小港區	2018-11-25T03:38:49+08:00	24368	49715	74083	3952	78035	132733	58.79%	18.36%	89	89
14	高雄市小港區	2018-11-24T22:30:00+08:00	14974	30376	45350	2480	47830	80033	59.76%	18.71%	56	89
14	高雄市小港區	2018-11-24T22:54:20+08:00	18190	37136	55326	2908	58234	98891	58.89%	18.39%	68	89
14	高雄市小港區	2018-11-25T03:56:05+08:00	24368	49715	74083	3952	78035	132733	58.79%	18.36%	89	89
14	高雄市小港區	2018-11-25T00:18:23+08:00	23460	47598	71058	3769	74827	126706	59.06%	18.52%	86	89
14	高雄市小港區	2018-11-25T06:13:46+08:00	24368	49715	74083	3952	78035	132733	58.79%	18.36%	89	89
14	高雄市小港區	2018-11-25T00:22:57+08:00	23460	47598	71058	3769	74827	126706	59.06%	18.52%	86	89
14	高雄市小港區	2018-11-24T23:47:22+08:00	23158	46835	69993	3678	73671	124849	59.01%	18.55%	85	89
14	高雄市小港區	2018-11-24T22:41:29+08:00	17180	34961	52141	2756	54897	92650	59.25%	18.54%	64	89
14	高雄市小港區	2018-11-24T22:16:03+08:00	12706	26392	39098	2144	41242	68740	60%	18.48%	49	89
14	高雄市小港區	2018-11-24T23:23:32+08:00	21540	43288	64828	3387	68215	115621	59%	18.63%	79	89
14	高雄市小港區	2018-11-24T23:51:28+08:00	23158	46835	69993	3678	73671	124849	59.01%	18.55%	85	89
14	高雄市小港區	2018-11-24T22:57:47+08:00	19398	38745	58143	3062	61205	103701	59.02%	18.71%	71	89
14	高雄市小港區	2018-11-25T01:25:46+08:00	24087	48945	73032	3904	76936	130750	58.84%	18.42%	88	89
14	高雄市小港區	2018-11-24T22:19:31+08:00	13879	28025	41904	2271	44175	73850	59.82%	18.79%	52	89
14	高雄市小港區	2018-11-25T00:57:30+08:00	23830	48263	72093	3851	75944	129106	58.82%	18.46%	87	89
14	高雄市小港區	2018-11-24T22:40:22+08:00	17180	34961	52141	2756	54897	92650	59.25%	18.54%	64	89
14	高雄市小港區	2018-11-24T22:36:55+08:00	16904	34397	51301	2706	54007	91307	59.15%	18.51%	63	89
14	高雄市小港區	2018-11-24T23:08:29+08:00	20149	40456	60605	3222	63827	108079	59.06%	18.64%	74	89
14	高雄市小港區	2018-11-24T23:15:57+08:00	20647	41587	62234	3321	65555	111045	59.03%	18.59%	76	89
14	高雄市小港區	2018-11-25T03:32:28+08:00	24368	49715	74083	3952	78035	132733	58.79%	18.36%	89	89
14	高雄市小港區	2018-11-25T03:49:45+08:00	24368	49715	74083	3952	78035	132733	58.79%	18.36%	89	89
14	高雄市小港區	2018-11-25T06:23:54+08:00	24368	49715	74083	3952	78035	132733	58.79%	18.36%	89	89
14	高雄市小港區	2018-11-24T22:26:31+08:00	14974	30376	45350	2480	47830	80033	59.76%	18.71%	56	89
14	高雄市小港區	2018-11-24T22:50:41+08:00	18190	37136	55326	2908	58234	98891	58.89%	18.39%	68	89
14	高雄市小港區	2018-11-24T22:45:03+08:00	17457	35520	52977	2795	55772	94158	59.23%	18.54%	65	89
14	苗栗縣頭屋鄉	2018-11-25T04:02:44+08:00	1586	4187	5773	349	6122	9390	65.2%	16.89%	12	12
14	苗栗縣頭屋鄉	2018-11-25T00:09:29+08:00	1586	4187	5773	349	6122	9390	65.2%	16.89%	12	12
14	苗栗縣頭屋鄉	2018-11-25T01:12:38+08:00	1586	4187	5773	349	6122	9390	65.2%	16.89%	12	12
14	苗栗縣頭屋鄉	2018-11-25T00:14:05+08:00	1586	4187	5773	349	6122	9390	65.2%	16.89%	12	12
14	苗栗縣頭屋鄉	2018-11-24T23:19:45+08:00	1586	4187	5773	349	6122	9390	65.2%	16.89%	12	12
14	苗栗縣頭屋鄉	2018-11-25T00:00:03+08:00	1586	4187	5773	349	6122	9390	65.2%	16.89%	12	12
14	苗栗縣頭屋鄉	2018-11-24T22:23:08+08:00	1586	4187	5773	349	6122	9390	65.2%	16.89%	12	12
14	苗栗縣頭屋鄉	2018-11-24T23:08:31+08:00	1586	4187	5773	349	6122	9390	65.2%	16.89%	12	12
14	苗栗縣頭屋鄉	2018-11-25T03:32:30+08:00	1586	4187	5773	349	6122	9390	65.2%	16.89%	12	12
14	苗栗縣頭屋鄉	2018-11-24T23:51:30+08:00	1586	4187	5773	349	6122	9390	65.2%	16.89%	12	12
14	苗栗縣頭屋鄉	2018-11-24T22:30:01+08:00	1586	4187	5773	349	6122	9390	65.2%	16.89%	12	12
14	苗栗縣頭屋鄉	2018-11-24T23:27:14+08:00	1586	4187	5773	349	6122	9390	65.2%	16.89%	12	12
14	苗栗縣頭屋鄉	2018-11-24T22:19:33+08:00	1586	4187	5773	349	6122	9390	65.2%	16.89%	12	12
14	苗栗縣頭屋鄉	2018-11-25T00:57:32+08:00	1586	4187	5773	349	6122	9390	65.2%	16.89%	12	12
14	苗栗縣頭屋鄉	2018-11-24T22:36:56+08:00	1586	4187	5773	349	6122	9390	65.2%	16.89%	12	12
14	苗栗縣頭屋鄉	2018-11-24T22:50:43+08:00	1586	4187	5773	349	6122	9390	65.2%	16.89%	12	12
14	苗栗縣頭屋鄉	2018-11-25T00:18:25+08:00	1586	4187	5773	349	6122	9390	65.2%	16.89%	12	12
14	苗栗縣頭屋鄉	2018-11-25T06:23:56+08:00	1586	4187	5773	349	6122	9390	65.2%	16.89%	12	12
14	苗栗縣頭屋鄉	2018-11-24T22:26:33+08:00	1586	4187	5773	349	6122	9390	65.2%	16.89%	12	12
14	苗栗縣頭屋鄉	2018-11-25T03:49:47+08:00	1586	4187	5773	349	6122	9390	65.2%	16.89%	12	12
14	苗栗縣頭屋鄉	2018-11-24T22:41:31+08:00	1586	4187	5773	349	6122	9390	65.2%	16.89%	12	12
14	苗栗縣頭屋鄉	2018-11-25T00:05:01+08:00	1586	4187	5773	349	6122	9390	65.2%	16.89%	12	12
14	苗栗縣頭屋鄉	2018-11-25T06:13:48+08:00	1586	4187	5773	349	6122	9390	65.2%	16.89%	12	12
14	苗栗縣頭屋鄉	2018-11-25T00:22:59+08:00	1586	4187	5773	349	6122	9390	65.2%	16.89%	12	12
14	苗栗縣頭屋鄉	2018-11-24T23:05:01+08:00	1586	4187	5773	349	6122	9390	65.2%	16.89%	12	12
14	苗栗縣頭屋鄉	2018-11-24T23:31:06+08:00	1586	4187	5773	349	6122	9390	65.2%	16.89%	12	12
14	苗栗縣頭屋鄉	2018-11-24T22:16:05+08:00	1586	4187	5773	349	6122	9390	65.2%	16.89%	12	12
14	苗栗縣頭屋鄉	2018-11-25T06:08:48+08:00	1586	4187	5773	349	6122	9390	65.2%	16.89%	12	12
14	苗栗縣頭屋鄉	2018-11-25T01:07:22+08:00	1586	4187	5773	349	6122	9390	65.2%	16.89%	12	12
14	苗栗縣頭屋鄉	2018-11-24T22:33:33+08:00	1586	4187	5773	349	6122	9390	65.2%	16.89%	12	12
14	苗栗縣頭屋鄉	2018-11-24T23:43:13+08:00	1586	4187	5773	349	6122	9390	65.2%	16.89%	12	12
14	苗栗縣頭屋鄉	2018-11-24T23:01:27+08:00	1586	4187	5773	349	6122	9390	65.2%	16.89%	12	12
14	苗栗縣頭屋鄉	2018-11-24T23:35:06+08:00	1586	4187	5773	349	6122	9390	65.2%	16.89%	12	12
14	苗栗縣頭屋鄉	2018-11-25T06:29:12+08:00	1586	4187	5773	349	6122	9390	65.2%	16.89%	12	12
14	苗栗縣頭屋鄉	2018-11-24T23:47:24+08:00	1586	4187	5773	349	6122	9390	65.2%	16.89%	12	12
14	苗栗縣頭屋鄉	2018-11-24T23:55:42+08:00	1586	4187	5773	349	6122	9390	65.2%	16.89%	12	12
14	苗栗縣頭屋鄉	2018-11-24T22:57:48+08:00	1586	4187	5773	349	6122	9390	65.2%	16.89%	12	12
14	苗栗縣頭屋鄉	2018-11-24T23:23:34+08:00	1586	4187	5773	349	6122	9390	65.2%	16.89%	12	12
14	苗栗縣頭屋鄉	2018-11-25T03:38:51+08:00	1586	4187	5773	349	6122	9390	65.2%	16.89%	12	12
14	苗栗縣頭屋鄉	2018-11-24T22:13:22+08:00	1586	4187	5773	349	6122	9390	65.2%	16.89%	12	12
14	苗栗縣頭屋鄉	2018-11-25T01:17:47+08:00	1586	4187	5773	349	6122	9390	65.2%	16.89%	12	12
14	苗栗縣頭屋鄉	2018-11-25T03:44:17+08:00	1586	4187	5773	349	6122	9390	65.2%	16.89%	12	12
14	苗栗縣頭屋鄉	2018-11-25T01:25:48+08:00	1586	4187	5773	349	6122	9390	65.2%	16.89%	12	12
14	苗栗縣頭屋鄉	2018-11-24T22:40:24+08:00	1586	4187	5773	349	6122	9390	65.2%	16.89%	12	12
14	苗栗縣頭屋鄉	2018-11-25T01:02:26+08:00	1586	4187	5773	349	6122	9390	65.2%	16.89%	12	12
14	苗栗縣頭屋鄉	2018-11-24T23:15:59+08:00	1586	4187	5773	349	6122	9390	65.2%	16.89%	12	12
14	苗栗縣頭屋鄉	2018-11-25T06:18:53+08:00	1586	4187	5773	349	6122	9390	65.2%	16.89%	12	12
14	苗栗縣頭屋鄉	2018-11-24T23:12:11+08:00	1586	4187	5773	349	6122	9390	65.2%	16.89%	12	12
14	苗栗縣頭屋鄉	2018-11-24T23:39:10+08:00	1586	4187	5773	349	6122	9390	65.2%	16.89%	12	12
14	苗栗縣頭屋鄉	2018-11-25T03:56:07+08:00	1586	4187	5773	349	6122	9390	65.2%	16.89%	12	12
14	苗栗縣頭屋鄉	2018-11-24T22:45:04+08:00	1586	4187	5773	349	6122	9390	65.2%	16.89%	12	12
14	苗栗縣頭屋鄉	2018-11-24T22:54:22+08:00	1586	4187	5773	349	6122	9390	65.2%	16.89%	12	12
14	苗栗縣苑裡鎮	2018-11-25T04:02:44+08:00	5758	15032	20790	1610	22400	38890	57.6%	14.81%	40	40
14	苗栗縣苑裡鎮	2018-11-24T23:31:05+08:00	5758	15032	20790	1610	22400	38890	57.6%	14.81%	40	40
14	苗栗縣苑裡鎮	2018-11-25T00:09:29+08:00	5758	15032	20790	1610	22400	38890	57.6%	14.81%	40	40
14	苗栗縣苑裡鎮	2018-11-25T01:07:21+08:00	5758	15032	20790	1610	22400	38890	57.6%	14.81%	40	40
14	苗栗縣苑裡鎮	2018-11-25T01:12:38+08:00	5758	15032	20790	1610	22400	38890	57.6%	14.81%	40	40
14	苗栗縣苑裡鎮	2018-11-25T00:14:05+08:00	5758	15032	20790	1610	22400	38890	57.6%	14.81%	40	40
14	苗栗縣苑裡鎮	2018-11-24T23:19:45+08:00	5758	15032	20790	1610	22400	38890	57.6%	14.81%	40	40
14	苗栗縣苑裡鎮	2018-11-24T22:23:07+08:00	3527	9248	12775	1014	13789	23751	58.06%	14.85%	27	40
14	苗栗縣苑裡鎮	2018-11-25T00:00:03+08:00	5758	15032	20790	1610	22400	38890	57.6%	14.81%	40	40
14	苗栗縣苑裡鎮	2018-11-24T23:08:30+08:00	5462	14199	19661	1515	21176	36747	57.63%	14.86%	38	40
14	苗栗縣苑裡鎮	2018-11-25T03:32:30+08:00	5758	15032	20790	1610	22400	38890	57.6%	14.81%	40	40
14	苗栗縣苑裡鎮	2018-11-24T23:51:30+08:00	5758	15032	20790	1610	22400	38890	57.6%	14.81%	40	40
14	苗栗縣苑裡鎮	2018-11-24T22:30:01+08:00	4006	10490	14496	1119	15615	27110	57.6%	14.78%	30	40
14	苗栗縣苑裡鎮	2018-11-24T23:27:14+08:00	5758	15032	20790	1610	22400	38890	57.6%	14.81%	40	40
14	苗栗縣苑裡鎮	2018-11-24T22:19:32+08:00	3527	9248	12775	1014	13789	23751	58.06%	14.85%	27	40
14	苗栗縣苑裡鎮	2018-11-25T00:57:32+08:00	5758	15032	20790	1610	22400	38890	57.6%	14.81%	40	40
14	苗栗縣苑裡鎮	2018-11-24T22:36:56+08:00	4389	11415	15804	1205	17009	29453	57.75%	14.9%	32	40
14	苗栗縣苑裡鎮	2018-11-25T00:18:25+08:00	5758	15032	20790	1610	22400	38890	57.6%	14.81%	40	40
14	苗栗縣苑裡鎮	2018-11-24T23:05:00+08:00	5297	13760	19057	1460	20517	35516	57.77%	14.91%	37	40
14	苗栗縣苑裡鎮	2018-11-25T03:49:47+08:00	5758	15032	20790	1610	22400	38890	57.6%	14.81%	40	40
14	苗栗縣苑裡鎮	2018-11-24T22:26:32+08:00	3740	9781	13521	1060	14581	25097	58.1%	14.9%	28	40
14	苗栗縣苑裡鎮	2018-11-25T06:13:48+08:00	5758	15032	20790	1610	22400	38890	57.6%	14.81%	40	40
14	苗栗縣苑裡鎮	2018-11-24T22:50:42+08:00	4847	12632	17479	1348	18827	32589	57.77%	14.87%	35	40
14	苗栗縣苑裡鎮	2018-11-24T22:54:21+08:00	4847	12632	17479	1348	18827	32589	57.77%	14.87%	35	40
14	苗栗縣苑裡鎮	2018-11-25T00:05:00+08:00	5758	15032	20790	1610	22400	38890	57.6%	14.81%	40	40
14	苗栗縣苑裡鎮	2018-11-24T22:41:30+08:00	4496	11695	16191	1249	17440	30241	57.67%	14.87%	33	40
14	苗栗縣苑裡鎮	2018-11-25T00:22:59+08:00	5758	15032	20790	1610	22400	38890	57.6%	14.81%	40	40
14	苗栗縣苑裡鎮	2018-11-24T22:16:05+08:00	3384	8869	12253	953	13206	22699	58.18%	14.91%	26	40
14	苗栗縣苑裡鎮	2018-11-24T23:01:26+08:00	5103	13236	18339	1391	19730	34168	57.74%	14.94%	36	40
14	苗栗縣苑裡鎮	2018-11-24T23:43:12+08:00	5758	15032	20790	1610	22400	38890	57.6%	14.81%	40	40
14	苗栗縣苑裡鎮	2018-11-24T22:33:33+08:00	4223	10941	15164	1167	16331	28259	57.79%	14.94%	31	40
14	苗栗縣苑裡鎮	2018-11-25T06:08:47+08:00	5758	15032	20790	1610	22400	38890	57.6%	14.81%	40	40
14	苗栗縣苑裡鎮	2018-11-24T23:35:06+08:00	5758	15032	20790	1610	22400	38890	57.6%	14.81%	40	40
14	苗栗縣苑裡鎮	2018-11-24T23:47:23+08:00	5758	15032	20790	1610	22400	38890	57.6%	14.81%	40	40
14	苗栗縣苑裡鎮	2018-11-25T06:29:12+08:00	5758	15032	20790	1610	22400	38890	57.6%	14.81%	40	40
14	苗栗縣苑裡鎮	2018-11-24T23:55:42+08:00	5758	15032	20790	1610	22400	38890	57.6%	14.81%	40	40
14	苗栗縣苑裡鎮	2018-11-25T01:17:46+08:00	5758	15032	20790	1610	22400	38890	57.6%	14.81%	40	40
14	苗栗縣苑裡鎮	2018-11-24T22:57:48+08:00	5103	13236	18339	1391	19730	34168	57.74%	14.94%	36	40
14	苗栗縣苑裡鎮	2018-11-25T03:38:50+08:00	5758	15032	20790	1610	22400	38890	57.6%	14.81%	40	40
14	苗栗縣苑裡鎮	2018-11-24T23:23:34+08:00	5758	15032	20790	1610	22400	38890	57.6%	14.81%	40	40
14	苗栗縣苑裡鎮	2018-11-24T22:13:22+08:00	3235	8399	11634	925	12559	21617	58.1%	14.97%	25	40
14	苗栗縣苑裡鎮	2018-11-25T03:44:17+08:00	5758	15032	20790	1610	22400	38890	57.6%	14.81%	40	40
14	苗栗縣苑裡鎮	2018-11-25T01:25:48+08:00	5758	15032	20790	1610	22400	38890	57.6%	14.81%	40	40
14	苗栗縣苑裡鎮	2018-11-24T22:40:23+08:00	4496	11695	16191	1249	17440	30241	57.67%	14.87%	33	40
14	苗栗縣苑裡鎮	2018-11-24T23:15:58+08:00	5758	15032	20790	1610	22400	38890	57.6%	14.81%	40	40
14	苗栗縣苑裡鎮	2018-11-25T01:02:26+08:00	5758	15032	20790	1610	22400	38890	57.6%	14.81%	40	40
14	苗栗縣苑裡鎮	2018-11-25T06:18:53+08:00	5758	15032	20790	1610	22400	38890	57.6%	14.81%	40	40
14	苗栗縣苑裡鎮	2018-11-25T06:23:55+08:00	5758	15032	20790	1610	22400	38890	57.6%	14.81%	40	40
14	苗栗縣苑裡鎮	2018-11-24T23:39:10+08:00	5758	15032	20790	1610	22400	38890	57.6%	14.81%	40	40
14	苗栗縣苑裡鎮	2018-11-25T03:56:07+08:00	5758	15032	20790	1610	22400	38890	57.6%	14.81%	40	40
14	苗栗縣苑裡鎮	2018-11-24T22:45:04+08:00	4660	12122	16782	1297	18079	31355	57.66%	14.86%	34	40
14	苗栗縣苑裡鎮	2018-11-24T23:12:10+08:00	5586	14557	20143	1556	21699	37620	57.68%	14.85%	39	40
14	澎湖縣馬公市	2018-11-24T22:33:39+08:00	3655	9323	12978	901	13879	28559	48.6%	12.8%	31	50
14	澎湖縣馬公市	2018-11-25T03:49:52+08:00	7199	17432	24631	1522	26153	53655	48.74%	13.42%	50	50
14	澎湖縣馬公市	2018-11-24T23:43:18+08:00	5394	14057	19451	1269	20720	42622	48.61%	12.66%	42	50
14	澎湖縣馬公市	2018-11-24T23:47:29+08:00	5394	14057	19451	1269	20720	42622	48.61%	12.66%	42	50
14	澎湖縣馬公市	2018-11-25T06:29:18+08:00	7199	17432	24631	1522	26153	53655	48.74%	13.42%	50	50
14	澎湖縣馬公市	2018-11-25T01:07:27+08:00	7199	17432	24631	1522	26153	53655	48.74%	13.42%	50	50
14	澎湖縣馬公市	2018-11-25T06:13:53+08:00	7199	17432	24631	1522	26153	53655	48.74%	13.42%	50	50
14	澎湖縣馬公市	2018-11-25T00:18:31+08:00	7037	16962	23999	1478	25477	52307	48.71%	13.45%	49	50
14	澎湖縣馬公市	2018-11-24T22:37:01+08:00	3804	9733	13537	943	14480	29753	48.67%	12.79%	32	50
14	澎湖縣馬公市	2018-11-25T03:44:24+08:00	7199	17432	24631	1522	26153	53655	48.74%	13.42%	50	50
14	澎湖縣馬公市	2018-11-24T23:08:37+08:00	4189	10753	14942	1022	15964	32700	48.82%	12.81%	34	50
14	澎湖縣馬公市	2018-11-24T23:55:48+08:00	5394	14057	19451	1269	20720	42622	48.61%	12.66%	42	50
14	澎湖縣馬公市	2018-11-24T22:13:28+08:00	2560	6379	8939	654	9593	19949	48.09%	12.83%	24	50
14	澎湖縣馬公市	2018-11-24T23:23:39+08:00	4745	12366	17111	1160	18271	37343	48.93%	12.71%	38	50
14	澎湖縣馬公市	2018-11-25T06:18:58+08:00	7199	17432	24631	1522	26153	53655	48.74%	13.42%	50	50
14	澎湖縣馬公市	2018-11-24T23:51:36+08:00	5394	14057	19451	1269	20720	42622	48.61%	12.66%	42	50
14	澎湖縣馬公市	2018-11-24T22:23:14+08:00	3100	7794	10894	762	11656	23834	48.9%	13.01%	27	50
14	澎湖縣馬公市	2018-11-24T22:40:28+08:00	4016	10296	14312	979	15291	31307	48.84%	12.83%	33	50
14	澎湖縣馬公市	2018-11-25T00:09:35+08:00	6088	15788	21876	1369	23245	47497	48.94%	12.82%	46	50
14	澎湖縣馬公市	2018-11-25T00:05:06+08:00	6088	15788	21876	1369	23245	47497	48.94%	12.82%	46	50
14	澎湖縣馬公市	2018-11-24T23:35:11+08:00	5394	14057	19451	1269	20720	42622	48.61%	12.66%	42	50
14	澎湖縣馬公市	2018-11-24T22:41:36+08:00	4016	10296	14312	979	15291	31307	48.84%	12.83%	33	50
14	澎湖縣馬公市	2018-11-24T22:45:09+08:00	4016	10296	14312	979	15291	31307	48.84%	12.83%	33	50
14	澎湖縣馬公市	2018-11-24T22:54:26+08:00	4016	10296	14312	979	15291	31307	48.84%	12.83%	33	50
14	澎湖縣馬公市	2018-11-25T00:14:10+08:00	6892	16521	23413	1432	24845	51023	48.69%	13.51%	48	50
14	澎湖縣馬公市	2018-11-25T03:56:13+08:00	7199	17432	24631	1522	26153	53655	48.74%	13.42%	50	50
14	澎湖縣馬公市	2018-11-24T23:16:04+08:00	4468	11610	16078	1081	17159	35135	48.84%	12.72%	36	50
14	澎湖縣馬公市	2018-11-25T03:32:35+08:00	7199	17432	24631	1522	26153	53655	48.74%	13.42%	50	50
14	澎湖縣馬公市	2018-11-25T01:25:53+08:00	7199	17432	24631	1522	26153	53655	48.74%	13.42%	50	50
14	澎湖縣馬公市	2018-11-25T01:02:32+08:00	7199	17432	24631	1522	26153	53655	48.74%	13.42%	50	50
14	澎湖縣馬公市	2018-11-24T22:30:10+08:00	3441	8603	12044	865	12909	26436	48.83%	13.02%	29	50
14	澎湖縣馬公市	2018-11-25T00:23:04+08:00	7037	16962	23999	1478	25477	52307	48.71%	13.45%	49	50
14	澎湖縣馬公市	2018-11-25T06:24:01+08:00	7199	17432	24631	1522	26153	53655	48.74%	13.42%	50	50
14	澎湖縣馬公市	2018-11-25T03:38:56+08:00	7199	17432	24631	1522	26153	53655	48.74%	13.42%	50	50
14	澎湖縣馬公市	2018-11-24T23:27:19+08:00	4890	12704	17594	1181	18775	38344	48.96%	12.75%	39	50
14	澎湖縣馬公市	2018-11-24T22:19:38+08:00	2982	7484	10466	738	11204	22942	48.84%	13%	26	50
14	澎湖縣馬公市	2018-11-25T01:17:53+08:00	7199	17432	24631	1522	26153	53655	48.74%	13.42%	50	50
14	澎湖縣馬公市	2018-11-25T00:00:12+08:00	5601	14577	20178	1296	21474	44062	48.74%	12.71%	43	50
14	澎湖縣馬公市	2018-11-24T22:57:55+08:00	4016	10296	14312	979	15291	31307	48.84%	12.83%	33	50
14	澎湖縣馬公市	2018-11-24T23:19:52+08:00	4745	12366	17111	1160	18271	37343	48.93%	12.71%	38	50
14	澎湖縣馬公市	2018-11-25T00:57:38+08:00	7199	17432	24631	1522	26153	53655	48.74%	13.42%	50	50
14	澎湖縣馬公市	2018-11-24T23:35:12+08:00	5394	14057	19451	1269	20720	42622	48.61%	12.66%	42	50
14	澎湖縣馬公市	2018-11-25T06:08:54+08:00	7199	17432	24631	1522	26153	53655	48.74%	13.42%	50	50
14	澎湖縣馬公市	2018-11-24T23:12:16+08:00	4189	10753	14942	1022	15964	32700	48.82%	12.81%	34	50
14	澎湖縣馬公市	2018-11-24T23:39:17+08:00	5394	14057	19451	1269	20720	42622	48.61%	12.66%	42	50
14	澎湖縣馬公市	2018-11-25T01:12:44+08:00	7199	17432	24631	1522	26153	53655	48.74%	13.42%	50	50
14	澎湖縣馬公市	2018-11-24T22:50:49+08:00	4016	10296	14312	979	15291	31307	48.84%	12.83%	33	50
14	澎湖縣馬公市	2018-11-24T22:26:37+08:00	3271	8221	11492	821	12313	25221	48.82%	12.97%	28	50
14	澎湖縣馬公市	2018-11-25T04:02:53+08:00	7199	17432	24631	1522	26153	53655	48.74%	13.42%	50	50
14	澎湖縣馬公市	2018-11-24T23:05:05+08:00	4189	10753	14942	1022	15964	32700	48.82%	12.81%	34	50
14	澎湖縣馬公市	2018-11-24T23:31:12+08:00	5394	14057	19451	1269	20720	42622	48.61%	12.66%	42	50
14	澎湖縣馬公市	2018-11-24T22:16:11+08:00	2786	6984	9770	685	10455	21430	48.79%	13%	25	50
14	澎湖縣馬公市	2018-11-24T23:01:32+08:00	4016	10296	14312	979	15291	31307	48.84%	12.83%	33	50
14	臺東縣達仁鄉	2018-11-24T22:33:39+08:00	257	994	1251	102	1353	2270	59.6%	11.32%	6	7
14	臺東縣達仁鄉	2018-11-25T03:49:52+08:00	373	1312	1685	144	1829	3137	58.3%	11.89%	7	7
14	臺東縣達仁鄉	2018-11-24T23:43:18+08:00	373	1312	1685	144	1829	3137	58.3%	11.89%	7	7
14	臺東縣達仁鄉	2018-11-24T23:47:29+08:00	373	1312	1685	144	1829	3137	58.3%	11.89%	7	7
14	臺東縣達仁鄉	2018-11-25T06:29:18+08:00	373	1312	1685	144	1829	3137	58.3%	11.89%	7	7
14	臺東縣達仁鄉	2018-11-25T01:07:27+08:00	373	1312	1685	144	1829	3137	58.3%	11.89%	7	7
14	臺東縣達仁鄉	2018-11-25T06:13:53+08:00	373	1312	1685	144	1829	3137	58.3%	11.89%	7	7
14	臺東縣達仁鄉	2018-11-25T00:18:31+08:00	373	1312	1685	144	1829	3137	58.3%	11.89%	7	7
14	臺東縣達仁鄉	2018-11-24T22:37:01+08:00	257	994	1251	102	1353	2270	59.6%	11.32%	6	7
14	臺東縣達仁鄉	2018-11-25T03:44:24+08:00	373	1312	1685	144	1829	3137	58.3%	11.89%	7	7
14	臺東縣達仁鄉	2018-11-24T23:08:37+08:00	257	994	1251	102	1353	2270	59.6%	11.32%	6	7
14	臺東縣達仁鄉	2018-11-24T23:55:48+08:00	373	1312	1685	144	1829	3137	58.3%	11.89%	7	7
14	臺東縣達仁鄉	2018-11-24T22:13:28+08:00	257	994	1251	102	1353	2270	59.6%	11.32%	6	7
14	臺東縣達仁鄉	2018-11-24T23:23:39+08:00	373	1312	1685	144	1829	3137	58.3%	11.89%	7	7
14	臺東縣達仁鄉	2018-11-25T06:18:58+08:00	373	1312	1685	144	1829	3137	58.3%	11.89%	7	7
14	臺東縣達仁鄉	2018-11-25T00:00:11+08:00	373	1312	1685	144	1829	3137	58.3%	11.89%	7	7
14	臺東縣達仁鄉	2018-11-24T23:51:36+08:00	373	1312	1685	144	1829	3137	58.3%	11.89%	7	7
14	臺東縣達仁鄉	2018-11-24T22:23:14+08:00	257	994	1251	102	1353	2270	59.6%	11.32%	6	7
14	臺東縣達仁鄉	2018-11-24T22:40:28+08:00	257	994	1251	102	1353	2270	59.6%	11.32%	6	7
14	臺東縣達仁鄉	2018-11-25T00:09:35+08:00	373	1312	1685	144	1829	3137	58.3%	11.89%	7	7
14	臺東縣達仁鄉	2018-11-25T00:05:06+08:00	373	1312	1685	144	1829	3137	58.3%	11.89%	7	7
14	臺東縣達仁鄉	2018-11-24T23:35:11+08:00	373	1312	1685	144	1829	3137	58.3%	11.89%	7	7
14	臺東縣達仁鄉	2018-11-24T22:41:36+08:00	257	994	1251	102	1353	2270	59.6%	11.32%	6	7
14	臺東縣達仁鄉	2018-11-24T23:01:31+08:00	257	994	1251	102	1353	2270	59.6%	11.32%	6	7
14	臺東縣達仁鄉	2018-11-24T22:45:09+08:00	257	994	1251	102	1353	2270	59.6%	11.32%	6	7
14	臺東縣達仁鄉	2018-11-24T22:54:26+08:00	257	994	1251	102	1353	2270	59.6%	11.32%	6	7
14	臺東縣達仁鄉	2018-11-25T00:14:10+08:00	373	1312	1685	144	1829	3137	58.3%	11.89%	7	7
14	臺東縣達仁鄉	2018-11-25T03:56:13+08:00	373	1312	1685	144	1829	3137	58.3%	11.89%	7	7
14	臺東縣達仁鄉	2018-11-24T23:16:03+08:00	373	1312	1685	144	1829	3137	58.3%	11.89%	7	7
14	臺東縣達仁鄉	2018-11-25T03:32:35+08:00	373	1312	1685	144	1829	3137	58.3%	11.89%	7	7
14	臺東縣達仁鄉	2018-11-25T01:25:53+08:00	373	1312	1685	144	1829	3137	58.3%	11.89%	7	7
14	臺東縣達仁鄉	2018-11-25T01:02:32+08:00	373	1312	1685	144	1829	3137	58.3%	11.89%	7	7
14	臺東縣達仁鄉	2018-11-24T22:30:10+08:00	257	994	1251	102	1353	2270	59.6%	11.32%	6	7
14	臺東縣達仁鄉	2018-11-25T00:23:04+08:00	373	1312	1685	144	1829	3137	58.3%	11.89%	7	7
14	臺東縣達仁鄉	2018-11-25T06:24:01+08:00	373	1312	1685	144	1829	3137	58.3%	11.89%	7	7
14	臺東縣達仁鄉	2018-11-25T03:38:56+08:00	373	1312	1685	144	1829	3137	58.3%	11.89%	7	7
14	臺東縣達仁鄉	2018-11-24T23:27:19+08:00	373	1312	1685	144	1829	3137	58.3%	11.89%	7	7
14	臺東縣達仁鄉	2018-11-24T22:19:38+08:00	257	994	1251	102	1353	2270	59.6%	11.32%	6	7
14	臺東縣達仁鄉	2018-11-25T00:57:37+08:00	373	1312	1685	144	1829	3137	58.3%	11.89%	7	7
14	臺東縣達仁鄉	2018-11-24T22:57:54+08:00	257	994	1251	102	1353	2270	59.6%	11.32%	6	7
14	臺東縣達仁鄉	2018-11-25T01:17:53+08:00	373	1312	1685	144	1829	3137	58.3%	11.89%	7	7
14	臺東縣達仁鄉	2018-11-24T23:19:52+08:00	373	1312	1685	144	1829	3137	58.3%	11.89%	7	7
14	臺東縣達仁鄉	2018-11-25T06:08:54+08:00	373	1312	1685	144	1829	3137	58.3%	11.89%	7	7
14	臺東縣達仁鄉	2018-11-24T23:12:16+08:00	257	994	1251	102	1353	2270	59.6%	11.32%	6	7
14	臺東縣達仁鄉	2018-11-24T23:39:17+08:00	373	1312	1685	144	1829	3137	58.3%	11.89%	7	7
14	臺東縣達仁鄉	2018-11-25T01:12:44+08:00	373	1312	1685	144	1829	3137	58.3%	11.89%	7	7
14	臺東縣達仁鄉	2018-11-24T22:50:49+08:00	257	994	1251	102	1353	2270	59.6%	11.32%	6	7
14	臺東縣達仁鄉	2018-11-24T22:26:37+08:00	257	994	1251	102	1353	2270	59.6%	11.32%	6	7
14	臺東縣達仁鄉	2018-11-25T04:02:53+08:00	373	1312	1685	144	1829	3137	58.3%	11.89%	7	7
14	臺東縣達仁鄉	2018-11-24T23:05:05+08:00	257	994	1251	102	1353	2270	59.6%	11.32%	6	7
14	臺東縣達仁鄉	2018-11-24T23:31:12+08:00	373	1312	1685	144	1829	3137	58.3%	11.89%	7	7
14	臺東縣達仁鄉	2018-11-24T22:16:11+08:00	257	994	1251	102	1353	2270	59.6%	11.32%	6	7
14	臺東縣鹿野鄉	2018-11-25T06:29:17+08:00	864	2044	2908	220	3128	6936	45.1%	12.46%	10	10
14	臺東縣鹿野鄉	2018-11-24T23:47:29+08:00	864	2044	2908	220	3128	6936	45.1%	12.46%	10	10
14	臺東縣鹿野鄉	2018-11-24T22:33:38+08:00	713	1707	2420	190	2610	5832	44.75%	12.23%	9	10
14	臺東縣鹿野鄉	2018-11-25T01:07:27+08:00	864	2044	2908	220	3128	6936	45.1%	12.46%	10	10
14	臺東縣鹿野鄉	2018-11-25T06:13:53+08:00	864	2044	2908	220	3128	6936	45.1%	12.46%	10	10
14	臺東縣鹿野鄉	2018-11-24T23:43:17+08:00	864	2044	2908	220	3128	6936	45.1%	12.46%	10	10
14	臺東縣鹿野鄉	2018-11-25T00:18:31+08:00	864	2044	2908	220	3128	6936	45.1%	12.46%	10	10
14	臺東縣鹿野鄉	2018-11-24T22:37:01+08:00	864	2044	2908	220	3128	6936	45.1%	12.46%	10	10
14	臺東縣鹿野鄉	2018-11-24T22:13:27+08:00	713	1707	2420	190	2610	5832	44.75%	12.23%	9	10
14	臺東縣鹿野鄉	2018-11-25T03:44:24+08:00	864	2044	2908	220	3128	6936	45.1%	12.46%	10	10
14	臺東縣鹿野鄉	2018-11-25T01:02:31+08:00	864	2044	2908	220	3128	6936	45.1%	12.46%	10	10
14	臺東縣鹿野鄉	2018-11-25T03:38:55+08:00	864	2044	2908	220	3128	6936	45.1%	12.46%	10	10
14	臺東縣鹿野鄉	2018-11-24T23:55:47+08:00	864	2044	2908	220	3128	6936	45.1%	12.46%	10	10
14	臺東縣鹿野鄉	2018-11-24T23:08:36+08:00	864	2044	2908	220	3128	6936	45.1%	12.46%	10	10
14	臺東縣鹿野鄉	2018-11-24T23:23:39+08:00	864	2044	2908	220	3128	6936	45.1%	12.46%	10	10
14	臺東縣鹿野鄉	2018-11-25T06:18:58+08:00	864	2044	2908	220	3128	6936	45.1%	12.46%	10	10
14	臺東縣鹿野鄉	2018-11-25T00:00:11+08:00	864	2044	2908	220	3128	6936	45.1%	12.46%	10	10
14	臺東縣鹿野鄉	2018-11-24T23:51:36+08:00	864	2044	2908	220	3128	6936	45.1%	12.46%	10	10
14	臺東縣鹿野鄉	2018-11-24T22:30:09+08:00	713	1707	2420	190	2610	5832	44.75%	12.23%	9	10
14	臺東縣鹿野鄉	2018-11-24T22:23:14+08:00	713	1707	2420	190	2610	5832	44.75%	12.23%	9	10
14	臺東縣鹿野鄉	2018-11-24T22:40:28+08:00	864	2044	2908	220	3128	6936	45.1%	12.46%	10	10
14	臺東縣鹿野鄉	2018-11-25T00:09:35+08:00	864	2044	2908	220	3128	6936	45.1%	12.46%	10	10
14	臺東縣鹿野鄉	2018-11-24T23:35:11+08:00	864	2044	2908	220	3128	6936	45.1%	12.46%	10	10
14	臺東縣鹿野鄉	2018-11-24T23:01:31+08:00	864	2044	2908	220	3128	6936	45.1%	12.46%	10	10
14	臺東縣鹿野鄉	2018-11-24T22:45:09+08:00	864	2044	2908	220	3128	6936	45.1%	12.46%	10	10
14	臺東縣鹿野鄉	2018-11-24T22:54:26+08:00	864	2044	2908	220	3128	6936	45.1%	12.46%	10	10
14	臺東縣鹿野鄉	2018-11-25T00:14:10+08:00	864	2044	2908	220	3128	6936	45.1%	12.46%	10	10
14	臺東縣鹿野鄉	2018-11-25T03:56:13+08:00	864	2044	2908	220	3128	6936	45.1%	12.46%	10	10
14	臺東縣鹿野鄉	2018-11-25T03:49:51+08:00	864	2044	2908	220	3128	6936	45.1%	12.46%	10	10
14	臺東縣鹿野鄉	2018-11-24T23:16:03+08:00	864	2044	2908	220	3128	6936	45.1%	12.46%	10	10
14	臺東縣鹿野鄉	2018-11-25T03:32:35+08:00	864	2044	2908	220	3128	6936	45.1%	12.46%	10	10
14	臺東縣鹿野鄉	2018-11-25T01:25:53+08:00	864	2044	2908	220	3128	6936	45.1%	12.46%	10	10
14	臺東縣鹿野鄉	2018-11-25T00:23:04+08:00	864	2044	2908	220	3128	6936	45.1%	12.46%	10	10
14	臺東縣鹿野鄉	2018-11-25T06:24:01+08:00	864	2044	2908	220	3128	6936	45.1%	12.46%	10	10
14	臺東縣鹿野鄉	2018-11-24T23:27:19+08:00	864	2044	2908	220	3128	6936	45.1%	12.46%	10	10
14	臺東縣鹿野鄉	2018-11-25T00:57:37+08:00	864	2044	2908	220	3128	6936	45.1%	12.46%	10	10
14	臺東縣鹿野鄉	2018-11-24T22:57:54+08:00	864	2044	2908	220	3128	6936	45.1%	12.46%	10	10
14	臺東縣鹿野鄉	2018-11-25T01:17:53+08:00	864	2044	2908	220	3128	6936	45.1%	12.46%	10	10
14	臺東縣鹿野鄉	2018-11-24T22:19:37+08:00	713	1707	2420	190	2610	5832	44.75%	12.23%	9	10
14	臺東縣鹿野鄉	2018-11-24T23:19:52+08:00	864	2044	2908	220	3128	6936	45.1%	12.46%	10	10
14	臺東縣鹿野鄉	2018-11-24T22:41:35+08:00	864	2044	2908	220	3128	6936	45.1%	12.46%	10	10
14	臺東縣鹿野鄉	2018-11-25T00:05:05+08:00	864	2044	2908	220	3128	6936	45.1%	12.46%	10	10
14	臺東縣鹿野鄉	2018-11-24T23:12:16+08:00	864	2044	2908	220	3128	6936	45.1%	12.46%	10	10
14	臺東縣鹿野鄉	2018-11-25T06:08:53+08:00	864	2044	2908	220	3128	6936	45.1%	12.46%	10	10
14	臺東縣鹿野鄉	2018-11-25T01:12:44+08:00	864	2044	2908	220	3128	6936	45.1%	12.46%	10	10
14	臺東縣鹿野鄉	2018-11-24T22:26:37+08:00	713	1707	2420	190	2610	5832	44.75%	12.23%	9	10
14	臺東縣鹿野鄉	2018-11-25T04:02:53+08:00	864	2044	2908	220	3128	6936	45.1%	12.46%	10	10
14	臺東縣鹿野鄉	2018-11-24T23:05:05+08:00	864	2044	2908	220	3128	6936	45.1%	12.46%	10	10
14	臺東縣鹿野鄉	2018-11-24T22:50:48+08:00	864	2044	2908	220	3128	6936	45.1%	12.46%	10	10
14	臺東縣鹿野鄉	2018-11-24T23:31:12+08:00	864	2044	2908	220	3128	6936	45.1%	12.46%	10	10
14	臺東縣鹿野鄉	2018-11-24T22:16:11+08:00	713	1707	2420	190	2610	5832	44.75%	12.23%	9	10
14	臺東縣鹿野鄉	2018-11-24T23:39:16+08:00	864	2044	2908	220	3128	6936	45.1%	12.46%	10	10
14	臺中市龍井區	2018-11-24T23:35:03+08:00	10845	23194	34039	1946	35985	63584	56.59%	17.06%	45	45
14	臺中市龍井區	2018-11-24T22:33:30+08:00	8243	17935	26178	1526	27704	49105	56.42%	16.79%	36	45
14	臺中市龍井區	2018-11-24T22:16:01+08:00	7452	16093	23545	1396	24941	44160	56.48%	16.88%	33	45
14	臺中市龍井區	2018-11-24T23:31:02+08:00	10845	23194	34039	1946	35985	63584	56.59%	17.06%	45	45
14	臺中市龍井區	2018-11-24T23:01:22+08:00	10623	22674	33297	1887	35184	62256	56.52%	17.06%	44	45
14	臺中市龍井區	2018-11-24T23:12:07+08:00	10845	23194	34039	1946	35985	63584	56.59%	17.06%	45	45
14	臺中市龍井區	2018-11-24T23:47:20+08:00	10845	23194	34039	1946	35985	63584	56.59%	17.06%	45	45
14	臺中市龍井區	2018-11-25T01:07:18+08:00	10845	23194	34039	1946	35985	63584	56.59%	17.06%	45	45
14	臺中市龍井區	2018-11-25T06:08:43+08:00	10845	23194	34039	1946	35985	63584	56.59%	17.06%	45	45
14	臺中市龍井區	2018-11-24T22:57:45+08:00	10324	22050	32374	1819	34193	60477	56.54%	17.07%	43	45
14	臺中市龍井區	2018-11-25T01:17:42+08:00	10845	23194	34039	1946	35985	63584	56.59%	17.06%	45	45
14	臺中市龍井區	2018-11-24T22:13:18+08:00	7219	15471	22690	1344	24034	42547	56.49%	16.97%	32	45
14	臺中市龍井區	2018-11-24T22:19:29+08:00	7452	16093	23545	1396	24941	44160	56.48%	16.88%	33	45
14	臺中市龍井區	2018-11-25T00:57:28+08:00	10845	23194	34039	1946	35985	63584	56.59%	17.06%	45	45
14	臺中市龍井區	2018-11-24T23:23:31+08:00	10845	23194	34039	1946	35985	63584	56.59%	17.06%	45	45
14	臺中市龍井區	2018-11-25T03:44:13+08:00	10845	23194	34039	1946	35985	63584	56.59%	17.06%	45	45
14	臺中市龍井區	2018-11-25T00:04:57+08:00	10845	23194	34039	1946	35985	63584	56.59%	17.06%	45	45
14	臺中市龍井區	2018-11-24T23:04:56+08:00	10623	22674	33297	1887	35184	62256	56.52%	17.06%	44	45
14	臺中市龍井區	2018-11-24T23:15:55+08:00	10845	23194	34039	1946	35985	63584	56.59%	17.06%	45	45
14	臺中市龍井區	2018-11-24T22:40:20+08:00	8490	18522	27012	1565	28577	50768	56.29%	16.72%	37	45
14	臺中市龍井區	2018-11-25T06:18:50+08:00	10845	23194	34039	1946	35985	63584	56.59%	17.06%	45	45
14	臺中市龍井區	2018-11-25T01:25:44+08:00	10845	23194	34039	1946	35985	63584	56.59%	17.06%	45	45
14	臺中市龍井區	2018-11-25T01:02:22+08:00	10845	23194	34039	1946	35985	63584	56.59%	17.06%	45	45
14	臺中市龍井區	2018-11-25T03:38:47+08:00	10845	23194	34039	1946	35985	63584	56.59%	17.06%	45	45
14	臺中市龍井區	2018-11-24T23:55:39+08:00	10845	23194	34039	1946	35985	63584	56.59%	17.06%	45	45
14	臺中市龍井區	2018-11-24T22:54:18+08:00	9642	20847	30489	1708	32197	57167	56.32%	16.87%	41	45
14	臺中市龍井區	2018-11-24T22:45:01+08:00	8792	19107	27899	1578	29477	52392	56.26%	16.78%	38	45
14	臺中市龍井區	2018-11-25T00:18:22+08:00	10845	23194	34039	1946	35985	63584	56.59%	17.06%	45	45
14	臺中市龍井區	2018-11-25T00:22:56+08:00	10845	23194	34039	1946	35985	63584	56.59%	17.06%	45	45
14	臺中市龍井區	2018-11-25T03:56:03+08:00	10845	23194	34039	1946	35985	63584	56.59%	17.06%	45	45
14	臺中市龍井區	2018-11-24T23:39:05+08:00	10845	23194	34039	1946	35985	63584	56.59%	17.06%	45	45
14	臺中市龍井區	2018-11-25T01:12:34+08:00	10845	23194	34039	1946	35985	63584	56.59%	17.06%	45	45
14	臺中市龍井區	2018-11-25T04:02:40+08:00	10845	23194	34039	1946	35985	63584	56.59%	17.06%	45	45
14	臺中市龍井區	2018-11-25T00:09:25+08:00	10845	23194	34039	1946	35985	63584	56.59%	17.06%	45	45
14	臺中市龍井區	2018-11-25T00:14:01+08:00	10845	23194	34039	1946	35985	63584	56.59%	17.06%	45	45
14	臺中市龍井區	2018-11-24T22:41:28+08:00	8490	18522	27012	1565	28577	50768	56.29%	16.72%	37	45
14	臺中市龍井區	2018-11-24T22:50:38+08:00	9642	20847	30489	1708	32197	57167	56.32%	16.87%	41	45
14	臺中市龍井區	2018-11-24T23:51:26+08:00	10845	23194	34039	1946	35985	63584	56.59%	17.06%	45	45
14	臺中市龍井區	2018-11-25T00:00:00+08:00	10845	23194	34039	1946	35985	63584	56.59%	17.06%	45	45
14	臺中市龍井區	2018-11-24T22:23:04+08:00	8000	17352	25352	1480	26832	47596	56.37%	16.81%	35	45
14	臺中市龍井區	2018-11-24T23:19:41+08:00	10845	23194	34039	1946	35985	63584	56.59%	17.06%	45	45
14	臺中市龍井區	2018-11-24T22:29:58+08:00	8243	17935	26178	1526	27704	49105	56.42%	16.79%	36	45
14	臺中市龍井區	2018-11-24T22:36:53+08:00	8243	17935	26178	1526	27704	49105	56.42%	16.79%	36	45
14	臺中市龍井區	2018-11-24T23:27:11+08:00	10845	23194	34039	1946	35985	63584	56.59%	17.06%	45	45
14	臺中市龍井區	2018-11-24T23:08:27+08:00	10623	22674	33297	1887	35184	62256	56.52%	17.06%	44	45
14	臺中市龍井區	2018-11-25T03:32:26+08:00	10845	23194	34039	1946	35985	63584	56.59%	17.06%	45	45
14	臺中市龍井區	2018-11-25T06:29:08+08:00	10845	23194	34039	1946	35985	63584	56.59%	17.06%	45	45
14	臺中市龍井區	2018-11-25T03:49:44+08:00	10845	23194	34039	1946	35985	63584	56.59%	17.06%	45	45
14	臺中市龍井區	2018-11-24T22:26:30+08:00	8243	17935	26178	1526	27704	49105	56.42%	16.79%	36	45
14	臺中市龍井區	2018-11-25T06:23:52+08:00	10845	23194	34039	1946	35985	63584	56.59%	17.06%	45	45
14	臺中市龍井區	2018-11-24T23:43:09+08:00	10845	23194	34039	1946	35985	63584	56.59%	17.06%	45	45
14	臺中市龍井區	2018-11-25T06:13:45+08:00	10845	23194	34039	1946	35985	63584	56.59%	17.06%	45	45
14	宜蘭縣員山鄉	2018-11-24T22:33:37+08:00	3613	7053	10666	1022	11688	21819	53.57%	16.56%	26	31
14	宜蘭縣員山鄉	2018-11-24T23:47:28+08:00	4660	9221	13881	1256	15137	28131	53.81%	16.57%	31	31
14	宜蘭縣員山鄉	2018-11-24T22:37:00+08:00	3613	7053	10666	1022	11688	21819	53.57%	16.56%	26	31
14	宜蘭縣員山鄉	2018-11-25T00:18:30+08:00	4660	9221	13881	1256	15137	28131	53.81%	16.57%	31	31
14	宜蘭縣員山鄉	2018-11-25T01:07:26+08:00	4660	9221	13881	1256	15137	28131	53.81%	16.57%	31	31
14	宜蘭縣員山鄉	2018-11-25T06:13:52+08:00	4660	9221	13881	1256	15137	28131	53.81%	16.57%	31	31
14	宜蘭縣員山鄉	2018-11-25T06:29:16+08:00	4660	9221	13881	1256	15137	28131	53.81%	16.57%	31	31
14	宜蘭縣員山鄉	2018-11-24T23:43:17+08:00	4660	9221	13881	1256	15137	28131	53.81%	16.57%	31	31
14	宜蘭縣員山鄉	2018-11-25T01:02:31+08:00	4660	9221	13881	1256	15137	28131	53.81%	16.57%	31	31
14	宜蘭縣員山鄉	2018-11-24T23:55:46+08:00	4660	9221	13881	1256	15137	28131	53.81%	16.57%	31	31
14	宜蘭縣員山鄉	2018-11-24T23:23:38+08:00	4273	8350	12623	1144	13767	25693	53.58%	16.63%	29	31
14	宜蘭縣員山鄉	2018-11-25T03:38:55+08:00	4660	9221	13881	1256	15137	28131	53.81%	16.57%	31	31
14	宜蘭縣員山鄉	2018-11-25T03:44:22+08:00	4660	9221	13881	1256	15137	28131	53.81%	16.57%	31	31
14	宜蘭縣員山鄉	2018-11-24T22:13:26+08:00	3293	6428	9721	927	10648	20003	53.23%	16.46%	24	31
14	宜蘭縣員山鄉	2018-11-24T23:08:36+08:00	4273	8350	12623	1144	13767	25693	53.58%	16.63%	29	31
14	宜蘭縣員山鄉	2018-11-24T22:30:08+08:00	3293	6428	9721	927	10648	20003	53.23%	16.46%	24	31
14	宜蘭縣員山鄉	2018-11-24T22:40:27+08:00	3613	7053	10666	1022	11688	21819	53.57%	16.56%	26	31
14	宜蘭縣員山鄉	2018-11-25T00:00:10+08:00	4660	9221	13881	1256	15137	28131	53.81%	16.57%	31	31
14	宜蘭縣員山鄉	2018-11-25T06:18:57+08:00	4660	9221	13881	1256	15137	28131	53.81%	16.57%	31	31
14	宜蘭縣員山鄉	2018-11-24T22:23:13+08:00	3293	6428	9721	927	10648	20003	53.23%	16.46%	24	31
14	宜蘭縣員山鄉	2018-11-24T23:19:51+08:00	4273	8350	12623	1144	13767	25693	53.58%	16.63%	29	31
14	宜蘭縣員山鄉	2018-11-24T23:12:15+08:00	4273	8350	12623	1144	13767	25693	53.58%	16.63%	29	31
14	宜蘭縣員山鄉	2018-11-24T22:45:08+08:00	3613	7053	10666	1022	11688	21819	53.57%	16.56%	26	31
14	宜蘭縣員山鄉	2018-11-24T23:01:30+08:00	4018	7818	11836	1086	12922	24228	53.33%	16.58%	28	31
14	宜蘭縣員山鄉	2018-11-24T23:39:15+08:00	4660	9221	13881	1256	15137	28131	53.81%	16.57%	31	31
14	宜蘭縣員山鄉	2018-11-24T23:31:11+08:00	4660	9221	13881	1256	15137	28131	53.81%	16.57%	31	31
14	宜蘭縣員山鄉	2018-11-25T00:09:34+08:00	4660	9221	13881	1256	15137	28131	53.81%	16.57%	31	31
14	宜蘭縣員山鄉	2018-11-24T23:35:10+08:00	4660	9221	13881	1256	15137	28131	53.81%	16.57%	31	31
14	宜蘭縣員山鄉	2018-11-25T00:14:09+08:00	4660	9221	13881	1256	15137	28131	53.81%	16.57%	31	31
14	宜蘭縣員山鄉	2018-11-25T03:49:51+08:00	4660	9221	13881	1256	15137	28131	53.81%	16.57%	31	31
14	宜蘭縣員山鄉	2018-11-24T23:16:02+08:00	4273	8350	12623	1144	13767	25693	53.58%	16.63%	29	31
14	宜蘭縣員山鄉	2018-11-25T03:56:12+08:00	4660	9221	13881	1256	15137	28131	53.81%	16.57%	31	31
14	宜蘭縣員山鄉	2018-11-25T06:24:00+08:00	4660	9221	13881	1256	15137	28131	53.81%	16.57%	31	31
14	宜蘭縣員山鄉	2018-11-25T00:23:03+08:00	4660	9221	13881	1256	15137	28131	53.81%	16.57%	31	31
14	宜蘭縣員山鄉	2018-11-25T03:32:34+08:00	4660	9221	13881	1256	15137	28131	53.81%	16.57%	31	31
14	宜蘭縣員山鄉	2018-11-25T01:25:52+08:00	4660	9221	13881	1256	15137	28131	53.81%	16.57%	31	31
14	宜蘭縣員山鄉	2018-11-24T22:57:53+08:00	3841	7505	11346	1058	12404	23212	53.44%	16.55%	27	31
14	宜蘭縣員山鄉	2018-11-24T22:19:36+08:00	3293	6428	9721	927	10648	20003	53.23%	16.46%	24	31
14	宜蘭縣員山鄉	2018-11-25T00:57:36+08:00	4660	9221	13881	1256	15137	28131	53.81%	16.57%	31	31
14	宜蘭縣員山鄉	2018-11-25T01:17:52+08:00	4660	9221	13881	1256	15137	28131	53.81%	16.57%	31	31
14	宜蘭縣員山鄉	2018-11-24T23:27:18+08:00	4460	8711	13171	1207	14378	26775	53.7%	16.66%	30	31
14	宜蘭縣員山鄉	2018-11-24T23:51:35+08:00	4660	9221	13881	1256	15137	28131	53.81%	16.57%	31	31
14	宜蘭縣員山鄉	2018-11-24T23:05:04+08:00	4273	8350	12623	1144	13767	25693	53.58%	16.63%	29	31
14	宜蘭縣員山鄉	2018-11-25T04:02:52+08:00	4660	9221	13881	1256	15137	28131	53.81%	16.57%	31	31
14	宜蘭縣員山鄉	2018-11-24T22:50:47+08:00	3841	7505	11346	1058	12404	23212	53.44%	16.55%	27	31
14	宜蘭縣員山鄉	2018-11-24T22:16:10+08:00	3293	6428	9721	927	10648	20003	53.23%	16.46%	24	31
14	宜蘭縣員山鄉	2018-11-25T01:12:43+08:00	4660	9221	13881	1256	15137	28131	53.81%	16.57%	31	31
14	宜蘭縣員山鄉	2018-11-25T00:05:04+08:00	4660	9221	13881	1256	15137	28131	53.81%	16.57%	31	31
14	宜蘭縣員山鄉	2018-11-24T22:41:34+08:00	3613	7053	10666	1022	11688	21819	53.57%	16.56%	26	31
14	宜蘭縣員山鄉	2018-11-24T22:26:36+08:00	3293	6428	9721	927	10648	20003	53.23%	16.46%	24	31
14	宜蘭縣員山鄉	2018-11-25T06:08:52+08:00	4660	9221	13881	1256	15137	28131	53.81%	16.57%	31	31
14	宜蘭縣員山鄉	2018-11-24T22:54:25+08:00	3841	7505	11346	1058	12404	23212	53.44%	16.55%	27	31
14	雲林縣麥寮鄉	2018-11-24T23:47:26+08:00	4892	11932	16824	1402	18226	37119	49.1%	13.18%	28	28
14	雲林縣麥寮鄉	2018-11-24T23:16:00+08:00	4684	11427	16111	1309	17420	35648	48.87%	13.14%	27	28
14	雲林縣麥寮鄉	2018-11-24T22:16:07+08:00	4082	10087	14169	1167	15336	31431	48.79%	12.99%	24	28
14	雲林縣麥寮鄉	2018-11-25T01:25:50+08:00	4892	11932	16824	1402	18226	37119	49.1%	13.18%	28	28
14	雲林縣麥寮鄉	2018-11-25T00:23:01+08:00	4892	11932	16824	1402	18226	37119	49.1%	13.18%	28	28
14	雲林縣麥寮鄉	2018-11-24T23:23:36+08:00	4892	11932	16824	1402	18226	37119	49.1%	13.18%	28	28
14	雲林縣麥寮鄉	2018-11-25T03:38:52+08:00	4892	11932	16824	1402	18226	37119	49.1%	13.18%	28	28
14	雲林縣麥寮鄉	2018-11-24T22:57:50+08:00	4684	11427	16111	1309	17420	35648	48.87%	13.14%	27	28
14	雲林縣麥寮鄉	2018-11-25T00:57:34+08:00	4892	11932	16824	1402	18226	37119	49.1%	13.18%	28	28
14	雲林縣麥寮鄉	2018-11-24T22:36:58+08:00	4082	10087	14169	1167	15336	31431	48.79%	12.99%	24	28
14	雲林縣麥寮鄉	2018-11-24T22:19:34+08:00	4082	10087	14169	1167	15336	31431	48.79%	12.99%	24	28
14	雲林縣麥寮鄉	2018-11-24T22:45:06+08:00	4270	10456	14726	1222	15948	32771	48.66%	13.03%	25	28
14	雲林縣麥寮鄉	2018-11-25T06:08:50+08:00	4892	11932	16824	1402	18226	37119	49.1%	13.18%	28	28
14	雲林縣麥寮鄉	2018-11-25T01:12:40+08:00	4892	11932	16824	1402	18226	37119	49.1%	13.18%	28	28
14	雲林縣麥寮鄉	2018-11-24T22:26:34+08:00	4082	10087	14169	1167	15336	31431	48.79%	12.99%	24	28
14	雲林縣麥寮鄉	2018-11-25T03:49:49+08:00	4892	11932	16824	1402	18226	37119	49.1%	13.18%	28	28
14	雲林縣麥寮鄉	2018-11-25T06:23:57+08:00	4892	11932	16824	1402	18226	37119	49.1%	13.18%	28	28
14	雲林縣麥寮鄉	2018-11-24T23:39:12+08:00	4892	11932	16824	1402	18226	37119	49.1%	13.18%	28	28
14	雲林縣麥寮鄉	2018-11-24T22:50:45+08:00	4436	10774	15210	1254	16464	33727	48.82%	13.15%	26	28
14	雲林縣麥寮鄉	2018-11-24T23:12:13+08:00	4684	11427	16111	1309	17420	35648	48.87%	13.14%	27	28
14	雲林縣麥寮鄉	2018-11-24T23:31:08+08:00	4892	11932	16824	1402	18226	37119	49.1%	13.18%	28	28
14	雲林縣麥寮鄉	2018-11-24T23:01:28+08:00	4684	11427	16111	1309	17420	35648	48.87%	13.14%	27	28
14	雲林縣麥寮鄉	2018-11-25T06:29:14+08:00	4892	11932	16824	1402	18226	37119	49.1%	13.18%	28	28
14	雲林縣麥寮鄉	2018-11-25T04:02:49+08:00	4892	11932	16824	1402	18226	37119	49.1%	13.18%	28	28
14	雲林縣麥寮鄉	2018-11-25T01:07:23+08:00	4892	11932	16824	1402	18226	37119	49.1%	13.18%	28	28
14	雲林縣麥寮鄉	2018-11-24T23:43:14+08:00	4892	11932	16824	1402	18226	37119	49.1%	13.18%	28	28
14	雲林縣麥寮鄉	2018-11-25T06:13:50+08:00	4892	11932	16824	1402	18226	37119	49.1%	13.18%	28	28
14	雲林縣麥寮鄉	2018-11-24T23:35:08+08:00	4892	11932	16824	1402	18226	37119	49.1%	13.18%	28	28
14	雲林縣麥寮鄉	2018-11-24T22:33:35+08:00	4082	10087	14169	1167	15336	31431	48.79%	12.99%	24	28
14	雲林縣麥寮鄉	2018-11-25T00:14:06+08:00	4892	11932	16824	1402	18226	37119	49.1%	13.18%	28	28
14	雲林縣麥寮鄉	2018-11-25T00:00:07+08:00	4892	11932	16824	1402	18226	37119	49.1%	13.18%	28	28
14	雲林縣麥寮鄉	2018-11-24T23:08:33+08:00	4684	11427	16111	1309	17420	35648	48.87%	13.14%	27	28
14	雲林縣麥寮鄉	2018-11-25T03:32:32+08:00	4892	11932	16824	1402	18226	37119	49.1%	13.18%	28	28
14	雲林縣麥寮鄉	2018-11-25T03:44:20+08:00	4892	11932	16824	1402	18226	37119	49.1%	13.18%	28	28
14	雲林縣麥寮鄉	2018-11-24T22:13:24+08:00	4082	10087	14169	1167	15336	31431	48.79%	12.99%	24	28
14	雲林縣麥寮鄉	2018-11-24T23:55:44+08:00	4892	11932	16824	1402	18226	37119	49.1%	13.18%	28	28
14	雲林縣麥寮鄉	2018-11-25T01:17:49+08:00	4892	11932	16824	1402	18226	37119	49.1%	13.18%	28	28
14	雲林縣麥寮鄉	2018-11-24T23:19:47+08:00	4684	11427	16111	1309	17420	35648	48.87%	13.14%	27	28
14	雲林縣麥寮鄉	2018-11-25T06:18:55+08:00	4892	11932	16824	1402	18226	37119	49.1%	13.18%	28	28
14	雲林縣麥寮鄉	2018-11-25T01:02:28+08:00	4892	11932	16824	1402	18226	37119	49.1%	13.18%	28	28
14	雲林縣麥寮鄉	2018-11-24T23:27:16+08:00	4892	11932	16824	1402	18226	37119	49.1%	13.18%	28	28
14	雲林縣麥寮鄉	2018-11-24T22:40:25+08:00	4270	10456	14726	1222	15948	32771	48.66%	13.03%	25	28
14	雲林縣麥寮鄉	2018-11-24T22:23:10+08:00	4082	10087	14169	1167	15336	31431	48.79%	12.99%	24	28
14	雲林縣麥寮鄉	2018-11-24T22:30:03+08:00	4082	10087	14169	1167	15336	31431	48.79%	12.99%	24	28
14	雲林縣麥寮鄉	2018-11-24T23:51:32+08:00	4892	11932	16824	1402	18226	37119	49.1%	13.18%	28	28
14	雲林縣麥寮鄉	2018-11-25T00:05:02+08:00	4892	11932	16824	1402	18226	37119	49.1%	13.18%	28	28
14	雲林縣麥寮鄉	2018-11-24T22:41:32+08:00	4270	10456	14726	1222	15948	32771	48.66%	13.03%	25	28
14	雲林縣麥寮鄉	2018-11-25T00:09:31+08:00	4892	11932	16824	1402	18226	37119	49.1%	13.18%	28	28
14	雲林縣麥寮鄉	2018-11-24T22:54:23+08:00	4684	11427	16111	1309	17420	35648	48.87%	13.14%	27	28
14	雲林縣麥寮鄉	2018-11-24T23:05:02+08:00	4684	11427	16111	1309	17420	35648	48.87%	13.14%	27	28
14	雲林縣麥寮鄉	2018-11-25T03:56:09+08:00	4892	11932	16824	1402	18226	37119	49.1%	13.18%	28	28
14	雲林縣麥寮鄉	2018-11-25T00:18:27+08:00	4892	11932	16824	1402	18226	37119	49.1%	13.18%	28	28
14	雲林縣虎尾鎮	2018-11-24T23:16:00+08:00	5522	12628	18150	1122	19272	35941	53.62%	15.36%	29	46
14	雲林縣虎尾鎮	2018-11-24T22:16:07+08:00	3138	6892	10030	669	10699	20275	52.77%	15.48%	18	46
14	雲林縣虎尾鎮	2018-11-24T22:23:09+08:00	3780	8485	12265	793	13058	24576	53.13%	15.38%	21	46
14	雲林縣虎尾鎮	2018-11-25T03:32:31+08:00	8894	20574	29468	1670	31138	58167	53.53%	15.29%	46	46
14	雲林縣虎尾鎮	2018-11-25T00:23:01+08:00	8894	20574	29468	1670	31138	58167	53.53%	15.29%	46	46
14	雲林縣虎尾鎮	2018-11-25T03:38:52+08:00	8894	20574	29468	1670	31138	58167	53.53%	15.29%	46	46
14	雲林縣虎尾鎮	2018-11-24T22:36:57+08:00	4347	9985	14332	901	15233	28744	53%	15.12%	24	46
14	雲林縣虎尾鎮	2018-11-24T22:57:50+08:00	4830	11051	15881	976	16857	31482	53.54%	15.34%	26	46
14	雲林縣虎尾鎮	2018-11-25T00:57:33+08:00	8894	20574	29468	1670	31138	58167	53.53%	15.29%	46	46
14	雲林縣虎尾鎮	2018-11-24T23:27:15+08:00	6197	14167	20364	1226	21590	40110	53.83%	15.45%	32	46
14	雲林縣虎尾鎮	2018-11-24T22:19:34+08:00	3328	7354	10682	728	11410	21784	52.38%	15.28%	19	46
14	雲林縣虎尾鎮	2018-11-24T23:12:12+08:00	5292	12144	17436	1073	18509	34521	53.62%	15.33%	28	46
14	雲林縣虎尾鎮	2018-11-24T22:45:06+08:00	4347	9985	14332	901	15233	28744	53%	15.12%	24	46
14	雲林縣虎尾鎮	2018-11-25T06:13:49+08:00	8894	20574	29468	1670	31138	58167	53.53%	15.29%	46	46
14	雲林縣虎尾鎮	2018-11-25T01:12:40+08:00	8894	20574	29468	1670	31138	58167	53.53%	15.29%	46	46
14	雲林縣虎尾鎮	2018-11-24T22:26:34+08:00	3780	8485	12265	793	13058	24576	53.13%	15.38%	21	46
14	雲林縣虎尾鎮	2018-11-25T06:23:57+08:00	8894	20574	29468	1670	31138	58167	53.53%	15.29%	46	46
14	雲林縣虎尾鎮	2018-11-24T23:39:12+08:00	7160	16517	23677	1343	25020	46677	53.6%	15.34%	36	46
14	雲林縣虎尾鎮	2018-11-24T22:50:45+08:00	4593	10576	15169	929	16098	30188	53.33%	15.21%	25	46
14	雲林縣虎尾鎮	2018-11-25T03:49:48+08:00	8894	20574	29468	1670	31138	58167	53.53%	15.29%	46	46
14	雲林縣虎尾鎮	2018-11-24T23:01:28+08:00	4830	11051	15881	976	16857	31482	53.54%	15.34%	26	46
14	雲林縣虎尾鎮	2018-11-25T04:02:47+08:00	8894	20574	29468	1670	31138	58167	53.53%	15.29%	46	46
14	雲林縣虎尾鎮	2018-11-24T23:47:25+08:00	7623	17418	25041	1415	26456	49104	53.88%	15.52%	38	46
14	雲林縣虎尾鎮	2018-11-25T06:29:14+08:00	8894	20574	29468	1670	31138	58167	53.53%	15.29%	46	46
14	雲林縣虎尾鎮	2018-11-24T23:35:07+08:00	6892	15810	22702	1315	24017	44812	53.6%	15.38%	35	46
14	雲林縣虎尾鎮	2018-11-25T01:07:23+08:00	8894	20574	29468	1670	31138	58167	53.53%	15.29%	46	46
14	雲林縣虎尾鎮	2018-11-24T23:43:14+08:00	7342	16901	24243	1378	25621	47797	53.6%	15.36%	37	46
14	雲林縣虎尾鎮	2018-11-24T23:31:07+08:00	6892	15810	22702	1315	24017	44812	53.6%	15.38%	35	46
14	雲林縣虎尾鎮	2018-11-25T06:08:49+08:00	8894	20574	29468	1670	31138	58167	53.53%	15.29%	46	46
14	雲林縣虎尾鎮	2018-11-24T22:33:35+08:00	4180	9515	13695	873	14568	27461	53.05%	15.22%	23	46
14	雲林縣虎尾鎮	2018-11-25T00:14:06+08:00	8723	20131	28854	1642	30496	56883	53.61%	15.33%	45	46
14	雲林縣虎尾鎮	2018-11-24T23:23:35+08:00	6197	14167	20364	1226	21590	40110	53.83%	15.45%	32	46
14	雲林縣虎尾鎮	2018-11-24T22:13:23+08:00	2951	6476	9427	634	10061	18962	53.06%	15.56%	17	46
14	雲林縣虎尾鎮	2018-11-25T01:17:48+08:00	8894	20574	29468	1670	31138	58167	53.53%	15.29%	46	46
14	雲林縣虎尾鎮	2018-11-24T23:55:44+08:00	7771	17794	25565	1449	27014	50328	53.68%	15.44%	39	46
14	雲林縣虎尾鎮	2018-11-25T00:00:06+08:00	7902	18073	25975	1477	27452	51218	53.6%	15.43%	40	46
14	雲林縣虎尾鎮	2018-11-24T23:08:32+08:00	5292	12144	17436	1073	18509	34521	53.62%	15.33%	28	46
14	雲林縣虎尾鎮	2018-11-24T23:19:47+08:00	5745	13173	18918	1179	20097	37445	53.67%	15.34%	30	46
14	雲林縣虎尾鎮	2018-11-25T03:44:19+08:00	8894	20574	29468	1670	31138	58167	53.53%	15.29%	46	46
14	雲林縣虎尾鎮	2018-11-25T01:02:27+08:00	8894	20574	29468	1670	31138	58167	53.53%	15.29%	46	46
14	雲林縣虎尾鎮	2018-11-24T22:40:25+08:00	4347	9985	14332	901	15233	28744	53%	15.12%	24	46
14	雲林縣虎尾鎮	2018-11-24T22:30:03+08:00	3780	8485	12265	793	13058	24576	53.13%	15.38%	21	46
14	雲林縣虎尾鎮	2018-11-25T01:25:49+08:00	8894	20574	29468	1670	31138	58167	53.53%	15.29%	46	46
14	雲林縣虎尾鎮	2018-11-25T06:18:54+08:00	8894	20574	29468	1670	31138	58167	53.53%	15.29%	46	46
14	雲林縣虎尾鎮	2018-11-24T23:51:32+08:00	7771	17794	25565	1449	27014	50328	53.68%	15.44%	39	46
14	雲林縣虎尾鎮	2018-11-25T00:05:02+08:00	8570	19758	28328	1615	29943	55805	53.66%	15.36%	44	46
14	雲林縣虎尾鎮	2018-11-24T22:41:32+08:00	4347	9985	14332	901	15233	28744	53%	15.12%	24	46
14	雲林縣虎尾鎮	2018-11-25T00:09:31+08:00	8723	20131	28854	1642	30496	56883	53.61%	15.33%	45	46
14	雲林縣虎尾鎮	2018-11-24T22:54:23+08:00	4593	10576	15169	929	16098	30188	53.33%	15.21%	25	46
14	雲林縣虎尾鎮	2018-11-24T23:05:02+08:00	5044	11495	16539	1038	17577	33031	53.21%	15.27%	27	46
14	雲林縣虎尾鎮	2018-11-25T03:56:09+08:00	8894	20574	29468	1670	31138	58167	53.53%	15.29%	46	46
14	雲林縣虎尾鎮	2018-11-25T00:18:27+08:00	8894	20574	29468	1670	31138	58167	53.53%	15.29%	46	46
14	高雄市鳥松區	2018-11-25T04:02:43+08:00	7872	14815	22687	1215	23902	39191	60.99%	20.09%	28	28
14	高雄市鳥松區	2018-11-25T06:29:10+08:00	7872	14815	22687	1215	23902	39191	60.99%	20.09%	28	28
14	高雄市鳥松區	2018-11-25T00:14:03+08:00	7576	14175	21751	1164	22915	37638	60.88%	20.13%	27	28
14	高雄市鳥松區	2018-11-24T23:01:25+08:00	5978	10950	16928	914	17842	29531	60.42%	20.24%	22	28
14	高雄市鳥松區	2018-11-24T23:12:09+08:00	5978	10950	16928	914	17842	29531	60.42%	20.24%	22	28
14	高雄市鳥松區	2018-11-24T23:43:11+08:00	6913	12836	19749	1062	20811	34164	60.91%	20.23%	25	28
14	高雄市鳥松區	2018-11-24T23:39:08+08:00	6913	12836	19749	1062	20811	34164	60.91%	20.23%	25	28
14	高雄市鳥松區	2018-11-25T00:09:27+08:00	7381	13689	21070	1106	22176	36383	60.95%	20.29%	26	28
14	高雄市鳥松區	2018-11-25T01:12:36+08:00	7872	14815	22687	1215	23902	39191	60.99%	20.09%	28	28
14	高雄市鳥松區	2018-11-24T23:35:05+08:00	6913	12836	19749	1062	20811	34164	60.91%	20.23%	25	28
14	高雄市鳥松區	2018-11-25T01:07:20+08:00	7872	14815	22687	1215	23902	39191	60.99%	20.09%	28	28
14	高雄市鳥松區	2018-11-24T23:31:04+08:00	6913	12836	19749	1062	20811	34164	60.91%	20.23%	25	28
14	高雄市鳥松區	2018-11-25T01:17:45+08:00	7872	14815	22687	1215	23902	39191	60.99%	20.09%	28	28
14	高雄市鳥松區	2018-11-25T03:44:15+08:00	7872	14815	22687	1215	23902	39191	60.99%	20.09%	28	28
14	高雄市鳥松區	2018-11-24T22:13:20+08:00	2811	5953	8764	446	9210	14889	61.86%	18.88%	12	28
14	高雄市鳥松區	2018-11-24T23:55:41+08:00	7381	13689	21070	1106	22176	36383	60.95%	20.29%	26	28
14	高雄市鳥松區	2018-11-24T22:23:06+08:00	4065	7086	11151	608	11759	19097	61.58%	21.29%	15	28
14	高雄市鳥松區	2018-11-24T23:19:43+08:00	6339	11616	17955	951	18906	31219	60.56%	20.3%	23	28
14	高雄市鳥松區	2018-11-24T23:04:58+08:00	5978	10950	16928	914	17842	29531	60.42%	20.24%	22	28
14	高雄市鳥松區	2018-11-25T00:00:02+08:00	7381	13689	21070	1106	22176	36383	60.95%	20.29%	26	28
14	高雄市鳥松區	2018-11-25T00:04:59+08:00	7381	13689	21070	1106	22176	36383	60.95%	20.29%	26	28
14	高雄市鳥松區	2018-11-25T01:02:24+08:00	7872	14815	22687	1215	23902	39191	60.99%	20.09%	28	28
14	高雄市鳥松區	2018-11-24T23:27:13+08:00	6544	12125	18669	1014	19683	32420	60.71%	20.19%	24	28
14	高雄市鳥松區	2018-11-25T03:38:49+08:00	7872	14815	22687	1215	23902	39191	60.99%	20.09%	28	28
14	高雄市鳥松區	2018-11-24T22:30:00+08:00	4532	8147	12679	705	13384	21893	61.13%	20.7%	17	28
14	高雄市鳥松區	2018-11-25T06:13:47+08:00	7872	14815	22687	1215	23902	39191	60.99%	20.09%	28	28
14	高雄市鳥松區	2018-11-24T22:54:20+08:00	5656	10330	15986	868	16854	27752	60.73%	20.38%	21	28
14	高雄市鳥松區	2018-11-25T00:22:58+08:00	7872	14815	22687	1215	23902	39191	60.99%	20.09%	28	28
14	高雄市鳥松區	2018-11-25T03:56:05+08:00	7872	14815	22687	1215	23902	39191	60.99%	20.09%	28	28
14	高雄市鳥松區	2018-11-25T00:18:24+08:00	7872	14815	22687	1215	23902	39191	60.99%	20.09%	28	28
14	高雄市鳥松區	2018-11-25T06:08:46+08:00	7872	14815	22687	1215	23902	39191	60.99%	20.09%	28	28
14	高雄市鳥松區	2018-11-24T23:47:22+08:00	6913	12836	19749	1062	20811	34164	60.91%	20.23%	25	28
14	高雄市鳥松區	2018-11-24T22:41:29+08:00	5092	9261	14353	790	15143	24796	61.07%	20.54%	19	28
14	高雄市鳥松區	2018-11-24T22:16:04+08:00	2811	5953	8764	446	9210	14889	61.86%	18.88%	12	28
14	高雄市鳥松區	2018-11-24T22:33:32+08:00	4785	8626	13411	742	14153	23118	61.22%	20.7%	18	28
14	高雄市鳥松區	2018-11-24T23:23:33+08:00	6339	11616	17955	951	18906	31219	60.56%	20.3%	23	28
14	高雄市鳥松區	2018-11-24T23:51:29+08:00	7381	13689	21070	1106	22176	36383	60.95%	20.29%	26	28
14	高雄市鳥松區	2018-11-24T22:57:47+08:00	5656	10330	15986	868	16854	27752	60.73%	20.38%	21	28
14	高雄市鳥松區	2018-11-24T22:19:31+08:00	3502	5960	9462	477	9939	16259	61.13%	21.54%	13	28
14	高雄市鳥松區	2018-11-25T00:57:30+08:00	7872	14815	22687	1215	23902	39191	60.99%	20.09%	28	28
14	高雄市鳥松區	2018-11-25T03:32:29+08:00	7872	14815	22687	1215	23902	39191	60.99%	20.09%	28	28
14	高雄市鳥松區	2018-11-25T06:18:52+08:00	7872	14815	22687	1215	23902	39191	60.99%	20.09%	28	28
14	高雄市鳥松區	2018-11-24T22:40:22+08:00	5092	9261	14353	790	15143	24796	61.07%	20.54%	19	28
14	高雄市鳥松區	2018-11-25T01:25:47+08:00	7872	14815	22687	1215	23902	39191	60.99%	20.09%	28	28
14	高雄市鳥松區	2018-11-24T22:36:55+08:00	4785	8626	13411	742	14153	23118	61.22%	20.7%	18	28
14	高雄市鳥松區	2018-11-24T23:08:29+08:00	5978	10950	16928	914	17842	29531	60.42%	20.24%	22	28
14	高雄市鳥松區	2018-11-24T23:15:57+08:00	6339	11616	17955	951	18906	31219	60.56%	20.3%	23	28
14	高雄市鳥松區	2018-11-25T03:49:45+08:00	7872	14815	22687	1215	23902	39191	60.99%	20.09%	28	28
14	高雄市鳥松區	2018-11-25T06:23:54+08:00	7872	14815	22687	1215	23902	39191	60.99%	20.09%	28	28
14	高雄市鳥松區	2018-11-24T22:26:31+08:00	4532	8147	12679	705	13384	21893	61.13%	20.7%	17	28
14	高雄市鳥松區	2018-11-24T22:50:41+08:00	5656	10330	15986	868	16854	27752	60.73%	20.38%	21	28
14	高雄市鳥松區	2018-11-24T22:45:03+08:00	5325	9710	15035	840	15875	26118	60.78%	20.39%	20	28
14	高雄市苓雅區	2018-11-25T06:29:10+08:00	28522	57208	85730	4100	89830	146786	61.2%	19.43%	116	116
14	高雄市苓雅區	2018-11-24T23:35:04+08:00	24048	48929	72977	3373	76350	124991	61.08%	19.24%	101	116
14	高雄市苓雅區	2018-11-25T00:14:03+08:00	26596	53225	79821	3819	83640	136822	61.13%	19.44%	110	116
14	高雄市苓雅區	2018-11-24T23:12:09+08:00	22596	45993	68589	3177	71766	117293	61.19%	19.26%	96	116
14	高雄市苓雅區	2018-11-25T06:08:45+08:00	28522	57208	85730	4100	89830	146786	61.2%	19.43%	116	116
14	高雄市苓雅區	2018-11-24T23:43:11+08:00	25382	50767	76149	3579	79728	130470	61.11%	19.45%	105	116
14	高雄市苓雅區	2018-11-25T00:09:27+08:00	26596	53225	79821	3819	83640	136822	61.13%	19.44%	110	116
14	高雄市苓雅區	2018-11-24T22:33:31+08:00	19291	39097	58388	2655	61043	99467	61.37%	19.39%	83	116
14	高雄市苓雅區	2018-11-25T01:12:36+08:00	27730	55648	83378	4019	87397	143020	61.11%	19.39%	114	116
14	高雄市苓雅區	2018-11-25T04:02:42+08:00	28522	57208	85730	4100	89830	146786	61.2%	19.43%	116	116
14	高雄市苓雅區	2018-11-25T01:07:20+08:00	27730	55648	83378	4019	87397	143020	61.11%	19.39%	114	116
14	高雄市苓雅區	2018-11-24T23:39:07+08:00	24818	49843	74661	3451	78112	127774	61.13%	19.42%	103	116
14	高雄市苓雅區	2018-11-24T23:31:03+08:00	24048	48929	72977	3373	76350	124991	61.08%	19.24%	101	116
14	高雄市苓雅區	2018-11-24T23:01:24+08:00	21738	44190	65928	3035	68963	112411	61.35%	19.34%	93	116
14	高雄市苓雅區	2018-11-25T03:44:15+08:00	28522	57208	85730	4100	89830	146786	61.2%	19.43%	116	116
14	高雄市苓雅區	2018-11-24T23:19:42+08:00	23205	47144	70349	3250	73599	120656	61%	19.23%	98	116
14	高雄市苓雅區	2018-11-24T22:13:20+08:00	16481	32950	49431	2269	51700	84506	61.18%	19.5%	72	116
14	高雄市苓雅區	2018-11-24T23:55:41+08:00	25584	51198	76782	3629	80411	131572	61.12%	19.44%	106	116
14	高雄市苓雅區	2018-11-24T22:23:06+08:00	18071	36366	54437	2490	56927	93074	61.16%	19.42%	78	116
14	高雄市苓雅區	2018-11-25T01:17:44+08:00	27730	55648	83378	4019	87397	143020	61.11%	19.39%	114	116
14	高雄市苓雅區	2018-11-24T23:04:58+08:00	22346	45495	67841	3141	70982	115849	61.27%	19.29%	95	116
14	高雄市苓雅區	2018-11-25T00:04:59+08:00	26596	53225	79821	3819	83640	136822	61.13%	19.44%	110	116
14	高雄市苓雅區	2018-11-25T06:18:51+08:00	28522	57208	85730	4100	89830	146786	61.2%	19.43%	116	116
14	高雄市苓雅區	2018-11-25T01:02:24+08:00	27730	55648	83378	4019	87397	143020	61.11%	19.39%	114	116
14	高雄市苓雅區	2018-11-24T23:27:13+08:00	23521	47857	71378	3299	74677	122374	61.02%	19.22%	99	116
14	高雄市苓雅區	2018-11-25T03:38:49+08:00	28522	57208	85730	4100	89830	146786	61.2%	19.43%	116	116
14	高雄市苓雅區	2018-11-24T22:54:20+08:00	20886	42535	63421	2925	66346	108300	61.26%	19.29%	90	116
14	高雄市苓雅區	2018-11-25T03:56:05+08:00	28522	57208	85730	4100	89830	146786	61.2%	19.43%	116	116
14	高雄市苓雅區	2018-11-25T00:18:23+08:00	26928	53973	80901	3887	84788	138626	61.16%	19.42%	111	116
14	高雄市苓雅區	2018-11-25T06:13:46+08:00	28522	57208	85730	4100	89830	146786	61.2%	19.43%	116	116
14	高雄市苓雅區	2018-11-25T00:22:57+08:00	27151	54409	81560	3925	85485	139898	61.11%	19.41%	112	116
14	高雄市苓雅區	2018-11-24T23:47:22+08:00	25382	50767	76149	3579	79728	130470	61.11%	19.45%	105	116
14	高雄市苓雅區	2018-11-24T22:41:29+08:00	19955	40651	60606	2788	63394	103411	61.3%	19.3%	86	116
14	高雄市苓雅區	2018-11-24T22:16:03+08:00	16723	33361	50084	2295	52379	85627	61.17%	19.53%	73	116
14	高雄市苓雅區	2018-11-24T22:29:59+08:00	19063	38555	57618	2613	60231	98231	61.32%	19.41%	82	116
14	高雄市苓雅區	2018-11-24T23:23:32+08:00	23521	47857	71378	3299	74677	122374	61.02%	19.22%	99	116
14	高雄市苓雅區	2018-11-24T23:51:28+08:00	25382	50767	76149	3579	79728	130470	61.11%	19.45%	105	116
14	高雄市苓雅區	2018-11-24T22:57:46+08:00	21189	43136	64325	2950	67275	109731	61.31%	19.31%	91	116
14	高雄市苓雅區	2018-11-25T00:00:01+08:00	25906	51748	77654	3675	81329	133068	61.12%	19.47%	107	116
14	高雄市苓雅區	2018-11-25T01:25:46+08:00	27730	55648	83378	4019	87397	143020	61.11%	19.39%	114	116
14	高雄市苓雅區	2018-11-24T22:19:31+08:00	17315	34545	51860	2388	54248	88676	61.18%	19.53%	75	116
14	高雄市苓雅區	2018-11-25T00:57:30+08:00	27730	55648	83378	4019	87397	143020	61.11%	19.39%	114	116
14	高雄市苓雅區	2018-11-24T22:40:22+08:00	19955	40651	60606	2788	63394	103411	61.3%	19.3%	86	116
14	高雄市苓雅區	2018-11-24T22:36:55+08:00	19711	40225	59936	2750	62686	102127	61.38%	19.3%	85	116
14	高雄市苓雅區	2018-11-24T23:08:29+08:00	22346	45495	67841	3141	70982	115849	61.27%	19.29%	95	116
14	高雄市苓雅區	2018-11-24T23:15:57+08:00	22978	46679	69657	3227	72884	119338	61.07%	19.25%	97	116
14	高雄市苓雅區	2018-11-25T03:32:28+08:00	28522	57208	85730	4100	89830	146786	61.2%	19.43%	116	116
14	高雄市苓雅區	2018-11-25T03:49:45+08:00	28522	57208	85730	4100	89830	146786	61.2%	19.43%	116	116
14	高雄市苓雅區	2018-11-25T06:23:54+08:00	28522	57208	85730	4100	89830	146786	61.2%	19.43%	116	116
14	高雄市苓雅區	2018-11-24T22:26:31+08:00	18634	37561	56195	2575	58770	95911	61.28%	19.43%	80	116
14	高雄市苓雅區	2018-11-24T22:50:41+08:00	20706	42197	62903	2865	65768	107450	61.21%	19.27%	89	116
14	高雄市苓雅區	2018-11-24T22:45:03+08:00	19955	40651	60606	2788	63394	103411	61.3%	19.3%	86	116
14	基隆市信義區	2018-11-25T06:29:19+08:00	7688	15505	23193	944	24137	46014	52.46%	16.71%	36	36
14	基隆市信義區	2018-11-25T01:07:28+08:00	7688	15505	23193	944	24137	46014	52.46%	16.71%	36	36
14	基隆市信義區	2018-11-25T03:49:53+08:00	7688	15505	23193	944	24137	46014	52.46%	16.71%	36	36
14	基隆市信義區	2018-11-24T22:50:50+08:00	4961	9717	14678	569	15247	28382	53.72%	17.48%	24	36
14	基隆市信義區	2018-11-25T06:13:54+08:00	7688	15505	23193	944	24137	46014	52.46%	16.71%	36	36
14	基隆市信義區	2018-11-24T23:43:19+08:00	6888	13782	20670	865	21535	40984	52.54%	16.81%	33	36
14	基隆市信義區	2018-11-24T22:13:29+08:00	3570	7063	10633	422	11055	20541	53.82%	17.38%	17	36
14	基隆市信義區	2018-11-25T03:32:36+08:00	7688	15505	23193	944	24137	46014	52.46%	16.71%	36	36
14	基隆市信義區	2018-11-25T03:44:25+08:00	7688	15505	23193	944	24137	46014	52.46%	16.71%	36	36
14	基隆市信義區	2018-11-24T23:08:38+08:00	6236	12399	18635	761	19396	36973	52.46%	16.87%	30	36
14	基隆市信義區	2018-11-24T23:55:49+08:00	6888	13782	20670	865	21535	40984	52.54%	16.81%	33	36
14	基隆市信義區	2018-11-25T06:24:02+08:00	7688	15505	23193	944	24137	46014	52.46%	16.71%	36	36
14	基隆市信義區	2018-11-24T23:51:37+08:00	6888	13782	20670	865	21535	40984	52.54%	16.81%	33	36
14	基隆市信義區	2018-11-24T22:23:15+08:00	4179	8239	12418	504	12922	24168	53.47%	17.29%	20	36
14	基隆市信義區	2018-11-24T22:40:29+08:00	4348	8570	12918	522	13440	25167	53.4%	17.28%	21	36
14	基隆市信義區	2018-11-25T06:18:59+08:00	7688	15505	23193	944	24137	46014	52.46%	16.71%	36	36
14	基隆市信義區	2018-11-24T23:23:40+08:00	6665	13290	19955	829	20784	39429	52.71%	16.9%	32	36
14	基隆市信義區	2018-11-24T22:33:40+08:00	4348	8570	12918	522	13440	25167	53.4%	17.28%	21	36
14	基隆市信義區	2018-11-24T22:54:27+08:00	5160	10168	15328	606	15934	29867	53.35%	17.28%	25	36
14	基隆市信義區	2018-11-25T00:14:11+08:00	7379	14890	22269	912	23181	44029	52.65%	16.76%	35	36
14	基隆市信義區	2018-11-24T22:16:12+08:00	3910	7790	11700	471	12171	22829	53.31%	17.13%	19	36
14	基隆市信義區	2018-11-24T22:41:37+08:00	4348	8570	12918	522	13440	25167	53.4%	17.28%	21	36
14	基隆市信義區	2018-11-25T00:05:07+08:00	7147	14328	21475	894	22369	42553	52.57%	16.8%	34	36
14	基隆市信義區	2018-11-24T23:05:06+08:00	6015	11902	17917	729	18646	35209	52.96%	17.08%	29	36
14	基隆市信義區	2018-11-24T22:45:10+08:00	4525	8924	13449	540	13989	26096	53.61%	17.34%	22	36
14	基隆市信義區	2018-11-25T03:56:14+08:00	7688	15505	23193	944	24137	46014	52.46%	16.71%	36	36
14	基隆市信義區	2018-11-24T22:37:02+08:00	4348	8570	12918	522	13440	25167	53.4%	17.28%	21	36
14	基隆市信義區	2018-11-25T00:18:32+08:00	7688	15505	23193	944	24137	46014	52.46%	16.71%	36	36
14	基隆市信義區	2018-11-24T23:16:04+08:00	6665	13290	19955	829	20784	39429	52.71%	16.9%	32	36
14	基隆市信義區	2018-11-25T00:23:05+08:00	7688	15505	23193	944	24137	46014	52.46%	16.71%	36	36
14	基隆市信義區	2018-11-25T01:25:54+08:00	7688	15505	23193	944	24137	46014	52.46%	16.71%	36	36
14	基隆市信義區	2018-11-24T22:30:11+08:00	4348	8570	12918	522	13440	25167	53.4%	17.28%	21	36
14	基隆市信義區	2018-11-25T03:38:56+08:00	7688	15505	23193	944	24137	46014	52.46%	16.71%	36	36
14	基隆市信義區	2018-11-25T01:02:33+08:00	7688	15505	23193	944	24137	46014	52.46%	16.71%	36	36
14	基隆市信義區	2018-11-24T23:19:53+08:00	6665	13290	19955	829	20784	39429	52.71%	16.9%	32	36
14	基隆市信義區	2018-11-25T00:00:12+08:00	7147	14328	21475	894	22369	42553	52.57%	16.8%	34	36
14	基隆市信義區	2018-11-25T01:17:55+08:00	7688	15505	23193	944	24137	46014	52.46%	16.71%	36	36
14	基隆市信義區	2018-11-24T22:57:55+08:00	5583	11071	16654	669	17323	32892	52.67%	16.97%	27	36
14	基隆市信義區	2018-11-24T22:19:39+08:00	4179	8239	12418	504	12922	24168	53.47%	17.29%	20	36
14	基隆市信義區	2018-11-24T23:27:20+08:00	6888	13782	20670	865	21535	40984	52.54%	16.81%	33	36
14	基隆市信義區	2018-11-25T00:57:38+08:00	7688	15505	23193	944	24137	46014	52.46%	16.71%	36	36
14	基隆市信義區	2018-11-24T23:35:12+08:00	6888	13782	20670	865	21535	40984	52.54%	16.81%	33	36
14	基隆市信義區	2018-11-24T23:47:30+08:00	6888	13782	20670	865	21535	40984	52.54%	16.81%	33	36
14	基隆市信義區	2018-11-25T00:09:36+08:00	7379	14890	22269	912	23181	44029	52.65%	16.76%	35	36
14	基隆市信義區	2018-11-24T23:01:33+08:00	5766	11514	17280	708	17988	34025	52.87%	16.95%	28	36
14	基隆市信義區	2018-11-24T23:31:13+08:00	6888	13782	20670	865	21535	40984	52.54%	16.81%	33	36
14	基隆市信義區	2018-11-25T04:02:54+08:00	7688	15505	23193	944	24137	46014	52.46%	16.71%	36	36
14	基隆市信義區	2018-11-25T01:12:45+08:00	7688	15505	23193	944	24137	46014	52.46%	16.71%	36	36
14	基隆市信義區	2018-11-24T22:26:38+08:00	4179	8239	12418	504	12922	24168	53.47%	17.29%	20	36
14	基隆市信義區	2018-11-24T23:12:17+08:00	6455	12863	19318	800	20118	38241	52.61%	16.88%	31	36
14	基隆市信義區	2018-11-24T23:39:18+08:00	6888	13782	20670	865	21535	40984	52.54%	16.81%	33	36
14	基隆市信義區	2018-11-25T06:08:55+08:00	7688	15505	23193	944	24137	46014	52.46%	16.71%	36	36
14	新竹縣關西鎮	2018-11-25T04:02:43+08:00	3623	9655	13278	786	14064	24712	56.91%	14.66%	27	27
14	新竹縣關西鎮	2018-11-25T01:12:37+08:00	3623	9655	13278	786	14064	24712	56.91%	14.66%	27	27
14	新竹縣關西鎮	2018-11-25T00:14:04+08:00	3623	9655	13278	786	14064	24712	56.91%	14.66%	27	27
14	新竹縣關西鎮	2018-11-24T23:31:05+08:00	3623	9655	13278	786	14064	24712	56.91%	14.66%	27	27
14	新竹縣關西鎮	2018-11-25T01:07:21+08:00	3623	9655	13278	786	14064	24712	56.91%	14.66%	27	27
14	新竹縣關西鎮	2018-11-24T23:35:05+08:00	3623	9655	13278	786	14064	24712	56.91%	14.66%	27	27
14	新竹縣關西鎮	2018-11-25T06:29:11+08:00	3623	9655	13278	786	14064	24712	56.91%	14.66%	27	27
14	新竹縣關西鎮	2018-11-24T23:39:09+08:00	3623	9655	13278	786	14064	24712	56.91%	14.66%	27	27
14	新竹縣關西鎮	2018-11-25T00:09:28+08:00	3623	9655	13278	786	14064	24712	56.91%	14.66%	27	27
14	新竹縣關西鎮	2018-11-24T22:23:07+08:00	2607	6831	9438	568	10006	17714	56.49%	14.72%	20	27
14	新竹縣關西鎮	2018-11-25T00:00:03+08:00	3623	9655	13278	786	14064	24712	56.91%	14.66%	27	27
14	新竹縣關西鎮	2018-11-24T23:08:30+08:00	3623	9655	13278	786	14064	24712	56.91%	14.66%	27	27
14	新竹縣關西鎮	2018-11-24T23:19:44+08:00	3623	9655	13278	786	14064	24712	56.91%	14.66%	27	27
14	新竹縣關西鎮	2018-11-24T22:13:21+08:00	2407	6183	8590	526	9116	16178	56.35%	14.88%	18	27
14	新竹縣關西鎮	2018-11-24T23:51:30+08:00	3623	9655	13278	786	14064	24712	56.91%	14.66%	27	27
14	新竹縣關西鎮	2018-11-24T22:30:01+08:00	2791	7300	10091	599	10690	18922	56.5%	14.75%	21	27
14	新竹縣關西鎮	2018-11-24T23:27:14+08:00	3623	9655	13278	786	14064	24712	56.91%	14.66%	27	27
14	新竹縣關西鎮	2018-11-24T22:19:32+08:00	2543	6602	9145	552	9697	17234	56.27%	14.76%	19	27
14	新竹縣關西鎮	2018-11-24T22:36:56+08:00	3071	7965	11036	661	11697	20576	56.85%	14.93%	23	27
14	新竹縣關西鎮	2018-11-25T01:02:25+08:00	3623	9655	13278	786	14064	24712	56.91%	14.66%	27	27
14	新竹縣關西鎮	2018-11-25T06:13:47+08:00	3623	9655	13278	786	14064	24712	56.91%	14.66%	27	27
14	新竹縣關西鎮	2018-11-25T00:18:25+08:00	3623	9655	13278	786	14064	24712	56.91%	14.66%	27	27
14	新竹縣關西鎮	2018-11-24T23:05:00+08:00	3491	9231	12722	763	13485	23735	56.81%	14.71%	26	27
14	新竹縣關西鎮	2018-11-24T22:26:32+08:00	2607	6831	9438	568	10006	17714	56.49%	14.72%	20	27
14	新竹縣關西鎮	2018-11-24T22:50:42+08:00	3397	8849	12246	733	12979	22792	56.95%	14.9%	25	27
14	新竹縣關西鎮	2018-11-24T22:54:21+08:00	3491	9231	12722	763	13485	23735	56.81%	14.71%	26	27
14	新竹縣關西鎮	2018-11-25T00:05:00+08:00	3623	9655	13278	786	14064	24712	56.91%	14.66%	27	27
14	新竹縣關西鎮	2018-11-24T22:41:30+08:00	3071	7965	11036	661	11697	20576	56.85%	14.93%	23	27
14	新竹縣關西鎮	2018-11-25T00:22:59+08:00	3623	9655	13278	786	14064	24712	56.91%	14.66%	27	27
14	新竹縣關西鎮	2018-11-25T03:49:46+08:00	3623	9655	13278	786	14064	24712	56.91%	14.66%	27	27
14	新竹縣關西鎮	2018-11-24T22:16:05+08:00	2543	6602	9145	552	9697	17234	56.27%	14.76%	19	27
14	新竹縣關西鎮	2018-11-24T23:01:26+08:00	3491	9231	12722	763	13485	23735	56.81%	14.71%	26	27
14	新竹縣關西鎮	2018-11-24T23:43:12+08:00	3623	9655	13278	786	14064	24712	56.91%	14.66%	27	27
14	新竹縣關西鎮	2018-11-25T06:08:47+08:00	3623	9655	13278	786	14064	24712	56.91%	14.66%	27	27
14	新竹縣關西鎮	2018-11-24T22:33:32+08:00	2941	7660	10601	625	11226	19768	56.79%	14.88%	22	27
14	新竹縣關西鎮	2018-11-24T23:47:23+08:00	3623	9655	13278	786	14064	24712	56.91%	14.66%	27	27
14	新竹縣關西鎮	2018-11-24T23:55:42+08:00	3623	9655	13278	786	14064	24712	56.91%	14.66%	27	27
14	新竹縣關西鎮	2018-11-25T01:17:46+08:00	3623	9655	13278	786	14064	24712	56.91%	14.66%	27	27
14	新竹縣關西鎮	2018-11-24T22:57:48+08:00	3491	9231	12722	763	13485	23735	56.81%	14.71%	26	27
14	新竹縣關西鎮	2018-11-25T03:38:50+08:00	3623	9655	13278	786	14064	24712	56.91%	14.66%	27	27
14	新竹縣關西鎮	2018-11-24T23:23:33+08:00	3623	9655	13278	786	14064	24712	56.91%	14.66%	27	27
14	新竹縣關西鎮	2018-11-25T03:44:17+08:00	3623	9655	13278	786	14064	24712	56.91%	14.66%	27	27
14	新竹縣關西鎮	2018-11-24T22:40:23+08:00	3071	7965	11036	661	11697	20576	56.85%	14.93%	23	27
14	新竹縣關西鎮	2018-11-25T03:32:29+08:00	3623	9655	13278	786	14064	24712	56.91%	14.66%	27	27
14	新竹縣關西鎮	2018-11-25T06:18:52+08:00	3623	9655	13278	786	14064	24712	56.91%	14.66%	27	27
14	新竹縣關西鎮	2018-11-24T23:15:58+08:00	3623	9655	13278	786	14064	24712	56.91%	14.66%	27	27
14	新竹縣關西鎮	2018-11-25T00:57:31+08:00	3623	9655	13278	786	14064	24712	56.91%	14.66%	27	27
14	新竹縣關西鎮	2018-11-25T01:25:47+08:00	3623	9655	13278	786	14064	24712	56.91%	14.66%	27	27
14	新竹縣關西鎮	2018-11-25T03:56:06+08:00	3623	9655	13278	786	14064	24712	56.91%	14.66%	27	27
14	新竹縣關西鎮	2018-11-25T06:23:55+08:00	3623	9655	13278	786	14064	24712	56.91%	14.66%	27	27
14	新竹縣關西鎮	2018-11-24T22:45:04+08:00	3211	8328	11539	692	12231	21430	57.07%	14.98%	24	27
14	新竹縣關西鎮	2018-11-24T23:12:10+08:00	3623	9655	13278	786	14064	24712	56.91%	14.66%	27	27
14	臺中市南區	2018-11-24T23:47:19+08:00	18993	36766	55759	2992	58751	95539	61.49%	19.88%	69	74
14	臺中市南區	2018-11-24T22:16:01+08:00	15147	29057	44204	2312	46516	76164	61.07%	19.89%	55	74
14	臺中市南區	2018-11-25T01:07:17+08:00	20611	39862	60473	3253	63726	103643	61.49%	19.89%	74	74
14	臺中市南區	2018-11-24T23:01:22+08:00	18502	35770	54272	2866	57138	93028	61.42%	19.89%	67	74
14	臺中市南區	2018-11-25T06:08:42+08:00	20611	39862	60473	3253	63726	103643	61.49%	19.89%	74	74
14	臺中市南區	2018-11-24T23:35:02+08:00	18716	36234	54950	2919	57869	94235	61.41%	19.86%	68	74
14	臺中市南區	2018-11-24T23:12:06+08:00	18716	36234	54950	2919	57869	94235	61.41%	19.86%	68	74
14	臺中市南區	2018-11-24T22:26:29+08:00	16321	31311	47632	2489	50121	82024	61.11%	19.9%	59	74
14	臺中市南區	2018-11-25T03:44:12+08:00	20611	39862	60473	3253	63726	103643	61.49%	19.89%	74	74
14	臺中市南區	2018-11-24T22:19:29+08:00	15717	30199	45916	2405	48321	79040	61.13%	19.88%	57	74
14	臺中市南區	2018-11-25T00:04:56+08:00	18993	36766	55759	2992	58751	95539	61.49%	19.88%	69	74
14	臺中市南區	2018-11-24T22:57:44+08:00	18502	35770	54272	2866	57138	93028	61.42%	19.89%	67	74
14	臺中市南區	2018-11-25T00:57:27+08:00	20611	39862	60473	3253	63726	103643	61.49%	19.89%	74	74
14	臺中市南區	2018-11-24T22:13:17+08:00	14898	28598	43496	2279	45775	74880	61.13%	19.9%	54	74
14	臺中市南區	2018-11-24T23:23:30+08:00	18716	36234	54950	2919	57869	94235	61.41%	19.86%	68	74
14	臺中市南區	2018-11-24T23:55:38+08:00	18993	36766	55759	2992	58751	95539	61.49%	19.88%	69	74
14	臺中市南區	2018-11-24T22:40:20+08:00	17703	34073	51776	2721	54497	88780	61.38%	19.94%	64	74
14	臺中市南區	2018-11-24T23:15:54+08:00	18716	36234	54950	2919	57869	94235	61.41%	19.86%	68	74
14	臺中市南區	2018-11-25T01:25:43+08:00	20611	39862	60473	3253	63726	103643	61.49%	19.89%	74	74
14	臺中市南區	2018-11-24T23:59:59+08:00	18993	36766	55759	2992	58751	95539	61.49%	19.88%	69	74
14	臺中市南區	2018-11-25T01:02:22+08:00	20611	39862	60473	3253	63726	103643	61.49%	19.89%	74	74
14	臺中市南區	2018-11-25T03:38:47+08:00	20611	39862	60473	3253	63726	103643	61.49%	19.89%	74	74
14	臺中市南區	2018-11-24T22:54:18+08:00	18502	35770	54272	2866	57138	93028	61.42%	19.89%	67	74
14	臺中市南區	2018-11-25T06:23:51+08:00	20611	39862	60473	3253	63726	103643	61.49%	19.89%	74	74
14	臺中市南區	2018-11-24T22:45:00+08:00	18073	34810	52883	2762	55645	90506	61.48%	19.97%	65	74
14	臺中市南區	2018-11-24T23:31:01+08:00	18716	36234	54950	2919	57869	94235	61.41%	19.86%	68	74
14	臺中市南區	2018-11-25T00:09:24+08:00	18712	36198	54910	2938	57848	94152	61.44%	19.87%	68	74
14	臺中市南區	2018-11-24T22:41:27+08:00	17703	34073	51776	2721	54497	88780	61.38%	19.94%	64	74
14	臺中市南區	2018-11-25T04:02:40+08:00	20611	39862	60473	3253	63726	103643	61.49%	19.89%	74	74
14	臺中市南區	2018-11-25T01:12:33+08:00	20611	39862	60473	3253	63726	103643	61.49%	19.89%	74	74
14	臺中市南區	2018-11-24T22:50:37+08:00	18291	35241	53532	2835	56367	91636	61.51%	19.96%	66	74
14	臺中市南區	2018-11-25T00:14:00+08:00	19388	37524	56912	3002	59914	97600	61.39%	19.86%	70	74
14	臺中市南區	2018-11-24T23:39:04+08:00	18993	36766	55759	2992	58751	95539	61.49%	19.88%	69	74
14	臺中市南區	2018-11-24T23:51:26+08:00	18993	36766	55759	2992	58751	95539	61.49%	19.88%	69	74
14	臺中市南區	2018-11-25T06:18:49+08:00	20611	39862	60473	3253	63726	103643	61.49%	19.89%	74	74
14	臺中市南區	2018-11-25T01:17:41+08:00	20611	39862	60473	3253	63726	103643	61.49%	19.89%	74	74
14	臺中市南區	2018-11-24T22:23:03+08:00	15717	30199	45916	2405	48321	79040	61.13%	19.88%	57	74
14	臺中市南區	2018-11-24T22:29:56+08:00	16584	31838	48422	2522	50944	83418	61.07%	19.88%	60	74
14	臺中市南區	2018-11-24T23:04:55+08:00	18716	36234	54950	2919	57869	94235	61.41%	19.86%	68	74
14	臺中市南區	2018-11-24T23:19:40+08:00	18716	36234	54950	2919	57869	94235	61.41%	19.86%	68	74
14	臺中市南區	2018-11-24T22:36:53+08:00	17355	33393	50748	2667	53415	87057	61.36%	19.94%	63	74
14	臺中市南區	2018-11-24T23:27:10+08:00	18716	36234	54950	2919	57869	94235	61.41%	19.86%	68	74
14	臺中市南區	2018-11-24T23:08:26+08:00	18716	36234	54950	2919	57869	94235	61.41%	19.86%	68	74
14	臺中市南區	2018-11-25T03:32:26+08:00	20611	39862	60473	3253	63726	103643	61.49%	19.89%	74	74
14	臺中市南區	2018-11-25T03:49:43+08:00	20611	39862	60473	3253	63726	103643	61.49%	19.89%	74	74
14	臺中市南區	2018-11-25T00:22:55+08:00	19669	38092	57761	3056	60817	98987	61.44%	19.87%	71	74
14	臺中市南區	2018-11-25T03:56:01+08:00	20611	39862	60473	3253	63726	103643	61.49%	19.89%	74	74
14	臺中市南區	2018-11-25T06:13:44+08:00	20611	39862	60473	3253	63726	103643	61.49%	19.89%	74	74
14	臺中市南區	2018-11-25T00:18:21+08:00	19388	37524	56912	3002	59914	97600	61.39%	19.86%	70	74
14	臺中市南區	2018-11-24T22:33:29+08:00	17355	33393	50748	2667	53415	87057	61.36%	19.94%	63	74
14	臺中市南區	2018-11-25T06:29:07+08:00	20611	39862	60473	3253	63726	103643	61.49%	19.89%	74	74
14	臺中市南區	2018-11-24T23:43:08+08:00	18993	36766	55759	2992	58751	95539	61.49%	19.88%	69	74
14	臺中市沙鹿區	2018-11-24T23:47:19+08:00	12165	27773	39938	2330	42268	74207	56.96%	16.39%	53	53
14	臺中市沙鹿區	2018-11-24T23:35:03+08:00	12165	27773	39938	2330	42268	74207	56.96%	16.39%	53	53
14	臺中市沙鹿區	2018-11-24T22:16:01+08:00	6027	14098	20125	1153	21278	36732	57.93%	16.41%	29	53
14	臺中市沙鹿區	2018-11-24T23:01:22+08:00	8944	20652	29596	1659	31255	54138	57.73%	16.52%	41	53
14	臺中市沙鹿區	2018-11-24T23:12:06+08:00	10047	23102	33149	1834	34983	60938	57.41%	16.49%	45	53
14	臺中市沙鹿區	2018-11-25T01:07:18+08:00	12165	27773	39938	2330	42268	74207	56.96%	16.39%	53	53
14	臺中市沙鹿區	2018-11-25T06:08:43+08:00	12165	27773	39938	2330	42268	74207	56.96%	16.39%	53	53
14	臺中市沙鹿區	2018-11-24T22:26:29+08:00	6739	15712	22451	1273	23724	40905	58%	16.47%	32	53
14	臺中市沙鹿區	2018-11-25T03:44:12+08:00	12165	27773	39938	2330	42268	74207	56.96%	16.39%	53	53
14	臺中市沙鹿區	2018-11-25T01:17:42+08:00	12165	27773	39938	2330	42268	74207	56.96%	16.39%	53	53
14	臺中市沙鹿區	2018-11-24T22:13:18+08:00	6027	14098	20125	1153	21278	36732	57.93%	16.41%	29	53
14	臺中市沙鹿區	2018-11-24T22:19:29+08:00	6265	14662	20927	1215	22142	38201	57.96%	16.4%	30	53
14	臺中市沙鹿區	2018-11-25T00:57:28+08:00	12165	27773	39938	2330	42268	74207	56.96%	16.39%	53	53
14	臺中市沙鹿區	2018-11-25T00:04:56+08:00	12165	27773	39938	2330	42268	74207	56.96%	16.39%	53	53
14	臺中市沙鹿區	2018-11-24T22:57:44+08:00	8766	20169	28935	1620	30555	52996	57.66%	16.54%	40	53
14	臺中市沙鹿區	2018-11-24T23:23:30+08:00	10863	24831	35694	2070	37764	66330	56.93%	16.38%	48	53
14	臺中市沙鹿區	2018-11-24T23:04:56+08:00	9459	21810	31269	1766	33035	57432	57.52%	16.47%	43	53
14	臺中市沙鹿區	2018-11-24T22:40:20+08:00	7945	18297	26242	1483	27725	48041	57.71%	16.54%	37	53
14	臺中市沙鹿區	2018-11-24T23:15:54+08:00	10047	23102	33149	1834	34983	60938	57.41%	16.49%	45	53
14	臺中市沙鹿區	2018-11-25T01:25:44+08:00	12165	27773	39938	2330	42268	74207	56.96%	16.39%	53	53
14	臺中市沙鹿區	2018-11-24T23:59:59+08:00	12165	27773	39938	2330	42268	74207	56.96%	16.39%	53	53
14	臺中市沙鹿區	2018-11-25T01:02:22+08:00	12165	27773	39938	2330	42268	74207	56.96%	16.39%	53	53
14	臺中市沙鹿區	2018-11-25T03:38:47+08:00	12165	27773	39938	2330	42268	74207	56.96%	16.39%	53	53
14	臺中市沙鹿區	2018-11-24T23:55:39+08:00	12165	27773	39938	2330	42268	74207	56.96%	16.39%	53	53
14	臺中市沙鹿區	2018-11-24T22:54:18+08:00	8229	18931	27160	1517	28677	49674	57.73%	16.57%	38	53
14	臺中市沙鹿區	2018-11-24T22:45:01+08:00	7945	18297	26242	1483	27725	48041	57.71%	16.54%	37	53
14	臺中市沙鹿區	2018-11-25T03:56:02+08:00	12165	27773	39938	2330	42268	74207	56.96%	16.39%	53	53
14	臺中市沙鹿區	2018-11-24T23:39:05+08:00	12165	27773	39938	2330	42268	74207	56.96%	16.39%	53	53
14	臺中市沙鹿區	2018-11-24T23:31:01+08:00	11947	27303	39250	2279	41529	72922	56.95%	16.38%	52	53
14	臺中市沙鹿區	2018-11-25T00:09:24+08:00	12165	27773	39938	2330	42268	74207	56.96%	16.39%	53	53
14	臺中市沙鹿區	2018-11-24T22:41:27+08:00	7945	18297	26242	1483	27725	48041	57.71%	16.54%	37	53
14	臺中市沙鹿區	2018-11-25T04:02:40+08:00	12165	27773	39938	2330	42268	74207	56.96%	16.39%	53	53
14	臺中市沙鹿區	2018-11-25T01:12:33+08:00	12165	27773	39938	2330	42268	74207	56.96%	16.39%	53	53
14	臺中市沙鹿區	2018-11-25T00:14:01+08:00	12165	27773	39938	2330	42268	74207	56.96%	16.39%	53	53
14	臺中市沙鹿區	2018-11-24T22:50:38+08:00	8229	18931	27160	1517	28677	49674	57.73%	16.57%	38	53
14	臺中市沙鹿區	2018-11-24T23:51:26+08:00	12165	27773	39938	2330	42268	74207	56.96%	16.39%	53	53
14	臺中市沙鹿區	2018-11-25T06:18:49+08:00	12165	27773	39938	2330	42268	74207	56.96%	16.39%	53	53
14	臺中市沙鹿區	2018-11-24T22:23:03+08:00	6561	15319	21880	1241	23121	39866	58%	16.46%	31	53
14	臺中市沙鹿區	2018-11-24T22:29:56+08:00	7271	16853	24124	1348	25472	43773	58.19%	16.61%	34	53
14	臺中市沙鹿區	2018-11-24T23:19:40+08:00	10553	24187	34740	2012	36752	64490	56.99%	16.36%	47	53
14	臺中市沙鹿區	2018-11-24T22:36:53+08:00	7945	18297	26242	1483	27725	48041	57.71%	16.54%	37	53
14	臺中市沙鹿區	2018-11-24T23:08:26+08:00	10047	23102	33149	1834	34983	60938	57.41%	16.49%	45	53
14	臺中市沙鹿區	2018-11-24T23:27:11+08:00	11070	25419	36489	2137	38626	67774	56.99%	16.33%	49	53
14	臺中市沙鹿區	2018-11-25T03:32:26+08:00	12165	27773	39938	2330	42268	74207	56.96%	16.39%	53	53
14	臺中市沙鹿區	2018-11-25T03:49:43+08:00	12165	27773	39938	2330	42268	74207	56.96%	16.39%	53	53
14	臺中市沙鹿區	2018-11-25T06:29:08+08:00	12165	27773	39938	2330	42268	74207	56.96%	16.39%	53	53
14	臺中市沙鹿區	2018-11-25T00:22:55+08:00	12165	27773	39938	2330	42268	74207	56.96%	16.39%	53	53
14	臺中市沙鹿區	2018-11-25T06:13:44+08:00	12165	27773	39938	2330	42268	74207	56.96%	16.39%	53	53
14	臺中市沙鹿區	2018-11-25T00:18:21+08:00	12165	27773	39938	2330	42268	74207	56.96%	16.39%	53	53
14	臺中市沙鹿區	2018-11-25T06:23:52+08:00	12165	27773	39938	2330	42268	74207	56.96%	16.39%	53	53
14	臺中市沙鹿區	2018-11-24T23:43:09+08:00	12165	27773	39938	2330	42268	74207	56.96%	16.39%	53	53
14	臺中市沙鹿區	2018-11-24T22:33:29+08:00	7674	17736	25410	1438	26848	46413	57.85%	16.53%	36	53
14	臺北市士林區	2018-11-24T23:47:17+08:00	27579	44079	71658	4218	75876	131304	57.79%	21%	93	163
14	臺北市士林區	2018-11-24T22:26:28+08:00	12090	19069	31159	2020	33179	57852	57.35%	20.9%	44	163
14	臺北市士林區	2018-11-25T01:12:31+08:00	38842	61328	100170	5799	105969	183816	57.65%	21.13%	127	163
14	臺北市士林區	2018-11-25T01:07:16+08:00	38842	61328	100170	5799	105969	183816	57.65%	21.13%	127	163
14	臺北市士林區	2018-11-24T22:19:27+08:00	11770	18512	30282	1985	32267	56331	57.28%	20.89%	43	163
14	臺北市士林區	2018-11-24T22:13:16+08:00	11427	17944	29371	1933	31304	54672	57.26%	20.9%	42	163
14	臺北市士林區	2018-11-24T22:57:42+08:00	16781	26883	43664	2800	46464	81078	57.31%	20.7%	59	163
14	臺北市士林區	2018-11-25T00:57:26+08:00	37030	58622	95652	5592	101244	175815	57.59%	21.06%	122	163
14	臺北市士林區	2018-11-24T23:51:25+08:00	27877	44525	72402	4261	76663	132654	57.79%	21.01%	94	163
14	臺北市士林區	2018-11-24T22:29:54+08:00	12398	19528	31926	2073	33999	59271	57.36%	20.92%	45	163
14	臺北市士林區	2018-11-24T23:27:09+08:00	22509	36095	58604	3594	62198	107998	57.59%	20.84%	78	163
14	臺北市士林區	2018-11-24T22:44:59+08:00	14354	22688	37042	2437	39479	68854	57.34%	20.85%	51	163
14	臺北市士林區	2018-11-24T22:19:28+08:00	11770	18512	30282	1985	32267	56331	57.28%	20.89%	43	163
14	臺北市士林區	2018-11-24T22:23:01+08:00	12090	19069	31159	2020	33179	57852	57.35%	20.9%	44	163
14	臺北市士林區	2018-11-24T22:57:43+08:00	16781	26883	43664	2800	46464	81078	57.31%	20.7%	59	163
14	臺北市士林區	2018-11-24T23:51:24+08:00	27877	44525	72402	4261	76663	132654	57.79%	21.01%	94	163
14	臺北市士林區	2018-11-25T03:32:24+08:00	50658	80462	131120	7567	138687	241854	57.34%	20.95%	163	163
14	臺北市士林區	2018-11-25T03:38:46+08:00	50658	80462	131120	7567	138687	241854	57.34%	20.95%	163	163
14	臺北市士林區	2018-11-24T23:59:58+08:00	30142	48047	78189	4568	82757	143153	57.81%	21.06%	101	163
14	臺北市士林區	2018-11-25T01:25:42+08:00	41196	65036	106232	6151	112383	195258	57.56%	21.1%	134	163
14	臺北市士林區	2018-11-24T22:40:18+08:00	14029	22185	36214	2389	38603	67402	57.27%	20.81%	50	163
14	臺北市士林區	2018-11-25T03:32:25+08:00	50658	80462	131120	7567	138687	241854	57.34%	20.95%	163	163
14	臺北市士林區	2018-11-24T23:08:24+08:00	18978	30572	49550	3116	52666	91678	57.45%	20.7%	66	163
14	臺北市士林區	2018-11-24T23:15:53+08:00	20802	33328	54130	3407	57537	99688	57.72%	20.87%	72	163
14	臺北市士林區	2018-11-24T23:59:57+08:00	30142	48047	78189	4568	82757	143153	57.81%	21.06%	101	163
14	臺北市士林區	2018-11-24T22:40:19+08:00	14029	22185	36214	2389	38603	67402	57.27%	20.81%	50	163
14	臺北市士林區	2018-11-24T23:55:37+08:00	29748	47490	77238	4508	81746	141488	57.78%	21.03%	100	163
14	臺北市士林區	2018-11-25T00:13:59+08:00	31932	51002	82934	4891	87825	152269	57.68%	20.97%	107	163
14	臺北市士林區	2018-11-24T22:36:51+08:00	13345	21067	34412	2282	36694	64093	57.25%	20.82%	48	163
14	臺北市士林區	2018-11-25T06:29:05+08:00	50658	80462	131120	7567	138687	241854	57.34%	20.95%	163	163
14	臺北市士林區	2018-11-24T22:54:17+08:00	15572	24651	40223	2600	42823	74885	57.19%	20.79%	55	163
14	臺北市士林區	2018-11-25T06:23:50+08:00	50658	80462	131120	7567	138687	241854	57.34%	20.95%	163	163
14	臺北市士林區	2018-11-24T23:01:21+08:00	17865	28545	46410	2968	49378	86015	57.41%	20.77%	62	163
14	臺北市士林區	2018-11-24T23:12:04+08:00	19338	31097	50435	3142	53577	93316	57.41%	20.72%	67	163
14	臺北市士林區	2018-11-25T06:08:41+08:00	50658	80462	131120	7567	138687	241854	57.34%	20.95%	163	163
14	臺北市士林區	2018-11-25T00:09:22+08:00	31077	49614	80691	4740	85431	147789	57.81%	21.03%	104	163
14	臺北市士林區	2018-11-24T23:31:00+08:00	23158	37245	60403	3659	64062	111206	57.61%	20.82%	80	163
14	臺北市士林區	2018-11-24T23:39:03+08:00	24466	39410	63876	3877	67753	117407	57.71%	20.84%	84	163
14	臺北市士林區	2018-11-24T23:01:20+08:00	17865	28545	46410	2968	49378	86015	57.41%	20.77%	62	163
14	臺北市士林區	2018-11-24T22:50:36+08:00	14673	23281	37954	2494	40448	70522	57.36%	20.81%	52	163
14	臺北市士林區	2018-11-25T01:12:32+08:00	38842	61328	100170	5799	105969	183816	57.65%	21.13%	127	163
14	臺北市士林區	2018-11-24T22:41:26+08:00	14029	22185	36214	2389	38603	67402	57.27%	20.81%	50	163
14	臺北市士林區	2018-11-24T23:35:01+08:00	23779	38313	62092	3753	65845	114319	57.6%	20.8%	82	163
14	臺北市士林區	2018-11-24T23:04:54+08:00	18465	29498	47963	3058	51021	88788	57.46%	20.8%	64	163
14	臺北市士林區	2018-11-25T00:04:55+08:00	31077	49614	80691	4740	85431	147789	57.81%	21.03%	104	163
14	臺北市士林區	2018-11-25T03:44:11+08:00	50658	80462	131120	7567	138687	241854	57.34%	20.95%	163	163
14	臺北市士林區	2018-11-25T06:18:48+08:00	50658	80462	131120	7567	138687	241854	57.34%	20.95%	163	163
14	臺北市士林區	2018-11-24T22:23:02+08:00	12090	19069	31159	2020	33179	57852	57.35%	20.9%	44	163
14	臺北市士林區	2018-11-25T03:44:10+08:00	50658	80462	131120	7567	138687	241854	57.34%	20.95%	163	163
14	臺北市士林區	2018-11-25T01:17:40+08:00	39858	62908	102766	5947	108713	188497	57.67%	21.15%	130	163
14	臺北市士林區	2018-11-25T01:02:20+08:00	38128	60245	98373	5710	104083	180748	57.58%	21.09%	125	163
14	臺北市士林區	2018-11-24T23:19:38+08:00	21383	34267	55650	3475	59125	102394	57.74%	20.88%	74	163
14	臺北市士林區	2018-11-24T23:23:29+08:00	21891	35163	57054	3551	60605	105015	57.71%	20.85%	76	163
14	臺北市士林區	2018-11-24T22:36:52+08:00	13345	21067	34412	2282	36694	64093	57.25%	20.82%	48	163
14	臺北市士林區	2018-11-24T22:15:59+08:00	11770	18512	30282	1985	32267	56331	57.28%	20.89%	43	163
14	臺北市士林區	2018-11-24T23:19:39+08:00	21383	34267	55650	3475	59125	102394	57.74%	20.88%	74	163
14	臺北市士林區	2018-11-25T01:17:39+08:00	39858	62908	102766	5947	108713	188497	57.67%	21.15%	130	163
14	臺北市士林區	2018-11-25T06:29:06+08:00	50658	80462	131120	7567	138687	241854	57.34%	20.95%	163	163
14	臺北市士林區	2018-11-24T22:33:28+08:00	13057	20554	33611	2217	35828	62563	57.27%	20.87%	47	163
14	臺北市士林區	2018-11-25T06:13:43+08:00	50658	80462	131120	7567	138687	241854	57.34%	20.95%	163	163
14	臺北市士林區	2018-11-24T23:43:07+08:00	26159	41885	68044	4052	72096	124915	57.72%	20.94%	89	163
14	臺北市士林區	2018-11-25T00:22:53+08:00	32587	52059	84646	4972	89618	155286	57.71%	20.99%	109	163
14	臺北市士林區	2018-11-25T03:56:00+08:00	50658	80462	131120	7567	138687	241854	57.34%	20.95%	163	163
14	臺北市士林區	2018-11-24T22:33:27+08:00	13057	20554	33611	2217	35828	62563	57.27%	20.87%	47	163
14	臺北市士林區	2018-11-25T03:49:42+08:00	50658	80462	131120	7567	138687	241854	57.34%	20.95%	163	163
14	臺北市士林區	2018-11-25T00:18:20+08:00	32587	52059	84646	4972	89618	155286	57.71%	20.99%	109	163
14	臺北市士林區	2018-11-25T04:02:38+08:00	50658	80462	131120	7567	138687	241854	57.34%	20.95%	163	163
14	臺北市松山區	2018-11-24T23:47:17+08:00	22920	37276	60196	2746	62942	105750	59.52%	21.67%	75	117
14	臺北市松山區	2018-11-24T22:50:35+08:00	14802	24008	38810	1764	40574	67787	59.86%	21.84%	49	117
14	臺北市松山區	2018-11-25T01:12:31+08:00	32993	53234	86227	3938	90165	151882	59.37%	21.72%	106	117
14	臺北市松山區	2018-11-24T22:26:27+08:00	11672	18573	30245	1366	31611	52982	59.66%	22.03%	38	117
14	臺北市松山區	2018-11-24T22:19:27+08:00	9400	15047	24447	1084	25531	42883	59.54%	21.92%	31	117
14	臺北市松山區	2018-11-24T22:57:42+08:00	16704	27043	43747	1977	45724	76905	59.46%	21.72%	55	117
14	臺北市松山區	2018-11-25T00:57:26+08:00	30244	49288	79532	3637	83169	140165	59.34%	21.58%	98	117
14	臺北市松山區	2018-11-24T22:29:54+08:00	12462	20096	32558	1482	34040	57019	59.7%	21.86%	41	117
14	臺北市松山區	2018-11-24T23:27:09+08:00	20554	33227	53781	2426	56207	94545	59.45%	21.74%	67	117
14	臺北市松山區	2018-11-24T22:44:59+08:00	13636	22085	35721	1628	37349	62504	59.75%	21.82%	45	117
14	臺北市松山區	2018-11-24T22:23:01+08:00	10394	16618	27012	1215	28227	47354	59.61%	21.95%	34	117
14	臺北市松山區	2018-11-25T03:55:59+08:00	36698	59358	96056	4370	100426	169278	59.33%	21.68%	117	117
14	臺北市松山區	2018-11-24T23:51:24+08:00	22920	37276	60196	2746	62942	105750	59.52%	21.67%	75	117
14	臺北市松山區	2018-11-24T23:15:52+08:00	18901	30624	49525	2244	51769	87084	59.45%	21.7%	62	117
14	臺北市松山區	2018-11-25T03:32:24+08:00	36698	59358	96056	4370	100426	169278	59.33%	21.68%	117	117
14	臺北市松山區	2018-11-25T01:25:42+08:00	32993	53234	86227	3938	90165	151882	59.37%	21.72%	106	117
14	臺北市松山區	2018-11-24T23:55:36+08:00	22920	37276	60196	2746	62942	105750	59.52%	21.67%	75	117
14	臺北市松山區	2018-11-25T00:13:58+08:00	25332	41397	66729	3005	69734	117339	59.43%	21.59%	83	117
14	臺北市松山區	2018-11-24T22:40:18+08:00	13371	21594	34965	1586	36551	61228	59.7%	21.84%	44	117
14	臺北市松山區	2018-11-24T23:08:24+08:00	18020	29153	47173	2128	49301	83057	59.36%	21.7%	59	117
14	臺北市松山區	2018-11-24T23:59:57+08:00	23527	38299	61826	2825	64651	108587	59.54%	21.67%	77	117
14	臺北市松山區	2018-11-24T22:36:51+08:00	13371	21594	34965	1586	36551	61228	59.7%	21.84%	44	117
14	臺北市松山區	2018-11-24T22:54:16+08:00	15076	24575	39651	1801	41452	69277	59.84%	21.76%	50	117
14	臺北市松山區	2018-11-25T06:29:05+08:00	36698	59358	96056	4370	100426	169278	59.33%	21.68%	117	117
14	臺北市松山區	2018-11-25T06:23:50+08:00	36698	59358	96056	4370	100426	169278	59.33%	21.68%	117	117
14	臺北市松山區	2018-11-25T03:49:41+08:00	36698	59358	96056	4370	100426	169278	59.33%	21.68%	117	117
14	臺北市松山區	2018-11-24T23:39:02+08:00	21643	35285	56928	2558	59486	100153	59.4%	21.61%	71	117
14	臺北市松山區	2018-11-24T23:12:04+08:00	18332	29701	48033	2154	50187	84520	59.38%	21.69%	60	117
14	臺北市松山區	2018-11-25T06:08:40+08:00	36698	59358	96056	4370	100426	169278	59.33%	21.68%	117	117
14	臺北市松山區	2018-11-25T00:09:22+08:00	24403	39839	64242	2914	67156	112986	59.44%	21.6%	80	117
14	臺北市松山區	2018-11-25T01:07:15+08:00	32083	51582	83665	3826	87491	147365	59.37%	21.77%	103	117
14	臺北市松山區	2018-11-24T23:01:20+08:00	17034	27503	44537	2017	46554	78408	59.37%	21.72%	56	117
14	臺北市松山區	2018-11-24T22:41:26+08:00	13371	21594	34965	1586	36551	61228	59.7%	21.84%	44	117
14	臺北市松山區	2018-11-24T23:35:01+08:00	21110	34339	55449	2466	57915	97507	59.4%	21.65%	69	117
14	臺北市松山區	2018-11-24T23:04:54+08:00	17376	28131	45507	2055	47562	80134	59.35%	21.68%	57	117
14	臺北市松山區	2018-11-25T06:18:47+08:00	36698	59358	96056	4370	100426	169278	59.33%	21.68%	117	117
14	臺北市松山區	2018-11-25T00:04:55+08:00	24403	39839	64242	2914	67156	112986	59.44%	21.6%	80	117
14	臺北市松山區	2018-11-24T22:13:15+08:00	7684	12097	19781	862	20643	34667	59.55%	22.17%	25	117
14	臺北市松山區	2018-11-25T03:44:10+08:00	36698	59358	96056	4370	100426	169278	59.33%	21.68%	117	117
14	臺北市松山區	2018-11-25T01:02:20+08:00	31509	50667	82176	3760	85936	144854	59.33%	21.75%	101	117
14	臺北市松山區	2018-11-25T03:38:45+08:00	36698	59358	96056	4370	100426	169278	59.33%	21.68%	117	117
14	臺北市松山區	2018-11-24T23:19:38+08:00	19282	31155	50437	2303	52740	88784	59.4%	21.72%	63	117
14	臺北市松山區	2018-11-24T23:23:29+08:00	19627	31631	51258	2333	53591	90236	59.39%	21.75%	64	117
14	臺北市松山區	2018-11-24T23:30:59+08:00	20909	33809	54718	2453	57171	96199	59.43%	21.74%	68	117
14	臺北市松山區	2018-11-24T22:15:59+08:00	8179	13033	21212	904	22116	37142	59.54%	22.02%	27	117
14	臺北市松山區	2018-11-25T01:17:39+08:00	32993	53234	86227	3938	90165	151882	59.37%	21.72%	106	117
14	臺北市松山區	2018-11-24T23:43:07+08:00	22638	36849	59487	2707	62194	104536	59.5%	21.66%	74	117
14	臺北市松山區	2018-11-25T00:18:19+08:00	26399	43095	69494	3129	72623	122625	59.22%	21.53%	86	117
14	臺北市松山區	2018-11-25T00:22:53+08:00	28146	45793	73939	3382	77321	130566	59.22%	21.56%	91	117
14	臺北市松山區	2018-11-24T22:33:27+08:00	13072	21037	34109	1555	35664	59732	59.71%	21.88%	43	117
14	臺北市松山區	2018-11-25T06:13:42+08:00	36698	59358	96056	4370	100426	169278	59.33%	21.68%	117	117
14	臺北市松山區	2018-11-25T04:02:38+08:00	36698	59358	96056	4370	100426	169278	59.33%	21.68%	117	117
14	屏東縣里港鄉	2018-11-25T03:56:10+08:00	3647	7278	10925	1225	12150	22128	54.91%	16.48%	20	20
14	屏東縣里港鄉	2018-11-24T23:16:01+08:00	3438	6844	10282	1185	11467	20594	55.68%	16.69%	19	20
14	屏東縣里港鄉	2018-11-24T23:43:16+08:00	3647	7278	10925	1225	12150	22128	54.91%	16.48%	20	20
14	屏東縣里港鄉	2018-11-24T22:33:36+08:00	2921	5755	8676	1020	9696	17464	55.52%	16.73%	17	20
14	屏東縣里港鄉	2018-11-24T23:47:27+08:00	3647	7278	10925	1225	12150	22128	54.91%	16.48%	20	20
14	屏東縣里港鄉	2018-11-24T22:16:09+08:00	2921	5755	8676	1020	9696	17464	55.52%	16.73%	17	20
14	屏東縣里港鄉	2018-11-25T03:38:54+08:00	3647	7278	10925	1225	12150	22128	54.91%	16.48%	20	20
14	屏東縣里港鄉	2018-11-25T01:25:51+08:00	3647	7278	10925	1225	12150	22128	54.91%	16.48%	20	20
14	屏東縣里港鄉	2018-11-24T23:23:37+08:00	3438	6844	10282	1185	11467	20594	55.68%	16.69%	19	20
14	屏東縣里港鄉	2018-11-25T06:18:56+08:00	3647	7278	10925	1225	12150	22128	54.91%	16.48%	20	20
14	屏東縣里港鄉	2018-11-24T22:30:06+08:00	2921	5755	8676	1020	9696	17464	55.52%	16.73%	17	20
14	屏東縣里港鄉	2018-11-24T22:19:35+08:00	2921	5755	8676	1020	9696	17464	55.52%	16.73%	17	20
14	屏東縣里港鄉	2018-11-25T01:17:50+08:00	3647	7278	10925	1225	12150	22128	54.91%	16.48%	20	20
14	屏東縣里港鄉	2018-11-24T22:36:59+08:00	2921	5755	8676	1020	9696	17464	55.52%	16.73%	17	20
14	屏東縣里港鄉	2018-11-24T22:40:26+08:00	2921	5755	8676	1020	9696	17464	55.52%	16.73%	17	20
14	屏東縣里港鄉	2018-11-25T00:57:35+08:00	3647	7278	10925	1225	12150	22128	54.91%	16.48%	20	20
14	屏東縣里港鄉	2018-11-25T00:09:32+08:00	3647	7278	10925	1225	12150	22128	54.91%	16.48%	20	20
14	屏東縣里港鄉	2018-11-24T23:31:10+08:00	3647	7278	10925	1225	12150	22128	54.91%	16.48%	20	20
14	屏東縣里港鄉	2018-11-24T23:39:14+08:00	3647	7278	10925	1225	12150	22128	54.91%	16.48%	20	20
14	屏東縣里港鄉	2018-11-25T04:02:51+08:00	3647	7278	10925	1225	12150	22128	54.91%	16.48%	20	20
14	屏東縣里港鄉	2018-11-24T22:26:35+08:00	2921	5755	8676	1020	9696	17464	55.52%	16.73%	17	20
14	屏東縣里港鄉	2018-11-24T23:12:14+08:00	3438	6844	10282	1185	11467	20594	55.68%	16.69%	19	20
14	屏東縣里港鄉	2018-11-25T06:23:59+08:00	3647	7278	10925	1225	12150	22128	54.91%	16.48%	20	20
14	屏東縣里港鄉	2018-11-24T22:45:07+08:00	2921	5755	8676	1020	9696	17464	55.52%	16.73%	17	20
14	屏東縣里港鄉	2018-11-25T06:08:51+08:00	3647	7278	10925	1225	12150	22128	54.91%	16.48%	20	20
14	屏東縣里港鄉	2018-11-25T01:07:25+08:00	3647	7278	10925	1225	12150	22128	54.91%	16.48%	20	20
14	屏東縣里港鄉	2018-11-25T06:13:51+08:00	3647	7278	10925	1225	12150	22128	54.91%	16.48%	20	20
14	屏東縣里港鄉	2018-11-24T23:35:09+08:00	3647	7278	10925	1225	12150	22128	54.91%	16.48%	20	20
14	屏東縣里港鄉	2018-11-24T23:01:29+08:00	3438	6844	10282	1185	11467	20594	55.68%	16.69%	19	20
14	屏東縣里港鄉	2018-11-25T03:49:50+08:00	3647	7278	10925	1225	12150	22128	54.91%	16.48%	20	20
14	屏東縣里港鄉	2018-11-25T00:14:08+08:00	3647	7278	10925	1225	12150	22128	54.91%	16.48%	20	20
14	屏東縣里港鄉	2018-11-25T06:29:15+08:00	3647	7278	10925	1225	12150	22128	54.91%	16.48%	20	20
14	屏東縣里港鄉	2018-11-24T23:55:45+08:00	3647	7278	10925	1225	12150	22128	54.91%	16.48%	20	20
14	屏東縣里港鄉	2018-11-24T23:08:34+08:00	3438	6844	10282	1185	11467	20594	55.68%	16.69%	19	20
14	屏東縣里港鄉	2018-11-25T00:00:09+08:00	3647	7278	10925	1225	12150	22128	54.91%	16.48%	20	20
14	屏東縣里港鄉	2018-11-25T00:23:02+08:00	3647	7278	10925	1225	12150	22128	54.91%	16.48%	20	20
14	屏東縣里港鄉	2018-11-25T03:32:33+08:00	3647	7278	10925	1225	12150	22128	54.91%	16.48%	20	20
14	屏東縣里港鄉	2018-11-25T03:44:21+08:00	3647	7278	10925	1225	12150	22128	54.91%	16.48%	20	20
14	屏東縣里港鄉	2018-11-24T22:13:25+08:00	2921	5755	8676	1020	9696	17464	55.52%	16.73%	17	20
14	屏東縣里港鄉	2018-11-24T23:19:49+08:00	3438	6844	10282	1185	11467	20594	55.68%	16.69%	19	20
14	屏東縣里港鄉	2018-11-24T22:23:11+08:00	2921	5755	8676	1020	9696	17464	55.52%	16.73%	17	20
14	屏東縣里港鄉	2018-11-24T23:27:17+08:00	3647	7278	10925	1225	12150	22128	54.91%	16.48%	20	20
14	屏東縣里港鄉	2018-11-25T01:02:29+08:00	3647	7278	10925	1225	12150	22128	54.91%	16.48%	20	20
14	屏東縣里港鄉	2018-11-24T23:51:33+08:00	3647	7278	10925	1225	12150	22128	54.91%	16.48%	20	20
14	屏東縣里港鄉	2018-11-24T22:57:52+08:00	3438	6844	10282	1185	11467	20594	55.68%	16.69%	19	20
14	屏東縣里港鄉	2018-11-24T23:05:03+08:00	3438	6844	10282	1185	11467	20594	55.68%	16.69%	19	20
14	屏東縣里港鄉	2018-11-24T22:54:24+08:00	2921	5755	8676	1020	9696	17464	55.52%	16.73%	17	20
14	屏東縣里港鄉	2018-11-25T00:18:28+08:00	3647	7278	10925	1225	12150	22128	54.91%	16.48%	20	20
14	屏東縣里港鄉	2018-11-24T22:41:33+08:00	2921	5755	8676	1020	9696	17464	55.52%	16.73%	17	20
14	屏東縣里港鄉	2018-11-25T00:05:03+08:00	3647	7278	10925	1225	12150	22128	54.91%	16.48%	20	20
14	屏東縣里港鄉	2018-11-25T01:12:42+08:00	3647	7278	10925	1225	12150	22128	54.91%	16.48%	20	20
14	屏東縣里港鄉	2018-11-24T22:50:46+08:00	2921	5755	8676	1020	9696	17464	55.52%	16.73%	17	20
14	屏東縣林邊鄉	2018-11-24T22:33:37+08:00	1970	4647	6617	721	7338	13230	55.46%	14.89%	14	16
14	屏東縣林邊鄉	2018-11-24T23:43:16+08:00	2351	5531	7882	860	8742	15691	55.71%	14.98%	16	16
14	屏東縣林邊鄉	2018-11-25T03:56:11+08:00	2351	5531	7882	860	8742	15691	55.71%	14.98%	16	16
14	屏東縣林邊鄉	2018-11-25T06:29:16+08:00	2351	5531	7882	860	8742	15691	55.71%	14.98%	16	16
14	屏東縣林邊鄉	2018-11-24T23:47:27+08:00	2351	5531	7882	860	8742	15691	55.71%	14.98%	16	16
14	屏東縣林邊鄉	2018-11-24T22:16:09+08:00	1777	3925	5702	641	6343	11383	55.72%	15.61%	12	16
14	屏東縣林邊鄉	2018-11-25T03:38:54+08:00	2351	5531	7882	860	8742	15691	55.71%	14.98%	16	16
14	屏東縣林邊鄉	2018-11-24T23:55:46+08:00	2351	5531	7882	860	8742	15691	55.71%	14.98%	16	16
14	屏東縣林邊鄉	2018-11-25T03:44:22+08:00	2351	5531	7882	860	8742	15691	55.71%	14.98%	16	16
14	屏東縣林邊鄉	2018-11-24T22:13:26+08:00	1777	3925	5702	641	6343	11383	55.72%	15.61%	12	16
14	屏東縣林邊鄉	2018-11-25T01:25:51+08:00	2351	5531	7882	860	8742	15691	55.71%	14.98%	16	16
14	屏東縣林邊鄉	2018-11-24T23:23:37+08:00	2351	5531	7882	860	8742	15691	55.71%	14.98%	16	16
14	屏東縣林邊鄉	2018-11-25T06:18:56+08:00	2351	5531	7882	860	8742	15691	55.71%	14.98%	16	16
14	屏東縣林邊鄉	2018-11-24T22:23:12+08:00	1812	4385	6197	680	6877	12505	54.99%	14.49%	13	16
14	屏東縣林邊鄉	2018-11-24T22:40:27+08:00	2194	5194	7388	815	8203	14688	55.85%	14.94%	15	16
14	屏東縣林邊鄉	2018-11-24T22:36:59+08:00	2194	5194	7388	815	8203	14688	55.85%	14.94%	15	16
14	屏東縣林邊鄉	2018-11-25T00:00:10+08:00	2351	5531	7882	860	8742	15691	55.71%	14.98%	16	16
14	屏東縣林邊鄉	2018-11-25T01:17:51+08:00	2351	5531	7882	860	8742	15691	55.71%	14.98%	16	16
14	屏東縣林邊鄉	2018-11-24T22:30:07+08:00	1812	4385	6197	680	6877	12505	54.99%	14.49%	13	16
14	屏東縣林邊鄉	2018-11-24T23:31:10+08:00	2351	5531	7882	860	8742	15691	55.71%	14.98%	16	16
14	屏東縣林邊鄉	2018-11-24T23:39:14+08:00	2351	5531	7882	860	8742	15691	55.71%	14.98%	16	16
14	屏東縣林邊鄉	2018-11-24T23:01:30+08:00	2351	5531	7882	860	8742	15691	55.71%	14.98%	16	16
14	屏東縣林邊鄉	2018-11-25T04:02:51+08:00	2351	5531	7882	860	8742	15691	55.71%	14.98%	16	16
14	屏東縣林邊鄉	2018-11-24T23:12:14+08:00	2351	5531	7882	860	8742	15691	55.71%	14.98%	16	16
14	屏東縣林邊鄉	2018-11-25T06:23:59+08:00	2351	5531	7882	860	8742	15691	55.71%	14.98%	16	16
14	屏東縣林邊鄉	2018-11-25T00:09:33+08:00	2351	5531	7882	860	8742	15691	55.71%	14.98%	16	16
14	屏東縣林邊鄉	2018-11-24T22:45:07+08:00	2351	5531	7882	860	8742	15691	55.71%	14.98%	16	16
14	屏東縣林邊鄉	2018-11-25T06:08:51+08:00	2351	5531	7882	860	8742	15691	55.71%	14.98%	16	16
14	屏東縣林邊鄉	2018-11-25T01:07:25+08:00	2351	5531	7882	860	8742	15691	55.71%	14.98%	16	16
14	屏東縣林邊鄉	2018-11-25T06:13:51+08:00	2351	5531	7882	860	8742	15691	55.71%	14.98%	16	16
14	屏東縣林邊鄉	2018-11-24T23:16:02+08:00	2351	5531	7882	860	8742	15691	55.71%	14.98%	16	16
14	屏東縣林邊鄉	2018-11-24T23:35:09+08:00	2351	5531	7882	860	8742	15691	55.71%	14.98%	16	16
14	屏東縣林邊鄉	2018-11-25T03:49:50+08:00	2351	5531	7882	860	8742	15691	55.71%	14.98%	16	16
14	屏東縣林邊鄉	2018-11-25T00:14:08+08:00	2351	5531	7882	860	8742	15691	55.71%	14.98%	16	16
14	屏東縣林邊鄉	2018-11-25T00:23:02+08:00	2351	5531	7882	860	8742	15691	55.71%	14.98%	16	16
14	屏東縣林邊鄉	2018-11-24T23:08:35+08:00	2351	5531	7882	860	8742	15691	55.71%	14.98%	16	16
14	屏東縣林邊鄉	2018-11-25T03:32:33+08:00	2351	5531	7882	860	8742	15691	55.71%	14.98%	16	16
14	屏東縣林邊鄉	2018-11-24T23:19:49+08:00	2351	5531	7882	860	8742	15691	55.71%	14.98%	16	16
14	屏東縣林邊鄉	2018-11-24T23:27:17+08:00	2351	5531	7882	860	8742	15691	55.71%	14.98%	16	16
14	屏東縣林邊鄉	2018-11-24T22:19:36+08:00	1812	4385	6197	680	6877	12505	54.99%	14.49%	13	16
14	屏東縣林邊鄉	2018-11-25T01:02:29+08:00	2351	5531	7882	860	8742	15691	55.71%	14.98%	16	16
14	屏東縣林邊鄉	2018-11-24T23:51:34+08:00	2351	5531	7882	860	8742	15691	55.71%	14.98%	16	16
14	屏東縣林邊鄉	2018-11-24T22:57:52+08:00	2351	5531	7882	860	8742	15691	55.71%	14.98%	16	16
14	屏東縣林邊鄉	2018-11-25T00:57:36+08:00	2351	5531	7882	860	8742	15691	55.71%	14.98%	16	16
14	屏東縣林邊鄉	2018-11-24T23:05:03+08:00	2351	5531	7882	860	8742	15691	55.71%	14.98%	16	16
14	屏東縣林邊鄉	2018-11-24T22:50:47+08:00	2351	5531	7882	860	8742	15691	55.71%	14.98%	16	16
14	屏東縣林邊鄉	2018-11-25T00:05:04+08:00	2351	5531	7882	860	8742	15691	55.71%	14.98%	16	16
14	屏東縣林邊鄉	2018-11-24T22:41:34+08:00	2194	5194	7388	815	8203	14688	55.85%	14.94%	15	16
14	屏東縣林邊鄉	2018-11-25T01:12:42+08:00	2351	5531	7882	860	8742	15691	55.71%	14.98%	16	16
14	屏東縣林邊鄉	2018-11-24T22:26:36+08:00	1812	4385	6197	680	6877	12505	54.99%	14.49%	13	16
14	屏東縣林邊鄉	2018-11-25T00:18:29+08:00	2351	5531	7882	860	8742	15691	55.71%	14.98%	16	16
14	屏東縣林邊鄉	2018-11-24T22:54:25+08:00	2351	5531	7882	860	8742	15691	55.71%	14.98%	16	16
14	高雄市永安區	2018-11-25T04:02:43+08:00	2115	4960	7075	501	7576	12001	63.13%	17.62%	12	12
14	高雄市永安區	2018-11-25T01:12:37+08:00	2115	4960	7075	501	7576	12001	63.13%	17.62%	12	12
14	高雄市永安區	2018-11-25T00:14:03+08:00	2115	4960	7075	501	7576	12001	63.13%	17.62%	12	12
14	高雄市永安區	2018-11-24T23:01:25+08:00	1490	3614	5104	395	5499	8692	63.27%	17.14%	10	12
14	高雄市永安區	2018-11-25T00:09:27+08:00	2115	4960	7075	501	7576	12001	63.13%	17.62%	12	12
14	高雄市永安區	2018-11-24T23:35:05+08:00	1849	4383	6232	459	6691	10583	63.22%	17.47%	11	12
14	高雄市永安區	2018-11-25T06:29:11+08:00	2115	4960	7075	501	7576	12001	63.13%	17.62%	12	12
14	高雄市永安區	2018-11-24T23:39:09+08:00	1849	4383	6232	459	6691	10583	63.22%	17.47%	11	12
14	高雄市永安區	2018-11-25T01:07:20+08:00	2115	4960	7075	501	7576	12001	63.13%	17.62%	12	12
14	高雄市永安區	2018-11-24T23:31:04+08:00	1849	4383	6232	459	6691	10583	63.22%	17.47%	11	12
14	高雄市永安區	2018-11-25T01:17:45+08:00	2115	4960	7075	501	7576	12001	63.13%	17.62%	12	12
14	高雄市永安區	2018-11-24T23:55:41+08:00	2115	4960	7075	501	7576	12001	63.13%	17.62%	12	12
14	高雄市永安區	2018-11-24T23:08:30+08:00	1490	3614	5104	395	5499	8692	63.27%	17.14%	10	12
14	高雄市永安區	2018-11-24T23:19:44+08:00	1849	4383	6232	459	6691	10583	63.22%	17.47%	11	12
14	高雄市永安區	2018-11-24T22:23:06+08:00	1490	3614	5104	395	5499	8692	63.27%	17.14%	10	12
14	高雄市永安區	2018-11-24T22:13:21+08:00	1236	2991	4227	319	4546	7215	63.01%	17.13%	9	12
14	高雄市永安區	2018-11-24T23:04:58+08:00	1490	3614	5104	395	5499	8692	63.27%	17.14%	10	12
14	高雄市永安區	2018-11-25T00:00:02+08:00	2115	4960	7075	501	7576	12001	63.13%	17.62%	12	12
14	高雄市永安區	2018-11-25T00:04:59+08:00	2115	4960	7075	501	7576	12001	63.13%	17.62%	12	12
14	高雄市永安區	2018-11-24T23:27:13+08:00	1849	4383	6232	459	6691	10583	63.22%	17.47%	11	12
14	高雄市永安區	2018-11-24T22:30:00+08:00	1490	3614	5104	395	5499	8692	63.27%	17.14%	10	12
14	高雄市永安區	2018-11-25T01:02:25+08:00	2115	4960	7075	501	7576	12001	63.13%	17.62%	12	12
14	高雄市永安區	2018-11-25T06:13:47+08:00	2115	4960	7075	501	7576	12001	63.13%	17.62%	12	12
14	高雄市永安區	2018-11-24T22:54:20+08:00	1490	3614	5104	395	5499	8692	63.27%	17.14%	10	12
14	高雄市永安區	2018-11-25T00:22:58+08:00	2115	4960	7075	501	7576	12001	63.13%	17.62%	12	12
14	高雄市永安區	2018-11-25T03:56:05+08:00	2115	4960	7075	501	7576	12001	63.13%	17.62%	12	12
14	高雄市永安區	2018-11-24T22:26:32+08:00	1490	3614	5104	395	5499	8692	63.27%	17.14%	10	12
14	高雄市永安區	2018-11-25T00:18:24+08:00	2115	4960	7075	501	7576	12001	63.13%	17.62%	12	12
14	高雄市永安區	2018-11-24T22:41:30+08:00	1490	3614	5104	395	5499	8692	63.27%	17.14%	10	12
14	高雄市永安區	2018-11-25T03:49:46+08:00	2115	4960	7075	501	7576	12001	63.13%	17.62%	12	12
14	高雄市永安區	2018-11-25T06:08:46+08:00	2115	4960	7075	501	7576	12001	63.13%	17.62%	12	12
14	高雄市永安區	2018-11-24T23:43:12+08:00	1849	4383	6232	459	6691	10583	63.22%	17.47%	11	12
14	高雄市永安區	2018-11-24T23:47:22+08:00	1849	4383	6232	459	6691	10583	63.22%	17.47%	11	12
14	高雄市永安區	2018-11-24T22:16:04+08:00	1236	2991	4227	319	4546	7215	63.01%	17.13%	9	12
14	高雄市永安區	2018-11-24T22:33:32+08:00	1490	3614	5104	395	5499	8692	63.27%	17.14%	10	12
14	高雄市永安區	2018-11-25T03:44:16+08:00	2115	4960	7075	501	7576	12001	63.13%	17.62%	12	12
14	高雄市永安區	2018-11-25T03:38:50+08:00	2115	4960	7075	501	7576	12001	63.13%	17.62%	12	12
14	高雄市永安區	2018-11-24T23:23:33+08:00	1849	4383	6232	459	6691	10583	63.22%	17.47%	11	12
14	高雄市永安區	2018-11-24T23:51:29+08:00	1849	4383	6232	459	6691	10583	63.22%	17.47%	11	12
14	高雄市永安區	2018-11-24T22:57:47+08:00	1490	3614	5104	395	5499	8692	63.27%	17.14%	10	12
14	高雄市永安區	2018-11-24T22:19:31+08:00	1490	3614	5104	395	5499	8692	63.27%	17.14%	10	12
14	高雄市永安區	2018-11-24T22:40:23+08:00	1490	3614	5104	395	5499	8692	63.27%	17.14%	10	12
14	高雄市永安區	2018-11-25T03:32:29+08:00	2115	4960	7075	501	7576	12001	63.13%	17.62%	12	12
14	高雄市永安區	2018-11-25T06:18:52+08:00	2115	4960	7075	501	7576	12001	63.13%	17.62%	12	12
14	高雄市永安區	2018-11-25T00:57:31+08:00	2115	4960	7075	501	7576	12001	63.13%	17.62%	12	12
14	高雄市永安區	2018-11-25T01:25:47+08:00	2115	4960	7075	501	7576	12001	63.13%	17.62%	12	12
14	高雄市永安區	2018-11-24T22:36:55+08:00	1490	3614	5104	395	5499	8692	63.27%	17.14%	10	12
14	高雄市永安區	2018-11-24T23:15:57+08:00	1849	4383	6232	459	6691	10583	63.22%	17.47%	11	12
14	高雄市永安區	2018-11-25T06:23:55+08:00	2115	4960	7075	501	7576	12001	63.13%	17.62%	12	12
14	高雄市永安區	2018-11-24T23:12:10+08:00	1490	3614	5104	395	5499	8692	63.27%	17.14%	10	12
14	高雄市永安區	2018-11-24T22:50:41+08:00	1490	3614	5104	395	5499	8692	63.27%	17.14%	10	12
14	高雄市永安區	2018-11-24T22:45:03+08:00	1490	3614	5104	395	5499	8692	63.27%	17.14%	10	12
14	高雄市桃源區	2018-11-25T04:02:43+08:00	395	1376	1771	75	1846	3498	52.77%	11.29%	8	8
14	高雄市桃源區	2018-11-25T01:12:37+08:00	395	1376	1771	75	1846	3498	52.77%	11.29%	8	8
14	高雄市桃源區	2018-11-25T00:14:04+08:00	395	1376	1771	75	1846	3498	52.77%	11.29%	8	8
14	高雄市桃源區	2018-11-24T23:31:05+08:00	395	1376	1771	75	1846	3498	52.77%	11.29%	8	8
14	高雄市桃源區	2018-11-25T01:07:21+08:00	395	1376	1771	75	1846	3498	52.77%	11.29%	8	8
14	高雄市桃源區	2018-11-24T23:35:05+08:00	395	1376	1771	75	1846	3498	52.77%	11.29%	8	8
14	高雄市桃源區	2018-11-25T06:29:11+08:00	395	1376	1771	75	1846	3498	52.77%	11.29%	8	8
14	高雄市桃源區	2018-11-24T23:39:09+08:00	395	1376	1771	75	1846	3498	52.77%	11.29%	8	8
14	高雄市桃源區	2018-11-25T00:09:28+08:00	395	1376	1771	75	1846	3498	52.77%	11.29%	8	8
14	高雄市桃源區	2018-11-25T01:17:45+08:00	395	1376	1771	75	1846	3498	52.77%	11.29%	8	8
14	高雄市桃源區	2018-11-24T22:23:07+08:00	289	1181	1470	66	1536	2602	59.03%	11.11%	6	8
14	高雄市桃源區	2018-11-24T23:08:30+08:00	395	1376	1771	75	1846	3498	52.77%	11.29%	8	8
14	高雄市桃源區	2018-11-24T23:04:59+08:00	395	1376	1771	75	1846	3498	52.77%	11.29%	8	8
14	高雄市桃源區	2018-11-24T23:19:44+08:00	395	1376	1771	75	1846	3498	52.77%	11.29%	8	8
14	高雄市桃源區	2018-11-24T22:13:21+08:00	207	890	1097	58	1155	1819	63.5%	11.38%	5	8
14	高雄市桃源區	2018-11-25T00:00:02+08:00	395	1376	1771	75	1846	3498	52.77%	11.29%	8	8
14	高雄市桃源區	2018-11-24T23:27:13+08:00	395	1376	1771	75	1846	3498	52.77%	11.29%	8	8
14	高雄市桃源區	2018-11-24T22:19:32+08:00	289	1181	1470	66	1536	2602	59.03%	11.11%	6	8
14	高雄市桃源區	2018-11-24T22:30:00+08:00	395	1376	1771	75	1846	3498	52.77%	11.29%	8	8
14	高雄市桃源區	2018-11-25T01:02:25+08:00	395	1376	1771	75	1846	3498	52.77%	11.29%	8	8
14	高雄市桃源區	2018-11-25T06:13:47+08:00	395	1376	1771	75	1846	3498	52.77%	11.29%	8	8
14	高雄市桃源區	2018-11-25T00:22:58+08:00	395	1376	1771	75	1846	3498	52.77%	11.29%	8	8
14	高雄市桃源區	2018-11-24T22:26:32+08:00	329	1253	1582	68	1650	2866	57.57%	11.48%	7	8
14	高雄市桃源區	2018-11-25T00:18:24+08:00	395	1376	1771	75	1846	3498	52.77%	11.29%	8	8
14	高雄市桃源區	2018-11-24T22:50:42+08:00	395	1376	1771	75	1846	3498	52.77%	11.29%	8	8
14	高雄市桃源區	2018-11-24T22:54:21+08:00	395	1376	1771	75	1846	3498	52.77%	11.29%	8	8
14	高雄市桃源區	2018-11-25T00:05:00+08:00	395	1376	1771	75	1846	3498	52.77%	11.29%	8	8
14	高雄市桃源區	2018-11-24T22:41:30+08:00	395	1376	1771	75	1846	3498	52.77%	11.29%	8	8
14	高雄市桃源區	2018-11-25T03:49:46+08:00	395	1376	1771	75	1846	3498	52.77%	11.29%	8	8
14	高雄市桃源區	2018-11-24T23:01:26+08:00	395	1376	1771	75	1846	3498	52.77%	11.29%	8	8
14	高雄市桃源區	2018-11-25T06:08:46+08:00	395	1376	1771	75	1846	3498	52.77%	11.29%	8	8
14	高雄市桃源區	2018-11-24T23:43:12+08:00	395	1376	1771	75	1846	3498	52.77%	11.29%	8	8
14	高雄市桃源區	2018-11-24T22:16:04+08:00	207	890	1097	58	1155	1819	63.5%	11.38%	5	8
14	高雄市桃源區	2018-11-24T22:33:32+08:00	395	1376	1771	75	1846	3498	52.77%	11.29%	8	8
14	高雄市桃源區	2018-11-24T23:47:23+08:00	395	1376	1771	75	1846	3498	52.77%	11.29%	8	8
14	高雄市桃源區	2018-11-24T23:55:42+08:00	395	1376	1771	75	1846	3498	52.77%	11.29%	8	8
14	高雄市桃源區	2018-11-25T03:44:16+08:00	395	1376	1771	75	1846	3498	52.77%	11.29%	8	8
14	高雄市桃源區	2018-11-25T03:38:50+08:00	395	1376	1771	75	1846	3498	52.77%	11.29%	8	8
14	高雄市桃源區	2018-11-24T23:23:33+08:00	395	1376	1771	75	1846	3498	52.77%	11.29%	8	8
14	高雄市桃源區	2018-11-24T23:51:29+08:00	395	1376	1771	75	1846	3498	52.77%	11.29%	8	8
14	高雄市桃源區	2018-11-24T22:57:47+08:00	395	1376	1771	75	1846	3498	52.77%	11.29%	8	8
14	高雄市桃源區	2018-11-24T22:40:23+08:00	395	1376	1771	75	1846	3498	52.77%	11.29%	8	8
14	高雄市桃源區	2018-11-25T03:32:29+08:00	395	1376	1771	75	1846	3498	52.77%	11.29%	8	8
14	高雄市桃源區	2018-11-25T06:18:52+08:00	395	1376	1771	75	1846	3498	52.77%	11.29%	8	8
14	高雄市桃源區	2018-11-24T23:15:58+08:00	395	1376	1771	75	1846	3498	52.77%	11.29%	8	8
14	高雄市桃源區	2018-11-25T00:57:31+08:00	395	1376	1771	75	1846	3498	52.77%	11.29%	8	8
14	高雄市桃源區	2018-11-25T01:25:47+08:00	395	1376	1771	75	1846	3498	52.77%	11.29%	8	8
14	高雄市桃源區	2018-11-24T22:36:55+08:00	395	1376	1771	75	1846	3498	52.77%	11.29%	8	8
14	高雄市桃源區	2018-11-25T03:56:06+08:00	395	1376	1771	75	1846	3498	52.77%	11.29%	8	8
14	高雄市桃源區	2018-11-25T06:23:55+08:00	395	1376	1771	75	1846	3498	52.77%	11.29%	8	8
14	高雄市桃源區	2018-11-24T23:12:10+08:00	395	1376	1771	75	1846	3498	52.77%	11.29%	8	8
14	高雄市桃源區	2018-11-24T22:45:03+08:00	395	1376	1771	75	1846	3498	52.77%	11.29%	8	8
14	嘉義縣朴子市	2018-11-24T23:47:26+08:00	4507	10715	15222	1314	16536	31914	51.81%	14.12%	32	35
14	嘉義縣朴子市	2018-11-24T22:16:08+08:00	3252	7739	10991	989	11980	22819	52.5%	14.25%	25	35
14	嘉義縣朴子市	2018-11-24T23:16:00+08:00	4365	10347	14712	1273	15985	30974	51.61%	14.09%	31	35
14	嘉義縣朴子市	2018-11-25T01:25:50+08:00	5003	11776	16779	1431	18210	35191	51.75%	14.22%	35	35
14	嘉義縣朴子市	2018-11-25T03:38:53+08:00	5003	11776	16779	1431	18210	35191	51.75%	14.22%	35	35
14	嘉義縣朴子市	2018-11-25T00:23:01+08:00	5003	11776	16779	1431	18210	35191	51.75%	14.22%	35	35
14	嘉義縣朴子市	2018-11-24T23:23:36+08:00	4365	10347	14712	1273	15985	30974	51.61%	14.09%	31	35
14	嘉義縣朴子市	2018-11-24T22:19:35+08:00	3252	7739	10991	989	11980	22819	52.5%	14.25%	25	35
14	嘉義縣朴子市	2018-11-25T00:57:34+08:00	5003	11776	16779	1431	18210	35191	51.75%	14.22%	35	35
14	嘉義縣朴子市	2018-11-24T22:40:26+08:00	3700	8895	12595	1141	13736	26581	51.68%	13.92%	28	35
14	嘉義縣朴子市	2018-11-24T22:36:58+08:00	3586	8627	12213	1113	13326	25353	52.56%	14.14%	27	35
14	嘉義縣朴子市	2018-11-24T22:57:51+08:00	3924	9432	13356	1176	14532	28252	51.44%	13.89%	29	35
14	嘉義縣朴子市	2018-11-25T00:09:32+08:00	4724	11237	15961	1392	17353	33712	51.47%	14.01%	34	35
14	嘉義縣朴子市	2018-11-24T22:45:06+08:00	3700	8895	12595	1141	13736	26581	51.68%	13.92%	28	35
14	嘉義縣朴子市	2018-11-25T06:08:50+08:00	5003	11776	16779	1431	18210	35191	51.75%	14.22%	35	35
14	嘉義縣朴子市	2018-11-25T06:23:58+08:00	5003	11776	16779	1431	18210	35191	51.75%	14.22%	35	35
14	嘉義縣朴子市	2018-11-24T23:39:13+08:00	4507	10715	15222	1314	16536	31914	51.81%	14.12%	32	35
14	嘉義縣朴子市	2018-11-25T03:49:49+08:00	5003	11776	16779	1431	18210	35191	51.75%	14.22%	35	35
14	嘉義縣朴子市	2018-11-25T01:12:41+08:00	5003	11776	16779	1431	18210	35191	51.75%	14.22%	35	35
14	嘉義縣朴子市	2018-11-24T22:26:35+08:00	3252	7739	10991	989	11980	22819	52.5%	14.25%	25	35
14	嘉義縣朴子市	2018-11-24T22:50:45+08:00	3924	9432	13356	1176	14532	28252	51.44%	13.89%	29	35
14	嘉義縣朴子市	2018-11-24T23:12:13+08:00	4365	10347	14712	1273	15985	30974	51.61%	14.09%	31	35
14	嘉義縣朴子市	2018-11-25T04:02:50+08:00	5003	11776	16779	1431	18210	35191	51.75%	14.22%	35	35
14	嘉義縣朴子市	2018-11-24T23:31:08+08:00	4365	10347	14712	1273	15985	30974	51.61%	14.09%	31	35
14	嘉義縣朴子市	2018-11-24T23:43:15+08:00	4507	10715	15222	1314	16536	31914	51.81%	14.12%	32	35
14	嘉義縣朴子市	2018-11-25T06:29:14+08:00	5003	11776	16779	1431	18210	35191	51.75%	14.22%	35	35
14	嘉義縣朴子市	2018-11-25T00:14:07+08:00	4724	11237	15961	1392	17353	33712	51.47%	14.01%	34	35
14	嘉義縣朴子市	2018-11-24T23:01:29+08:00	3924	9432	13356	1176	14532	28252	51.44%	13.89%	29	35
14	嘉義縣朴子市	2018-11-25T01:07:24+08:00	5003	11776	16779	1431	18210	35191	51.75%	14.22%	35	35
14	嘉義縣朴子市	2018-11-25T06:13:50+08:00	5003	11776	16779	1431	18210	35191	51.75%	14.22%	35	35
14	嘉義縣朴子市	2018-11-24T23:35:08+08:00	4365	10347	14712	1273	15985	30974	51.61%	14.09%	31	35
14	嘉義縣朴子市	2018-11-24T22:33:35+08:00	3361	8054	11415	1055	12470	23857	52.27%	14.09%	26	35
14	嘉義縣朴子市	2018-11-24T23:08:33+08:00	3924	9432	13356	1176	14532	28252	51.44%	13.89%	29	35
14	嘉義縣朴子市	2018-11-25T03:32:32+08:00	5003	11776	16779	1431	18210	35191	51.75%	14.22%	35	35
14	嘉義縣朴子市	2018-11-24T23:19:48+08:00	4365	10347	14712	1273	15985	30974	51.61%	14.09%	31	35
14	嘉義縣朴子市	2018-11-25T03:44:20+08:00	5003	11776	16779	1431	18210	35191	51.75%	14.22%	35	35
14	嘉義縣朴子市	2018-11-24T22:13:24+08:00	3125	7460	10585	949	11534	22009	52.41%	14.2%	24	35
14	嘉義縣朴子市	2018-11-25T00:00:08+08:00	4724	11237	15961	1392	17353	33712	51.47%	14.01%	34	35
14	嘉義縣朴子市	2018-11-24T23:55:44+08:00	4724	11237	15961	1392	17353	33712	51.47%	14.01%	34	35
14	嘉義縣朴子市	2018-11-25T01:17:49+08:00	5003	11776	16779	1431	18210	35191	51.75%	14.22%	35	35
14	嘉義縣朴子市	2018-11-25T06:18:55+08:00	5003	11776	16779	1431	18210	35191	51.75%	14.22%	35	35
14	嘉義縣朴子市	2018-11-25T01:02:28+08:00	5003	11776	16779	1431	18210	35191	51.75%	14.22%	35	35
14	嘉義縣朴子市	2018-11-24T23:27:16+08:00	4365	10347	14712	1273	15985	30974	51.61%	14.09%	31	35
14	嘉義縣朴子市	2018-11-24T22:30:04+08:00	3361	8054	11415	1055	12470	23857	52.27%	14.09%	26	35
14	嘉義縣朴子市	2018-11-24T22:23:10+08:00	3252	7739	10991	989	11980	22819	52.5%	14.25%	25	35
14	嘉義縣朴子市	2018-11-24T23:51:32+08:00	4724	11237	15961	1392	17353	33712	51.47%	14.01%	34	35
14	嘉義縣朴子市	2018-11-25T00:05:02+08:00	4724	11237	15961	1392	17353	33712	51.47%	14.01%	34	35
14	嘉義縣朴子市	2018-11-24T22:41:32+08:00	3700	8895	12595	1141	13736	26581	51.68%	13.92%	28	35
14	嘉義縣朴子市	2018-11-24T22:54:23+08:00	3924	9432	13356	1176	14532	28252	51.44%	13.89%	29	35
14	嘉義縣朴子市	2018-11-24T23:05:02+08:00	3924	9432	13356	1176	14532	28252	51.44%	13.89%	29	35
14	嘉義縣朴子市	2018-11-25T03:56:09+08:00	5003	11776	16779	1431	18210	35191	51.75%	14.22%	35	35
14	嘉義縣朴子市	2018-11-25T00:18:27+08:00	5003	11776	16779	1431	18210	35191	51.75%	14.22%	35	35
14	嘉義縣水上鄉	2018-11-25T03:56:10+08:00	6509	14932	21441	1798	23239	43857	52.99%	14.84%	39	39
14	嘉義縣水上鄉	2018-11-24T23:47:26+08:00	5675	12808	18483	1586	20069	37360	53.72%	15.19%	35	39
14	嘉義縣水上鄉	2018-11-24T23:16:01+08:00	4499	10114	14613	1299	15912	29471	53.99%	15.27%	31	39
14	嘉義縣水上鄉	2018-11-24T22:16:08+08:00	3258	7141	10399	937	11336	20839	54.4%	15.63%	24	39
14	嘉義縣水上鄉	2018-11-24T22:33:36+08:00	3362	7342	10704	971	11675	21409	54.53%	15.7%	25	39
14	嘉義縣水上鄉	2018-11-25T03:38:53+08:00	6509	14932	21441	1798	23239	43857	52.99%	14.84%	39	39
14	嘉義縣水上鄉	2018-11-24T23:23:36+08:00	4499	10114	14613	1299	15912	29471	53.99%	15.27%	31	39
14	嘉義縣水上鄉	2018-11-25T01:25:51+08:00	6509	14932	21441	1798	23239	43857	52.99%	14.84%	39	39
14	嘉義縣水上鄉	2018-11-24T22:19:35+08:00	3258	7141	10399	937	11336	20839	54.4%	15.63%	24	39
14	嘉義縣水上鄉	2018-11-25T00:57:34+08:00	6509	14932	21441	1798	23239	43857	52.99%	14.84%	39	39
14	嘉義縣水上鄉	2018-11-25T01:17:50+08:00	6509	14932	21441	1798	23239	43857	52.99%	14.84%	39	39
14	嘉義縣水上鄉	2018-11-24T22:40:26+08:00	3362	7342	10704	971	11675	21409	54.53%	15.7%	25	39
14	嘉義縣水上鄉	2018-11-24T22:36:58+08:00	3362	7342	10704	971	11675	21409	54.53%	15.7%	25	39
14	嘉義縣水上鄉	2018-11-24T22:57:51+08:00	4065	8992	13057	1186	14243	26303	54.15%	15.45%	29	39
14	嘉義縣水上鄉	2018-11-25T00:09:32+08:00	6096	13868	19964	1672	21636	40616	53.27%	15.01%	37	39
14	嘉義縣水上鄉	2018-11-25T06:08:50+08:00	6509	14932	21441	1798	23239	43857	52.99%	14.84%	39	39
14	嘉義縣水上鄉	2018-11-25T06:23:58+08:00	6509	14932	21441	1798	23239	43857	52.99%	14.84%	39	39
14	嘉義縣水上鄉	2018-11-24T23:39:13+08:00	5675	12808	18483	1586	20069	37360	53.72%	15.19%	35	39
14	嘉義縣水上鄉	2018-11-25T03:49:49+08:00	6509	14932	21441	1798	23239	43857	52.99%	14.84%	39	39
14	嘉義縣水上鄉	2018-11-25T01:12:41+08:00	6509	14932	21441	1798	23239	43857	52.99%	14.84%	39	39
14	嘉義縣水上鄉	2018-11-24T22:26:35+08:00	3362	7342	10704	971	11675	21409	54.53%	15.7%	25	39
14	嘉義縣水上鄉	2018-11-24T23:12:14+08:00	4065	8992	13057	1186	14243	26303	54.15%	15.45%	29	39
14	嘉義縣水上鄉	2018-11-24T22:45:07+08:00	3362	7342	10704	971	11675	21409	54.53%	15.7%	25	39
14	嘉義縣水上鄉	2018-11-25T04:02:50+08:00	6509	14932	21441	1798	23239	43857	52.99%	14.84%	39	39
14	嘉義縣水上鄉	2018-11-24T23:43:15+08:00	5675	12808	18483	1586	20069	37360	53.72%	15.19%	35	39
14	嘉義縣水上鄉	2018-11-25T00:14:07+08:00	6096	13868	19964	1672	21636	40616	53.27%	15.01%	37	39
14	嘉義縣水上鄉	2018-11-24T23:01:29+08:00	4065	8992	13057	1186	14243	26303	54.15%	15.45%	29	39
14	嘉義縣水上鄉	2018-11-25T01:07:24+08:00	6509	14932	21441	1798	23239	43857	52.99%	14.84%	39	39
14	嘉義縣水上鄉	2018-11-24T23:31:09+08:00	5095	11486	16581	1454	18035	33425	53.96%	15.24%	33	39
14	嘉義縣水上鄉	2018-11-25T06:13:50+08:00	6509	14932	21441	1798	23239	43857	52.99%	14.84%	39	39
14	嘉義縣水上鄉	2018-11-24T23:35:08+08:00	5374	12138	17512	1498	19010	35373	53.74%	15.19%	34	39
14	嘉義縣水上鄉	2018-11-25T06:29:15+08:00	6509	14932	21441	1798	23239	43857	52.99%	14.84%	39	39
14	嘉義縣水上鄉	2018-11-24T23:55:45+08:00	5675	12808	18483	1586	20069	37360	53.72%	15.19%	35	39
14	嘉義縣水上鄉	2018-11-24T23:08:34+08:00	4065	8992	13057	1186	14243	26303	54.15%	15.45%	29	39
14	嘉義縣水上鄉	2018-11-25T03:32:32+08:00	6509	14932	21441	1798	23239	43857	52.99%	14.84%	39	39
14	嘉義縣水上鄉	2018-11-25T00:00:09+08:00	5675	12808	18483	1586	20069	37360	53.72%	15.19%	35	39
14	嘉義縣水上鄉	2018-11-25T00:23:02+08:00	6509	14932	21441	1798	23239	43857	52.99%	14.84%	39	39
14	嘉義縣水上鄉	2018-11-24T23:19:48+08:00	4499	10114	14613	1299	15912	29471	53.99%	15.27%	31	39
14	嘉義縣水上鄉	2018-11-25T03:44:20+08:00	6509	14932	21441	1798	23239	43857	52.99%	14.84%	39	39
14	嘉義縣水上鄉	2018-11-24T22:13:25+08:00	3258	7141	10399	937	11336	20839	54.4%	15.63%	24	39
14	嘉義縣水上鄉	2018-11-24T22:23:11+08:00	3258	7141	10399	937	11336	20839	54.4%	15.63%	24	39
14	嘉義縣水上鄉	2018-11-24T23:51:33+08:00	5675	12808	18483	1586	20069	37360	53.72%	15.19%	35	39
14	嘉義縣水上鄉	2018-11-25T06:18:55+08:00	6509	14932	21441	1798	23239	43857	52.99%	14.84%	39	39
14	嘉義縣水上鄉	2018-11-25T01:02:28+08:00	6509	14932	21441	1798	23239	43857	52.99%	14.84%	39	39
14	嘉義縣水上鄉	2018-11-24T23:27:16+08:00	5095	11486	16581	1454	18035	33425	53.96%	15.24%	33	39
14	嘉義縣水上鄉	2018-11-24T22:30:04+08:00	3362	7342	10704	971	11675	21409	54.53%	15.7%	25	39
14	嘉義縣水上鄉	2018-11-24T23:05:03+08:00	4065	8992	13057	1186	14243	26303	54.15%	15.45%	29	39
14	嘉義縣水上鄉	2018-11-24T22:54:24+08:00	3835	8375	12210	1140	13350	24531	54.42%	15.63%	28	39
14	嘉義縣水上鄉	2018-11-25T00:18:28+08:00	6251	14313	20564	1729	22293	41925	53.17%	14.91%	38	39
14	嘉義縣水上鄉	2018-11-24T22:41:33+08:00	3362	7342	10704	971	11675	21409	54.53%	15.7%	25	39
14	嘉義縣水上鄉	2018-11-25T00:05:03+08:00	6096	13868	19964	1672	21636	40616	53.27%	15.01%	37	39
14	嘉義縣水上鄉	2018-11-24T22:50:46+08:00	3668	8022	11690	1080	12770	23466	54.42%	15.63%	27	39
14	金門縣烈嶼鄉	2018-11-24T22:33:39+08:00	823	3243	4066	193	4259	11676	36.48%	7.05%	8	8
14	金門縣烈嶼鄉	2018-11-25T03:49:52+08:00	823	3243	4066	193	4259	11676	36.48%	7.05%	8	8
14	金門縣烈嶼鄉	2018-11-24T23:43:18+08:00	823	3243	4066	193	4259	11676	36.48%	7.05%	8	8
14	金門縣烈嶼鄉	2018-11-25T06:29:18+08:00	823	3243	4066	193	4259	11676	36.48%	7.05%	8	8
14	金門縣烈嶼鄉	2018-11-25T01:07:27+08:00	823	3243	4066	193	4259	11676	36.48%	7.05%	8	8
14	金門縣烈嶼鄉	2018-11-25T06:13:53+08:00	823	3243	4066	193	4259	11676	36.48%	7.05%	8	8
14	金門縣烈嶼鄉	2018-11-24T23:08:37+08:00	823	3243	4066	193	4259	11676	36.48%	7.05%	8	8
14	金門縣烈嶼鄉	2018-11-25T03:32:36+08:00	823	3243	4066	193	4259	11676	36.48%	7.05%	8	8
14	金門縣烈嶼鄉	2018-11-24T23:55:48+08:00	823	3243	4066	193	4259	11676	36.48%	7.05%	8	8
14	金門縣烈嶼鄉	2018-11-25T03:44:25+08:00	823	3243	4066	193	4259	11676	36.48%	7.05%	8	8
14	金門縣烈嶼鄉	2018-11-24T22:13:28+08:00	823	3243	4066	193	4259	11676	36.48%	7.05%	8	8
14	金門縣烈嶼鄉	2018-11-24T23:23:39+08:00	823	3243	4066	193	4259	11676	36.48%	7.05%	8	8
14	金門縣烈嶼鄉	2018-11-25T06:18:58+08:00	823	3243	4066	193	4259	11676	36.48%	7.05%	8	8
14	金門縣烈嶼鄉	2018-11-24T22:40:29+08:00	823	3243	4066	193	4259	11676	36.48%	7.05%	8	8
14	金門縣烈嶼鄉	2018-11-24T23:51:36+08:00	823	3243	4066	193	4259	11676	36.48%	7.05%	8	8
14	金門縣烈嶼鄉	2018-11-24T22:23:14+08:00	823	3243	4066	193	4259	11676	36.48%	7.05%	8	8
14	金門縣烈嶼鄉	2018-11-24T22:54:27+08:00	823	3243	4066	193	4259	11676	36.48%	7.05%	8	8
14	金門縣烈嶼鄉	2018-11-25T00:14:11+08:00	823	3243	4066	193	4259	11676	36.48%	7.05%	8	8
14	金門縣烈嶼鄉	2018-11-25T00:05:06+08:00	823	3243	4066	193	4259	11676	36.48%	7.05%	8	8
14	金門縣烈嶼鄉	2018-11-24T22:41:36+08:00	823	3243	4066	193	4259	11676	36.48%	7.05%	8	8
14	金門縣烈嶼鄉	2018-11-24T22:16:12+08:00	823	3243	4066	193	4259	11676	36.48%	7.05%	8	8
14	金門縣烈嶼鄉	2018-11-24T23:05:06+08:00	823	3243	4066	193	4259	11676	36.48%	7.05%	8	8
14	金門縣烈嶼鄉	2018-11-24T22:45:10+08:00	823	3243	4066	193	4259	11676	36.48%	7.05%	8	8
14	金門縣烈嶼鄉	2018-11-25T03:56:14+08:00	823	3243	4066	193	4259	11676	36.48%	7.05%	8	8
14	金門縣烈嶼鄉	2018-11-24T22:37:02+08:00	823	3243	4066	193	4259	11676	36.48%	7.05%	8	8
14	金門縣烈嶼鄉	2018-11-25T00:18:32+08:00	823	3243	4066	193	4259	11676	36.48%	7.05%	8	8
14	金門縣烈嶼鄉	2018-11-24T23:16:04+08:00	823	3243	4066	193	4259	11676	36.48%	7.05%	8	8
14	金門縣烈嶼鄉	2018-11-25T00:23:05+08:00	823	3243	4066	193	4259	11676	36.48%	7.05%	8	8
14	金門縣烈嶼鄉	2018-11-25T01:25:54+08:00	823	3243	4066	193	4259	11676	36.48%	7.05%	8	8
14	金門縣烈嶼鄉	2018-11-25T01:02:32+08:00	823	3243	4066	193	4259	11676	36.48%	7.05%	8	8
14	金門縣烈嶼鄉	2018-11-24T22:30:10+08:00	823	3243	4066	193	4259	11676	36.48%	7.05%	8	8
14	金門縣烈嶼鄉	2018-11-25T06:24:01+08:00	823	3243	4066	193	4259	11676	36.48%	7.05%	8	8
14	金門縣烈嶼鄉	2018-11-25T03:38:56+08:00	823	3243	4066	193	4259	11676	36.48%	7.05%	8	8
14	金門縣烈嶼鄉	2018-11-24T22:19:38+08:00	823	3243	4066	193	4259	11676	36.48%	7.05%	8	8
14	金門縣烈嶼鄉	2018-11-24T23:19:53+08:00	823	3243	4066	193	4259	11676	36.48%	7.05%	8	8
14	金門縣烈嶼鄉	2018-11-25T01:17:54+08:00	823	3243	4066	193	4259	11676	36.48%	7.05%	8	8
14	金門縣烈嶼鄉	2018-11-25T00:00:12+08:00	823	3243	4066	193	4259	11676	36.48%	7.05%	8	8
14	金門縣烈嶼鄉	2018-11-24T22:57:55+08:00	823	3243	4066	193	4259	11676	36.48%	7.05%	8	8
14	金門縣烈嶼鄉	2018-11-24T23:27:20+08:00	823	3243	4066	193	4259	11676	36.48%	7.05%	8	8
14	金門縣烈嶼鄉	2018-11-25T00:57:38+08:00	823	3243	4066	193	4259	11676	36.48%	7.05%	8	8
14	金門縣烈嶼鄉	2018-11-24T23:35:12+08:00	823	3243	4066	193	4259	11676	36.48%	7.05%	8	8
14	金門縣烈嶼鄉	2018-11-24T23:47:30+08:00	823	3243	4066	193	4259	11676	36.48%	7.05%	8	8
14	金門縣烈嶼鄉	2018-11-25T00:09:36+08:00	823	3243	4066	193	4259	11676	36.48%	7.05%	8	8
14	金門縣烈嶼鄉	2018-11-25T06:08:54+08:00	823	3243	4066	193	4259	11676	36.48%	7.05%	8	8
14	金門縣烈嶼鄉	2018-11-24T23:39:17+08:00	823	3243	4066	193	4259	11676	36.48%	7.05%	8	8
14	金門縣烈嶼鄉	2018-11-24T22:50:49+08:00	823	3243	4066	193	4259	11676	36.48%	7.05%	8	8
14	金門縣烈嶼鄉	2018-11-24T23:31:13+08:00	823	3243	4066	193	4259	11676	36.48%	7.05%	8	8
14	金門縣烈嶼鄉	2018-11-25T04:02:53+08:00	823	3243	4066	193	4259	11676	36.48%	7.05%	8	8
14	金門縣烈嶼鄉	2018-11-24T23:01:32+08:00	823	3243	4066	193	4259	11676	36.48%	7.05%	8	8
14	金門縣烈嶼鄉	2018-11-25T01:12:45+08:00	823	3243	4066	193	4259	11676	36.48%	7.05%	8	8
14	金門縣烈嶼鄉	2018-11-24T22:26:38+08:00	823	3243	4066	193	4259	11676	36.48%	7.05%	8	8
14	金門縣烈嶼鄉	2018-11-24T23:12:17+08:00	823	3243	4066	193	4259	11676	36.48%	7.05%	8	8
14	臺南市佳里區	2018-11-24T23:35:03+08:00	7962	16801	24763	1644	26407	50407	52.39%	15.8%	41	41
14	臺南市佳里區	2018-11-24T22:33:30+08:00	7962	16801	24763	1644	26407	50407	52.39%	15.8%	41	41
14	臺南市佳里區	2018-11-24T23:31:02+08:00	7962	16801	24763	1644	26407	50407	52.39%	15.8%	41	41
14	臺南市佳里區	2018-11-24T23:39:06+08:00	7962	16801	24763	1644	26407	50407	52.39%	15.8%	41	41
14	臺南市佳里區	2018-11-24T23:12:07+08:00	7962	16801	24763	1644	26407	50407	52.39%	15.8%	41	41
14	臺南市佳里區	2018-11-25T00:14:02+08:00	7962	16801	24763	1644	26407	50407	52.39%	15.8%	41	41
14	臺南市佳里區	2018-11-24T23:47:20+08:00	7962	16801	24763	1644	26407	50407	52.39%	15.8%	41	41
14	臺南市佳里區	2018-11-24T23:43:10+08:00	7962	16801	24763	1644	26407	50407	52.39%	15.8%	41	41
14	臺南市佳里區	2018-11-25T06:08:44+08:00	7962	16801	24763	1644	26407	50407	52.39%	15.8%	41	41
14	臺南市佳里區	2018-11-25T01:07:18+08:00	7962	16801	24763	1644	26407	50407	52.39%	15.8%	41	41
14	臺南市佳里區	2018-11-24T23:01:23+08:00	7962	16801	24763	1644	26407	50407	52.39%	15.8%	41	41
14	臺南市佳里區	2018-11-24T22:57:45+08:00	7962	16801	24763	1644	26407	50407	52.39%	15.8%	41	41
14	臺南市佳里區	2018-11-24T23:04:57+08:00	7962	16801	24763	1644	26407	50407	52.39%	15.8%	41	41
14	臺南市佳里區	2018-11-24T23:23:31+08:00	7962	16801	24763	1644	26407	50407	52.39%	15.8%	41	41
14	臺南市佳里區	2018-11-25T00:57:29+08:00	7962	16801	24763	1644	26407	50407	52.39%	15.8%	41	41
14	臺南市佳里區	2018-11-24T22:13:19+08:00	7962	16801	24763	1644	26407	50407	52.39%	15.8%	41	41
14	臺南市佳里區	2018-11-25T03:44:14+08:00	7962	16801	24763	1644	26407	50407	52.39%	15.8%	41	41
14	臺南市佳里區	2018-11-25T01:17:43+08:00	7962	16801	24763	1644	26407	50407	52.39%	15.8%	41	41
14	臺南市佳里區	2018-11-25T00:04:57+08:00	7962	16801	24763	1644	26407	50407	52.39%	15.8%	41	41
14	臺南市佳里區	2018-11-24T23:55:40+08:00	7962	16801	24763	1644	26407	50407	52.39%	15.8%	41	41
14	臺南市佳里區	2018-11-24T23:15:55+08:00	7962	16801	24763	1644	26407	50407	52.39%	15.8%	41	41
14	臺南市佳里區	2018-11-25T01:02:23+08:00	7962	16801	24763	1644	26407	50407	52.39%	15.8%	41	41
14	臺南市佳里區	2018-11-25T01:25:45+08:00	7962	16801	24763	1644	26407	50407	52.39%	15.8%	41	41
14	臺南市佳里區	2018-11-25T03:38:48+08:00	7962	16801	24763	1644	26407	50407	52.39%	15.8%	41	41
14	臺南市佳里區	2018-11-25T06:18:50+08:00	7962	16801	24763	1644	26407	50407	52.39%	15.8%	41	41
14	臺南市佳里區	2018-11-24T22:40:21+08:00	7962	16801	24763	1644	26407	50407	52.39%	15.8%	41	41
14	臺南市佳里區	2018-11-24T22:45:01+08:00	7962	16801	24763	1644	26407	50407	52.39%	15.8%	41	41
14	臺南市佳里區	2018-11-25T00:18:22+08:00	7962	16801	24763	1644	26407	50407	52.39%	15.8%	41	41
14	臺南市佳里區	2018-11-25T00:22:56+08:00	7962	16801	24763	1644	26407	50407	52.39%	15.8%	41	41
14	臺南市佳里區	2018-11-24T22:54:19+08:00	7962	16801	24763	1644	26407	50407	52.39%	15.8%	41	41
14	臺南市佳里區	2018-11-25T03:56:03+08:00	7962	16801	24763	1644	26407	50407	52.39%	15.8%	41	41
14	臺南市佳里區	2018-11-24T22:16:02+08:00	7962	16801	24763	1644	26407	50407	52.39%	15.8%	41	41
14	臺南市佳里區	2018-11-25T01:12:34+08:00	7962	16801	24763	1644	26407	50407	52.39%	15.8%	41	41
14	臺南市佳里區	2018-11-24T22:50:39+08:00	7962	16801	24763	1644	26407	50407	52.39%	15.8%	41	41
14	臺南市佳里區	2018-11-25T00:09:25+08:00	7962	16801	24763	1644	26407	50407	52.39%	15.8%	41	41
14	臺南市佳里區	2018-11-24T22:41:28+08:00	7962	16801	24763	1644	26407	50407	52.39%	15.8%	41	41
14	臺南市佳里區	2018-11-25T04:02:41+08:00	7962	16801	24763	1644	26407	50407	52.39%	15.8%	41	41
14	臺南市佳里區	2018-11-25T00:00:00+08:00	7962	16801	24763	1644	26407	50407	52.39%	15.8%	41	41
14	臺南市佳里區	2018-11-24T22:23:04+08:00	7962	16801	24763	1644	26407	50407	52.39%	15.8%	41	41
14	臺南市佳里區	2018-11-24T23:19:41+08:00	7962	16801	24763	1644	26407	50407	52.39%	15.8%	41	41
14	臺南市佳里區	2018-11-24T23:51:27+08:00	7962	16801	24763	1644	26407	50407	52.39%	15.8%	41	41
14	臺南市佳里區	2018-11-24T22:29:58+08:00	7962	16801	24763	1644	26407	50407	52.39%	15.8%	41	41
14	臺南市佳里區	2018-11-24T22:36:54+08:00	7962	16801	24763	1644	26407	50407	52.39%	15.8%	41	41
14	臺南市佳里區	2018-11-25T03:32:27+08:00	7962	16801	24763	1644	26407	50407	52.39%	15.8%	41	41
14	臺南市佳里區	2018-11-24T23:27:11+08:00	7962	16801	24763	1644	26407	50407	52.39%	15.8%	41	41
14	臺南市佳里區	2018-11-24T22:19:30+08:00	7962	16801	24763	1644	26407	50407	52.39%	15.8%	41	41
14	臺南市佳里區	2018-11-24T23:08:27+08:00	7962	16801	24763	1644	26407	50407	52.39%	15.8%	41	41
14	臺南市佳里區	2018-11-25T03:49:44+08:00	7962	16801	24763	1644	26407	50407	52.39%	15.8%	41	41
14	臺南市佳里區	2018-11-24T22:26:30+08:00	7962	16801	24763	1644	26407	50407	52.39%	15.8%	41	41
14	臺南市佳里區	2018-11-25T06:29:09+08:00	7962	16801	24763	1644	26407	50407	52.39%	15.8%	41	41
14	臺南市佳里區	2018-11-25T06:23:53+08:00	7962	16801	24763	1644	26407	50407	52.39%	15.8%	41	41
14	臺南市佳里區	2018-11-25T06:13:45+08:00	7962	16801	24763	1644	26407	50407	52.39%	15.8%	41	41
14	屏東縣三地門鄉	2018-11-24T22:33:37+08:00	451	1131	1582	140	1722	3213	53.59%	14.04%	6	10
14	屏東縣三地門鄉	2018-11-24T22:37:00+08:00	451	1131	1582	140	1722	3213	53.59%	14.04%	6	10
14	屏東縣三地門鄉	2018-11-24T23:43:16+08:00	667	1888	2555	186	2741	4925	55.65%	13.54%	9	10
14	屏東縣三地門鄉	2018-11-25T03:56:11+08:00	938	2463	3401	230	3631	6373	56.97%	14.72%	10	10
14	屏東縣三地門鄉	2018-11-25T06:29:16+08:00	938	2463	3401	230	3631	6373	56.97%	14.72%	10	10
14	屏東縣三地門鄉	2018-11-24T23:47:27+08:00	667	1888	2555	186	2741	4925	55.65%	13.54%	9	10
14	屏東縣三地門鄉	2018-11-24T22:16:09+08:00	372	920	1292	75	1367	2641	51.76%	14.09%	5	10
14	屏東縣三地門鄉	2018-11-25T03:38:54+08:00	938	2463	3401	230	3631	6373	56.97%	14.72%	10	10
14	屏東縣三地門鄉	2018-11-24T23:55:46+08:00	667	1888	2555	186	2741	4925	55.65%	13.54%	9	10
14	屏東縣三地門鄉	2018-11-25T03:44:22+08:00	938	2463	3401	230	3631	6373	56.97%	14.72%	10	10
14	屏東縣三地門鄉	2018-11-24T22:13:26+08:00	372	920	1292	75	1367	2641	51.76%	14.09%	5	10
14	屏東縣三地門鄉	2018-11-24T23:23:37+08:00	617	1704	2321	181	2502	4467	56.01%	13.81%	8	10
14	屏東縣三地門鄉	2018-11-25T06:18:56+08:00	938	2463	3401	230	3631	6373	56.97%	14.72%	10	10
14	屏東縣三地門鄉	2018-11-24T22:23:12+08:00	451	1131	1582	140	1722	3213	53.59%	14.04%	6	10
14	屏東縣三地門鄉	2018-11-24T22:40:27+08:00	451	1131	1582	140	1722	3213	53.59%	14.04%	6	10
14	屏東縣三地門鄉	2018-11-25T00:00:10+08:00	667	1888	2555	186	2741	4925	55.65%	13.54%	9	10
14	屏東縣三地門鄉	2018-11-25T01:17:51+08:00	938	2463	3401	230	3631	6373	56.97%	14.72%	10	10
14	屏東縣三地門鄉	2018-11-24T22:30:07+08:00	451	1131	1582	140	1722	3213	53.59%	14.04%	6	10
14	屏東縣三地門鄉	2018-11-24T23:12:15+08:00	617	1704	2321	181	2502	4467	56.01%	13.81%	8	10
14	屏東縣三地門鄉	2018-11-24T22:45:08+08:00	451	1131	1582	140	1722	3213	53.59%	14.04%	6	10
14	屏東縣三地門鄉	2018-11-24T23:31:10+08:00	617	1704	2321	181	2502	4467	56.01%	13.81%	8	10
14	屏東縣三地門鄉	2018-11-24T23:01:30+08:00	617	1704	2321	181	2502	4467	56.01%	13.81%	8	10
14	屏東縣三地門鄉	2018-11-25T04:02:51+08:00	938	2463	3401	230	3631	6373	56.97%	14.72%	10	10
14	屏東縣三地門鄉	2018-11-24T23:39:15+08:00	667	1888	2555	186	2741	4925	55.65%	13.54%	9	10
14	屏東縣三地門鄉	2018-11-25T06:23:59+08:00	938	2463	3401	230	3631	6373	56.97%	14.72%	10	10
14	屏東縣三地門鄉	2018-11-25T00:09:33+08:00	667	1888	2555	186	2741	4925	55.65%	13.54%	9	10
14	屏東縣三地門鄉	2018-11-25T01:07:25+08:00	938	2463	3401	230	3631	6373	56.97%	14.72%	10	10
14	屏東縣三地門鄉	2018-11-25T06:13:51+08:00	938	2463	3401	230	3631	6373	56.97%	14.72%	10	10
14	屏東縣三地門鄉	2018-11-24T23:16:02+08:00	617	1704	2321	181	2502	4467	56.01%	13.81%	8	10
14	屏東縣三地門鄉	2018-11-24T23:35:09+08:00	617	1704	2321	181	2502	4467	56.01%	13.81%	8	10
14	屏東縣三地門鄉	2018-11-25T03:49:50+08:00	938	2463	3401	230	3631	6373	56.97%	14.72%	10	10
14	屏東縣三地門鄉	2018-11-25T00:14:08+08:00	667	1888	2555	186	2741	4925	55.65%	13.54%	9	10
14	屏東縣三地門鄉	2018-11-25T00:23:03+08:00	667	1888	2555	186	2741	4925	55.65%	13.54%	9	10
14	屏東縣三地門鄉	2018-11-24T23:08:35+08:00	617	1704	2321	181	2502	4467	56.01%	13.81%	8	10
14	屏東縣三地門鄉	2018-11-25T03:32:34+08:00	938	2463	3401	230	3631	6373	56.97%	14.72%	10	10
14	屏東縣三地門鄉	2018-11-25T01:25:52+08:00	938	2463	3401	230	3631	6373	56.97%	14.72%	10	10
14	屏東縣三地門鄉	2018-11-24T23:19:49+08:00	617	1704	2321	181	2502	4467	56.01%	13.81%	8	10
14	屏東縣三地門鄉	2018-11-24T22:19:36+08:00	451	1131	1582	140	1722	3213	53.59%	14.04%	6	10
14	屏東縣三地門鄉	2018-11-25T01:02:29+08:00	938	2463	3401	230	3631	6373	56.97%	14.72%	10	10
14	屏東縣三地門鄉	2018-11-24T23:51:34+08:00	667	1888	2555	186	2741	4925	55.65%	13.54%	9	10
14	屏東縣三地門鄉	2018-11-24T22:57:52+08:00	617	1704	2321	181	2502	4467	56.01%	13.81%	8	10
14	屏東縣三地門鄉	2018-11-25T00:57:36+08:00	938	2463	3401	230	3631	6373	56.97%	14.72%	10	10
14	屏東縣三地門鄉	2018-11-24T23:27:18+08:00	617	1704	2321	181	2502	4467	56.01%	13.81%	8	10
14	屏東縣三地門鄉	2018-11-24T23:05:04+08:00	617	1704	2321	181	2502	4467	56.01%	13.81%	8	10
14	屏東縣三地門鄉	2018-11-24T22:50:47+08:00	451	1131	1582	140	1722	3213	53.59%	14.04%	6	10
14	屏東縣三地門鄉	2018-11-25T00:05:04+08:00	667	1888	2555	186	2741	4925	55.65%	13.54%	9	10
14	屏東縣三地門鄉	2018-11-24T22:41:34+08:00	451	1131	1582	140	1722	3213	53.59%	14.04%	6	10
14	屏東縣三地門鄉	2018-11-25T01:12:42+08:00	938	2463	3401	230	3631	6373	56.97%	14.72%	10	10
14	屏東縣三地門鄉	2018-11-24T22:26:36+08:00	451	1131	1582	140	1722	3213	53.59%	14.04%	6	10
14	屏東縣三地門鄉	2018-11-25T00:18:29+08:00	667	1888	2555	186	2741	4925	55.65%	13.54%	9	10
14	屏東縣三地門鄉	2018-11-25T06:08:52+08:00	938	2463	3401	230	3631	6373	56.97%	14.72%	10	10
14	屏東縣三地門鄉	2018-11-24T22:54:25+08:00	501	1373	1874	156	2030	3829	53.02%	13.08%	7	10
14	臺南市鹽水區	2018-11-24T23:35:03+08:00	3142	6633	9775	858	10633	22121	48.07%	14.2%	31	31
14	臺南市鹽水區	2018-11-24T22:33:30+08:00	2932	6208	9140	832	9972	20748	48.06%	14.13%	30	31
14	臺南市鹽水區	2018-11-24T23:31:02+08:00	3142	6633	9775	858	10633	22121	48.07%	14.2%	31	31
14	臺南市鹽水區	2018-11-24T23:39:06+08:00	3142	6633	9775	858	10633	22121	48.07%	14.2%	31	31
14	臺南市鹽水區	2018-11-24T23:12:07+08:00	3142	6633	9775	858	10633	22121	48.07%	14.2%	31	31
14	臺南市鹽水區	2018-11-24T23:47:20+08:00	3142	6633	9775	858	10633	22121	48.07%	14.2%	31	31
14	臺南市鹽水區	2018-11-25T01:07:18+08:00	3142	6633	9775	858	10633	22121	48.07%	14.2%	31	31
14	臺南市鹽水區	2018-11-25T06:08:43+08:00	3142	6633	9775	858	10633	22121	48.07%	14.2%	31	31
14	臺南市鹽水區	2018-11-24T23:01:23+08:00	3142	6633	9775	858	10633	22121	48.07%	14.2%	31	31
14	臺南市鹽水區	2018-11-24T22:57:45+08:00	3142	6633	9775	858	10633	22121	48.07%	14.2%	31	31
14	臺南市鹽水區	2018-11-25T01:17:42+08:00	3142	6633	9775	858	10633	22121	48.07%	14.2%	31	31
14	臺南市鹽水區	2018-11-24T22:13:18+08:00	2738	5859	8597	796	9393	19504	48.16%	14.04%	29	31
14	臺南市鹽水區	2018-11-24T22:19:29+08:00	2738	5859	8597	796	9393	19504	48.16%	14.04%	29	31
14	臺南市鹽水區	2018-11-25T00:57:28+08:00	3142	6633	9775	858	10633	22121	48.07%	14.2%	31	31
14	臺南市鹽水區	2018-11-24T23:23:31+08:00	3142	6633	9775	858	10633	22121	48.07%	14.2%	31	31
14	臺南市鹽水區	2018-11-25T03:44:13+08:00	3142	6633	9775	858	10633	22121	48.07%	14.2%	31	31
14	臺南市鹽水區	2018-11-25T00:04:57+08:00	3142	6633	9775	858	10633	22121	48.07%	14.2%	31	31
14	臺南市鹽水區	2018-11-24T23:04:56+08:00	3142	6633	9775	858	10633	22121	48.07%	14.2%	31	31
14	臺南市鹽水區	2018-11-24T23:15:55+08:00	3142	6633	9775	858	10633	22121	48.07%	14.2%	31	31
14	臺南市鹽水區	2018-11-25T03:38:48+08:00	3142	6633	9775	858	10633	22121	48.07%	14.2%	31	31
14	臺南市鹽水區	2018-11-25T06:18:50+08:00	3142	6633	9775	858	10633	22121	48.07%	14.2%	31	31
14	臺南市鹽水區	2018-11-25T01:25:44+08:00	3142	6633	9775	858	10633	22121	48.07%	14.2%	31	31
14	臺南市鹽水區	2018-11-24T22:40:21+08:00	2932	6208	9140	832	9972	20748	48.06%	14.13%	30	31
14	臺南市鹽水區	2018-11-25T01:02:22+08:00	3142	6633	9775	858	10633	22121	48.07%	14.2%	31	31
14	臺南市鹽水區	2018-11-24T23:55:39+08:00	3142	6633	9775	858	10633	22121	48.07%	14.2%	31	31
14	臺南市鹽水區	2018-11-24T22:45:01+08:00	2932	6208	9140	832	9972	20748	48.06%	14.13%	30	31
14	臺南市鹽水區	2018-11-25T00:18:22+08:00	3142	6633	9775	858	10633	22121	48.07%	14.2%	31	31
14	臺南市鹽水區	2018-11-25T00:22:56+08:00	3142	6633	9775	858	10633	22121	48.07%	14.2%	31	31
14	臺南市鹽水區	2018-11-24T22:54:19+08:00	3142	6633	9775	858	10633	22121	48.07%	14.2%	31	31
14	臺南市鹽水區	2018-11-25T03:56:03+08:00	3142	6633	9775	858	10633	22121	48.07%	14.2%	31	31
14	臺南市鹽水區	2018-11-24T22:16:02+08:00	2738	5859	8597	796	9393	19504	48.16%	14.04%	29	31
14	臺南市鹽水區	2018-11-25T01:12:34+08:00	3142	6633	9775	858	10633	22121	48.07%	14.2%	31	31
14	臺南市鹽水區	2018-11-24T22:50:39+08:00	2932	6208	9140	832	9972	20748	48.06%	14.13%	30	31
14	臺南市鹽水區	2018-11-25T00:09:25+08:00	3142	6633	9775	858	10633	22121	48.07%	14.2%	31	31
14	臺南市鹽水區	2018-11-25T00:14:01+08:00	3142	6633	9775	858	10633	22121	48.07%	14.2%	31	31
14	臺南市鹽水區	2018-11-24T22:41:28+08:00	2932	6208	9140	832	9972	20748	48.06%	14.13%	30	31
14	臺南市鹽水區	2018-11-25T04:02:41+08:00	3142	6633	9775	858	10633	22121	48.07%	14.2%	31	31
14	臺南市鹽水區	2018-11-25T00:00:00+08:00	3142	6633	9775	858	10633	22121	48.07%	14.2%	31	31
14	臺南市鹽水區	2018-11-24T22:23:04+08:00	2932	6208	9140	832	9972	20748	48.06%	14.13%	30	31
14	臺南市鹽水區	2018-11-24T23:19:41+08:00	3142	6633	9775	858	10633	22121	48.07%	14.2%	31	31
14	臺南市鹽水區	2018-11-24T23:51:27+08:00	3142	6633	9775	858	10633	22121	48.07%	14.2%	31	31
14	臺南市鹽水區	2018-11-24T22:29:58+08:00	2932	6208	9140	832	9972	20748	48.06%	14.13%	30	31
14	臺南市鹽水區	2018-11-24T22:36:53+08:00	2932	6208	9140	832	9972	20748	48.06%	14.13%	30	31
14	臺南市鹽水區	2018-11-24T23:27:11+08:00	3142	6633	9775	858	10633	22121	48.07%	14.2%	31	31
14	臺南市鹽水區	2018-11-24T23:08:27+08:00	3142	6633	9775	858	10633	22121	48.07%	14.2%	31	31
14	臺南市鹽水區	2018-11-25T03:32:26+08:00	3142	6633	9775	858	10633	22121	48.07%	14.2%	31	31
14	臺南市鹽水區	2018-11-25T06:29:08+08:00	3142	6633	9775	858	10633	22121	48.07%	14.2%	31	31
14	臺南市鹽水區	2018-11-25T03:49:44+08:00	3142	6633	9775	858	10633	22121	48.07%	14.2%	31	31
14	臺南市鹽水區	2018-11-24T22:26:30+08:00	2932	6208	9140	832	9972	20748	48.06%	14.13%	30	31
14	臺南市鹽水區	2018-11-25T06:23:52+08:00	3142	6633	9775	858	10633	22121	48.07%	14.2%	31	31
14	臺南市鹽水區	2018-11-24T23:43:09+08:00	3142	6633	9775	858	10633	22121	48.07%	14.2%	31	31
14	臺南市鹽水區	2018-11-25T06:13:45+08:00	3142	6633	9775	858	10633	22121	48.07%	14.2%	31	31
14	花蓮縣卓溪鄉	2018-11-25T06:29:17+08:00	551	2007	2558	291	2849	4947	57.59%	11.14%	10	10
14	花蓮縣卓溪鄉	2018-11-25T00:18:30+08:00	551	2007	2558	291	2849	4947	57.59%	11.14%	10	10
14	花蓮縣卓溪鄉	2018-11-25T01:07:26+08:00	551	2007	2558	291	2849	4947	57.59%	11.14%	10	10
14	花蓮縣卓溪鄉	2018-11-24T23:47:29+08:00	551	2007	2558	291	2849	4947	57.59%	11.14%	10	10
14	花蓮縣卓溪鄉	2018-11-24T22:33:38+08:00	456	1612	2068	246	2314	3986	58.05%	11.44%	8	10
14	花蓮縣卓溪鄉	2018-11-25T06:13:53+08:00	551	2007	2558	291	2849	4947	57.59%	11.14%	10	10
14	花蓮縣卓溪鄉	2018-11-24T23:43:17+08:00	551	2007	2558	291	2849	4947	57.59%	11.14%	10	10
14	花蓮縣卓溪鄉	2018-11-24T22:37:01+08:00	456	1612	2068	246	2314	3986	58.05%	11.44%	8	10
14	花蓮縣卓溪鄉	2018-11-25T03:44:23+08:00	551	2007	2558	291	2849	4947	57.59%	11.14%	10	10
14	花蓮縣卓溪鄉	2018-11-24T22:13:27+08:00	399	1268	1667	206	1873	3285	57.02%	12.15%	7	10
14	花蓮縣卓溪鄉	2018-11-25T01:02:31+08:00	551	2007	2558	291	2849	4947	57.59%	11.14%	10	10
14	花蓮縣卓溪鄉	2018-11-25T03:38:55+08:00	551	2007	2558	291	2849	4947	57.59%	11.14%	10	10
14	花蓮縣卓溪鄉	2018-11-24T23:55:47+08:00	551	2007	2558	291	2849	4947	57.59%	11.14%	10	10
14	花蓮縣卓溪鄉	2018-11-24T23:08:36+08:00	514	1832	2346	271	2617	4519	57.91%	11.37%	9	10
14	花蓮縣卓溪鄉	2018-11-24T23:23:39+08:00	551	2007	2558	291	2849	4947	57.59%	11.14%	10	10
14	花蓮縣卓溪鄉	2018-11-25T00:00:11+08:00	551	2007	2558	291	2849	4947	57.59%	11.14%	10	10
14	花蓮縣卓溪鄉	2018-11-24T23:51:36+08:00	551	2007	2558	291	2849	4947	57.59%	11.14%	10	10
14	花蓮縣卓溪鄉	2018-11-25T06:18:57+08:00	551	2007	2558	291	2849	4947	57.59%	11.14%	10	10
14	花蓮縣卓溪鄉	2018-11-24T22:30:09+08:00	456	1612	2068	246	2314	3986	58.05%	11.44%	8	10
14	花蓮縣卓溪鄉	2018-11-24T22:40:28+08:00	456	1612	2068	246	2314	3986	58.05%	11.44%	8	10
14	花蓮縣卓溪鄉	2018-11-24T22:23:13+08:00	399	1268	1667	206	1873	3285	57.02%	12.15%	7	10
14	花蓮縣卓溪鄉	2018-11-24T23:35:11+08:00	551	2007	2558	291	2849	4947	57.59%	11.14%	10	10
14	花蓮縣卓溪鄉	2018-11-24T23:01:31+08:00	456	1612	2068	246	2314	3986	58.05%	11.44%	8	10
14	花蓮縣卓溪鄉	2018-11-24T22:45:09+08:00	456	1612	2068	246	2314	3986	58.05%	11.44%	8	10
14	花蓮縣卓溪鄉	2018-11-24T23:31:11+08:00	551	2007	2558	291	2849	4947	57.59%	11.14%	10	10
14	花蓮縣卓溪鄉	2018-11-25T00:09:34+08:00	551	2007	2558	291	2849	4947	57.59%	11.14%	10	10
14	花蓮縣卓溪鄉	2018-11-24T22:54:26+08:00	456	1612	2068	246	2314	3986	58.05%	11.44%	8	10
14	花蓮縣卓溪鄉	2018-11-25T00:14:10+08:00	551	2007	2558	291	2849	4947	57.59%	11.14%	10	10
14	花蓮縣卓溪鄉	2018-11-25T03:56:13+08:00	551	2007	2558	291	2849	4947	57.59%	11.14%	10	10
14	花蓮縣卓溪鄉	2018-11-25T03:49:51+08:00	551	2007	2558	291	2849	4947	57.59%	11.14%	10	10
14	花蓮縣卓溪鄉	2018-11-24T23:16:03+08:00	551	2007	2558	291	2849	4947	57.59%	11.14%	10	10
14	花蓮縣卓溪鄉	2018-11-25T03:32:35+08:00	551	2007	2558	291	2849	4947	57.59%	11.14%	10	10
14	花蓮縣卓溪鄉	2018-11-25T06:24:00+08:00	551	2007	2558	291	2849	4947	57.59%	11.14%	10	10
14	花蓮縣卓溪鄉	2018-11-25T01:25:53+08:00	551	2007	2558	291	2849	4947	57.59%	11.14%	10	10
14	花蓮縣卓溪鄉	2018-11-25T00:23:04+08:00	551	2007	2558	291	2849	4947	57.59%	11.14%	10	10
14	花蓮縣卓溪鄉	2018-11-24T23:27:19+08:00	551	2007	2558	291	2849	4947	57.59%	11.14%	10	10
14	花蓮縣卓溪鄉	2018-11-25T00:57:37+08:00	551	2007	2558	291	2849	4947	57.59%	11.14%	10	10
14	花蓮縣卓溪鄉	2018-11-24T22:57:54+08:00	456	1612	2068	246	2314	3986	58.05%	11.44%	8	10
14	花蓮縣卓溪鄉	2018-11-24T22:19:37+08:00	399	1268	1667	206	1873	3285	57.02%	12.15%	7	10
14	花蓮縣卓溪鄉	2018-11-25T01:17:52+08:00	551	2007	2558	291	2849	4947	57.59%	11.14%	10	10
14	花蓮縣卓溪鄉	2018-11-24T23:19:52+08:00	551	2007	2558	291	2849	4947	57.59%	11.14%	10	10
14	花蓮縣卓溪鄉	2018-11-24T22:41:35+08:00	456	1612	2068	246	2314	3986	58.05%	11.44%	8	10
14	花蓮縣卓溪鄉	2018-11-25T00:05:05+08:00	551	2007	2558	291	2849	4947	57.59%	11.14%	10	10
14	花蓮縣卓溪鄉	2018-11-25T04:02:52+08:00	551	2007	2558	291	2849	4947	57.59%	11.14%	10	10
14	花蓮縣卓溪鄉	2018-11-24T23:12:16+08:00	514	1832	2346	271	2617	4519	57.91%	11.37%	9	10
14	花蓮縣卓溪鄉	2018-11-25T06:08:53+08:00	551	2007	2558	291	2849	4947	57.59%	11.14%	10	10
14	花蓮縣卓溪鄉	2018-11-25T01:12:43+08:00	551	2007	2558	291	2849	4947	57.59%	11.14%	10	10
14	花蓮縣卓溪鄉	2018-11-24T22:26:37+08:00	399	1268	1667	206	1873	3285	57.02%	12.15%	7	10
14	花蓮縣卓溪鄉	2018-11-24T23:05:05+08:00	456	1612	2068	246	2314	3986	58.05%	11.44%	8	10
14	花蓮縣卓溪鄉	2018-11-24T22:50:48+08:00	456	1612	2068	246	2314	3986	58.05%	11.44%	8	10
14	花蓮縣卓溪鄉	2018-11-24T22:16:11+08:00	399	1268	1667	206	1873	3285	57.02%	12.15%	7	10
14	花蓮縣卓溪鄉	2018-11-24T23:39:16+08:00	551	2007	2558	291	2849	4947	57.59%	11.14%	10	10
14	花蓮縣玉里鎮	2018-11-25T06:29:17+08:00	2279	6432	8711	1083	9794	20650	47.43%	11.04%	23	23
14	花蓮縣玉里鎮	2018-11-24T23:47:28+08:00	1758	4956	6714	830	7544	15184	49.68%	11.58%	18	23
14	花蓮縣玉里鎮	2018-11-24T22:37:00+08:00	994	2875	3869	556	4425	8959	49.39%	11.09%	12	23
14	花蓮縣玉里鎮	2018-11-25T00:18:30+08:00	1961	5400	7361	936	8297	17118	48.47%	11.46%	20	23
14	花蓮縣玉里鎮	2018-11-25T01:07:26+08:00	2279	6432	8711	1083	9794	20650	47.43%	11.04%	23	23
14	花蓮縣玉里鎮	2018-11-25T06:13:52+08:00	2279	6432	8711	1083	9794	20650	47.43%	11.04%	23	23
14	花蓮縣玉里鎮	2018-11-24T22:33:38+08:00	994	2875	3869	556	4425	8959	49.39%	11.09%	12	23
14	花蓮縣玉里鎮	2018-11-24T23:43:17+08:00	1758	4956	6714	830	7544	15184	49.68%	11.58%	18	23
14	花蓮縣玉里鎮	2018-11-25T03:44:23+08:00	2279	6432	8711	1083	9794	20650	47.43%	11.04%	23	23
14	花蓮縣玉里鎮	2018-11-24T22:13:27+08:00	903	2589	3492	462	3954	8093	48.86%	11.16%	11	23
14	花蓮縣玉里鎮	2018-11-25T01:02:31+08:00	2279	6432	8711	1083	9794	20650	47.43%	11.04%	23	23
14	花蓮縣玉里鎮	2018-11-24T23:23:38+08:00	1347	3826	5173	720	5893	11953	49.3%	11.27%	15	23
14	花蓮縣玉里鎮	2018-11-25T03:38:55+08:00	2279	6432	8711	1083	9794	20650	47.43%	11.04%	23	23
14	花蓮縣玉里鎮	2018-11-24T23:55:47+08:00	1867	5183	7050	866	7916	16053	49.31%	11.63%	19	23
14	花蓮縣玉里鎮	2018-11-24T23:08:36+08:00	1275	3615	4890	668	5558	11184	49.7%	11.4%	14	23
14	花蓮縣玉里鎮	2018-11-25T00:00:11+08:00	1961	5400	7361	936	8297	17118	48.47%	11.46%	20	23
14	花蓮縣玉里鎮	2018-11-24T22:40:27+08:00	994	2875	3869	556	4425	8959	49.39%	11.09%	12	23
14	花蓮縣玉里鎮	2018-11-25T06:18:57+08:00	2279	6432	8711	1083	9794	20650	47.43%	11.04%	23	23
14	花蓮縣玉里鎮	2018-11-24T22:30:09+08:00	994	2875	3869	556	4425	8959	49.39%	11.09%	12	23
14	花蓮縣玉里鎮	2018-11-24T22:23:13+08:00	903	2589	3492	462	3954	8093	48.86%	11.16%	11	23
14	花蓮縣玉里鎮	2018-11-24T23:19:51+08:00	1347	3826	5173	720	5893	11953	49.3%	11.27%	15	23
14	花蓮縣玉里鎮	2018-11-24T23:12:15+08:00	1347	3826	5173	720	5893	11953	49.3%	11.27%	15	23
14	花蓮縣玉里鎮	2018-11-24T22:45:08+08:00	994	2875	3869	556	4425	8959	49.39%	11.09%	12	23
14	花蓮縣玉里鎮	2018-11-24T23:35:11+08:00	1565	4457	6022	794	6816	13940	48.9%	11.23%	17	23
14	花蓮縣玉里鎮	2018-11-24T23:01:31+08:00	1275	3615	4890	668	5558	11184	49.7%	11.4%	14	23
14	花蓮縣玉里鎮	2018-11-24T23:31:11+08:00	1488	4199	5687	755	6442	12961	49.7%	11.48%	16	23
14	花蓮縣玉里鎮	2018-11-25T00:09:34+08:00	1961	5400	7361	936	8297	17118	48.47%	11.46%	20	23
14	花蓮縣玉里鎮	2018-11-25T00:14:09+08:00	1961	5400	7361	936	8297	17118	48.47%	11.46%	20	23
14	花蓮縣玉里鎮	2018-11-25T03:49:51+08:00	2279	6432	8711	1083	9794	20650	47.43%	11.04%	23	23
14	花蓮縣玉里鎮	2018-11-24T23:16:03+08:00	1347	3826	5173	720	5893	11953	49.3%	11.27%	15	23
14	花蓮縣玉里鎮	2018-11-25T03:56:12+08:00	2279	6432	8711	1083	9794	20650	47.43%	11.04%	23	23
14	花蓮縣玉里鎮	2018-11-25T06:24:00+08:00	2279	6432	8711	1083	9794	20650	47.43%	11.04%	23	23
14	花蓮縣玉里鎮	2018-11-25T00:23:03+08:00	2014	5570	7584	956	8540	18108	47.16%	11.12%	21	23
14	花蓮縣玉里鎮	2018-11-25T03:32:34+08:00	2279	6432	8711	1083	9794	20650	47.43%	11.04%	23	23
14	花蓮縣玉里鎮	2018-11-25T01:25:52+08:00	2279	6432	8711	1083	9794	20650	47.43%	11.04%	23	23
14	花蓮縣玉里鎮	2018-11-25T00:57:37+08:00	2279	6432	8711	1083	9794	20650	47.43%	11.04%	23	23
14	花蓮縣玉里鎮	2018-11-24T22:57:53+08:00	1146	3250	4396	627	5023	10205	49.22%	11.23%	13	23
14	花蓮縣玉里鎮	2018-11-24T22:19:37+08:00	903	2589	3492	462	3954	8093	48.86%	11.16%	11	23
14	花蓮縣玉里鎮	2018-11-25T01:17:52+08:00	2279	6432	8711	1083	9794	20650	47.43%	11.04%	23	23
14	花蓮縣玉里鎮	2018-11-24T23:27:18+08:00	1347	3826	5173	720	5893	11953	49.3%	11.27%	15	23
14	花蓮縣玉里鎮	2018-11-24T23:51:35+08:00	1867	5183	7050	866	7916	16053	49.31%	11.63%	19	23
14	花蓮縣玉里鎮	2018-11-24T23:05:04+08:00	1275	3615	4890	668	5558	11184	49.7%	11.4%	14	23
14	花蓮縣玉里鎮	2018-11-24T22:41:35+08:00	994	2875	3869	556	4425	8959	49.39%	11.09%	12	23
14	花蓮縣玉里鎮	2018-11-25T00:05:05+08:00	1961	5400	7361	936	8297	17118	48.47%	11.46%	20	23
14	花蓮縣玉里鎮	2018-11-25T04:02:52+08:00	2279	6432	8711	1083	9794	20650	47.43%	11.04%	23	23
14	花蓮縣玉里鎮	2018-11-25T06:08:53+08:00	2279	6432	8711	1083	9794	20650	47.43%	11.04%	23	23
14	花蓮縣玉里鎮	2018-11-24T22:16:10+08:00	903	2589	3492	462	3954	8093	48.86%	11.16%	11	23
14	花蓮縣玉里鎮	2018-11-25T01:12:43+08:00	2279	6432	8711	1083	9794	20650	47.43%	11.04%	23	23
14	花蓮縣玉里鎮	2018-11-24T22:26:37+08:00	903	2589	3492	462	3954	8093	48.86%	11.16%	11	23
14	花蓮縣玉里鎮	2018-11-24T22:50:48+08:00	1146	3250	4396	627	5023	10205	49.22%	11.23%	13	23
14	花蓮縣玉里鎮	2018-11-24T23:39:16+08:00	1565	4457	6022	794	6816	13940	48.9%	11.23%	17	23
14	花蓮縣玉里鎮	2018-11-24T22:54:25+08:00	1146	3250	4396	627	5023	10205	49.22%	11.23%	13	23
14	南投縣鹿谷鄉	2018-11-25T01:12:39+08:00	2541	5431	7972	552	8524	15941	53.47%	15.94%	21	21
14	南投縣鹿谷鄉	2018-11-25T04:02:45+08:00	2541	5431	7972	552	8524	15941	53.47%	15.94%	21	21
14	南投縣鹿谷鄉	2018-11-24T22:16:07+08:00	2541	5431	7972	552	8524	15941	53.47%	15.94%	21	21
14	南投縣鹿谷鄉	2018-11-24T22:23:09+08:00	2541	5431	7972	552	8524	15941	53.47%	15.94%	21	21
14	南投縣鹿谷鄉	2018-11-25T03:32:31+08:00	2541	5431	7972	552	8524	15941	53.47%	15.94%	21	21
14	南投縣鹿谷鄉	2018-11-25T00:00:04+08:00	2541	5431	7972	552	8524	15941	53.47%	15.94%	21	21
14	南投縣鹿谷鄉	2018-11-25T03:38:52+08:00	2541	5431	7972	552	8524	15941	53.47%	15.94%	21	21
14	南投縣鹿谷鄉	2018-11-25T00:23:00+08:00	2541	5431	7972	552	8524	15941	53.47%	15.94%	21	21
14	南投縣鹿谷鄉	2018-11-24T22:36:57+08:00	2541	5431	7972	552	8524	15941	53.47%	15.94%	21	21
14	南投縣鹿谷鄉	2018-11-24T22:57:50+08:00	2541	5431	7972	552	8524	15941	53.47%	15.94%	21	21
14	南投縣鹿谷鄉	2018-11-25T00:57:33+08:00	2541	5431	7972	552	8524	15941	53.47%	15.94%	21	21
14	南投縣鹿谷鄉	2018-11-24T23:51:31+08:00	2541	5431	7972	552	8524	15941	53.47%	15.94%	21	21
14	南投縣鹿谷鄉	2018-11-24T23:27:15+08:00	2541	5431	7972	552	8524	15941	53.47%	15.94%	21	21
14	南投縣鹿谷鄉	2018-11-24T22:19:34+08:00	2541	5431	7972	552	8524	15941	53.47%	15.94%	21	21
14	南投縣鹿谷鄉	2018-11-24T22:50:44+08:00	2541	5431	7972	552	8524	15941	53.47%	15.94%	21	21
14	南投縣鹿谷鄉	2018-11-24T23:12:12+08:00	2541	5431	7972	552	8524	15941	53.47%	15.94%	21	21
14	南投縣鹿谷鄉	2018-11-25T06:13:49+08:00	2541	5431	7972	552	8524	15941	53.47%	15.94%	21	21
14	南投縣鹿谷鄉	2018-11-24T22:26:34+08:00	2541	5431	7972	552	8524	15941	53.47%	15.94%	21	21
14	南投縣鹿谷鄉	2018-11-25T06:23:57+08:00	2541	5431	7972	552	8524	15941	53.47%	15.94%	21	21
14	南投縣鹿谷鄉	2018-11-24T23:39:12+08:00	2541	5431	7972	552	8524	15941	53.47%	15.94%	21	21
14	南投縣鹿谷鄉	2018-11-25T03:49:48+08:00	2541	5431	7972	552	8524	15941	53.47%	15.94%	21	21
14	南投縣鹿谷鄉	2018-11-24T23:05:01+08:00	2541	5431	7972	552	8524	15941	53.47%	15.94%	21	21
14	南投縣鹿谷鄉	2018-11-24T23:01:28+08:00	2541	5431	7972	552	8524	15941	53.47%	15.94%	21	21
14	南投縣鹿谷鄉	2018-11-24T23:47:25+08:00	2541	5431	7972	552	8524	15941	53.47%	15.94%	21	21
14	南投縣鹿谷鄉	2018-11-25T06:29:13+08:00	2541	5431	7972	552	8524	15941	53.47%	15.94%	21	21
14	南投縣鹿谷鄉	2018-11-24T23:35:07+08:00	2541	5431	7972	552	8524	15941	53.47%	15.94%	21	21
14	南投縣鹿谷鄉	2018-11-24T22:33:34+08:00	2541	5431	7972	552	8524	15941	53.47%	15.94%	21	21
14	南投縣鹿谷鄉	2018-11-25T01:07:23+08:00	2541	5431	7972	552	8524	15941	53.47%	15.94%	21	21
14	南投縣鹿谷鄉	2018-11-24T23:43:14+08:00	2541	5431	7972	552	8524	15941	53.47%	15.94%	21	21
14	南投縣鹿谷鄉	2018-11-24T23:31:07+08:00	2541	5431	7972	552	8524	15941	53.47%	15.94%	21	21
14	南投縣鹿谷鄉	2018-11-25T06:08:49+08:00	2541	5431	7972	552	8524	15941	53.47%	15.94%	21	21
14	南投縣鹿谷鄉	2018-11-25T00:14:06+08:00	2541	5431	7972	552	8524	15941	53.47%	15.94%	21	21
14	南投縣鹿谷鄉	2018-11-24T23:23:35+08:00	2541	5431	7972	552	8524	15941	53.47%	15.94%	21	21
14	南投縣鹿谷鄉	2018-11-24T22:13:23+08:00	2541	5431	7972	552	8524	15941	53.47%	15.94%	21	21
14	南投縣鹿谷鄉	2018-11-25T01:17:48+08:00	2541	5431	7972	552	8524	15941	53.47%	15.94%	21	21
14	南投縣鹿谷鄉	2018-11-24T23:55:43+08:00	2541	5431	7972	552	8524	15941	53.47%	15.94%	21	21
14	南投縣鹿谷鄉	2018-11-24T23:08:32+08:00	2541	5431	7972	552	8524	15941	53.47%	15.94%	21	21
14	南投縣鹿谷鄉	2018-11-24T23:19:47+08:00	2541	5431	7972	552	8524	15941	53.47%	15.94%	21	21
14	南投縣鹿谷鄉	2018-11-25T03:44:19+08:00	2541	5431	7972	552	8524	15941	53.47%	15.94%	21	21
14	南投縣鹿谷鄉	2018-11-24T22:30:02+08:00	2541	5431	7972	552	8524	15941	53.47%	15.94%	21	21
14	南投縣鹿谷鄉	2018-11-25T01:02:27+08:00	2541	5431	7972	552	8524	15941	53.47%	15.94%	21	21
14	南投縣鹿谷鄉	2018-11-24T22:40:25+08:00	2541	5431	7972	552	8524	15941	53.47%	15.94%	21	21
14	南投縣鹿谷鄉	2018-11-25T01:25:49+08:00	2541	5431	7972	552	8524	15941	53.47%	15.94%	21	21
14	南投縣鹿谷鄉	2018-11-24T23:15:59+08:00	2541	5431	7972	552	8524	15941	53.47%	15.94%	21	21
14	南投縣鹿谷鄉	2018-11-25T06:18:54+08:00	2541	5431	7972	552	8524	15941	53.47%	15.94%	21	21
14	南投縣鹿谷鄉	2018-11-25T03:56:08+08:00	2541	5431	7972	552	8524	15941	53.47%	15.94%	21	21
14	南投縣鹿谷鄉	2018-11-25T00:05:02+08:00	2541	5431	7972	552	8524	15941	53.47%	15.94%	21	21
14	南投縣鹿谷鄉	2018-11-24T22:41:32+08:00	2541	5431	7972	552	8524	15941	53.47%	15.94%	21	21
14	南投縣鹿谷鄉	2018-11-25T00:09:31+08:00	2541	5431	7972	552	8524	15941	53.47%	15.94%	21	21
14	南投縣鹿谷鄉	2018-11-24T22:54:23+08:00	2541	5431	7972	552	8524	15941	53.47%	15.94%	21	21
14	南投縣鹿谷鄉	2018-11-24T22:45:05+08:00	2541	5431	7972	552	8524	15941	53.47%	15.94%	21	21
14	南投縣鹿谷鄉	2018-11-25T00:18:26+08:00	2541	5431	7972	552	8524	15941	53.47%	15.94%	21	21
14	雲林縣四湖鄉	2018-11-24T23:47:26+08:00	2046	5442	7488	800	8288	20983	39.5%	9.75%	25	25
14	雲林縣四湖鄉	2018-11-24T23:16:00+08:00	2046	5442	7488	800	8288	20983	39.5%	9.75%	25	25
14	雲林縣四湖鄉	2018-11-24T22:16:07+08:00	2046	5442	7488	800	8288	20983	39.5%	9.75%	25	25
14	雲林縣四湖鄉	2018-11-25T01:25:50+08:00	2046	5442	7488	800	8288	20983	39.5%	9.75%	25	25
14	雲林縣四湖鄉	2018-11-25T03:38:53+08:00	2046	5442	7488	800	8288	20983	39.5%	9.75%	25	25
14	雲林縣四湖鄉	2018-11-25T00:23:01+08:00	2046	5442	7488	800	8288	20983	39.5%	9.75%	25	25
14	雲林縣四湖鄉	2018-11-24T23:23:36+08:00	2046	5442	7488	800	8288	20983	39.5%	9.75%	25	25
14	雲林縣四湖鄉	2018-11-25T00:57:34+08:00	2046	5442	7488	800	8288	20983	39.5%	9.75%	25	25
14	雲林縣四湖鄉	2018-11-24T22:36:58+08:00	2046	5442	7488	800	8288	20983	39.5%	9.75%	25	25
14	雲林縣四湖鄉	2018-11-24T22:57:51+08:00	2046	5442	7488	800	8288	20983	39.5%	9.75%	25	25
14	雲林縣四湖鄉	2018-11-24T22:19:34+08:00	2046	5442	7488	800	8288	20983	39.5%	9.75%	25	25
14	雲林縣四湖鄉	2018-11-24T22:45:06+08:00	2046	5442	7488	800	8288	20983	39.5%	9.75%	25	25
14	雲林縣四湖鄉	2018-11-25T06:08:50+08:00	2046	5442	7488	800	8288	20983	39.5%	9.75%	25	25
14	雲林縣四湖鄉	2018-11-25T06:23:58+08:00	2046	5442	7488	800	8288	20983	39.5%	9.75%	25	25
14	雲林縣四湖鄉	2018-11-25T01:12:40+08:00	2046	5442	7488	800	8288	20983	39.5%	9.75%	25	25
14	雲林縣四湖鄉	2018-11-24T22:26:34+08:00	2046	5442	7488	800	8288	20983	39.5%	9.75%	25	25
14	雲林縣四湖鄉	2018-11-25T03:49:49+08:00	2046	5442	7488	800	8288	20983	39.5%	9.75%	25	25
14	雲林縣四湖鄉	2018-11-24T23:39:12+08:00	2046	5442	7488	800	8288	20983	39.5%	9.75%	25	25
14	雲林縣四湖鄉	2018-11-24T22:50:45+08:00	2046	5442	7488	800	8288	20983	39.5%	9.75%	25	25
14	雲林縣四湖鄉	2018-11-24T23:12:13+08:00	2046	5442	7488	800	8288	20983	39.5%	9.75%	25	25
14	雲林縣四湖鄉	2018-11-25T04:02:50+08:00	2046	5442	7488	800	8288	20983	39.5%	9.75%	25	25
14	雲林縣四湖鄉	2018-11-24T23:31:08+08:00	2046	5442	7488	800	8288	20983	39.5%	9.75%	25	25
14	雲林縣四湖鄉	2018-11-24T23:43:15+08:00	2046	5442	7488	800	8288	20983	39.5%	9.75%	25	25
14	雲林縣四湖鄉	2018-11-24T23:01:28+08:00	2046	5442	7488	800	8288	20983	39.5%	9.75%	25	25
14	雲林縣四湖鄉	2018-11-25T06:29:14+08:00	2046	5442	7488	800	8288	20983	39.5%	9.75%	25	25
14	雲林縣四湖鄉	2018-11-25T00:14:07+08:00	2046	5442	7488	800	8288	20983	39.5%	9.75%	25	25
14	雲林縣四湖鄉	2018-11-25T01:07:23+08:00	2046	5442	7488	800	8288	20983	39.5%	9.75%	25	25
14	雲林縣四湖鄉	2018-11-25T06:13:50+08:00	2046	5442	7488	800	8288	20983	39.5%	9.75%	25	25
14	雲林縣四湖鄉	2018-11-24T23:35:08+08:00	2046	5442	7488	800	8288	20983	39.5%	9.75%	25	25
14	雲林縣四湖鄉	2018-11-24T22:33:35+08:00	2046	5442	7488	800	8288	20983	39.5%	9.75%	25	25
14	雲林縣四湖鄉	2018-11-24T23:08:33+08:00	2046	5442	7488	800	8288	20983	39.5%	9.75%	25	25
14	雲林縣四湖鄉	2018-11-25T03:32:32+08:00	2046	5442	7488	800	8288	20983	39.5%	9.75%	25	25
14	雲林縣四湖鄉	2018-11-25T03:44:20+08:00	2046	5442	7488	800	8288	20983	39.5%	9.75%	25	25
14	雲林縣四湖鄉	2018-11-24T22:13:24+08:00	2046	5442	7488	800	8288	20983	39.5%	9.75%	25	25
14	雲林縣四湖鄉	2018-11-25T00:00:08+08:00	2046	5442	7488	800	8288	20983	39.5%	9.75%	25	25
14	雲林縣四湖鄉	2018-11-24T23:55:44+08:00	2046	5442	7488	800	8288	20983	39.5%	9.75%	25	25
14	雲林縣四湖鄉	2018-11-25T01:17:49+08:00	2046	5442	7488	800	8288	20983	39.5%	9.75%	25	25
14	雲林縣四湖鄉	2018-11-24T23:19:47+08:00	2046	5442	7488	800	8288	20983	39.5%	9.75%	25	25
14	雲林縣四湖鄉	2018-11-25T06:18:55+08:00	2046	5442	7488	800	8288	20983	39.5%	9.75%	25	25
14	雲林縣四湖鄉	2018-11-25T01:02:28+08:00	2046	5442	7488	800	8288	20983	39.5%	9.75%	25	25
14	雲林縣四湖鄉	2018-11-24T23:27:16+08:00	2046	5442	7488	800	8288	20983	39.5%	9.75%	25	25
14	雲林縣四湖鄉	2018-11-24T22:40:25+08:00	2046	5442	7488	800	8288	20983	39.5%	9.75%	25	25
14	雲林縣四湖鄉	2018-11-24T22:23:10+08:00	2046	5442	7488	800	8288	20983	39.5%	9.75%	25	25
14	雲林縣四湖鄉	2018-11-24T22:30:03+08:00	2046	5442	7488	800	8288	20983	39.5%	9.75%	25	25
14	雲林縣四湖鄉	2018-11-24T23:51:32+08:00	2046	5442	7488	800	8288	20983	39.5%	9.75%	25	25
14	雲林縣四湖鄉	2018-11-25T00:05:02+08:00	2046	5442	7488	800	8288	20983	39.5%	9.75%	25	25
14	雲林縣四湖鄉	2018-11-24T22:41:32+08:00	2046	5442	7488	800	8288	20983	39.5%	9.75%	25	25
14	雲林縣四湖鄉	2018-11-25T00:09:31+08:00	2046	5442	7488	800	8288	20983	39.5%	9.75%	25	25
14	雲林縣四湖鄉	2018-11-24T22:54:23+08:00	2046	5442	7488	800	8288	20983	39.5%	9.75%	25	25
14	雲林縣四湖鄉	2018-11-24T23:05:02+08:00	2046	5442	7488	800	8288	20983	39.5%	9.75%	25	25
14	雲林縣四湖鄉	2018-11-25T03:56:09+08:00	2046	5442	7488	800	8288	20983	39.5%	9.75%	25	25
14	雲林縣四湖鄉	2018-11-25T00:18:27+08:00	2046	5442	7488	800	8288	20983	39.5%	9.75%	25	25
14	雲林縣大埤鄉	2018-11-24T23:16:00+08:00	2326	5471	7797	685	8482	16509	51.38%	14.09%	18	18
14	雲林縣大埤鄉	2018-11-24T22:16:07+08:00	2018	4783	6801	594	7395	14131	52.33%	14.28%	16	18
14	雲林縣大埤鄉	2018-11-25T01:25:50+08:00	2326	5471	7797	685	8482	16509	51.38%	14.09%	18	18
14	雲林縣大埤鄉	2018-11-25T00:23:01+08:00	2326	5471	7797	685	8482	16509	51.38%	14.09%	18	18
14	雲林縣大埤鄉	2018-11-25T03:38:52+08:00	2326	5471	7797	685	8482	16509	51.38%	14.09%	18	18
14	雲林縣大埤鄉	2018-11-24T22:57:50+08:00	2326	5471	7797	685	8482	16509	51.38%	14.09%	18	18
14	雲林縣大埤鄉	2018-11-25T00:57:34+08:00	2326	5471	7797	685	8482	16509	51.38%	14.09%	18	18
14	雲林縣大埤鄉	2018-11-24T22:36:58+08:00	2326	5471	7797	685	8482	16509	51.38%	14.09%	18	18
14	雲林縣大埤鄉	2018-11-24T22:19:34+08:00	2018	4783	6801	594	7395	14131	52.33%	14.28%	16	18
14	雲林縣大埤鄉	2018-11-24T22:45:06+08:00	2326	5471	7797	685	8482	16509	51.38%	14.09%	18	18
14	雲林縣大埤鄉	2018-11-25T01:12:40+08:00	2326	5471	7797	685	8482	16509	51.38%	14.09%	18	18
14	雲林縣大埤鄉	2018-11-24T22:26:34+08:00	2152	5014	7166	620	7786	15079	51.63%	14.27%	17	18
14	雲林縣大埤鄉	2018-11-25T06:23:57+08:00	2326	5471	7797	685	8482	16509	51.38%	14.09%	18	18
14	雲林縣大埤鄉	2018-11-24T23:39:12+08:00	2326	5471	7797	685	8482	16509	51.38%	14.09%	18	18
14	雲林縣大埤鄉	2018-11-24T22:50:45+08:00	2326	5471	7797	685	8482	16509	51.38%	14.09%	18	18
14	雲林縣大埤鄉	2018-11-24T23:12:13+08:00	2326	5471	7797	685	8482	16509	51.38%	14.09%	18	18
14	雲林縣大埤鄉	2018-11-25T03:49:48+08:00	2326	5471	7797	685	8482	16509	51.38%	14.09%	18	18
14	雲林縣大埤鄉	2018-11-24T23:31:08+08:00	2326	5471	7797	685	8482	16509	51.38%	14.09%	18	18
14	雲林縣大埤鄉	2018-11-24T23:01:28+08:00	2326	5471	7797	685	8482	16509	51.38%	14.09%	18	18
14	雲林縣大埤鄉	2018-11-24T23:47:25+08:00	2326	5471	7797	685	8482	16509	51.38%	14.09%	18	18
14	雲林縣大埤鄉	2018-11-25T06:29:14+08:00	2326	5471	7797	685	8482	16509	51.38%	14.09%	18	18
14	雲林縣大埤鄉	2018-11-24T23:35:07+08:00	2326	5471	7797	685	8482	16509	51.38%	14.09%	18	18
14	雲林縣大埤鄉	2018-11-25T01:07:23+08:00	2326	5471	7797	685	8482	16509	51.38%	14.09%	18	18
14	雲林縣大埤鄉	2018-11-24T23:43:14+08:00	2326	5471	7797	685	8482	16509	51.38%	14.09%	18	18
14	雲林縣大埤鄉	2018-11-25T06:13:50+08:00	2326	5471	7797	685	8482	16509	51.38%	14.09%	18	18
14	雲林縣大埤鄉	2018-11-25T06:08:49+08:00	2326	5471	7797	685	8482	16509	51.38%	14.09%	18	18
14	雲林縣大埤鄉	2018-11-24T22:33:35+08:00	2152	5014	7166	620	7786	15079	51.63%	14.27%	17	18
14	雲林縣大埤鄉	2018-11-25T00:14:06+08:00	2326	5471	7797	685	8482	16509	51.38%	14.09%	18	18
14	雲林縣大埤鄉	2018-11-25T04:02:48+08:00	2326	5471	7797	685	8482	16509	51.38%	14.09%	18	18
14	雲林縣大埤鄉	2018-11-25T00:00:07+08:00	2326	5471	7797	685	8482	16509	51.38%	14.09%	18	18
14	雲林縣大埤鄉	2018-11-24T23:08:33+08:00	2326	5471	7797	685	8482	16509	51.38%	14.09%	18	18
14	雲林縣大埤鄉	2018-11-25T03:32:32+08:00	2326	5471	7797	685	8482	16509	51.38%	14.09%	18	18
14	雲林縣大埤鄉	2018-11-24T23:23:35+08:00	2326	5471	7797	685	8482	16509	51.38%	14.09%	18	18
14	雲林縣大埤鄉	2018-11-24T22:13:24+08:00	2018	4783	6801	594	7395	14131	52.33%	14.28%	16	18
14	雲林縣大埤鄉	2018-11-24T23:55:44+08:00	2326	5471	7797	685	8482	16509	51.38%	14.09%	18	18
14	雲林縣大埤鄉	2018-11-25T01:17:49+08:00	2326	5471	7797	685	8482	16509	51.38%	14.09%	18	18
14	雲林縣大埤鄉	2018-11-24T23:19:47+08:00	2326	5471	7797	685	8482	16509	51.38%	14.09%	18	18
14	雲林縣大埤鄉	2018-11-25T03:44:19+08:00	2326	5471	7797	685	8482	16509	51.38%	14.09%	18	18
14	雲林縣大埤鄉	2018-11-25T01:02:27+08:00	2326	5471	7797	685	8482	16509	51.38%	14.09%	18	18
14	雲林縣大埤鄉	2018-11-24T23:27:16+08:00	2326	5471	7797	685	8482	16509	51.38%	14.09%	18	18
14	雲林縣大埤鄉	2018-11-24T22:40:25+08:00	2326	5471	7797	685	8482	16509	51.38%	14.09%	18	18
14	雲林縣大埤鄉	2018-11-24T22:23:10+08:00	2018	4783	6801	594	7395	14131	52.33%	14.28%	16	18
14	雲林縣大埤鄉	2018-11-24T22:30:03+08:00	2152	5014	7166	620	7786	15079	51.63%	14.27%	17	18
14	雲林縣大埤鄉	2018-11-25T06:18:54+08:00	2326	5471	7797	685	8482	16509	51.38%	14.09%	18	18
14	雲林縣大埤鄉	2018-11-24T23:51:32+08:00	2326	5471	7797	685	8482	16509	51.38%	14.09%	18	18
14	雲林縣大埤鄉	2018-11-25T00:05:02+08:00	2326	5471	7797	685	8482	16509	51.38%	14.09%	18	18
14	雲林縣大埤鄉	2018-11-24T22:41:32+08:00	2326	5471	7797	685	8482	16509	51.38%	14.09%	18	18
14	雲林縣大埤鄉	2018-11-25T00:09:31+08:00	2326	5471	7797	685	8482	16509	51.38%	14.09%	18	18
14	雲林縣大埤鄉	2018-11-24T22:54:23+08:00	2326	5471	7797	685	8482	16509	51.38%	14.09%	18	18
14	雲林縣大埤鄉	2018-11-24T23:05:02+08:00	2326	5471	7797	685	8482	16509	51.38%	14.09%	18	18
14	雲林縣大埤鄉	2018-11-25T03:56:09+08:00	2326	5471	7797	685	8482	16509	51.38%	14.09%	18	18
14	雲林縣大埤鄉	2018-11-25T00:18:27+08:00	2326	5471	7797	685	8482	16509	51.38%	14.09%	18	18
14	澎湖縣白沙鄉	2018-11-24T22:33:39+08:00	563	1633	2196	168	2364	5491	43.05%	10.25%	13	15
14	澎湖縣白沙鄉	2018-11-25T03:49:52+08:00	886	2483	3369	287	3656	8625	42.39%	10.27%	15	15
14	澎湖縣白沙鄉	2018-11-24T23:43:18+08:00	886	2483	3369	287	3656	8625	42.39%	10.27%	15	15
14	澎湖縣白沙鄉	2018-11-24T23:47:29+08:00	886	2483	3369	287	3656	8625	42.39%	10.27%	15	15
14	澎湖縣白沙鄉	2018-11-25T06:29:18+08:00	886	2483	3369	287	3656	8625	42.39%	10.27%	15	15
14	澎湖縣白沙鄉	2018-11-25T01:07:27+08:00	886	2483	3369	287	3656	8625	42.39%	10.27%	15	15
14	澎湖縣白沙鄉	2018-11-25T06:13:53+08:00	886	2483	3369	287	3656	8625	42.39%	10.27%	15	15
14	澎湖縣白沙鄉	2018-11-25T00:18:31+08:00	886	2483	3369	287	3656	8625	42.39%	10.27%	15	15
14	澎湖縣白沙鄉	2018-11-24T22:37:01+08:00	563	1633	2196	168	2364	5491	43.05%	10.25%	13	15
14	澎湖縣白沙鄉	2018-11-25T03:44:24+08:00	886	2483	3369	287	3656	8625	42.39%	10.27%	15	15
14	澎湖縣白沙鄉	2018-11-24T23:08:37+08:00	563	1633	2196	168	2364	5491	43.05%	10.25%	13	15
14	澎湖縣白沙鄉	2018-11-24T23:55:48+08:00	886	2483	3369	287	3656	8625	42.39%	10.27%	15	15
14	澎湖縣白沙鄉	2018-11-24T22:13:28+08:00	484	1455	1939	139	2078	4717	44.05%	10.26%	12	15
14	澎湖縣白沙鄉	2018-11-24T23:23:39+08:00	886	2483	3369	287	3656	8625	42.39%	10.27%	15	15
14	澎湖縣白沙鄉	2018-11-25T06:18:58+08:00	886	2483	3369	287	3656	8625	42.39%	10.27%	15	15
14	澎湖縣白沙鄉	2018-11-24T23:51:36+08:00	886	2483	3369	287	3656	8625	42.39%	10.27%	15	15
14	澎湖縣白沙鄉	2018-11-24T22:23:14+08:00	484	1455	1939	139	2078	4717	44.05%	10.26%	12	15
14	澎湖縣白沙鄉	2018-11-24T22:40:28+08:00	563	1633	2196	168	2364	5491	43.05%	10.25%	13	15
14	澎湖縣白沙鄉	2018-11-25T00:09:35+08:00	886	2483	3369	287	3656	8625	42.39%	10.27%	15	15
14	澎湖縣白沙鄉	2018-11-25T00:05:06+08:00	886	2483	3369	287	3656	8625	42.39%	10.27%	15	15
14	澎湖縣白沙鄉	2018-11-24T22:41:36+08:00	563	1633	2196	168	2364	5491	43.05%	10.25%	13	15
14	澎湖縣白沙鄉	2018-11-24T22:45:09+08:00	563	1633	2196	168	2364	5491	43.05%	10.25%	13	15
14	澎湖縣白沙鄉	2018-11-24T22:54:26+08:00	563	1633	2196	168	2364	5491	43.05%	10.25%	13	15
14	澎湖縣白沙鄉	2018-11-25T00:14:10+08:00	886	2483	3369	287	3656	8625	42.39%	10.27%	15	15
14	澎湖縣白沙鄉	2018-11-25T03:56:13+08:00	886	2483	3369	287	3656	8625	42.39%	10.27%	15	15
14	澎湖縣白沙鄉	2018-11-24T23:16:04+08:00	746	2199	2945	210	3155	7196	43.84%	10.37%	14	15
14	澎湖縣白沙鄉	2018-11-25T03:32:35+08:00	886	2483	3369	287	3656	8625	42.39%	10.27%	15	15
14	澎湖縣白沙鄉	2018-11-25T01:25:53+08:00	886	2483	3369	287	3656	8625	42.39%	10.27%	15	15
14	澎湖縣白沙鄉	2018-11-25T01:02:32+08:00	886	2483	3369	287	3656	8625	42.39%	10.27%	15	15
14	澎湖縣白沙鄉	2018-11-24T22:30:10+08:00	484	1455	1939	139	2078	4717	44.05%	10.26%	12	15
14	澎湖縣白沙鄉	2018-11-25T00:23:04+08:00	886	2483	3369	287	3656	8625	42.39%	10.27%	15	15
14	澎湖縣白沙鄉	2018-11-25T06:24:01+08:00	886	2483	3369	287	3656	8625	42.39%	10.27%	15	15
14	澎湖縣白沙鄉	2018-11-25T03:38:56+08:00	886	2483	3369	287	3656	8625	42.39%	10.27%	15	15
14	澎湖縣白沙鄉	2018-11-24T23:27:19+08:00	886	2483	3369	287	3656	8625	42.39%	10.27%	15	15
14	澎湖縣白沙鄉	2018-11-24T22:19:38+08:00	484	1455	1939	139	2078	4717	44.05%	10.26%	12	15
14	澎湖縣白沙鄉	2018-11-25T01:17:53+08:00	886	2483	3369	287	3656	8625	42.39%	10.27%	15	15
14	澎湖縣白沙鄉	2018-11-25T00:00:12+08:00	886	2483	3369	287	3656	8625	42.39%	10.27%	15	15
14	澎湖縣白沙鄉	2018-11-24T22:57:55+08:00	563	1633	2196	168	2364	5491	43.05%	10.25%	13	15
14	澎湖縣白沙鄉	2018-11-24T23:19:52+08:00	746	2199	2945	210	3155	7196	43.84%	10.37%	14	15
14	澎湖縣白沙鄉	2018-11-25T00:57:38+08:00	886	2483	3369	287	3656	8625	42.39%	10.27%	15	15
14	澎湖縣白沙鄉	2018-11-24T23:35:12+08:00	886	2483	3369	287	3656	8625	42.39%	10.27%	15	15
14	澎湖縣白沙鄉	2018-11-25T06:08:54+08:00	886	2483	3369	287	3656	8625	42.39%	10.27%	15	15
14	澎湖縣白沙鄉	2018-11-24T23:12:16+08:00	563	1633	2196	168	2364	5491	43.05%	10.25%	13	15
14	澎湖縣白沙鄉	2018-11-24T23:39:17+08:00	886	2483	3369	287	3656	8625	42.39%	10.27%	15	15
14	澎湖縣白沙鄉	2018-11-25T01:12:44+08:00	886	2483	3369	287	3656	8625	42.39%	10.27%	15	15
14	澎湖縣白沙鄉	2018-11-24T22:50:49+08:00	563	1633	2196	168	2364	5491	43.05%	10.25%	13	15
14	澎湖縣白沙鄉	2018-11-24T22:26:37+08:00	484	1455	1939	139	2078	4717	44.05%	10.26%	12	15
14	澎湖縣白沙鄉	2018-11-25T04:02:53+08:00	886	2483	3369	287	3656	8625	42.39%	10.27%	15	15
14	澎湖縣白沙鄉	2018-11-24T23:05:05+08:00	563	1633	2196	168	2364	5491	43.05%	10.25%	13	15
14	澎湖縣白沙鄉	2018-11-24T23:31:12+08:00	886	2483	3369	287	3656	8625	42.39%	10.27%	15	15
14	澎湖縣白沙鄉	2018-11-24T22:16:11+08:00	484	1455	1939	139	2078	4717	44.05%	10.26%	12	15
14	澎湖縣白沙鄉	2018-11-24T23:01:32+08:00	563	1633	2196	168	2364	5491	43.05%	10.25%	13	15
14	苗栗縣	2018-11-25T04:02:44+08:00	69712	177248	246960	15666	262626	461580	56.9%	15.1%	470	470
14	苗栗縣	2018-11-25T00:14:04+08:00	69436	176771	246207	15635	261842	460092	56.91%	15.09%	469	470
14	苗栗縣	2018-11-24T23:31:05+08:00	68217	174005	242222	15431	257653	452669	56.92%	15.07%	463	470
14	苗栗縣	2018-11-25T01:07:21+08:00	69712	177248	246960	15666	262626	461580	56.9%	15.1%	470	470
14	苗栗縣	2018-11-25T01:12:38+08:00	69712	177248	246960	15666	262626	461580	56.9%	15.1%	470	470
14	苗栗縣	2018-11-25T00:09:28+08:00	69436	176771	246207	15635	261842	460092	56.91%	15.09%	469	470
14	苗栗縣	2018-11-24T23:19:45+08:00	67758	173007	240765	15371	256136	449939	56.93%	15.06%	461	470
14	苗栗縣	2018-11-24T22:23:07+08:00	50472	129777	180249	11808	192057	337366	56.93%	14.96%	367	470
14	苗栗縣	2018-11-25T00:00:03+08:00	69241	176312	245553	15584	261137	458997	56.89%	15.09%	468	470
14	苗栗縣	2018-11-24T23:08:30+08:00	64644	164894	229538	14684	244222	428693	56.97%	15.08%	444	470
14	苗栗縣	2018-11-24T22:13:21+08:00	47102	121228	168330	11164	179494	315963	56.81%	14.91%	348	470
14	苗栗縣	2018-11-25T03:32:30+08:00	69712	177248	246960	15666	262626	461580	56.9%	15.1%	470	470
14	苗栗縣	2018-11-24T23:51:30+08:00	69059	175863	244922	15553	260475	457856	56.89%	15.08%	467	470
14	苗栗縣	2018-11-24T22:30:01+08:00	52982	135780	188762	12249	201011	353273	56.9%	15%	381	470
14	苗栗縣	2018-11-24T23:27:14+08:00	67948	173522	241470	15401	256871	451125	56.94%	15.06%	462	470
14	苗栗縣	2018-11-24T22:19:32+08:00	49336	126733	176069	11604	187673	329931	56.88%	14.95%	360	470
14	苗栗縣	2018-11-25T00:57:32+08:00	69436	176771	246207	15635	261842	460092	56.91%	15.09%	469	470
14	苗栗縣	2018-11-24T22:36:56+08:00	55710	142802	198512	12851	211363	370890	56.99%	15.02%	396	470
14	苗栗縣	2018-11-25T00:18:25+08:00	69436	176771	246207	15635	261842	460092	56.91%	15.09%	469	470
14	苗栗縣	2018-11-24T23:05:00+08:00	63421	162331	225752	14442	240194	421720	56.96%	15.04%	438	470
14	苗栗縣	2018-11-25T03:49:47+08:00	69712	177248	246960	15666	262626	461580	56.9%	15.1%	470	470
14	苗栗縣	2018-11-24T22:26:32+08:00	51559	132418	183977	11974	195951	344287	56.92%	14.98%	373	470
14	苗栗縣	2018-11-25T06:13:48+08:00	69712	177248	246960	15666	262626	461580	56.9%	15.1%	470	470
14	苗栗縣	2018-11-24T22:50:42+08:00	59247	151878	211125	13585	224710	394417	56.97%	15.02%	416	470
14	苗栗縣	2018-11-24T22:54:21+08:00	60084	153919	214003	13777	227780	399892	56.96%	15.03%	421	470
14	苗栗縣	2018-11-25T00:05:00+08:00	69241	176312	245553	15584	261137	458997	56.89%	15.09%	468	470
14	苗栗縣	2018-11-24T22:41:30+08:00	56656	145214	201870	13037	214907	377216	56.97%	15.02%	402	470
14	苗栗縣	2018-11-25T00:22:59+08:00	69436	176771	246207	15635	261842	460092	56.91%	15.09%	469	470
14	苗栗縣	2018-11-24T22:16:05+08:00	48551	124738	173289	11423	184712	324943	56.84%	14.94%	355	470
14	苗栗縣	2018-11-24T23:01:26+08:00	62436	159820	222256	14231	236487	415343	56.94%	15.03%	433	470
14	苗栗縣	2018-11-24T23:43:12+08:00	68895	175589	244484	15526	260010	456783	56.92%	15.08%	466	470
14	苗栗縣	2018-11-24T22:33:33+08:00	54640	139959	194599	12647	207246	363581	57%	15.03%	390	470
14	苗栗縣	2018-11-25T06:08:47+08:00	69712	177248	246960	15666	262626	461580	56.9%	15.1%	470	470
14	苗栗縣	2018-11-24T23:35:06+08:00	68673	175074	243747	15492	259239	455445	56.92%	15.08%	465	470
14	苗栗縣	2018-11-24T23:47:23+08:00	68895	175589	244484	15526	260010	456783	56.92%	15.08%	466	470
14	苗栗縣	2018-11-25T06:29:12+08:00	69712	177248	246960	15666	262626	461580	56.9%	15.1%	470	470
14	苗栗縣	2018-11-24T23:55:42+08:00	69241	176312	245553	15584	261137	458997	56.89%	15.09%	468	470
14	苗栗縣	2018-11-25T01:17:46+08:00	69712	177248	246960	15666	262626	461580	56.9%	15.1%	470	470
14	苗栗縣	2018-11-24T22:57:48+08:00	61958	158786	220744	14161	234905	412610	56.93%	15.02%	431	470
14	苗栗縣	2018-11-25T03:38:50+08:00	69712	177248	246960	15666	262626	461580	56.9%	15.1%	470	470
14	苗栗縣	2018-11-24T23:23:34+08:00	67758	173007	240765	15371	256136	449939	56.93%	15.06%	461	470
14	苗栗縣	2018-11-25T03:44:17+08:00	69712	177248	246960	15666	262626	461580	56.9%	15.1%	470	470
14	苗栗縣	2018-11-25T01:25:48+08:00	69712	177248	246960	15666	262626	461580	56.9%	15.1%	470	470
14	苗栗縣	2018-11-24T22:40:23+08:00	56656	145214	201870	13037	214907	377216	56.97%	15.02%	402	470
14	苗栗縣	2018-11-24T23:15:58+08:00	66541	169632	236173	15144	251317	441049	56.98%	15.09%	455	470
14	苗栗縣	2018-11-25T01:02:26+08:00	69712	177248	246960	15666	262626	461580	56.9%	15.1%	470	470
14	苗栗縣	2018-11-25T06:18:53+08:00	69712	177248	246960	15666	262626	461580	56.9%	15.1%	470	470
14	苗栗縣	2018-11-25T06:23:55+08:00	69712	177248	246960	15666	262626	461580	56.9%	15.1%	470	470
14	苗栗縣	2018-11-24T23:39:10+08:00	68673	175074	243747	15492	259239	455445	56.92%	15.08%	465	470
14	苗栗縣	2018-11-25T03:56:07+08:00	69712	177248	246960	15666	262626	461580	56.9%	15.1%	470	470
14	苗栗縣	2018-11-24T22:45:04+08:00	57769	148006	205775	13255	219030	384725	56.93%	15.02%	408	470
14	苗栗縣	2018-11-24T23:12:10+08:00	65447	166867	232314	14862	247176	433786	56.98%	15.09%	449	470
14	苗栗縣銅鑼鄉	2018-11-25T04:02:44+08:00	2188	5976	8164	486	8650	15424	56.08%	14.19%	16	16
14	苗栗縣銅鑼鄉	2018-11-25T00:09:29+08:00	2188	5976	8164	486	8650	15424	56.08%	14.19%	16	16
14	苗栗縣銅鑼鄉	2018-11-25T01:12:38+08:00	2188	5976	8164	486	8650	15424	56.08%	14.19%	16	16
14	苗栗縣銅鑼鄉	2018-11-25T00:14:05+08:00	2188	5976	8164	486	8650	15424	56.08%	14.19%	16	16
14	苗栗縣銅鑼鄉	2018-11-24T23:19:45+08:00	2188	5976	8164	486	8650	15424	56.08%	14.19%	16	16
14	苗栗縣銅鑼鄉	2018-11-25T00:00:03+08:00	2188	5976	8164	486	8650	15424	56.08%	14.19%	16	16
14	苗栗縣銅鑼鄉	2018-11-24T22:23:08+08:00	2188	5976	8164	486	8650	15424	56.08%	14.19%	16	16
14	苗栗縣銅鑼鄉	2018-11-24T23:08:31+08:00	2188	5976	8164	486	8650	15424	56.08%	14.19%	16	16
14	苗栗縣銅鑼鄉	2018-11-25T03:32:30+08:00	2188	5976	8164	486	8650	15424	56.08%	14.19%	16	16
14	苗栗縣銅鑼鄉	2018-11-24T23:51:30+08:00	2188	5976	8164	486	8650	15424	56.08%	14.19%	16	16
14	苗栗縣銅鑼鄉	2018-11-24T22:30:01+08:00	2188	5976	8164	486	8650	15424	56.08%	14.19%	16	16
14	苗栗縣銅鑼鄉	2018-11-24T23:27:14+08:00	2188	5976	8164	486	8650	15424	56.08%	14.19%	16	16
14	苗栗縣銅鑼鄉	2018-11-24T22:19:33+08:00	2188	5976	8164	486	8650	15424	56.08%	14.19%	16	16
14	苗栗縣銅鑼鄉	2018-11-25T00:57:32+08:00	2188	5976	8164	486	8650	15424	56.08%	14.19%	16	16
14	苗栗縣銅鑼鄉	2018-11-24T22:36:56+08:00	2188	5976	8164	486	8650	15424	56.08%	14.19%	16	16
14	苗栗縣銅鑼鄉	2018-11-24T22:50:43+08:00	2188	5976	8164	486	8650	15424	56.08%	14.19%	16	16
14	苗栗縣銅鑼鄉	2018-11-25T00:18:25+08:00	2188	5976	8164	486	8650	15424	56.08%	14.19%	16	16
14	苗栗縣銅鑼鄉	2018-11-25T06:23:56+08:00	2188	5976	8164	486	8650	15424	56.08%	14.19%	16	16
14	苗栗縣銅鑼鄉	2018-11-24T22:26:33+08:00	2188	5976	8164	486	8650	15424	56.08%	14.19%	16	16
14	苗栗縣銅鑼鄉	2018-11-24T23:05:00+08:00	2188	5976	8164	486	8650	15424	56.08%	14.19%	16	16
14	苗栗縣銅鑼鄉	2018-11-25T03:49:47+08:00	2188	5976	8164	486	8650	15424	56.08%	14.19%	16	16
14	苗栗縣銅鑼鄉	2018-11-24T22:41:31+08:00	2188	5976	8164	486	8650	15424	56.08%	14.19%	16	16
14	苗栗縣銅鑼鄉	2018-11-25T00:05:01+08:00	2188	5976	8164	486	8650	15424	56.08%	14.19%	16	16
14	苗栗縣銅鑼鄉	2018-11-25T06:13:48+08:00	2188	5976	8164	486	8650	15424	56.08%	14.19%	16	16
14	苗栗縣銅鑼鄉	2018-11-25T00:22:59+08:00	2188	5976	8164	486	8650	15424	56.08%	14.19%	16	16
14	苗栗縣銅鑼鄉	2018-11-24T23:31:06+08:00	2188	5976	8164	486	8650	15424	56.08%	14.19%	16	16
14	苗栗縣銅鑼鄉	2018-11-24T22:16:05+08:00	2188	5976	8164	486	8650	15424	56.08%	14.19%	16	16
14	苗栗縣銅鑼鄉	2018-11-25T01:07:22+08:00	2188	5976	8164	486	8650	15424	56.08%	14.19%	16	16
14	苗栗縣銅鑼鄉	2018-11-24T22:33:33+08:00	2188	5976	8164	486	8650	15424	56.08%	14.19%	16	16
14	苗栗縣銅鑼鄉	2018-11-24T23:43:13+08:00	2188	5976	8164	486	8650	15424	56.08%	14.19%	16	16
14	苗栗縣銅鑼鄉	2018-11-25T06:08:47+08:00	2188	5976	8164	486	8650	15424	56.08%	14.19%	16	16
14	苗栗縣銅鑼鄉	2018-11-24T23:01:27+08:00	2188	5976	8164	486	8650	15424	56.08%	14.19%	16	16
14	苗栗縣銅鑼鄉	2018-11-24T23:35:06+08:00	2188	5976	8164	486	8650	15424	56.08%	14.19%	16	16
14	苗栗縣銅鑼鄉	2018-11-25T06:29:12+08:00	2188	5976	8164	486	8650	15424	56.08%	14.19%	16	16
14	苗栗縣銅鑼鄉	2018-11-24T23:47:24+08:00	2188	5976	8164	486	8650	15424	56.08%	14.19%	16	16
14	苗栗縣銅鑼鄉	2018-11-24T23:55:42+08:00	2188	5976	8164	486	8650	15424	56.08%	14.19%	16	16
14	苗栗縣銅鑼鄉	2018-11-24T22:57:48+08:00	2188	5976	8164	486	8650	15424	56.08%	14.19%	16	16
14	苗栗縣銅鑼鄉	2018-11-24T23:23:34+08:00	2188	5976	8164	486	8650	15424	56.08%	14.19%	16	16
14	苗栗縣銅鑼鄉	2018-11-25T03:38:51+08:00	2188	5976	8164	486	8650	15424	56.08%	14.19%	16	16
14	苗栗縣銅鑼鄉	2018-11-24T22:13:22+08:00	2188	5976	8164	486	8650	15424	56.08%	14.19%	16	16
14	苗栗縣銅鑼鄉	2018-11-25T01:17:47+08:00	2188	5976	8164	486	8650	15424	56.08%	14.19%	16	16
14	苗栗縣銅鑼鄉	2018-11-25T03:44:17+08:00	2188	5976	8164	486	8650	15424	56.08%	14.19%	16	16
14	苗栗縣銅鑼鄉	2018-11-25T01:25:48+08:00	2188	5976	8164	486	8650	15424	56.08%	14.19%	16	16
14	苗栗縣銅鑼鄉	2018-11-24T22:40:24+08:00	2188	5976	8164	486	8650	15424	56.08%	14.19%	16	16
14	苗栗縣銅鑼鄉	2018-11-24T23:15:58+08:00	2188	5976	8164	486	8650	15424	56.08%	14.19%	16	16
14	苗栗縣銅鑼鄉	2018-11-25T01:02:26+08:00	2188	5976	8164	486	8650	15424	56.08%	14.19%	16	16
14	苗栗縣銅鑼鄉	2018-11-25T06:18:53+08:00	2188	5976	8164	486	8650	15424	56.08%	14.19%	16	16
14	苗栗縣銅鑼鄉	2018-11-24T23:12:11+08:00	2188	5976	8164	486	8650	15424	56.08%	14.19%	16	16
14	苗栗縣銅鑼鄉	2018-11-24T23:39:10+08:00	2188	5976	8164	486	8650	15424	56.08%	14.19%	16	16
14	苗栗縣銅鑼鄉	2018-11-25T03:56:07+08:00	2188	5976	8164	486	8650	15424	56.08%	14.19%	16	16
14	苗栗縣銅鑼鄉	2018-11-24T22:45:04+08:00	2188	5976	8164	486	8650	15424	56.08%	14.19%	16	16
14	苗栗縣銅鑼鄉	2018-11-24T22:54:22+08:00	2188	5976	8164	486	8650	15424	56.08%	14.19%	16	16
14	高雄市林園區	2018-11-25T06:29:10+08:00	9748	21186	30934	1974	32908	59129	55.65%	16.49%	51	51
14	高雄市林園區	2018-11-25T00:14:03+08:00	9748	21186	30934	1974	32908	59129	55.65%	16.49%	51	51
14	高雄市林園區	2018-11-24T23:01:25+08:00	9490	20581	30071	1947	32018	57644	55.54%	16.46%	50	51
14	高雄市林園區	2018-11-24T23:12:09+08:00	9490	20581	30071	1947	32018	57644	55.54%	16.46%	50	51
14	高雄市林園區	2018-11-25T06:08:45+08:00	9748	21186	30934	1974	32908	59129	55.65%	16.49%	51	51
14	高雄市林園區	2018-11-24T23:43:11+08:00	9490	20581	30071	1947	32018	57644	55.54%	16.46%	50	51
14	高雄市林園區	2018-11-24T23:39:08+08:00	9490	20581	30071	1947	32018	57644	55.54%	16.46%	50	51
14	高雄市林園區	2018-11-25T00:09:27+08:00	9748	21186	30934	1974	32908	59129	55.65%	16.49%	51	51
14	高雄市林園區	2018-11-25T01:12:36+08:00	9748	21186	30934	1974	32908	59129	55.65%	16.49%	51	51
14	高雄市林園區	2018-11-25T04:02:42+08:00	9748	21186	30934	1974	32908	59129	55.65%	16.49%	51	51
14	高雄市林園區	2018-11-24T23:35:05+08:00	9490	20581	30071	1947	32018	57644	55.54%	16.46%	50	51
14	高雄市林園區	2018-11-25T01:07:20+08:00	9748	21186	30934	1974	32908	59129	55.65%	16.49%	51	51
14	高雄市林園區	2018-11-24T23:31:04+08:00	9490	20581	30071	1947	32018	57644	55.54%	16.46%	50	51
14	高雄市林園區	2018-11-25T03:44:15+08:00	9748	21186	30934	1974	32908	59129	55.65%	16.49%	51	51
14	高雄市林園區	2018-11-24T22:13:20+08:00	8313	18133	26446	1728	28174	50140	56.19%	16.58%	45	51
14	高雄市林園區	2018-11-24T23:55:41+08:00	9748	21186	30934	1974	32908	59129	55.65%	16.49%	51	51
14	高雄市林園區	2018-11-24T22:23:06+08:00	8313	18133	26446	1728	28174	50140	56.19%	16.58%	45	51
14	高雄市林園區	2018-11-24T23:19:43+08:00	9490	20581	30071	1947	32018	57644	55.54%	16.46%	50	51
14	高雄市林園區	2018-11-25T01:17:44+08:00	9748	21186	30934	1974	32908	59129	55.65%	16.49%	51	51
14	高雄市林園區	2018-11-24T23:04:58+08:00	9490	20581	30071	1947	32018	57644	55.54%	16.46%	50	51
14	高雄市林園區	2018-11-25T00:00:02+08:00	9748	21186	30934	1974	32908	59129	55.65%	16.49%	51	51
14	高雄市林園區	2018-11-25T00:04:59+08:00	9748	21186	30934	1974	32908	59129	55.65%	16.49%	51	51
14	高雄市林園區	2018-11-25T06:18:51+08:00	9748	21186	30934	1974	32908	59129	55.65%	16.49%	51	51
14	高雄市林園區	2018-11-25T01:02:24+08:00	9748	21186	30934	1974	32908	59129	55.65%	16.49%	51	51
14	高雄市林園區	2018-11-24T23:27:13+08:00	9490	20581	30071	1947	32018	57644	55.54%	16.46%	50	51
14	高雄市林園區	2018-11-25T03:38:49+08:00	9748	21186	30934	1974	32908	59129	55.65%	16.49%	51	51
14	高雄市林園區	2018-11-24T22:30:00+08:00	8313	18133	26446	1728	28174	50140	56.19%	16.58%	45	51
14	高雄市林園區	2018-11-24T22:54:20+08:00	8957	19506	28463	1881	30344	54368	55.81%	16.47%	48	51
14	高雄市林園區	2018-11-25T00:22:58+08:00	9748	21186	30934	1974	32908	59129	55.65%	16.49%	51	51
14	高雄市林園區	2018-11-25T03:56:05+08:00	9748	21186	30934	1974	32908	59129	55.65%	16.49%	51	51
14	高雄市林園區	2018-11-25T00:18:24+08:00	9748	21186	30934	1974	32908	59129	55.65%	16.49%	51	51
14	高雄市林園區	2018-11-25T06:13:46+08:00	9748	21186	30934	1974	32908	59129	55.65%	16.49%	51	51
14	高雄市林園區	2018-11-24T23:47:22+08:00	9490	20581	30071	1947	32018	57644	55.54%	16.46%	50	51
14	高雄市林園區	2018-11-24T22:41:29+08:00	8957	19506	28463	1881	30344	54368	55.81%	16.47%	48	51
14	高雄市林園區	2018-11-24T22:16:03+08:00	8313	18133	26446	1728	28174	50140	56.19%	16.58%	45	51
14	高雄市林園區	2018-11-24T22:33:32+08:00	8740	19028	27768	1821	29589	52988	55.84%	16.49%	47	51
14	高雄市林園區	2018-11-24T23:51:28+08:00	9748	21186	30934	1974	32908	59129	55.65%	16.49%	51	51
14	高雄市林園區	2018-11-24T23:23:33+08:00	9490	20581	30071	1947	32018	57644	55.54%	16.46%	50	51
14	高雄市林園區	2018-11-24T22:57:47+08:00	8957	19506	28463	1881	30344	54368	55.81%	16.47%	48	51
14	高雄市林園區	2018-11-25T01:25:46+08:00	9748	21186	30934	1974	32908	59129	55.65%	16.49%	51	51
14	高雄市林園區	2018-11-24T22:19:31+08:00	8313	18133	26446	1728	28174	50140	56.19%	16.58%	45	51
14	高雄市林園區	2018-11-25T00:57:30+08:00	9748	21186	30934	1974	32908	59129	55.65%	16.49%	51	51
14	高雄市林園區	2018-11-24T22:40:22+08:00	8957	19506	28463	1881	30344	54368	55.81%	16.47%	48	51
14	高雄市林園區	2018-11-24T22:36:55+08:00	8957	19506	28463	1881	30344	54368	55.81%	16.47%	48	51
14	高雄市林園區	2018-11-24T23:08:29+08:00	9490	20581	30071	1947	32018	57644	55.54%	16.46%	50	51
14	高雄市林園區	2018-11-24T23:15:57+08:00	9490	20581	30071	1947	32018	57644	55.54%	16.46%	50	51
14	高雄市林園區	2018-11-25T03:32:28+08:00	9748	21186	30934	1974	32908	59129	55.65%	16.49%	51	51
14	高雄市林園區	2018-11-25T03:49:45+08:00	9748	21186	30934	1974	32908	59129	55.65%	16.49%	51	51
14	高雄市林園區	2018-11-25T06:23:54+08:00	9748	21186	30934	1974	32908	59129	55.65%	16.49%	51	51
14	高雄市林園區	2018-11-24T22:26:31+08:00	8313	18133	26446	1728	28174	50140	56.19%	16.58%	45	51
14	高雄市林園區	2018-11-24T22:50:41+08:00	8957	19506	28463	1881	30344	54368	55.81%	16.47%	48	51
14	高雄市林園區	2018-11-24T22:45:03+08:00	8957	19506	28463	1881	30344	54368	55.81%	16.47%	48	51
14	高雄市左營區	2018-11-25T06:29:10+08:00	29870	64229	94099	4131	98230	161367	60.87%	18.51%	103	103
14	高雄市左營區	2018-11-24T23:35:04+08:00	16038	34819	50857	2397	53254	86847	61.32%	18.47%	63	103
14	高雄市左營區	2018-11-24T23:47:21+08:00	18181	39570	57751	2685	60436	98487	61.36%	18.46%	69	103
14	高雄市左營區	2018-11-25T00:14:03+08:00	21904	48327	70231	3160	73391	119702	61.31%	18.3%	81	103
14	高雄市左營區	2018-11-24T23:12:09+08:00	12988	28463	41451	2028	43479	71295	60.98%	18.22%	54	103
14	高雄市左營區	2018-11-25T06:08:45+08:00	29870	64229	94099	4131	98230	161367	60.87%	18.51%	103	103
14	高雄市左營區	2018-11-24T23:43:11+08:00	17833	38745	56578	2649	59227	96514	61.37%	18.48%	68	103
14	高雄市左營區	2018-11-24T22:33:31+08:00	7128	16542	23670	1296	24966	40941	60.98%	17.41%	36	103
14	高雄市左營區	2018-11-25T01:12:36+08:00	26643	57919	84562	3760	88322	144087	61.3%	18.49%	94	103
14	高雄市左營區	2018-11-25T04:02:42+08:00	29870	64229	94099	4131	98230	161367	60.87%	18.51%	103	103
14	高雄市左營區	2018-11-25T00:09:26+08:00	21587	47429	69016	3112	72128	117684	61.29%	18.34%	80	103
14	高雄市左營區	2018-11-25T01:07:20+08:00	26643	57919	84562	3760	88322	144087	61.3%	18.49%	94	103
14	高雄市左營區	2018-11-24T23:39:07+08:00	16234	35408	51642	2418	54060	88206	61.29%	18.4%	64	103
14	高雄市左營區	2018-11-24T23:31:03+08:00	15714	34203	49917	2368	52285	85346	61.26%	18.41%	62	103
14	高雄市左營區	2018-11-24T23:01:24+08:00	12216	26757	38973	1891	40864	67038	60.96%	18.22%	51	103
14	高雄市左營區	2018-11-25T03:44:15+08:00	29870	64229	94099	4131	98230	161367	60.87%	18.51%	103	103
14	高雄市左營區	2018-11-24T23:19:42+08:00	13711	29887	43598	2096	45694	74802	61.09%	18.33%	56	103
14	高雄市左營區	2018-11-24T22:13:20+08:00	5426	11883	17309	1017	18326	29804	61.49%	18.21%	29	103
14	高雄市左營區	2018-11-25T00:04:58+08:00	21270	46635	67905	3076	70981	115851	61.27%	18.36%	79	103
14	高雄市左營區	2018-11-24T23:55:41+08:00	20333	44574	64907	2944	67851	110915	61.17%	18.33%	76	103
14	高雄市左營區	2018-11-25T01:17:44+08:00	27484	59541	87025	3851	90876	148311	61.27%	18.53%	96	103
14	高雄市左營區	2018-11-24T23:04:58+08:00	12575	27501	40076	1913	41989	68904	60.94%	18.25%	52	103
14	高雄市左營區	2018-11-25T06:18:51+08:00	29870	64229	94099	4131	98230	161367	60.87%	18.51%	103	103
14	高雄市左營區	2018-11-25T01:02:24+08:00	26643	57919	84562	3760	88322	144087	61.3%	18.49%	94	103
14	高雄市左營區	2018-11-25T03:38:49+08:00	29870	64229	94099	4131	98230	161367	60.87%	18.51%	103	103
14	高雄市左營區	2018-11-24T23:27:12+08:00	14880	32200	47080	2186	49266	80413	61.27%	18.5%	59	103
14	高雄市左營區	2018-11-24T22:54:20+08:00	10448	23099	33547	1706	35253	57642	61.16%	18.13%	46	103
14	高雄市左營區	2018-11-25T00:18:23+08:00	21904	48327	70231	3160	73391	119702	61.31%	18.3%	81	103
14	高雄市左營區	2018-11-25T06:13:46+08:00	29870	64229	94099	4131	98230	161367	60.87%	18.51%	103	103
14	高雄市左營區	2018-11-25T00:22:57+08:00	22564	49719	72283	3271	75554	123276	61.29%	18.3%	83	103
14	高雄市左營區	2018-11-25T03:56:04+08:00	29870	64229	94099	4131	98230	161367	60.87%	18.51%	103	103
14	高雄市左營區	2018-11-24T22:41:29+08:00	8417	19217	27634	1463	29097	47503	61.25%	17.72%	40	103
14	高雄市左營區	2018-11-24T22:16:03+08:00	5933	13094	19027	1077	20104	32992	60.94%	17.98%	31	103
14	高雄市左營區	2018-11-24T22:29:59+08:00	6667	15223	21890	1230	23120	37846	61.09%	17.62%	34	103
14	高雄市左營區	2018-11-24T23:23:32+08:00	14880	32200	47080	2186	49266	80413	61.27%	18.5%	59	103
14	高雄市左營區	2018-11-24T23:51:28+08:00	19728	43033	62761	2876	65637	107147	61.26%	18.41%	74	103
14	高雄市左營區	2018-11-24T22:57:46+08:00	11531	25417	36948	1813	38761	63473	61.07%	18.17%	49	103
14	高雄市左營區	2018-11-25T00:00:01+08:00	21270	46635	67905	3076	70981	115851	61.27%	18.36%	79	103
14	高雄市左營區	2018-11-24T22:23:05+08:00	6501	14558	21059	1185	22244	36444	61.04%	17.84%	33	103
14	高雄市左營區	2018-11-24T22:36:54+08:00	8078	18614	26692	1433	28125	45965	61.19%	17.57%	39	103
14	高雄市左營區	2018-11-25T01:25:46+08:00	28066	60750	88816	3966	92782	152564	60.82%	18.4%	98	103
14	高雄市左營區	2018-11-24T22:19:31+08:00	5933	13094	19027	1077	20104	32992	60.94%	17.98%	31	103
14	高雄市左營區	2018-11-25T00:57:30+08:00	26643	57919	84562	3760	88322	144087	61.3%	18.49%	94	103
14	高雄市左營區	2018-11-24T23:08:28+08:00	12988	28463	41451	2028	43479	71295	60.98%	18.22%	54	103
14	高雄市左營區	2018-11-24T22:40:22+08:00	8417	19217	27634	1463	29097	47503	61.25%	17.72%	40	103
14	高雄市左營區	2018-11-24T23:15:57+08:00	13711	29887	43598	2096	45694	74802	61.09%	18.33%	56	103
14	高雄市左營區	2018-11-25T03:32:28+08:00	29870	64229	94099	4131	98230	161367	60.87%	18.51%	103	103
14	高雄市左營區	2018-11-24T22:45:02+08:00	8417	19217	27634	1463	29097	47503	61.25%	17.72%	40	103
14	高雄市左營區	2018-11-24T22:50:40+08:00	9405	21172	30577	1580	32157	52487	61.27%	17.92%	43	103
14	高雄市左營區	2018-11-25T03:49:45+08:00	29870	64229	94099	4131	98230	161367	60.87%	18.51%	103	103
14	高雄市左營區	2018-11-25T06:23:54+08:00	29870	64229	94099	4131	98230	161367	60.87%	18.51%	103	103
14	高雄市左營區	2018-11-24T22:26:31+08:00	6667	15223	21890	1230	23120	37846	61.09%	17.62%	34	103
14	桃園市平鎮區	2018-11-25T01:07:17+08:00	29045	64386	93431	4155	97586	183560	53.16%	15.82%	125	125
14	桃園市平鎮區	2018-11-24T23:01:22+08:00	22778	49952	72730	3295	76025	142183	53.47%	16.02%	99	125
14	桃園市平鎮區	2018-11-25T06:08:42+08:00	29045	64386	93431	4155	97586	183560	53.16%	15.82%	125	125
14	桃園市平鎮區	2018-11-24T23:47:18+08:00	26275	58022	84297	3808	88105	164986	53.4%	15.93%	114	125
14	桃園市平鎮區	2018-11-24T23:35:02+08:00	25497	56453	81950	3700	85650	160442	53.38%	15.89%	111	125
14	桃園市平鎮區	2018-11-24T23:12:06+08:00	23014	50553	73567	3333	76900	143819	53.47%	16%	100	125
14	桃園市平鎮區	2018-11-24T22:26:29+08:00	17313	37758	55071	2492	57563	106881	53.86%	16.2%	77	125
14	桃園市平鎮區	2018-11-24T22:16:00+08:00	16221	35347	51568	2337	53905	99914	53.95%	16.23%	73	125
14	桃園市平鎮區	2018-11-25T03:44:12+08:00	29045	64386	93431	4155	97586	183560	53.16%	15.82%	125	125
14	桃園市平鎮區	2018-11-25T00:04:56+08:00	27079	59806	86885	3910	90795	169841	53.46%	15.94%	117	125
14	桃園市平鎮區	2018-11-24T22:19:28+08:00	16544	35960	52504	2371	54875	101535	54.05%	16.29%	74	125
14	桃園市平鎮區	2018-11-24T22:57:44+08:00	22347	48862	71209	3197	74406	139160	53.47%	16.06%	97	125
14	桃園市平鎮區	2018-11-25T00:57:27+08:00	28762	63748	92510	4130	96640	181648	53.2%	15.83%	124	125
14	桃園市平鎮區	2018-11-24T22:13:17+08:00	15872	34478	50350	2262	52612	97668	53.87%	16.25%	71	125
14	桃園市平鎮區	2018-11-24T23:23:30+08:00	24544	54091	78635	3566	82201	153734	53.47%	15.97%	107	125
14	桃園市平鎮區	2018-11-24T22:29:55+08:00	17540	38384	55924	2510	58434	108437	53.89%	16.18%	78	125
14	桃園市平鎮區	2018-11-24T23:08:25+08:00	23014	50553	73567	3333	76900	143819	53.47%	16%	100	125
14	桃園市平鎮區	2018-11-24T23:55:38+08:00	26589	58659	85248	3841	89089	166696	53.44%	15.95%	115	125
14	桃園市平鎮區	2018-11-25T03:32:25+08:00	29045	64386	93431	4155	97586	183560	53.16%	15.82%	125	125
14	桃園市平鎮區	2018-11-24T23:15:54+08:00	23677	52024	75701	3430	79131	147912	53.5%	16.01%	103	125
14	桃園市平鎮區	2018-11-24T22:40:19+08:00	19293	42381	61674	2778	64452	120093	53.67%	16.07%	85	125
14	桃園市平鎮區	2018-11-25T01:25:43+08:00	29045	64386	93431	4155	97586	183560	53.16%	15.82%	125	125
14	桃園市平鎮區	2018-11-24T23:59:59+08:00	26813	59237	86050	3880	89930	168286	53.44%	15.93%	116	125
14	桃園市平鎮區	2018-11-25T03:38:47+08:00	29045	64386	93431	4155	97586	183560	53.16%	15.82%	125	125
14	桃園市平鎮區	2018-11-24T22:54:18+08:00	21303	46707	68010	3038	71048	132780	53.51%	16.04%	93	125
14	桃園市平鎮區	2018-11-25T06:23:51+08:00	29045	64386	93431	4155	97586	183560	53.16%	15.82%	125	125
14	桃園市平鎮區	2018-11-24T22:45:00+08:00	19631	42998	62629	2813	65442	122144	53.58%	16.07%	86	125
14	桃園市平鎮區	2018-11-24T23:31:01+08:00	25497	56453	81950	3700	85650	160442	53.38%	15.89%	111	125
14	桃園市平鎮區	2018-11-25T00:09:24+08:00	27523	60947	88470	3975	92445	173362	53.32%	15.88%	119	125
14	桃園市平鎮區	2018-11-24T22:41:27+08:00	19293	42381	61674	2778	64452	120093	53.67%	16.07%	85	125
14	桃園市平鎮區	2018-11-25T01:12:33+08:00	29045	64386	93431	4155	97586	183560	53.16%	15.82%	125	125
14	桃園市平鎮區	2018-11-24T22:50:37+08:00	20916	45755	66671	2986	69657	130222	53.49%	16.06%	91	125
14	桃園市平鎮區	2018-11-25T00:14:00+08:00	27523	60947	88470	3975	92445	173362	53.32%	15.88%	119	125
14	桃園市平鎮區	2018-11-24T23:39:04+08:00	26065	57527	83592	3761	87353	163601	53.39%	15.93%	113	125
14	桃園市平鎮區	2018-11-24T23:51:26+08:00	26275	58022	84297	3808	88105	164986	53.4%	15.93%	114	125
14	桃園市平鎮區	2018-11-25T06:18:49+08:00	29045	64386	93431	4155	97586	183560	53.16%	15.82%	125	125
14	桃園市平鎮區	2018-11-25T01:17:41+08:00	29045	64386	93431	4155	97586	183560	53.16%	15.82%	125	125
14	桃園市平鎮區	2018-11-24T22:23:03+08:00	17043	37133	54176	2466	56642	104887	54%	16.25%	76	125
14	桃園市平鎮區	2018-11-24T23:04:55+08:00	23014	50553	73567	3333	76900	143819	53.47%	16%	100	125
14	桃園市平鎮區	2018-11-24T23:19:40+08:00	24168	53222	77390	3528	80918	151129	53.54%	15.99%	105	125
14	桃園市平鎮區	2018-11-24T23:27:10+08:00	24963	55123	80086	3645	83731	156769	53.41%	15.92%	109	125
14	桃園市平鎮區	2018-11-24T22:36:52+08:00	19058	41595	60653	2741	63394	118162	53.65%	16.13%	84	125
14	桃園市平鎮區	2018-11-25T01:02:21+08:00	29045	64386	93431	4155	97586	183560	53.16%	15.82%	125	125
14	桃園市平鎮區	2018-11-25T03:49:43+08:00	29045	64386	93431	4155	97586	183560	53.16%	15.82%	125	125
14	桃園市平鎮區	2018-11-25T00:22:55+08:00	27770	61419	89189	3999	93188	175079	53.23%	15.86%	120	125
14	桃園市平鎮區	2018-11-25T03:56:01+08:00	29045	64386	93431	4155	97586	183560	53.16%	15.82%	125	125
14	桃園市平鎮區	2018-11-25T04:02:39+08:00	29045	64386	93431	4155	97586	183560	53.16%	15.82%	125	125
14	桃園市平鎮區	2018-11-25T06:13:44+08:00	29045	64386	93431	4155	97586	183560	53.16%	15.82%	125	125
14	桃園市平鎮區	2018-11-25T00:18:21+08:00	27770	61419	89189	3999	93188	175079	53.23%	15.86%	120	125
14	桃園市平鎮區	2018-11-24T22:33:29+08:00	18308	39908	58216	2603	60819	113018	53.81%	16.2%	81	125
14	桃園市平鎮區	2018-11-25T06:29:07+08:00	29045	64386	93431	4155	97586	183560	53.16%	15.82%	125	125
14	桃園市平鎮區	2018-11-24T23:43:08+08:00	26275	58022	84297	3808	88105	164986	53.4%	15.93%	114	125
14	桃園市	2018-11-25T01:07:17+08:00	268419	575239	843658	42324	885982	1715221	51.65%	15.65%	095	1
14	桃園市	2018-11-25T06:08:42+08:00	282142	603494	885636	44083	929719	1801823	51.6%	15.66%	142	1
14	桃園市	2018-11-24T22:26:28+08:00	129873	283232	413105	22300	435405	836172	52.07%	15.53%	578	1
14	桃園市	2018-11-24T23:47:18+08:00	222163	480876	703039	36093	739132	1425419	51.85%	15.59%	932	1
14	桃園市	2018-11-24T23:35:02+08:00	209228	453619	662847	34207	697054	1343641	51.88%	15.57%	883	1
14	桃園市	2018-11-24T22:16:00+08:00	117887	256584	374471	20151	394622	757740	52.08%	15.56%	528	1
14	桃園市	2018-11-24T23:51:25+08:00	224665	486096	710761	36393	747154	1441427	51.83%	15.59%	941	1
14	桃園市	2018-11-25T00:04:56+08:00	236607	510425	747032	37865	784897	1516673	51.75%	15.6%	983	1
14	桃園市	2018-11-24T22:19:28+08:00	121755	265123	386878	20822	407700	782573	52.1%	15.56%	545	1
14	桃園市	2018-11-25T00:57:27+08:00	263071	564776	827847	41543	869390	1682350	51.68%	15.64%	077	1
14	桃園市	2018-11-24T22:57:43+08:00	172217	373638	545855	28556	574411	1105116	51.98%	15.58%	742	1
14	桃園市	2018-11-24T22:13:17+08:00	113792	247779	361571	19487	381058	732886	51.99%	15.53%	511	1
14	桃園市	2018-11-24T23:23:30+08:00	197426	427549	624975	32345	657320	1266842	51.89%	15.58%	839	1
14	桃園市	2018-11-24T22:29:55+08:00	133033	289890	422923	22753	445676	856632	52.03%	15.53%	590	1
14	桃園市	2018-11-24T23:08:25+08:00	181542	394979	576521	30108	606629	1167779	51.95%	15.55%	781	1
14	桃園市	2018-11-24T23:55:38+08:00	229429	495439	724868	36967	761835	1470466	51.81%	15.6%	957	1
14	桃園市	2018-11-25T03:38:46+08:00	282142	603494	885636	44083	929719	1801823	51.6%	15.66%	142	1
14	桃園市	2018-11-24T23:59:58+08:00	232256	501485	733741	37351	771092	1489763	51.76%	15.59%	967	1
14	桃園市	2018-11-25T03:32:25+08:00	282142	603494	885636	44083	929719	1801823	51.6%	15.66%	142	1
14	桃園市	2018-11-24T23:15:53+08:00	190421	412935	603356	31340	634696	1223037	51.9%	15.57%	814	1
14	桃園市	2018-11-24T22:40:19+08:00	147356	320055	467411	24974	492385	946994	51.99%	15.56%	646	1
14	桃園市	2018-11-25T01:25:43+08:00	273583	585763	859346	42971	902317	1746909	51.65%	15.66%	113	1
14	桃園市	2018-11-25T06:23:51+08:00	282142	603494	885636	44083	929719	1801823	51.6%	15.66%	142	1
14	桃園市	2018-11-24T22:54:17+08:00	162889	353193	516082	27210	543292	1045670	51.96%	15.58%	705	1
14	桃園市	2018-11-24T22:45:00+08:00	151233	328110	479343	25418	504761	971301	51.97%	15.57%	660	1
14	桃園市	2018-11-24T23:01:21+08:00	176375	383278	559653	29274	588927	1133522	51.96%	15.56%	760	1
14	桃園市	2018-11-24T23:31:01+08:00	205947	446224	652171	33688	685859	1322177	51.87%	15.58%	871	1
14	桃園市	2018-11-25T00:09:23+08:00	238790	515229	754019	38197	792216	1531801	51.72%	15.59%	991	1
14	桃園市	2018-11-24T22:41:27+08:00	147356	320055	467411	24974	492385	946994	51.99%	15.56%	646	1
14	桃園市	2018-11-24T22:50:37+08:00	158578	343731	502309	26522	528831	1017727	51.96%	15.58%	688	1
14	桃園市	2018-11-25T00:14:00+08:00	242901	523864	766765	38793	805558	1557603	51.72%	15.59%	006	1
14	桃園市	2018-11-24T23:12:05+08:00	183886	399808	583694	30442	614136	1183215	51.9%	15.54%	790	1
14	桃園市	2018-11-24T23:39:04+08:00	213670	462939	676609	34787	711396	1371645	51.86%	15.58%	899	1
14	桃園市	2018-11-25T01:12:32+08:00	270891	580280	851171	42600	893771	1730365	51.65%	15.66%	103	1
14	桃園市	2018-11-25T03:44:11+08:00	282142	603494	885636	44083	929719	1801823	51.6%	15.66%	142	1
14	桃園市	2018-11-25T06:18:48+08:00	282142	603494	885636	44083	929719	1801823	51.6%	15.66%	142	1
14	桃園市	2018-11-24T23:04:55+08:00	179644	390756	570400	29829	600229	1155354	51.95%	15.55%	773	1
14	桃園市	2018-11-24T22:23:02+08:00	125536	273657	399193	21503	420696	807990	52.07%	15.54%	561	1
14	桃園市	2018-11-25T01:17:40+08:00	271894	581924	853818	42726	896544	1735748	51.65%	15.66%	106	1
14	桃園市	2018-11-24T23:27:10+08:00	200533	434299	634832	32843	667675	1287048	51.88%	15.58%	851	1
14	桃園市	2018-11-24T22:36:52+08:00	143960	312502	456462	24517	480979	925151	51.99%	15.56%	633	1
14	桃園市	2018-11-25T01:02:21+08:00	266037	569952	835989	41929	877918	1699212	51.67%	15.66%	086	1
14	桃園市	2018-11-24T23:19:39+08:00	194442	421848	616290	31972	648262	1248631	51.92%	15.57%	829	1
14	桃園市	2018-11-25T06:29:06+08:00	282142	603494	885636	44083	929719	1801823	51.6%	15.66%	142	1
14	桃園市	2018-11-25T03:56:01+08:00	282142	603494	885636	44083	929719	1801823	51.6%	15.66%	142	1
14	桃園市	2018-11-24T22:33:28+08:00	136044	295964	432008	23242	455250	875444	52%	15.54%	602	1
14	桃園市	2018-11-25T06:13:43+08:00	282142	603494	885636	44083	929719	1801823	51.6%	15.66%	142	1
14	桃園市	2018-11-25T04:02:39+08:00	282142	603494	885636	44083	929719	1801823	51.6%	15.66%	142	1
14	桃園市	2018-11-25T00:18:21+08:00	245496	529158	774654	39112	813766	1573545	51.72%	15.6%	015	1
14	桃園市	2018-11-25T00:22:54+08:00	248978	536112	785090	39595	824685	1595692	51.68%	15.6%	027	1
14	桃園市	2018-11-25T03:49:42+08:00	282142	603494	885636	44083	929719	1801823	51.6%	15.66%	142	1
14	桃園市	2018-11-24T23:43:08+08:00	219359	474610	693969	35663	729632	1406959	51.86%	15.59%	921	1
14	臺中市北屯區	2018-11-24T23:47:19+08:00	34903	73843	108746	4932	113678	196966	57.71%	17.72%	120	137
14	臺中市北屯區	2018-11-24T22:16:01+08:00	22254	46833	69087	3157	72244	124354	58.1%	17.9%	78	137
14	臺中市北屯區	2018-11-25T01:07:17+08:00	38522	81583	120105	5403	125508	218374	57.47%	17.64%	132	137
14	臺中市北屯區	2018-11-24T23:01:22+08:00	29977	63640	93617	4243	97860	168820	57.97%	17.76%	104	137
14	臺中市北屯區	2018-11-25T06:08:42+08:00	40045	85010	125055	5636	130691	227720	57.39%	17.59%	137	137
14	臺中市北屯區	2018-11-24T23:35:02+08:00	34015	72010	106025	4824	110849	192179	57.68%	17.7%	117	137
14	臺中市北屯區	2018-11-24T23:12:06+08:00	31076	66062	97138	4455	101593	175315	57.95%	17.73%	108	137
14	臺中市北屯區	2018-11-24T22:26:29+08:00	24686	51991	76677	3498	80175	138070	58.07%	17.88%	86	137
14	臺中市北屯區	2018-11-25T03:44:12+08:00	40045	85010	125055	5636	130691	227720	57.39%	17.59%	137	137
14	臺中市北屯區	2018-11-24T22:19:29+08:00	23174	48782	71956	3297	75253	129437	58.14%	17.9%	81	137
14	臺中市北屯區	2018-11-25T00:04:56+08:00	36951	78223	115174	5164	120338	209192	57.53%	17.66%	127	137
14	臺中市北屯區	2018-11-24T22:57:44+08:00	29618	62982	92600	4201	96801	166780	58.04%	17.76%	103	137
14	臺中市北屯區	2018-11-25T00:57:27+08:00	38522	81583	120105	5403	125508	218374	57.47%	17.64%	132	137
14	臺中市北屯區	2018-11-24T22:13:17+08:00	21917	46153	68070	3129	71199	122857	57.95%	17.84%	77	137
14	臺中市北屯區	2018-11-24T23:23:30+08:00	32745	69315	102060	4663	106723	184855	57.73%	17.71%	113	137
14	臺中市北屯區	2018-11-24T23:55:38+08:00	35405	74959	110364	4997	115361	200107	57.65%	17.69%	122	137
14	臺中市北屯區	2018-11-24T22:40:20+08:00	27105	57426	84531	3851	88382	151863	58.2%	17.85%	94	137
14	臺中市北屯區	2018-11-24T23:15:54+08:00	31993	67948	99941	4602	104543	180576	57.89%	17.72%	111	137
14	臺中市北屯區	2018-11-25T01:25:43+08:00	38823	82380	121203	5467	126670	220525	57.44%	17.6%	133	137
14	臺中市北屯區	2018-11-24T23:59:59+08:00	35683	75527	111210	5037	116247	201782	57.61%	17.68%	123	137
14	臺中市北屯區	2018-11-25T01:02:22+08:00	38522	81583	120105	5403	125508	218374	57.47%	17.64%	132	137
14	臺中市北屯區	2018-11-25T03:38:47+08:00	40045	85010	125055	5636	130691	227720	57.39%	17.59%	137	137
14	臺中市北屯區	2018-11-24T22:54:18+08:00	29618	62982	92600	4201	96801	166780	58.04%	17.76%	103	137
14	臺中市北屯區	2018-11-25T03:56:02+08:00	40045	85010	125055	5636	130691	227720	57.39%	17.59%	137	137
14	臺中市北屯區	2018-11-24T22:45:00+08:00	28010	59390	87400	3981	91381	157404	58.06%	17.79%	97	137
14	臺中市北屯區	2018-11-24T23:39:05+08:00	34368	72696	107064	4866	111930	194054	57.68%	17.71%	118	137
14	臺中市北屯區	2018-11-24T23:31:01+08:00	34015	72010	106025	4824	110849	192179	57.68%	17.7%	117	137
14	臺中市北屯區	2018-11-25T00:09:24+08:00	36951	78223	115174	5164	120338	209192	57.53%	17.66%	127	137
14	臺中市北屯區	2018-11-24T22:41:27+08:00	27105	57426	84531	3851	88382	151863	58.2%	17.85%	94	137
14	臺中市北屯區	2018-11-25T04:02:40+08:00	40045	85010	125055	5636	130691	227720	57.39%	17.59%	137	137
14	臺中市北屯區	2018-11-25T01:12:33+08:00	38823	82380	121203	5467	126670	220525	57.44%	17.6%	133	137
14	臺中市北屯區	2018-11-25T00:14:01+08:00	37300	78982	116282	5211	121493	211066	57.56%	17.67%	128	137
14	臺中市北屯區	2018-11-24T22:50:38+08:00	29038	61741	90779	4130	94909	163505	58.05%	17.76%	101	137
14	臺中市北屯區	2018-11-24T23:51:26+08:00	35185	74464	109649	4950	114599	198735	57.66%	17.7%	121	137
14	臺中市北屯區	2018-11-25T06:18:49+08:00	40045	85010	125055	5636	130691	227720	57.39%	17.59%	137	137
14	臺中市北屯區	2018-11-25T01:17:41+08:00	38823	82380	121203	5467	126670	220525	57.44%	17.6%	133	137
14	臺中市北屯區	2018-11-24T22:23:03+08:00	24686	51991	76677	3498	80175	138070	58.07%	17.88%	86	137
14	臺中市北屯區	2018-11-24T22:29:56+08:00	25658	54072	79730	3625	83355	143257	58.19%	17.91%	89	137
14	臺中市北屯區	2018-11-24T23:04:55+08:00	30211	64256	94467	4293	98760	170461	57.94%	17.72%	105	137
14	臺中市北屯區	2018-11-24T23:19:40+08:00	31993	67948	99941	4602	104543	180576	57.89%	17.72%	111	137
14	臺中市北屯區	2018-11-24T22:36:53+08:00	26440	55928	82368	3770	86138	148199	58.12%	17.84%	92	137
14	臺中市北屯區	2018-11-24T23:27:10+08:00	33393	70632	104025	4745	108770	188439	57.72%	17.72%	115	137
14	臺中市北屯區	2018-11-24T23:08:26+08:00	31076	66062	97138	4455	101593	175315	57.95%	17.73%	108	137
14	臺中市北屯區	2018-11-25T03:32:26+08:00	40045	85010	125055	5636	130691	227720	57.39%	17.59%	137	137
14	臺中市北屯區	2018-11-25T03:49:43+08:00	40045	85010	125055	5636	130691	227720	57.39%	17.59%	137	137
14	臺中市北屯區	2018-11-25T00:22:55+08:00	38181	80850	119031	5345	124376	216322	57.5%	17.65%	131	137
14	臺中市北屯區	2018-11-25T06:13:44+08:00	40045	85010	125055	5636	130691	227720	57.39%	17.59%	137	137
14	臺中市北屯區	2018-11-25T00:18:21+08:00	37642	79675	117317	5255	122572	213099	57.52%	17.66%	129	137
14	臺中市北屯區	2018-11-25T06:23:52+08:00	40045	85010	125055	5636	130691	227720	57.39%	17.59%	137	137
14	臺中市北屯區	2018-11-24T22:33:29+08:00	25658	54072	79730	3625	83355	143257	58.19%	17.91%	89	137
14	臺中市北屯區	2018-11-25T06:29:07+08:00	40045	85010	125055	5636	130691	227720	57.39%	17.59%	137	137
14	臺中市北屯區	2018-11-24T23:43:08+08:00	34655	73311	107966	4891	112857	195649	57.68%	17.71%	119	137
14	臺中市大雅區	2018-11-24T23:47:19+08:00	12308	29879	42187	2229	44416	77189	57.54%	15.95%	46	46
14	臺中市大雅區	2018-11-24T23:35:03+08:00	12066	29313	41379	2214	43593	75807	57.51%	15.92%	45	46
14	臺中市大雅區	2018-11-24T22:16:01+08:00	8381	20544	28925	1538	30463	52752	57.75%	15.89%	32	46
14	臺中市大雅區	2018-11-24T23:01:22+08:00	11053	26661	37714	1975	39689	68973	57.54%	16.03%	41	46
14	臺中市大雅區	2018-11-24T23:12:07+08:00	11353	27282	38635	2037	40672	70871	57.39%	16.02%	42	46
14	臺中市大雅區	2018-11-25T01:07:18+08:00	12308	29879	42187	2229	44416	77189	57.54%	15.95%	46	46
14	臺中市大雅區	2018-11-25T06:08:43+08:00	12308	29879	42187	2229	44416	77189	57.54%	15.95%	46	46
14	臺中市大雅區	2018-11-24T22:26:29+08:00	9477	23224	32701	1739	34440	59740	57.65%	15.86%	36	46
14	臺中市大雅區	2018-11-25T01:17:42+08:00	12308	29879	42187	2229	44416	77189	57.54%	15.95%	46	46
14	臺中市大雅區	2018-11-24T22:13:18+08:00	8128	19934	28062	1498	29560	50873	58.11%	15.98%	31	46
14	臺中市大雅區	2018-11-24T22:19:29+08:00	8612	21175	29787	1598	31385	54399	57.69%	15.83%	33	46
14	臺中市大雅區	2018-11-25T00:57:28+08:00	12308	29879	42187	2229	44416	77189	57.54%	15.95%	46	46
14	臺中市大雅區	2018-11-24T23:23:31+08:00	11855	28596	40451	2153	42604	74074	57.52%	16%	44	46
14	臺中市大雅區	2018-11-24T22:57:44+08:00	10701	25951	36652	1931	38583	66960	57.62%	15.98%	40	46
14	臺中市大雅區	2018-11-25T03:44:13+08:00	12308	29879	42187	2229	44416	77189	57.54%	15.95%	46	46
14	臺中市大雅區	2018-11-25T00:04:57+08:00	12308	29879	42187	2229	44416	77189	57.54%	15.95%	46	46
14	臺中市大雅區	2018-11-24T23:04:56+08:00	11353	27282	38635	2037	40672	70871	57.39%	16.02%	42	46
14	臺中市大雅區	2018-11-24T23:15:55+08:00	11627	27963	39590	2081	41671	72439	57.53%	16.05%	43	46
14	臺中市大雅區	2018-11-24T22:40:20+08:00	10701	25951	36652	1931	38583	66960	57.62%	15.98%	40	46
14	臺中市大雅區	2018-11-25T01:25:44+08:00	12308	29879	42187	2229	44416	77189	57.54%	15.95%	46	46
14	臺中市大雅區	2018-11-24T23:59:59+08:00	12308	29879	42187	2229	44416	77189	57.54%	15.95%	46	46
14	臺中市大雅區	2018-11-25T01:02:22+08:00	12308	29879	42187	2229	44416	77189	57.54%	15.95%	46	46
14	臺中市大雅區	2018-11-25T03:38:47+08:00	12308	29879	42187	2229	44416	77189	57.54%	15.95%	46	46
14	臺中市大雅區	2018-11-24T23:55:39+08:00	12308	29879	42187	2229	44416	77189	57.54%	15.95%	46	46
14	臺中市大雅區	2018-11-24T22:54:18+08:00	10701	25951	36652	1931	38583	66960	57.62%	15.98%	40	46
14	臺中市大雅區	2018-11-24T22:45:01+08:00	10701	25951	36652	1931	38583	66960	57.62%	15.98%	40	46
14	臺中市大雅區	2018-11-25T00:18:22+08:00	12308	29879	42187	2229	44416	77189	57.54%	15.95%	46	46
14	臺中市大雅區	2018-11-25T00:22:56+08:00	12308	29879	42187	2229	44416	77189	57.54%	15.95%	46	46
14	臺中市大雅區	2018-11-25T03:56:02+08:00	12308	29879	42187	2229	44416	77189	57.54%	15.95%	46	46
14	臺中市大雅區	2018-11-24T23:39:05+08:00	12066	29313	41379	2214	43593	75807	57.51%	15.92%	45	46
14	臺中市大雅區	2018-11-24T23:31:01+08:00	12066	29313	41379	2214	43593	75807	57.51%	15.92%	45	46
14	臺中市大雅區	2018-11-25T00:09:24+08:00	12308	29879	42187	2229	44416	77189	57.54%	15.95%	46	46
14	臺中市大雅區	2018-11-24T22:41:27+08:00	10701	25951	36652	1931	38583	66960	57.62%	15.98%	40	46
14	臺中市大雅區	2018-11-25T04:02:40+08:00	12308	29879	42187	2229	44416	77189	57.54%	15.95%	46	46
14	臺中市大雅區	2018-11-25T01:12:33+08:00	12308	29879	42187	2229	44416	77189	57.54%	15.95%	46	46
14	臺中市大雅區	2018-11-25T00:14:01+08:00	12308	29879	42187	2229	44416	77189	57.54%	15.95%	46	46
14	臺中市大雅區	2018-11-24T22:50:38+08:00	10701	25951	36652	1931	38583	66960	57.62%	15.98%	40	46
14	臺中市大雅區	2018-11-24T23:51:26+08:00	12308	29879	42187	2229	44416	77189	57.54%	15.95%	46	46
14	臺中市大雅區	2018-11-25T06:18:49+08:00	12308	29879	42187	2229	44416	77189	57.54%	15.95%	46	46
14	臺中市大雅區	2018-11-24T22:23:04+08:00	8892	21927	30819	1635	32454	56362	57.58%	15.78%	34	46
14	臺中市大雅區	2018-11-24T22:29:56+08:00	10066	24552	34618	1823	36441	63160	57.7%	15.94%	38	46
14	臺中市大雅區	2018-11-24T23:19:40+08:00	11627	27963	39590	2081	41671	72439	57.53%	16.05%	43	46
14	臺中市大雅區	2018-11-24T22:36:53+08:00	10701	25951	36652	1931	38583	66960	57.62%	15.98%	40	46
14	臺中市大雅區	2018-11-24T23:08:26+08:00	11353	27282	38635	2037	40672	70871	57.39%	16.02%	42	46
14	臺中市大雅區	2018-11-24T23:27:11+08:00	11855	28596	40451	2153	42604	74074	57.52%	16%	44	46
14	臺中市大雅區	2018-11-25T03:32:26+08:00	12308	29879	42187	2229	44416	77189	57.54%	15.95%	46	46
14	臺中市大雅區	2018-11-25T03:49:43+08:00	12308	29879	42187	2229	44416	77189	57.54%	15.95%	46	46
14	臺中市大雅區	2018-11-25T06:29:08+08:00	12308	29879	42187	2229	44416	77189	57.54%	15.95%	46	46
14	臺中市大雅區	2018-11-25T06:13:44+08:00	12308	29879	42187	2229	44416	77189	57.54%	15.95%	46	46
14	臺中市大雅區	2018-11-25T06:23:52+08:00	12308	29879	42187	2229	44416	77189	57.54%	15.95%	46	46
14	臺中市大雅區	2018-11-24T23:43:09+08:00	12308	29879	42187	2229	44416	77189	57.54%	15.95%	46	46
14	臺中市大雅區	2018-11-24T22:33:29+08:00	10380	25270	35650	1891	37541	65144	57.63%	15.93%	39	46
14	臺南市左鎮區	2018-11-24T23:35:04+08:00	447	1308	1755	231	1986	4418	44.95%	10.12%	10	10
14	臺南市左鎮區	2018-11-24T23:47:21+08:00	447	1308	1755	231	1986	4418	44.95%	10.12%	10	10
14	臺南市左鎮區	2018-11-25T01:07:19+08:00	447	1308	1755	231	1986	4418	44.95%	10.12%	10	10
14	臺南市左鎮區	2018-11-24T22:33:31+08:00	447	1308	1755	231	1986	4418	44.95%	10.12%	10	10
14	臺南市左鎮區	2018-11-25T00:14:02+08:00	447	1308	1755	231	1986	4418	44.95%	10.12%	10	10
14	臺南市左鎮區	2018-11-24T23:43:10+08:00	447	1308	1755	231	1986	4418	44.95%	10.12%	10	10
14	臺南市左鎮區	2018-11-25T06:08:44+08:00	447	1308	1755	231	1986	4418	44.95%	10.12%	10	10
14	臺南市左鎮區	2018-11-25T00:09:26+08:00	447	1308	1755	231	1986	4418	44.95%	10.12%	10	10
14	臺南市左鎮區	2018-11-24T23:12:08+08:00	447	1308	1755	231	1986	4418	44.95%	10.12%	10	10
14	臺南市左鎮區	2018-11-24T23:39:07+08:00	447	1308	1755	231	1986	4418	44.95%	10.12%	10	10
14	臺南市左鎮區	2018-11-24T23:31:03+08:00	447	1308	1755	231	1986	4418	44.95%	10.12%	10	10
14	臺南市左鎮區	2018-11-24T23:01:24+08:00	447	1308	1755	231	1986	4418	44.95%	10.12%	10	10
14	臺南市左鎮區	2018-11-24T23:19:42+08:00	447	1308	1755	231	1986	4418	44.95%	10.12%	10	10
14	臺南市左鎮區	2018-11-25T00:04:58+08:00	447	1308	1755	231	1986	4418	44.95%	10.12%	10	10
14	臺南市左鎮區	2018-11-24T23:04:57+08:00	447	1308	1755	231	1986	4418	44.95%	10.12%	10	10
14	臺南市左鎮區	2018-11-25T00:57:29+08:00	447	1308	1755	231	1986	4418	44.95%	10.12%	10	10
14	臺南市左鎮區	2018-11-24T22:13:19+08:00	447	1308	1755	231	1986	4418	44.95%	10.12%	10	10
14	臺南市左鎮區	2018-11-25T03:44:14+08:00	447	1308	1755	231	1986	4418	44.95%	10.12%	10	10
14	臺南市左鎮區	2018-11-25T01:17:43+08:00	447	1308	1755	231	1986	4418	44.95%	10.12%	10	10
14	臺南市左鎮區	2018-11-24T23:55:40+08:00	447	1308	1755	231	1986	4418	44.95%	10.12%	10	10
14	臺南市左鎮區	2018-11-25T06:18:51+08:00	447	1308	1755	231	1986	4418	44.95%	10.12%	10	10
14	臺南市左鎮區	2018-11-25T01:02:23+08:00	447	1308	1755	231	1986	4418	44.95%	10.12%	10	10
14	臺南市左鎮區	2018-11-25T01:25:45+08:00	447	1308	1755	231	1986	4418	44.95%	10.12%	10	10
14	臺南市左鎮區	2018-11-25T03:38:48+08:00	447	1308	1755	231	1986	4418	44.95%	10.12%	10	10
14	臺南市左鎮區	2018-11-24T22:40:21+08:00	447	1308	1755	231	1986	4418	44.95%	10.12%	10	10
14	臺南市左鎮區	2018-11-24T23:27:12+08:00	447	1308	1755	231	1986	4418	44.95%	10.12%	10	10
14	臺南市左鎮區	2018-11-25T00:18:23+08:00	447	1308	1755	231	1986	4418	44.95%	10.12%	10	10
14	臺南市左鎮區	2018-11-24T22:54:19+08:00	447	1308	1755	231	1986	4418	44.95%	10.12%	10	10
14	臺南市左鎮區	2018-11-25T06:13:46+08:00	447	1308	1755	231	1986	4418	44.95%	10.12%	10	10
14	臺南市左鎮區	2018-11-25T00:22:57+08:00	447	1308	1755	231	1986	4418	44.95%	10.12%	10	10
14	臺南市左鎮區	2018-11-25T03:56:04+08:00	447	1308	1755	231	1986	4418	44.95%	10.12%	10	10
14	臺南市左鎮區	2018-11-24T22:16:02+08:00	447	1308	1755	231	1986	4418	44.95%	10.12%	10	10
14	臺南市左鎮區	2018-11-24T22:41:28+08:00	447	1308	1755	231	1986	4418	44.95%	10.12%	10	10
14	臺南市左鎮區	2018-11-25T04:02:41+08:00	447	1308	1755	231	1986	4418	44.95%	10.12%	10	10
14	臺南市左鎮區	2018-11-25T01:12:35+08:00	447	1308	1755	231	1986	4418	44.95%	10.12%	10	10
14	臺南市左鎮區	2018-11-24T22:29:59+08:00	447	1308	1755	231	1986	4418	44.95%	10.12%	10	10
14	臺南市左鎮區	2018-11-24T23:23:32+08:00	447	1308	1755	231	1986	4418	44.95%	10.12%	10	10
14	臺南市左鎮區	2018-11-24T22:57:46+08:00	447	1308	1755	231	1986	4418	44.95%	10.12%	10	10
14	臺南市左鎮區	2018-11-25T00:00:01+08:00	447	1308	1755	231	1986	4418	44.95%	10.12%	10	10
14	臺南市左鎮區	2018-11-24T23:51:27+08:00	447	1308	1755	231	1986	4418	44.95%	10.12%	10	10
14	臺南市左鎮區	2018-11-24T22:23:05+08:00	447	1308	1755	231	1986	4418	44.95%	10.12%	10	10
14	臺南市左鎮區	2018-11-24T22:36:54+08:00	447	1308	1755	231	1986	4418	44.95%	10.12%	10	10
14	臺南市左鎮區	2018-11-24T23:15:56+08:00	447	1308	1755	231	1986	4418	44.95%	10.12%	10	10
14	臺南市左鎮區	2018-11-24T23:08:28+08:00	447	1308	1755	231	1986	4418	44.95%	10.12%	10	10
14	臺南市左鎮區	2018-11-25T03:32:27+08:00	447	1308	1755	231	1986	4418	44.95%	10.12%	10	10
14	臺南市左鎮區	2018-11-24T22:19:30+08:00	447	1308	1755	231	1986	4418	44.95%	10.12%	10	10
14	臺南市左鎮區	2018-11-25T03:49:44+08:00	447	1308	1755	231	1986	4418	44.95%	10.12%	10	10
14	臺南市左鎮區	2018-11-24T22:45:02+08:00	447	1308	1755	231	1986	4418	44.95%	10.12%	10	10
14	臺南市左鎮區	2018-11-24T22:50:40+08:00	447	1308	1755	231	1986	4418	44.95%	10.12%	10	10
14	臺南市左鎮區	2018-11-24T22:26:30+08:00	447	1308	1755	231	1986	4418	44.95%	10.12%	10	10
14	臺南市左鎮區	2018-11-25T06:29:09+08:00	447	1308	1755	231	1986	4418	44.95%	10.12%	10	10
14	臺南市左鎮區	2018-11-25T06:23:53+08:00	447	1308	1755	231	1986	4418	44.95%	10.12%	10	10
14	屏東縣潮州鎮	2018-11-25T03:56:10+08:00	6776	15936	22712	1538	24250	46444	52.21%	14.59%	40	40
14	屏東縣潮州鎮	2018-11-24T23:47:26+08:00	6532	15415	21947	1493	23440	44813	52.31%	14.58%	39	40
14	屏東縣潮州鎮	2018-11-24T23:16:01+08:00	5922	13938	19860	1331	21191	40515	52.3%	14.62%	36	40
14	屏東縣潮州鎮	2018-11-24T23:43:16+08:00	6532	15415	21947	1493	23440	44813	52.31%	14.58%	39	40
14	屏東縣潮州鎮	2018-11-24T22:33:36+08:00	3798	8859	12657	900	13557	25547	53.07%	14.87%	25	40
14	屏東縣潮州鎮	2018-11-24T22:16:09+08:00	2971	6977	9948	735	10683	20031	53.33%	14.83%	21	40
14	屏東縣潮州鎮	2018-11-25T03:38:53+08:00	6776	15936	22712	1538	24250	46444	52.21%	14.59%	40	40
14	屏東縣潮州鎮	2018-11-25T01:25:51+08:00	6776	15936	22712	1538	24250	46444	52.21%	14.59%	40	40
14	屏東縣潮州鎮	2018-11-24T23:23:37+08:00	6294	14828	21122	1452	22574	43069	52.41%	14.61%	38	40
14	屏東縣潮州鎮	2018-11-25T06:18:56+08:00	6776	15936	22712	1538	24250	46444	52.21%	14.59%	40	40
14	屏東縣潮州鎮	2018-11-24T22:19:35+08:00	2971	6977	9948	735	10683	20031	53.33%	14.83%	21	40
14	屏東縣潮州鎮	2018-11-25T01:17:50+08:00	6776	15936	22712	1538	24250	46444	52.21%	14.59%	40	40
14	屏東縣潮州鎮	2018-11-24T22:36:59+08:00	4190	9799	13989	977	14966	28267	52.95%	14.82%	27	40
14	屏東縣潮州鎮	2018-11-24T22:40:26+08:00	4390	10168	14558	994	15552	29522	52.68%	14.87%	28	40
14	屏東縣潮州鎮	2018-11-25T00:57:35+08:00	6776	15936	22712	1538	24250	46444	52.21%	14.59%	40	40
14	屏東縣潮州鎮	2018-11-24T22:57:51+08:00	5526	12979	18505	1266	19771	37686	52.46%	14.66%	34	40
14	屏東縣潮州鎮	2018-11-25T00:09:32+08:00	6776	15936	22712	1538	24250	46444	52.21%	14.59%	40	40
14	屏東縣潮州鎮	2018-11-25T06:23:58+08:00	6776	15936	22712	1538	24250	46444	52.21%	14.59%	40	40
14	屏東縣潮州鎮	2018-11-24T23:39:14+08:00	6532	15415	21947	1493	23440	44813	52.31%	14.58%	39	40
14	屏東縣潮州鎮	2018-11-25T03:49:49+08:00	6776	15936	22712	1538	24250	46444	52.21%	14.59%	40	40
14	屏東縣潮州鎮	2018-11-25T01:12:41+08:00	6776	15936	22712	1538	24250	46444	52.21%	14.59%	40	40
14	屏東縣潮州鎮	2018-11-24T22:26:35+08:00	3201	7481	10682	780	11462	21470	53.39%	14.91%	22	40
14	屏東縣潮州鎮	2018-11-24T23:12:14+08:00	5526	12979	18505	1266	19771	37686	52.46%	14.66%	34	40
14	屏東縣潮州鎮	2018-11-24T22:45:07+08:00	4726	11032	15758	1098	16856	31931	52.79%	14.8%	30	40
14	屏東縣潮州鎮	2018-11-25T06:08:51+08:00	6776	15936	22712	1538	24250	46444	52.21%	14.59%	40	40
14	屏東縣潮州鎮	2018-11-25T04:02:50+08:00	6776	15936	22712	1538	24250	46444	52.21%	14.59%	40	40
14	屏東縣潮州鎮	2018-11-25T06:13:51+08:00	6776	15936	22712	1538	24250	46444	52.21%	14.59%	40	40
14	屏東縣潮州鎮	2018-11-25T00:14:07+08:00	6776	15936	22712	1538	24250	46444	52.21%	14.59%	40	40
14	屏東縣潮州鎮	2018-11-24T23:35:09+08:00	6532	15415	21947	1493	23440	44813	52.31%	14.58%	39	40
14	屏東縣潮州鎮	2018-11-24T23:01:29+08:00	5526	12979	18505	1266	19771	37686	52.46%	14.66%	34	40
14	屏東縣潮州鎮	2018-11-25T01:07:24+08:00	6776	15936	22712	1538	24250	46444	52.21%	14.59%	40	40
14	屏東縣潮州鎮	2018-11-24T23:31:09+08:00	6532	15415	21947	1493	23440	44813	52.31%	14.58%	39	40
14	屏東縣潮州鎮	2018-11-25T06:29:15+08:00	6776	15936	22712	1538	24250	46444	52.21%	14.59%	40	40
14	屏東縣潮州鎮	2018-11-24T23:55:45+08:00	6532	15415	21947	1493	23440	44813	52.31%	14.58%	39	40
14	屏東縣潮州鎮	2018-11-24T23:08:34+08:00	5526	12979	18505	1266	19771	37686	52.46%	14.66%	34	40
14	屏東縣潮州鎮	2018-11-25T00:00:09+08:00	6532	15415	21947	1493	23440	44813	52.31%	14.58%	39	40
14	屏東縣潮州鎮	2018-11-25T00:23:02+08:00	6776	15936	22712	1538	24250	46444	52.21%	14.59%	40	40
14	屏東縣潮州鎮	2018-11-24T23:19:48+08:00	6162	14525	20687	1397	22084	42173	52.37%	14.61%	37	40
14	屏東縣潮州鎮	2018-11-25T03:32:33+08:00	6776	15936	22712	1538	24250	46444	52.21%	14.59%	40	40
14	屏東縣潮州鎮	2018-11-25T03:44:21+08:00	6776	15936	22712	1538	24250	46444	52.21%	14.59%	40	40
14	屏東縣潮州鎮	2018-11-24T22:13:25+08:00	2781	6541	9322	694	10016	18735	53.46%	14.84%	20	40
14	屏東縣潮州鎮	2018-11-24T22:23:11+08:00	3201	7481	10682	780	11462	21470	53.39%	14.91%	22	40
14	屏東縣潮州鎮	2018-11-24T22:30:05+08:00	3441	8051	11492	804	12296	23104	53.22%	14.89%	23	40
14	屏東縣潮州鎮	2018-11-24T23:27:17+08:00	6294	14828	21122	1452	22574	43069	52.41%	14.61%	38	40
14	屏東縣潮州鎮	2018-11-25T01:02:29+08:00	6776	15936	22712	1538	24250	46444	52.21%	14.59%	40	40
14	屏東縣潮州鎮	2018-11-24T23:51:33+08:00	6532	15415	21947	1493	23440	44813	52.31%	14.58%	39	40
14	屏東縣潮州鎮	2018-11-24T23:05:03+08:00	5526	12979	18505	1266	19771	37686	52.46%	14.66%	34	40
14	屏東縣潮州鎮	2018-11-24T22:54:24+08:00	5132	12062	17194	1182	18376	35033	52.45%	14.65%	32	40
14	屏東縣潮州鎮	2018-11-25T00:18:28+08:00	6776	15936	22712	1538	24250	46444	52.21%	14.59%	40	40
14	屏東縣潮州鎮	2018-11-24T22:41:33+08:00	4390	10168	14558	994	15552	29522	52.68%	14.87%	28	40
14	屏東縣潮州鎮	2018-11-25T00:05:03+08:00	6776	15936	22712	1538	24250	46444	52.21%	14.59%	40	40
14	屏東縣潮州鎮	2018-11-24T22:50:46+08:00	5132	12062	17194	1182	18376	35033	52.45%	14.65%	32	40
14	臺南市安平區	2018-11-25T06:29:10+08:00	9422	17626	27048	1183	28231	55379	50.98%	17.01%	32	32
14	臺南市安平區	2018-11-24T23:35:04+08:00	7027	13203	20230	791	21021	40575	51.81%	17.32%	24	32
14	臺南市安平區	2018-11-24T23:47:21+08:00	7027	13203	20230	791	21021	40575	51.81%	17.32%	24	32
14	臺南市安平區	2018-11-25T06:08:45+08:00	9422	17626	27048	1183	28231	55379	50.98%	17.01%	32	32
14	臺南市安平區	2018-11-24T23:43:11+08:00	7027	13203	20230	791	21021	40575	51.81%	17.32%	24	32
14	臺南市安平區	2018-11-25T01:07:19+08:00	9422	17626	27048	1183	28231	55379	50.98%	17.01%	32	32
14	臺南市安平區	2018-11-24T22:33:31+08:00	3261	6152	9413	381	9794	18536	52.84%	17.59%	12	32
14	臺南市安平區	2018-11-25T00:14:02+08:00	8135	15273	23408	971	24379	47681	51.13%	17.06%	28	32
14	臺南市安平區	2018-11-25T04:02:42+08:00	9422	17626	27048	1183	28231	55379	50.98%	17.01%	32	32
14	臺南市安平區	2018-11-25T00:09:26+08:00	7848	14790	22638	939	23577	46058	51.19%	17.04%	27	32
14	臺南市安平區	2018-11-24T23:12:08+08:00	5441	10376	15817	599	16416	31656	51.86%	17.19%	19	32
14	臺南市安平區	2018-11-24T23:39:07+08:00	7027	13203	20230	791	21021	40575	51.81%	17.32%	24	32
14	臺南市安平區	2018-11-24T23:31:03+08:00	6691	12687	19378	744	20122	38795	51.87%	17.25%	23	32
14	臺南市安平區	2018-11-24T23:01:24+08:00	5132	9894	15026	582	15608	30003	52.02%	17.1%	18	32
14	臺南市安平區	2018-11-25T03:44:15+08:00	9422	17626	27048	1183	28231	55379	50.98%	17.01%	32	32
14	臺南市安平區	2018-11-24T23:19:42+08:00	6040	11434	17474	671	18145	34933	51.94%	17.29%	21	32
14	臺南市安平區	2018-11-25T00:04:58+08:00	7564	14165	21729	856	22585	44057	51.26%	17.17%	26	32
14	臺南市安平區	2018-11-24T23:04:57+08:00	5132	9894	15026	582	15608	30003	52.02%	17.1%	18	32
14	臺南市安平區	2018-11-24T22:13:19+08:00	2325	4387	6712	250	6962	13254	52.53%	17.54%	9	32
14	臺南市安平區	2018-11-25T01:17:44+08:00	9422	17626	27048	1183	28231	55379	50.98%	17.01%	32	32
14	臺南市安平區	2018-11-24T23:55:40+08:00	7285	13661	20946	823	21769	42329	51.43%	17.21%	25	32
14	臺南市安平區	2018-11-25T06:18:51+08:00	9422	17626	27048	1183	28231	55379	50.98%	17.01%	32	32
14	臺南市安平區	2018-11-25T01:02:24+08:00	9422	17626	27048	1183	28231	55379	50.98%	17.01%	32	32
14	臺南市安平區	2018-11-25T03:38:49+08:00	9422	17626	27048	1183	28231	55379	50.98%	17.01%	32	32
14	臺南市安平區	2018-11-24T23:27:12+08:00	6383	12091	18474	701	19175	37040	51.77%	17.23%	22	32
14	臺南市安平區	2018-11-24T22:54:20+08:00	4212	7889	12101	474	12575	23999	52.4%	17.55%	15	32
14	臺南市安平區	2018-11-25T00:18:23+08:00	8361	15782	24143	1024	25167	49173	51.18%	17%	29	32
14	臺南市安平區	2018-11-25T06:13:46+08:00	9422	17626	27048	1183	28231	55379	50.98%	17.01%	32	32
14	臺南市安平區	2018-11-25T00:22:57+08:00	8750	16374	25124	1070	26194	51152	51.21%	17.11%	30	32
14	臺南市安平區	2018-11-25T03:56:04+08:00	9422	17626	27048	1183	28231	55379	50.98%	17.01%	32	32
14	臺南市安平區	2018-11-24T22:41:29+08:00	3603	6790	10393	418	10811	20690	52.25%	17.41%	13	32
14	臺南市安平區	2018-11-24T22:16:03+08:00	2325	4387	6712	250	6962	13254	52.53%	17.54%	9	32
14	臺南市安平區	2018-11-25T01:12:35+08:00	9422	17626	27048	1183	28231	55379	50.98%	17.01%	32	32
14	臺南市安平區	2018-11-24T22:29:59+08:00	3261	6152	9413	381	9794	18536	52.84%	17.59%	12	32
14	臺南市安平區	2018-11-24T23:23:32+08:00	6040	11434	17474	671	18145	34933	51.94%	17.29%	21	32
14	臺南市安平區	2018-11-24T23:51:28+08:00	7285	13661	20946	823	21769	42329	51.43%	17.21%	25	32
14	臺南市安平區	2018-11-24T22:57:46+08:00	4783	9145	13928	554	14482	27871	51.96%	17.16%	17	32
14	臺南市安平區	2018-11-25T00:00:01+08:00	7564	14165	21729	856	22585	44057	51.26%	17.17%	26	32
14	臺南市安平區	2018-11-24T22:23:05+08:00	2954	5539	8493	339	8832	16783	52.62%	17.6%	11	32
14	臺南市安平區	2018-11-24T22:36:54+08:00	3261	6152	9413	381	9794	18536	52.84%	17.59%	12	32
14	臺南市安平區	2018-11-25T01:25:46+08:00	9422	17626	27048	1183	28231	55379	50.98%	17.01%	32	32
14	臺南市安平區	2018-11-25T00:57:30+08:00	9422	17626	27048	1183	28231	55379	50.98%	17.01%	32	32
14	臺南市安平區	2018-11-24T23:08:28+08:00	5441	10376	15817	599	16416	31656	51.86%	17.19%	19	32
14	臺南市安平區	2018-11-24T22:40:22+08:00	3603	6790	10393	418	10811	20690	52.25%	17.41%	13	32
14	臺南市安平區	2018-11-24T22:19:30+08:00	2644	4886	7530	304	7834	14940	52.44%	17.7%	10	32
14	臺南市安平區	2018-11-24T23:15:57+08:00	5719	10866	16585	630	17215	33258	51.76%	17.2%	20	32
14	臺南市安平區	2018-11-25T03:32:28+08:00	9422	17626	27048	1183	28231	55379	50.98%	17.01%	32	32
14	臺南市安平區	2018-11-24T22:45:02+08:00	3877	7302	11179	432	11611	22140	52.44%	17.51%	14	32
14	臺南市安平區	2018-11-24T22:50:40+08:00	3877	7302	11179	432	11611	22140	52.44%	17.51%	14	32
14	臺南市安平區	2018-11-25T03:49:45+08:00	9422	17626	27048	1183	28231	55379	50.98%	17.01%	32	32
14	臺南市安平區	2018-11-25T06:23:54+08:00	9422	17626	27048	1183	28231	55379	50.98%	17.01%	32	32
14	臺南市安平區	2018-11-24T22:26:31+08:00	2954	5539	8493	339	8832	16783	52.62%	17.6%	11	32
14	屏東縣萬巒鄉	2018-11-24T23:16:01+08:00	2591	5675	8266	900	9166	17945	51.08%	14.44%	18	18
14	屏東縣萬巒鄉	2018-11-24T23:43:16+08:00	2591	5675	8266	900	9166	17945	51.08%	14.44%	18	18
14	屏東縣萬巒鄉	2018-11-24T22:33:36+08:00	2591	5675	8266	900	9166	17945	51.08%	14.44%	18	18
14	屏東縣萬巒鄉	2018-11-25T03:56:11+08:00	2591	5675	8266	900	9166	17945	51.08%	14.44%	18	18
14	屏東縣萬巒鄉	2018-11-24T23:47:27+08:00	2591	5675	8266	900	9166	17945	51.08%	14.44%	18	18
14	屏東縣萬巒鄉	2018-11-24T22:16:09+08:00	2222	4877	7099	790	7889	15069	52.35%	14.75%	16	18
14	屏東縣萬巒鄉	2018-11-25T03:38:54+08:00	2591	5675	8266	900	9166	17945	51.08%	14.44%	18	18
14	屏東縣萬巒鄉	2018-11-25T01:25:51+08:00	2591	5675	8266	900	9166	17945	51.08%	14.44%	18	18
14	屏東縣萬巒鄉	2018-11-24T23:23:37+08:00	2591	5675	8266	900	9166	17945	51.08%	14.44%	18	18
14	屏東縣萬巒鄉	2018-11-25T06:18:56+08:00	2591	5675	8266	900	9166	17945	51.08%	14.44%	18	18
14	屏東縣萬巒鄉	2018-11-24T22:30:06+08:00	2443	5301	7744	874	8618	16717	51.55%	14.61%	17	18
14	屏東縣萬巒鄉	2018-11-25T01:17:50+08:00	2591	5675	8266	900	9166	17945	51.08%	14.44%	18	18
14	屏東縣萬巒鄉	2018-11-24T22:36:59+08:00	2591	5675	8266	900	9166	17945	51.08%	14.44%	18	18
14	屏東縣萬巒鄉	2018-11-24T22:40:26+08:00	2591	5675	8266	900	9166	17945	51.08%	14.44%	18	18
14	屏東縣萬巒鄉	2018-11-25T00:57:35+08:00	2591	5675	8266	900	9166	17945	51.08%	14.44%	18	18
14	屏東縣萬巒鄉	2018-11-24T23:31:10+08:00	2591	5675	8266	900	9166	17945	51.08%	14.44%	18	18
14	屏東縣萬巒鄉	2018-11-24T23:39:14+08:00	2591	5675	8266	900	9166	17945	51.08%	14.44%	18	18
14	屏東縣萬巒鄉	2018-11-24T23:01:30+08:00	2591	5675	8266	900	9166	17945	51.08%	14.44%	18	18
14	屏東縣萬巒鄉	2018-11-25T04:02:51+08:00	2591	5675	8266	900	9166	17945	51.08%	14.44%	18	18
14	屏東縣萬巒鄉	2018-11-24T22:26:35+08:00	2443	5301	7744	874	8618	16717	51.55%	14.61%	17	18
14	屏東縣萬巒鄉	2018-11-24T23:12:14+08:00	2591	5675	8266	900	9166	17945	51.08%	14.44%	18	18
14	屏東縣萬巒鄉	2018-11-25T06:23:59+08:00	2591	5675	8266	900	9166	17945	51.08%	14.44%	18	18
14	屏東縣萬巒鄉	2018-11-25T00:09:33+08:00	2591	5675	8266	900	9166	17945	51.08%	14.44%	18	18
14	屏東縣萬巒鄉	2018-11-24T22:45:07+08:00	2591	5675	8266	900	9166	17945	51.08%	14.44%	18	18
14	屏東縣萬巒鄉	2018-11-25T06:08:51+08:00	2591	5675	8266	900	9166	17945	51.08%	14.44%	18	18
14	屏東縣萬巒鄉	2018-11-25T01:07:25+08:00	2591	5675	8266	900	9166	17945	51.08%	14.44%	18	18
14	屏東縣萬巒鄉	2018-11-25T06:13:51+08:00	2591	5675	8266	900	9166	17945	51.08%	14.44%	18	18
14	屏東縣萬巒鄉	2018-11-24T23:35:09+08:00	2591	5675	8266	900	9166	17945	51.08%	14.44%	18	18
14	屏東縣萬巒鄉	2018-11-25T03:49:50+08:00	2591	5675	8266	900	9166	17945	51.08%	14.44%	18	18
14	屏東縣萬巒鄉	2018-11-25T00:14:08+08:00	2591	5675	8266	900	9166	17945	51.08%	14.44%	18	18
14	屏東縣萬巒鄉	2018-11-25T06:29:15+08:00	2591	5675	8266	900	9166	17945	51.08%	14.44%	18	18
14	屏東縣萬巒鄉	2018-11-24T23:55:45+08:00	2591	5675	8266	900	9166	17945	51.08%	14.44%	18	18
14	屏東縣萬巒鄉	2018-11-24T23:08:34+08:00	2591	5675	8266	900	9166	17945	51.08%	14.44%	18	18
14	屏東縣萬巒鄉	2018-11-25T00:00:09+08:00	2591	5675	8266	900	9166	17945	51.08%	14.44%	18	18
14	屏東縣萬巒鄉	2018-11-25T00:23:02+08:00	2591	5675	8266	900	9166	17945	51.08%	14.44%	18	18
14	屏東縣萬巒鄉	2018-11-25T03:32:33+08:00	2591	5675	8266	900	9166	17945	51.08%	14.44%	18	18
14	屏東縣萬巒鄉	2018-11-25T03:44:21+08:00	2591	5675	8266	900	9166	17945	51.08%	14.44%	18	18
14	屏東縣萬巒鄉	2018-11-24T22:13:25+08:00	2222	4877	7099	790	7889	15069	52.35%	14.75%	16	18
14	屏東縣萬巒鄉	2018-11-24T23:19:49+08:00	2591	5675	8266	900	9166	17945	51.08%	14.44%	18	18
14	屏東縣萬巒鄉	2018-11-24T22:23:11+08:00	2443	5301	7744	874	8618	16717	51.55%	14.61%	17	18
14	屏東縣萬巒鄉	2018-11-24T23:27:17+08:00	2591	5675	8266	900	9166	17945	51.08%	14.44%	18	18
14	屏東縣萬巒鄉	2018-11-24T22:19:36+08:00	2222	4877	7099	790	7889	15069	52.35%	14.75%	16	18
14	屏東縣萬巒鄉	2018-11-25T01:02:29+08:00	2591	5675	8266	900	9166	17945	51.08%	14.44%	18	18
14	屏東縣萬巒鄉	2018-11-24T23:51:33+08:00	2591	5675	8266	900	9166	17945	51.08%	14.44%	18	18
14	屏東縣萬巒鄉	2018-11-24T22:57:52+08:00	2591	5675	8266	900	9166	17945	51.08%	14.44%	18	18
14	屏東縣萬巒鄉	2018-11-24T23:05:03+08:00	2591	5675	8266	900	9166	17945	51.08%	14.44%	18	18
14	屏東縣萬巒鄉	2018-11-24T22:54:24+08:00	2591	5675	8266	900	9166	17945	51.08%	14.44%	18	18
14	屏東縣萬巒鄉	2018-11-25T00:18:28+08:00	2591	5675	8266	900	9166	17945	51.08%	14.44%	18	18
14	屏東縣萬巒鄉	2018-11-24T22:41:33+08:00	2591	5675	8266	900	9166	17945	51.08%	14.44%	18	18
14	屏東縣萬巒鄉	2018-11-25T00:05:03+08:00	2591	5675	8266	900	9166	17945	51.08%	14.44%	18	18
14	屏東縣萬巒鄉	2018-11-25T01:12:42+08:00	2591	5675	8266	900	9166	17945	51.08%	14.44%	18	18
14	屏東縣萬巒鄉	2018-11-24T22:50:46+08:00	2591	5675	8266	900	9166	17945	51.08%	14.44%	18	18
14	宜蘭縣礁溪鄉	2018-11-24T22:33:37+08:00	4441	9162	13603	960	14563	27013	53.91%	16.44%	28	32
14	宜蘭縣礁溪鄉	2018-11-24T23:47:28+08:00	5114	10560	15674	1128	16802	31084	54.05%	16.45%	32	32
14	宜蘭縣礁溪鄉	2018-11-24T22:37:00+08:00	4441	9162	13603	960	14563	27013	53.91%	16.44%	28	32
14	宜蘭縣礁溪鄉	2018-11-25T01:07:26+08:00	5114	10560	15674	1128	16802	31084	54.05%	16.45%	32	32
14	宜蘭縣礁溪鄉	2018-11-25T06:13:52+08:00	5114	10560	15674	1128	16802	31084	54.05%	16.45%	32	32
14	宜蘭縣礁溪鄉	2018-11-25T06:29:16+08:00	5114	10560	15674	1128	16802	31084	54.05%	16.45%	32	32
14	宜蘭縣礁溪鄉	2018-11-24T23:43:17+08:00	5114	10560	15674	1128	16802	31084	54.05%	16.45%	32	32
14	宜蘭縣礁溪鄉	2018-11-25T01:02:31+08:00	5114	10560	15674	1128	16802	31084	54.05%	16.45%	32	32
14	宜蘭縣礁溪鄉	2018-11-24T23:55:46+08:00	5114	10560	15674	1128	16802	31084	54.05%	16.45%	32	32
14	宜蘭縣礁溪鄉	2018-11-24T23:23:38+08:00	5114	10560	15674	1128	16802	31084	54.05%	16.45%	32	32
14	宜蘭縣礁溪鄉	2018-11-25T03:38:55+08:00	5114	10560	15674	1128	16802	31084	54.05%	16.45%	32	32
14	宜蘭縣礁溪鄉	2018-11-25T03:44:22+08:00	5114	10560	15674	1128	16802	31084	54.05%	16.45%	32	32
14	宜蘭縣礁溪鄉	2018-11-24T22:13:26+08:00	3886	7947	11833	839	12672	23572	53.76%	16.49%	25	32
14	宜蘭縣礁溪鄉	2018-11-24T22:23:12+08:00	4068	8426	12494	887	13381	24766	54.03%	16.43%	26	32
14	宜蘭縣礁溪鄉	2018-11-24T22:30:08+08:00	4296	8809	13105	915	14020	25891	54.15%	16.59%	27	32
14	宜蘭縣礁溪鄉	2018-11-24T22:40:27+08:00	4441	9162	13603	960	14563	27013	53.91%	16.44%	28	32
14	宜蘭縣礁溪鄉	2018-11-25T00:00:10+08:00	5114	10560	15674	1128	16802	31084	54.05%	16.45%	32	32
14	宜蘭縣礁溪鄉	2018-11-25T06:18:57+08:00	5114	10560	15674	1128	16802	31084	54.05%	16.45%	32	32
14	宜蘭縣礁溪鄉	2018-11-24T23:19:51+08:00	5114	10560	15674	1128	16802	31084	54.05%	16.45%	32	32
14	宜蘭縣礁溪鄉	2018-11-24T23:12:15+08:00	4957	10238	15195	1097	16292	29952	54.39%	16.55%	31	32
14	宜蘭縣礁溪鄉	2018-11-24T22:45:08+08:00	4441	9162	13603	960	14563	27013	53.91%	16.44%	28	32
14	宜蘭縣礁溪鄉	2018-11-24T23:01:30+08:00	4891	10078	14969	1088	16057	29534	54.37%	16.56%	30	32
14	宜蘭縣礁溪鄉	2018-11-24T23:39:15+08:00	5114	10560	15674	1128	16802	31084	54.05%	16.45%	32	32
14	宜蘭縣礁溪鄉	2018-11-24T23:31:11+08:00	5114	10560	15674	1128	16802	31084	54.05%	16.45%	32	32
14	宜蘭縣礁溪鄉	2018-11-25T00:09:34+08:00	5114	10560	15674	1128	16802	31084	54.05%	16.45%	32	32
14	宜蘭縣礁溪鄉	2018-11-24T23:35:10+08:00	5114	10560	15674	1128	16802	31084	54.05%	16.45%	32	32
14	宜蘭縣礁溪鄉	2018-11-25T00:14:09+08:00	5114	10560	15674	1128	16802	31084	54.05%	16.45%	32	32
14	宜蘭縣礁溪鄉	2018-11-25T03:49:51+08:00	5114	10560	15674	1128	16802	31084	54.05%	16.45%	32	32
14	宜蘭縣礁溪鄉	2018-11-24T23:16:02+08:00	5114	10560	15674	1128	16802	31084	54.05%	16.45%	32	32
14	宜蘭縣礁溪鄉	2018-11-25T03:56:12+08:00	5114	10560	15674	1128	16802	31084	54.05%	16.45%	32	32
14	宜蘭縣礁溪鄉	2018-11-25T06:24:00+08:00	5114	10560	15674	1128	16802	31084	54.05%	16.45%	32	32
14	宜蘭縣礁溪鄉	2018-11-25T00:23:03+08:00	5114	10560	15674	1128	16802	31084	54.05%	16.45%	32	32
14	宜蘭縣礁溪鄉	2018-11-24T23:08:35+08:00	4957	10238	15195	1097	16292	29952	54.39%	16.55%	31	32
14	宜蘭縣礁溪鄉	2018-11-25T03:32:34+08:00	5114	10560	15674	1128	16802	31084	54.05%	16.45%	32	32
14	宜蘭縣礁溪鄉	2018-11-25T01:25:52+08:00	5114	10560	15674	1128	16802	31084	54.05%	16.45%	32	32
14	宜蘭縣礁溪鄉	2018-11-24T22:57:53+08:00	4658	9651	14309	1028	15337	28327	54.14%	16.44%	29	32
14	宜蘭縣礁溪鄉	2018-11-24T22:19:36+08:00	4068	8426	12494	887	13381	24766	54.03%	16.43%	26	32
14	宜蘭縣礁溪鄉	2018-11-25T00:57:36+08:00	5114	10560	15674	1128	16802	31084	54.05%	16.45%	32	32
14	宜蘭縣礁溪鄉	2018-11-25T01:17:52+08:00	5114	10560	15674	1128	16802	31084	54.05%	16.45%	32	32
14	宜蘭縣礁溪鄉	2018-11-24T23:27:18+08:00	5114	10560	15674	1128	16802	31084	54.05%	16.45%	32	32
14	宜蘭縣礁溪鄉	2018-11-24T23:51:35+08:00	5114	10560	15674	1128	16802	31084	54.05%	16.45%	32	32
14	宜蘭縣礁溪鄉	2018-11-24T23:05:04+08:00	4957	10238	15195	1097	16292	29952	54.39%	16.55%	31	32
14	宜蘭縣礁溪鄉	2018-11-25T04:02:52+08:00	5114	10560	15674	1128	16802	31084	54.05%	16.45%	32	32
14	宜蘭縣礁溪鄉	2018-11-24T22:50:47+08:00	4658	9651	14309	1028	15337	28327	54.14%	16.44%	29	32
14	宜蘭縣礁溪鄉	2018-11-24T22:16:10+08:00	4068	8426	12494	887	13381	24766	54.03%	16.43%	26	32
14	宜蘭縣礁溪鄉	2018-11-25T01:12:43+08:00	5114	10560	15674	1128	16802	31084	54.05%	16.45%	32	32
14	宜蘭縣礁溪鄉	2018-11-25T00:05:04+08:00	5114	10560	15674	1128	16802	31084	54.05%	16.45%	32	32
14	宜蘭縣礁溪鄉	2018-11-24T22:41:34+08:00	4441	9162	13603	960	14563	27013	53.91%	16.44%	28	32
14	宜蘭縣礁溪鄉	2018-11-24T22:26:36+08:00	4296	8809	13105	915	14020	25891	54.15%	16.59%	27	32
14	宜蘭縣礁溪鄉	2018-11-25T00:18:29+08:00	5114	10560	15674	1128	16802	31084	54.05%	16.45%	32	32
14	宜蘭縣礁溪鄉	2018-11-25T06:08:52+08:00	5114	10560	15674	1128	16802	31084	54.05%	16.45%	32	32
14	宜蘭縣礁溪鄉	2018-11-24T22:54:25+08:00	4658	9651	14309	1028	15337	28327	54.14%	16.44%	29	32
14	嘉義縣東石鄉	2018-11-25T03:56:10+08:00	2032	5889	7921	963	8884	21915	40.54%	9.27%	27	27
14	嘉義縣東石鄉	2018-11-24T23:47:26+08:00	2032	5889	7921	963	8884	21915	40.54%	9.27%	27	27
14	嘉義縣東石鄉	2018-11-24T23:16:01+08:00	2032	5889	7921	963	8884	21915	40.54%	9.27%	27	27
14	嘉義縣東石鄉	2018-11-24T22:16:08+08:00	1913	5646	7559	910	8469	21014	40.3%	9.1%	26	27
14	嘉義縣東石鄉	2018-11-24T22:33:36+08:00	2032	5889	7921	963	8884	21915	40.54%	9.27%	27	27
14	嘉義縣東石鄉	2018-11-25T01:25:50+08:00	2032	5889	7921	963	8884	21915	40.54%	9.27%	27	27
14	嘉義縣東石鄉	2018-11-25T03:38:53+08:00	2032	5889	7921	963	8884	21915	40.54%	9.27%	27	27
14	嘉義縣東石鄉	2018-11-24T23:23:36+08:00	2032	5889	7921	963	8884	21915	40.54%	9.27%	27	27
14	嘉義縣東石鄉	2018-11-24T22:19:35+08:00	2032	5889	7921	963	8884	21915	40.54%	9.27%	27	27
14	嘉義縣東石鄉	2018-11-25T00:57:34+08:00	2032	5889	7921	963	8884	21915	40.54%	9.27%	27	27
14	嘉義縣東石鄉	2018-11-25T01:17:50+08:00	2032	5889	7921	963	8884	21915	40.54%	9.27%	27	27
14	嘉義縣東石鄉	2018-11-24T22:40:26+08:00	2032	5889	7921	963	8884	21915	40.54%	9.27%	27	27
14	嘉義縣東石鄉	2018-11-24T22:36:58+08:00	2032	5889	7921	963	8884	21915	40.54%	9.27%	27	27
14	嘉義縣東石鄉	2018-11-24T22:57:51+08:00	2032	5889	7921	963	8884	21915	40.54%	9.27%	27	27
14	嘉義縣東石鄉	2018-11-25T00:09:32+08:00	2032	5889	7921	963	8884	21915	40.54%	9.27%	27	27
14	嘉義縣東石鄉	2018-11-24T22:45:06+08:00	2032	5889	7921	963	8884	21915	40.54%	9.27%	27	27
14	嘉義縣東石鄉	2018-11-25T06:08:50+08:00	2032	5889	7921	963	8884	21915	40.54%	9.27%	27	27
14	嘉義縣東石鄉	2018-11-25T06:23:58+08:00	2032	5889	7921	963	8884	21915	40.54%	9.27%	27	27
14	嘉義縣東石鄉	2018-11-24T23:39:13+08:00	2032	5889	7921	963	8884	21915	40.54%	9.27%	27	27
14	嘉義縣東石鄉	2018-11-25T03:49:49+08:00	2032	5889	7921	963	8884	21915	40.54%	9.27%	27	27
14	嘉義縣東石鄉	2018-11-25T01:12:41+08:00	2032	5889	7921	963	8884	21915	40.54%	9.27%	27	27
14	嘉義縣東石鄉	2018-11-24T22:26:35+08:00	2032	5889	7921	963	8884	21915	40.54%	9.27%	27	27
14	嘉義縣東石鄉	2018-11-24T23:12:13+08:00	2032	5889	7921	963	8884	21915	40.54%	9.27%	27	27
14	嘉義縣東石鄉	2018-11-25T04:02:50+08:00	2032	5889	7921	963	8884	21915	40.54%	9.27%	27	27
14	嘉義縣東石鄉	2018-11-24T23:43:15+08:00	2032	5889	7921	963	8884	21915	40.54%	9.27%	27	27
14	嘉義縣東石鄉	2018-11-25T00:14:07+08:00	2032	5889	7921	963	8884	21915	40.54%	9.27%	27	27
14	嘉義縣東石鄉	2018-11-24T23:01:29+08:00	2032	5889	7921	963	8884	21915	40.54%	9.27%	27	27
14	嘉義縣東石鄉	2018-11-25T01:07:24+08:00	2032	5889	7921	963	8884	21915	40.54%	9.27%	27	27
14	嘉義縣東石鄉	2018-11-24T23:31:09+08:00	2032	5889	7921	963	8884	21915	40.54%	9.27%	27	27
14	嘉義縣東石鄉	2018-11-25T06:13:50+08:00	2032	5889	7921	963	8884	21915	40.54%	9.27%	27	27
14	嘉義縣東石鄉	2018-11-24T23:35:08+08:00	2032	5889	7921	963	8884	21915	40.54%	9.27%	27	27
14	嘉義縣東石鄉	2018-11-25T06:29:15+08:00	2032	5889	7921	963	8884	21915	40.54%	9.27%	27	27
14	嘉義縣東石鄉	2018-11-24T23:55:45+08:00	2032	5889	7921	963	8884	21915	40.54%	9.27%	27	27
14	嘉義縣東石鄉	2018-11-24T23:08:34+08:00	2032	5889	7921	963	8884	21915	40.54%	9.27%	27	27
14	嘉義縣東石鄉	2018-11-25T03:32:32+08:00	2032	5889	7921	963	8884	21915	40.54%	9.27%	27	27
14	嘉義縣東石鄉	2018-11-25T00:23:02+08:00	2032	5889	7921	963	8884	21915	40.54%	9.27%	27	27
14	嘉義縣東石鄉	2018-11-24T23:19:48+08:00	2032	5889	7921	963	8884	21915	40.54%	9.27%	27	27
14	嘉義縣東石鄉	2018-11-25T03:44:20+08:00	2032	5889	7921	963	8884	21915	40.54%	9.27%	27	27
14	嘉義縣東石鄉	2018-11-24T22:13:24+08:00	1913	5646	7559	910	8469	21014	40.3%	9.1%	26	27
14	嘉義縣東石鄉	2018-11-25T00:00:08+08:00	2032	5889	7921	963	8884	21915	40.54%	9.27%	27	27
14	嘉義縣東石鄉	2018-11-24T22:23:11+08:00	2032	5889	7921	963	8884	21915	40.54%	9.27%	27	27
14	嘉義縣東石鄉	2018-11-24T23:51:33+08:00	2032	5889	7921	963	8884	21915	40.54%	9.27%	27	27
14	嘉義縣東石鄉	2018-11-25T06:18:55+08:00	2032	5889	7921	963	8884	21915	40.54%	9.27%	27	27
14	嘉義縣東石鄉	2018-11-25T01:02:28+08:00	2032	5889	7921	963	8884	21915	40.54%	9.27%	27	27
14	嘉義縣東石鄉	2018-11-24T23:27:16+08:00	2032	5889	7921	963	8884	21915	40.54%	9.27%	27	27
14	嘉義縣東石鄉	2018-11-24T22:30:04+08:00	2032	5889	7921	963	8884	21915	40.54%	9.27%	27	27
14	嘉義縣東石鄉	2018-11-24T23:05:03+08:00	2032	5889	7921	963	8884	21915	40.54%	9.27%	27	27
14	嘉義縣東石鄉	2018-11-24T22:54:24+08:00	2032	5889	7921	963	8884	21915	40.54%	9.27%	27	27
14	嘉義縣東石鄉	2018-11-24T22:41:33+08:00	2032	5889	7921	963	8884	21915	40.54%	9.27%	27	27
14	嘉義縣東石鄉	2018-11-25T00:05:03+08:00	2032	5889	7921	963	8884	21915	40.54%	9.27%	27	27
14	嘉義縣東石鄉	2018-11-25T00:18:27+08:00	2032	5889	7921	963	8884	21915	40.54%	9.27%	27	27
14	嘉義縣東石鄉	2018-11-24T22:50:46+08:00	2032	5889	7921	963	8884	21915	40.54%	9.27%	27	27
14	臺南市善化區	2018-11-24T23:35:04+08:00	6455	11838	18293	1185	19478	38164	51.04%	16.91%	28	29
14	臺南市善化區	2018-11-24T23:47:21+08:00	6753	12468	19221	1254	20475	39950	51.25%	16.9%	29	29
14	臺南市善化區	2018-11-24T22:33:30+08:00	6195	11440	17635	1144	18779	36918	50.87%	16.78%	27	29
14	臺南市善化區	2018-11-24T23:31:02+08:00	6455	11838	18293	1185	19478	38164	51.04%	16.91%	28	29
14	臺南市善化區	2018-11-24T23:39:06+08:00	6455	11838	18293	1185	19478	38164	51.04%	16.91%	28	29
14	臺南市善化區	2018-11-25T01:07:19+08:00	6753	12468	19221	1254	20475	39950	51.25%	16.9%	29	29
14	臺南市善化區	2018-11-25T00:14:02+08:00	6753	12468	19221	1254	20475	39950	51.25%	16.9%	29	29
14	臺南市善化區	2018-11-24T23:43:10+08:00	6753	12468	19221	1254	20475	39950	51.25%	16.9%	29	29
14	臺南市善化區	2018-11-25T06:08:44+08:00	6753	12468	19221	1254	20475	39950	51.25%	16.9%	29	29
14	臺南市善化區	2018-11-25T00:09:26+08:00	6753	12468	19221	1254	20475	39950	51.25%	16.9%	29	29
14	臺南市善化區	2018-11-24T23:01:23+08:00	6455	11838	18293	1185	19478	38164	51.04%	16.91%	28	29
14	臺南市善化區	2018-11-24T23:12:08+08:00	6455	11838	18293	1185	19478	38164	51.04%	16.91%	28	29
14	臺南市善化區	2018-11-25T00:04:58+08:00	6753	12468	19221	1254	20475	39950	51.25%	16.9%	29	29
14	臺南市善化區	2018-11-24T23:04:57+08:00	6455	11838	18293	1185	19478	38164	51.04%	16.91%	28	29
14	臺南市善化區	2018-11-24T23:23:31+08:00	6455	11838	18293	1185	19478	38164	51.04%	16.91%	28	29
14	臺南市善化區	2018-11-25T00:57:29+08:00	6753	12468	19221	1254	20475	39950	51.25%	16.9%	29	29
14	臺南市善化區	2018-11-24T22:13:19+08:00	5451	10022	15473	1017	16490	32394	50.9%	16.83%	24	29
14	臺南市善化區	2018-11-25T03:44:14+08:00	6753	12468	19221	1254	20475	39950	51.25%	16.9%	29	29
14	臺南市善化區	2018-11-25T01:17:43+08:00	6753	12468	19221	1254	20475	39950	51.25%	16.9%	29	29
14	臺南市善化區	2018-11-24T23:55:40+08:00	6753	12468	19221	1254	20475	39950	51.25%	16.9%	29	29
14	臺南市善化區	2018-11-25T01:02:23+08:00	6753	12468	19221	1254	20475	39950	51.25%	16.9%	29	29
14	臺南市善化區	2018-11-25T01:25:45+08:00	6753	12468	19221	1254	20475	39950	51.25%	16.9%	29	29
14	臺南市善化區	2018-11-25T03:38:48+08:00	6753	12468	19221	1254	20475	39950	51.25%	16.9%	29	29
14	臺南市善化區	2018-11-25T06:18:50+08:00	6753	12468	19221	1254	20475	39950	51.25%	16.9%	29	29
14	臺南市善化區	2018-11-24T22:40:21+08:00	6455	11838	18293	1185	19478	38164	51.04%	16.91%	28	29
14	臺南市善化區	2018-11-24T23:27:12+08:00	6455	11838	18293	1185	19478	38164	51.04%	16.91%	28	29
14	臺南市善化區	2018-11-25T00:18:22+08:00	6753	12468	19221	1254	20475	39950	51.25%	16.9%	29	29
14	臺南市善化區	2018-11-24T22:54:19+08:00	6455	11838	18293	1185	19478	38164	51.04%	16.91%	28	29
14	臺南市善化區	2018-11-25T00:22:57+08:00	6753	12468	19221	1254	20475	39950	51.25%	16.9%	29	29
14	臺南市善化區	2018-11-25T03:56:04+08:00	6753	12468	19221	1254	20475	39950	51.25%	16.9%	29	29
14	臺南市善化區	2018-11-24T22:16:02+08:00	5451	10022	15473	1017	16490	32394	50.9%	16.83%	24	29
14	臺南市善化區	2018-11-24T22:41:28+08:00	6455	11838	18293	1185	19478	38164	51.04%	16.91%	28	29
14	臺南市善化區	2018-11-25T04:02:41+08:00	6753	12468	19221	1254	20475	39950	51.25%	16.9%	29	29
14	臺南市善化區	2018-11-25T01:12:35+08:00	6753	12468	19221	1254	20475	39950	51.25%	16.9%	29	29
14	臺南市善化區	2018-11-24T22:57:46+08:00	6455	11838	18293	1185	19478	38164	51.04%	16.91%	28	29
14	臺南市善化區	2018-11-24T23:19:41+08:00	6455	11838	18293	1185	19478	38164	51.04%	16.91%	28	29
14	臺南市善化區	2018-11-25T00:00:01+08:00	6753	12468	19221	1254	20475	39950	51.25%	16.9%	29	29
14	臺南市善化區	2018-11-24T23:51:27+08:00	6753	12468	19221	1254	20475	39950	51.25%	16.9%	29	29
14	臺南市善化區	2018-11-24T22:29:58+08:00	5907	10832	16739	1091	17830	35100	50.8%	16.83%	26	29
14	臺南市善化區	2018-11-24T22:23:05+08:00	5616	10365	15981	1029	17010	33526	50.74%	16.75%	25	29
14	臺南市善化區	2018-11-24T22:36:54+08:00	6195	11440	17635	1144	18779	36918	50.87%	16.78%	27	29
14	臺南市善化區	2018-11-24T23:15:56+08:00	6455	11838	18293	1185	19478	38164	51.04%	16.91%	28	29
14	臺南市善化區	2018-11-24T23:08:28+08:00	6455	11838	18293	1185	19478	38164	51.04%	16.91%	28	29
14	臺南市善化區	2018-11-25T03:32:27+08:00	6753	12468	19221	1254	20475	39950	51.25%	16.9%	29	29
14	臺南市善化區	2018-11-24T22:19:30+08:00	5616	10365	15981	1029	17010	33526	50.74%	16.75%	25	29
14	臺南市善化區	2018-11-25T03:49:44+08:00	6753	12468	19221	1254	20475	39950	51.25%	16.9%	29	29
14	臺南市善化區	2018-11-24T22:45:02+08:00	6455	11838	18293	1185	19478	38164	51.04%	16.91%	28	29
14	臺南市善化區	2018-11-24T22:50:40+08:00	6455	11838	18293	1185	19478	38164	51.04%	16.91%	28	29
14	臺南市善化區	2018-11-24T22:26:30+08:00	5616	10365	15981	1029	17010	33526	50.74%	16.75%	25	29
14	臺南市善化區	2018-11-25T06:29:09+08:00	6753	12468	19221	1254	20475	39950	51.25%	16.9%	29	29
14	臺南市善化區	2018-11-25T06:23:53+08:00	6753	12468	19221	1254	20475	39950	51.25%	16.9%	29	29
14	臺南市善化區	2018-11-25T06:13:45+08:00	6753	12468	19221	1254	20475	39950	51.25%	16.9%	29	29
14	臺南市六甲區	2018-11-24T23:35:03+08:00	2846	5630	8476	805	9281	19144	48.48%	14.87%	19	19
14	臺南市六甲區	2018-11-24T22:33:30+08:00	2846	5630	8476	805	9281	19144	48.48%	14.87%	19	19
14	臺南市六甲區	2018-11-24T23:31:02+08:00	2846	5630	8476	805	9281	19144	48.48%	14.87%	19	19
14	臺南市六甲區	2018-11-24T23:39:06+08:00	2846	5630	8476	805	9281	19144	48.48%	14.87%	19	19
14	臺南市六甲區	2018-11-24T23:12:07+08:00	2846	5630	8476	805	9281	19144	48.48%	14.87%	19	19
14	臺南市六甲區	2018-11-24T23:47:20+08:00	2846	5630	8476	805	9281	19144	48.48%	14.87%	19	19
14	臺南市六甲區	2018-11-24T23:43:10+08:00	2846	5630	8476	805	9281	19144	48.48%	14.87%	19	19
14	臺南市六甲區	2018-11-25T06:08:44+08:00	2846	5630	8476	805	9281	19144	48.48%	14.87%	19	19
14	臺南市六甲區	2018-11-25T01:07:18+08:00	2846	5630	8476	805	9281	19144	48.48%	14.87%	19	19
14	臺南市六甲區	2018-11-24T23:01:23+08:00	2846	5630	8476	805	9281	19144	48.48%	14.87%	19	19
14	臺南市六甲區	2018-11-24T22:57:45+08:00	2846	5630	8476	805	9281	19144	48.48%	14.87%	19	19
14	臺南市六甲區	2018-11-24T22:13:18+08:00	2846	5630	8476	805	9281	19144	48.48%	14.87%	19	19
14	臺南市六甲區	2018-11-25T00:57:28+08:00	2846	5630	8476	805	9281	19144	48.48%	14.87%	19	19
14	臺南市六甲區	2018-11-24T23:23:31+08:00	2846	5630	8476	805	9281	19144	48.48%	14.87%	19	19
14	臺南市六甲區	2018-11-25T03:44:14+08:00	2846	5630	8476	805	9281	19144	48.48%	14.87%	19	19
14	臺南市六甲區	2018-11-25T01:17:43+08:00	2846	5630	8476	805	9281	19144	48.48%	14.87%	19	19
14	臺南市六甲區	2018-11-25T00:04:57+08:00	2846	5630	8476	805	9281	19144	48.48%	14.87%	19	19
14	臺南市六甲區	2018-11-24T23:04:56+08:00	2846	5630	8476	805	9281	19144	48.48%	14.87%	19	19
14	臺南市六甲區	2018-11-24T23:15:55+08:00	2846	5630	8476	805	9281	19144	48.48%	14.87%	19	19
14	臺南市六甲區	2018-11-25T01:02:23+08:00	2846	5630	8476	805	9281	19144	48.48%	14.87%	19	19
14	臺南市六甲區	2018-11-25T01:25:45+08:00	2846	5630	8476	805	9281	19144	48.48%	14.87%	19	19
14	臺南市六甲區	2018-11-25T03:38:48+08:00	2846	5630	8476	805	9281	19144	48.48%	14.87%	19	19
14	臺南市六甲區	2018-11-25T06:18:50+08:00	2846	5630	8476	805	9281	19144	48.48%	14.87%	19	19
14	臺南市六甲區	2018-11-24T22:40:21+08:00	2846	5630	8476	805	9281	19144	48.48%	14.87%	19	19
14	臺南市六甲區	2018-11-24T23:55:39+08:00	2846	5630	8476	805	9281	19144	48.48%	14.87%	19	19
14	臺南市六甲區	2018-11-24T22:45:01+08:00	2846	5630	8476	805	9281	19144	48.48%	14.87%	19	19
14	臺南市六甲區	2018-11-25T00:18:22+08:00	2846	5630	8476	805	9281	19144	48.48%	14.87%	19	19
14	臺南市六甲區	2018-11-25T00:22:56+08:00	2846	5630	8476	805	9281	19144	48.48%	14.87%	19	19
14	臺南市六甲區	2018-11-24T22:54:19+08:00	2846	5630	8476	805	9281	19144	48.48%	14.87%	19	19
14	臺南市六甲區	2018-11-25T03:56:03+08:00	2846	5630	8476	805	9281	19144	48.48%	14.87%	19	19
14	臺南市六甲區	2018-11-24T22:16:02+08:00	2846	5630	8476	805	9281	19144	48.48%	14.87%	19	19
14	臺南市六甲區	2018-11-25T01:12:34+08:00	2846	5630	8476	805	9281	19144	48.48%	14.87%	19	19
14	臺南市六甲區	2018-11-24T22:50:39+08:00	2846	5630	8476	805	9281	19144	48.48%	14.87%	19	19
14	臺南市六甲區	2018-11-25T00:09:25+08:00	2846	5630	8476	805	9281	19144	48.48%	14.87%	19	19
14	臺南市六甲區	2018-11-25T00:14:01+08:00	2846	5630	8476	805	9281	19144	48.48%	14.87%	19	19
14	臺南市六甲區	2018-11-24T22:41:28+08:00	2846	5630	8476	805	9281	19144	48.48%	14.87%	19	19
14	臺南市六甲區	2018-11-25T04:02:41+08:00	2846	5630	8476	805	9281	19144	48.48%	14.87%	19	19
14	臺南市六甲區	2018-11-25T00:00:00+08:00	2846	5630	8476	805	9281	19144	48.48%	14.87%	19	19
14	臺南市六甲區	2018-11-24T22:23:04+08:00	2846	5630	8476	805	9281	19144	48.48%	14.87%	19	19
14	臺南市六甲區	2018-11-24T23:19:41+08:00	2846	5630	8476	805	9281	19144	48.48%	14.87%	19	19
14	臺南市六甲區	2018-11-24T23:51:27+08:00	2846	5630	8476	805	9281	19144	48.48%	14.87%	19	19
14	臺南市六甲區	2018-11-24T22:29:58+08:00	2846	5630	8476	805	9281	19144	48.48%	14.87%	19	19
14	臺南市六甲區	2018-11-24T22:36:54+08:00	2846	5630	8476	805	9281	19144	48.48%	14.87%	19	19
14	臺南市六甲區	2018-11-25T03:32:27+08:00	2846	5630	8476	805	9281	19144	48.48%	14.87%	19	19
14	臺南市六甲區	2018-11-24T23:27:11+08:00	2846	5630	8476	805	9281	19144	48.48%	14.87%	19	19
14	臺南市六甲區	2018-11-24T22:19:30+08:00	2846	5630	8476	805	9281	19144	48.48%	14.87%	19	19
14	臺南市六甲區	2018-11-24T23:08:27+08:00	2846	5630	8476	805	9281	19144	48.48%	14.87%	19	19
14	臺南市六甲區	2018-11-25T03:49:44+08:00	2846	5630	8476	805	9281	19144	48.48%	14.87%	19	19
14	臺南市六甲區	2018-11-24T22:26:30+08:00	2846	5630	8476	805	9281	19144	48.48%	14.87%	19	19
14	臺南市六甲區	2018-11-25T06:29:09+08:00	2846	5630	8476	805	9281	19144	48.48%	14.87%	19	19
14	臺南市六甲區	2018-11-25T06:23:53+08:00	2846	5630	8476	805	9281	19144	48.48%	14.87%	19	19
14	臺南市六甲區	2018-11-25T06:13:45+08:00	2846	5630	8476	805	9281	19144	48.48%	14.87%	19	19
14	臺中市太平區	2018-11-24T23:35:03+08:00	22282	50957	73239	4195	77434	140170	55.24%	15.9%	84	93
14	臺中市太平區	2018-11-24T22:33:30+08:00	18468	42415	60883	3473	64356	116635	55.18%	15.83%	71	93
14	臺中市太平區	2018-11-24T22:16:01+08:00	15356	35487	50843	2961	53804	97847	54.99%	15.69%	61	93
14	臺中市太平區	2018-11-24T23:31:02+08:00	22016	50342	72358	4138	76496	138149	55.37%	15.94%	83	93
14	臺中市太平區	2018-11-24T23:12:07+08:00	20369	46823	67192	3797	70989	128586	55.21%	15.84%	78	93
14	臺中市太平區	2018-11-24T23:47:20+08:00	22825	52223	75048	4327	79375	143522	55.31%	15.9%	86	93
14	臺中市太平區	2018-11-25T01:07:18+08:00	24875	57165	82040	4681	86721	157926	54.91%	15.75%	93	93
14	臺中市太平區	2018-11-25T06:08:43+08:00	24875	57165	82040	4681	86721	157926	54.91%	15.75%	93	93
14	臺中市太平區	2018-11-24T23:01:23+08:00	19915	45619	65534	3705	69239	125445	55.19%	15.88%	76	93
14	臺中市太平區	2018-11-24T22:57:45+08:00	19669	45032	64701	3671	68372	123765	55.24%	15.89%	75	93
14	臺中市太平區	2018-11-25T01:17:42+08:00	24875	57165	82040	4681	86721	157926	54.91%	15.75%	93	93
14	臺中市太平區	2018-11-24T22:13:18+08:00	14842	34392	49234	2889	52123	94654	55.07%	15.68%	59	93
14	臺中市太平區	2018-11-24T22:19:29+08:00	15978	36896	52874	3041	55915	101797	54.93%	15.7%	63	93
14	臺中市太平區	2018-11-25T00:57:28+08:00	24875	57165	82040	4681	86721	157926	54.91%	15.75%	93	93
14	臺中市太平區	2018-11-24T23:23:31+08:00	21063	48453	69516	3962	73478	132703	55.37%	15.87%	80	93
14	臺中市太平區	2018-11-25T03:44:13+08:00	24875	57165	82040	4681	86721	157926	54.91%	15.75%	93	93
14	臺中市太平區	2018-11-25T00:04:57+08:00	23161	52939	76100	4396	80496	145648	55.27%	15.9%	87	93
14	臺中市太平區	2018-11-24T23:04:56+08:00	19915	45619	65534	3705	69239	125445	55.19%	15.88%	76	93
14	臺中市太平區	2018-11-24T23:15:55+08:00	20753	47713	68466	3881	72347	130756	55.33%	15.87%	79	93
14	臺中市太平區	2018-11-25T06:18:50+08:00	24875	57165	82040	4681	86721	157926	54.91%	15.75%	93	93
14	臺中市太平區	2018-11-25T01:25:44+08:00	24875	57165	82040	4681	86721	157926	54.91%	15.75%	93	93
14	臺中市太平區	2018-11-24T22:40:21+08:00	18777	43079	61856	3521	65377	118511	55.17%	15.84%	72	93
14	臺中市太平區	2018-11-25T01:02:22+08:00	24875	57165	82040	4681	86721	157926	54.91%	15.75%	93	93
14	臺中市太平區	2018-11-25T03:38:47+08:00	24875	57165	82040	4681	86721	157926	54.91%	15.75%	93	93
14	臺中市太平區	2018-11-24T23:55:39+08:00	22825	52223	75048	4327	79375	143522	55.31%	15.9%	86	93
14	臺中市太平區	2018-11-24T22:54:18+08:00	19341	44360	63701	3632	67333	121937	55.22%	15.86%	74	93
14	臺中市太平區	2018-11-24T22:45:01+08:00	18777	43079	61856	3521	65377	118511	55.17%	15.84%	72	93
14	臺中市太平區	2018-11-25T00:18:22+08:00	23449	53703	77152	4457	81609	147696	55.25%	15.88%	88	93
14	臺中市太平區	2018-11-25T00:22:56+08:00	23896	55194	79090	4529	83619	151606	55.16%	15.76%	90	93
14	臺中市太平區	2018-11-25T03:56:03+08:00	24875	57165	82040	4681	86721	157926	54.91%	15.75%	93	93
14	臺中市太平區	2018-11-24T23:39:05+08:00	22612	51696	74308	4267	78575	142080	55.3%	15.91%	85	93
14	臺中市太平區	2018-11-25T01:12:34+08:00	24875	57165	82040	4681	86721	157926	54.91%	15.75%	93	93
14	臺中市太平區	2018-11-25T04:02:40+08:00	24875	57165	82040	4681	86721	157926	54.91%	15.75%	93	93
14	臺中市太平區	2018-11-24T22:50:39+08:00	19341	44360	63701	3632	67333	121937	55.22%	15.86%	74	93
14	臺中市太平區	2018-11-25T00:09:25+08:00	23161	52939	76100	4396	80496	145648	55.27%	15.9%	87	93
14	臺中市太平區	2018-11-25T00:14:01+08:00	23449	53703	77152	4457	81609	147696	55.25%	15.88%	88	93
14	臺中市太平區	2018-11-24T22:41:28+08:00	18777	43079	61856	3521	65377	118511	55.17%	15.84%	72	93
14	臺中市太平區	2018-11-25T00:00:00+08:00	23161	52939	76100	4396	80496	145648	55.27%	15.9%	87	93
14	臺中市太平區	2018-11-24T22:23:04+08:00	16301	37692	53993	3114	57107	103872	54.98%	15.69%	64	93
14	臺中市太平區	2018-11-24T23:19:41+08:00	20753	47713	68466	3881	72347	130756	55.33%	15.87%	79	93
14	臺中市太平區	2018-11-24T23:51:27+08:00	22825	52223	75048	4327	79375	143522	55.31%	15.9%	86	93
14	臺中市太平區	2018-11-24T22:29:58+08:00	17578	40612	58190	3357	61547	111949	54.98%	15.7%	68	93
14	臺中市太平區	2018-11-24T22:36:53+08:00	18777	43079	61856	3521	65377	118511	55.17%	15.84%	72	93
14	臺中市太平區	2018-11-24T23:27:11+08:00	21384	49045	70429	3979	74408	134186	55.45%	15.94%	81	93
14	臺中市太平區	2018-11-24T23:08:27+08:00	20122	46185	66307	3722	70029	127004	55.14%	15.84%	77	93
14	臺中市太平區	2018-11-25T03:32:26+08:00	24875	57165	82040	4681	86721	157926	54.91%	15.75%	93	93
14	臺中市太平區	2018-11-25T06:29:08+08:00	24875	57165	82040	4681	86721	157926	54.91%	15.75%	93	93
14	臺中市太平區	2018-11-25T03:49:44+08:00	24875	57165	82040	4681	86721	157926	54.91%	15.75%	93	93
14	臺中市太平區	2018-11-24T22:26:30+08:00	16863	38995	55858	3229	59087	107554	54.94%	15.68%	66	93
14	臺中市太平區	2018-11-25T06:23:52+08:00	24875	57165	82040	4681	86721	157926	54.91%	15.75%	93	93
14	臺中市太平區	2018-11-24T23:43:09+08:00	22825	52223	75048	4327	79375	143522	55.31%	15.9%	86	93
14	臺中市太平區	2018-11-25T06:13:45+08:00	24875	57165	82040	4681	86721	157926	54.91%	15.75%	93	93
14	花蓮縣豐濱鄉	2018-11-25T06:29:17+08:00	485	1248	1733	273	2006	4395	45.64%	11.04%	7	7
14	花蓮縣豐濱鄉	2018-11-24T23:47:28+08:00	417	1042	1459	203	1662	3678	45.19%	11.34%	6	7
14	花蓮縣豐濱鄉	2018-11-25T00:18:30+08:00	417	1042	1459	203	1662	3678	45.19%	11.34%	6	7
14	花蓮縣豐濱鄉	2018-11-25T01:07:26+08:00	417	1042	1459	203	1662	3678	45.19%	11.34%	6	7
14	花蓮縣豐濱鄉	2018-11-25T06:13:52+08:00	485	1248	1733	273	2006	4395	45.64%	11.04%	7	7
14	花蓮縣豐濱鄉	2018-11-24T22:33:38+08:00	275	664	939	90	1029	2396	42.95%	11.48%	4	7
14	花蓮縣豐濱鄉	2018-11-24T23:43:17+08:00	417	1042	1459	203	1662	3678	45.19%	11.34%	6	7
14	花蓮縣豐濱鄉	2018-11-24T22:37:01+08:00	275	664	939	90	1029	2396	42.95%	11.48%	4	7
14	花蓮縣豐濱鄉	2018-11-25T03:44:23+08:00	485	1248	1733	273	2006	4395	45.64%	11.04%	7	7
14	花蓮縣豐濱鄉	2018-11-24T22:13:27+08:00	275	664	939	90	1029	2396	42.95%	11.48%	4	7
14	花蓮縣豐濱鄉	2018-11-25T01:02:31+08:00	417	1042	1459	203	1662	3678	45.19%	11.34%	6	7
14	花蓮縣豐濱鄉	2018-11-24T23:23:38+08:00	417	1042	1459	203	1662	3678	45.19%	11.34%	6	7
14	花蓮縣豐濱鄉	2018-11-25T03:38:55+08:00	485	1248	1733	273	2006	4395	45.64%	11.04%	7	7
14	花蓮縣豐濱鄉	2018-11-24T23:55:47+08:00	417	1042	1459	203	1662	3678	45.19%	11.34%	6	7
14	花蓮縣豐濱鄉	2018-11-24T23:08:36+08:00	417	1042	1459	203	1662	3678	45.19%	11.34%	6	7
14	花蓮縣豐濱鄉	2018-11-25T00:00:11+08:00	417	1042	1459	203	1662	3678	45.19%	11.34%	6	7
14	花蓮縣豐濱鄉	2018-11-25T06:18:57+08:00	485	1248	1733	273	2006	4395	45.64%	11.04%	7	7
14	花蓮縣豐濱鄉	2018-11-24T22:30:09+08:00	275	664	939	90	1029	2396	42.95%	11.48%	4	7
14	花蓮縣豐濱鄉	2018-11-24T22:40:28+08:00	275	664	939	90	1029	2396	42.95%	11.48%	4	7
14	花蓮縣豐濱鄉	2018-11-24T22:23:13+08:00	275	664	939	90	1029	2396	42.95%	11.48%	4	7
14	花蓮縣豐濱鄉	2018-11-24T23:19:51+08:00	417	1042	1459	203	1662	3678	45.19%	11.34%	6	7
14	花蓮縣豐濱鄉	2018-11-24T23:35:11+08:00	417	1042	1459	203	1662	3678	45.19%	11.34%	6	7
14	花蓮縣豐濱鄉	2018-11-24T23:01:31+08:00	417	1042	1459	203	1662	3678	45.19%	11.34%	6	7
14	花蓮縣豐濱鄉	2018-11-24T22:45:09+08:00	275	664	939	90	1029	2396	42.95%	11.48%	4	7
14	花蓮縣豐濱鄉	2018-11-24T23:31:11+08:00	417	1042	1459	203	1662	3678	45.19%	11.34%	6	7
14	花蓮縣豐濱鄉	2018-11-25T00:09:34+08:00	417	1042	1459	203	1662	3678	45.19%	11.34%	6	7
14	花蓮縣豐濱鄉	2018-11-24T22:54:26+08:00	417	1042	1459	203	1662	3678	45.19%	11.34%	6	7
14	花蓮縣豐濱鄉	2018-11-25T00:14:09+08:00	417	1042	1459	203	1662	3678	45.19%	11.34%	6	7
14	花蓮縣豐濱鄉	2018-11-25T03:49:51+08:00	485	1248	1733	273	2006	4395	45.64%	11.04%	7	7
14	花蓮縣豐濱鄉	2018-11-24T23:16:03+08:00	417	1042	1459	203	1662	3678	45.19%	11.34%	6	7
14	花蓮縣豐濱鄉	2018-11-25T03:56:12+08:00	485	1248	1733	273	2006	4395	45.64%	11.04%	7	7
14	花蓮縣豐濱鄉	2018-11-25T03:32:35+08:00	485	1248	1733	273	2006	4395	45.64%	11.04%	7	7
14	花蓮縣豐濱鄉	2018-11-25T06:24:00+08:00	485	1248	1733	273	2006	4395	45.64%	11.04%	7	7
14	花蓮縣豐濱鄉	2018-11-25T01:25:53+08:00	417	1042	1459	203	1662	3678	45.19%	11.34%	6	7
14	花蓮縣豐濱鄉	2018-11-25T00:23:04+08:00	417	1042	1459	203	1662	3678	45.19%	11.34%	6	7
14	花蓮縣豐濱鄉	2018-11-25T00:57:37+08:00	417	1042	1459	203	1662	3678	45.19%	11.34%	6	7
14	花蓮縣豐濱鄉	2018-11-24T22:57:53+08:00	417	1042	1459	203	1662	3678	45.19%	11.34%	6	7
14	花蓮縣豐濱鄉	2018-11-24T22:19:37+08:00	275	664	939	90	1029	2396	42.95%	11.48%	4	7
14	花蓮縣豐濱鄉	2018-11-25T01:17:52+08:00	417	1042	1459	203	1662	3678	45.19%	11.34%	6	7
14	花蓮縣豐濱鄉	2018-11-24T23:27:18+08:00	417	1042	1459	203	1662	3678	45.19%	11.34%	6	7
14	花蓮縣豐濱鄉	2018-11-24T23:51:35+08:00	417	1042	1459	203	1662	3678	45.19%	11.34%	6	7
14	花蓮縣豐濱鄉	2018-11-24T23:05:04+08:00	417	1042	1459	203	1662	3678	45.19%	11.34%	6	7
14	花蓮縣豐濱鄉	2018-11-24T22:41:35+08:00	275	664	939	90	1029	2396	42.95%	11.48%	4	7
14	花蓮縣豐濱鄉	2018-11-25T00:05:05+08:00	417	1042	1459	203	1662	3678	45.19%	11.34%	6	7
14	花蓮縣豐濱鄉	2018-11-25T04:02:52+08:00	485	1248	1733	273	2006	4395	45.64%	11.04%	7	7
14	花蓮縣豐濱鄉	2018-11-24T23:12:16+08:00	417	1042	1459	203	1662	3678	45.19%	11.34%	6	7
14	花蓮縣豐濱鄉	2018-11-25T06:08:53+08:00	485	1248	1733	273	2006	4395	45.64%	11.04%	7	7
14	花蓮縣豐濱鄉	2018-11-25T01:12:43+08:00	417	1042	1459	203	1662	3678	45.19%	11.34%	6	7
14	花蓮縣豐濱鄉	2018-11-24T22:26:37+08:00	275	664	939	90	1029	2396	42.95%	11.48%	4	7
14	花蓮縣豐濱鄉	2018-11-24T22:50:48+08:00	417	1042	1459	203	1662	3678	45.19%	11.34%	6	7
14	花蓮縣豐濱鄉	2018-11-24T22:16:11+08:00	275	664	939	90	1029	2396	42.95%	11.48%	4	7
14	花蓮縣豐濱鄉	2018-11-24T23:39:16+08:00	417	1042	1459	203	1662	3678	45.19%	11.34%	6	7
14	臺東縣東河鄉	2018-11-25T06:29:17+08:00	788	2203	2991	358	3349	7635	43.86%	10.32%	11	11
14	臺東縣東河鄉	2018-11-25T03:49:52+08:00	788	2203	2991	358	3349	7635	43.86%	10.32%	11	11
14	臺東縣東河鄉	2018-11-24T23:47:29+08:00	788	2203	2991	358	3349	7635	43.86%	10.32%	11	11
14	臺東縣東河鄉	2018-11-24T22:33:38+08:00	589	1745	2334	276	2610	6439	40.53%	9.15%	10	11
14	臺東縣東河鄉	2018-11-25T01:07:27+08:00	788	2203	2991	358	3349	7635	43.86%	10.32%	11	11
14	臺東縣東河鄉	2018-11-25T06:13:53+08:00	788	2203	2991	358	3349	7635	43.86%	10.32%	11	11
14	臺東縣東河鄉	2018-11-24T23:43:17+08:00	788	2203	2991	358	3349	7635	43.86%	10.32%	11	11
14	臺東縣東河鄉	2018-11-25T00:18:31+08:00	788	2203	2991	358	3349	7635	43.86%	10.32%	11	11
14	臺東縣東河鄉	2018-11-24T22:37:01+08:00	589	1745	2334	276	2610	6439	40.53%	9.15%	10	11
14	臺東縣東河鄉	2018-11-24T22:13:27+08:00	589	1745	2334	276	2610	6439	40.53%	9.15%	10	11
14	臺東縣東河鄉	2018-11-25T03:44:24+08:00	788	2203	2991	358	3349	7635	43.86%	10.32%	11	11
14	臺東縣東河鄉	2018-11-25T01:02:31+08:00	788	2203	2991	358	3349	7635	43.86%	10.32%	11	11
14	臺東縣東河鄉	2018-11-24T23:08:37+08:00	788	2203	2991	358	3349	7635	43.86%	10.32%	11	11
14	臺東縣東河鄉	2018-11-25T03:38:55+08:00	788	2203	2991	358	3349	7635	43.86%	10.32%	11	11
14	臺東縣東河鄉	2018-11-24T23:55:47+08:00	788	2203	2991	358	3349	7635	43.86%	10.32%	11	11
14	臺東縣東河鄉	2018-11-24T23:23:39+08:00	788	2203	2991	358	3349	7635	43.86%	10.32%	11	11
14	臺東縣東河鄉	2018-11-25T06:18:58+08:00	788	2203	2991	358	3349	7635	43.86%	10.32%	11	11
14	臺東縣東河鄉	2018-11-25T00:00:11+08:00	788	2203	2991	358	3349	7635	43.86%	10.32%	11	11
14	臺東縣東河鄉	2018-11-24T23:51:36+08:00	788	2203	2991	358	3349	7635	43.86%	10.32%	11	11
14	臺東縣東河鄉	2018-11-24T22:30:09+08:00	589	1745	2334	276	2610	6439	40.53%	9.15%	10	11
14	臺東縣東河鄉	2018-11-24T22:23:14+08:00	589	1745	2334	276	2610	6439	40.53%	9.15%	10	11
14	臺東縣東河鄉	2018-11-24T22:40:28+08:00	589	1745	2334	276	2610	6439	40.53%	9.15%	10	11
14	臺東縣東河鄉	2018-11-25T00:09:35+08:00	788	2203	2991	358	3349	7635	43.86%	10.32%	11	11
14	臺東縣東河鄉	2018-11-24T23:35:11+08:00	788	2203	2991	358	3349	7635	43.86%	10.32%	11	11
14	臺東縣東河鄉	2018-11-24T23:01:31+08:00	589	1745	2334	276	2610	6439	40.53%	9.15%	10	11
14	臺東縣東河鄉	2018-11-24T22:45:09+08:00	589	1745	2334	276	2610	6439	40.53%	9.15%	10	11
14	臺東縣東河鄉	2018-11-24T22:54:26+08:00	589	1745	2334	276	2610	6439	40.53%	9.15%	10	11
14	臺東縣東河鄉	2018-11-25T00:14:10+08:00	788	2203	2991	358	3349	7635	43.86%	10.32%	11	11
14	臺東縣東河鄉	2018-11-25T03:56:13+08:00	788	2203	2991	358	3349	7635	43.86%	10.32%	11	11
14	臺東縣東河鄉	2018-11-24T23:16:03+08:00	788	2203	2991	358	3349	7635	43.86%	10.32%	11	11
14	臺東縣東河鄉	2018-11-25T03:32:35+08:00	788	2203	2991	358	3349	7635	43.86%	10.32%	11	11
14	臺東縣東河鄉	2018-11-25T01:25:53+08:00	788	2203	2991	358	3349	7635	43.86%	10.32%	11	11
14	臺東縣東河鄉	2018-11-25T00:23:04+08:00	788	2203	2991	358	3349	7635	43.86%	10.32%	11	11
14	臺東縣東河鄉	2018-11-25T06:24:01+08:00	788	2203	2991	358	3349	7635	43.86%	10.32%	11	11
14	臺東縣東河鄉	2018-11-24T23:27:19+08:00	788	2203	2991	358	3349	7635	43.86%	10.32%	11	11
14	臺東縣東河鄉	2018-11-25T00:57:37+08:00	788	2203	2991	358	3349	7635	43.86%	10.32%	11	11
14	臺東縣東河鄉	2018-11-24T22:57:54+08:00	589	1745	2334	276	2610	6439	40.53%	9.15%	10	11
14	臺東縣東河鄉	2018-11-25T01:17:53+08:00	788	2203	2991	358	3349	7635	43.86%	10.32%	11	11
14	臺東縣東河鄉	2018-11-24T22:19:37+08:00	589	1745	2334	276	2610	6439	40.53%	9.15%	10	11
14	臺東縣東河鄉	2018-11-24T23:19:52+08:00	788	2203	2991	358	3349	7635	43.86%	10.32%	11	11
14	臺東縣東河鄉	2018-11-24T22:41:35+08:00	589	1745	2334	276	2610	6439	40.53%	9.15%	10	11
14	臺東縣東河鄉	2018-11-25T00:05:05+08:00	788	2203	2991	358	3349	7635	43.86%	10.32%	11	11
14	臺東縣東河鄉	2018-11-24T23:12:16+08:00	788	2203	2991	358	3349	7635	43.86%	10.32%	11	11
14	臺東縣東河鄉	2018-11-25T06:08:53+08:00	788	2203	2991	358	3349	7635	43.86%	10.32%	11	11
14	臺東縣東河鄉	2018-11-25T01:12:44+08:00	788	2203	2991	358	3349	7635	43.86%	10.32%	11	11
14	臺東縣東河鄉	2018-11-24T22:50:49+08:00	589	1745	2334	276	2610	6439	40.53%	9.15%	10	11
14	臺東縣東河鄉	2018-11-24T22:26:37+08:00	589	1745	2334	276	2610	6439	40.53%	9.15%	10	11
14	臺東縣東河鄉	2018-11-25T04:02:53+08:00	788	2203	2991	358	3349	7635	43.86%	10.32%	11	11
14	臺東縣東河鄉	2018-11-24T23:05:05+08:00	788	2203	2991	358	3349	7635	43.86%	10.32%	11	11
14	臺東縣東河鄉	2018-11-24T23:31:12+08:00	788	2203	2991	358	3349	7635	43.86%	10.32%	11	11
14	臺東縣東河鄉	2018-11-24T22:16:11+08:00	589	1745	2334	276	2610	6439	40.53%	9.15%	10	11
14	臺東縣東河鄉	2018-11-24T23:39:16+08:00	788	2203	2991	358	3349	7635	43.86%	10.32%	11	11
14	桃園市龍潭區	2018-11-25T01:07:17+08:00	14320	35478	49798	2500	52298	97911	53.41%	14.63%	62	64
14	桃園市龍潭區	2018-11-25T06:08:42+08:00	14882	36956	51838	2571	54409	101574	53.57%	14.65%	64	64
14	桃園市龍潭區	2018-11-24T23:47:18+08:00	12594	31166	43760	2218	45978	86093	53.41%	14.63%	55	64
14	桃園市龍潭區	2018-11-24T23:35:02+08:00	11619	28559	40178	2067	42245	79470	53.16%	14.62%	51	64
14	桃園市龍潭區	2018-11-24T22:26:29+08:00	7269	17423	24692	1297	25989	48794	53.26%	14.9%	34	64
14	桃園市龍潭區	2018-11-24T22:16:00+08:00	7269	17423	24692	1297	25989	48794	53.26%	14.9%	34	64
14	桃園市龍潭區	2018-11-25T03:44:12+08:00	14882	36956	51838	2571	54409	101574	53.57%	14.65%	64	64
14	桃園市龍潭區	2018-11-25T00:04:56+08:00	13291	32860	46151	2347	48498	90844	53.39%	14.63%	58	64
14	桃園市龍潭區	2018-11-24T22:19:28+08:00	7269	17423	24692	1297	25989	48794	53.26%	14.9%	34	64
14	桃園市龍潭區	2018-11-24T22:57:44+08:00	10034	24589	34623	1744	36367	68749	52.9%	14.6%	45	64
14	桃園市龍潭區	2018-11-25T00:57:27+08:00	13813	34224	48037	2437	50474	94333	53.51%	14.64%	60	64
14	桃園市龍潭區	2018-11-24T22:13:17+08:00	7269	17423	24692	1297	25989	48794	53.26%	14.9%	34	64
14	桃園市龍潭區	2018-11-24T23:23:30+08:00	11047	27051	38098	1956	40054	75481	53.07%	14.64%	49	64
14	桃園市龍潭區	2018-11-24T22:29:55+08:00	7269	17423	24692	1297	25989	48794	53.26%	14.9%	34	64
14	桃園市龍潭區	2018-11-24T23:08:25+08:00	10718	26327	37045	1898	38943	73572	52.93%	14.57%	48	64
14	桃園市龍潭區	2018-11-24T23:55:38+08:00	12852	31793	44645	2268	46913	87814	53.42%	14.64%	56	64
14	桃園市龍潭區	2018-11-25T03:32:25+08:00	14882	36956	51838	2571	54409	101574	53.57%	14.65%	64	64
14	桃園市龍潭區	2018-11-24T23:15:54+08:00	10718	26327	37045	1898	38943	73572	52.93%	14.57%	48	64
14	桃園市龍潭區	2018-11-24T22:40:19+08:00	8182	19757	27939	1490	29429	55462	53.06%	14.75%	38	64
14	桃園市龍潭區	2018-11-25T01:25:43+08:00	14320	35478	49798	2500	52298	97911	53.41%	14.63%	62	64
14	桃園市龍潭區	2018-11-24T23:59:59+08:00	12852	31793	44645	2268	46913	87814	53.42%	14.64%	56	64
14	桃園市龍潭區	2018-11-25T03:38:47+08:00	14882	36956	51838	2571	54409	101574	53.57%	14.65%	64	64
14	桃園市龍潭區	2018-11-25T06:23:51+08:00	14882	36956	51838	2571	54409	101574	53.57%	14.65%	64	64
14	桃園市龍潭區	2018-11-24T22:54:17+08:00	9293	22576	31869	1606	33475	62785	53.32%	14.8%	42	64
14	桃園市龍潭區	2018-11-24T22:45:00+08:00	8536	20513	29049	1519	30568	57557	53.11%	14.83%	39	64
14	桃園市龍潭區	2018-11-24T23:01:21+08:00	10434	25698	36132	1855	37987	71816	52.89%	14.53%	47	64
14	桃園市龍潭區	2018-11-24T23:31:01+08:00	11324	27806	39130	2002	41132	77483	53.09%	14.61%	50	64
14	桃園市龍潭區	2018-11-25T00:09:23+08:00	13291	32860	46151	2347	48498	90844	53.39%	14.63%	58	64
14	桃園市龍潭區	2018-11-24T22:41:27+08:00	8182	19757	27939	1490	29429	55462	53.06%	14.75%	38	64
14	桃園市龍潭區	2018-11-25T01:12:33+08:00	14320	35478	49798	2500	52298	97911	53.41%	14.63%	62	64
14	桃園市龍潭區	2018-11-24T22:50:37+08:00	9018	21769	30787	1576	32363	60938	53.11%	14.8%	41	64
14	桃園市龍潭區	2018-11-25T00:14:00+08:00	13543	33530	47073	2402	49475	92636	53.41%	14.62%	59	64
14	桃園市龍潭區	2018-11-24T23:12:05+08:00	10718	26327	37045	1898	38943	73572	52.93%	14.57%	48	64
14	桃園市龍潭區	2018-11-24T23:39:04+08:00	11911	29335	41246	2109	43355	81494	53.2%	14.62%	52	64
14	桃園市龍潭區	2018-11-24T23:51:26+08:00	12594	31166	43760	2218	45978	86093	53.41%	14.63%	55	64
14	桃園市龍潭區	2018-11-25T06:18:49+08:00	14882	36956	51838	2571	54409	101574	53.57%	14.65%	64	64
14	桃園市龍潭區	2018-11-25T01:17:41+08:00	14320	35478	49798	2500	52298	97911	53.41%	14.63%	62	64
14	桃園市龍潭區	2018-11-24T22:23:03+08:00	7269	17423	24692	1297	25989	48794	53.26%	14.9%	34	64
14	桃園市龍潭區	2018-11-24T23:04:55+08:00	10718	26327	37045	1898	38943	73572	52.93%	14.57%	48	64
14	桃園市龍潭區	2018-11-24T23:19:40+08:00	11047	27051	38098	1956	40054	75481	53.07%	14.64%	49	64
14	桃園市龍潭區	2018-11-24T23:27:10+08:00	11047	27051	38098	1956	40054	75481	53.07%	14.64%	49	64
14	桃園市龍潭區	2018-11-24T22:36:52+08:00	7967	19234	27201	1454	28655	53898	53.17%	14.78%	37	64
14	桃園市龍潭區	2018-11-25T01:02:21+08:00	13813	34224	48037	2437	50474	94333	53.51%	14.64%	60	64
14	桃園市龍潭區	2018-11-25T03:49:43+08:00	14882	36956	51838	2571	54409	101574	53.57%	14.65%	64	64
14	桃園市龍潭區	2018-11-25T00:22:55+08:00	13543	33530	47073	2402	49475	92636	53.41%	14.62%	59	64
14	桃園市龍潭區	2018-11-25T03:56:01+08:00	14882	36956	51838	2571	54409	101574	53.57%	14.65%	64	64
14	桃園市龍潭區	2018-11-25T04:02:39+08:00	14882	36956	51838	2571	54409	101574	53.57%	14.65%	64	64
14	桃園市龍潭區	2018-11-25T06:13:44+08:00	14882	36956	51838	2571	54409	101574	53.57%	14.65%	64	64
14	桃園市龍潭區	2018-11-25T00:18:21+08:00	13543	33530	47073	2402	49475	92636	53.41%	14.62%	59	64
14	桃園市龍潭區	2018-11-24T22:33:29+08:00	7706	18552	26258	1399	27657	51817	53.37%	14.87%	36	64
14	桃園市龍潭區	2018-11-25T06:29:07+08:00	14882	36956	51838	2571	54409	101574	53.57%	14.65%	64	64
14	桃園市龍潭區	2018-11-24T23:43:08+08:00	12356	30441	42797	2168	44965	84428	53.26%	14.63%	54	64
14	臺北市大安區	2018-11-24T23:47:17+08:00	28912	47039	75951	3015	78966	137304	57.51%	21.06%	105	188
14	臺北市大安區	2018-11-24T22:26:28+08:00	11388	18489	29877	1179	31056	54903	56.57%	20.74%	44	188
14	臺北市大安區	2018-11-24T22:50:35+08:00	14901	24256	39157	1525	40682	71922	56.56%	20.72%	57	188
14	臺北市大安區	2018-11-25T01:12:31+08:00	40954	66956	107910	4232	112142	193667	57.9%	21.15%	146	188
14	臺北市大安區	2018-11-25T01:07:16+08:00	40351	65688	106039	4189	110228	190629	57.82%	21.17%	144	188
14	臺北市大安區	2018-11-24T22:19:27+08:00	10485	17085	27570	1110	28680	50880	56.37%	20.61%	41	188
14	臺北市大安區	2018-11-24T22:13:16+08:00	9020	14694	23714	938	24652	44080	55.93%	20.46%	36	188
14	臺北市大安區	2018-11-24T22:57:42+08:00	17317	28030	45347	1745	47092	82696	56.95%	20.94%	65	188
14	臺北市大安區	2018-11-25T00:57:26+08:00	39248	63783	103031	4061	107092	185108	57.85%	21.2%	140	188
14	臺北市大安區	2018-11-24T23:51:25+08:00	29198	47502	76700	3035	79735	138589	57.53%	21.07%	106	188
14	臺北市大安區	2018-11-24T22:29:54+08:00	11599	18887	30486	1200	31686	56032	56.55%	20.7%	45	188
14	臺北市大安區	2018-11-24T23:27:09+08:00	24978	40551	65529	2635	68164	118947	57.31%	21%	92	188
14	臺北市大安區	2018-11-24T22:44:59+08:00	13358	21736	35094	1352	36446	64402	56.59%	20.74%	51	188
14	臺北市大安區	2018-11-24T22:23:01+08:00	10793	17533	28326	1134	29460	52208	56.43%	20.67%	42	188
14	臺北市大安區	2018-11-25T03:55:59+08:00	53370	87228	140598	5605	146203	252645	57.87%	21.12%	188	188
14	臺北市大安區	2018-11-24T23:51:24+08:00	29198	47502	76700	3035	79735	138589	57.53%	21.07%	106	188
14	臺北市大安區	2018-11-24T23:15:52+08:00	21794	34999	56793	2238	59031	103020	57.3%	21.16%	80	188
14	臺北市大安區	2018-11-25T03:32:24+08:00	53147	86850	139997	5590	145587	251501	57.89%	21.13%	187	188
14	臺北市大安區	2018-11-25T03:38:46+08:00	53370	87228	140598	5605	146203	252645	57.87%	21.12%	188	188
14	臺北市大安區	2018-11-25T01:25:42+08:00	41450	67867	109317	4278	113595	196222	57.89%	21.12%	148	188
14	臺北市大安區	2018-11-24T23:55:36+08:00	30085	49006	79091	3127	82218	142746	57.6%	21.08%	109	188
14	臺北市大安區	2018-11-24T22:40:18+08:00	13139	21405	34544	1329	35873	63403	56.58%	20.72%	50	188
14	臺北市大安區	2018-11-24T23:08:24+08:00	19737	31769	51506	2007	53513	93517	57.22%	21.11%	73	188
14	臺北市大安區	2018-11-24T23:15:53+08:00	21794	34999	56793	2238	59031	103020	57.3%	21.16%	80	188
14	臺北市大安區	2018-11-24T23:59:57+08:00	31252	51013	82265	3274	85539	148303	57.68%	21.07%	113	188
14	臺北市大安區	2018-11-24T22:40:19+08:00	13139	21405	34544	1329	35873	63403	56.58%	20.72%	50	188
14	臺北市大安區	2018-11-24T23:55:37+08:00	30085	49006	79091	3127	82218	142746	57.6%	21.08%	109	188
14	臺北市大安區	2018-11-25T00:13:59+08:00	33564	54883	88447	3518	91965	159530	57.65%	21.04%	121	188
14	臺北市大安區	2018-11-24T22:36:51+08:00	13139	21405	34544	1329	35873	63403	56.58%	20.72%	50	188
14	臺北市大安區	2018-11-24T22:54:16+08:00	15464	25136	40600	1587	42187	74336	56.75%	20.8%	59	188
14	臺北市大安區	2018-11-25T06:29:05+08:00	53370	87228	140598	5605	146203	252645	57.87%	21.12%	188	188
14	臺北市大安區	2018-11-24T22:54:17+08:00	15464	25136	40600	1587	42187	74336	56.75%	20.8%	59	188
14	臺北市大安區	2018-11-25T06:23:50+08:00	53370	87228	140598	5605	146203	252645	57.87%	21.12%	188	188
14	臺北市大安區	2018-11-25T03:49:41+08:00	53370	87228	140598	5605	146203	252645	57.87%	21.12%	188	188
14	臺北市大安區	2018-11-24T23:39:02+08:00	26968	43920	70888	2847	73735	128498	57.38%	20.99%	99	188
14	臺北市大安區	2018-11-24T23:12:04+08:00	20028	32239	52267	2036	54303	94946	57.19%	21.09%	74	188
14	臺北市大安區	2018-11-25T06:08:41+08:00	53370	87228	140598	5605	146203	252645	57.87%	21.12%	188	188
14	臺北市大安區	2018-11-25T06:08:40+08:00	53370	87228	140598	5605	146203	252645	57.87%	21.12%	188	188
14	臺北市大安區	2018-11-25T00:09:22+08:00	31252	51013	82265	3274	85539	148303	57.68%	21.07%	113	188
14	臺北市大安區	2018-11-24T23:31:00+08:00	26445	43052	69497	2788	72285	126062	57.34%	20.98%	97	188
14	臺北市大安區	2018-11-24T23:39:03+08:00	26968	43920	70888	2847	73735	128498	57.38%	20.99%	99	188
14	臺北市大安區	2018-11-24T23:01:20+08:00	17958	29035	46993	1808	48801	85460	57.1%	21.01%	67	188
14	臺北市大安區	2018-11-24T22:50:36+08:00	14901	24256	39157	1525	40682	71922	56.56%	20.72%	57	188
14	臺北市大安區	2018-11-25T01:12:32+08:00	40954	66956	107910	4232	112142	193667	57.9%	21.15%	146	188
14	臺北市大安區	2018-11-24T22:41:26+08:00	13139	21405	34544	1329	35873	63403	56.58%	20.72%	50	188
14	臺北市大安區	2018-11-24T23:35:01+08:00	26968	43920	70888	2847	73735	128498	57.38%	20.99%	99	188
14	臺北市大安區	2018-11-24T23:04:54+08:00	18516	29863	48379	1863	50242	87972	57.11%	21.05%	69	188
14	臺北市大安區	2018-11-25T06:18:47+08:00	53370	87228	140598	5605	146203	252645	57.87%	21.12%	188	188
14	臺北市大安區	2018-11-25T00:04:55+08:00	31252	51013	82265	3274	85539	148303	57.68%	21.07%	113	188
14	臺北市大安區	2018-11-24T22:13:15+08:00	9020	14694	23714	938	24652	44080	55.93%	20.46%	36	188
14	臺北市大安區	2018-11-25T06:18:48+08:00	53370	87228	140598	5605	146203	252645	57.87%	21.12%	188	188
14	臺北市大安區	2018-11-25T03:44:10+08:00	53370	87228	140598	5605	146203	252645	57.87%	21.12%	188	188
14	臺北市大安區	2018-11-25T01:02:20+08:00	40096	65206	105302	4166	109468	189301	57.83%	21.18%	143	188
14	臺北市大安區	2018-11-25T03:38:45+08:00	53370	87228	140598	5605	146203	252645	57.87%	21.12%	188	188
14	臺北市大安區	2018-11-24T23:19:38+08:00	22230	36082	58312	2317	60629	105620	57.4%	21.05%	82	188
14	臺北市大安區	2018-11-24T23:23:29+08:00	22960	37268	60228	2407	62635	109161	57.38%	21.03%	85	188
14	臺北市大安區	2018-11-24T22:15:59+08:00	9653	15702	25355	1007	26362	47018	56.07%	20.53%	38	188
14	臺北市大安區	2018-11-25T01:17:39+08:00	41198	67436	108634	4254	112888	194913	57.92%	21.14%	147	188
14	臺北市大安區	2018-11-25T06:29:06+08:00	53370	87228	140598	5605	146203	252645	57.87%	21.12%	188	188
14	臺北市大安區	2018-11-24T22:33:28+08:00	12209	19897	32106	1249	33355	58969	56.56%	20.7%	47	188
14	臺北市大安區	2018-11-25T06:13:43+08:00	53370	87228	140598	5605	146203	252645	57.87%	21.12%	188	188
14	臺北市大安區	2018-11-24T23:43:07+08:00	28298	45975	74273	2959	77232	134376	57.47%	21.06%	103	188
14	臺北市大安區	2018-11-25T00:22:53+08:00	35313	57762	93075	3710	96785	167725	57.7%	21.05%	127	188
14	臺北市大安區	2018-11-25T03:56:00+08:00	53370	87228	140598	5605	146203	252645	57.87%	21.12%	188	188
14	臺北市大安區	2018-11-24T22:33:27+08:00	12209	19897	32106	1249	33355	58969	56.56%	20.7%	47	188
14	臺北市大安區	2018-11-25T03:49:42+08:00	53370	87228	140598	5605	146203	252645	57.87%	21.12%	188	188
14	臺北市大安區	2018-11-25T00:18:20+08:00	34123	55886	90009	3582	93591	162313	57.66%	21.02%	123	188
14	臺北市大安區	2018-11-25T06:13:42+08:00	53370	87228	140598	5605	146203	252645	57.87%	21.12%	188	188
14	臺北市大安區	2018-11-25T04:02:38+08:00	53370	87228	140598	5605	146203	252645	57.87%	21.12%	188	188
14	臺中市大甲區	2018-11-24T23:47:19+08:00	10111	23943	34054	2346	36400	63069	57.71%	16.03%	54	54
14	臺中市大甲區	2018-11-24T22:16:01+08:00	9329	22060	31389	2203	33592	58370	57.55%	15.98%	51	54
14	臺中市大甲區	2018-11-24T23:01:22+08:00	9787	23181	32968	2301	35269	61135	57.69%	16.01%	53	54
14	臺中市大甲區	2018-11-24T23:35:02+08:00	10111	23943	34054	2346	36400	63069	57.71%	16.03%	54	54
14	臺中市大甲區	2018-11-24T23:12:06+08:00	10111	23943	34054	2346	36400	63069	57.71%	16.03%	54	54
14	臺中市大甲區	2018-11-25T01:07:18+08:00	10111	23943	34054	2346	36400	63069	57.71%	16.03%	54	54
14	臺中市大甲區	2018-11-25T06:08:43+08:00	10111	23943	34054	2346	36400	63069	57.71%	16.03%	54	54
14	臺中市大甲區	2018-11-24T22:26:29+08:00	9525	22545	32070	2250	34320	59537	57.64%	16%	52	54
14	臺中市大甲區	2018-11-25T03:44:12+08:00	10111	23943	34054	2346	36400	63069	57.71%	16.03%	54	54
14	臺中市大甲區	2018-11-25T01:17:42+08:00	10111	23943	34054	2346	36400	63069	57.71%	16.03%	54	54
14	臺中市大甲區	2018-11-24T22:19:29+08:00	9329	22060	31389	2203	33592	58370	57.55%	15.98%	51	54
14	臺中市大甲區	2018-11-25T00:57:28+08:00	10111	23943	34054	2346	36400	63069	57.71%	16.03%	54	54
14	臺中市大甲區	2018-11-25T00:04:56+08:00	10111	23943	34054	2346	36400	63069	57.71%	16.03%	54	54
14	臺中市大甲區	2018-11-24T22:57:44+08:00	9787	23181	32968	2301	35269	61135	57.69%	16.01%	53	54
14	臺中市大甲區	2018-11-24T22:13:17+08:00	9329	22060	31389	2203	33592	58370	57.55%	15.98%	51	54
14	臺中市大甲區	2018-11-24T23:23:30+08:00	10111	23943	34054	2346	36400	63069	57.71%	16.03%	54	54
14	臺中市大甲區	2018-11-24T23:04:56+08:00	10111	23943	34054	2346	36400	63069	57.71%	16.03%	54	54
14	臺中市大甲區	2018-11-24T22:40:20+08:00	9525	22545	32070	2250	34320	59537	57.64%	16%	52	54
14	臺中市大甲區	2018-11-24T23:15:54+08:00	10111	23943	34054	2346	36400	63069	57.71%	16.03%	54	54
14	臺中市大甲區	2018-11-25T01:25:44+08:00	10111	23943	34054	2346	36400	63069	57.71%	16.03%	54	54
14	臺中市大甲區	2018-11-24T23:59:59+08:00	10111	23943	34054	2346	36400	63069	57.71%	16.03%	54	54
14	臺中市大甲區	2018-11-25T01:02:22+08:00	10111	23943	34054	2346	36400	63069	57.71%	16.03%	54	54
14	臺中市大甲區	2018-11-25T03:38:47+08:00	10111	23943	34054	2346	36400	63069	57.71%	16.03%	54	54
14	臺中市大甲區	2018-11-24T23:55:39+08:00	10111	23943	34054	2346	36400	63069	57.71%	16.03%	54	54
14	臺中市大甲區	2018-11-24T22:54:18+08:00	9525	22545	32070	2250	34320	59537	57.64%	16%	52	54
14	臺中市大甲區	2018-11-24T22:45:01+08:00	9525	22545	32070	2250	34320	59537	57.64%	16%	52	54
14	臺中市大甲區	2018-11-25T03:56:02+08:00	10111	23943	34054	2346	36400	63069	57.71%	16.03%	54	54
14	臺中市大甲區	2018-11-24T23:39:05+08:00	10111	23943	34054	2346	36400	63069	57.71%	16.03%	54	54
14	臺中市大甲區	2018-11-24T23:31:01+08:00	10111	23943	34054	2346	36400	63069	57.71%	16.03%	54	54
14	臺中市大甲區	2018-11-25T00:09:24+08:00	10111	23943	34054	2346	36400	63069	57.71%	16.03%	54	54
14	臺中市大甲區	2018-11-24T22:41:27+08:00	9525	22545	32070	2250	34320	59537	57.64%	16%	52	54
14	臺中市大甲區	2018-11-25T04:02:40+08:00	10111	23943	34054	2346	36400	63069	57.71%	16.03%	54	54
14	臺中市大甲區	2018-11-25T01:12:33+08:00	10111	23943	34054	2346	36400	63069	57.71%	16.03%	54	54
14	臺中市大甲區	2018-11-25T00:14:01+08:00	10111	23943	34054	2346	36400	63069	57.71%	16.03%	54	54
14	臺中市大甲區	2018-11-24T22:50:38+08:00	9525	22545	32070	2250	34320	59537	57.64%	16%	52	54
14	臺中市大甲區	2018-11-24T23:51:26+08:00	10111	23943	34054	2346	36400	63069	57.71%	16.03%	54	54
14	臺中市大甲區	2018-11-25T06:18:49+08:00	10111	23943	34054	2346	36400	63069	57.71%	16.03%	54	54
14	臺中市大甲區	2018-11-24T22:23:03+08:00	9525	22545	32070	2250	34320	59537	57.64%	16%	52	54
14	臺中市大甲區	2018-11-24T22:29:56+08:00	9525	22545	32070	2250	34320	59537	57.64%	16%	52	54
14	臺中市大甲區	2018-11-24T23:19:40+08:00	10111	23943	34054	2346	36400	63069	57.71%	16.03%	54	54
14	臺中市大甲區	2018-11-24T22:36:53+08:00	9525	22545	32070	2250	34320	59537	57.64%	16%	52	54
14	臺中市大甲區	2018-11-24T23:08:26+08:00	10111	23943	34054	2346	36400	63069	57.71%	16.03%	54	54
14	臺中市大甲區	2018-11-24T23:27:11+08:00	10111	23943	34054	2346	36400	63069	57.71%	16.03%	54	54
14	臺中市大甲區	2018-11-25T03:32:26+08:00	10111	23943	34054	2346	36400	63069	57.71%	16.03%	54	54
14	臺中市大甲區	2018-11-25T03:49:43+08:00	10111	23943	34054	2346	36400	63069	57.71%	16.03%	54	54
14	臺中市大甲區	2018-11-25T06:29:08+08:00	10111	23943	34054	2346	36400	63069	57.71%	16.03%	54	54
14	臺中市大甲區	2018-11-25T00:22:55+08:00	10111	23943	34054	2346	36400	63069	57.71%	16.03%	54	54
14	臺中市大甲區	2018-11-25T06:13:44+08:00	10111	23943	34054	2346	36400	63069	57.71%	16.03%	54	54
14	臺中市大甲區	2018-11-25T00:18:21+08:00	10111	23943	34054	2346	36400	63069	57.71%	16.03%	54	54
14	臺中市大甲區	2018-11-25T06:23:52+08:00	10111	23943	34054	2346	36400	63069	57.71%	16.03%	54	54
14	臺中市大甲區	2018-11-24T23:43:09+08:00	10111	23943	34054	2346	36400	63069	57.71%	16.03%	54	54
14	臺中市大甲區	2018-11-24T22:33:29+08:00	9525	22545	32070	2250	34320	59537	57.64%	16%	52	54
14	臺中市中區	2018-11-24T23:47:19+08:00	2451	5329	7780	489	8269	14696	56.27%	16.68%	12	12
14	臺中市中區	2018-11-24T22:16:01+08:00	2115	4714	6829	416	7245	13044	55.54%	16.21%	11	12
14	臺中市中區	2018-11-25T01:07:17+08:00	2451	5329	7780	489	8269	14696	56.27%	16.68%	12	12
14	臺中市中區	2018-11-24T23:01:22+08:00	2451	5329	7780	489	8269	14696	56.27%	16.68%	12	12
14	臺中市中區	2018-11-25T06:08:42+08:00	2451	5329	7780	489	8269	14696	56.27%	16.68%	12	12
14	臺中市中區	2018-11-24T23:35:02+08:00	2451	5329	7780	489	8269	14696	56.27%	16.68%	12	12
14	臺中市中區	2018-11-24T23:12:06+08:00	2451	5329	7780	489	8269	14696	56.27%	16.68%	12	12
14	臺中市中區	2018-11-24T22:26:29+08:00	2115	4714	6829	416	7245	13044	55.54%	16.21%	11	12
14	臺中市中區	2018-11-25T03:44:12+08:00	2451	5329	7780	489	8269	14696	56.27%	16.68%	12	12
14	臺中市中區	2018-11-25T00:04:56+08:00	2451	5329	7780	489	8269	14696	56.27%	16.68%	12	12
14	臺中市中區	2018-11-24T22:19:28+08:00	2115	4714	6829	416	7245	13044	55.54%	16.21%	11	12
14	臺中市中區	2018-11-24T22:57:44+08:00	2451	5329	7780	489	8269	14696	56.27%	16.68%	12	12
14	臺中市中區	2018-11-25T00:57:27+08:00	2451	5329	7780	489	8269	14696	56.27%	16.68%	12	12
14	臺中市中區	2018-11-24T22:13:17+08:00	2115	4714	6829	416	7245	13044	55.54%	16.21%	11	12
14	臺中市中區	2018-11-24T23:23:30+08:00	2451	5329	7780	489	8269	14696	56.27%	16.68%	12	12
14	臺中市中區	2018-11-24T23:55:38+08:00	2451	5329	7780	489	8269	14696	56.27%	16.68%	12	12
14	臺中市中區	2018-11-24T22:40:20+08:00	2451	5329	7780	489	8269	14696	56.27%	16.68%	12	12
14	臺中市中區	2018-11-24T23:15:54+08:00	2451	5329	7780	489	8269	14696	56.27%	16.68%	12	12
14	臺中市中區	2018-11-25T01:25:43+08:00	2451	5329	7780	489	8269	14696	56.27%	16.68%	12	12
14	臺中市中區	2018-11-24T23:59:59+08:00	2451	5329	7780	489	8269	14696	56.27%	16.68%	12	12
14	臺中市中區	2018-11-25T03:38:47+08:00	2451	5329	7780	489	8269	14696	56.27%	16.68%	12	12
14	臺中市中區	2018-11-24T22:54:18+08:00	2451	5329	7780	489	8269	14696	56.27%	16.68%	12	12
14	臺中市中區	2018-11-25T06:23:51+08:00	2451	5329	7780	489	8269	14696	56.27%	16.68%	12	12
14	臺中市中區	2018-11-24T22:45:00+08:00	2451	5329	7780	489	8269	14696	56.27%	16.68%	12	12
14	臺中市中區	2018-11-24T23:31:01+08:00	2451	5329	7780	489	8269	14696	56.27%	16.68%	12	12
14	臺中市中區	2018-11-25T00:09:24+08:00	2451	5329	7780	489	8269	14696	56.27%	16.68%	12	12
14	臺中市中區	2018-11-24T22:41:27+08:00	2451	5329	7780	489	8269	14696	56.27%	16.68%	12	12
14	臺中市中區	2018-11-25T04:02:40+08:00	2451	5329	7780	489	8269	14696	56.27%	16.68%	12	12
14	臺中市中區	2018-11-25T01:12:33+08:00	2451	5329	7780	489	8269	14696	56.27%	16.68%	12	12
14	臺中市中區	2018-11-24T22:50:37+08:00	2451	5329	7780	489	8269	14696	56.27%	16.68%	12	12
14	臺中市中區	2018-11-25T00:14:00+08:00	2451	5329	7780	489	8269	14696	56.27%	16.68%	12	12
14	臺中市中區	2018-11-24T23:39:04+08:00	2451	5329	7780	489	8269	14696	56.27%	16.68%	12	12
14	臺中市中區	2018-11-24T23:51:26+08:00	2451	5329	7780	489	8269	14696	56.27%	16.68%	12	12
14	臺中市中區	2018-11-25T06:18:49+08:00	2451	5329	7780	489	8269	14696	56.27%	16.68%	12	12
14	臺中市中區	2018-11-25T01:17:41+08:00	2451	5329	7780	489	8269	14696	56.27%	16.68%	12	12
14	臺中市中區	2018-11-24T22:23:03+08:00	2115	4714	6829	416	7245	13044	55.54%	16.21%	11	12
14	臺中市中區	2018-11-24T22:29:56+08:00	2115	4714	6829	416	7245	13044	55.54%	16.21%	11	12
14	臺中市中區	2018-11-24T23:04:55+08:00	2451	5329	7780	489	8269	14696	56.27%	16.68%	12	12
14	臺中市中區	2018-11-24T23:19:40+08:00	2451	5329	7780	489	8269	14696	56.27%	16.68%	12	12
14	臺中市中區	2018-11-24T23:27:10+08:00	2451	5329	7780	489	8269	14696	56.27%	16.68%	12	12
14	臺中市中區	2018-11-24T23:08:26+08:00	2451	5329	7780	489	8269	14696	56.27%	16.68%	12	12
14	臺中市中區	2018-11-24T22:36:52+08:00	2451	5329	7780	489	8269	14696	56.27%	16.68%	12	12
14	臺中市中區	2018-11-25T01:02:21+08:00	2451	5329	7780	489	8269	14696	56.27%	16.68%	12	12
14	臺中市中區	2018-11-25T03:32:26+08:00	2451	5329	7780	489	8269	14696	56.27%	16.68%	12	12
14	臺中市中區	2018-11-25T03:49:43+08:00	2451	5329	7780	489	8269	14696	56.27%	16.68%	12	12
14	臺中市中區	2018-11-25T00:22:55+08:00	2451	5329	7780	489	8269	14696	56.27%	16.68%	12	12
14	臺中市中區	2018-11-25T03:56:01+08:00	2451	5329	7780	489	8269	14696	56.27%	16.68%	12	12
14	臺中市中區	2018-11-25T06:13:44+08:00	2451	5329	7780	489	8269	14696	56.27%	16.68%	12	12
14	臺中市中區	2018-11-25T00:18:21+08:00	2451	5329	7780	489	8269	14696	56.27%	16.68%	12	12
14	臺中市中區	2018-11-24T22:33:29+08:00	2115	4714	6829	416	7245	13044	55.54%	16.21%	11	12
14	臺中市中區	2018-11-25T06:29:07+08:00	2451	5329	7780	489	8269	14696	56.27%	16.68%	12	12
14	臺中市中區	2018-11-24T23:43:08+08:00	2451	5329	7780	489	8269	14696	56.27%	16.68%	12	12
14	雲林縣斗六市	2018-11-24T23:16:00+08:00	10123	23637	33760	1538	35298	61261	57.62%	16.52%	50	69
14	雲林縣斗六市	2018-11-24T22:16:07+08:00	7023	16174	23197	1069	24266	42057	57.7%	16.7%	37	69
14	雲林縣斗六市	2018-11-24T22:23:09+08:00	7192	16599	23791	1095	24886	43203	57.6%	16.65%	38	69
14	雲林縣斗六市	2018-11-25T03:32:31+08:00	14769	34352	49121	2328	51449	89761	57.32%	16.45%	69	69
14	雲林縣斗六市	2018-11-25T00:23:01+08:00	13428	31349	44777	2160	46937	81661	57.48%	16.44%	64	69
14	雲林縣斗六市	2018-11-25T03:38:52+08:00	14769	34352	49121	2328	51449	89761	57.32%	16.45%	69	69
14	雲林縣斗六市	2018-11-24T22:36:57+08:00	8177	19113	27290	1253	28543	49607	57.54%	16.48%	42	69
14	雲林縣斗六市	2018-11-24T22:57:50+08:00	9179	21395	30574	1386	31960	55335	57.76%	16.59%	46	69
14	雲林縣斗六市	2018-11-25T00:57:33+08:00	14769	34352	49121	2328	51449	89761	57.32%	16.45%	69	69
14	雲林縣斗六市	2018-11-24T23:27:15+08:00	10877	25170	36047	1635	37682	65352	57.66%	16.64%	53	69
14	雲林縣斗六市	2018-11-24T22:19:34+08:00	7023	16174	23197	1069	24266	42057	57.7%	16.7%	37	69
14	雲林縣斗六市	2018-11-24T22:50:44+08:00	8853	20704	29557	1337	30894	53588	57.65%	16.52%	45	69
14	雲林縣斗六市	2018-11-24T23:12:12+08:00	9804	22866	32670	1472	34142	59090	57.78%	16.59%	49	69
14	雲林縣斗六市	2018-11-24T22:45:06+08:00	8415	19608	28023	1288	29311	51077	57.39%	16.48%	43	69
14	雲林縣斗六市	2018-11-25T06:13:49+08:00	14769	34352	49121	2328	51449	89761	57.32%	16.45%	69	69
14	雲林縣斗六市	2018-11-25T01:12:40+08:00	14769	34352	49121	2328	51449	89761	57.32%	16.45%	69	69
14	雲林縣斗六市	2018-11-24T22:26:34+08:00	7192	16599	23791	1095	24886	43203	57.6%	16.65%	38	69
14	雲林縣斗六市	2018-11-25T06:23:57+08:00	14769	34352	49121	2328	51449	89761	57.32%	16.45%	69	69
14	雲林縣斗六市	2018-11-24T23:39:12+08:00	11686	27055	38741	1772	40513	70114	57.78%	16.67%	56	69
14	雲林縣斗六市	2018-11-25T03:49:48+08:00	14769	34352	49121	2328	51449	89761	57.32%	16.45%	69	69
14	雲林縣斗六市	2018-11-24T23:01:28+08:00	9415	21867	31282	1414	32696	56549	57.82%	16.65%	47	69
14	雲林縣斗六市	2018-11-25T04:02:47+08:00	14769	34352	49121	2328	51449	89761	57.32%	16.45%	69	69
14	雲林縣斗六市	2018-11-24T23:47:25+08:00	11686	27055	38741	1772	40513	70114	57.78%	16.67%	56	69
14	雲林縣斗六市	2018-11-25T06:29:13+08:00	14769	34352	49121	2328	51449	89761	57.32%	16.45%	69	69
14	雲林縣斗六市	2018-11-24T23:35:07+08:00	11493	26639	38132	1721	39853	69003	57.76%	16.66%	55	69
14	雲林縣斗六市	2018-11-25T01:07:23+08:00	14769	34352	49121	2328	51449	89761	57.32%	16.45%	69	69
14	雲林縣斗六市	2018-11-24T23:43:14+08:00	11686	27055	38741	1772	40513	70114	57.78%	16.67%	56	69
14	雲林縣斗六市	2018-11-24T23:31:07+08:00	11493	26639	38132	1721	39853	69003	57.76%	16.66%	55	69
14	雲林縣斗六市	2018-11-25T06:08:49+08:00	14769	34352	49121	2328	51449	89761	57.32%	16.45%	69	69
14	雲林縣斗六市	2018-11-24T22:33:35+08:00	7944	18538	26482	1229	27711	48019	57.71%	16.54%	41	69
14	雲林縣斗六市	2018-11-25T00:14:06+08:00	12361	28807	41168	1938	43106	74719	57.69%	16.54%	60	69
14	雲林縣斗六市	2018-11-24T23:23:35+08:00	10616	24613	35229	1612	36841	63940	57.62%	16.6%	52	69
14	雲林縣斗六市	2018-11-24T22:13:23+08:00	6844	15771	22615	1052	23667	40960	57.78%	16.71%	36	69
14	雲林縣斗六市	2018-11-25T01:17:48+08:00	14769	34352	49121	2328	51449	89761	57.32%	16.45%	69	69
14	雲林縣斗六市	2018-11-24T23:55:44+08:00	11686	27055	38741	1772	40513	70114	57.78%	16.67%	56	69
14	雲林縣斗六市	2018-11-25T00:00:06+08:00	11821	27438	39259	1809	41068	71237	57.65%	16.59%	57	69
14	雲林縣斗六市	2018-11-24T23:08:32+08:00	9804	22866	32670	1472	34142	59090	57.78%	16.59%	49	69
14	雲林縣斗六市	2018-11-24T23:19:47+08:00	10333	24121	34454	1571	36025	62522	57.62%	16.53%	51	69
14	雲林縣斗六市	2018-11-25T03:44:19+08:00	14769	34352	49121	2328	51449	89761	57.32%	16.45%	69	69
14	雲林縣斗六市	2018-11-25T01:02:27+08:00	14769	34352	49121	2328	51449	89761	57.32%	16.45%	69	69
14	雲林縣斗六市	2018-11-24T22:40:25+08:00	8177	19113	27290	1253	28543	49607	57.54%	16.48%	42	69
14	雲林縣斗六市	2018-11-24T22:30:03+08:00	7192	16599	23791	1095	24886	43203	57.6%	16.65%	38	69
14	雲林縣斗六市	2018-11-25T01:25:49+08:00	14769	34352	49121	2328	51449	89761	57.32%	16.45%	69	69
14	雲林縣斗六市	2018-11-25T06:18:54+08:00	14769	34352	49121	2328	51449	89761	57.32%	16.45%	69	69
14	雲林縣斗六市	2018-11-24T23:51:32+08:00	11686	27055	38741	1772	40513	70114	57.78%	16.67%	56	69
14	雲林縣斗六市	2018-11-25T03:56:08+08:00	14769	34352	49121	2328	51449	89761	57.32%	16.45%	69	69
14	雲林縣斗六市	2018-11-25T00:05:02+08:00	11965	27826	39791	1830	41621	72164	57.68%	16.58%	58	69
14	雲林縣斗六市	2018-11-24T22:41:32+08:00	8177	19113	27290	1253	28543	49607	57.54%	16.48%	42	69
14	雲林縣斗六市	2018-11-25T00:09:31+08:00	12361	28807	41168	1938	43106	74719	57.69%	16.54%	60	69
14	雲林縣斗六市	2018-11-24T22:54:23+08:00	8853	20704	29557	1337	30894	53588	57.65%	16.52%	45	69
14	雲林縣斗六市	2018-11-24T23:05:02+08:00	9554	22288	31842	1448	33290	57736	57.66%	16.55%	48	69
14	雲林縣斗六市	2018-11-25T00:18:27+08:00	12983	30279	43262	2075	45337	78695	57.61%	16.5%	62	69
14	雲林縣二崙鄉	2018-11-24T23:16:00+08:00	3016	7007	10023	1122	11145	23367	47.7%	12.91%	23	23
14	雲林縣二崙鄉	2018-11-24T22:16:07+08:00	2333	5475	7808	901	8709	18601	46.82%	12.54%	19	23
14	雲林縣二崙鄉	2018-11-25T01:25:50+08:00	3016	7007	10023	1122	11145	23367	47.7%	12.91%	23	23
14	雲林縣二崙鄉	2018-11-25T00:23:01+08:00	3016	7007	10023	1122	11145	23367	47.7%	12.91%	23	23
14	雲林縣二崙鄉	2018-11-24T23:23:36+08:00	3016	7007	10023	1122	11145	23367	47.7%	12.91%	23	23
14	雲林縣二崙鄉	2018-11-25T03:38:52+08:00	3016	7007	10023	1122	11145	23367	47.7%	12.91%	23	23
14	雲林縣二崙鄉	2018-11-24T22:57:50+08:00	3016	7007	10023	1122	11145	23367	47.7%	12.91%	23	23
14	雲林縣二崙鄉	2018-11-25T00:57:34+08:00	3016	7007	10023	1122	11145	23367	47.7%	12.91%	23	23
14	雲林縣二崙鄉	2018-11-24T22:36:58+08:00	2883	6689	9572	1071	10643	22518	47.26%	12.8%	22	23
14	雲林縣二崙鄉	2018-11-24T22:19:34+08:00	2333	5475	7808	901	8709	18601	46.82%	12.54%	19	23
14	雲林縣二崙鄉	2018-11-24T22:45:06+08:00	2883	6689	9572	1071	10643	22518	47.26%	12.8%	22	23
14	雲林縣二崙鄉	2018-11-25T06:08:50+08:00	3016	7007	10023	1122	11145	23367	47.7%	12.91%	23	23
14	雲林縣二崙鄉	2018-11-25T01:12:40+08:00	3016	7007	10023	1122	11145	23367	47.7%	12.91%	23	23
14	雲林縣二崙鄉	2018-11-24T22:26:34+08:00	2743	6377	9120	1015	10135	21500	47.14%	12.76%	21	23
14	雲林縣二崙鄉	2018-11-25T06:23:57+08:00	3016	7007	10023	1122	11145	23367	47.7%	12.91%	23	23
14	雲林縣二崙鄉	2018-11-24T23:39:12+08:00	3016	7007	10023	1122	11145	23367	47.7%	12.91%	23	23
14	雲林縣二崙鄉	2018-11-24T22:50:45+08:00	3016	7007	10023	1122	11145	23367	47.7%	12.91%	23	23
14	雲林縣二崙鄉	2018-11-24T23:12:13+08:00	3016	7007	10023	1122	11145	23367	47.7%	12.91%	23	23
14	雲林縣二崙鄉	2018-11-25T03:49:48+08:00	3016	7007	10023	1122	11145	23367	47.7%	12.91%	23	23
14	雲林縣二崙鄉	2018-11-24T23:31:08+08:00	3016	7007	10023	1122	11145	23367	47.7%	12.91%	23	23
14	雲林縣二崙鄉	2018-11-24T23:01:28+08:00	3016	7007	10023	1122	11145	23367	47.7%	12.91%	23	23
14	雲林縣二崙鄉	2018-11-24T23:47:25+08:00	3016	7007	10023	1122	11145	23367	47.7%	12.91%	23	23
14	雲林縣二崙鄉	2018-11-25T06:29:14+08:00	3016	7007	10023	1122	11145	23367	47.7%	12.91%	23	23
14	雲林縣二崙鄉	2018-11-25T04:02:49+08:00	3016	7007	10023	1122	11145	23367	47.7%	12.91%	23	23
14	雲林縣二崙鄉	2018-11-25T01:07:23+08:00	3016	7007	10023	1122	11145	23367	47.7%	12.91%	23	23
14	雲林縣二崙鄉	2018-11-24T23:43:14+08:00	3016	7007	10023	1122	11145	23367	47.7%	12.91%	23	23
14	雲林縣二崙鄉	2018-11-25T06:13:50+08:00	3016	7007	10023	1122	11145	23367	47.7%	12.91%	23	23
14	雲林縣二崙鄉	2018-11-24T23:35:08+08:00	3016	7007	10023	1122	11145	23367	47.7%	12.91%	23	23
14	雲林縣二崙鄉	2018-11-24T22:33:35+08:00	2883	6689	9572	1071	10643	22518	47.26%	12.8%	22	23
14	雲林縣二崙鄉	2018-11-25T00:14:06+08:00	3016	7007	10023	1122	11145	23367	47.7%	12.91%	23	23
14	雲林縣二崙鄉	2018-11-25T00:00:07+08:00	3016	7007	10023	1122	11145	23367	47.7%	12.91%	23	23
14	雲林縣二崙鄉	2018-11-24T23:08:33+08:00	3016	7007	10023	1122	11145	23367	47.7%	12.91%	23	23
14	雲林縣二崙鄉	2018-11-25T03:32:32+08:00	3016	7007	10023	1122	11145	23367	47.7%	12.91%	23	23
14	雲林縣二崙鄉	2018-11-25T03:44:20+08:00	3016	7007	10023	1122	11145	23367	47.7%	12.91%	23	23
14	雲林縣二崙鄉	2018-11-24T22:13:24+08:00	2333	5475	7808	901	8709	18601	46.82%	12.54%	19	23
14	雲林縣二崙鄉	2018-11-24T23:55:44+08:00	3016	7007	10023	1122	11145	23367	47.7%	12.91%	23	23
14	雲林縣二崙鄉	2018-11-25T01:17:49+08:00	3016	7007	10023	1122	11145	23367	47.7%	12.91%	23	23
14	雲林縣二崙鄉	2018-11-24T23:19:47+08:00	3016	7007	10023	1122	11145	23367	47.7%	12.91%	23	23
14	雲林縣二崙鄉	2018-11-25T06:18:55+08:00	3016	7007	10023	1122	11145	23367	47.7%	12.91%	23	23
14	雲林縣二崙鄉	2018-11-25T01:02:28+08:00	3016	7007	10023	1122	11145	23367	47.7%	12.91%	23	23
14	雲林縣二崙鄉	2018-11-24T23:27:16+08:00	3016	7007	10023	1122	11145	23367	47.7%	12.91%	23	23
14	雲林縣二崙鄉	2018-11-24T22:40:25+08:00	2883	6689	9572	1071	10643	22518	47.26%	12.8%	22	23
14	雲林縣二崙鄉	2018-11-24T22:23:10+08:00	2563	5977	8540	962	9502	20339	46.72%	12.6%	20	23
14	雲林縣二崙鄉	2018-11-24T22:30:03+08:00	2743	6377	9120	1015	10135	21500	47.14%	12.76%	21	23
14	雲林縣二崙鄉	2018-11-24T23:51:32+08:00	3016	7007	10023	1122	11145	23367	47.7%	12.91%	23	23
14	雲林縣二崙鄉	2018-11-25T00:05:02+08:00	3016	7007	10023	1122	11145	23367	47.7%	12.91%	23	23
14	雲林縣二崙鄉	2018-11-24T22:41:32+08:00	2883	6689	9572	1071	10643	22518	47.26%	12.8%	22	23
14	雲林縣二崙鄉	2018-11-25T00:09:31+08:00	3016	7007	10023	1122	11145	23367	47.7%	12.91%	23	23
14	雲林縣二崙鄉	2018-11-24T22:54:23+08:00	3016	7007	10023	1122	11145	23367	47.7%	12.91%	23	23
14	雲林縣二崙鄉	2018-11-24T23:05:02+08:00	3016	7007	10023	1122	11145	23367	47.7%	12.91%	23	23
14	雲林縣二崙鄉	2018-11-25T03:56:09+08:00	3016	7007	10023	1122	11145	23367	47.7%	12.91%	23	23
14	雲林縣二崙鄉	2018-11-25T00:18:27+08:00	3016	7007	10023	1122	11145	23367	47.7%	12.91%	23	23
14	新竹縣新豐鄉	2018-11-25T04:02:43+08:00	7092	17354	24446	1199	25645	45790	56.01%	15.49%	39	39
14	新竹縣新豐鄉	2018-11-25T01:12:37+08:00	7092	17354	24446	1199	25645	45790	56.01%	15.49%	39	39
14	新竹縣新豐鄉	2018-11-25T00:14:04+08:00	6865	16798	23663	1171	24834	44345	56%	15.48%	38	39
14	新竹縣新豐鄉	2018-11-24T23:31:05+08:00	6050	14751	20801	1051	21852	38880	56.2%	15.56%	34	39
14	新竹縣新豐鄉	2018-11-25T01:07:21+08:00	7092	17354	24446	1199	25645	45790	56.01%	15.49%	39	39
14	新竹縣新豐鄉	2018-11-24T23:35:05+08:00	6050	14751	20801	1051	21852	38880	56.2%	15.56%	34	39
14	新竹縣新豐鄉	2018-11-25T06:29:11+08:00	7092	17354	24446	1199	25645	45790	56.01%	15.49%	39	39
14	新竹縣新豐鄉	2018-11-24T23:39:09+08:00	6050	14751	20801	1051	21852	38880	56.2%	15.56%	34	39
14	新竹縣新豐鄉	2018-11-25T00:09:28+08:00	6717	16406	23123	1127	24250	43265	56.05%	15.53%	37	39
14	新竹縣新豐鄉	2018-11-24T22:23:07+08:00	3194	7869	11063	526	11589	20815	55.68%	15.34%	19	39
14	新竹縣新豐鄉	2018-11-25T00:00:03+08:00	6275	15289	21564	1069	22633	40366	56.07%	15.55%	35	39
14	新竹縣新豐鄉	2018-11-24T23:08:30+08:00	4896	12108	17004	911	17915	32077	55.85%	15.26%	29	39
14	新竹縣新豐鄉	2018-11-24T23:19:44+08:00	5601	13700	19301	1021	20322	36307	55.97%	15.43%	32	39
14	新竹縣新豐鄉	2018-11-24T22:13:21+08:00	2840	7026	9866	465	10331	18457	55.97%	15.39%	17	39
14	新竹縣新豐鄉	2018-11-25T03:32:30+08:00	7092	17354	24446	1199	25645	45790	56.01%	15.49%	39	39
14	新竹縣新豐鄉	2018-11-24T23:51:30+08:00	6275	15289	21564	1069	22633	40366	56.07%	15.55%	35	39
14	新竹縣新豐鄉	2018-11-24T22:30:01+08:00	3417	8424	11841	578	12419	22292	55.71%	15.33%	20	39
14	新竹縣新豐鄉	2018-11-24T23:27:14+08:00	6050	14751	20801	1051	21852	38880	56.2%	15.56%	34	39
14	新竹縣新豐鄉	2018-11-24T22:19:32+08:00	3194	7869	11063	526	11589	20815	55.68%	15.34%	19	39
14	新竹縣新豐鄉	2018-11-24T22:36:56+08:00	4094	9979	14073	712	14785	26444	55.91%	15.48%	24	39
14	新竹縣新豐鄉	2018-11-25T01:02:25+08:00	7092	17354	24446	1199	25645	45790	56.01%	15.49%	39	39
14	新竹縣新豐鄉	2018-11-25T06:13:47+08:00	7092	17354	24446	1199	25645	45790	56.01%	15.49%	39	39
14	新竹縣新豐鄉	2018-11-25T00:18:25+08:00	6865	16798	23663	1171	24834	44345	56%	15.48%	38	39
14	新竹縣新豐鄉	2018-11-24T23:05:00+08:00	4896	12108	17004	911	17915	32077	55.85%	15.26%	29	39
14	新竹縣新豐鄉	2018-11-24T22:26:32+08:00	3194	7869	11063	526	11589	20815	55.68%	15.34%	19	39
14	新竹縣新豐鄉	2018-11-24T22:50:42+08:00	4422	10779	15201	772	15973	28724	55.61%	15.39%	26	39
14	新竹縣新豐鄉	2018-11-24T22:54:21+08:00	4422	10779	15201	772	15973	28724	55.61%	15.39%	26	39
14	新竹縣新豐鄉	2018-11-25T00:05:00+08:00	6472	15871	22343	1094	23437	41822	56.04%	15.48%	36	39
14	新竹縣新豐鄉	2018-11-24T22:41:30+08:00	4242	10364	14606	755	15361	27507	55.84%	15.42%	25	39
14	新竹縣新豐鄉	2018-11-25T00:22:59+08:00	6865	16798	23663	1171	24834	44345	56%	15.48%	38	39
14	新竹縣新豐鄉	2018-11-25T03:49:46+08:00	7092	17354	24446	1199	25645	45790	56.01%	15.49%	39	39
14	新竹縣新豐鄉	2018-11-24T22:16:05+08:00	3041	7473	10514	500	11014	19726	55.83%	15.42%	18	39
14	新竹縣新豐鄉	2018-11-24T23:01:26+08:00	4734	11646	16380	866	17246	31010	55.61%	15.27%	28	39
14	新竹縣新豐鄉	2018-11-24T23:43:12+08:00	6050	14751	20801	1051	21852	38880	56.2%	15.56%	34	39
14	新竹縣新豐鄉	2018-11-24T22:33:33+08:00	3928	9608	13536	676	14212	25441	55.86%	15.44%	23	39
14	新竹縣新豐鄉	2018-11-25T06:08:47+08:00	7092	17354	24446	1199	25645	45790	56.01%	15.49%	39	39
14	新竹縣新豐鄉	2018-11-24T23:47:23+08:00	6050	14751	20801	1051	21852	38880	56.2%	15.56%	34	39
14	新竹縣新豐鄉	2018-11-24T23:55:42+08:00	6275	15289	21564	1069	22633	40366	56.07%	15.55%	35	39
14	新竹縣新豐鄉	2018-11-25T01:17:46+08:00	7092	17354	24446	1199	25645	45790	56.01%	15.49%	39	39
14	新竹縣新豐鄉	2018-11-24T22:57:48+08:00	4555	11150	15705	829	16534	29753	55.57%	15.31%	27	39
14	新竹縣新豐鄉	2018-11-25T03:38:50+08:00	7092	17354	24446	1199	25645	45790	56.01%	15.49%	39	39
14	新竹縣新豐鄉	2018-11-24T23:23:33+08:00	6050	14751	20801	1051	21852	38880	56.2%	15.56%	34	39
14	新竹縣新豐鄉	2018-11-25T03:44:17+08:00	7092	17354	24446	1199	25645	45790	56.01%	15.49%	39	39
14	新竹縣新豐鄉	2018-11-24T22:40:23+08:00	4242	10364	14606	755	15361	27507	55.84%	15.42%	25	39
14	新竹縣新豐鄉	2018-11-25T06:18:52+08:00	7092	17354	24446	1199	25645	45790	56.01%	15.49%	39	39
14	新竹縣新豐鄉	2018-11-24T23:15:58+08:00	5317	13066	18383	988	19371	34645	55.91%	15.35%	31	39
14	新竹縣新豐鄉	2018-11-25T00:57:31+08:00	7092	17354	24446	1199	25645	45790	56.01%	15.49%	39	39
14	新竹縣新豐鄉	2018-11-25T01:25:47+08:00	7092	17354	24446	1199	25645	45790	56.01%	15.49%	39	39
14	新竹縣新豐鄉	2018-11-25T03:56:06+08:00	7092	17354	24446	1199	25645	45790	56.01%	15.49%	39	39
14	新竹縣新豐鄉	2018-11-25T06:23:55+08:00	7092	17354	24446	1199	25645	45790	56.01%	15.49%	39	39
14	新竹縣新豐鄉	2018-11-24T22:45:04+08:00	4242	10364	14606	755	15361	27507	55.84%	15.42%	25	39
14	新竹縣新豐鄉	2018-11-24T23:12:10+08:00	5110	12515	17625	958	18583	33343	55.73%	15.33%	30	39
14	苗栗縣公館鄉	2018-11-25T04:02:44+08:00	4235	11312	15547	1169	16716	28318	59.03%	14.96%	28	28
14	苗栗縣公館鄉	2018-11-25T00:09:29+08:00	4235	11312	15547	1169	16716	28318	59.03%	14.96%	28	28
14	苗栗縣公館鄉	2018-11-25T01:12:38+08:00	4235	11312	15547	1169	16716	28318	59.03%	14.96%	28	28
14	苗栗縣公館鄉	2018-11-25T00:14:05+08:00	4235	11312	15547	1169	16716	28318	59.03%	14.96%	28	28
14	苗栗縣公館鄉	2018-11-24T23:19:45+08:00	4235	11312	15547	1169	16716	28318	59.03%	14.96%	28	28
14	苗栗縣公館鄉	2018-11-25T00:00:03+08:00	4235	11312	15547	1169	16716	28318	59.03%	14.96%	28	28
14	苗栗縣公館鄉	2018-11-24T22:23:08+08:00	3642	9799	13441	1052	14493	24514	59.12%	14.86%	25	28
14	苗栗縣公館鄉	2018-11-24T23:08:31+08:00	4235	11312	15547	1169	16716	28318	59.03%	14.96%	28	28
14	苗栗縣公館鄉	2018-11-25T03:32:30+08:00	4235	11312	15547	1169	16716	28318	59.03%	14.96%	28	28
14	苗栗縣公館鄉	2018-11-24T23:51:30+08:00	4235	11312	15547	1169	16716	28318	59.03%	14.96%	28	28
14	苗栗縣公館鄉	2018-11-24T22:30:01+08:00	3642	9799	13441	1052	14493	24514	59.12%	14.86%	25	28
14	苗栗縣公館鄉	2018-11-24T23:27:14+08:00	4235	11312	15547	1169	16716	28318	59.03%	14.96%	28	28
14	苗栗縣公館鄉	2018-11-24T22:19:33+08:00	3642	9799	13441	1052	14493	24514	59.12%	14.86%	25	28
14	苗栗縣公館鄉	2018-11-25T00:57:32+08:00	4235	11312	15547	1169	16716	28318	59.03%	14.96%	28	28
14	苗栗縣公館鄉	2018-11-24T22:36:56+08:00	4069	10856	14925	1140	16065	27086	59.31%	15.02%	27	28
14	苗栗縣公館鄉	2018-11-24T22:50:43+08:00	4069	10856	14925	1140	16065	27086	59.31%	15.02%	27	28
14	苗栗縣公館鄉	2018-11-25T00:18:25+08:00	4235	11312	15547	1169	16716	28318	59.03%	14.96%	28	28
14	苗栗縣公館鄉	2018-11-25T06:23:56+08:00	4235	11312	15547	1169	16716	28318	59.03%	14.96%	28	28
14	苗栗縣公館鄉	2018-11-24T22:26:33+08:00	3642	9799	13441	1052	14493	24514	59.12%	14.86%	25	28
14	苗栗縣公館鄉	2018-11-24T23:05:00+08:00	4235	11312	15547	1169	16716	28318	59.03%	14.96%	28	28
14	苗栗縣公館鄉	2018-11-25T03:49:47+08:00	4235	11312	15547	1169	16716	28318	59.03%	14.96%	28	28
14	苗栗縣公館鄉	2018-11-24T22:41:31+08:00	4069	10856	14925	1140	16065	27086	59.31%	15.02%	27	28
14	苗栗縣公館鄉	2018-11-25T06:13:48+08:00	4235	11312	15547	1169	16716	28318	59.03%	14.96%	28	28
14	苗栗縣公館鄉	2018-11-25T00:05:00+08:00	4235	11312	15547	1169	16716	28318	59.03%	14.96%	28	28
14	苗栗縣公館鄉	2018-11-25T00:22:59+08:00	4235	11312	15547	1169	16716	28318	59.03%	14.96%	28	28
14	苗栗縣公館鄉	2018-11-24T23:31:06+08:00	4235	11312	15547	1169	16716	28318	59.03%	14.96%	28	28
14	苗栗縣公館鄉	2018-11-24T22:16:05+08:00	3642	9799	13441	1052	14493	24514	59.12%	14.86%	25	28
14	苗栗縣公館鄉	2018-11-25T01:07:22+08:00	4235	11312	15547	1169	16716	28318	59.03%	14.96%	28	28
14	苗栗縣公館鄉	2018-11-24T22:33:33+08:00	3852	10324	14176	1094	15270	25764	59.27%	14.95%	26	28
14	苗栗縣公館鄉	2018-11-24T23:43:13+08:00	4235	11312	15547	1169	16716	28318	59.03%	14.96%	28	28
14	苗栗縣公館鄉	2018-11-25T06:08:47+08:00	4235	11312	15547	1169	16716	28318	59.03%	14.96%	28	28
14	苗栗縣公館鄉	2018-11-24T23:01:27+08:00	4235	11312	15547	1169	16716	28318	59.03%	14.96%	28	28
14	苗栗縣公館鄉	2018-11-24T23:35:06+08:00	4235	11312	15547	1169	16716	28318	59.03%	14.96%	28	28
14	苗栗縣公館鄉	2018-11-25T06:29:12+08:00	4235	11312	15547	1169	16716	28318	59.03%	14.96%	28	28
14	苗栗縣公館鄉	2018-11-24T23:47:24+08:00	4235	11312	15547	1169	16716	28318	59.03%	14.96%	28	28
14	苗栗縣公館鄉	2018-11-24T23:55:42+08:00	4235	11312	15547	1169	16716	28318	59.03%	14.96%	28	28
14	苗栗縣公館鄉	2018-11-24T22:57:48+08:00	4235	11312	15547	1169	16716	28318	59.03%	14.96%	28	28
14	苗栗縣公館鄉	2018-11-24T23:23:34+08:00	4235	11312	15547	1169	16716	28318	59.03%	14.96%	28	28
14	苗栗縣公館鄉	2018-11-25T03:38:51+08:00	4235	11312	15547	1169	16716	28318	59.03%	14.96%	28	28
14	苗栗縣公館鄉	2018-11-24T22:13:22+08:00	3642	9799	13441	1052	14493	24514	59.12%	14.86%	25	28
14	苗栗縣公館鄉	2018-11-25T01:17:47+08:00	4235	11312	15547	1169	16716	28318	59.03%	14.96%	28	28
14	苗栗縣公館鄉	2018-11-25T03:44:17+08:00	4235	11312	15547	1169	16716	28318	59.03%	14.96%	28	28
14	苗栗縣公館鄉	2018-11-25T01:25:48+08:00	4235	11312	15547	1169	16716	28318	59.03%	14.96%	28	28
14	苗栗縣公館鄉	2018-11-24T22:40:24+08:00	4069	10856	14925	1140	16065	27086	59.31%	15.02%	27	28
14	苗栗縣公館鄉	2018-11-24T23:15:58+08:00	4235	11312	15547	1169	16716	28318	59.03%	14.96%	28	28
14	苗栗縣公館鄉	2018-11-25T01:02:26+08:00	4235	11312	15547	1169	16716	28318	59.03%	14.96%	28	28
14	苗栗縣公館鄉	2018-11-25T06:18:53+08:00	4235	11312	15547	1169	16716	28318	59.03%	14.96%	28	28
14	苗栗縣公館鄉	2018-11-24T23:12:11+08:00	4235	11312	15547	1169	16716	28318	59.03%	14.96%	28	28
14	苗栗縣公館鄉	2018-11-24T23:39:10+08:00	4235	11312	15547	1169	16716	28318	59.03%	14.96%	28	28
14	苗栗縣公館鄉	2018-11-25T03:56:07+08:00	4235	11312	15547	1169	16716	28318	59.03%	14.96%	28	28
14	苗栗縣公館鄉	2018-11-24T22:45:04+08:00	4069	10856	14925	1140	16065	27086	59.31%	15.02%	27	28
14	苗栗縣公館鄉	2018-11-24T22:54:22+08:00	4069	10856	14925	1140	16065	27086	59.31%	15.02%	27	28
14	基隆市中山區	2018-11-24T22:33:39+08:00	5677	11470	17147	1060	18207	35945	50.65%	15.79%	32	35
14	基隆市中山區	2018-11-25T06:29:19+08:00	6749	13396	20145	1141	21286	41856	50.86%	16.12%	35	35
14	基隆市中山區	2018-11-24T23:43:18+08:00	6398	12723	19121	1112	20233	39910	50.7%	16.03%	34	35
14	基隆市中山區	2018-11-25T01:07:28+08:00	6749	13396	20145	1141	21286	41856	50.86%	16.12%	35	35
14	基隆市中山區	2018-11-25T03:49:53+08:00	6749	13396	20145	1141	21286	41856	50.86%	16.12%	35	35
14	基隆市中山區	2018-11-24T22:50:50+08:00	6050	12184	18234	1091	19325	38033	50.81%	15.91%	33	35
14	基隆市中山區	2018-11-25T06:13:54+08:00	6749	13396	20145	1141	21286	41856	50.86%	16.12%	35	35
14	基隆市中山區	2018-11-24T22:13:29+08:00	4738	9526	14264	813	15077	29617	50.91%	16%	28	35
14	基隆市中山區	2018-11-25T03:32:36+08:00	6749	13396	20145	1141	21286	41856	50.86%	16.12%	35	35
14	基隆市中山區	2018-11-25T03:44:25+08:00	6749	13396	20145	1141	21286	41856	50.86%	16.12%	35	35
14	基隆市中山區	2018-11-24T23:08:38+08:00	6050	12184	18234	1091	19325	38033	50.81%	15.91%	33	35
14	基隆市中山區	2018-11-24T23:55:49+08:00	6749	13396	20145	1141	21286	41856	50.86%	16.12%	35	35
14	基隆市中山區	2018-11-25T06:24:02+08:00	6749	13396	20145	1141	21286	41856	50.86%	16.12%	35	35
14	基隆市中山區	2018-11-24T23:51:37+08:00	6749	13396	20145	1141	21286	41856	50.86%	16.12%	35	35
14	基隆市中山區	2018-11-24T22:23:15+08:00	5486	11083	16569	977	17546	34765	50.47%	15.78%	31	35
14	基隆市中山區	2018-11-24T22:40:29+08:00	5677	11470	17147	1060	18207	35945	50.65%	15.79%	32	35
14	基隆市中山區	2018-11-25T06:18:59+08:00	6749	13396	20145	1141	21286	41856	50.86%	16.12%	35	35
14	基隆市中山區	2018-11-24T23:23:40+08:00	6050	12184	18234	1091	19325	38033	50.81%	15.91%	33	35
14	基隆市中山區	2018-11-24T22:54:27+08:00	6050	12184	18234	1091	19325	38033	50.81%	15.91%	33	35
14	基隆市中山區	2018-11-25T00:14:11+08:00	6749	13396	20145	1141	21286	41856	50.86%	16.12%	35	35
14	基隆市中山區	2018-11-24T22:16:12+08:00	5031	10137	15168	879	16047	31555	50.85%	15.94%	29	35
14	基隆市中山區	2018-11-24T22:41:37+08:00	5677	11470	17147	1060	18207	35945	50.65%	15.79%	32	35
14	基隆市中山區	2018-11-25T00:05:07+08:00	6749	13396	20145	1141	21286	41856	50.86%	16.12%	35	35
14	基隆市中山區	2018-11-24T23:05:06+08:00	6050	12184	18234	1091	19325	38033	50.81%	15.91%	33	35
14	基隆市中山區	2018-11-24T22:45:10+08:00	5677	11470	17147	1060	18207	35945	50.65%	15.79%	32	35
14	基隆市中山區	2018-11-25T03:56:14+08:00	6749	13396	20145	1141	21286	41856	50.86%	16.12%	35	35
14	基隆市中山區	2018-11-24T22:37:02+08:00	5677	11470	17147	1060	18207	35945	50.65%	15.79%	32	35
14	基隆市中山區	2018-11-25T00:18:32+08:00	6749	13396	20145	1141	21286	41856	50.86%	16.12%	35	35
14	基隆市中山區	2018-11-24T23:16:04+08:00	6050	12184	18234	1091	19325	38033	50.81%	15.91%	33	35
14	基隆市中山區	2018-11-25T00:23:05+08:00	6749	13396	20145	1141	21286	41856	50.86%	16.12%	35	35
14	基隆市中山區	2018-11-25T01:25:54+08:00	6749	13396	20145	1141	21286	41856	50.86%	16.12%	35	35
14	基隆市中山區	2018-11-24T22:30:11+08:00	5677	11470	17147	1060	18207	35945	50.65%	15.79%	32	35
14	基隆市中山區	2018-11-25T03:38:56+08:00	6749	13396	20145	1141	21286	41856	50.86%	16.12%	35	35
14	基隆市中山區	2018-11-25T01:02:33+08:00	6749	13396	20145	1141	21286	41856	50.86%	16.12%	35	35
14	基隆市中山區	2018-11-24T22:19:38+08:00	5252	10608	15860	945	16805	33197	50.62%	15.82%	30	35
14	基隆市中山區	2018-11-24T23:19:53+08:00	6050	12184	18234	1091	19325	38033	50.81%	15.91%	33	35
14	基隆市中山區	2018-11-25T01:17:54+08:00	6749	13396	20145	1141	21286	41856	50.86%	16.12%	35	35
14	基隆市中山區	2018-11-25T00:00:12+08:00	6749	13396	20145	1141	21286	41856	50.86%	16.12%	35	35
14	基隆市中山區	2018-11-24T22:57:55+08:00	6050	12184	18234	1091	19325	38033	50.81%	15.91%	33	35
14	基隆市中山區	2018-11-24T23:27:20+08:00	6050	12184	18234	1091	19325	38033	50.81%	15.91%	33	35
14	基隆市中山區	2018-11-25T00:57:38+08:00	6749	13396	20145	1141	21286	41856	50.86%	16.12%	35	35
14	基隆市中山區	2018-11-24T23:35:12+08:00	6398	12723	19121	1112	20233	39910	50.7%	16.03%	34	35
14	基隆市中山區	2018-11-24T23:47:30+08:00	6398	12723	19121	1112	20233	39910	50.7%	16.03%	34	35
14	基隆市中山區	2018-11-25T00:09:36+08:00	6749	13396	20145	1141	21286	41856	50.86%	16.12%	35	35
14	基隆市中山區	2018-11-24T23:01:33+08:00	6050	12184	18234	1091	19325	38033	50.81%	15.91%	33	35
14	基隆市中山區	2018-11-24T23:31:13+08:00	6398	12723	19121	1112	20233	39910	50.7%	16.03%	34	35
14	基隆市中山區	2018-11-25T04:02:54+08:00	6749	13396	20145	1141	21286	41856	50.86%	16.12%	35	35
14	基隆市中山區	2018-11-25T01:12:45+08:00	6749	13396	20145	1141	21286	41856	50.86%	16.12%	35	35
14	基隆市中山區	2018-11-24T22:26:38+08:00	5677	11470	17147	1060	18207	35945	50.65%	15.79%	32	35
14	基隆市中山區	2018-11-24T23:12:17+08:00	6050	12184	18234	1091	19325	38033	50.81%	15.91%	33	35
14	基隆市中山區	2018-11-24T23:39:18+08:00	6398	12723	19121	1112	20233	39910	50.7%	16.03%	34	35
14	基隆市中山區	2018-11-25T06:08:55+08:00	6749	13396	20145	1141	21286	41856	50.86%	16.12%	35	35
14	臺南市	2018-11-24T23:35:03+08:00	244122	489233	733355	45689	779044	1514957	51.42%	16.11%	278	1
14	臺南市	2018-11-24T22:33:30+08:00	195837	395474	591311	38301	629612	1233457	51.04%	15.88%	102	1
14	臺南市	2018-11-24T23:31:02+08:00	241975	485249	727224	45314	772538	1502562	51.41%	16.1%	271	1
14	臺南市	2018-11-24T23:39:06+08:00	245285	491652	736937	45885	782822	1522001	51.43%	16.12%	282	1
14	臺南市	2018-11-24T23:12:07+08:00	228979	459857	688836	43215	732051	1426307	51.32%	16.05%	226	1
14	臺南市	2018-11-24T23:47:20+08:00	247255	495417	742672	46138	788810	1533235	51.45%	16.13%	288	1
14	臺南市	2018-11-25T01:07:18+08:00	257331	514385	771716	47807	819523	1592458	51.46%	16.16%	321	1
14	臺南市	2018-11-25T06:08:43+08:00	257730	515188	772918	47869	820787	1594821	51.47%	16.16%	322	1
14	臺南市	2018-11-24T23:01:23+08:00	223183	448777	671960	42343	714303	1393025	51.28%	16.02%	205	1
14	臺南市	2018-11-24T22:57:45+08:00	220283	442795	663078	41938	705016	1375505	51.26%	16.01%	193	1
14	臺南市	2018-11-25T01:17:42+08:00	257730	515188	772918	47851	820769	1594821	51.46%	16.16%	322	1
14	臺南市	2018-11-24T22:13:18+08:00	176164	356655	532819	35118	567937	1114060	50.98%	15.81%	024	1
14	臺南市	2018-11-24T22:19:29+08:00	184070	372383	556453	36441	592894	1161467	51.05%	15.85%	056	1
14	臺南市	2018-11-25T00:57:28+08:00	257025	513763	770788	47766	818554	1590343	51.47%	16.16%	320	1
14	臺南市	2018-11-24T23:23:31+08:00	236704	474695	711399	44375	755774	1471395	51.36%	16.09%	253	1
14	臺南市	2018-11-25T03:44:13+08:00	257730	515188	772918	47869	820787	1594821	51.47%	16.16%	322	1
14	臺南市	2018-11-25T00:04:57+08:00	251220	503398	754618	46838	801456	1557709	51.45%	16.13%	302	1
14	臺南市	2018-11-24T23:04:56+08:00	224405	451105	675510	42551	718061	1400334	51.28%	16.03%	209	1
14	臺南市	2018-11-24T23:15:55+08:00	232409	466392	698801	43784	742585	1447179	51.31%	16.06%	238	1
14	臺南市	2018-11-25T03:38:48+08:00	257730	515188	772918	47869	820787	1594821	51.47%	16.16%	322	1
14	臺南市	2018-11-25T06:18:50+08:00	257730	515188	772918	47869	820787	1594821	51.47%	16.16%	322	1
14	臺南市	2018-11-25T01:25:44+08:00	257638	514981	772619	47845	820464	1593720	51.48%	16.17%	321	1
14	臺南市	2018-11-24T22:40:21+08:00	204899	412459	617358	39568	656926	1285282	51.11%	15.94%	136	1
14	臺南市	2018-11-25T01:02:22+08:00	257331	514385	771716	47807	819523	1592458	51.46%	16.16%	321	1
14	臺南市	2018-11-24T23:55:39+08:00	248988	498887	747875	46444	794319	1544227	51.44%	16.12%	294	1
14	臺南市	2018-11-24T22:45:01+08:00	208654	419713	628367	40120	668487	1307006	51.15%	15.96%	151	1
14	臺南市	2018-11-25T00:18:22+08:00	252892	506703	759595	47153	806748	1567581	51.46%	16.13%	308	1
14	臺南市	2018-11-25T00:22:56+08:00	253607	507962	761569	47269	808838	1571627	51.47%	16.14%	310	1
14	臺南市	2018-11-24T22:54:19+08:00	216046	434553	650599	41294	691893	1350834	51.22%	15.99%	178	1
14	臺南市	2018-11-25T03:56:03+08:00	257730	515188	772918	47869	820787	1594821	51.47%	16.16%	322	1
14	臺南市	2018-11-24T22:16:02+08:00	180310	365017	545327	35872	581199	1138364	51.06%	15.84%	041	1
14	臺南市	2018-11-25T01:12:34+08:00	257331	514385	771716	47807	819523	1592458	51.46%	16.16%	321	1
14	臺南市	2018-11-25T04:02:40+08:00	257730	515188	772918	47869	820787	1594821	51.47%	16.16%	322	1
14	臺南市	2018-11-24T22:50:39+08:00	212861	428438	641299	40869	682168	1332461	51.2%	15.98%	167	1
14	臺南市	2018-11-25T00:09:25+08:00	251830	504673	756503	46983	803486	1561484	51.46%	16.13%	304	1
14	臺南市	2018-11-25T00:14:01+08:00	252378	505620	757998	47062	805060	1564534	51.46%	16.13%	306	1
14	臺南市	2018-11-24T22:41:28+08:00	204899	412459	617358	39568	656926	1285282	51.11%	15.94%	136	1
14	臺南市	2018-11-25T00:00:00+08:00	249773	500454	750227	46547	796774	1549104	51.43%	16.12%	297	1
14	臺南市	2018-11-24T22:23:04+08:00	188807	381802	570609	37117	607726	1190936	51.03%	15.85%	074	1
14	臺南市	2018-11-24T23:19:41+08:00	235306	472072	707378	44187	751565	1463726	51.35%	16.08%	248	1
14	臺南市	2018-11-24T23:51:27+08:00	248360	497541	745901	46332	792233	1539927	51.45%	16.13%	292	1
14	臺南市	2018-11-24T22:29:58+08:00	193902	391899	585801	37971	623772	1222218	51.04%	15.86%	095	1
14	臺南市	2018-11-24T22:36:53+08:00	201310	405747	607057	39077	646134	1264911	51.08%	15.91%	124	1
14	臺南市	2018-11-24T23:27:11+08:00	238513	478352	716865	44700	761565	1482236	51.38%	16.09%	259	1
14	臺南市	2018-11-24T23:08:27+08:00	226959	455816	682775	42875	725650	1414199	51.31%	16.05%	218	1
14	臺南市	2018-11-25T03:32:26+08:00	257730	515188	772918	47869	820787	1594821	51.47%	16.16%	322	1
14	臺南市	2018-11-25T06:29:08+08:00	257730	515188	772918	47869	820787	1594821	51.47%	16.16%	322	1
14	臺南市	2018-11-25T03:49:44+08:00	257730	515188	772918	47869	820787	1594821	51.47%	16.16%	322	1
14	臺南市	2018-11-24T22:26:30+08:00	190575	385252	575827	37374	613201	1201950	51.02%	15.86%	082	1
14	臺南市	2018-11-25T06:23:52+08:00	257730	515188	772918	47869	820787	1594821	51.47%	16.16%	322	1
14	臺南市	2018-11-24T23:43:09+08:00	246453	493923	740376	46071	786447	1528980	51.44%	16.12%	286	1
14	臺南市	2018-11-25T06:13:45+08:00	257730	515188	772918	47869	820787	1594821	51.47%	16.16%	322	1
14	屏東縣滿州鄉	2018-11-24T22:33:37+08:00	887	1982	2869	210	3079	7206	42.73%	12.31%	8	8
14	屏東縣滿州鄉	2018-11-24T22:37:00+08:00	887	1982	2869	210	3079	7206	42.73%	12.31%	8	8
14	屏東縣滿州鄉	2018-11-24T23:43:16+08:00	887	1982	2869	210	3079	7206	42.73%	12.31%	8	8
14	屏東縣滿州鄉	2018-11-25T03:56:11+08:00	887	1982	2869	210	3079	7206	42.73%	12.31%	8	8
14	屏東縣滿州鄉	2018-11-25T06:29:16+08:00	887	1982	2869	210	3079	7206	42.73%	12.31%	8	8
14	屏東縣滿州鄉	2018-11-24T23:47:27+08:00	887	1982	2869	210	3079	7206	42.73%	12.31%	8	8
14	屏東縣滿州鄉	2018-11-24T22:16:09+08:00	887	1982	2869	210	3079	7206	42.73%	12.31%	8	8
14	屏東縣滿州鄉	2018-11-25T03:38:54+08:00	887	1982	2869	210	3079	7206	42.73%	12.31%	8	8
14	屏東縣滿州鄉	2018-11-24T23:55:46+08:00	887	1982	2869	210	3079	7206	42.73%	12.31%	8	8
14	屏東縣滿州鄉	2018-11-25T03:44:22+08:00	887	1982	2869	210	3079	7206	42.73%	12.31%	8	8
14	屏東縣滿州鄉	2018-11-24T22:13:26+08:00	887	1982	2869	210	3079	7206	42.73%	12.31%	8	8
14	屏東縣滿州鄉	2018-11-24T23:23:37+08:00	887	1982	2869	210	3079	7206	42.73%	12.31%	8	8
14	屏東縣滿州鄉	2018-11-25T06:18:56+08:00	887	1982	2869	210	3079	7206	42.73%	12.31%	8	8
14	屏東縣滿州鄉	2018-11-24T22:23:12+08:00	887	1982	2869	210	3079	7206	42.73%	12.31%	8	8
14	屏東縣滿州鄉	2018-11-24T22:40:27+08:00	887	1982	2869	210	3079	7206	42.73%	12.31%	8	8
14	屏東縣滿州鄉	2018-11-25T00:00:10+08:00	887	1982	2869	210	3079	7206	42.73%	12.31%	8	8
14	屏東縣滿州鄉	2018-11-25T01:17:51+08:00	887	1982	2869	210	3079	7206	42.73%	12.31%	8	8
14	屏東縣滿州鄉	2018-11-24T22:30:07+08:00	887	1982	2869	210	3079	7206	42.73%	12.31%	8	8
14	屏東縣滿州鄉	2018-11-24T23:12:15+08:00	887	1982	2869	210	3079	7206	42.73%	12.31%	8	8
14	屏東縣滿州鄉	2018-11-24T22:45:08+08:00	887	1982	2869	210	3079	7206	42.73%	12.31%	8	8
14	屏東縣滿州鄉	2018-11-24T23:31:10+08:00	887	1982	2869	210	3079	7206	42.73%	12.31%	8	8
14	屏東縣滿州鄉	2018-11-24T23:01:30+08:00	887	1982	2869	210	3079	7206	42.73%	12.31%	8	8
14	屏東縣滿州鄉	2018-11-25T04:02:51+08:00	887	1982	2869	210	3079	7206	42.73%	12.31%	8	8
14	屏東縣滿州鄉	2018-11-24T23:39:15+08:00	887	1982	2869	210	3079	7206	42.73%	12.31%	8	8
14	屏東縣滿州鄉	2018-11-25T06:23:59+08:00	887	1982	2869	210	3079	7206	42.73%	12.31%	8	8
14	屏東縣滿州鄉	2018-11-25T00:09:33+08:00	887	1982	2869	210	3079	7206	42.73%	12.31%	8	8
14	屏東縣滿州鄉	2018-11-25T01:07:25+08:00	887	1982	2869	210	3079	7206	42.73%	12.31%	8	8
14	屏東縣滿州鄉	2018-11-25T06:13:51+08:00	887	1982	2869	210	3079	7206	42.73%	12.31%	8	8
14	屏東縣滿州鄉	2018-11-24T23:16:02+08:00	887	1982	2869	210	3079	7206	42.73%	12.31%	8	8
14	屏東縣滿州鄉	2018-11-24T23:35:09+08:00	887	1982	2869	210	3079	7206	42.73%	12.31%	8	8
14	屏東縣滿州鄉	2018-11-25T03:49:50+08:00	887	1982	2869	210	3079	7206	42.73%	12.31%	8	8
14	屏東縣滿州鄉	2018-11-25T00:14:08+08:00	887	1982	2869	210	3079	7206	42.73%	12.31%	8	8
14	屏東縣滿州鄉	2018-11-25T00:23:03+08:00	887	1982	2869	210	3079	7206	42.73%	12.31%	8	8
14	屏東縣滿州鄉	2018-11-24T23:08:35+08:00	887	1982	2869	210	3079	7206	42.73%	12.31%	8	8
14	屏東縣滿州鄉	2018-11-25T03:32:34+08:00	887	1982	2869	210	3079	7206	42.73%	12.31%	8	8
14	屏東縣滿州鄉	2018-11-25T01:25:52+08:00	887	1982	2869	210	3079	7206	42.73%	12.31%	8	8
14	屏東縣滿州鄉	2018-11-24T23:19:49+08:00	887	1982	2869	210	3079	7206	42.73%	12.31%	8	8
14	屏東縣滿州鄉	2018-11-24T23:27:17+08:00	887	1982	2869	210	3079	7206	42.73%	12.31%	8	8
14	屏東縣滿州鄉	2018-11-24T22:19:36+08:00	887	1982	2869	210	3079	7206	42.73%	12.31%	8	8
14	屏東縣滿州鄉	2018-11-25T01:02:29+08:00	887	1982	2869	210	3079	7206	42.73%	12.31%	8	8
14	屏東縣滿州鄉	2018-11-24T23:51:34+08:00	887	1982	2869	210	3079	7206	42.73%	12.31%	8	8
14	屏東縣滿州鄉	2018-11-24T22:57:52+08:00	887	1982	2869	210	3079	7206	42.73%	12.31%	8	8
14	屏東縣滿州鄉	2018-11-25T00:57:36+08:00	887	1982	2869	210	3079	7206	42.73%	12.31%	8	8
14	屏東縣滿州鄉	2018-11-24T23:05:04+08:00	887	1982	2869	210	3079	7206	42.73%	12.31%	8	8
14	屏東縣滿州鄉	2018-11-24T22:50:47+08:00	887	1982	2869	210	3079	7206	42.73%	12.31%	8	8
14	屏東縣滿州鄉	2018-11-25T00:05:04+08:00	887	1982	2869	210	3079	7206	42.73%	12.31%	8	8
14	屏東縣滿州鄉	2018-11-24T22:41:34+08:00	887	1982	2869	210	3079	7206	42.73%	12.31%	8	8
14	屏東縣滿州鄉	2018-11-25T01:12:42+08:00	887	1982	2869	210	3079	7206	42.73%	12.31%	8	8
14	屏東縣滿州鄉	2018-11-24T22:26:36+08:00	887	1982	2869	210	3079	7206	42.73%	12.31%	8	8
14	屏東縣滿州鄉	2018-11-25T00:18:29+08:00	887	1982	2869	210	3079	7206	42.73%	12.31%	8	8
14	屏東縣滿州鄉	2018-11-25T06:08:52+08:00	887	1982	2869	210	3079	7206	42.73%	12.31%	8	8
14	屏東縣滿州鄉	2018-11-24T22:54:25+08:00	887	1982	2869	210	3079	7206	42.73%	12.31%	8	8
14	臺南市官田區	2018-11-24T23:35:03+08:00	3074	5324	8398	692	9090	18675	48.67%	16.46%	20	20
14	臺南市官田區	2018-11-24T22:33:30+08:00	3074	5324	8398	692	9090	18675	48.67%	16.46%	20	20
14	臺南市官田區	2018-11-24T23:31:02+08:00	3074	5324	8398	692	9090	18675	48.67%	16.46%	20	20
14	臺南市官田區	2018-11-24T23:39:06+08:00	3074	5324	8398	692	9090	18675	48.67%	16.46%	20	20
14	臺南市官田區	2018-11-24T23:12:07+08:00	3074	5324	8398	692	9090	18675	48.67%	16.46%	20	20
14	臺南市官田區	2018-11-25T00:14:02+08:00	3074	5324	8398	692	9090	18675	48.67%	16.46%	20	20
14	臺南市官田區	2018-11-24T23:47:20+08:00	3074	5324	8398	692	9090	18675	48.67%	16.46%	20	20
14	臺南市官田區	2018-11-24T23:43:10+08:00	3074	5324	8398	692	9090	18675	48.67%	16.46%	20	20
14	臺南市官田區	2018-11-25T06:08:44+08:00	3074	5324	8398	692	9090	18675	48.67%	16.46%	20	20
14	臺南市官田區	2018-11-25T01:07:18+08:00	3074	5324	8398	692	9090	18675	48.67%	16.46%	20	20
14	臺南市官田區	2018-11-24T23:01:23+08:00	3074	5324	8398	692	9090	18675	48.67%	16.46%	20	20
14	臺南市官田區	2018-11-24T22:57:45+08:00	3074	5324	8398	692	9090	18675	48.67%	16.46%	20	20
14	臺南市官田區	2018-11-24T22:13:18+08:00	3074	5324	8398	692	9090	18675	48.67%	16.46%	20	20
14	臺南市官田區	2018-11-25T00:57:28+08:00	3074	5324	8398	692	9090	18675	48.67%	16.46%	20	20
14	臺南市官田區	2018-11-24T23:04:57+08:00	3074	5324	8398	692	9090	18675	48.67%	16.46%	20	20
14	臺南市官田區	2018-11-24T23:23:31+08:00	3074	5324	8398	692	9090	18675	48.67%	16.46%	20	20
14	臺南市官田區	2018-11-25T03:44:14+08:00	3074	5324	8398	692	9090	18675	48.67%	16.46%	20	20
14	臺南市官田區	2018-11-25T01:17:43+08:00	3074	5324	8398	692	9090	18675	48.67%	16.46%	20	20
14	臺南市官田區	2018-11-25T00:04:57+08:00	3074	5324	8398	692	9090	18675	48.67%	16.46%	20	20
14	臺南市官田區	2018-11-24T23:15:55+08:00	3074	5324	8398	692	9090	18675	48.67%	16.46%	20	20
14	臺南市官田區	2018-11-25T01:02:23+08:00	3074	5324	8398	692	9090	18675	48.67%	16.46%	20	20
14	臺南市官田區	2018-11-25T01:25:45+08:00	3074	5324	8398	692	9090	18675	48.67%	16.46%	20	20
14	臺南市官田區	2018-11-25T03:38:48+08:00	3074	5324	8398	692	9090	18675	48.67%	16.46%	20	20
14	臺南市官田區	2018-11-25T06:18:50+08:00	3074	5324	8398	692	9090	18675	48.67%	16.46%	20	20
14	臺南市官田區	2018-11-24T22:40:21+08:00	3074	5324	8398	692	9090	18675	48.67%	16.46%	20	20
14	臺南市官田區	2018-11-24T23:55:39+08:00	3074	5324	8398	692	9090	18675	48.67%	16.46%	20	20
14	臺南市官田區	2018-11-24T22:45:01+08:00	3074	5324	8398	692	9090	18675	48.67%	16.46%	20	20
14	臺南市官田區	2018-11-25T00:18:22+08:00	3074	5324	8398	692	9090	18675	48.67%	16.46%	20	20
14	臺南市官田區	2018-11-25T00:22:56+08:00	3074	5324	8398	692	9090	18675	48.67%	16.46%	20	20
14	臺南市官田區	2018-11-24T22:54:19+08:00	3074	5324	8398	692	9090	18675	48.67%	16.46%	20	20
14	臺南市官田區	2018-11-25T03:56:03+08:00	3074	5324	8398	692	9090	18675	48.67%	16.46%	20	20
14	臺南市官田區	2018-11-24T22:16:02+08:00	3074	5324	8398	692	9090	18675	48.67%	16.46%	20	20
14	臺南市官田區	2018-11-25T01:12:34+08:00	3074	5324	8398	692	9090	18675	48.67%	16.46%	20	20
14	臺南市官田區	2018-11-24T22:50:39+08:00	3074	5324	8398	692	9090	18675	48.67%	16.46%	20	20
14	臺南市官田區	2018-11-25T00:09:25+08:00	3074	5324	8398	692	9090	18675	48.67%	16.46%	20	20
14	臺南市官田區	2018-11-24T22:41:28+08:00	3074	5324	8398	692	9090	18675	48.67%	16.46%	20	20
14	臺南市官田區	2018-11-25T04:02:41+08:00	3074	5324	8398	692	9090	18675	48.67%	16.46%	20	20
14	臺南市官田區	2018-11-25T00:00:00+08:00	3074	5324	8398	692	9090	18675	48.67%	16.46%	20	20
14	臺南市官田區	2018-11-24T22:23:04+08:00	3074	5324	8398	692	9090	18675	48.67%	16.46%	20	20
14	臺南市官田區	2018-11-24T23:19:41+08:00	3074	5324	8398	692	9090	18675	48.67%	16.46%	20	20
14	臺南市官田區	2018-11-24T23:51:27+08:00	3074	5324	8398	692	9090	18675	48.67%	16.46%	20	20
14	臺南市官田區	2018-11-24T22:29:58+08:00	3074	5324	8398	692	9090	18675	48.67%	16.46%	20	20
14	臺南市官田區	2018-11-24T22:36:54+08:00	3074	5324	8398	692	9090	18675	48.67%	16.46%	20	20
14	臺南市官田區	2018-11-25T03:32:27+08:00	3074	5324	8398	692	9090	18675	48.67%	16.46%	20	20
14	臺南市官田區	2018-11-24T23:27:11+08:00	3074	5324	8398	692	9090	18675	48.67%	16.46%	20	20
14	臺南市官田區	2018-11-24T22:19:30+08:00	3074	5324	8398	692	9090	18675	48.67%	16.46%	20	20
14	臺南市官田區	2018-11-24T23:08:27+08:00	3074	5324	8398	692	9090	18675	48.67%	16.46%	20	20
14	臺南市官田區	2018-11-25T03:49:44+08:00	3074	5324	8398	692	9090	18675	48.67%	16.46%	20	20
14	臺南市官田區	2018-11-24T22:26:30+08:00	3074	5324	8398	692	9090	18675	48.67%	16.46%	20	20
14	臺南市官田區	2018-11-25T06:29:09+08:00	3074	5324	8398	692	9090	18675	48.67%	16.46%	20	20
14	臺南市官田區	2018-11-25T06:23:53+08:00	3074	5324	8398	692	9090	18675	48.67%	16.46%	20	20
14	臺南市官田區	2018-11-25T06:13:45+08:00	3074	5324	8398	692	9090	18675	48.67%	16.46%	20	20
14	花蓮縣花蓮市	2018-11-25T06:29:17+08:00	12198	31255	43453	2228	45681	84807	53.86%	14.38%	81	81
14	花蓮縣花蓮市	2018-11-24T23:47:28+08:00	7614	19861	27475	1491	28966	53393	54.25%	14.26%	56	81
14	花蓮縣花蓮市	2018-11-24T22:37:00+08:00	2969	7857	10826	595	11421	20883	54.69%	14.22%	27	81
14	花蓮縣花蓮市	2018-11-25T00:18:30+08:00	9159	23881	33040	1740	34780	64009	54.34%	14.31%	65	81
14	花蓮縣花蓮市	2018-11-25T01:07:26+08:00	11514	29499	41013	2109	43122	79385	54.32%	14.5%	77	81
14	花蓮縣花蓮市	2018-11-25T06:13:52+08:00	12198	31255	43453	2228	45681	84807	53.86%	14.38%	81	81
14	花蓮縣花蓮市	2018-11-24T22:33:38+08:00	2969	7857	10826	595	11421	20883	54.69%	14.22%	27	81
14	花蓮縣花蓮市	2018-11-24T23:43:17+08:00	7331	19168	26499	1449	27948	51503	54.26%	14.23%	54	81
14	花蓮縣花蓮市	2018-11-25T03:44:23+08:00	12198	31255	43453	2228	45681	84807	53.86%	14.38%	81	81
14	花蓮縣花蓮市	2018-11-24T22:13:27+08:00	2583	6835	9418	528	9946	18238	54.53%	14.16%	24	81
14	花蓮縣花蓮市	2018-11-25T01:02:31+08:00	11142	28630	39772	2053	41825	76891	54.4%	14.49%	75	81
14	花蓮縣花蓮市	2018-11-24T23:23:38+08:00	5367	13885	19252	1041	20293	37359	54.32%	14.37%	42	81
14	花蓮縣花蓮市	2018-11-25T03:38:55+08:00	12198	31255	43453	2228	45681	84807	53.86%	14.38%	81	81
14	花蓮縣花蓮市	2018-11-24T23:55:47+08:00	7896	20697	28593	1538	30131	55541	54.25%	14.22%	58	81
14	花蓮縣花蓮市	2018-11-24T23:08:36+08:00	4731	12413	17144	908	18052	33231	54.32%	14.24%	38	81
14	花蓮縣花蓮市	2018-11-25T00:00:11+08:00	7896	20697	28593	1538	30131	55541	54.25%	14.22%	58	81
14	花蓮縣花蓮市	2018-11-24T22:40:27+08:00	2969	7857	10826	595	11421	20883	54.69%	14.22%	27	81
14	花蓮縣花蓮市	2018-11-25T06:18:57+08:00	12198	31255	43453	2228	45681	84807	53.86%	14.38%	81	81
14	花蓮縣花蓮市	2018-11-24T22:30:09+08:00	2700	7115	9815	546	10361	18953	54.67%	14.25%	25	81
14	花蓮縣花蓮市	2018-11-24T22:23:13+08:00	2700	7115	9815	546	10361	18953	54.67%	14.25%	25	81
14	花蓮縣花蓮市	2018-11-24T23:19:51+08:00	5179	13375	18554	999	19553	36110	54.15%	14.34%	41	81
14	花蓮縣花蓮市	2018-11-24T23:12:15+08:00	4946	12813	17759	937	18696	34570	54.08%	14.31%	39	81
14	花蓮縣花蓮市	2018-11-24T22:45:08+08:00	3450	9267	12717	675	13392	24607	54.42%	14.02%	30	81
14	花蓮縣花蓮市	2018-11-24T23:35:11+08:00	6475	16958	23433	1277	24710	45648	54.13%	14.18%	49	81
14	花蓮縣花蓮市	2018-11-24T23:01:31+08:00	4295	11329	15624	811	16435	30429	54.01%	14.11%	35	81
14	花蓮縣花蓮市	2018-11-24T23:31:11+08:00	6035	15697	21732	1191	22923	42105	54.44%	14.33%	46	81
14	花蓮縣花蓮市	2018-11-25T00:09:34+08:00	8400	22091	30491	1617	32108	59339	54.11%	14.16%	61	81
14	花蓮縣花蓮市	2018-11-25T00:14:09+08:00	8814	22986	31800	1676	33476	61730	54.23%	14.28%	63	81
14	花蓮縣花蓮市	2018-11-25T03:49:51+08:00	12198	31255	43453	2228	45681	84807	53.86%	14.38%	81	81
14	花蓮縣花蓮市	2018-11-24T23:16:03+08:00	5179	13375	18554	999	19553	36110	54.15%	14.34%	41	81
14	花蓮縣花蓮市	2018-11-25T03:56:12+08:00	12198	31255	43453	2228	45681	84807	53.86%	14.38%	81	81
14	花蓮縣花蓮市	2018-11-25T06:24:00+08:00	12198	31255	43453	2228	45681	84807	53.86%	14.38%	81	81
14	花蓮縣花蓮市	2018-11-25T00:23:03+08:00	9348	24323	33671	1776	35447	65444	54.16%	14.28%	66	81
14	花蓮縣花蓮市	2018-11-25T03:32:34+08:00	12198	31255	43453	2228	45681	84807	53.86%	14.38%	81	81
14	花蓮縣花蓮市	2018-11-25T01:25:52+08:00	11858	30429	42287	2178	44465	82106	54.16%	14.44%	79	81
14	花蓮縣花蓮市	2018-11-25T00:57:37+08:00	10925	28132	39057	2016	41073	75560	54.36%	14.46%	74	81
14	花蓮縣花蓮市	2018-11-24T22:57:53+08:00	4106	10871	14977	782	15759	29162	54.04%	14.08%	34	81
14	花蓮縣花蓮市	2018-11-24T22:19:37+08:00	2700	7115	9815	546	10361	18953	54.67%	14.25%	25	81
14	花蓮縣花蓮市	2018-11-25T01:17:52+08:00	11352	29064	40416	2092	42508	78222	54.34%	14.51%	76	81
14	花蓮縣花蓮市	2018-11-24T23:27:18+08:00	5557	14393	19950	1095	21045	38618	54.5%	14.39%	43	81
14	花蓮縣花蓮市	2018-11-24T23:51:35+08:00	7896	20697	28593	1538	30131	55541	54.25%	14.22%	58	81
14	花蓮縣花蓮市	2018-11-24T23:05:04+08:00	4583	12059	16642	881	17523	32306	54.24%	14.19%	37	81
14	花蓮縣花蓮市	2018-11-24T22:41:35+08:00	2969	7857	10826	595	11421	20883	54.69%	14.22%	27	81
14	花蓮縣花蓮市	2018-11-25T00:05:05+08:00	8220	21614	29834	1582	31416	57960	54.2%	14.18%	60	81
14	花蓮縣花蓮市	2018-11-25T04:02:52+08:00	12198	31255	43453	2228	45681	84807	53.86%	14.38%	81	81
14	花蓮縣花蓮市	2018-11-25T06:08:53+08:00	12198	31255	43453	2228	45681	84807	53.86%	14.38%	81	81
14	花蓮縣花蓮市	2018-11-24T22:16:10+08:00	2583	6835	9418	528	9946	18238	54.53%	14.16%	24	81
14	花蓮縣花蓮市	2018-11-25T01:12:43+08:00	11352	29064	40416	2092	42508	78222	54.34%	14.51%	76	81
14	花蓮縣花蓮市	2018-11-24T22:26:37+08:00	2700	7115	9815	546	10361	18953	54.67%	14.25%	25	81
14	花蓮縣花蓮市	2018-11-24T22:50:48+08:00	3965	10485	14450	762	15212	28207	53.93%	14.06%	33	81
14	花蓮縣花蓮市	2018-11-24T23:39:16+08:00	6656	17391	24047	1304	25351	46916	54.03%	14.19%	50	81
14	花蓮縣花蓮市	2018-11-24T22:54:25+08:00	4106	10871	14977	782	15759	29162	54.04%	14.08%	34	81
14	花蓮縣秀林鄉	2018-11-25T06:29:17+08:00	1602	4402	6004	449	6453	12562	51.37%	12.75%	14	14
14	花蓮縣秀林鄉	2018-11-25T00:18:30+08:00	773	2036	2809	237	3046	5756	52.92%	13.43%	8	14
14	花蓮縣秀林鄉	2018-11-25T01:07:26+08:00	923	2400	3323	275	3598	6881	52.29%	13.41%	9	14
14	花蓮縣秀林鄉	2018-11-25T06:13:52+08:00	1602	4402	6004	449	6453	12562	51.37%	12.75%	14	14
14	花蓮縣秀林鄉	2018-11-24T23:47:29+08:00	590	1596	2186	159	2345	4617	50.79%	12.78%	7	14
14	花蓮縣秀林鄉	2018-11-24T22:33:38+08:00	201	501	702	52	754	1503	50.17%	13.37%	4	14
14	花蓮縣秀林鄉	2018-11-24T23:43:17+08:00	590	1596	2186	159	2345	4617	50.79%	12.78%	7	14
14	花蓮縣秀林鄉	2018-11-24T22:37:01+08:00	201	501	702	52	754	1503	50.17%	13.37%	4	14
14	花蓮縣秀林鄉	2018-11-25T03:44:23+08:00	1602	4402	6004	449	6453	12562	51.37%	12.75%	14	14
14	花蓮縣秀林鄉	2018-11-24T22:13:27+08:00	201	501	702	52	754	1503	50.17%	13.37%	4	14
14	花蓮縣秀林鄉	2018-11-25T01:02:31+08:00	923	2400	3323	275	3598	6881	52.29%	13.41%	9	14
14	花蓮縣秀林鄉	2018-11-25T03:38:55+08:00	1602	4402	6004	449	6453	12562	51.37%	12.75%	14	14
14	花蓮縣秀林鄉	2018-11-24T23:55:47+08:00	590	1596	2186	159	2345	4617	50.79%	12.78%	7	14
14	花蓮縣秀林鄉	2018-11-24T23:08:36+08:00	201	501	702	52	754	1503	50.17%	13.37%	4	14
14	花蓮縣秀林鄉	2018-11-24T23:23:39+08:00	590	1596	2186	159	2345	4617	50.79%	12.78%	7	14
14	花蓮縣秀林鄉	2018-11-25T00:00:11+08:00	590	1596	2186	159	2345	4617	50.79%	12.78%	7	14
14	花蓮縣秀林鄉	2018-11-24T23:51:36+08:00	590	1596	2186	159	2345	4617	50.79%	12.78%	7	14
14	花蓮縣秀林鄉	2018-11-25T06:18:57+08:00	1602	4402	6004	449	6453	12562	51.37%	12.75%	14	14
14	花蓮縣秀林鄉	2018-11-24T22:30:09+08:00	201	501	702	52	754	1503	50.17%	13.37%	4	14
14	花蓮縣秀林鄉	2018-11-24T22:40:28+08:00	201	501	702	52	754	1503	50.17%	13.37%	4	14
14	花蓮縣秀林鄉	2018-11-24T22:23:13+08:00	201	501	702	52	754	1503	50.17%	13.37%	4	14
14	花蓮縣秀林鄉	2018-11-24T23:19:51+08:00	445	1184	1629	110	1739	3630	47.91%	12.26%	6	14
14	花蓮縣秀林鄉	2018-11-24T23:35:11+08:00	590	1596	2186	159	2345	4617	50.79%	12.78%	7	14
14	花蓮縣秀林鄉	2018-11-24T23:01:31+08:00	201	501	702	52	754	1503	50.17%	13.37%	4	14
14	花蓮縣秀林鄉	2018-11-24T22:45:09+08:00	201	501	702	52	754	1503	50.17%	13.37%	4	14
14	花蓮縣秀林鄉	2018-11-24T23:31:11+08:00	590	1596	2186	159	2345	4617	50.79%	12.78%	7	14
14	花蓮縣秀林鄉	2018-11-25T00:09:34+08:00	590	1596	2186	159	2345	4617	50.79%	12.78%	7	14
14	花蓮縣秀林鄉	2018-11-24T22:54:26+08:00	201	501	702	52	754	1503	50.17%	13.37%	4	14
14	花蓮縣秀林鄉	2018-11-25T00:14:10+08:00	590	1596	2186	159	2345	4617	50.79%	12.78%	7	14
14	花蓮縣秀林鄉	2018-11-25T03:56:13+08:00	1602	4402	6004	449	6453	12562	51.37%	12.75%	14	14
14	花蓮縣秀林鄉	2018-11-25T03:49:51+08:00	1602	4402	6004	449	6453	12562	51.37%	12.75%	14	14
14	花蓮縣秀林鄉	2018-11-24T23:16:03+08:00	310	775	1085	75	1160	2257	51.4%	13.74%	5	14
14	花蓮縣秀林鄉	2018-11-25T03:32:35+08:00	1602	4402	6004	449	6453	12562	51.37%	12.75%	14	14
14	花蓮縣秀林鄉	2018-11-25T06:24:00+08:00	1602	4402	6004	449	6453	12562	51.37%	12.75%	14	14
14	花蓮縣秀林鄉	2018-11-25T01:25:53+08:00	923	2400	3323	275	3598	6881	52.29%	13.41%	9	14
14	花蓮縣秀林鄉	2018-11-25T00:23:04+08:00	773	2036	2809	237	3046	5756	52.92%	13.43%	8	14
14	花蓮縣秀林鄉	2018-11-24T23:27:19+08:00	590	1596	2186	159	2345	4617	50.79%	12.78%	7	14
14	花蓮縣秀林鄉	2018-11-25T00:57:37+08:00	923	2400	3323	275	3598	6881	52.29%	13.41%	9	14
14	花蓮縣秀林鄉	2018-11-24T22:57:53+08:00	201	501	702	52	754	1503	50.17%	13.37%	4	14
14	花蓮縣秀林鄉	2018-11-24T22:19:37+08:00	201	501	702	52	754	1503	50.17%	13.37%	4	14
14	花蓮縣秀林鄉	2018-11-25T01:17:52+08:00	923	2400	3323	275	3598	6881	52.29%	13.41%	9	14
14	花蓮縣秀林鄉	2018-11-24T22:41:35+08:00	201	501	702	52	754	1503	50.17%	13.37%	4	14
14	花蓮縣秀林鄉	2018-11-25T00:05:05+08:00	590	1596	2186	159	2345	4617	50.79%	12.78%	7	14
14	花蓮縣秀林鄉	2018-11-25T04:02:52+08:00	1602	4402	6004	449	6453	12562	51.37%	12.75%	14	14
14	花蓮縣秀林鄉	2018-11-24T23:12:16+08:00	201	501	702	52	754	1503	50.17%	13.37%	4	14
14	花蓮縣秀林鄉	2018-11-25T06:08:53+08:00	1602	4402	6004	449	6453	12562	51.37%	12.75%	14	14
14	花蓮縣秀林鄉	2018-11-25T01:12:43+08:00	923	2400	3323	275	3598	6881	52.29%	13.41%	9	14
14	花蓮縣秀林鄉	2018-11-24T22:26:37+08:00	201	501	702	52	754	1503	50.17%	13.37%	4	14
14	花蓮縣秀林鄉	2018-11-24T23:05:05+08:00	201	501	702	52	754	1503	50.17%	13.37%	4	14
14	花蓮縣秀林鄉	2018-11-24T22:50:48+08:00	201	501	702	52	754	1503	50.17%	13.37%	4	14
14	花蓮縣秀林鄉	2018-11-24T22:16:11+08:00	201	501	702	52	754	1503	50.17%	13.37%	4	14
14	花蓮縣秀林鄉	2018-11-24T23:39:16+08:00	590	1596	2186	159	2345	4617	50.79%	12.78%	7	14
14	高雄市內門區	2018-11-25T04:02:43+08:00	1561	4042	5603	614	6217	13002	47.82%	12.01%	18	18
14	高雄市內門區	2018-11-25T01:12:37+08:00	1561	4042	5603	614	6217	13002	47.82%	12.01%	18	18
14	高雄市內門區	2018-11-25T00:14:04+08:00	1561	4042	5603	614	6217	13002	47.82%	12.01%	18	18
14	高雄市內門區	2018-11-24T23:31:05+08:00	1561	4042	5603	614	6217	13002	47.82%	12.01%	18	18
14	高雄市內門區	2018-11-25T01:07:21+08:00	1561	4042	5603	614	6217	13002	47.82%	12.01%	18	18
14	高雄市內門區	2018-11-24T23:35:05+08:00	1561	4042	5603	614	6217	13002	47.82%	12.01%	18	18
14	高雄市內門區	2018-11-25T06:29:11+08:00	1561	4042	5603	614	6217	13002	47.82%	12.01%	18	18
14	高雄市內門區	2018-11-24T23:39:09+08:00	1561	4042	5603	614	6217	13002	47.82%	12.01%	18	18
14	高雄市內門區	2018-11-25T00:09:28+08:00	1561	4042	5603	614	6217	13002	47.82%	12.01%	18	18
14	高雄市內門區	2018-11-25T01:17:45+08:00	1561	4042	5603	614	6217	13002	47.82%	12.01%	18	18
14	高雄市內門區	2018-11-24T22:23:07+08:00	1561	4042	5603	614	6217	13002	47.82%	12.01%	18	18
14	高雄市內門區	2018-11-24T23:55:41+08:00	1561	4042	5603	614	6217	13002	47.82%	12.01%	18	18
14	高雄市內門區	2018-11-24T23:08:30+08:00	1561	4042	5603	614	6217	13002	47.82%	12.01%	18	18
14	高雄市內門區	2018-11-24T23:04:59+08:00	1561	4042	5603	614	6217	13002	47.82%	12.01%	18	18
14	高雄市內門區	2018-11-24T23:19:44+08:00	1561	4042	5603	614	6217	13002	47.82%	12.01%	18	18
14	高雄市內門區	2018-11-24T22:13:21+08:00	1294	3477	4771	492	5263	11280	46.66%	11.47%	17	18
14	高雄市內門區	2018-11-25T00:00:02+08:00	1561	4042	5603	614	6217	13002	47.82%	12.01%	18	18
14	高雄市內門區	2018-11-24T23:27:13+08:00	1561	4042	5603	614	6217	13002	47.82%	12.01%	18	18
14	高雄市內門區	2018-11-24T22:19:32+08:00	1294	3477	4771	492	5263	11280	46.66%	11.47%	17	18
14	高雄市內門區	2018-11-24T22:30:00+08:00	1561	4042	5603	614	6217	13002	47.82%	12.01%	18	18
14	高雄市內門區	2018-11-25T01:02:25+08:00	1561	4042	5603	614	6217	13002	47.82%	12.01%	18	18
14	高雄市內門區	2018-11-25T06:13:47+08:00	1561	4042	5603	614	6217	13002	47.82%	12.01%	18	18
14	高雄市內門區	2018-11-25T00:22:58+08:00	1561	4042	5603	614	6217	13002	47.82%	12.01%	18	18
14	高雄市內門區	2018-11-24T22:26:32+08:00	1561	4042	5603	614	6217	13002	47.82%	12.01%	18	18
14	高雄市內門區	2018-11-25T00:18:24+08:00	1561	4042	5603	614	6217	13002	47.82%	12.01%	18	18
14	高雄市內門區	2018-11-24T22:50:42+08:00	1561	4042	5603	614	6217	13002	47.82%	12.01%	18	18
14	高雄市內門區	2018-11-24T22:54:21+08:00	1561	4042	5603	614	6217	13002	47.82%	12.01%	18	18
14	高雄市內門區	2018-11-25T00:05:00+08:00	1561	4042	5603	614	6217	13002	47.82%	12.01%	18	18
14	高雄市內門區	2018-11-24T22:41:30+08:00	1561	4042	5603	614	6217	13002	47.82%	12.01%	18	18
14	高雄市內門區	2018-11-25T03:49:46+08:00	1561	4042	5603	614	6217	13002	47.82%	12.01%	18	18
14	高雄市內門區	2018-11-24T23:01:26+08:00	1561	4042	5603	614	6217	13002	47.82%	12.01%	18	18
14	高雄市內門區	2018-11-25T06:08:46+08:00	1561	4042	5603	614	6217	13002	47.82%	12.01%	18	18
14	高雄市內門區	2018-11-24T23:43:12+08:00	1561	4042	5603	614	6217	13002	47.82%	12.01%	18	18
14	高雄市內門區	2018-11-24T22:16:04+08:00	1294	3477	4771	492	5263	11280	46.66%	11.47%	17	18
14	高雄市內門區	2018-11-24T22:33:32+08:00	1561	4042	5603	614	6217	13002	47.82%	12.01%	18	18
14	高雄市內門區	2018-11-24T23:47:23+08:00	1561	4042	5603	614	6217	13002	47.82%	12.01%	18	18
14	高雄市內門區	2018-11-25T03:44:16+08:00	1561	4042	5603	614	6217	13002	47.82%	12.01%	18	18
14	高雄市內門區	2018-11-25T03:38:50+08:00	1561	4042	5603	614	6217	13002	47.82%	12.01%	18	18
14	高雄市內門區	2018-11-24T23:23:33+08:00	1561	4042	5603	614	6217	13002	47.82%	12.01%	18	18
14	高雄市內門區	2018-11-24T23:51:29+08:00	1561	4042	5603	614	6217	13002	47.82%	12.01%	18	18
14	高雄市內門區	2018-11-24T22:57:47+08:00	1561	4042	5603	614	6217	13002	47.82%	12.01%	18	18
14	高雄市內門區	2018-11-24T22:40:23+08:00	1561	4042	5603	614	6217	13002	47.82%	12.01%	18	18
14	高雄市內門區	2018-11-25T03:32:29+08:00	1561	4042	5603	614	6217	13002	47.82%	12.01%	18	18
14	高雄市內門區	2018-11-25T06:18:52+08:00	1561	4042	5603	614	6217	13002	47.82%	12.01%	18	18
14	高雄市內門區	2018-11-24T23:15:58+08:00	1561	4042	5603	614	6217	13002	47.82%	12.01%	18	18
14	高雄市內門區	2018-11-25T00:57:31+08:00	1561	4042	5603	614	6217	13002	47.82%	12.01%	18	18
14	高雄市內門區	2018-11-25T01:25:47+08:00	1561	4042	5603	614	6217	13002	47.82%	12.01%	18	18
14	高雄市內門區	2018-11-24T22:36:55+08:00	1561	4042	5603	614	6217	13002	47.82%	12.01%	18	18
14	高雄市內門區	2018-11-25T03:56:06+08:00	1561	4042	5603	614	6217	13002	47.82%	12.01%	18	18
14	高雄市內門區	2018-11-25T06:23:55+08:00	1561	4042	5603	614	6217	13002	47.82%	12.01%	18	18
14	高雄市內門區	2018-11-24T23:12:10+08:00	1561	4042	5603	614	6217	13002	47.82%	12.01%	18	18
14	高雄市內門區	2018-11-24T22:45:03+08:00	1561	4042	5603	614	6217	13002	47.82%	12.01%	18	18
14	高雄市湖內區	2018-11-25T04:02:43+08:00	4290	9315	13605	808	14413	25729	56.02%	16.67%	24	24
14	高雄市湖內區	2018-11-25T01:12:37+08:00	4290	9315	13605	808	14413	25729	56.02%	16.67%	24	24
14	高雄市湖內區	2018-11-25T00:14:03+08:00	4290	9315	13605	808	14413	25729	56.02%	16.67%	24	24
14	高雄市湖內區	2018-11-24T23:01:25+08:00	4290	9315	13605	808	14413	25729	56.02%	16.67%	24	24
14	高雄市湖內區	2018-11-24T23:12:09+08:00	4290	9315	13605	808	14413	25729	56.02%	16.67%	24	24
14	高雄市湖內區	2018-11-25T00:09:27+08:00	4290	9315	13605	808	14413	25729	56.02%	16.67%	24	24
14	高雄市湖內區	2018-11-24T23:35:05+08:00	4290	9315	13605	808	14413	25729	56.02%	16.67%	24	24
14	高雄市湖內區	2018-11-25T06:29:11+08:00	4290	9315	13605	808	14413	25729	56.02%	16.67%	24	24
14	高雄市湖內區	2018-11-24T23:39:09+08:00	4290	9315	13605	808	14413	25729	56.02%	16.67%	24	24
14	高雄市湖內區	2018-11-25T01:07:20+08:00	4290	9315	13605	808	14413	25729	56.02%	16.67%	24	24
14	高雄市湖內區	2018-11-24T23:31:04+08:00	4290	9315	13605	808	14413	25729	56.02%	16.67%	24	24
14	高雄市湖內區	2018-11-25T01:17:45+08:00	4290	9315	13605	808	14413	25729	56.02%	16.67%	24	24
14	高雄市湖內區	2018-11-24T22:13:20+08:00	4091	8909	13000	771	13771	24712	55.73%	16.55%	23	24
14	高雄市湖內區	2018-11-24T23:55:41+08:00	4290	9315	13605	808	14413	25729	56.02%	16.67%	24	24
14	高雄市湖內區	2018-11-24T22:23:06+08:00	4091	8909	13000	771	13771	24712	55.73%	16.55%	23	24
14	高雄市湖內區	2018-11-24T23:19:43+08:00	4290	9315	13605	808	14413	25729	56.02%	16.67%	24	24
14	高雄市湖內區	2018-11-24T23:04:58+08:00	4290	9315	13605	808	14413	25729	56.02%	16.67%	24	24
14	高雄市湖內區	2018-11-25T00:00:02+08:00	4290	9315	13605	808	14413	25729	56.02%	16.67%	24	24
14	高雄市湖內區	2018-11-25T00:04:59+08:00	4290	9315	13605	808	14413	25729	56.02%	16.67%	24	24
14	高雄市湖內區	2018-11-24T23:27:13+08:00	4290	9315	13605	808	14413	25729	56.02%	16.67%	24	24
14	高雄市湖內區	2018-11-24T22:30:00+08:00	4091	8909	13000	771	13771	24712	55.73%	16.55%	23	24
14	高雄市湖內區	2018-11-25T01:02:25+08:00	4290	9315	13605	808	14413	25729	56.02%	16.67%	24	24
14	高雄市湖內區	2018-11-25T06:13:47+08:00	4290	9315	13605	808	14413	25729	56.02%	16.67%	24	24
14	高雄市湖內區	2018-11-24T22:54:20+08:00	4290	9315	13605	808	14413	25729	56.02%	16.67%	24	24
14	高雄市湖內區	2018-11-25T00:22:58+08:00	4290	9315	13605	808	14413	25729	56.02%	16.67%	24	24
14	高雄市湖內區	2018-11-25T03:56:05+08:00	4290	9315	13605	808	14413	25729	56.02%	16.67%	24	24
14	高雄市湖內區	2018-11-24T22:26:32+08:00	4091	8909	13000	771	13771	24712	55.73%	16.55%	23	24
14	高雄市湖內區	2018-11-25T00:18:24+08:00	4290	9315	13605	808	14413	25729	56.02%	16.67%	24	24
14	高雄市湖內區	2018-11-24T22:41:30+08:00	4290	9315	13605	808	14413	25729	56.02%	16.67%	24	24
14	高雄市湖內區	2018-11-25T03:49:46+08:00	4290	9315	13605	808	14413	25729	56.02%	16.67%	24	24
14	高雄市湖內區	2018-11-25T06:08:46+08:00	4290	9315	13605	808	14413	25729	56.02%	16.67%	24	24
14	高雄市湖內區	2018-11-24T23:43:12+08:00	4290	9315	13605	808	14413	25729	56.02%	16.67%	24	24
14	高雄市湖內區	2018-11-24T23:47:22+08:00	4290	9315	13605	808	14413	25729	56.02%	16.67%	24	24
14	高雄市湖內區	2018-11-24T22:16:04+08:00	4091	8909	13000	771	13771	24712	55.73%	16.55%	23	24
14	高雄市湖內區	2018-11-24T22:33:32+08:00	4091	8909	13000	771	13771	24712	55.73%	16.55%	23	24
14	高雄市湖內區	2018-11-25T03:44:16+08:00	4290	9315	13605	808	14413	25729	56.02%	16.67%	24	24
14	高雄市湖內區	2018-11-25T03:38:50+08:00	4290	9315	13605	808	14413	25729	56.02%	16.67%	24	24
14	高雄市湖內區	2018-11-24T23:23:33+08:00	4290	9315	13605	808	14413	25729	56.02%	16.67%	24	24
14	高雄市湖內區	2018-11-24T23:51:29+08:00	4290	9315	13605	808	14413	25729	56.02%	16.67%	24	24
14	高雄市湖內區	2018-11-24T22:57:47+08:00	4290	9315	13605	808	14413	25729	56.02%	16.67%	24	24
14	高雄市湖內區	2018-11-24T22:19:31+08:00	4091	8909	13000	771	13771	24712	55.73%	16.55%	23	24
14	高雄市湖內區	2018-11-24T22:40:23+08:00	4290	9315	13605	808	14413	25729	56.02%	16.67%	24	24
14	高雄市湖內區	2018-11-25T03:32:29+08:00	4290	9315	13605	808	14413	25729	56.02%	16.67%	24	24
14	高雄市湖內區	2018-11-25T06:18:52+08:00	4290	9315	13605	808	14413	25729	56.02%	16.67%	24	24
14	高雄市湖內區	2018-11-25T00:57:31+08:00	4290	9315	13605	808	14413	25729	56.02%	16.67%	24	24
14	高雄市湖內區	2018-11-25T01:25:47+08:00	4290	9315	13605	808	14413	25729	56.02%	16.67%	24	24
14	高雄市湖內區	2018-11-24T22:36:55+08:00	4091	8909	13000	771	13771	24712	55.73%	16.55%	23	24
14	高雄市湖內區	2018-11-24T23:08:29+08:00	4290	9315	13605	808	14413	25729	56.02%	16.67%	24	24
14	高雄市湖內區	2018-11-24T23:15:57+08:00	4290	9315	13605	808	14413	25729	56.02%	16.67%	24	24
14	高雄市湖內區	2018-11-25T06:23:54+08:00	4290	9315	13605	808	14413	25729	56.02%	16.67%	24	24
14	高雄市湖內區	2018-11-24T22:50:41+08:00	4290	9315	13605	808	14413	25729	56.02%	16.67%	24	24
14	高雄市湖內區	2018-11-24T22:45:03+08:00	4290	9315	13605	808	14413	25729	56.02%	16.67%	24	24
14	嘉義縣義竹鄉	2018-11-25T03:56:10+08:00	2239	5294	7533	865	8398	16647	50.45%	13.45%	26	26
14	嘉義縣義竹鄉	2018-11-24T23:47:26+08:00	2239	5294	7533	865	8398	16647	50.45%	13.45%	26	26
14	嘉義縣義竹鄉	2018-11-24T23:16:01+08:00	2239	5294	7533	865	8398	16647	50.45%	13.45%	26	26
14	嘉義縣義竹鄉	2018-11-24T22:16:08+08:00	1888	4524	6412	755	7167	14275	50.21%	13.23%	24	26
14	嘉義縣義竹鄉	2018-11-24T22:33:36+08:00	2239	5294	7533	865	8398	16647	50.45%	13.45%	26	26
14	嘉義縣義竹鄉	2018-11-25T01:25:50+08:00	2239	5294	7533	865	8398	16647	50.45%	13.45%	26	26
14	嘉義縣義竹鄉	2018-11-25T03:38:53+08:00	2239	5294	7533	865	8398	16647	50.45%	13.45%	26	26
14	嘉義縣義竹鄉	2018-11-24T23:23:36+08:00	2239	5294	7533	865	8398	16647	50.45%	13.45%	26	26
14	嘉義縣義竹鄉	2018-11-24T22:19:35+08:00	1888	4524	6412	755	7167	14275	50.21%	13.23%	24	26
14	嘉義縣義竹鄉	2018-11-25T00:57:34+08:00	2239	5294	7533	865	8398	16647	50.45%	13.45%	26	26
14	嘉義縣義竹鄉	2018-11-25T01:17:50+08:00	2239	5294	7533	865	8398	16647	50.45%	13.45%	26	26
14	嘉義縣義竹鄉	2018-11-24T22:40:26+08:00	2239	5294	7533	865	8398	16647	50.45%	13.45%	26	26
14	嘉義縣義竹鄉	2018-11-24T22:36:58+08:00	2239	5294	7533	865	8398	16647	50.45%	13.45%	26	26
14	嘉義縣義竹鄉	2018-11-24T22:57:51+08:00	2239	5294	7533	865	8398	16647	50.45%	13.45%	26	26
14	嘉義縣義竹鄉	2018-11-25T00:09:32+08:00	2239	5294	7533	865	8398	16647	50.45%	13.45%	26	26
14	嘉義縣義竹鄉	2018-11-24T22:45:06+08:00	2239	5294	7533	865	8398	16647	50.45%	13.45%	26	26
14	嘉義縣義竹鄉	2018-11-25T06:08:50+08:00	2239	5294	7533	865	8398	16647	50.45%	13.45%	26	26
14	嘉義縣義竹鄉	2018-11-25T06:23:58+08:00	2239	5294	7533	865	8398	16647	50.45%	13.45%	26	26
14	嘉義縣義竹鄉	2018-11-24T23:39:13+08:00	2239	5294	7533	865	8398	16647	50.45%	13.45%	26	26
14	嘉義縣義竹鄉	2018-11-25T03:49:49+08:00	2239	5294	7533	865	8398	16647	50.45%	13.45%	26	26
14	嘉義縣義竹鄉	2018-11-25T01:12:41+08:00	2239	5294	7533	865	8398	16647	50.45%	13.45%	26	26
14	嘉義縣義竹鄉	2018-11-24T22:26:35+08:00	2239	5294	7533	865	8398	16647	50.45%	13.45%	26	26
14	嘉義縣義竹鄉	2018-11-24T23:12:13+08:00	2239	5294	7533	865	8398	16647	50.45%	13.45%	26	26
14	嘉義縣義竹鄉	2018-11-25T04:02:50+08:00	2239	5294	7533	865	8398	16647	50.45%	13.45%	26	26
14	嘉義縣義竹鄉	2018-11-24T23:43:15+08:00	2239	5294	7533	865	8398	16647	50.45%	13.45%	26	26
14	嘉義縣義竹鄉	2018-11-25T00:14:07+08:00	2239	5294	7533	865	8398	16647	50.45%	13.45%	26	26
14	嘉義縣義竹鄉	2018-11-24T23:01:29+08:00	2239	5294	7533	865	8398	16647	50.45%	13.45%	26	26
14	嘉義縣義竹鄉	2018-11-25T01:07:24+08:00	2239	5294	7533	865	8398	16647	50.45%	13.45%	26	26
14	嘉義縣義竹鄉	2018-11-24T23:31:09+08:00	2239	5294	7533	865	8398	16647	50.45%	13.45%	26	26
14	嘉義縣義竹鄉	2018-11-25T06:13:50+08:00	2239	5294	7533	865	8398	16647	50.45%	13.45%	26	26
14	嘉義縣義竹鄉	2018-11-24T23:35:08+08:00	2239	5294	7533	865	8398	16647	50.45%	13.45%	26	26
14	嘉義縣義竹鄉	2018-11-25T06:29:15+08:00	2239	5294	7533	865	8398	16647	50.45%	13.45%	26	26
14	嘉義縣義竹鄉	2018-11-24T23:55:45+08:00	2239	5294	7533	865	8398	16647	50.45%	13.45%	26	26
14	嘉義縣義竹鄉	2018-11-24T23:08:34+08:00	2239	5294	7533	865	8398	16647	50.45%	13.45%	26	26
14	嘉義縣義竹鄉	2018-11-25T03:32:32+08:00	2239	5294	7533	865	8398	16647	50.45%	13.45%	26	26
14	嘉義縣義竹鄉	2018-11-25T00:23:02+08:00	2239	5294	7533	865	8398	16647	50.45%	13.45%	26	26
14	嘉義縣義竹鄉	2018-11-24T23:19:48+08:00	2239	5294	7533	865	8398	16647	50.45%	13.45%	26	26
14	嘉義縣義竹鄉	2018-11-25T03:44:20+08:00	2239	5294	7533	865	8398	16647	50.45%	13.45%	26	26
14	嘉義縣義竹鄉	2018-11-25T00:00:08+08:00	2239	5294	7533	865	8398	16647	50.45%	13.45%	26	26
14	嘉義縣義竹鄉	2018-11-24T22:13:25+08:00	1888	4524	6412	755	7167	14275	50.21%	13.23%	24	26
14	嘉義縣義竹鄉	2018-11-24T22:23:11+08:00	2239	5294	7533	865	8398	16647	50.45%	13.45%	26	26
14	嘉義縣義竹鄉	2018-11-24T23:51:33+08:00	2239	5294	7533	865	8398	16647	50.45%	13.45%	26	26
14	嘉義縣義竹鄉	2018-11-25T06:18:55+08:00	2239	5294	7533	865	8398	16647	50.45%	13.45%	26	26
14	嘉義縣義竹鄉	2018-11-25T01:02:28+08:00	2239	5294	7533	865	8398	16647	50.45%	13.45%	26	26
14	嘉義縣義竹鄉	2018-11-24T23:27:16+08:00	2239	5294	7533	865	8398	16647	50.45%	13.45%	26	26
14	嘉義縣義竹鄉	2018-11-24T22:30:04+08:00	2239	5294	7533	865	8398	16647	50.45%	13.45%	26	26
14	嘉義縣義竹鄉	2018-11-24T23:05:03+08:00	2239	5294	7533	865	8398	16647	50.45%	13.45%	26	26
14	嘉義縣義竹鄉	2018-11-24T22:54:24+08:00	2239	5294	7533	865	8398	16647	50.45%	13.45%	26	26
14	嘉義縣義竹鄉	2018-11-25T00:18:28+08:00	2239	5294	7533	865	8398	16647	50.45%	13.45%	26	26
14	嘉義縣義竹鄉	2018-11-24T22:41:33+08:00	2239	5294	7533	865	8398	16647	50.45%	13.45%	26	26
14	嘉義縣義竹鄉	2018-11-25T00:05:03+08:00	2239	5294	7533	865	8398	16647	50.45%	13.45%	26	26
14	嘉義縣義竹鄉	2018-11-24T22:50:46+08:00	2239	5294	7533	865	8398	16647	50.45%	13.45%	26	26
14	嘉義縣	2018-11-24T23:47:26+08:00	54243	129178	183421	16755	200176	396403	50.5%	13.68%	454	486
14	嘉義縣	2018-11-24T22:16:08+08:00	36938	88436	125374	11786	137160	274218	50.02%	13.47%	359	486
14	嘉義縣	2018-11-24T23:16:00+08:00	48720	117034	165754	15351	181105	360071	50.3%	13.53%	430	486
14	嘉義縣	2018-11-25T01:25:50+08:00	61021	143492	204513	18373	222886	439687	50.69%	13.88%	484	486
14	嘉義縣	2018-11-25T03:38:53+08:00	61462	144616	206078	18516	224594	442775	50.72%	13.88%	486	486
14	嘉義縣	2018-11-25T00:23:01+08:00	58652	138323	196975	17741	214716	424129	50.63%	13.83%	473	486
14	嘉義縣	2018-11-24T23:23:36+08:00	49825	119307	169132	15642	184774	366857	50.37%	13.58%	435	486
14	嘉義縣	2018-11-24T22:19:35+08:00	37691	90179	127870	12028	139898	279562	50.04%	13.48%	364	486
14	嘉義縣	2018-11-25T00:57:34+08:00	60055	141164	201219	18180	219399	433201	50.65%	13.86%	480	486
14	嘉義縣	2018-11-24T22:36:58+08:00	42209	101339	143548	13616	157164	313126	50.19%	13.48%	395	486
14	嘉義縣	2018-11-24T22:57:51+08:00	45938	110338	156276	14618	170894	340386	50.21%	13.5%	416	486
14	嘉義縣	2018-11-25T00:09:32+08:00	57515	135583	193098	17468	210566	416294	50.58%	13.82%	468	486
14	嘉義縣	2018-11-24T22:45:06+08:00	42641	102327	144968	13811	158779	316389	50.18%	13.48%	399	486
14	嘉義縣	2018-11-25T06:08:50+08:00	61462	144616	206078	18516	224594	442775	50.72%	13.88%	486	486
14	嘉義縣	2018-11-25T06:23:58+08:00	61462	144616	206078	18516	224594	442775	50.72%	13.88%	486	486
14	嘉義縣	2018-11-24T23:39:13+08:00	53057	126515	179572	16480	196052	388778	50.43%	13.65%	449	486
14	嘉義縣	2018-11-24T22:26:34+08:00	39571	94867	134438	12781	147219	293493	50.16%	13.48%	378	486
14	嘉義縣	2018-11-25T03:49:49+08:00	61462	144616	206078	18516	224594	442775	50.72%	13.88%	486	486
14	嘉義縣	2018-11-25T01:12:41+08:00	60779	142913	203692	18344	222036	438075	50.68%	13.87%	483	486
14	嘉義縣	2018-11-24T22:50:45+08:00	43689	104824	148513	14057	162570	323980	50.18%	13.49%	405	486
14	嘉義縣	2018-11-24T23:12:13+08:00	47806	114809	162615	15151	177766	353735	50.25%	13.51%	426	486
14	嘉義縣	2018-11-25T04:02:50+08:00	61462	144616	206078	18516	224594	442775	50.72%	13.88%	486	486
14	嘉義縣	2018-11-24T23:31:08+08:00	52107	124317	176424	16215	192639	382094	50.42%	13.64%	445	486
14	嘉義縣	2018-11-24T23:43:15+08:00	54006	128717	182723	16719	199442	394980	50.49%	13.67%	453	486
14	嘉義縣	2018-11-25T06:29:14+08:00	61462	144616	206078	18516	224594	442775	50.72%	13.88%	486	486
14	嘉義縣	2018-11-25T00:14:07+08:00	57805	136256	194061	17526	211587	418117	50.6%	13.83%	469	486
14	嘉義縣	2018-11-24T23:01:29+08:00	46402	111479	157881	14734	172615	343577	50.24%	13.51%	419	486
14	嘉義縣	2018-11-25T01:07:24+08:00	60779	142913	203692	18344	222036	438075	50.68%	13.87%	483	486
14	嘉義縣	2018-11-25T06:13:50+08:00	61462	144616	206078	18516	224594	442775	50.72%	13.88%	486	486
14	嘉義縣	2018-11-24T23:35:08+08:00	52386	124969	177355	16259	193614	384042	50.41%	13.64%	446	486
14	嘉義縣	2018-11-24T22:33:35+08:00	41704	99989	141693	13488	155181	309219	50.18%	13.49%	392	486
14	嘉義縣	2018-11-24T23:08:33+08:00	47181	113420	160601	14996	175597	349414	50.25%	13.5%	423	486
14	嘉義縣	2018-11-25T03:32:32+08:00	61462	144616	206078	18516	224594	442775	50.72%	13.88%	486	486
14	嘉義縣	2018-11-24T23:19:48+08:00	49334	118402	167736	15532	183268	364294	50.31%	13.54%	433	486
14	嘉義縣	2018-11-25T03:44:20+08:00	61462	144616	206078	18516	224594	442775	50.72%	13.88%	486	486
14	嘉義縣	2018-11-24T22:13:24+08:00	36190	86602	122792	11593	134385	268591	50.03%	13.47%	354	486
14	嘉義縣	2018-11-25T00:00:08+08:00	55116	131242	186358	16986	203344	402478	50.52%	13.69%	459	486
14	嘉義縣	2018-11-24T23:55:44+08:00	54905	130736	185641	16932	202573	400997	50.52%	13.69%	458	486
14	嘉義縣	2018-11-25T01:17:49+08:00	60779	142913	203692	18344	222036	438075	50.68%	13.87%	483	486
14	嘉義縣	2018-11-25T06:18:55+08:00	61462	144616	206078	18516	224594	442775	50.72%	13.88%	486	486
14	嘉義縣	2018-11-25T01:02:28+08:00	60249	141599	201848	18243	220091	434403	50.67%	13.87%	481	486
14	嘉義縣	2018-11-24T23:27:16+08:00	51364	122717	174081	15967	190048	377089	50.4%	13.62%	441	486
14	嘉義縣	2018-11-24T22:40:25+08:00	42385	101814	144199	13684	157883	314787	50.16%	13.46%	397	486
14	嘉義縣	2018-11-24T22:23:10+08:00	38712	92749	131461	12469	143930	287316	50.09%	13.47%	371	486
14	嘉義縣	2018-11-24T22:30:03+08:00	40324	96705	137029	13050	150079	298821	50.22%	13.49%	383	486
14	嘉義縣	2018-11-24T23:51:32+08:00	54687	130168	184855	16870	201725	399468	50.5%	13.69%	457	486
14	嘉義縣	2018-11-25T00:05:02+08:00	56247	133916	190163	17259	207422	410318	50.55%	13.71%	464	486
14	嘉義縣	2018-11-24T22:41:32+08:00	42385	101814	144199	13684	157883	314787	50.16%	13.46%	397	486
14	嘉義縣	2018-11-24T22:54:23+08:00	44430	106627	151057	14230	165287	329325	50.19%	13.49%	409	486
14	嘉義縣	2018-11-24T23:05:02+08:00	46955	112864	159819	14933	174752	348014	50.21%	13.49%	422	486
14	嘉義縣	2018-11-25T03:56:09+08:00	61462	144616	206078	18516	224594	442775	50.72%	13.88%	486	486
14	嘉義縣	2018-11-25T00:18:27+08:00	58084	136795	194879	17565	212444	419596	50.63%	13.84%	470	486
14	臺北市北投區	2018-11-24T23:47:17+08:00	21918	35903	57821	3025	60846	108510	56.07%	20.2%	75	141
14	臺北市北投區	2018-11-24T22:26:28+08:00	9653	15603	25256	1384	26640	47810	55.72%	20.19%	35	141
14	臺北市北投區	2018-11-25T01:12:31+08:00	36212	58648	94860	5031	99891	177171	56.38%	20.44%	119	141
14	臺北市北投區	2018-11-25T01:07:16+08:00	36212	58648	94860	5031	99891	177171	56.38%	20.44%	119	141
14	臺北市北投區	2018-11-24T22:19:27+08:00	8073	13075	21148	1154	22302	40427	55.17%	19.97%	30	141
14	臺北市北投區	2018-11-24T22:13:16+08:00	7361	12022	19383	1105	20488	37108	55.21%	19.84%	28	141
14	臺北市北投區	2018-11-24T22:57:42+08:00	14047	22763	36810	1938	38748	68826	56.3%	20.41%	49	141
14	臺北市北投區	2018-11-25T00:57:26+08:00	33891	55021	88912	4757	93669	166761	56.17%	20.32%	112	141
14	臺北市北投區	2018-11-24T23:51:25+08:00	22194	36308	58502	3075	61577	109719	56.12%	20.23%	76	141
14	臺北市北投區	2018-11-24T22:29:54+08:00	9653	15603	25256	1384	26640	47810	55.72%	20.19%	35	141
14	臺北市北投區	2018-11-24T23:27:09+08:00	19312	31881	51193	2736	53929	96104	56.12%	20.09%	67	141
14	臺北市北投區	2018-11-24T22:44:59+08:00	11954	19223	31177	1663	32840	58554	56.08%	20.42%	42	141
14	臺北市北投區	2018-11-24T22:19:28+08:00	8073	13075	21148	1154	22302	40427	55.17%	19.97%	30	141
14	臺北市北投區	2018-11-24T22:23:01+08:00	9063	14693	23756	1298	25054	45162	55.48%	20.07%	33	141
14	臺北市北投區	2018-11-24T22:57:43+08:00	14047	22763	36810	1938	38748	68826	56.3%	20.41%	49	141
14	臺北市北投區	2018-11-25T03:32:24+08:00	43826	70478	114304	5955	120259	213250	56.39%	20.55%	141	141
14	臺北市北投區	2018-11-25T03:38:46+08:00	43826	70478	114304	5955	120259	213250	56.39%	20.55%	141	141
14	臺北市北投區	2018-11-24T23:59:58+08:00	23730	38842	62572	3326	65898	117576	56.05%	20.18%	81	141
14	臺北市北投區	2018-11-25T01:25:42+08:00	37298	60221	97519	5151	102670	182327	56.31%	20.46%	122	141
14	臺北市北投區	2018-11-24T22:40:18+08:00	11329	18243	29572	1581	31153	55653	55.98%	20.36%	40	141
14	臺北市北投區	2018-11-25T03:32:25+08:00	43826	70478	114304	5955	120259	213250	56.39%	20.55%	141	141
14	臺北市北投區	2018-11-24T23:08:24+08:00	16617	27274	43891	2330	46221	82141	56.27%	20.23%	58	141
14	臺北市北投區	2018-11-24T23:15:53+08:00	17889	29276	47165	2499	49664	88040	56.41%	20.32%	62	141
14	臺北市北投區	2018-11-24T23:59:57+08:00	23730	38842	62572	3326	65898	117576	56.05%	20.18%	81	141
14	臺北市北投區	2018-11-24T22:40:19+08:00	11329	18243	29572	1581	31153	55653	55.98%	20.36%	40	141
14	臺北市北投區	2018-11-24T23:55:37+08:00	23011	37743	60754	3213	63967	114100	56.06%	20.17%	79	141
14	臺北市北投區	2018-11-25T00:13:59+08:00	27131	44280	71411	3826	75237	133892	56.19%	20.26%	91	141
14	臺北市北投區	2018-11-24T22:36:51+08:00	10661	17153	27814	1501	29315	52556	55.78%	20.29%	38	141
14	臺北市北投區	2018-11-24T22:54:17+08:00	12835	20746	33581	1799	35380	62806	56.33%	20.44%	45	141
14	臺北市北投區	2018-11-25T06:23:50+08:00	43826	70478	114304	5955	120259	213250	56.39%	20.55%	141	141
14	臺北市北投區	2018-11-24T23:01:21+08:00	15114	24574	39688	2087	41775	74159	56.33%	20.38%	53	141
14	臺北市北投區	2018-11-24T23:12:04+08:00	17257	28294	45551	2416	47967	85308	56.23%	20.23%	60	141
14	臺北市北投區	2018-11-25T06:08:41+08:00	43826	70478	114304	5955	120259	213250	56.39%	20.55%	141	141
14	臺北市北投區	2018-11-25T00:09:22+08:00	26063	42472	68535	3672	72207	128718	56.1%	20.25%	88	141
14	臺北市北投區	2018-11-24T23:31:00+08:00	20614	34057	54671	2885	57556	102575	56.11%	20.1%	71	141
14	臺北市北投區	2018-11-24T23:39:03+08:00	21206	34927	56133	2978	59111	105380	56.09%	20.12%	73	141
14	臺北市北投區	2018-11-24T23:01:20+08:00	15114	24574	39688	2087	41775	74159	56.33%	20.38%	53	141
14	臺北市北投區	2018-11-24T22:50:36+08:00	12536	20180	32716	1768	34484	61309	56.25%	20.45%	44	141
14	臺北市北投區	2018-11-25T01:12:32+08:00	36212	58648	94860	5031	99891	177171	56.38%	20.44%	119	141
14	臺北市北投區	2018-11-24T22:41:26+08:00	11329	18243	29572	1581	31153	55653	55.98%	20.36%	40	141
14	臺北市北投區	2018-11-24T23:35:01+08:00	21206	34927	56133	2978	59111	105380	56.09%	20.12%	73	141
14	臺北市北投區	2018-11-24T23:04:54+08:00	15369	25100	40469	2169	42638	75758	56.28%	20.29%	54	141
14	臺北市北投區	2018-11-25T00:04:55+08:00	25725	41953	67678	3633	71311	127185	56.07%	20.23%	87	141
14	臺北市北投區	2018-11-25T03:44:11+08:00	43826	70478	114304	5955	120259	213250	56.39%	20.55%	141	141
14	臺北市北投區	2018-11-25T06:18:48+08:00	43826	70478	114304	5955	120259	213250	56.39%	20.55%	141	141
14	臺北市北投區	2018-11-24T22:23:02+08:00	9063	14693	23756	1298	25054	45162	55.48%	20.07%	33	141
14	臺北市北投區	2018-11-25T03:44:10+08:00	43826	70478	114304	5955	120259	213250	56.39%	20.55%	141	141
14	臺北市北投區	2018-11-25T01:17:40+08:00	37298	60221	97519	5151	102670	182327	56.31%	20.46%	122	141
14	臺北市北投區	2018-11-25T01:02:20+08:00	34808	56544	91352	4859	96211	171038	56.25%	20.35%	115	141
14	臺北市北投區	2018-11-24T23:19:38+08:00	18129	29765	47894	2547	50441	89508	56.35%	20.25%	63	141
14	臺北市北投區	2018-11-24T23:23:29+08:00	18732	30840	49572	2613	52185	92599	56.36%	20.23%	65	141
14	臺北市北投區	2018-11-24T22:36:52+08:00	10661	17153	27814	1501	29315	52556	55.78%	20.29%	38	141
14	臺北市北投區	2018-11-24T22:15:59+08:00	7361	12022	19383	1105	20488	37108	55.21%	19.84%	28	141
14	臺北市北投區	2018-11-24T23:19:39+08:00	18129	29765	47894	2547	50441	89508	56.35%	20.25%	63	141
14	臺北市北投區	2018-11-25T01:17:39+08:00	37298	60221	97519	5151	102670	182327	56.31%	20.46%	122	141
14	臺北市北投區	2018-11-25T06:29:06+08:00	43826	70478	114304	5955	120259	213250	56.39%	20.55%	141	141
14	臺北市北投區	2018-11-24T22:33:28+08:00	10661	17153	27814	1501	29315	52556	55.78%	20.29%	38	141
14	臺北市北投區	2018-11-25T06:13:43+08:00	43826	70478	114304	5955	120259	213250	56.39%	20.55%	141	141
14	臺北市北投區	2018-11-24T23:43:07+08:00	21548	35416	56964	3006	59970	106836	56.13%	20.17%	74	141
14	臺北市北投區	2018-11-25T00:22:53+08:00	29700	48238	77938	4118	82056	145622	56.35%	20.4%	99	141
14	臺北市北投區	2018-11-25T03:56:00+08:00	43826	70478	114304	5955	120259	213250	56.39%	20.55%	141	141
14	臺北市北投區	2018-11-24T22:33:27+08:00	10661	17153	27814	1501	29315	52556	55.78%	20.29%	38	141
14	臺北市北投區	2018-11-25T03:49:42+08:00	43826	70478	114304	5955	120259	213250	56.39%	20.55%	141	141
14	臺北市北投區	2018-11-25T00:18:20+08:00	28380	46114	74494	3964	78458	139440	56.27%	20.35%	95	141
14	臺北市北投區	2018-11-25T04:02:38+08:00	43826	70478	114304	5955	120259	213250	56.39%	20.55%	141	141
14	臺北市信義區	2018-11-24T23:47:17+08:00	33457	56203	89660	4053	93713	160805	58.28%	20.81%	121	142
14	臺北市信義區	2018-11-24T22:26:28+08:00	20378	34199	54577	2262	56839	95778	59.34%	21.28%	75	142
14	臺北市信義區	2018-11-24T22:50:35+08:00	24640	41525	66165	2884	69049	116892	59.07%	21.08%	91	142
14	臺北市信義區	2018-11-25T01:12:31+08:00	39545	66509	106054	4758	110812	190444	58.19%	20.76%	142	142
14	臺北市信義區	2018-11-25T01:07:16+08:00	38931	65540	104471	4692	109163	187741	58.15%	20.74%	140	142
14	臺北市信義區	2018-11-24T22:19:27+08:00	19221	32242	51463	2136	53599	90284	59.37%	21.29%	71	142
14	臺北市信義區	2018-11-24T22:13:16+08:00	18608	31250	49858	2077	51935	87259	59.52%	21.33%	69	142
14	臺北市信義區	2018-11-24T22:57:42+08:00	26129	44322	70451	3121	73572	124829	58.94%	20.93%	96	142
14	臺北市信義區	2018-11-25T00:57:26+08:00	38643	64969	103612	4651	108263	186210	58.14%	20.75%	139	142
14	臺北市信義區	2018-11-24T23:51:25+08:00	33457	56203	89660	4053	93713	160805	58.28%	20.81%	121	142
14	臺北市信義區	2018-11-24T22:29:54+08:00	21220	35647	56867	2370	59237	99957	59.26%	21.23%	78	142
14	臺北市信義區	2018-11-24T23:27:09+08:00	30481	51246	81727	3665	85392	146789	58.17%	20.77%	111	142
14	臺北市信義區	2018-11-24T22:44:59+08:00	23292	39207	62499	2697	65196	110232	59.14%	21.13%	86	142
14	臺北市信義區	2018-11-24T22:23:01+08:00	19767	33074	52841	2207	55048	92856	59.28%	21.29%	73	142
14	臺北市信義區	2018-11-25T03:55:59+08:00	39545	66509	106054	4758	110812	190444	58.19%	20.76%	142	142
14	臺北市信義區	2018-11-24T23:51:24+08:00	33457	56203	89660	4053	93713	160805	58.28%	20.81%	121	142
14	臺北市信義區	2018-11-24T23:15:52+08:00	28393	47742	76135	3393	79528	135466	58.71%	20.96%	104	142
14	臺北市信義區	2018-11-25T03:32:24+08:00	39545	66509	106054	4758	110812	190444	58.19%	20.76%	142	142
14	臺北市信義區	2018-11-25T03:38:46+08:00	39545	66509	106054	4758	110812	190444	58.19%	20.76%	142	142
14	臺北市信義區	2018-11-25T01:25:42+08:00	39545	66509	106054	4758	110812	190444	58.19%	20.76%	142	142
14	臺北市信義區	2018-11-24T23:55:36+08:00	34218	57476	91694	4141	95835	164570	58.23%	20.79%	124	142
14	臺北市信義區	2018-11-25T00:13:58+08:00	36326	60969	97295	4374	101669	174683	58.2%	20.8%	131	142
14	臺北市信義區	2018-11-24T22:40:18+08:00	23021	38784	61805	2658	64463	108921	59.18%	21.14%	85	142
14	臺北市信義區	2018-11-24T23:08:24+08:00	27710	46832	74542	3333	77875	132485	58.78%	20.92%	102	142
14	臺北市信義區	2018-11-24T23:15:53+08:00	28393	47742	76135	3393	79528	135466	58.71%	20.96%	104	142
14	臺北市信義區	2018-11-24T23:59:57+08:00	34493	57980	92473	4166	96639	165975	58.23%	20.78%	125	142
14	臺北市信義區	2018-11-24T23:55:37+08:00	34218	57476	91694	4141	95835	164570	58.23%	20.79%	124	142
14	臺北市信義區	2018-11-25T00:13:59+08:00	36326	60969	97295	4374	101669	174683	58.2%	20.8%	131	142
14	臺北市信義區	2018-11-24T22:36:51+08:00	23021	38784	61805	2658	64463	108921	59.18%	21.14%	85	142
14	臺北市信義區	2018-11-24T22:54:16+08:00	24640	41525	66165	2884	69049	116892	59.07%	21.08%	91	142
14	臺北市信義區	2018-11-25T06:29:05+08:00	39545	66509	106054	4758	110812	190444	58.19%	20.76%	142	142
14	臺北市信義區	2018-11-24T22:54:17+08:00	24640	41525	66165	2884	69049	116892	59.07%	21.08%	91	142
14	臺北市信義區	2018-11-25T06:23:50+08:00	39545	66509	106054	4758	110812	190444	58.19%	20.76%	142	142
14	臺北市信義區	2018-11-25T03:49:41+08:00	39545	66509	106054	4758	110812	190444	58.19%	20.76%	142	142
14	臺北市信義區	2018-11-24T23:39:02+08:00	32050	53834	85884	3869	89753	154004	58.28%	20.81%	116	142
14	臺北市信義區	2018-11-24T23:12:04+08:00	28026	47285	75311	3356	78667	133845	58.77%	20.94%	103	142
14	臺北市信義區	2018-11-25T06:08:41+08:00	39545	66509	106054	4758	110812	190444	58.19%	20.76%	142	142
14	臺北市信義區	2018-11-25T06:08:40+08:00	39545	66509	106054	4758	110812	190444	58.19%	20.76%	142	142
14	臺北市信義區	2018-11-25T00:09:22+08:00	35078	58954	94032	4267	98299	168732	58.26%	20.79%	127	142
14	臺北市信義區	2018-11-24T23:31:00+08:00	31451	52760	84211	3800	88011	151232	58.2%	20.8%	114	142
14	臺北市信義區	2018-11-24T23:39:03+08:00	32050	53834	85884	3869	89753	154004	58.28%	20.81%	116	142
14	臺北市信義區	2018-11-24T23:01:20+08:00	26669	45223	71892	3182	75074	127598	58.84%	20.9%	98	142
14	臺北市信義區	2018-11-24T22:50:36+08:00	24640	41525	66165	2884	69049	116892	59.07%	21.08%	91	142
14	臺北市信義區	2018-11-25T01:12:32+08:00	39545	66509	106054	4758	110812	190444	58.19%	20.76%	142	142
14	臺北市信義區	2018-11-24T22:41:26+08:00	23021	38784	61805	2658	64463	108921	59.18%	21.14%	85	142
14	臺北市信義區	2018-11-24T23:35:01+08:00	31451	52760	84211	3800	88011	151232	58.2%	20.8%	114	142
14	臺北市信義區	2018-11-24T23:04:54+08:00	27225	46142	73367	3263	76630	130208	58.85%	20.91%	100	142
14	臺北市信義區	2018-11-25T06:18:47+08:00	39545	66509	106054	4758	110812	190444	58.19%	20.76%	142	142
14	臺北市信義區	2018-11-25T00:04:55+08:00	35078	58954	94032	4267	98299	168732	58.26%	20.79%	127	142
14	臺北市信義區	2018-11-24T22:13:15+08:00	18608	31250	49858	2077	51935	87259	59.52%	21.33%	69	142
14	臺北市信義區	2018-11-25T06:18:48+08:00	39545	66509	106054	4758	110812	190444	58.19%	20.76%	142	142
14	臺北市信義區	2018-11-25T03:44:10+08:00	39545	66509	106054	4758	110812	190444	58.19%	20.76%	142	142
14	臺北市信義區	2018-11-25T01:02:20+08:00	38931	65540	104471	4692	109163	187741	58.15%	20.74%	140	142
14	臺北市信義區	2018-11-25T03:38:45+08:00	39545	66509	106054	4758	110812	190444	58.19%	20.76%	142	142
14	臺北市信義區	2018-11-24T23:19:38+08:00	28938	48635	77573	3436	81009	139162	58.21%	20.79%	106	142
14	臺北市信義區	2018-11-24T23:23:29+08:00	29865	50245	80110	3604	83714	143652	58.28%	20.79%	109	142
14	臺北市信義區	2018-11-24T23:30:59+08:00	31451	52760	84211	3800	88011	151232	58.2%	20.8%	114	142
14	臺北市信義區	2018-11-24T22:15:59+08:00	18897	31763	50660	2112	52772	88709	59.49%	21.3%	70	142
14	臺北市信義區	2018-11-25T01:17:39+08:00	39545	66509	106054	4758	110812	190444	58.19%	20.76%	142	142
14	臺北市信義區	2018-11-25T06:29:06+08:00	39545	66509	106054	4758	110812	190444	58.19%	20.76%	142	142
14	臺北市信義區	2018-11-24T22:33:28+08:00	21972	36914	58886	2490	61376	103703	59.18%	21.19%	81	142
14	臺北市信義區	2018-11-25T06:13:43+08:00	39545	66509	106054	4758	110812	190444	58.19%	20.76%	142	142
14	臺北市信義區	2018-11-24T23:43:07+08:00	33153	55661	88814	4032	92846	159267	58.3%	20.82%	120	142
14	臺北市信義區	2018-11-25T00:18:19+08:00	36696	61559	98255	4416	102671	176414	58.2%	20.8%	132	142
14	臺北市信義區	2018-11-25T00:22:53+08:00	36696	61559	98255	4416	102671	176414	58.2%	20.8%	132	142
14	臺北市信義區	2018-11-25T03:56:00+08:00	39545	66509	106054	4758	110812	190444	58.19%	20.76%	142	142
14	臺北市信義區	2018-11-24T22:33:27+08:00	21972	36914	58886	2490	61376	103703	59.18%	21.19%	81	142
14	臺北市信義區	2018-11-25T03:49:42+08:00	39545	66509	106054	4758	110812	190444	58.19%	20.76%	142	142
14	臺北市信義區	2018-11-25T00:18:20+08:00	36696	61559	98255	4416	102671	176414	58.2%	20.8%	132	142
14	臺北市信義區	2018-11-25T06:13:42+08:00	39545	66509	106054	4758	110812	190444	58.19%	20.76%	142	142
14	臺北市信義區	2018-11-25T04:02:38+08:00	39545	66509	106054	4758	110812	190444	58.19%	20.76%	142	142
14	桃園市八德區	2018-11-25T01:07:17+08:00	25238	53665	78903	4498	83401	165065	50.53%	15.29%	101	101
14	桃園市八德區	2018-11-25T06:08:42+08:00	25238	53665	78903	4498	83401	165065	50.53%	15.29%	101	101
14	桃園市八德區	2018-11-24T23:47:18+08:00	24396	51908	76304	4332	80636	159622	50.52%	15.28%	98	101
14	桃園市八德區	2018-11-24T23:35:02+08:00	23915	50739	74654	4223	78877	156280	50.47%	15.3%	96	101
14	桃園市八德區	2018-11-24T22:26:29+08:00	17126	36735	53861	3127	56988	111836	50.96%	15.31%	72	101
14	桃園市八德區	2018-11-24T22:16:00+08:00	15656	33591	49247	2913	52160	102118	51.08%	15.33%	67	101
14	桃園市八德區	2018-11-25T03:44:12+08:00	25238	53665	78903	4498	83401	165065	50.53%	15.29%	101	101
14	桃園市八德區	2018-11-25T00:04:56+08:00	24672	52388	77060	4387	81447	161100	50.56%	15.31%	99	101
14	桃園市八德區	2018-11-24T22:19:28+08:00	16162	34756	50918	2997	53915	105694	51.01%	15.29%	69	101
14	桃園市八德區	2018-11-24T22:57:44+08:00	21916	46562	68478	3861	72339	143202	50.52%	15.3%	89	101
14	桃園市八德區	2018-11-25T00:57:27+08:00	25238	53665	78903	4498	83401	165065	50.53%	15.29%	101	101
14	桃園市八德區	2018-11-24T22:13:17+08:00	15424	32996	48420	2839	51259	100506	51%	15.35%	66	101
14	桃園市八德區	2018-11-24T23:23:30+08:00	23369	49650	73019	4142	77161	152876	50.47%	15.29%	94	101
14	桃園市八德區	2018-11-24T22:29:55+08:00	17648	37964	55612	3214	58826	115685	50.85%	15.26%	74	101
14	桃園市八德區	2018-11-24T23:08:25+08:00	22761	48392	71153	4016	75169	149171	50.39%	15.26%	92	101
14	桃園市八德區	2018-11-24T23:55:38+08:00	24396	51908	76304	4332	80636	159622	50.52%	15.28%	98	101
14	桃園市八德區	2018-11-25T03:38:46+08:00	25238	53665	78903	4498	83401	165065	50.53%	15.29%	101	101
14	桃園市八德區	2018-11-25T03:32:25+08:00	25238	53665	78903	4498	83401	165065	50.53%	15.29%	101	101
14	桃園市八德區	2018-11-24T23:15:54+08:00	23369	49650	73019	4142	77161	152876	50.47%	15.29%	94	101
14	桃園市八德區	2018-11-24T22:40:19+08:00	19613	42094	61707	3533	65240	128438	50.79%	15.27%	81	101
14	桃園市八德區	2018-11-25T01:25:43+08:00	25238	53665	78903	4498	83401	165065	50.53%	15.29%	101	101
14	桃園市八德區	2018-11-24T23:59:59+08:00	24396	51908	76304	4332	80636	159622	50.52%	15.28%	98	101
14	桃園市八德區	2018-11-25T06:23:51+08:00	25238	53665	78903	4498	83401	165065	50.53%	15.29%	101	101
14	桃園市八德區	2018-11-24T22:54:17+08:00	20954	44633	65587	3737	69324	137158	50.54%	15.28%	86	101
14	桃園市八德區	2018-11-24T22:45:00+08:00	20059	42620	62679	3565	66244	130699	50.68%	15.35%	82	101
14	桃園市八德區	2018-11-24T23:01:21+08:00	22197	47178	69375	3872	73247	145263	50.42%	15.28%	90	101
14	桃園市八德區	2018-11-24T23:31:01+08:00	23915	50739	74654	4223	78877	156280	50.47%	15.3%	96	101
14	桃園市八德區	2018-11-25T00:09:23+08:00	25238	53665	78903	4498	83401	165065	50.53%	15.29%	101	101
14	桃園市八德區	2018-11-24T22:41:27+08:00	19613	42094	61707	3533	65240	128438	50.79%	15.27%	81	101
14	桃園市八德區	2018-11-25T01:12:33+08:00	25238	53665	78903	4498	83401	165065	50.53%	15.29%	101	101
14	桃園市八德區	2018-11-24T22:50:37+08:00	20497	43604	64101	3642	67743	133992	50.56%	15.3%	84	101
14	桃園市八德區	2018-11-25T00:14:00+08:00	25238	53665	78903	4498	83401	165065	50.53%	15.29%	101	101
14	桃園市八德區	2018-11-24T23:12:05+08:00	23051	49037	72088	4104	76192	151012	50.45%	15.26%	93	101
14	桃園市八德區	2018-11-24T23:39:04+08:00	24157	51323	75480	4271	79751	157887	50.51%	15.3%	97	101
14	桃園市八德區	2018-11-24T23:51:26+08:00	24396	51908	76304	4332	80636	159622	50.52%	15.28%	98	101
14	桃園市八德區	2018-11-25T06:18:49+08:00	25238	53665	78903	4498	83401	165065	50.53%	15.29%	101	101
14	桃園市八德區	2018-11-25T01:17:41+08:00	25238	53665	78903	4498	83401	165065	50.53%	15.29%	101	101
14	桃園市八德區	2018-11-24T22:23:03+08:00	16514	35402	51916	3050	54966	107776	51%	15.32%	70	101
14	桃園市八德區	2018-11-24T23:04:55+08:00	22761	48392	71153	4016	75169	149171	50.39%	15.26%	92	101
14	桃園市八德區	2018-11-24T23:19:40+08:00	23369	49650	73019	4142	77161	152876	50.47%	15.29%	94	101
14	桃園市八德區	2018-11-24T23:27:10+08:00	23915	50739	74654	4223	78877	156280	50.47%	15.3%	96	101
14	桃園市八德區	2018-11-24T22:36:52+08:00	19000	40824	59824	3433	63257	124589	50.77%	15.25%	79	101
14	桃園市八德區	2018-11-25T01:02:21+08:00	25238	53665	78903	4498	83401	165065	50.53%	15.29%	101	101
14	桃園市八德區	2018-11-25T03:49:43+08:00	25238	53665	78903	4498	83401	165065	50.53%	15.29%	101	101
14	桃園市八德區	2018-11-25T00:22:55+08:00	25238	53665	78903	4498	83401	165065	50.53%	15.29%	101	101
14	桃園市八德區	2018-11-25T03:56:01+08:00	25238	53665	78903	4498	83401	165065	50.53%	15.29%	101	101
14	桃園市八德區	2018-11-25T04:02:39+08:00	25238	53665	78903	4498	83401	165065	50.53%	15.29%	101	101
14	桃園市八德區	2018-11-25T06:13:44+08:00	25238	53665	78903	4498	83401	165065	50.53%	15.29%	101	101
14	桃園市八德區	2018-11-25T00:18:21+08:00	25238	53665	78903	4498	83401	165065	50.53%	15.29%	101	101
14	桃園市八德區	2018-11-24T22:33:29+08:00	18750	40281	59031	3377	62408	123084	50.7%	15.23%	78	101
14	桃園市八德區	2018-11-25T06:29:07+08:00	25238	53665	78903	4498	83401	165065	50.53%	15.29%	101	101
14	桃園市八德區	2018-11-24T23:43:08+08:00	24157	51323	75480	4271	79751	157887	50.51%	15.3%	97	101
14	臺中市	2018-11-24T23:47:19+08:00	374620	820467	1195087	67822	1262909	2170160	58.19%	17.26%	529	1
14	臺中市	2018-11-24T22:16:01+08:00	254208	560520	814728	47737	862465	1477411	58.38%	17.21%	095	1
14	臺中市	2018-11-25T01:07:17+08:00	393422	862207	1255629	70824	1326453	2282657	58.11%	17.24%	594	1
14	臺中市	2018-11-24T23:01:22+08:00	334181	733303	1067484	60859	1128343	1934190	58.34%	17.28%	386	1
14	臺中市	2018-11-25T06:08:42+08:00	395557	866827	1262384	71128	1333512	2295642	58.09%	17.23%	601	1
14	臺中市	2018-11-24T23:35:02+08:00	365951	803835	1169786	66598	1236384	2124578	58.19%	17.22%	500	1
14	臺中市	2018-11-24T23:12:06+08:00	344588	756245	1100833	62694	1163527	1996328	58.28%	17.26%	425	1
14	臺中市	2018-11-24T22:26:29+08:00	275320	606193	881513	51146	932659	1597980	58.36%	17.23%	171	1
14	臺中市	2018-11-25T03:44:12+08:00	395557	866827	1262384	71128	1333512	2295642	58.09%	17.23%	601	1
14	臺中市	2018-11-25T00:04:56+08:00	382203	837550	1219753	68984	1288737	2215879	58.16%	17.25%	555	1
14	臺中市	2018-11-24T22:19:28+08:00	259915	573205	833120	48768	881888	1511001	58.36%	17.2%	116	1
14	臺中市	2018-11-24T22:57:44+08:00	330955	726228	1057183	60385	1117568	1914787	58.37%	17.28%	374	1
14	臺中市	2018-11-25T00:57:27+08:00	393183	861672	1254855	70781	1325636	2281141	58.11%	17.24%	593	1
14	臺中市	2018-11-24T22:13:17+08:00	248487	547999	796486	46787	843273	1443933	58.4%	17.21%	074	1
14	臺中市	2018-11-24T23:23:30+08:00	356538	783179	1139717	65003	1204720	2068711	58.24%	17.23%	467	1
14	臺中市	2018-11-24T23:55:38+08:00	376905	825824	1202729	68147	1270876	2184001	58.19%	17.26%	537	1
14	臺中市	2018-11-24T22:40:20+08:00	305538	670337	975875	56092	1031967	1767367	58.39%	17.29%	281	1
14	臺中市	2018-11-24T23:15:54+08:00	349816	768068	1117884	63602	1181486	2027229	58.28%	17.26%	443	1
14	臺中市	2018-11-25T01:25:43+08:00	394032	863570	1257602	70915	1328517	2286569	58.1%	17.23%	596	1
14	臺中市	2018-11-24T23:59:59+08:00	378041	828386	1206427	68350	1274777	2191228	58.18%	17.25%	541	1
14	臺中市	2018-11-25T03:38:47+08:00	395557	866827	1262384	71128	1333512	2295642	58.09%	17.23%	601	1
14	臺中市	2018-11-24T22:54:18+08:00	324245	712093	1036338	59254	1095592	1877091	58.37%	17.27%	351	1
14	臺中市	2018-11-25T06:23:51+08:00	395557	866827	1262384	71128	1333512	2295642	58.09%	17.23%	601	1
14	臺中市	2018-11-24T22:45:00+08:00	310566	681492	992058	56851	1048909	1797032	58.37%	17.28%	300	1
14	臺中市	2018-11-24T23:31:01+08:00	363846	799229	1163075	66253	1229328	2111889	58.21%	17.23%	492	1
14	臺中市	2018-11-25T00:09:24+08:00	381922	836982	1218904	68930	1287834	2214492	58.15%	17.25%	554	1
14	臺中市	2018-11-24T22:41:27+08:00	305538	670337	975875	56092	1031967	1767367	58.39%	17.29%	281	1
14	臺中市	2018-11-25T01:12:33+08:00	393422	862207	1255629	70824	1326453	2282657	58.11%	17.24%	594	1
14	臺中市	2018-11-24T22:50:37+08:00	320946	704681	1025627	58679	1084306	1857403	58.38%	17.28%	338	1
14	臺中市	2018-11-25T00:14:00+08:00	385158	844183	1229341	69421	1298762	2233119	58.16%	17.25%	565	1
14	臺中市	2018-11-24T23:39:04+08:00	369999	812301	1182300	67239	1249539	2146679	58.21%	17.24%	514	1
14	臺中市	2018-11-24T23:51:26+08:00	375135	821674	1196809	67864	1264673	2173313	58.19%	17.26%	531	1
14	臺中市	2018-11-25T06:18:49+08:00	395557	866827	1262384	71128	1333512	2295642	58.09%	17.23%	601	1
14	臺中市	2018-11-25T01:17:41+08:00	393723	863004	1256727	70888	1327615	2284808	58.11%	17.23%	595	1
14	臺中市	2018-11-24T22:23:03+08:00	267981	590937	858918	50014	908932	1557107	58.37%	17.21%	145	1
14	臺中市	2018-11-24T22:29:56+08:00	283240	623756	906996	52306	959302	1644024	58.35%	17.23%	200	1
14	臺中市	2018-11-24T23:04:55+08:00	338442	742427	1080869	61560	1142429	1959309	58.31%	17.27%	401	1
14	臺中市	2018-11-24T23:19:40+08:00	352593	774297	1126890	64253	1191143	2044371	58.26%	17.25%	454	1
14	臺中市	2018-11-24T23:27:10+08:00	358586	787529	1146115	65287	1211402	2080193	58.24%	17.24%	474	1
14	臺中市	2018-11-24T23:08:26+08:00	342131	751161	1093292	62208	1155500	1982567	58.28%	17.26%	416	1
14	臺中市	2018-11-24T22:36:52+08:00	300219	659925	960144	55295	1015439	1739675	58.37%	17.26%	262	1
14	臺中市	2018-11-25T01:02:21+08:00	393422	862207	1255629	70824	1326453	2282657	58.11%	17.24%	594	1
14	臺中市	2018-11-25T03:32:26+08:00	395557	866827	1262384	71128	1333512	2295642	58.09%	17.23%	601	1
14	臺中市	2018-11-25T03:49:43+08:00	395557	866827	1262384	71128	1333512	2295642	58.09%	17.23%	601	1
14	臺中市	2018-11-25T00:22:55+08:00	388121	851350	1239471	69924	1309395	2252020	58.14%	17.23%	576	1
14	臺中市	2018-11-25T03:56:01+08:00	395557	866827	1262384	71128	1333512	2295642	58.09%	17.23%	601	1
14	臺中市	2018-11-25T04:02:39+08:00	395557	866827	1262384	71128	1333512	2295642	58.09%	17.23%	601	1
14	臺中市	2018-11-25T06:13:44+08:00	395557	866827	1262384	71128	1333512	2295642	58.09%	17.23%	601	1
14	臺中市	2018-11-25T00:18:21+08:00	386089	846186	1232275	69576	1301851	2238579	58.16%	17.25%	568	1
14	臺中市	2018-11-24T22:33:29+08:00	287569	633255	920824	53102	973926	1668635	58.37%	17.23%	216	1
14	臺中市	2018-11-25T06:29:07+08:00	395557	866827	1262384	71128	1333512	2295642	58.09%	17.23%	601	1
14	臺中市	2018-11-24T23:43:08+08:00	373486	818107	1191593	67616	1259209	2163576	58.2%	17.26%	525	1
14	臺中市東勢區	2018-11-24T23:47:19+08:00	5837	16919	22756	1767	24523	41553	59.02%	14.05%	38	39
14	臺中市東勢區	2018-11-24T22:16:01+08:00	5499	15885	21384	1674	23058	38908	59.26%	14.13%	36	39
14	臺中市東勢區	2018-11-24T23:01:22+08:00	5837	16919	22756	1767	24523	41553	59.02%	14.05%	38	39
14	臺中市東勢區	2018-11-24T23:35:02+08:00	5837	16919	22756	1767	24523	41553	59.02%	14.05%	38	39
14	臺中市東勢區	2018-11-24T23:12:06+08:00	5837	16919	22756	1767	24523	41553	59.02%	14.05%	38	39
14	臺中市東勢區	2018-11-25T01:07:18+08:00	6038	17546	23584	1865	25449	43181	58.94%	13.98%	39	39
14	臺中市東勢區	2018-11-25T06:08:43+08:00	6038	17546	23584	1865	25449	43181	58.94%	13.98%	39	39
14	臺中市東勢區	2018-11-24T22:26:29+08:00	5684	16482	22166	1721	23887	40339	59.22%	14.09%	37	39
14	臺中市東勢區	2018-11-25T03:44:12+08:00	6038	17546	23584	1865	25449	43181	58.94%	13.98%	39	39
14	臺中市東勢區	2018-11-24T22:19:29+08:00	5684	16482	22166	1721	23887	40339	59.22%	14.09%	37	39
14	臺中市東勢區	2018-11-25T00:57:28+08:00	6038	17546	23584	1865	25449	43181	58.94%	13.98%	39	39
14	臺中市東勢區	2018-11-25T00:04:56+08:00	6038	17546	23584	1865	25449	43181	58.94%	13.98%	39	39
14	臺中市東勢區	2018-11-24T22:57:44+08:00	5837	16919	22756	1767	24523	41553	59.02%	14.05%	38	39
14	臺中市東勢區	2018-11-24T22:13:17+08:00	5499	15885	21384	1674	23058	38908	59.26%	14.13%	36	39
14	臺中市東勢區	2018-11-24T23:23:30+08:00	5837	16919	22756	1767	24523	41553	59.02%	14.05%	38	39
14	臺中市東勢區	2018-11-24T23:04:56+08:00	5837	16919	22756	1767	24523	41553	59.02%	14.05%	38	39
14	臺中市東勢區	2018-11-24T22:40:20+08:00	5837	16919	22756	1767	24523	41553	59.02%	14.05%	38	39
14	臺中市東勢區	2018-11-24T23:15:54+08:00	5837	16919	22756	1767	24523	41553	59.02%	14.05%	38	39
14	臺中市東勢區	2018-11-25T01:25:43+08:00	6038	17546	23584	1865	25449	43181	58.94%	13.98%	39	39
14	臺中市東勢區	2018-11-24T23:59:59+08:00	5837	16919	22756	1767	24523	41553	59.02%	14.05%	38	39
14	臺中市東勢區	2018-11-25T01:02:22+08:00	6038	17546	23584	1865	25449	43181	58.94%	13.98%	39	39
14	臺中市東勢區	2018-11-25T03:38:47+08:00	6038	17546	23584	1865	25449	43181	58.94%	13.98%	39	39
14	臺中市東勢區	2018-11-24T23:55:39+08:00	5837	16919	22756	1767	24523	41553	59.02%	14.05%	38	39
14	臺中市東勢區	2018-11-24T22:54:18+08:00	5837	16919	22756	1767	24523	41553	59.02%	14.05%	38	39
14	臺中市東勢區	2018-11-25T03:56:02+08:00	6038	17546	23584	1865	25449	43181	58.94%	13.98%	39	39
14	臺中市東勢區	2018-11-24T22:45:00+08:00	5837	16919	22756	1767	24523	41553	59.02%	14.05%	38	39
14	臺中市東勢區	2018-11-24T23:39:05+08:00	5837	16919	22756	1767	24523	41553	59.02%	14.05%	38	39
14	臺中市東勢區	2018-11-24T23:31:01+08:00	5837	16919	22756	1767	24523	41553	59.02%	14.05%	38	39
14	臺中市東勢區	2018-11-25T00:09:24+08:00	6038	17546	23584	1865	25449	43181	58.94%	13.98%	39	39
14	臺中市東勢區	2018-11-24T22:41:27+08:00	5837	16919	22756	1767	24523	41553	59.02%	14.05%	38	39
14	臺中市東勢區	2018-11-25T04:02:40+08:00	6038	17546	23584	1865	25449	43181	58.94%	13.98%	39	39
14	臺中市東勢區	2018-11-25T01:12:33+08:00	6038	17546	23584	1865	25449	43181	58.94%	13.98%	39	39
14	臺中市東勢區	2018-11-25T00:14:01+08:00	6038	17546	23584	1865	25449	43181	58.94%	13.98%	39	39
14	臺中市東勢區	2018-11-24T22:50:38+08:00	5837	16919	22756	1767	24523	41553	59.02%	14.05%	38	39
14	臺中市東勢區	2018-11-24T23:51:26+08:00	5837	16919	22756	1767	24523	41553	59.02%	14.05%	38	39
14	臺中市東勢區	2018-11-25T06:18:49+08:00	6038	17546	23584	1865	25449	43181	58.94%	13.98%	39	39
14	臺中市東勢區	2018-11-25T01:17:41+08:00	6038	17546	23584	1865	25449	43181	58.94%	13.98%	39	39
14	臺中市東勢區	2018-11-24T22:23:03+08:00	5684	16482	22166	1721	23887	40339	59.22%	14.09%	37	39
14	臺中市東勢區	2018-11-24T22:29:56+08:00	5684	16482	22166	1721	23887	40339	59.22%	14.09%	37	39
14	臺中市東勢區	2018-11-24T23:19:40+08:00	5837	16919	22756	1767	24523	41553	59.02%	14.05%	38	39
14	臺中市東勢區	2018-11-24T22:36:53+08:00	5837	16919	22756	1767	24523	41553	59.02%	14.05%	38	39
14	臺中市東勢區	2018-11-24T23:27:10+08:00	5837	16919	22756	1767	24523	41553	59.02%	14.05%	38	39
14	臺中市東勢區	2018-11-24T23:08:26+08:00	5837	16919	22756	1767	24523	41553	59.02%	14.05%	38	39
14	臺中市東勢區	2018-11-25T03:32:26+08:00	6038	17546	23584	1865	25449	43181	58.94%	13.98%	39	39
14	臺中市東勢區	2018-11-25T03:49:43+08:00	6038	17546	23584	1865	25449	43181	58.94%	13.98%	39	39
14	臺中市東勢區	2018-11-25T06:29:08+08:00	6038	17546	23584	1865	25449	43181	58.94%	13.98%	39	39
14	臺中市東勢區	2018-11-25T00:22:55+08:00	6038	17546	23584	1865	25449	43181	58.94%	13.98%	39	39
14	臺中市東勢區	2018-11-25T06:13:44+08:00	6038	17546	23584	1865	25449	43181	58.94%	13.98%	39	39
14	臺中市東勢區	2018-11-25T00:18:21+08:00	6038	17546	23584	1865	25449	43181	58.94%	13.98%	39	39
14	臺中市東勢區	2018-11-25T06:23:52+08:00	6038	17546	23584	1865	25449	43181	58.94%	13.98%	39	39
14	臺中市東勢區	2018-11-24T23:43:09+08:00	5837	16919	22756	1767	24523	41553	59.02%	14.05%	38	39
14	臺中市東勢區	2018-11-24T22:33:29+08:00	5684	16482	22166	1721	23887	40339	59.22%	14.09%	37	39
14	新竹縣芎林鄉	2018-11-25T04:02:43+08:00	2767	6855	9622	571	10193	17293	58.94%	16%	19	19
14	新竹縣芎林鄉	2018-11-25T01:12:37+08:00	2767	6855	9622	571	10193	17293	58.94%	16%	19	19
14	新竹縣芎林鄉	2018-11-25T00:14:04+08:00	2767	6855	9622	571	10193	17293	58.94%	16%	19	19
14	新竹縣芎林鄉	2018-11-24T23:31:05+08:00	2399	5998	8397	516	8913	14845	60.04%	16.16%	17	19
14	新竹縣芎林鄉	2018-11-25T01:07:21+08:00	2767	6855	9622	571	10193	17293	58.94%	16%	19	19
14	新竹縣芎林鄉	2018-11-24T23:35:05+08:00	2560	6411	8971	540	9511	15939	59.67%	16.06%	18	19
14	新竹縣芎林鄉	2018-11-25T06:29:11+08:00	2767	6855	9622	571	10193	17293	58.94%	16%	19	19
14	新竹縣芎林鄉	2018-11-24T23:39:09+08:00	2560	6411	8971	540	9511	15939	59.67%	16.06%	18	19
14	新竹縣芎林鄉	2018-11-25T00:09:28+08:00	2767	6855	9622	571	10193	17293	58.94%	16%	19	19
14	新竹縣芎林鄉	2018-11-24T22:23:07+08:00	1665	4194	5859	377	6236	10375	60.11%	16.05%	12	19
14	新竹縣芎林鄉	2018-11-25T00:00:03+08:00	2560	6411	8971	540	9511	15939	59.67%	16.06%	18	19
14	新竹縣芎林鄉	2018-11-24T23:08:30+08:00	2225	5489	7714	477	8191	13533	60.53%	16.44%	16	19
14	新竹縣芎林鄉	2018-11-24T23:19:44+08:00	2225	5489	7714	477	8191	13533	60.53%	16.44%	16	19
14	新竹縣芎林鄉	2018-11-24T22:13:21+08:00	1665	4194	5859	377	6236	10375	60.11%	16.05%	12	19
14	新竹縣芎林鄉	2018-11-25T03:32:30+08:00	2767	6855	9622	571	10193	17293	58.94%	16%	19	19
14	新竹縣芎林鄉	2018-11-24T23:51:30+08:00	2560	6411	8971	540	9511	15939	59.67%	16.06%	18	19
14	新竹縣芎林鄉	2018-11-24T22:30:01+08:00	1665	4194	5859	377	6236	10375	60.11%	16.05%	12	19
14	新竹縣芎林鄉	2018-11-24T23:27:14+08:00	2399	5998	8397	516	8913	14845	60.04%	16.16%	17	19
14	新竹縣芎林鄉	2018-11-24T22:19:32+08:00	1665	4194	5859	377	6236	10375	60.11%	16.05%	12	19
14	新竹縣芎林鄉	2018-11-24T22:36:56+08:00	1894	4840	6734	417	7151	11921	59.99%	15.89%	14	19
14	新竹縣芎林鄉	2018-11-25T01:02:25+08:00	2767	6855	9622	571	10193	17293	58.94%	16%	19	19
14	新竹縣芎林鄉	2018-11-25T06:13:47+08:00	2767	6855	9622	571	10193	17293	58.94%	16%	19	19
14	新竹縣芎林鄉	2018-11-25T00:18:25+08:00	2767	6855	9622	571	10193	17293	58.94%	16%	19	19
14	新竹縣芎林鄉	2018-11-24T23:05:00+08:00	2225	5489	7714	477	8191	13533	60.53%	16.44%	16	19
14	新竹縣芎林鄉	2018-11-24T22:26:32+08:00	1665	4194	5859	377	6236	10375	60.11%	16.05%	12	19
14	新竹縣芎林鄉	2018-11-24T22:50:42+08:00	2126	5226	7352	458	7810	12999	60.08%	16.36%	15	19
14	新竹縣芎林鄉	2018-11-24T22:54:21+08:00	2126	5226	7352	458	7810	12999	60.08%	16.36%	15	19
14	新竹縣芎林鄉	2018-11-25T00:05:00+08:00	2560	6411	8971	540	9511	15939	59.67%	16.06%	18	19
14	新竹縣芎林鄉	2018-11-24T22:41:30+08:00	1894	4840	6734	417	7151	11921	59.99%	15.89%	14	19
14	新竹縣芎林鄉	2018-11-25T00:22:59+08:00	2767	6855	9622	571	10193	17293	58.94%	16%	19	19
14	新竹縣芎林鄉	2018-11-25T03:49:46+08:00	2767	6855	9622	571	10193	17293	58.94%	16%	19	19
14	新竹縣芎林鄉	2018-11-24T22:16:05+08:00	1665	4194	5859	377	6236	10375	60.11%	16.05%	12	19
14	新竹縣芎林鄉	2018-11-24T23:01:26+08:00	2126	5226	7352	458	7810	12999	60.08%	16.36%	15	19
14	新竹縣芎林鄉	2018-11-24T23:43:12+08:00	2560	6411	8971	540	9511	15939	59.67%	16.06%	18	19
14	新竹縣芎林鄉	2018-11-24T22:33:33+08:00	1833	4673	6506	403	6909	11504	60.06%	15.93%	13	19
14	新竹縣芎林鄉	2018-11-25T06:08:47+08:00	2767	6855	9622	571	10193	17293	58.94%	16%	19	19
14	新竹縣芎林鄉	2018-11-24T23:47:23+08:00	2560	6411	8971	540	9511	15939	59.67%	16.06%	18	19
14	新竹縣芎林鄉	2018-11-24T23:55:42+08:00	2560	6411	8971	540	9511	15939	59.67%	16.06%	18	19
14	新竹縣芎林鄉	2018-11-25T01:17:46+08:00	2767	6855	9622	571	10193	17293	58.94%	16%	19	19
14	新竹縣芎林鄉	2018-11-24T22:57:48+08:00	2126	5226	7352	458	7810	12999	60.08%	16.36%	15	19
14	新竹縣芎林鄉	2018-11-25T03:38:50+08:00	2767	6855	9622	571	10193	17293	58.94%	16%	19	19
14	新竹縣芎林鄉	2018-11-24T23:23:33+08:00	2225	5489	7714	477	8191	13533	60.53%	16.44%	16	19
14	新竹縣芎林鄉	2018-11-25T03:44:17+08:00	2767	6855	9622	571	10193	17293	58.94%	16%	19	19
14	新竹縣芎林鄉	2018-11-24T22:40:23+08:00	1894	4840	6734	417	7151	11921	59.99%	15.89%	14	19
14	新竹縣芎林鄉	2018-11-25T06:18:52+08:00	2767	6855	9622	571	10193	17293	58.94%	16%	19	19
14	新竹縣芎林鄉	2018-11-24T23:15:58+08:00	2225	5489	7714	477	8191	13533	60.53%	16.44%	16	19
14	新竹縣芎林鄉	2018-11-25T00:57:31+08:00	2767	6855	9622	571	10193	17293	58.94%	16%	19	19
14	新竹縣芎林鄉	2018-11-25T01:25:47+08:00	2767	6855	9622	571	10193	17293	58.94%	16%	19	19
14	新竹縣芎林鄉	2018-11-25T03:56:06+08:00	2767	6855	9622	571	10193	17293	58.94%	16%	19	19
14	新竹縣芎林鄉	2018-11-25T06:23:55+08:00	2767	6855	9622	571	10193	17293	58.94%	16%	19	19
14	新竹縣芎林鄉	2018-11-24T22:45:04+08:00	1894	4840	6734	417	7151	11921	59.99%	15.89%	14	19
14	新竹縣芎林鄉	2018-11-24T23:12:10+08:00	2225	5489	7714	477	8191	13533	60.53%	16.44%	16	19
14	苗栗縣大湖鄉	2018-11-25T04:02:44+08:00	1679	4573	6252	513	6765	12653	53.47%	13.27%	15	15
14	苗栗縣大湖鄉	2018-11-25T00:09:29+08:00	1679	4573	6252	513	6765	12653	53.47%	13.27%	15	15
14	苗栗縣大湖鄉	2018-11-25T01:12:38+08:00	1679	4573	6252	513	6765	12653	53.47%	13.27%	15	15
14	苗栗縣大湖鄉	2018-11-25T00:14:05+08:00	1679	4573	6252	513	6765	12653	53.47%	13.27%	15	15
14	苗栗縣大湖鄉	2018-11-24T23:19:45+08:00	1679	4573	6252	513	6765	12653	53.47%	13.27%	15	15
14	苗栗縣大湖鄉	2018-11-25T00:00:03+08:00	1679	4573	6252	513	6765	12653	53.47%	13.27%	15	15
14	苗栗縣大湖鄉	2018-11-24T22:23:08+08:00	1679	4573	6252	513	6765	12653	53.47%	13.27%	15	15
14	苗栗縣大湖鄉	2018-11-24T23:08:31+08:00	1679	4573	6252	513	6765	12653	53.47%	13.27%	15	15
14	苗栗縣大湖鄉	2018-11-25T03:32:30+08:00	1679	4573	6252	513	6765	12653	53.47%	13.27%	15	15
14	苗栗縣大湖鄉	2018-11-24T23:51:30+08:00	1679	4573	6252	513	6765	12653	53.47%	13.27%	15	15
14	苗栗縣大湖鄉	2018-11-24T22:30:01+08:00	1679	4573	6252	513	6765	12653	53.47%	13.27%	15	15
14	苗栗縣大湖鄉	2018-11-24T23:27:14+08:00	1679	4573	6252	513	6765	12653	53.47%	13.27%	15	15
14	苗栗縣大湖鄉	2018-11-24T22:19:33+08:00	1679	4573	6252	513	6765	12653	53.47%	13.27%	15	15
14	苗栗縣大湖鄉	2018-11-25T00:57:32+08:00	1679	4573	6252	513	6765	12653	53.47%	13.27%	15	15
14	苗栗縣大湖鄉	2018-11-24T22:36:56+08:00	1679	4573	6252	513	6765	12653	53.47%	13.27%	15	15
14	苗栗縣大湖鄉	2018-11-24T22:50:43+08:00	1679	4573	6252	513	6765	12653	53.47%	13.27%	15	15
14	苗栗縣大湖鄉	2018-11-25T00:18:25+08:00	1679	4573	6252	513	6765	12653	53.47%	13.27%	15	15
14	苗栗縣大湖鄉	2018-11-25T06:23:56+08:00	1679	4573	6252	513	6765	12653	53.47%	13.27%	15	15
14	苗栗縣大湖鄉	2018-11-24T22:26:33+08:00	1679	4573	6252	513	6765	12653	53.47%	13.27%	15	15
14	苗栗縣大湖鄉	2018-11-24T23:05:00+08:00	1679	4573	6252	513	6765	12653	53.47%	13.27%	15	15
14	苗栗縣大湖鄉	2018-11-25T03:49:47+08:00	1679	4573	6252	513	6765	12653	53.47%	13.27%	15	15
14	苗栗縣大湖鄉	2018-11-24T22:41:31+08:00	1679	4573	6252	513	6765	12653	53.47%	13.27%	15	15
14	苗栗縣大湖鄉	2018-11-25T06:13:48+08:00	1679	4573	6252	513	6765	12653	53.47%	13.27%	15	15
14	苗栗縣大湖鄉	2018-11-25T00:05:00+08:00	1679	4573	6252	513	6765	12653	53.47%	13.27%	15	15
14	苗栗縣大湖鄉	2018-11-25T00:22:59+08:00	1679	4573	6252	513	6765	12653	53.47%	13.27%	15	15
14	苗栗縣大湖鄉	2018-11-24T23:31:06+08:00	1679	4573	6252	513	6765	12653	53.47%	13.27%	15	15
14	苗栗縣大湖鄉	2018-11-24T22:16:05+08:00	1679	4573	6252	513	6765	12653	53.47%	13.27%	15	15
14	苗栗縣大湖鄉	2018-11-25T01:07:22+08:00	1679	4573	6252	513	6765	12653	53.47%	13.27%	15	15
14	苗栗縣大湖鄉	2018-11-24T22:33:33+08:00	1679	4573	6252	513	6765	12653	53.47%	13.27%	15	15
14	苗栗縣大湖鄉	2018-11-24T23:43:13+08:00	1679	4573	6252	513	6765	12653	53.47%	13.27%	15	15
14	苗栗縣大湖鄉	2018-11-25T06:08:47+08:00	1679	4573	6252	513	6765	12653	53.47%	13.27%	15	15
14	苗栗縣大湖鄉	2018-11-24T23:01:27+08:00	1679	4573	6252	513	6765	12653	53.47%	13.27%	15	15
14	苗栗縣大湖鄉	2018-11-24T23:35:06+08:00	1679	4573	6252	513	6765	12653	53.47%	13.27%	15	15
14	苗栗縣大湖鄉	2018-11-24T23:47:23+08:00	1679	4573	6252	513	6765	12653	53.47%	13.27%	15	15
14	苗栗縣大湖鄉	2018-11-25T06:29:12+08:00	1679	4573	6252	513	6765	12653	53.47%	13.27%	15	15
14	苗栗縣大湖鄉	2018-11-24T23:55:42+08:00	1679	4573	6252	513	6765	12653	53.47%	13.27%	15	15
14	苗栗縣大湖鄉	2018-11-25T01:17:46+08:00	1679	4573	6252	513	6765	12653	53.47%	13.27%	15	15
14	苗栗縣大湖鄉	2018-11-24T22:57:48+08:00	1679	4573	6252	513	6765	12653	53.47%	13.27%	15	15
14	苗栗縣大湖鄉	2018-11-24T23:23:34+08:00	1679	4573	6252	513	6765	12653	53.47%	13.27%	15	15
14	苗栗縣大湖鄉	2018-11-25T03:38:51+08:00	1679	4573	6252	513	6765	12653	53.47%	13.27%	15	15
14	苗栗縣大湖鄉	2018-11-24T22:13:22+08:00	1679	4573	6252	513	6765	12653	53.47%	13.27%	15	15
14	苗栗縣大湖鄉	2018-11-25T03:44:17+08:00	1679	4573	6252	513	6765	12653	53.47%	13.27%	15	15
14	苗栗縣大湖鄉	2018-11-25T01:25:48+08:00	1679	4573	6252	513	6765	12653	53.47%	13.27%	15	15
14	苗栗縣大湖鄉	2018-11-24T22:40:24+08:00	1679	4573	6252	513	6765	12653	53.47%	13.27%	15	15
14	苗栗縣大湖鄉	2018-11-24T23:15:58+08:00	1679	4573	6252	513	6765	12653	53.47%	13.27%	15	15
14	苗栗縣大湖鄉	2018-11-25T01:02:26+08:00	1679	4573	6252	513	6765	12653	53.47%	13.27%	15	15
14	苗栗縣大湖鄉	2018-11-25T06:18:53+08:00	1679	4573	6252	513	6765	12653	53.47%	13.27%	15	15
14	苗栗縣大湖鄉	2018-11-24T23:12:11+08:00	1679	4573	6252	513	6765	12653	53.47%	13.27%	15	15
14	苗栗縣大湖鄉	2018-11-24T23:39:10+08:00	1679	4573	6252	513	6765	12653	53.47%	13.27%	15	15
14	苗栗縣大湖鄉	2018-11-25T03:56:07+08:00	1679	4573	6252	513	6765	12653	53.47%	13.27%	15	15
14	苗栗縣大湖鄉	2018-11-24T22:45:04+08:00	1679	4573	6252	513	6765	12653	53.47%	13.27%	15	15
14	苗栗縣大湖鄉	2018-11-24T22:54:22+08:00	1679	4573	6252	513	6765	12653	53.47%	13.27%	15	15
14	基隆市仁愛區	2018-11-24T22:33:39+08:00	6151	12100	18251	1309	19560	36738	53.24%	16.74%	35	35
14	基隆市仁愛區	2018-11-24T23:43:18+08:00	6151	12100	18251	1309	19560	36738	53.24%	16.74%	35	35
14	基隆市仁愛區	2018-11-25T01:07:28+08:00	6151	12100	18251	1309	19560	36738	53.24%	16.74%	35	35
14	基隆市仁愛區	2018-11-25T06:29:18+08:00	6151	12100	18251	1309	19560	36738	53.24%	16.74%	35	35
14	基隆市仁愛區	2018-11-25T03:49:53+08:00	6151	12100	18251	1309	19560	36738	53.24%	16.74%	35	35
14	基隆市仁愛區	2018-11-24T22:50:50+08:00	6151	12100	18251	1309	19560	36738	53.24%	16.74%	35	35
14	基隆市仁愛區	2018-11-25T06:13:54+08:00	6151	12100	18251	1309	19560	36738	53.24%	16.74%	35	35
14	基隆市仁愛區	2018-11-24T22:13:29+08:00	5785	11408	17193	1235	18428	34584	53.28%	16.73%	33	35
14	基隆市仁愛區	2018-11-25T03:32:36+08:00	6151	12100	18251	1309	19560	36738	53.24%	16.74%	35	35
14	基隆市仁愛區	2018-11-24T23:55:48+08:00	6151	12100	18251	1309	19560	36738	53.24%	16.74%	35	35
14	基隆市仁愛區	2018-11-25T03:44:25+08:00	6151	12100	18251	1309	19560	36738	53.24%	16.74%	35	35
14	基隆市仁愛區	2018-11-24T23:08:38+08:00	6151	12100	18251	1309	19560	36738	53.24%	16.74%	35	35
14	基隆市仁愛區	2018-11-25T06:24:02+08:00	6151	12100	18251	1309	19560	36738	53.24%	16.74%	35	35
14	基隆市仁愛區	2018-11-24T23:51:37+08:00	6151	12100	18251	1309	19560	36738	53.24%	16.74%	35	35
14	基隆市仁愛區	2018-11-24T22:23:15+08:00	6151	12100	18251	1309	19560	36738	53.24%	16.74%	35	35
14	基隆市仁愛區	2018-11-24T22:40:29+08:00	6151	12100	18251	1309	19560	36738	53.24%	16.74%	35	35
14	基隆市仁愛區	2018-11-25T06:18:59+08:00	6151	12100	18251	1309	19560	36738	53.24%	16.74%	35	35
14	基隆市仁愛區	2018-11-24T23:23:40+08:00	6151	12100	18251	1309	19560	36738	53.24%	16.74%	35	35
14	基隆市仁愛區	2018-11-24T22:54:27+08:00	6151	12100	18251	1309	19560	36738	53.24%	16.74%	35	35
14	基隆市仁愛區	2018-11-25T00:14:11+08:00	6151	12100	18251	1309	19560	36738	53.24%	16.74%	35	35
14	基隆市仁愛區	2018-11-25T00:05:06+08:00	6151	12100	18251	1309	19560	36738	53.24%	16.74%	35	35
14	基隆市仁愛區	2018-11-24T22:16:12+08:00	6151	12100	18251	1309	19560	36738	53.24%	16.74%	35	35
14	基隆市仁愛區	2018-11-24T22:41:37+08:00	6151	12100	18251	1309	19560	36738	53.24%	16.74%	35	35
14	基隆市仁愛區	2018-11-24T23:05:06+08:00	6151	12100	18251	1309	19560	36738	53.24%	16.74%	35	35
14	基隆市仁愛區	2018-11-24T22:45:10+08:00	6151	12100	18251	1309	19560	36738	53.24%	16.74%	35	35
14	基隆市仁愛區	2018-11-25T03:56:14+08:00	6151	12100	18251	1309	19560	36738	53.24%	16.74%	35	35
14	基隆市仁愛區	2018-11-24T22:37:02+08:00	6151	12100	18251	1309	19560	36738	53.24%	16.74%	35	35
14	基隆市仁愛區	2018-11-25T00:18:32+08:00	6151	12100	18251	1309	19560	36738	53.24%	16.74%	35	35
14	基隆市仁愛區	2018-11-24T23:16:04+08:00	6151	12100	18251	1309	19560	36738	53.24%	16.74%	35	35
14	基隆市仁愛區	2018-11-25T00:23:05+08:00	6151	12100	18251	1309	19560	36738	53.24%	16.74%	35	35
14	基隆市仁愛區	2018-11-25T01:25:54+08:00	6151	12100	18251	1309	19560	36738	53.24%	16.74%	35	35
14	基隆市仁愛區	2018-11-24T22:30:11+08:00	6151	12100	18251	1309	19560	36738	53.24%	16.74%	35	35
14	基隆市仁愛區	2018-11-25T03:38:56+08:00	6151	12100	18251	1309	19560	36738	53.24%	16.74%	35	35
14	基隆市仁愛區	2018-11-25T01:02:33+08:00	6151	12100	18251	1309	19560	36738	53.24%	16.74%	35	35
14	基隆市仁愛區	2018-11-24T22:19:38+08:00	6151	12100	18251	1309	19560	36738	53.24%	16.74%	35	35
14	基隆市仁愛區	2018-11-24T23:19:53+08:00	6151	12100	18251	1309	19560	36738	53.24%	16.74%	35	35
14	基隆市仁愛區	2018-11-25T01:17:54+08:00	6151	12100	18251	1309	19560	36738	53.24%	16.74%	35	35
14	基隆市仁愛區	2018-11-25T00:00:12+08:00	6151	12100	18251	1309	19560	36738	53.24%	16.74%	35	35
14	基隆市仁愛區	2018-11-24T22:57:55+08:00	6151	12100	18251	1309	19560	36738	53.24%	16.74%	35	35
14	基隆市仁愛區	2018-11-24T23:27:20+08:00	6151	12100	18251	1309	19560	36738	53.24%	16.74%	35	35
14	基隆市仁愛區	2018-11-25T00:57:38+08:00	6151	12100	18251	1309	19560	36738	53.24%	16.74%	35	35
14	基隆市仁愛區	2018-11-24T23:35:12+08:00	6151	12100	18251	1309	19560	36738	53.24%	16.74%	35	35
14	基隆市仁愛區	2018-11-24T23:47:30+08:00	6151	12100	18251	1309	19560	36738	53.24%	16.74%	35	35
14	基隆市仁愛區	2018-11-25T00:09:36+08:00	6151	12100	18251	1309	19560	36738	53.24%	16.74%	35	35
14	基隆市仁愛區	2018-11-24T23:01:33+08:00	6151	12100	18251	1309	19560	36738	53.24%	16.74%	35	35
14	基隆市仁愛區	2018-11-24T23:31:13+08:00	6151	12100	18251	1309	19560	36738	53.24%	16.74%	35	35
14	基隆市仁愛區	2018-11-25T04:02:54+08:00	6151	12100	18251	1309	19560	36738	53.24%	16.74%	35	35
14	基隆市仁愛區	2018-11-25T01:12:45+08:00	6151	12100	18251	1309	19560	36738	53.24%	16.74%	35	35
14	基隆市仁愛區	2018-11-24T22:26:38+08:00	6151	12100	18251	1309	19560	36738	53.24%	16.74%	35	35
14	基隆市仁愛區	2018-11-24T23:12:17+08:00	6151	12100	18251	1309	19560	36738	53.24%	16.74%	35	35
14	基隆市仁愛區	2018-11-24T23:39:18+08:00	6151	12100	18251	1309	19560	36738	53.24%	16.74%	35	35
14	基隆市仁愛區	2018-11-25T06:08:55+08:00	6151	12100	18251	1309	19560	36738	53.24%	16.74%	35	35
14	苗栗縣泰安鄉	2018-11-25T04:02:44+08:00	727	2542	3269	200	3469	5180	66.97%	14.03%	10	10
14	苗栗縣泰安鄉	2018-11-25T00:09:29+08:00	727	2542	3269	200	3469	5180	66.97%	14.03%	10	10
14	苗栗縣泰安鄉	2018-11-24T22:16:06+08:00	655	2169	2824	195	3019	4591	65.76%	14.27%	9	10
14	苗栗縣泰安鄉	2018-11-25T01:12:38+08:00	727	2542	3269	200	3469	5180	66.97%	14.03%	10	10
14	苗栗縣泰安鄉	2018-11-25T00:14:05+08:00	727	2542	3269	200	3469	5180	66.97%	14.03%	10	10
14	苗栗縣泰安鄉	2018-11-25T00:00:03+08:00	727	2542	3269	200	3469	5180	66.97%	14.03%	10	10
14	苗栗縣泰安鄉	2018-11-24T22:23:08+08:00	655	2169	2824	195	3019	4591	65.76%	14.27%	9	10
14	苗栗縣泰安鄉	2018-11-25T00:23:00+08:00	727	2542	3269	200	3469	5180	66.97%	14.03%	10	10
14	苗栗縣泰安鄉	2018-11-24T23:08:31+08:00	727	2542	3269	200	3469	5180	66.97%	14.03%	10	10
14	苗栗縣泰安鄉	2018-11-25T03:32:30+08:00	727	2542	3269	200	3469	5180	66.97%	14.03%	10	10
14	苗栗縣泰安鄉	2018-11-24T23:27:14+08:00	727	2542	3269	200	3469	5180	66.97%	14.03%	10	10
14	苗栗縣泰安鄉	2018-11-24T23:51:31+08:00	727	2542	3269	200	3469	5180	66.97%	14.03%	10	10
14	苗栗縣泰安鄉	2018-11-24T22:19:33+08:00	655	2169	2824	195	3019	4591	65.76%	14.27%	9	10
14	苗栗縣泰安鄉	2018-11-25T00:57:32+08:00	727	2542	3269	200	3469	5180	66.97%	14.03%	10	10
14	苗栗縣泰安鄉	2018-11-24T22:36:56+08:00	655	2169	2824	195	3019	4591	65.76%	14.27%	9	10
14	苗栗縣泰安鄉	2018-11-24T22:50:43+08:00	655	2169	2824	195	3019	4591	65.76%	14.27%	9	10
14	苗栗縣泰安鄉	2018-11-25T06:23:56+08:00	727	2542	3269	200	3469	5180	66.97%	14.03%	10	10
14	苗栗縣泰安鄉	2018-11-24T22:26:33+08:00	655	2169	2824	195	3019	4591	65.76%	14.27%	9	10
14	苗栗縣泰安鄉	2018-11-25T03:49:47+08:00	727	2542	3269	200	3469	5180	66.97%	14.03%	10	10
14	苗栗縣泰安鄉	2018-11-24T22:41:31+08:00	655	2169	2824	195	3019	4591	65.76%	14.27%	9	10
14	苗栗縣泰安鄉	2018-11-25T00:05:01+08:00	727	2542	3269	200	3469	5180	66.97%	14.03%	10	10
14	苗栗縣泰安鄉	2018-11-25T06:13:48+08:00	727	2542	3269	200	3469	5180	66.97%	14.03%	10	10
14	苗栗縣泰安鄉	2018-11-24T23:05:01+08:00	727	2542	3269	200	3469	5180	66.97%	14.03%	10	10
14	苗栗縣泰安鄉	2018-11-24T23:31:06+08:00	727	2542	3269	200	3469	5180	66.97%	14.03%	10	10
14	苗栗縣泰安鄉	2018-11-25T06:08:48+08:00	727	2542	3269	200	3469	5180	66.97%	14.03%	10	10
14	苗栗縣泰安鄉	2018-11-25T01:07:22+08:00	727	2542	3269	200	3469	5180	66.97%	14.03%	10	10
14	苗栗縣泰安鄉	2018-11-24T22:33:33+08:00	655	2169	2824	195	3019	4591	65.76%	14.27%	9	10
14	苗栗縣泰安鄉	2018-11-24T23:43:13+08:00	727	2542	3269	200	3469	5180	66.97%	14.03%	10	10
14	苗栗縣泰安鄉	2018-11-24T23:01:27+08:00	727	2542	3269	200	3469	5180	66.97%	14.03%	10	10
14	苗栗縣泰安鄉	2018-11-24T23:35:06+08:00	727	2542	3269	200	3469	5180	66.97%	14.03%	10	10
14	苗栗縣泰安鄉	2018-11-25T06:29:12+08:00	727	2542	3269	200	3469	5180	66.97%	14.03%	10	10
14	苗栗縣泰安鄉	2018-11-24T23:47:24+08:00	727	2542	3269	200	3469	5180	66.97%	14.03%	10	10
14	苗栗縣泰安鄉	2018-11-24T23:19:46+08:00	727	2542	3269	200	3469	5180	66.97%	14.03%	10	10
14	苗栗縣泰安鄉	2018-11-25T03:44:18+08:00	727	2542	3269	200	3469	5180	66.97%	14.03%	10	10
14	苗栗縣泰安鄉	2018-11-24T23:23:34+08:00	727	2542	3269	200	3469	5180	66.97%	14.03%	10	10
14	苗栗縣泰安鄉	2018-11-24T23:55:43+08:00	727	2542	3269	200	3469	5180	66.97%	14.03%	10	10
14	苗栗縣泰安鄉	2018-11-25T03:38:51+08:00	727	2542	3269	200	3469	5180	66.97%	14.03%	10	10
14	苗栗縣泰安鄉	2018-11-24T22:57:49+08:00	727	2542	3269	200	3469	5180	66.97%	14.03%	10	10
14	苗栗縣泰安鄉	2018-11-24T22:13:22+08:00	655	2169	2824	195	3019	4591	65.76%	14.27%	9	10
14	苗栗縣泰安鄉	2018-11-25T01:17:47+08:00	727	2542	3269	200	3469	5180	66.97%	14.03%	10	10
14	苗栗縣泰安鄉	2018-11-24T22:30:02+08:00	655	2169	2824	195	3019	4591	65.76%	14.27%	9	10
14	苗栗縣泰安鄉	2018-11-25T01:25:48+08:00	727	2542	3269	200	3469	5180	66.97%	14.03%	10	10
14	苗栗縣泰安鄉	2018-11-24T22:40:24+08:00	655	2169	2824	195	3019	4591	65.76%	14.27%	9	10
14	苗栗縣泰安鄉	2018-11-25T01:02:26+08:00	727	2542	3269	200	3469	5180	66.97%	14.03%	10	10
14	苗栗縣泰安鄉	2018-11-24T23:15:59+08:00	727	2542	3269	200	3469	5180	66.97%	14.03%	10	10
14	苗栗縣泰安鄉	2018-11-25T06:18:53+08:00	727	2542	3269	200	3469	5180	66.97%	14.03%	10	10
14	苗栗縣泰安鄉	2018-11-24T23:12:11+08:00	727	2542	3269	200	3469	5180	66.97%	14.03%	10	10
14	苗栗縣泰安鄉	2018-11-25T00:18:26+08:00	727	2542	3269	200	3469	5180	66.97%	14.03%	10	10
14	苗栗縣泰安鄉	2018-11-25T03:56:07+08:00	727	2542	3269	200	3469	5180	66.97%	14.03%	10	10
14	苗栗縣泰安鄉	2018-11-24T23:39:11+08:00	727	2542	3269	200	3469	5180	66.97%	14.03%	10	10
14	苗栗縣泰安鄉	2018-11-24T22:45:04+08:00	655	2169	2824	195	3019	4591	65.76%	14.27%	9	10
14	苗栗縣泰安鄉	2018-11-24T22:54:22+08:00	655	2169	2824	195	3019	4591	65.76%	14.27%	9	10
14	雲林縣林內鄉	2018-11-24T23:16:00+08:00	2451	5524	7975	845	8820	15551	56.72%	15.76%	15	15
14	雲林縣林內鄉	2018-11-24T22:16:07+08:00	2242	4994	7236	780	8016	14060	57.01%	15.95%	14	15
14	雲林縣林內鄉	2018-11-25T01:25:50+08:00	2451	5524	7975	845	8820	15551	56.72%	15.76%	15	15
14	雲林縣林內鄉	2018-11-25T00:23:01+08:00	2451	5524	7975	845	8820	15551	56.72%	15.76%	15	15
14	雲林縣林內鄉	2018-11-24T23:23:36+08:00	2451	5524	7975	845	8820	15551	56.72%	15.76%	15	15
14	雲林縣林內鄉	2018-11-25T03:38:52+08:00	2451	5524	7975	845	8820	15551	56.72%	15.76%	15	15
14	雲林縣林內鄉	2018-11-24T22:57:50+08:00	2451	5524	7975	845	8820	15551	56.72%	15.76%	15	15
14	雲林縣林內鄉	2018-11-25T00:57:34+08:00	2451	5524	7975	845	8820	15551	56.72%	15.76%	15	15
14	雲林縣林內鄉	2018-11-24T22:36:58+08:00	2451	5524	7975	845	8820	15551	56.72%	15.76%	15	15
14	雲林縣林內鄉	2018-11-24T22:19:34+08:00	2242	4994	7236	780	8016	14060	57.01%	15.95%	14	15
14	雲林縣林內鄉	2018-11-24T22:45:06+08:00	2451	5524	7975	845	8820	15551	56.72%	15.76%	15	15
14	雲林縣林內鄉	2018-11-25T01:12:40+08:00	2451	5524	7975	845	8820	15551	56.72%	15.76%	15	15
14	雲林縣林內鄉	2018-11-24T22:26:34+08:00	2451	5524	7975	845	8820	15551	56.72%	15.76%	15	15
14	雲林縣林內鄉	2018-11-25T06:23:57+08:00	2451	5524	7975	845	8820	15551	56.72%	15.76%	15	15
14	雲林縣林內鄉	2018-11-24T23:39:12+08:00	2451	5524	7975	845	8820	15551	56.72%	15.76%	15	15
14	雲林縣林內鄉	2018-11-24T22:50:45+08:00	2451	5524	7975	845	8820	15551	56.72%	15.76%	15	15
14	雲林縣林內鄉	2018-11-24T23:12:13+08:00	2451	5524	7975	845	8820	15551	56.72%	15.76%	15	15
14	雲林縣林內鄉	2018-11-25T03:49:48+08:00	2451	5524	7975	845	8820	15551	56.72%	15.76%	15	15
14	雲林縣林內鄉	2018-11-24T23:31:08+08:00	2451	5524	7975	845	8820	15551	56.72%	15.76%	15	15
14	雲林縣林內鄉	2018-11-24T23:01:28+08:00	2451	5524	7975	845	8820	15551	56.72%	15.76%	15	15
14	雲林縣林內鄉	2018-11-24T23:47:25+08:00	2451	5524	7975	845	8820	15551	56.72%	15.76%	15	15
14	雲林縣林內鄉	2018-11-25T06:29:14+08:00	2451	5524	7975	845	8820	15551	56.72%	15.76%	15	15
14	雲林縣林內鄉	2018-11-25T01:07:23+08:00	2451	5524	7975	845	8820	15551	56.72%	15.76%	15	15
14	雲林縣林內鄉	2018-11-24T23:43:14+08:00	2451	5524	7975	845	8820	15551	56.72%	15.76%	15	15
14	雲林縣林內鄉	2018-11-25T06:13:50+08:00	2451	5524	7975	845	8820	15551	56.72%	15.76%	15	15
14	雲林縣林內鄉	2018-11-25T06:08:49+08:00	2451	5524	7975	845	8820	15551	56.72%	15.76%	15	15
14	雲林縣林內鄉	2018-11-24T23:35:08+08:00	2451	5524	7975	845	8820	15551	56.72%	15.76%	15	15
14	雲林縣林內鄉	2018-11-24T22:33:35+08:00	2451	5524	7975	845	8820	15551	56.72%	15.76%	15	15
14	雲林縣林內鄉	2018-11-25T00:14:06+08:00	2451	5524	7975	845	8820	15551	56.72%	15.76%	15	15
14	雲林縣林內鄉	2018-11-25T04:02:48+08:00	2451	5524	7975	845	8820	15551	56.72%	15.76%	15	15
14	雲林縣林內鄉	2018-11-25T00:00:07+08:00	2451	5524	7975	845	8820	15551	56.72%	15.76%	15	15
14	雲林縣林內鄉	2018-11-24T23:08:33+08:00	2451	5524	7975	845	8820	15551	56.72%	15.76%	15	15
14	雲林縣林內鄉	2018-11-25T03:32:32+08:00	2451	5524	7975	845	8820	15551	56.72%	15.76%	15	15
14	雲林縣林內鄉	2018-11-25T03:44:20+08:00	2451	5524	7975	845	8820	15551	56.72%	15.76%	15	15
14	雲林縣林內鄉	2018-11-24T22:13:24+08:00	2242	4994	7236	780	8016	14060	57.01%	15.95%	14	15
14	雲林縣林內鄉	2018-11-24T23:55:44+08:00	2451	5524	7975	845	8820	15551	56.72%	15.76%	15	15
14	雲林縣林內鄉	2018-11-25T01:17:49+08:00	2451	5524	7975	845	8820	15551	56.72%	15.76%	15	15
14	雲林縣林內鄉	2018-11-24T23:19:47+08:00	2451	5524	7975	845	8820	15551	56.72%	15.76%	15	15
14	雲林縣林內鄉	2018-11-25T01:02:28+08:00	2451	5524	7975	845	8820	15551	56.72%	15.76%	15	15
14	雲林縣林內鄉	2018-11-24T23:27:16+08:00	2451	5524	7975	845	8820	15551	56.72%	15.76%	15	15
14	雲林縣林內鄉	2018-11-24T22:40:25+08:00	2451	5524	7975	845	8820	15551	56.72%	15.76%	15	15
14	雲林縣林內鄉	2018-11-24T22:23:10+08:00	2451	5524	7975	845	8820	15551	56.72%	15.76%	15	15
14	雲林縣林內鄉	2018-11-24T22:30:03+08:00	2451	5524	7975	845	8820	15551	56.72%	15.76%	15	15
14	雲林縣林內鄉	2018-11-25T06:18:54+08:00	2451	5524	7975	845	8820	15551	56.72%	15.76%	15	15
14	雲林縣林內鄉	2018-11-24T23:51:32+08:00	2451	5524	7975	845	8820	15551	56.72%	15.76%	15	15
14	雲林縣林內鄉	2018-11-25T00:05:02+08:00	2451	5524	7975	845	8820	15551	56.72%	15.76%	15	15
14	雲林縣林內鄉	2018-11-24T22:41:32+08:00	2451	5524	7975	845	8820	15551	56.72%	15.76%	15	15
14	雲林縣林內鄉	2018-11-25T00:09:31+08:00	2451	5524	7975	845	8820	15551	56.72%	15.76%	15	15
14	雲林縣林內鄉	2018-11-24T22:54:23+08:00	2451	5524	7975	845	8820	15551	56.72%	15.76%	15	15
14	雲林縣林內鄉	2018-11-24T23:05:02+08:00	2451	5524	7975	845	8820	15551	56.72%	15.76%	15	15
14	雲林縣林內鄉	2018-11-25T03:56:09+08:00	2451	5524	7975	845	8820	15551	56.72%	15.76%	15	15
14	雲林縣林內鄉	2018-11-25T00:18:27+08:00	2451	5524	7975	845	8820	15551	56.72%	15.76%	15	15
14	雲林縣	2018-11-24T23:16:00+08:00	73283	171396	244679	20498	265177	517105	51.28%	14.17%	509	557
14	雲林縣	2018-11-24T22:16:07+08:00	56562	132903	189465	16198	205663	406529	50.59%	13.91%	425	557
14	雲林縣	2018-11-24T22:23:09+08:00	58889	138041	196930	16956	213886	422182	50.66%	13.95%	437	557
14	雲林縣	2018-11-25T03:32:31+08:00	83844	196025	279869	22541	302410	584480	51.74%	14.35%	557	557
14	雲林縣	2018-11-25T00:23:01+08:00	82503	193022	275525	22373	297898	576380	51.68%	14.31%	552	557
14	雲林縣	2018-11-25T03:38:52+08:00	83844	196025	279869	22541	302410	584480	51.74%	14.35%	557	557
14	雲林縣	2018-11-24T22:36:57+08:00	64318	150596	214914	18326	233240	459069	50.81%	14.01%	466	557
14	雲林縣	2018-11-24T22:57:50+08:00	70512	164971	235483	19823	255306	499556	51.11%	14.11%	497	557
14	雲林縣	2018-11-25T00:57:33+08:00	83844	196025	279869	22541	302410	584480	51.74%	14.35%	557	557
14	雲林縣	2018-11-24T23:27:15+08:00	75684	176637	252321	20985	273306	531855	51.39%	14.23%	520	557
14	雲林縣	2018-11-24T22:19:34+08:00	57393	134777	192170	16552	208722	412516	50.6%	13.91%	430	557
14	雲林縣	2018-11-24T22:50:44+08:00	67838	158728	226566	19189	245755	482314	50.95%	14.07%	485	557
14	雲林縣	2018-11-24T23:12:12+08:00	72091	168614	240705	20220	260925	509599	51.2%	14.15%	504	557
14	雲林縣	2018-11-24T22:45:06+08:00	65863	154043	219906	18726	238632	469494	50.83%	14.03%	474	557
14	雲林縣	2018-11-25T06:13:49+08:00	83844	196025	279869	22541	302410	584480	51.74%	14.35%	557	557
14	雲林縣	2018-11-25T01:12:40+08:00	83844	196025	279869	22541	302410	584480	51.74%	14.35%	557	557
14	雲林縣	2018-11-24T22:26:34+08:00	59920	140410	200330	17184	217514	429326	50.66%	13.96%	443	557
14	雲林縣	2018-11-25T06:23:57+08:00	83844	196025	279869	22541	302410	584480	51.74%	14.35%	557	557
14	雲林縣	2018-11-24T23:39:12+08:00	78140	182418	260558	21397	281955	547238	51.52%	14.28%	530	557
14	雲林縣	2018-11-25T03:49:48+08:00	83844	196025	279869	22541	302410	584480	51.74%	14.35%	557	557
14	雲林縣	2018-11-24T23:01:28+08:00	71240	166522	237762	20065	257827	504019	51.15%	14.13%	500	557
14	雲林縣	2018-11-25T04:02:47+08:00	83844	196025	279869	22541	302410	584480	51.74%	14.35%	557	557
14	雲林縣	2018-11-24T23:47:25+08:00	79350	185108	264458	21650	286108	554601	51.59%	14.31%	535	557
14	雲林縣	2018-11-25T06:29:13+08:00	83844	196025	279869	22541	302410	584480	51.74%	14.35%	557	557
14	雲林縣	2018-11-24T23:35:07+08:00	77679	181295	258974	21318	280292	544262	51.5%	14.27%	528	557
14	雲林縣	2018-11-25T01:07:23+08:00	83844	196025	279869	22541	302410	584480	51.74%	14.35%	557	557
14	雲林縣	2018-11-24T23:43:14+08:00	79069	184591	263660	21613	285273	553294	51.56%	14.29%	534	557
14	雲林縣	2018-11-24T23:31:07+08:00	77454	180770	258224	21265	279489	542985	51.47%	14.26%	527	557
14	雲林縣	2018-11-25T06:08:49+08:00	83844	196025	279869	22541	302410	584480	51.74%	14.35%	557	557
14	雲林縣	2018-11-24T22:33:35+08:00	63177	147705	210882	18049	228931	450633	50.8%	14.02%	460	557
14	雲林縣	2018-11-25T00:14:06+08:00	81265	190037	271302	22123	293425	568154	51.65%	14.3%	547	557
14	雲林縣	2018-11-24T23:23:35+08:00	75301	175796	251097	20920	272017	529577	51.36%	14.22%	518	557
14	雲林縣	2018-11-24T22:13:23+08:00	55469	130354	185823	15885	201708	398441	50.62%	13.92%	418	557
14	雲林縣	2018-11-25T01:17:48+08:00	83844	196025	279869	22541	302410	584480	51.74%	14.35%	557	557
14	雲林縣	2018-11-24T23:55:44+08:00	79638	185948	265586	21764	287350	556994	51.59%	14.3%	537	557
14	雲林縣	2018-11-25T00:00:06+08:00	79904	186610	266514	21829	288343	559007	51.58%	14.29%	539	557
14	雲林縣	2018-11-24T23:08:32+08:00	72091	168614	240705	20220	260925	509599	51.2%	14.15%	504	557
14	雲林縣	2018-11-24T23:19:47+08:00	74156	173397	247553	20663	268216	522650	51.32%	14.19%	513	557
14	雲林縣	2018-11-25T03:44:19+08:00	83844	196025	279869	22541	302410	584480	51.74%	14.35%	557	557
14	雲林縣	2018-11-25T01:02:27+08:00	83844	196025	279869	22541	302410	584480	51.74%	14.35%	557	557
14	雲林縣	2018-11-24T22:40:25+08:00	65269	152733	218002	18591	236593	465569	50.82%	14.02%	471	557
14	雲林縣	2018-11-24T22:30:03+08:00	60710	142430	203140	17460	220600	435478	50.66%	13.94%	448	557
14	雲林縣	2018-11-25T01:25:49+08:00	83844	196025	279869	22541	302410	584480	51.74%	14.35%	557	557
14	雲林縣	2018-11-25T06:18:54+08:00	83844	196025	279869	22541	302410	584480	51.74%	14.35%	557	557
14	雲林縣	2018-11-24T23:51:32+08:00	79638	185948	265586	21764	287350	556994	51.59%	14.3%	537	557
14	雲林縣	2018-11-25T03:56:08+08:00	83844	196025	279869	22541	302410	584480	51.74%	14.35%	557	557
14	雲林縣	2018-11-25T00:05:02+08:00	80716	188683	269399	21988	291387	564521	51.62%	14.3%	544	557
14	雲林縣	2018-11-24T22:41:32+08:00	65269	152733	218002	18591	236593	465569	50.82%	14.02%	471	557
14	雲林縣	2018-11-25T00:09:31+08:00	81265	190037	271302	22123	293425	568154	51.65%	14.3%	547	557
14	雲林縣	2018-11-24T22:54:23+08:00	68884	161259	230143	19465	249608	489659	50.98%	14.07%	490	557
14	雲林縣	2018-11-24T23:05:02+08:00	71593	167387	238980	20161	259141	506755	51.14%	14.13%	502	557
14	雲林縣	2018-11-25T00:18:27+08:00	82058	191952	274010	22288	296298	573414	51.67%	14.31%	550	557
14	花蓮縣富里鄉	2018-11-25T06:29:17+08:00	913	2810	3723	434	4157	9065	45.86%	10.07%	13	13
14	花蓮縣富里鄉	2018-11-24T23:47:28+08:00	913	2810	3723	434	4157	9065	45.86%	10.07%	13	13
14	花蓮縣富里鄉	2018-11-25T00:18:30+08:00	913	2810	3723	434	4157	9065	45.86%	10.07%	13	13
14	花蓮縣富里鄉	2018-11-25T01:07:26+08:00	913	2810	3723	434	4157	9065	45.86%	10.07%	13	13
14	花蓮縣富里鄉	2018-11-25T06:13:52+08:00	913	2810	3723	434	4157	9065	45.86%	10.07%	13	13
14	花蓮縣富里鄉	2018-11-24T22:33:38+08:00	913	2810	3723	434	4157	9065	45.86%	10.07%	13	13
14	花蓮縣富里鄉	2018-11-24T23:43:17+08:00	913	2810	3723	434	4157	9065	45.86%	10.07%	13	13
14	花蓮縣富里鄉	2018-11-24T22:37:01+08:00	913	2810	3723	434	4157	9065	45.86%	10.07%	13	13
14	花蓮縣富里鄉	2018-11-25T03:44:23+08:00	913	2810	3723	434	4157	9065	45.86%	10.07%	13	13
14	花蓮縣富里鄉	2018-11-24T22:13:27+08:00	913	2810	3723	434	4157	9065	45.86%	10.07%	13	13
14	花蓮縣富里鄉	2018-11-25T01:02:31+08:00	913	2810	3723	434	4157	9065	45.86%	10.07%	13	13
14	花蓮縣富里鄉	2018-11-24T23:23:38+08:00	913	2810	3723	434	4157	9065	45.86%	10.07%	13	13
14	花蓮縣富里鄉	2018-11-25T03:38:55+08:00	913	2810	3723	434	4157	9065	45.86%	10.07%	13	13
14	花蓮縣富里鄉	2018-11-24T23:55:47+08:00	913	2810	3723	434	4157	9065	45.86%	10.07%	13	13
14	花蓮縣富里鄉	2018-11-24T23:08:36+08:00	913	2810	3723	434	4157	9065	45.86%	10.07%	13	13
14	花蓮縣富里鄉	2018-11-25T00:00:11+08:00	913	2810	3723	434	4157	9065	45.86%	10.07%	13	13
14	花蓮縣富里鄉	2018-11-25T06:18:57+08:00	913	2810	3723	434	4157	9065	45.86%	10.07%	13	13
14	花蓮縣富里鄉	2018-11-24T22:30:09+08:00	913	2810	3723	434	4157	9065	45.86%	10.07%	13	13
14	花蓮縣富里鄉	2018-11-24T22:40:28+08:00	913	2810	3723	434	4157	9065	45.86%	10.07%	13	13
14	花蓮縣富里鄉	2018-11-24T22:23:13+08:00	913	2810	3723	434	4157	9065	45.86%	10.07%	13	13
14	花蓮縣富里鄉	2018-11-24T23:19:51+08:00	913	2810	3723	434	4157	9065	45.86%	10.07%	13	13
14	花蓮縣富里鄉	2018-11-24T23:35:11+08:00	913	2810	3723	434	4157	9065	45.86%	10.07%	13	13
14	花蓮縣富里鄉	2018-11-24T23:01:31+08:00	913	2810	3723	434	4157	9065	45.86%	10.07%	13	13
14	花蓮縣富里鄉	2018-11-24T22:45:09+08:00	913	2810	3723	434	4157	9065	45.86%	10.07%	13	13
14	花蓮縣富里鄉	2018-11-24T23:31:11+08:00	913	2810	3723	434	4157	9065	45.86%	10.07%	13	13
14	花蓮縣富里鄉	2018-11-25T00:09:34+08:00	913	2810	3723	434	4157	9065	45.86%	10.07%	13	13
14	花蓮縣富里鄉	2018-11-24T22:54:26+08:00	913	2810	3723	434	4157	9065	45.86%	10.07%	13	13
14	花蓮縣富里鄉	2018-11-25T00:14:10+08:00	913	2810	3723	434	4157	9065	45.86%	10.07%	13	13
14	花蓮縣富里鄉	2018-11-25T03:56:13+08:00	913	2810	3723	434	4157	9065	45.86%	10.07%	13	13
14	花蓮縣富里鄉	2018-11-25T03:49:51+08:00	913	2810	3723	434	4157	9065	45.86%	10.07%	13	13
14	花蓮縣富里鄉	2018-11-24T23:16:03+08:00	913	2810	3723	434	4157	9065	45.86%	10.07%	13	13
14	花蓮縣富里鄉	2018-11-25T03:32:35+08:00	913	2810	3723	434	4157	9065	45.86%	10.07%	13	13
14	花蓮縣富里鄉	2018-11-25T06:24:00+08:00	913	2810	3723	434	4157	9065	45.86%	10.07%	13	13
14	花蓮縣富里鄉	2018-11-25T01:25:53+08:00	913	2810	3723	434	4157	9065	45.86%	10.07%	13	13
14	花蓮縣富里鄉	2018-11-25T00:23:04+08:00	913	2810	3723	434	4157	9065	45.86%	10.07%	13	13
14	花蓮縣富里鄉	2018-11-25T00:57:37+08:00	913	2810	3723	434	4157	9065	45.86%	10.07%	13	13
14	花蓮縣富里鄉	2018-11-24T22:57:53+08:00	913	2810	3723	434	4157	9065	45.86%	10.07%	13	13
14	花蓮縣富里鄉	2018-11-24T22:19:37+08:00	913	2810	3723	434	4157	9065	45.86%	10.07%	13	13
14	花蓮縣富里鄉	2018-11-25T01:17:52+08:00	913	2810	3723	434	4157	9065	45.86%	10.07%	13	13
14	花蓮縣富里鄉	2018-11-24T23:27:18+08:00	913	2810	3723	434	4157	9065	45.86%	10.07%	13	13
14	花蓮縣富里鄉	2018-11-24T23:51:35+08:00	913	2810	3723	434	4157	9065	45.86%	10.07%	13	13
14	花蓮縣富里鄉	2018-11-24T22:41:35+08:00	913	2810	3723	434	4157	9065	45.86%	10.07%	13	13
14	花蓮縣富里鄉	2018-11-25T00:05:05+08:00	913	2810	3723	434	4157	9065	45.86%	10.07%	13	13
14	花蓮縣富里鄉	2018-11-25T04:02:52+08:00	913	2810	3723	434	4157	9065	45.86%	10.07%	13	13
14	花蓮縣富里鄉	2018-11-24T23:12:16+08:00	913	2810	3723	434	4157	9065	45.86%	10.07%	13	13
14	花蓮縣富里鄉	2018-11-25T06:08:53+08:00	913	2810	3723	434	4157	9065	45.86%	10.07%	13	13
14	花蓮縣富里鄉	2018-11-25T01:12:43+08:00	913	2810	3723	434	4157	9065	45.86%	10.07%	13	13
14	花蓮縣富里鄉	2018-11-24T22:26:37+08:00	913	2810	3723	434	4157	9065	45.86%	10.07%	13	13
14	花蓮縣富里鄉	2018-11-24T23:05:05+08:00	913	2810	3723	434	4157	9065	45.86%	10.07%	13	13
14	花蓮縣富里鄉	2018-11-24T22:50:48+08:00	913	2810	3723	434	4157	9065	45.86%	10.07%	13	13
14	花蓮縣富里鄉	2018-11-24T22:16:11+08:00	913	2810	3723	434	4157	9065	45.86%	10.07%	13	13
14	花蓮縣富里鄉	2018-11-24T23:39:16+08:00	913	2810	3723	434	4157	9065	45.86%	10.07%	13	13
14	花蓮縣	2018-11-25T06:29:17+08:00	36102	100144	136246	10129	146375	278059	52.64%	12.98%	299	299
14	花蓮縣	2018-11-24T23:47:28+08:00	26200	73308	99508	7715	107223	202805	52.87%	12.92%	237	299
14	花蓮縣	2018-11-24T22:37:00+08:00	14420	41303	55723	4650	60373	114974	52.51%	12.54%	155	299
14	花蓮縣	2018-11-25T00:18:30+08:00	29577	82649	112226	8562	120788	228812	52.79%	12.93%	259	299
14	花蓮縣	2018-11-25T01:07:26+08:00	34040	94375	128415	9531	137946	261619	52.73%	13.01%	285	299
14	花蓮縣	2018-11-25T06:13:52+08:00	36102	100144	136246	10129	146375	278059	52.64%	12.98%	299	299
14	花蓮縣	2018-11-24T22:33:38+08:00	14420	41303	55723	4650	60373	114974	52.51%	12.54%	155	299
14	花蓮縣	2018-11-24T23:43:17+08:00	25634	71743	97377	7611	104988	198604	52.86%	12.91%	233	299
14	花蓮縣	2018-11-25T03:44:23+08:00	36102	100144	136246	10129	146375	278059	52.64%	12.98%	299	299
14	花蓮縣	2018-11-24T22:13:27+08:00	12407	35331	47738	4049	51787	99500	52.05%	12.47%	138	299
14	花蓮縣	2018-11-25T01:02:31+08:00	33359	92726	126085	9382	135467	256988	52.71%	12.98%	281	299
14	花蓮縣	2018-11-24T23:23:38+08:00	21821	61209	83030	6690	89720	170158	52.73%	12.82%	207	299
14	花蓮縣	2018-11-25T03:38:55+08:00	36102	100144	136246	10129	146375	278059	52.64%	12.98%	299	299
14	花蓮縣	2018-11-24T23:55:47+08:00	26884	75285	102169	7858	110027	208150	52.86%	12.92%	242	299
14	花蓮縣	2018-11-24T23:08:36+08:00	19440	54779	74219	5984	80203	152160	52.71%	12.78%	190	299
14	花蓮縣	2018-11-25T00:00:11+08:00	27314	76472	103786	7990	111776	212071	52.71%	12.88%	245	299
14	花蓮縣	2018-11-24T22:30:08+08:00	13570	39088	52658	4444	57102	109191	52.3%	12.43%	149	299
14	花蓮縣	2018-11-24T22:40:27+08:00	14516	41573	56089	4685	60774	115575	52.58%	12.56%	156	299
14	花蓮縣	2018-11-25T06:18:57+08:00	36102	100144	136246	10129	146375	278059	52.64%	12.98%	299	299
14	花蓮縣	2018-11-24T22:23:13+08:00	13315	38119	51434	4282	55716	106851	52.14%	12.46%	146	299
14	花蓮縣	2018-11-24T23:19:51+08:00	21488	60287	81775	6599	88374	167922	52.63%	12.8%	205	299
14	花蓮縣	2018-11-24T23:12:15+08:00	19877	55768	75645	6098	81743	155327	52.63%	12.8%	193	299
14	花蓮縣	2018-11-24T22:45:08+08:00	14997	42983	57980	4765	62745	119299	52.59%	12.57%	159	299
14	花蓮縣	2018-11-24T23:35:11+08:00	23975	67249	91224	7195	98419	186648	52.73%	12.85%	222	299
14	花蓮縣	2018-11-24T23:39:15+08:00	24264	68002	92266	7262	99528	188942	52.68%	12.84%	224	299
14	花蓮縣	2018-11-24T23:01:31+08:00	18595	52686	71281	5787	77068	146266	52.69%	12.71%	183	299
14	花蓮縣	2018-11-24T23:31:11+08:00	23163	64890	88053	7013	95066	179756	52.89%	12.89%	216	299
14	花蓮縣	2018-11-25T00:09:34+08:00	27716	77690	105406	8086	113492	215341	52.7%	12.87%	248	299
14	花蓮縣	2018-11-25T00:14:09+08:00	28566	79779	108345	8273	116618	221344	52.69%	12.91%	253	299
14	花蓮縣	2018-11-25T03:49:51+08:00	36102	100144	136246	10129	146375	278059	52.64%	12.98%	299	299
14	花蓮縣	2018-11-24T23:16:03+08:00	20411	57158	77569	6270	83839	159121	52.69%	12.83%	198	299
14	花蓮縣	2018-11-25T03:56:12+08:00	36102	100144	136246	10129	146375	278059	52.64%	12.98%	299	299
14	花蓮縣	2018-11-25T06:24:00+08:00	36102	100144	136246	10129	146375	278059	52.64%	12.98%	299	299
14	花蓮縣	2018-11-25T00:23:03+08:00	30009	83777	113786	8639	122425	232557	52.64%	12.9%	262	299
14	花蓮縣	2018-11-25T03:32:34+08:00	36102	100144	136246	10129	146375	278059	52.64%	12.98%	299	299
14	花蓮縣	2018-11-25T01:25:52+08:00	34384	95305	129689	9600	139289	264340	52.69%	13.01%	287	299
14	花蓮縣	2018-11-25T00:57:37+08:00	33142	92228	125370	9345	134715	255657	52.69%	12.96%	280	299
14	花蓮縣	2018-11-24T22:57:53+08:00	17827	50663	68490	5625	74115	140807	52.64%	12.66%	178	299
14	花蓮縣	2018-11-24T22:19:37+08:00	12787	36477	49264	4167	53431	102447	52.15%	12.48%	141	299
14	花蓮縣	2018-11-25T01:17:52+08:00	33878	93940	127818	9514	137332	260456	52.73%	13.01%	284	299
14	花蓮縣	2018-11-24T23:27:18+08:00	22164	62181	84345	6770	91115	172574	52.8%	12.84%	209	299
14	花蓮縣	2018-11-24T23:51:35+08:00	26884	75285	102169	7858	110027	208150	52.86%	12.92%	242	299
14	花蓮縣	2018-11-24T23:05:04+08:00	18996	53710	72706	5887	78593	148838	52.8%	12.76%	186	299
14	花蓮縣	2018-11-24T22:41:35+08:00	14516	41573	56089	4685	60774	115575	52.58%	12.56%	156	299
14	花蓮縣	2018-11-25T00:05:05+08:00	27638	77389	105027	8034	113061	214490	52.71%	12.89%	247	299
14	花蓮縣	2018-11-25T04:02:52+08:00	36102	100144	136246	10129	146375	278059	52.64%	12.98%	299	299
14	花蓮縣	2018-11-25T06:08:53+08:00	36102	100144	136246	10129	146375	278059	52.64%	12.98%	299	299
14	花蓮縣	2018-11-24T22:16:10+08:00	12407	35331	47738	4049	51787	99500	52.05%	12.47%	138	299
14	花蓮縣	2018-11-25T01:12:43+08:00	33878	93940	127818	9514	137332	260456	52.73%	13.01%	284	299
14	花蓮縣	2018-11-24T22:26:37+08:00	13422	38458	51880	4310	56190	107624	52.21%	12.47%	147	299
14	花蓮縣	2018-11-24T22:50:48+08:00	16991	48246	65237	5364	70601	134579	52.46%	12.63%	173	299
14	花蓮縣	2018-11-24T22:54:25+08:00	17408	49544	66952	5525	72477	137908	52.55%	12.62%	176	299
14	臺南市大內區	2018-11-24T23:35:03+08:00	1076	2658	3734	419	4153	8654	47.99%	12.43%	11	11
14	臺南市大內區	2018-11-24T22:33:30+08:00	1076	2658	3734	419	4153	8654	47.99%	12.43%	11	11
14	臺南市大內區	2018-11-24T23:31:02+08:00	1076	2658	3734	419	4153	8654	47.99%	12.43%	11	11
14	臺南市大內區	2018-11-24T23:39:06+08:00	1076	2658	3734	419	4153	8654	47.99%	12.43%	11	11
14	臺南市大內區	2018-11-24T23:12:07+08:00	1076	2658	3734	419	4153	8654	47.99%	12.43%	11	11
14	臺南市大內區	2018-11-25T00:14:02+08:00	1076	2658	3734	419	4153	8654	47.99%	12.43%	11	11
14	臺南市大內區	2018-11-24T23:47:20+08:00	1076	2658	3734	419	4153	8654	47.99%	12.43%	11	11
14	臺南市大內區	2018-11-24T23:43:10+08:00	1076	2658	3734	419	4153	8654	47.99%	12.43%	11	11
14	臺南市大內區	2018-11-25T06:08:44+08:00	1076	2658	3734	419	4153	8654	47.99%	12.43%	11	11
14	臺南市大內區	2018-11-25T01:07:18+08:00	1076	2658	3734	419	4153	8654	47.99%	12.43%	11	11
14	臺南市大內區	2018-11-24T23:01:23+08:00	1076	2658	3734	419	4153	8654	47.99%	12.43%	11	11
14	臺南市大內區	2018-11-24T22:57:45+08:00	1076	2658	3734	419	4153	8654	47.99%	12.43%	11	11
14	臺南市大內區	2018-11-24T23:04:57+08:00	1076	2658	3734	419	4153	8654	47.99%	12.43%	11	11
14	臺南市大內區	2018-11-24T23:23:31+08:00	1076	2658	3734	419	4153	8654	47.99%	12.43%	11	11
14	臺南市大內區	2018-11-25T00:57:29+08:00	1076	2658	3734	419	4153	8654	47.99%	12.43%	11	11
14	臺南市大內區	2018-11-24T22:13:19+08:00	1076	2658	3734	419	4153	8654	47.99%	12.43%	11	11
14	臺南市大內區	2018-11-25T03:44:14+08:00	1076	2658	3734	419	4153	8654	47.99%	12.43%	11	11
14	臺南市大內區	2018-11-25T01:17:43+08:00	1076	2658	3734	419	4153	8654	47.99%	12.43%	11	11
14	臺南市大內區	2018-11-25T00:04:57+08:00	1076	2658	3734	419	4153	8654	47.99%	12.43%	11	11
14	臺南市大內區	2018-11-24T23:55:40+08:00	1076	2658	3734	419	4153	8654	47.99%	12.43%	11	11
14	臺南市大內區	2018-11-24T23:15:55+08:00	1076	2658	3734	419	4153	8654	47.99%	12.43%	11	11
14	臺南市大內區	2018-11-25T01:02:23+08:00	1076	2658	3734	419	4153	8654	47.99%	12.43%	11	11
14	臺南市大內區	2018-11-25T01:25:45+08:00	1076	2658	3734	419	4153	8654	47.99%	12.43%	11	11
14	臺南市大內區	2018-11-25T03:38:48+08:00	1076	2658	3734	419	4153	8654	47.99%	12.43%	11	11
14	臺南市大內區	2018-11-25T06:18:50+08:00	1076	2658	3734	419	4153	8654	47.99%	12.43%	11	11
14	臺南市大內區	2018-11-24T22:40:21+08:00	1076	2658	3734	419	4153	8654	47.99%	12.43%	11	11
14	臺南市大內區	2018-11-24T22:45:01+08:00	1076	2658	3734	419	4153	8654	47.99%	12.43%	11	11
14	臺南市大內區	2018-11-25T00:18:22+08:00	1076	2658	3734	419	4153	8654	47.99%	12.43%	11	11
14	臺南市大內區	2018-11-25T00:22:56+08:00	1076	2658	3734	419	4153	8654	47.99%	12.43%	11	11
14	臺南市大內區	2018-11-24T22:54:19+08:00	1076	2658	3734	419	4153	8654	47.99%	12.43%	11	11
14	臺南市大內區	2018-11-25T03:56:03+08:00	1076	2658	3734	419	4153	8654	47.99%	12.43%	11	11
14	臺南市大內區	2018-11-24T22:16:02+08:00	1076	2658	3734	419	4153	8654	47.99%	12.43%	11	11
14	臺南市大內區	2018-11-25T01:12:34+08:00	1076	2658	3734	419	4153	8654	47.99%	12.43%	11	11
14	臺南市大內區	2018-11-24T22:50:39+08:00	1076	2658	3734	419	4153	8654	47.99%	12.43%	11	11
14	臺南市大內區	2018-11-25T00:09:25+08:00	1076	2658	3734	419	4153	8654	47.99%	12.43%	11	11
14	臺南市大內區	2018-11-24T22:41:28+08:00	1076	2658	3734	419	4153	8654	47.99%	12.43%	11	11
14	臺南市大內區	2018-11-25T04:02:41+08:00	1076	2658	3734	419	4153	8654	47.99%	12.43%	11	11
14	臺南市大內區	2018-11-25T00:00:00+08:00	1076	2658	3734	419	4153	8654	47.99%	12.43%	11	11
14	臺南市大內區	2018-11-24T22:23:04+08:00	1076	2658	3734	419	4153	8654	47.99%	12.43%	11	11
14	臺南市大內區	2018-11-24T23:19:41+08:00	1076	2658	3734	419	4153	8654	47.99%	12.43%	11	11
14	臺南市大內區	2018-11-24T23:51:27+08:00	1076	2658	3734	419	4153	8654	47.99%	12.43%	11	11
14	臺南市大內區	2018-11-24T22:29:58+08:00	1076	2658	3734	419	4153	8654	47.99%	12.43%	11	11
14	臺南市大內區	2018-11-24T22:36:54+08:00	1076	2658	3734	419	4153	8654	47.99%	12.43%	11	11
14	臺南市大內區	2018-11-25T03:32:27+08:00	1076	2658	3734	419	4153	8654	47.99%	12.43%	11	11
14	臺南市大內區	2018-11-24T23:27:11+08:00	1076	2658	3734	419	4153	8654	47.99%	12.43%	11	11
14	臺南市大內區	2018-11-24T22:19:30+08:00	1076	2658	3734	419	4153	8654	47.99%	12.43%	11	11
14	臺南市大內區	2018-11-24T23:08:27+08:00	1076	2658	3734	419	4153	8654	47.99%	12.43%	11	11
14	臺南市大內區	2018-11-25T03:49:44+08:00	1076	2658	3734	419	4153	8654	47.99%	12.43%	11	11
14	臺南市大內區	2018-11-24T22:26:30+08:00	1076	2658	3734	419	4153	8654	47.99%	12.43%	11	11
14	臺南市大內區	2018-11-25T06:29:09+08:00	1076	2658	3734	419	4153	8654	47.99%	12.43%	11	11
14	臺南市大內區	2018-11-25T06:23:53+08:00	1076	2658	3734	419	4153	8654	47.99%	12.43%	11	11
14	臺南市大內區	2018-11-25T06:13:45+08:00	1076	2658	3734	419	4153	8654	47.99%	12.43%	11	11
14	屏東縣枋山鄉	2018-11-24T22:33:37+08:00	376	880	1256	138	1394	2956	47.16%	12.72%	4	6
14	屏東縣枋山鄉	2018-11-24T22:37:00+08:00	376	880	1256	138	1394	2956	47.16%	12.72%	4	6
14	屏東縣枋山鄉	2018-11-24T23:43:16+08:00	682	1568	2250	212	2462	4856	50.7%	14.04%	6	6
14	屏東縣枋山鄉	2018-11-25T03:56:11+08:00	682	1568	2250	212	2462	4856	50.7%	14.04%	6	6
14	屏東縣枋山鄉	2018-11-25T06:29:16+08:00	682	1568	2250	212	2462	4856	50.7%	14.04%	6	6
14	屏東縣枋山鄉	2018-11-24T23:47:27+08:00	682	1568	2250	212	2462	4856	50.7%	14.04%	6	6
14	屏東縣枋山鄉	2018-11-24T22:16:09+08:00	376	880	1256	138	1394	2956	47.16%	12.72%	4	6
14	屏東縣枋山鄉	2018-11-25T03:38:54+08:00	682	1568	2250	212	2462	4856	50.7%	14.04%	6	6
14	屏東縣枋山鄉	2018-11-24T23:55:46+08:00	682	1568	2250	212	2462	4856	50.7%	14.04%	6	6
14	屏東縣枋山鄉	2018-11-25T03:44:22+08:00	682	1568	2250	212	2462	4856	50.7%	14.04%	6	6
14	屏東縣枋山鄉	2018-11-24T22:13:26+08:00	376	880	1256	138	1394	2956	47.16%	12.72%	4	6
14	屏東縣枋山鄉	2018-11-24T23:23:37+08:00	542	1240	1782	189	1971	3884	50.75%	13.95%	5	6
14	屏東縣枋山鄉	2018-11-25T06:18:56+08:00	682	1568	2250	212	2462	4856	50.7%	14.04%	6	6
14	屏東縣枋山鄉	2018-11-24T22:23:12+08:00	376	880	1256	138	1394	2956	47.16%	12.72%	4	6
14	屏東縣枋山鄉	2018-11-24T22:40:27+08:00	376	880	1256	138	1394	2956	47.16%	12.72%	4	6
14	屏東縣枋山鄉	2018-11-25T00:00:10+08:00	682	1568	2250	212	2462	4856	50.7%	14.04%	6	6
14	屏東縣枋山鄉	2018-11-25T01:17:51+08:00	682	1568	2250	212	2462	4856	50.7%	14.04%	6	6
14	屏東縣枋山鄉	2018-11-24T22:30:07+08:00	376	880	1256	138	1394	2956	47.16%	12.72%	4	6
14	屏東縣枋山鄉	2018-11-24T23:12:15+08:00	542	1240	1782	189	1971	3884	50.75%	13.95%	5	6
14	屏東縣枋山鄉	2018-11-24T22:45:08+08:00	376	880	1256	138	1394	2956	47.16%	12.72%	4	6
14	屏東縣枋山鄉	2018-11-24T23:31:10+08:00	542	1240	1782	189	1971	3884	50.75%	13.95%	5	6
14	屏東縣枋山鄉	2018-11-24T23:01:30+08:00	542	1240	1782	189	1971	3884	50.75%	13.95%	5	6
14	屏東縣枋山鄉	2018-11-25T04:02:51+08:00	682	1568	2250	212	2462	4856	50.7%	14.04%	6	6
14	屏東縣枋山鄉	2018-11-24T23:39:15+08:00	542	1240	1782	189	1971	3884	50.75%	13.95%	5	6
14	屏東縣枋山鄉	2018-11-25T06:23:59+08:00	682	1568	2250	212	2462	4856	50.7%	14.04%	6	6
14	屏東縣枋山鄉	2018-11-25T00:09:33+08:00	682	1568	2250	212	2462	4856	50.7%	14.04%	6	6
14	屏東縣枋山鄉	2018-11-25T01:07:25+08:00	682	1568	2250	212	2462	4856	50.7%	14.04%	6	6
14	屏東縣枋山鄉	2018-11-25T06:13:51+08:00	682	1568	2250	212	2462	4856	50.7%	14.04%	6	6
14	屏東縣枋山鄉	2018-11-24T23:16:02+08:00	542	1240	1782	189	1971	3884	50.75%	13.95%	5	6
14	屏東縣枋山鄉	2018-11-24T23:35:09+08:00	542	1240	1782	189	1971	3884	50.75%	13.95%	5	6
14	屏東縣枋山鄉	2018-11-25T03:49:50+08:00	682	1568	2250	212	2462	4856	50.7%	14.04%	6	6
14	屏東縣枋山鄉	2018-11-25T00:14:08+08:00	682	1568	2250	212	2462	4856	50.7%	14.04%	6	6
14	屏東縣枋山鄉	2018-11-25T00:23:03+08:00	682	1568	2250	212	2462	4856	50.7%	14.04%	6	6
14	屏東縣枋山鄉	2018-11-24T23:08:35+08:00	542	1240	1782	189	1971	3884	50.75%	13.95%	5	6
14	屏東縣枋山鄉	2018-11-25T03:32:34+08:00	682	1568	2250	212	2462	4856	50.7%	14.04%	6	6
14	屏東縣枋山鄉	2018-11-25T01:25:52+08:00	682	1568	2250	212	2462	4856	50.7%	14.04%	6	6
14	屏東縣枋山鄉	2018-11-24T23:19:49+08:00	542	1240	1782	189	1971	3884	50.75%	13.95%	5	6
14	屏東縣枋山鄉	2018-11-24T22:19:36+08:00	376	880	1256	138	1394	2956	47.16%	12.72%	4	6
14	屏東縣枋山鄉	2018-11-25T01:02:29+08:00	682	1568	2250	212	2462	4856	50.7%	14.04%	6	6
14	屏東縣枋山鄉	2018-11-24T23:51:34+08:00	682	1568	2250	212	2462	4856	50.7%	14.04%	6	6
14	屏東縣枋山鄉	2018-11-24T22:57:52+08:00	542	1240	1782	189	1971	3884	50.75%	13.95%	5	6
14	屏東縣枋山鄉	2018-11-25T00:57:36+08:00	682	1568	2250	212	2462	4856	50.7%	14.04%	6	6
14	屏東縣枋山鄉	2018-11-24T23:27:18+08:00	542	1240	1782	189	1971	3884	50.75%	13.95%	5	6
14	屏東縣枋山鄉	2018-11-24T23:05:04+08:00	542	1240	1782	189	1971	3884	50.75%	13.95%	5	6
14	屏東縣枋山鄉	2018-11-24T22:50:47+08:00	542	1240	1782	189	1971	3884	50.75%	13.95%	5	6
14	屏東縣枋山鄉	2018-11-25T00:05:04+08:00	682	1568	2250	212	2462	4856	50.7%	14.04%	6	6
14	屏東縣枋山鄉	2018-11-24T22:41:34+08:00	376	880	1256	138	1394	2956	47.16%	12.72%	4	6
14	屏東縣枋山鄉	2018-11-25T01:12:42+08:00	682	1568	2250	212	2462	4856	50.7%	14.04%	6	6
14	屏東縣枋山鄉	2018-11-24T22:26:36+08:00	376	880	1256	138	1394	2956	47.16%	12.72%	4	6
14	屏東縣枋山鄉	2018-11-25T00:18:29+08:00	682	1568	2250	212	2462	4856	50.7%	14.04%	6	6
14	屏東縣枋山鄉	2018-11-25T06:08:52+08:00	682	1568	2250	212	2462	4856	50.7%	14.04%	6	6
14	屏東縣枋山鄉	2018-11-24T22:54:25+08:00	542	1240	1782	189	1971	3884	50.75%	13.95%	5	6
14	臺南市新營區	2018-11-24T23:35:03+08:00	10002	20659	30661	1697	32358	64949	49.82%	15.4%	49	49
14	臺南市新營區	2018-11-24T22:33:30+08:00	9031	18577	27608	1531	29139	58484	49.82%	15.44%	45	49
14	臺南市新營區	2018-11-24T23:31:02+08:00	10002	20659	30661	1697	32358	64949	49.82%	15.4%	49	49
14	臺南市新營區	2018-11-24T23:39:06+08:00	10002	20659	30661	1697	32358	64949	49.82%	15.4%	49	49
14	臺南市新營區	2018-11-24T23:12:07+08:00	10002	20659	30661	1697	32358	64949	49.82%	15.4%	49	49
14	臺南市新營區	2018-11-24T23:47:20+08:00	10002	20659	30661	1697	32358	64949	49.82%	15.4%	49	49
14	臺南市新營區	2018-11-25T01:07:18+08:00	10002	20659	30661	1697	32358	64949	49.82%	15.4%	49	49
14	臺南市新營區	2018-11-25T06:08:43+08:00	10002	20659	30661	1697	32358	64949	49.82%	15.4%	49	49
14	臺南市新營區	2018-11-24T23:01:23+08:00	9719	20142	29861	1644	31505	63200	49.85%	15.38%	48	49
14	臺南市新營區	2018-11-24T22:57:45+08:00	9496	19594	29090	1607	30697	61762	49.7%	15.38%	47	49
14	臺南市新營區	2018-11-25T01:17:42+08:00	10002	20659	30661	1697	32358	64949	49.82%	15.4%	49	49
14	臺南市新營區	2018-11-24T22:13:18+08:00	7597	15487	23084	1274	24358	48333	50.4%	15.72%	39	49
14	臺南市新營區	2018-11-24T22:19:29+08:00	7975	16385	24360	1377	25737	51232	50.24%	15.57%	41	49
14	臺南市新營區	2018-11-25T00:57:28+08:00	10002	20659	30661	1697	32358	64949	49.82%	15.4%	49	49
14	臺南市新營區	2018-11-24T23:23:31+08:00	10002	20659	30661	1697	32358	64949	49.82%	15.4%	49	49
14	臺南市新營區	2018-11-25T03:44:13+08:00	10002	20659	30661	1697	32358	64949	49.82%	15.4%	49	49
14	臺南市新營區	2018-11-25T00:04:57+08:00	10002	20659	30661	1697	32358	64949	49.82%	15.4%	49	49
14	臺南市新營區	2018-11-24T23:04:56+08:00	9719	20142	29861	1644	31505	63200	49.85%	15.38%	48	49
14	臺南市新營區	2018-11-24T23:15:55+08:00	10002	20659	30661	1697	32358	64949	49.82%	15.4%	49	49
14	臺南市新營區	2018-11-25T03:38:48+08:00	10002	20659	30661	1697	32358	64949	49.82%	15.4%	49	49
14	臺南市新營區	2018-11-25T06:18:50+08:00	10002	20659	30661	1697	32358	64949	49.82%	15.4%	49	49
14	臺南市新營區	2018-11-25T01:25:44+08:00	10002	20659	30661	1697	32358	64949	49.82%	15.4%	49	49
14	臺南市新營區	2018-11-24T22:40:21+08:00	9031	18577	27608	1531	29139	58484	49.82%	15.44%	45	49
14	臺南市新營區	2018-11-25T01:02:22+08:00	10002	20659	30661	1697	32358	64949	49.82%	15.4%	49	49
14	臺南市新營區	2018-11-24T23:55:39+08:00	10002	20659	30661	1697	32358	64949	49.82%	15.4%	49	49
14	臺南市新營區	2018-11-24T22:45:01+08:00	9248	19037	28285	1552	29837	59917	49.8%	15.43%	46	49
14	臺南市新營區	2018-11-25T00:18:22+08:00	10002	20659	30661	1697	32358	64949	49.82%	15.4%	49	49
14	臺南市新營區	2018-11-25T00:22:56+08:00	10002	20659	30661	1697	32358	64949	49.82%	15.4%	49	49
14	臺南市新營區	2018-11-24T22:54:19+08:00	9496	19594	29090	1607	30697	61762	49.7%	15.38%	47	49
14	臺南市新營區	2018-11-25T03:56:03+08:00	10002	20659	30661	1697	32358	64949	49.82%	15.4%	49	49
14	臺南市新營區	2018-11-24T22:16:02+08:00	7762	15885	23647	1331	24978	49706	50.25%	15.62%	40	49
14	臺南市新營區	2018-11-25T01:12:34+08:00	10002	20659	30661	1697	32358	64949	49.82%	15.4%	49	49
14	臺南市新營區	2018-11-24T22:50:39+08:00	9496	19594	29090	1607	30697	61762	49.7%	15.38%	47	49
14	臺南市新營區	2018-11-25T00:09:25+08:00	10002	20659	30661	1697	32358	64949	49.82%	15.4%	49	49
14	臺南市新營區	2018-11-25T00:14:01+08:00	10002	20659	30661	1697	32358	64949	49.82%	15.4%	49	49
14	臺南市新營區	2018-11-24T22:41:28+08:00	9031	18577	27608	1531	29139	58484	49.82%	15.44%	45	49
14	臺南市新營區	2018-11-25T04:02:41+08:00	10002	20659	30661	1697	32358	64949	49.82%	15.4%	49	49
14	臺南市新營區	2018-11-25T00:00:00+08:00	10002	20659	30661	1697	32358	64949	49.82%	15.4%	49	49
14	臺南市新營區	2018-11-24T22:23:04+08:00	8245	16964	25209	1431	26640	53097	50.17%	15.53%	42	49
14	臺南市新營區	2018-11-24T23:19:41+08:00	10002	20659	30661	1697	32358	64949	49.82%	15.4%	49	49
14	臺南市新營區	2018-11-24T23:51:27+08:00	10002	20659	30661	1697	32358	64949	49.82%	15.4%	49	49
14	臺南市新營區	2018-11-24T22:29:58+08:00	8778	18039	26817	1493	28310	56889	49.76%	15.43%	44	49
14	臺南市新營區	2018-11-24T22:36:53+08:00	9031	18577	27608	1531	29139	58484	49.82%	15.44%	45	49
14	臺南市新營區	2018-11-24T23:27:11+08:00	10002	20659	30661	1697	32358	64949	49.82%	15.4%	49	49
14	臺南市新營區	2018-11-24T23:08:27+08:00	9719	20142	29861	1644	31505	63200	49.85%	15.38%	48	49
14	臺南市新營區	2018-11-25T03:32:26+08:00	10002	20659	30661	1697	32358	64949	49.82%	15.4%	49	49
14	臺南市新營區	2018-11-25T06:29:08+08:00	10002	20659	30661	1697	32358	64949	49.82%	15.4%	49	49
14	臺南市新營區	2018-11-25T03:49:44+08:00	10002	20659	30661	1697	32358	64949	49.82%	15.4%	49	49
14	臺南市新營區	2018-11-24T22:26:30+08:00	8528	17478	26006	1457	27463	55027	49.91%	15.5%	43	49
14	臺南市新營區	2018-11-25T06:23:52+08:00	10002	20659	30661	1697	32358	64949	49.82%	15.4%	49	49
14	臺南市新營區	2018-11-24T23:43:09+08:00	10002	20659	30661	1697	32358	64949	49.82%	15.4%	49	49
14	臺南市新營區	2018-11-25T06:13:45+08:00	10002	20659	30661	1697	32358	64949	49.82%	15.4%	49	49
14	嘉義縣太保市	2018-11-24T23:47:26+08:00	4420	9799	14219	1030	15249	28761	53.02%	15.37%	31	33
14	嘉義縣太保市	2018-11-24T22:16:08+08:00	3911	8731	12642	951	13593	25677	52.94%	15.23%	29	33
14	嘉義縣太保市	2018-11-24T23:16:00+08:00	4141	9277	13418	980	14398	27250	52.84%	15.2%	30	33
14	嘉義縣太保市	2018-11-25T01:25:50+08:00	4847	10763	15610	1198	16808	31568	53.24%	15.35%	33	33
14	嘉義縣太保市	2018-11-25T03:38:53+08:00	4847	10763	15610	1198	16808	31568	53.24%	15.35%	33	33
14	嘉義縣太保市	2018-11-25T00:23:01+08:00	4638	10367	15005	1092	16097	30290	53.14%	15.31%	32	33
14	嘉義縣太保市	2018-11-24T23:23:36+08:00	4141	9277	13418	980	14398	27250	52.84%	15.2%	30	33
14	嘉義縣太保市	2018-11-24T22:19:35+08:00	3911	8731	12642	951	13593	25677	52.94%	15.23%	29	33
14	嘉義縣太保市	2018-11-25T00:57:34+08:00	4847	10763	15610	1198	16808	31568	53.24%	15.35%	33	33
14	嘉義縣太保市	2018-11-24T22:40:26+08:00	3911	8731	12642	951	13593	25677	52.94%	15.23%	29	33
14	嘉義縣太保市	2018-11-24T22:36:58+08:00	3911	8731	12642	951	13593	25677	52.94%	15.23%	29	33
14	嘉義縣太保市	2018-11-24T22:57:51+08:00	4141	9277	13418	980	14398	27250	52.84%	15.2%	30	33
14	嘉義縣太保市	2018-11-25T00:09:32+08:00	4638	10367	15005	1092	16097	30290	53.14%	15.31%	32	33
14	嘉義縣太保市	2018-11-24T22:45:06+08:00	3911	8731	12642	951	13593	25677	52.94%	15.23%	29	33
14	嘉義縣太保市	2018-11-25T06:08:50+08:00	4847	10763	15610	1198	16808	31568	53.24%	15.35%	33	33
14	嘉義縣太保市	2018-11-25T06:23:58+08:00	4847	10763	15610	1198	16808	31568	53.24%	15.35%	33	33
14	嘉義縣太保市	2018-11-24T23:39:13+08:00	4420	9799	14219	1030	15249	28761	53.02%	15.37%	31	33
14	嘉義縣太保市	2018-11-25T03:49:49+08:00	4847	10763	15610	1198	16808	31568	53.24%	15.35%	33	33
14	嘉義縣太保市	2018-11-25T01:12:41+08:00	4847	10763	15610	1198	16808	31568	53.24%	15.35%	33	33
14	嘉義縣太保市	2018-11-24T22:26:35+08:00	3911	8731	12642	951	13593	25677	52.94%	15.23%	29	33
14	嘉義縣太保市	2018-11-24T22:50:45+08:00	4141	9277	13418	980	14398	27250	52.84%	15.2%	30	33
14	嘉義縣太保市	2018-11-24T23:12:13+08:00	4141	9277	13418	980	14398	27250	52.84%	15.2%	30	33
14	嘉義縣太保市	2018-11-25T04:02:50+08:00	4847	10763	15610	1198	16808	31568	53.24%	15.35%	33	33
14	嘉義縣太保市	2018-11-24T23:31:08+08:00	4420	9799	14219	1030	15249	28761	53.02%	15.37%	31	33
14	嘉義縣太保市	2018-11-24T23:43:15+08:00	4420	9799	14219	1030	15249	28761	53.02%	15.37%	31	33
14	嘉義縣太保市	2018-11-25T06:29:14+08:00	4847	10763	15610	1198	16808	31568	53.24%	15.35%	33	33
14	嘉義縣太保市	2018-11-25T00:14:07+08:00	4638	10367	15005	1092	16097	30290	53.14%	15.31%	32	33
14	嘉義縣太保市	2018-11-24T23:01:29+08:00	4141	9277	13418	980	14398	27250	52.84%	15.2%	30	33
14	嘉義縣太保市	2018-11-25T01:07:24+08:00	4847	10763	15610	1198	16808	31568	53.24%	15.35%	33	33
14	嘉義縣太保市	2018-11-25T06:13:50+08:00	4847	10763	15610	1198	16808	31568	53.24%	15.35%	33	33
14	嘉義縣太保市	2018-11-24T23:35:08+08:00	4420	9799	14219	1030	15249	28761	53.02%	15.37%	31	33
14	嘉義縣太保市	2018-11-24T22:33:35+08:00	3911	8731	12642	951	13593	25677	52.94%	15.23%	29	33
14	嘉義縣太保市	2018-11-24T23:08:33+08:00	4141	9277	13418	980	14398	27250	52.84%	15.2%	30	33
14	嘉義縣太保市	2018-11-25T03:32:32+08:00	4847	10763	15610	1198	16808	31568	53.24%	15.35%	33	33
14	嘉義縣太保市	2018-11-24T23:19:48+08:00	4141	9277	13418	980	14398	27250	52.84%	15.2%	30	33
14	嘉義縣太保市	2018-11-25T03:44:20+08:00	4847	10763	15610	1198	16808	31568	53.24%	15.35%	33	33
14	嘉義縣太保市	2018-11-24T22:13:24+08:00	3911	8731	12642	951	13593	25677	52.94%	15.23%	29	33
14	嘉義縣太保市	2018-11-25T00:00:08+08:00	4638	10367	15005	1092	16097	30290	53.14%	15.31%	32	33
14	嘉義縣太保市	2018-11-24T23:55:44+08:00	4638	10367	15005	1092	16097	30290	53.14%	15.31%	32	33
14	嘉義縣太保市	2018-11-25T01:17:49+08:00	4847	10763	15610	1198	16808	31568	53.24%	15.35%	33	33
14	嘉義縣太保市	2018-11-25T06:18:55+08:00	4847	10763	15610	1198	16808	31568	53.24%	15.35%	33	33
14	嘉義縣太保市	2018-11-25T01:02:28+08:00	4847	10763	15610	1198	16808	31568	53.24%	15.35%	33	33
14	嘉義縣太保市	2018-11-24T23:27:16+08:00	4420	9799	14219	1030	15249	28761	53.02%	15.37%	31	33
14	嘉義縣太保市	2018-11-24T22:23:10+08:00	3911	8731	12642	951	13593	25677	52.94%	15.23%	29	33
14	嘉義縣太保市	2018-11-24T22:30:03+08:00	3911	8731	12642	951	13593	25677	52.94%	15.23%	29	33
14	嘉義縣太保市	2018-11-24T23:51:32+08:00	4420	9799	14219	1030	15249	28761	53.02%	15.37%	31	33
14	嘉義縣太保市	2018-11-25T00:05:02+08:00	4638	10367	15005	1092	16097	30290	53.14%	15.31%	32	33
14	嘉義縣太保市	2018-11-24T22:41:32+08:00	3911	8731	12642	951	13593	25677	52.94%	15.23%	29	33
14	嘉義縣太保市	2018-11-24T22:54:23+08:00	4141	9277	13418	980	14398	27250	52.84%	15.2%	30	33
14	嘉義縣太保市	2018-11-24T23:05:02+08:00	4141	9277	13418	980	14398	27250	52.84%	15.2%	30	33
14	嘉義縣太保市	2018-11-25T03:56:09+08:00	4847	10763	15610	1198	16808	31568	53.24%	15.35%	33	33
14	嘉義縣太保市	2018-11-25T00:18:27+08:00	4638	10367	15005	1092	16097	30290	53.14%	15.31%	32	33
14	金門縣烏坵鄉	2018-11-24T22:33:39+08:00	37	124	161	4	165	567	29.1%	6.53%	2	2
14	金門縣烏坵鄉	2018-11-25T03:49:52+08:00	37	124	161	4	165	567	29.1%	6.53%	2	2
14	金門縣烏坵鄉	2018-11-24T23:43:18+08:00	37	124	161	4	165	567	29.1%	6.53%	2	2
14	金門縣烏坵鄉	2018-11-25T06:29:18+08:00	37	124	161	4	165	567	29.1%	6.53%	2	2
14	金門縣烏坵鄉	2018-11-25T01:07:27+08:00	37	124	161	4	165	567	29.1%	6.53%	2	2
14	金門縣烏坵鄉	2018-11-25T06:13:54+08:00	37	124	161	4	165	567	29.1%	6.53%	2	2
14	金門縣烏坵鄉	2018-11-24T23:08:37+08:00	37	124	161	4	165	567	29.1%	6.53%	2	2
14	金門縣烏坵鄉	2018-11-25T03:32:36+08:00	37	124	161	4	165	567	29.1%	6.53%	2	2
14	金門縣烏坵鄉	2018-11-24T23:55:48+08:00	37	124	161	4	165	567	29.1%	6.53%	2	2
14	金門縣烏坵鄉	2018-11-25T03:44:25+08:00	37	124	161	4	165	567	29.1%	6.53%	2	2
14	金門縣烏坵鄉	2018-11-24T22:13:28+08:00	37	124	161	4	165	567	29.1%	6.53%	2	2
14	金門縣烏坵鄉	2018-11-25T06:18:58+08:00	37	124	161	4	165	567	29.1%	6.53%	2	2
14	金門縣烏坵鄉	2018-11-24T22:40:29+08:00	37	124	161	4	165	567	29.1%	6.53%	2	2
14	金門縣烏坵鄉	2018-11-24T23:51:36+08:00	37	124	161	4	165	567	29.1%	6.53%	2	2
14	金門縣烏坵鄉	2018-11-24T22:23:14+08:00	37	124	161	4	165	567	29.1%	6.53%	2	2
14	金門縣烏坵鄉	2018-11-24T23:23:40+08:00	37	124	161	4	165	567	29.1%	6.53%	2	2
14	金門縣烏坵鄉	2018-11-24T22:54:27+08:00	37	124	161	4	165	567	29.1%	6.53%	2	2
14	金門縣烏坵鄉	2018-11-25T00:14:11+08:00	37	124	161	4	165	567	29.1%	6.53%	2	2
14	金門縣烏坵鄉	2018-11-25T00:05:06+08:00	37	124	161	4	165	567	29.1%	6.53%	2	2
14	金門縣烏坵鄉	2018-11-24T22:41:36+08:00	37	124	161	4	165	567	29.1%	6.53%	2	2
14	金門縣烏坵鄉	2018-11-24T22:16:12+08:00	37	124	161	4	165	567	29.1%	6.53%	2	2
14	金門縣烏坵鄉	2018-11-24T23:05:06+08:00	37	124	161	4	165	567	29.1%	6.53%	2	2
14	金門縣烏坵鄉	2018-11-24T22:45:10+08:00	37	124	161	4	165	567	29.1%	6.53%	2	2
14	金門縣烏坵鄉	2018-11-25T03:56:14+08:00	37	124	161	4	165	567	29.1%	6.53%	2	2
14	金門縣烏坵鄉	2018-11-24T22:37:02+08:00	37	124	161	4	165	567	29.1%	6.53%	2	2
14	金門縣烏坵鄉	2018-11-25T00:18:32+08:00	37	124	161	4	165	567	29.1%	6.53%	2	2
14	金門縣烏坵鄉	2018-11-24T23:16:04+08:00	37	124	161	4	165	567	29.1%	6.53%	2	2
14	金門縣烏坵鄉	2018-11-25T00:23:05+08:00	37	124	161	4	165	567	29.1%	6.53%	2	2
14	金門縣烏坵鄉	2018-11-25T01:25:54+08:00	37	124	161	4	165	567	29.1%	6.53%	2	2
14	金門縣烏坵鄉	2018-11-25T01:02:32+08:00	37	124	161	4	165	567	29.1%	6.53%	2	2
14	金門縣烏坵鄉	2018-11-25T06:24:01+08:00	37	124	161	4	165	567	29.1%	6.53%	2	2
14	金門縣烏坵鄉	2018-11-24T22:30:11+08:00	37	124	161	4	165	567	29.1%	6.53%	2	2
14	金門縣烏坵鄉	2018-11-25T03:38:56+08:00	37	124	161	4	165	567	29.1%	6.53%	2	2
14	金門縣烏坵鄉	2018-11-24T22:19:38+08:00	37	124	161	4	165	567	29.1%	6.53%	2	2
14	金門縣烏坵鄉	2018-11-24T23:19:53+08:00	37	124	161	4	165	567	29.1%	6.53%	2	2
14	金門縣烏坵鄉	2018-11-25T01:17:54+08:00	37	124	161	4	165	567	29.1%	6.53%	2	2
14	金門縣烏坵鄉	2018-11-25T00:00:12+08:00	37	124	161	4	165	567	29.1%	6.53%	2	2
14	金門縣烏坵鄉	2018-11-24T22:57:55+08:00	37	124	161	4	165	567	29.1%	6.53%	2	2
14	金門縣烏坵鄉	2018-11-24T23:27:20+08:00	37	124	161	4	165	567	29.1%	6.53%	2	2
14	金門縣烏坵鄉	2018-11-25T00:57:38+08:00	37	124	161	4	165	567	29.1%	6.53%	2	2
14	金門縣烏坵鄉	2018-11-24T23:35:12+08:00	37	124	161	4	165	567	29.1%	6.53%	2	2
14	金門縣烏坵鄉	2018-11-24T23:47:30+08:00	37	124	161	4	165	567	29.1%	6.53%	2	2
14	金門縣烏坵鄉	2018-11-25T00:09:36+08:00	37	124	161	4	165	567	29.1%	6.53%	2	2
14	金門縣烏坵鄉	2018-11-25T06:08:54+08:00	37	124	161	4	165	567	29.1%	6.53%	2	2
14	金門縣烏坵鄉	2018-11-24T23:39:17+08:00	37	124	161	4	165	567	29.1%	6.53%	2	2
14	金門縣烏坵鄉	2018-11-24T22:50:49+08:00	37	124	161	4	165	567	29.1%	6.53%	2	2
14	金門縣烏坵鄉	2018-11-24T23:31:13+08:00	37	124	161	4	165	567	29.1%	6.53%	2	2
14	金門縣烏坵鄉	2018-11-25T04:02:53+08:00	37	124	161	4	165	567	29.1%	6.53%	2	2
14	金門縣烏坵鄉	2018-11-24T23:01:32+08:00	37	124	161	4	165	567	29.1%	6.53%	2	2
14	金門縣烏坵鄉	2018-11-25T01:12:45+08:00	37	124	161	4	165	567	29.1%	6.53%	2	2
14	金門縣烏坵鄉	2018-11-24T22:26:38+08:00	37	124	161	4	165	567	29.1%	6.53%	2	2
14	金門縣烏坵鄉	2018-11-24T23:12:17+08:00	37	124	161	4	165	567	29.1%	6.53%	2	2
14	嘉義縣鹿草鄉	2018-11-25T03:56:10+08:00	1839	3973	5812	755	6567	13937	47.12%	13.2%	20	20
14	嘉義縣鹿草鄉	2018-11-24T23:47:26+08:00	1839	3973	5812	755	6567	13937	47.12%	13.2%	20	20
14	嘉義縣鹿草鄉	2018-11-24T23:16:01+08:00	1639	3561	5200	707	5907	12625	46.79%	12.98%	19	20
14	嘉義縣鹿草鄉	2018-11-24T22:16:08+08:00	1560	3272	4832	629	5461	11795	46.3%	13.23%	18	20
14	嘉義縣鹿草鄉	2018-11-24T22:33:36+08:00	1639	3561	5200	707	5907	12625	46.79%	12.98%	19	20
14	嘉義縣鹿草鄉	2018-11-25T03:38:53+08:00	1839	3973	5812	755	6567	13937	47.12%	13.2%	20	20
14	嘉義縣鹿草鄉	2018-11-24T23:23:36+08:00	1839	3973	5812	755	6567	13937	47.12%	13.2%	20	20
14	嘉義縣鹿草鄉	2018-11-25T01:25:51+08:00	1839	3973	5812	755	6567	13937	47.12%	13.2%	20	20
14	嘉義縣鹿草鄉	2018-11-24T22:19:35+08:00	1560	3272	4832	629	5461	11795	46.3%	13.23%	18	20
14	嘉義縣鹿草鄉	2018-11-25T00:57:34+08:00	1839	3973	5812	755	6567	13937	47.12%	13.2%	20	20
14	嘉義縣鹿草鄉	2018-11-25T01:17:50+08:00	1839	3973	5812	755	6567	13937	47.12%	13.2%	20	20
14	嘉義縣鹿草鄉	2018-11-24T22:40:26+08:00	1639	3561	5200	707	5907	12625	46.79%	12.98%	19	20
14	嘉義縣鹿草鄉	2018-11-24T22:36:58+08:00	1639	3561	5200	707	5907	12625	46.79%	12.98%	19	20
14	嘉義縣鹿草鄉	2018-11-24T22:57:51+08:00	1639	3561	5200	707	5907	12625	46.79%	12.98%	19	20
14	嘉義縣鹿草鄉	2018-11-25T00:09:32+08:00	1839	3973	5812	755	6567	13937	47.12%	13.2%	20	20
14	嘉義縣鹿草鄉	2018-11-25T06:08:50+08:00	1839	3973	5812	755	6567	13937	47.12%	13.2%	20	20
14	嘉義縣鹿草鄉	2018-11-25T06:23:58+08:00	1839	3973	5812	755	6567	13937	47.12%	13.2%	20	20
14	嘉義縣鹿草鄉	2018-11-24T23:39:13+08:00	1839	3973	5812	755	6567	13937	47.12%	13.2%	20	20
14	嘉義縣鹿草鄉	2018-11-25T03:49:49+08:00	1839	3973	5812	755	6567	13937	47.12%	13.2%	20	20
14	嘉義縣鹿草鄉	2018-11-25T01:12:41+08:00	1839	3973	5812	755	6567	13937	47.12%	13.2%	20	20
14	嘉義縣鹿草鄉	2018-11-24T22:26:35+08:00	1639	3561	5200	707	5907	12625	46.79%	12.98%	19	20
14	嘉義縣鹿草鄉	2018-11-24T22:45:07+08:00	1639	3561	5200	707	5907	12625	46.79%	12.98%	19	20
14	嘉義縣鹿草鄉	2018-11-24T23:12:13+08:00	1639	3561	5200	707	5907	12625	46.79%	12.98%	19	20
14	嘉義縣鹿草鄉	2018-11-25T04:02:50+08:00	1839	3973	5812	755	6567	13937	47.12%	13.2%	20	20
14	嘉義縣鹿草鄉	2018-11-24T23:43:15+08:00	1839	3973	5812	755	6567	13937	47.12%	13.2%	20	20
14	嘉義縣鹿草鄉	2018-11-25T00:14:07+08:00	1839	3973	5812	755	6567	13937	47.12%	13.2%	20	20
14	嘉義縣鹿草鄉	2018-11-24T23:01:29+08:00	1639	3561	5200	707	5907	12625	46.79%	12.98%	19	20
14	嘉義縣鹿草鄉	2018-11-25T01:07:24+08:00	1839	3973	5812	755	6567	13937	47.12%	13.2%	20	20
14	嘉義縣鹿草鄉	2018-11-24T23:31:09+08:00	1839	3973	5812	755	6567	13937	47.12%	13.2%	20	20
14	嘉義縣鹿草鄉	2018-11-25T06:13:50+08:00	1839	3973	5812	755	6567	13937	47.12%	13.2%	20	20
14	嘉義縣鹿草鄉	2018-11-24T23:35:08+08:00	1839	3973	5812	755	6567	13937	47.12%	13.2%	20	20
14	嘉義縣鹿草鄉	2018-11-25T06:29:15+08:00	1839	3973	5812	755	6567	13937	47.12%	13.2%	20	20
14	嘉義縣鹿草鄉	2018-11-24T23:55:45+08:00	1839	3973	5812	755	6567	13937	47.12%	13.2%	20	20
14	嘉義縣鹿草鄉	2018-11-24T23:08:34+08:00	1639	3561	5200	707	5907	12625	46.79%	12.98%	19	20
14	嘉義縣鹿草鄉	2018-11-25T03:32:32+08:00	1839	3973	5812	755	6567	13937	47.12%	13.2%	20	20
14	嘉義縣鹿草鄉	2018-11-25T00:00:09+08:00	1839	3973	5812	755	6567	13937	47.12%	13.2%	20	20
14	嘉義縣鹿草鄉	2018-11-25T00:23:02+08:00	1839	3973	5812	755	6567	13937	47.12%	13.2%	20	20
14	嘉義縣鹿草鄉	2018-11-24T23:19:48+08:00	1839	3973	5812	755	6567	13937	47.12%	13.2%	20	20
14	嘉義縣鹿草鄉	2018-11-25T03:44:20+08:00	1839	3973	5812	755	6567	13937	47.12%	13.2%	20	20
14	嘉義縣鹿草鄉	2018-11-24T22:13:25+08:00	1560	3272	4832	629	5461	11795	46.3%	13.23%	18	20
14	嘉義縣鹿草鄉	2018-11-24T22:23:11+08:00	1639	3561	5200	707	5907	12625	46.79%	12.98%	19	20
14	嘉義縣鹿草鄉	2018-11-24T23:51:33+08:00	1839	3973	5812	755	6567	13937	47.12%	13.2%	20	20
14	嘉義縣鹿草鄉	2018-11-25T06:18:55+08:00	1839	3973	5812	755	6567	13937	47.12%	13.2%	20	20
14	嘉義縣鹿草鄉	2018-11-25T01:02:28+08:00	1839	3973	5812	755	6567	13937	47.12%	13.2%	20	20
14	嘉義縣鹿草鄉	2018-11-24T23:27:16+08:00	1839	3973	5812	755	6567	13937	47.12%	13.2%	20	20
14	嘉義縣鹿草鄉	2018-11-24T22:30:04+08:00	1639	3561	5200	707	5907	12625	46.79%	12.98%	19	20
14	嘉義縣鹿草鄉	2018-11-24T23:05:03+08:00	1639	3561	5200	707	5907	12625	46.79%	12.98%	19	20
14	嘉義縣鹿草鄉	2018-11-24T22:54:24+08:00	1639	3561	5200	707	5907	12625	46.79%	12.98%	19	20
14	嘉義縣鹿草鄉	2018-11-25T00:18:28+08:00	1839	3973	5812	755	6567	13937	47.12%	13.2%	20	20
14	嘉義縣鹿草鄉	2018-11-24T22:41:33+08:00	1639	3561	5200	707	5907	12625	46.79%	12.98%	19	20
14	嘉義縣鹿草鄉	2018-11-25T00:05:03+08:00	1839	3973	5812	755	6567	13937	47.12%	13.2%	20	20
14	嘉義縣鹿草鄉	2018-11-24T22:50:46+08:00	1639	3561	5200	707	5907	12625	46.79%	12.98%	19	20
14	高雄市路竹區	2018-11-25T04:02:43+08:00	7707	16540	24247	1715	25962	43850	59.21%	17.58%	41	41
14	高雄市路竹區	2018-11-25T01:12:37+08:00	7707	16540	24247	1715	25962	43850	59.21%	17.58%	41	41
14	高雄市路竹區	2018-11-25T00:14:03+08:00	7707	16540	24247	1715	25962	43850	59.21%	17.58%	41	41
14	高雄市路竹區	2018-11-24T23:01:25+08:00	7707	16540	24247	1715	25962	43850	59.21%	17.58%	41	41
14	高雄市路竹區	2018-11-24T23:12:09+08:00	7707	16540	24247	1715	25962	43850	59.21%	17.58%	41	41
14	高雄市路竹區	2018-11-24T23:39:08+08:00	7707	16540	24247	1715	25962	43850	59.21%	17.58%	41	41
14	高雄市路竹區	2018-11-25T00:09:27+08:00	7707	16540	24247	1715	25962	43850	59.21%	17.58%	41	41
14	高雄市路竹區	2018-11-24T23:35:05+08:00	7707	16540	24247	1715	25962	43850	59.21%	17.58%	41	41
14	高雄市路竹區	2018-11-25T06:29:11+08:00	7707	16540	24247	1715	25962	43850	59.21%	17.58%	41	41
14	高雄市路竹區	2018-11-25T01:07:20+08:00	7707	16540	24247	1715	25962	43850	59.21%	17.58%	41	41
14	高雄市路竹區	2018-11-24T23:31:04+08:00	7707	16540	24247	1715	25962	43850	59.21%	17.58%	41	41
14	高雄市路竹區	2018-11-25T01:17:45+08:00	7707	16540	24247	1715	25962	43850	59.21%	17.58%	41	41
14	高雄市路竹區	2018-11-24T22:13:20+08:00	6780	14320	21100	1518	22618	38317	59.03%	17.69%	37	41
14	高雄市路竹區	2018-11-24T23:55:41+08:00	7707	16540	24247	1715	25962	43850	59.21%	17.58%	41	41
14	高雄市路竹區	2018-11-24T22:23:06+08:00	7052	14984	22036	1567	23603	39854	59.22%	17.69%	38	41
14	高雄市路竹區	2018-11-24T23:19:43+08:00	7707	16540	24247	1715	25962	43850	59.21%	17.58%	41	41
14	高雄市路竹區	2018-11-24T23:04:58+08:00	7707	16540	24247	1715	25962	43850	59.21%	17.58%	41	41
14	高雄市路竹區	2018-11-25T00:00:02+08:00	7707	16540	24247	1715	25962	43850	59.21%	17.58%	41	41
14	高雄市路竹區	2018-11-25T00:04:59+08:00	7707	16540	24247	1715	25962	43850	59.21%	17.58%	41	41
14	高雄市路竹區	2018-11-24T23:27:13+08:00	7707	16540	24247	1715	25962	43850	59.21%	17.58%	41	41
14	高雄市路竹區	2018-11-24T22:30:00+08:00	7253	15460	22713	1616	24329	41031	59.29%	17.68%	39	41
14	高雄市路竹區	2018-11-25T01:02:25+08:00	7707	16540	24247	1715	25962	43850	59.21%	17.58%	41	41
14	高雄市路竹區	2018-11-25T06:13:47+08:00	7707	16540	24247	1715	25962	43850	59.21%	17.58%	41	41
14	高雄市路竹區	2018-11-24T22:54:20+08:00	7707	16540	24247	1715	25962	43850	59.21%	17.58%	41	41
14	高雄市路竹區	2018-11-25T00:22:58+08:00	7707	16540	24247	1715	25962	43850	59.21%	17.58%	41	41
14	高雄市路竹區	2018-11-25T03:56:05+08:00	7707	16540	24247	1715	25962	43850	59.21%	17.58%	41	41
14	高雄市路竹區	2018-11-24T22:26:32+08:00	7052	14984	22036	1567	23603	39854	59.22%	17.69%	38	41
14	高雄市路竹區	2018-11-25T00:18:24+08:00	7707	16540	24247	1715	25962	43850	59.21%	17.58%	41	41
14	高雄市路竹區	2018-11-24T22:41:30+08:00	7707	16540	24247	1715	25962	43850	59.21%	17.58%	41	41
14	高雄市路竹區	2018-11-25T03:49:46+08:00	7707	16540	24247	1715	25962	43850	59.21%	17.58%	41	41
14	高雄市路竹區	2018-11-25T06:08:46+08:00	7707	16540	24247	1715	25962	43850	59.21%	17.58%	41	41
14	高雄市路竹區	2018-11-24T23:43:12+08:00	7707	16540	24247	1715	25962	43850	59.21%	17.58%	41	41
14	高雄市路竹區	2018-11-24T23:47:22+08:00	7707	16540	24247	1715	25962	43850	59.21%	17.58%	41	41
14	高雄市路竹區	2018-11-24T22:16:04+08:00	6780	14320	21100	1518	22618	38317	59.03%	17.69%	37	41
14	高雄市路竹區	2018-11-24T22:33:32+08:00	7253	15460	22713	1616	24329	41031	59.29%	17.68%	39	41
14	高雄市路竹區	2018-11-25T03:44:16+08:00	7707	16540	24247	1715	25962	43850	59.21%	17.58%	41	41
14	高雄市路竹區	2018-11-25T03:38:50+08:00	7707	16540	24247	1715	25962	43850	59.21%	17.58%	41	41
14	高雄市路竹區	2018-11-24T23:23:33+08:00	7707	16540	24247	1715	25962	43850	59.21%	17.58%	41	41
14	高雄市路竹區	2018-11-24T23:51:29+08:00	7707	16540	24247	1715	25962	43850	59.21%	17.58%	41	41
14	高雄市路竹區	2018-11-24T22:57:47+08:00	7707	16540	24247	1715	25962	43850	59.21%	17.58%	41	41
14	高雄市路竹區	2018-11-24T22:19:31+08:00	7052	14984	22036	1567	23603	39854	59.22%	17.69%	38	41
14	高雄市路竹區	2018-11-24T22:40:23+08:00	7707	16540	24247	1715	25962	43850	59.21%	17.58%	41	41
14	高雄市路竹區	2018-11-25T03:32:29+08:00	7707	16540	24247	1715	25962	43850	59.21%	17.58%	41	41
14	高雄市路竹區	2018-11-25T06:18:52+08:00	7707	16540	24247	1715	25962	43850	59.21%	17.58%	41	41
14	高雄市路竹區	2018-11-25T00:57:31+08:00	7707	16540	24247	1715	25962	43850	59.21%	17.58%	41	41
14	高雄市路竹區	2018-11-25T01:25:47+08:00	7707	16540	24247	1715	25962	43850	59.21%	17.58%	41	41
14	高雄市路竹區	2018-11-24T22:36:55+08:00	7446	15922	23368	1663	25031	42213	59.3%	17.64%	40	41
14	高雄市路竹區	2018-11-24T23:08:29+08:00	7707	16540	24247	1715	25962	43850	59.21%	17.58%	41	41
14	高雄市路竹區	2018-11-24T23:15:57+08:00	7707	16540	24247	1715	25962	43850	59.21%	17.58%	41	41
14	高雄市路竹區	2018-11-25T06:23:54+08:00	7707	16540	24247	1715	25962	43850	59.21%	17.58%	41	41
14	高雄市路竹區	2018-11-24T22:50:41+08:00	7707	16540	24247	1715	25962	43850	59.21%	17.58%	41	41
14	高雄市路竹區	2018-11-24T22:45:03+08:00	7707	16540	24247	1715	25962	43850	59.21%	17.58%	41	41
14	高雄市杉林區	2018-11-25T04:02:43+08:00	1180	3386	4566	432	4998	10607	47.12%	11.12%	10	10
14	高雄市杉林區	2018-11-25T01:12:37+08:00	1180	3386	4566	432	4998	10607	47.12%	11.12%	10	10
14	高雄市杉林區	2018-11-25T00:14:04+08:00	1180	3386	4566	432	4998	10607	47.12%	11.12%	10	10
14	高雄市杉林區	2018-11-24T23:31:05+08:00	1180	3386	4566	432	4998	10607	47.12%	11.12%	10	10
14	高雄市杉林區	2018-11-25T01:07:21+08:00	1180	3386	4566	432	4998	10607	47.12%	11.12%	10	10
14	高雄市杉林區	2018-11-24T23:35:05+08:00	1180	3386	4566	432	4998	10607	47.12%	11.12%	10	10
14	高雄市杉林區	2018-11-25T06:29:11+08:00	1180	3386	4566	432	4998	10607	47.12%	11.12%	10	10
14	高雄市杉林區	2018-11-24T23:39:09+08:00	1180	3386	4566	432	4998	10607	47.12%	11.12%	10	10
14	高雄市杉林區	2018-11-25T00:09:28+08:00	1180	3386	4566	432	4998	10607	47.12%	11.12%	10	10
14	高雄市杉林區	2018-11-25T01:17:45+08:00	1180	3386	4566	432	4998	10607	47.12%	11.12%	10	10
14	高雄市杉林區	2018-11-24T22:23:07+08:00	1180	3386	4566	432	4998	10607	47.12%	11.12%	10	10
14	高雄市杉林區	2018-11-24T23:55:41+08:00	1180	3386	4566	432	4998	10607	47.12%	11.12%	10	10
14	高雄市杉林區	2018-11-24T23:08:30+08:00	1180	3386	4566	432	4998	10607	47.12%	11.12%	10	10
14	高雄市杉林區	2018-11-24T23:04:59+08:00	1180	3386	4566	432	4998	10607	47.12%	11.12%	10	10
14	高雄市杉林區	2018-11-24T23:19:44+08:00	1180	3386	4566	432	4998	10607	47.12%	11.12%	10	10
14	高雄市杉林區	2018-11-24T22:13:21+08:00	1180	3386	4566	432	4998	10607	47.12%	11.12%	10	10
14	高雄市杉林區	2018-11-25T00:00:02+08:00	1180	3386	4566	432	4998	10607	47.12%	11.12%	10	10
14	高雄市杉林區	2018-11-24T23:27:13+08:00	1180	3386	4566	432	4998	10607	47.12%	11.12%	10	10
14	高雄市杉林區	2018-11-24T22:19:32+08:00	1180	3386	4566	432	4998	10607	47.12%	11.12%	10	10
14	高雄市杉林區	2018-11-24T22:30:00+08:00	1180	3386	4566	432	4998	10607	47.12%	11.12%	10	10
14	高雄市杉林區	2018-11-25T01:02:25+08:00	1180	3386	4566	432	4998	10607	47.12%	11.12%	10	10
14	高雄市杉林區	2018-11-25T06:13:47+08:00	1180	3386	4566	432	4998	10607	47.12%	11.12%	10	10
14	高雄市杉林區	2018-11-25T00:22:58+08:00	1180	3386	4566	432	4998	10607	47.12%	11.12%	10	10
14	高雄市杉林區	2018-11-24T22:26:32+08:00	1180	3386	4566	432	4998	10607	47.12%	11.12%	10	10
14	高雄市杉林區	2018-11-25T00:18:24+08:00	1180	3386	4566	432	4998	10607	47.12%	11.12%	10	10
14	高雄市杉林區	2018-11-24T22:50:42+08:00	1180	3386	4566	432	4998	10607	47.12%	11.12%	10	10
14	高雄市杉林區	2018-11-24T22:54:21+08:00	1180	3386	4566	432	4998	10607	47.12%	11.12%	10	10
14	高雄市杉林區	2018-11-25T00:05:00+08:00	1180	3386	4566	432	4998	10607	47.12%	11.12%	10	10
14	高雄市杉林區	2018-11-24T22:41:30+08:00	1180	3386	4566	432	4998	10607	47.12%	11.12%	10	10
14	高雄市杉林區	2018-11-25T03:49:46+08:00	1180	3386	4566	432	4998	10607	47.12%	11.12%	10	10
14	高雄市杉林區	2018-11-24T23:01:26+08:00	1180	3386	4566	432	4998	10607	47.12%	11.12%	10	10
14	高雄市杉林區	2018-11-25T06:08:46+08:00	1180	3386	4566	432	4998	10607	47.12%	11.12%	10	10
14	高雄市杉林區	2018-11-24T23:43:12+08:00	1180	3386	4566	432	4998	10607	47.12%	11.12%	10	10
14	高雄市杉林區	2018-11-24T23:47:22+08:00	1180	3386	4566	432	4998	10607	47.12%	11.12%	10	10
14	高雄市杉林區	2018-11-24T22:16:04+08:00	1180	3386	4566	432	4998	10607	47.12%	11.12%	10	10
14	高雄市杉林區	2018-11-24T22:33:32+08:00	1180	3386	4566	432	4998	10607	47.12%	11.12%	10	10
14	高雄市杉林區	2018-11-25T03:44:16+08:00	1180	3386	4566	432	4998	10607	47.12%	11.12%	10	10
14	高雄市杉林區	2018-11-25T03:38:50+08:00	1180	3386	4566	432	4998	10607	47.12%	11.12%	10	10
14	高雄市杉林區	2018-11-24T23:23:33+08:00	1180	3386	4566	432	4998	10607	47.12%	11.12%	10	10
14	高雄市杉林區	2018-11-24T23:51:29+08:00	1180	3386	4566	432	4998	10607	47.12%	11.12%	10	10
14	高雄市杉林區	2018-11-24T22:57:47+08:00	1180	3386	4566	432	4998	10607	47.12%	11.12%	10	10
14	高雄市杉林區	2018-11-24T22:40:23+08:00	1180	3386	4566	432	4998	10607	47.12%	11.12%	10	10
14	高雄市杉林區	2018-11-25T03:32:29+08:00	1180	3386	4566	432	4998	10607	47.12%	11.12%	10	10
14	高雄市杉林區	2018-11-25T06:18:52+08:00	1180	3386	4566	432	4998	10607	47.12%	11.12%	10	10
14	高雄市杉林區	2018-11-24T23:15:58+08:00	1180	3386	4566	432	4998	10607	47.12%	11.12%	10	10
14	高雄市杉林區	2018-11-25T00:57:31+08:00	1180	3386	4566	432	4998	10607	47.12%	11.12%	10	10
14	高雄市杉林區	2018-11-25T01:25:47+08:00	1180	3386	4566	432	4998	10607	47.12%	11.12%	10	10
14	高雄市杉林區	2018-11-24T22:36:55+08:00	1180	3386	4566	432	4998	10607	47.12%	11.12%	10	10
14	高雄市杉林區	2018-11-25T03:56:06+08:00	1180	3386	4566	432	4998	10607	47.12%	11.12%	10	10
14	高雄市杉林區	2018-11-25T06:23:55+08:00	1180	3386	4566	432	4998	10607	47.12%	11.12%	10	10
14	高雄市杉林區	2018-11-24T23:12:10+08:00	1180	3386	4566	432	4998	10607	47.12%	11.12%	10	10
14	高雄市杉林區	2018-11-24T22:45:03+08:00	1180	3386	4566	432	4998	10607	47.12%	11.12%	10	10
14	澎湖縣湖西鄉	2018-11-24T22:33:39+08:00	1332	3425	4757	329	5086	11895	42.76%	11.2%	22	23
14	澎湖縣湖西鄉	2018-11-25T03:49:52+08:00	1445	3701	5146	378	5524	12741	43.36%	11.34%	23	23
14	澎湖縣湖西鄉	2018-11-24T23:43:18+08:00	1445	3701	5146	378	5524	12741	43.36%	11.34%	23	23
14	澎湖縣湖西鄉	2018-11-24T23:47:29+08:00	1445	3701	5146	378	5524	12741	43.36%	11.34%	23	23
14	澎湖縣湖西鄉	2018-11-25T06:29:18+08:00	1445	3701	5146	378	5524	12741	43.36%	11.34%	23	23
14	澎湖縣湖西鄉	2018-11-25T01:07:27+08:00	1445	3701	5146	378	5524	12741	43.36%	11.34%	23	23
14	澎湖縣湖西鄉	2018-11-25T06:13:53+08:00	1445	3701	5146	378	5524	12741	43.36%	11.34%	23	23
14	澎湖縣湖西鄉	2018-11-25T00:18:31+08:00	1445	3701	5146	378	5524	12741	43.36%	11.34%	23	23
14	澎湖縣湖西鄉	2018-11-24T22:37:01+08:00	1332	3425	4757	329	5086	11895	42.76%	11.2%	22	23
14	澎湖縣湖西鄉	2018-11-25T03:44:24+08:00	1445	3701	5146	378	5524	12741	43.36%	11.34%	23	23
14	澎湖縣湖西鄉	2018-11-24T23:08:37+08:00	1445	3701	5146	378	5524	12741	43.36%	11.34%	23	23
14	澎湖縣湖西鄉	2018-11-24T23:55:48+08:00	1445	3701	5146	378	5524	12741	43.36%	11.34%	23	23
14	澎湖縣湖西鄉	2018-11-24T22:13:28+08:00	1332	3425	4757	329	5086	11895	42.76%	11.2%	22	23
14	澎湖縣湖西鄉	2018-11-24T23:23:39+08:00	1445	3701	5146	378	5524	12741	43.36%	11.34%	23	23
14	澎湖縣湖西鄉	2018-11-25T06:18:58+08:00	1445	3701	5146	378	5524	12741	43.36%	11.34%	23	23
14	澎湖縣湖西鄉	2018-11-24T23:51:36+08:00	1445	3701	5146	378	5524	12741	43.36%	11.34%	23	23
14	澎湖縣湖西鄉	2018-11-24T22:23:14+08:00	1332	3425	4757	329	5086	11895	42.76%	11.2%	22	23
14	澎湖縣湖西鄉	2018-11-24T22:40:28+08:00	1332	3425	4757	329	5086	11895	42.76%	11.2%	22	23
14	澎湖縣湖西鄉	2018-11-25T00:09:35+08:00	1445	3701	5146	378	5524	12741	43.36%	11.34%	23	23
14	澎湖縣湖西鄉	2018-11-25T00:05:06+08:00	1445	3701	5146	378	5524	12741	43.36%	11.34%	23	23
14	澎湖縣湖西鄉	2018-11-24T22:41:36+08:00	1332	3425	4757	329	5086	11895	42.76%	11.2%	22	23
14	澎湖縣湖西鄉	2018-11-24T22:45:09+08:00	1332	3425	4757	329	5086	11895	42.76%	11.2%	22	23
14	澎湖縣湖西鄉	2018-11-24T22:54:26+08:00	1332	3425	4757	329	5086	11895	42.76%	11.2%	22	23
14	澎湖縣湖西鄉	2018-11-25T00:14:10+08:00	1445	3701	5146	378	5524	12741	43.36%	11.34%	23	23
14	澎湖縣湖西鄉	2018-11-25T03:56:13+08:00	1445	3701	5146	378	5524	12741	43.36%	11.34%	23	23
14	澎湖縣湖西鄉	2018-11-24T23:16:04+08:00	1445	3701	5146	378	5524	12741	43.36%	11.34%	23	23
14	澎湖縣湖西鄉	2018-11-25T03:32:35+08:00	1445	3701	5146	378	5524	12741	43.36%	11.34%	23	23
14	澎湖縣湖西鄉	2018-11-25T01:25:53+08:00	1445	3701	5146	378	5524	12741	43.36%	11.34%	23	23
14	澎湖縣湖西鄉	2018-11-25T01:02:32+08:00	1445	3701	5146	378	5524	12741	43.36%	11.34%	23	23
14	澎湖縣湖西鄉	2018-11-24T22:30:10+08:00	1332	3425	4757	329	5086	11895	42.76%	11.2%	22	23
14	澎湖縣湖西鄉	2018-11-25T00:23:04+08:00	1445	3701	5146	378	5524	12741	43.36%	11.34%	23	23
14	澎湖縣湖西鄉	2018-11-25T06:24:01+08:00	1445	3701	5146	378	5524	12741	43.36%	11.34%	23	23
14	澎湖縣湖西鄉	2018-11-25T03:38:56+08:00	1445	3701	5146	378	5524	12741	43.36%	11.34%	23	23
14	澎湖縣湖西鄉	2018-11-24T23:27:19+08:00	1445	3701	5146	378	5524	12741	43.36%	11.34%	23	23
14	澎湖縣湖西鄉	2018-11-24T22:19:38+08:00	1332	3425	4757	329	5086	11895	42.76%	11.2%	22	23
14	澎湖縣湖西鄉	2018-11-25T01:17:53+08:00	1445	3701	5146	378	5524	12741	43.36%	11.34%	23	23
14	澎湖縣湖西鄉	2018-11-25T00:00:12+08:00	1445	3701	5146	378	5524	12741	43.36%	11.34%	23	23
14	澎湖縣湖西鄉	2018-11-24T22:57:55+08:00	1332	3425	4757	329	5086	11895	42.76%	11.2%	22	23
14	澎湖縣湖西鄉	2018-11-24T23:19:52+08:00	1445	3701	5146	378	5524	12741	43.36%	11.34%	23	23
14	澎湖縣湖西鄉	2018-11-25T00:57:38+08:00	1445	3701	5146	378	5524	12741	43.36%	11.34%	23	23
14	澎湖縣湖西鄉	2018-11-24T23:35:12+08:00	1445	3701	5146	378	5524	12741	43.36%	11.34%	23	23
14	澎湖縣湖西鄉	2018-11-25T06:08:54+08:00	1445	3701	5146	378	5524	12741	43.36%	11.34%	23	23
14	澎湖縣湖西鄉	2018-11-24T23:12:16+08:00	1445	3701	5146	378	5524	12741	43.36%	11.34%	23	23
14	澎湖縣湖西鄉	2018-11-24T23:39:17+08:00	1445	3701	5146	378	5524	12741	43.36%	11.34%	23	23
14	澎湖縣湖西鄉	2018-11-25T01:12:44+08:00	1445	3701	5146	378	5524	12741	43.36%	11.34%	23	23
14	澎湖縣湖西鄉	2018-11-24T22:50:49+08:00	1332	3425	4757	329	5086	11895	42.76%	11.2%	22	23
14	澎湖縣湖西鄉	2018-11-24T22:26:37+08:00	1332	3425	4757	329	5086	11895	42.76%	11.2%	22	23
14	澎湖縣湖西鄉	2018-11-25T04:02:53+08:00	1445	3701	5146	378	5524	12741	43.36%	11.34%	23	23
14	澎湖縣湖西鄉	2018-11-24T23:05:05+08:00	1445	3701	5146	378	5524	12741	43.36%	11.34%	23	23
14	澎湖縣湖西鄉	2018-11-24T23:31:12+08:00	1445	3701	5146	378	5524	12741	43.36%	11.34%	23	23
14	澎湖縣湖西鄉	2018-11-24T22:16:11+08:00	1332	3425	4757	329	5086	11895	42.76%	11.2%	22	23
14	澎湖縣湖西鄉	2018-11-24T23:01:32+08:00	1332	3425	4757	329	5086	11895	42.76%	11.2%	22	23
14	高雄市鼓山區	2018-11-25T06:29:10+08:00	22096	43286	65382	3072	68454	114979	59.54%	19.22%	77	77
14	高雄市鼓山區	2018-11-24T23:35:04+08:00	15135	30136	45271	2343	47614	80093	59.45%	18.9%	58	77
14	高雄市鼓山區	2018-11-24T23:47:21+08:00	15970	31617	47587	2427	50014	83878	59.63%	19.04%	60	77
14	高雄市鼓山區	2018-11-24T23:12:09+08:00	12174	24484	36658	2063	38721	65666	58.97%	18.54%	50	77
14	高雄市鼓山區	2018-11-25T06:08:45+08:00	22096	43286	65382	3072	68454	114979	59.54%	19.22%	77	77
14	高雄市鼓山區	2018-11-24T23:43:11+08:00	15970	31617	47587	2427	50014	83878	59.63%	19.04%	60	77
14	高雄市鼓山區	2018-11-25T01:07:19+08:00	21092	41241	62333	2972	65305	109881	59.43%	19.2%	74	77
14	高雄市鼓山區	2018-11-24T22:33:31+08:00	8243	16852	25095	1510	26605	45417	58.58%	18.15%	37	77
14	高雄市鼓山區	2018-11-25T00:14:02+08:00	17507	34295	51802	2560	54362	91313	59.53%	19.17%	64	77
14	高雄市鼓山區	2018-11-25T01:12:36+08:00	21092	41241	62333	2972	65305	109881	59.43%	19.2%	74	77
14	高雄市鼓山區	2018-11-25T04:02:42+08:00	22096	43286	65382	3072	68454	114979	59.54%	19.22%	77	77
14	高雄市鼓山區	2018-11-25T00:09:26+08:00	17507	34295	51802	2560	54362	91313	59.53%	19.17%	64	77
14	高雄市鼓山區	2018-11-24T23:39:07+08:00	15135	30136	45271	2343	47614	80093	59.45%	18.9%	58	77
14	高雄市鼓山區	2018-11-24T23:31:03+08:00	14370	28590	42960	2280	45240	76191	59.38%	18.86%	56	77
14	高雄市鼓山區	2018-11-24T23:01:24+08:00	11113	22674	33787	1919	35706	60779	58.75%	18.28%	47	77
14	高雄市鼓山區	2018-11-25T03:44:15+08:00	22096	43286	65382	3072	68454	114979	59.54%	19.22%	77	77
14	高雄市鼓山區	2018-11-24T23:19:42+08:00	13241	26431	39672	2175	41847	70610	59.26%	18.75%	53	77
14	高雄市鼓山區	2018-11-24T22:13:20+08:00	5748	12055	17803	1213	19016	32776	58.02%	17.54%	29	77
14	高雄市鼓山區	2018-11-25T00:04:58+08:00	17104	33650	50754	2544	53298	89426	59.6%	19.13%	63	77
14	高雄市鼓山區	2018-11-25T01:17:44+08:00	21092	41241	62333	2972	65305	109881	59.43%	19.2%	74	77
14	高雄市鼓山區	2018-11-24T23:04:58+08:00	11597	23659	35256	2023	37279	63304	58.89%	18.32%	49	77
14	高雄市鼓山區	2018-11-24T23:55:40+08:00	16440	32334	48774	2461	51235	85876	59.66%	19.14%	61	77
14	高雄市鼓山區	2018-11-25T06:18:51+08:00	22096	43286	65382	3072	68454	114979	59.54%	19.22%	77	77
14	高雄市鼓山區	2018-11-25T01:02:24+08:00	20366	39686	60052	2917	62969	106102	59.35%	19.19%	72	77
14	高雄市鼓山區	2018-11-25T03:38:49+08:00	22096	43286	65382	3072	68454	114979	59.54%	19.22%	77	77
14	高雄市鼓山區	2018-11-24T23:27:12+08:00	14370	28590	42960	2280	45240	76191	59.38%	18.86%	56	77
14	高雄市鼓山區	2018-11-24T22:54:20+08:00	9525	19503	29028	1723	30751	52543	58.53%	18.13%	42	77
14	高雄市鼓山區	2018-11-25T00:18:23+08:00	17507	34295	51802	2560	54362	91313	59.53%	19.17%	64	77
14	高雄市鼓山區	2018-11-25T06:13:46+08:00	22096	43286	65382	3072	68454	114979	59.54%	19.22%	77	77
14	高雄市鼓山區	2018-11-25T00:22:57+08:00	17853	34982	52835	2611	55446	93122	59.54%	19.17%	65	77
14	高雄市鼓山區	2018-11-25T03:56:04+08:00	22096	43286	65382	3072	68454	114979	59.54%	19.22%	77	77
14	高雄市鼓山區	2018-11-24T22:41:29+08:00	8662	17722	26384	1617	28001	48016	58.32%	18.04%	39	77
14	高雄市鼓山區	2018-11-24T22:16:03+08:00	6136	12810	18946	1244	20190	34688	58.2%	17.69%	30	77
14	高雄市鼓山區	2018-11-24T22:29:59+08:00	8009	16323	24332	1485	25817	44265	58.32%	18.09%	36	77
14	高雄市鼓山區	2018-11-24T23:23:32+08:00	14026	27853	41879	2232	44111	74324	59.35%	18.87%	55	77
14	高雄市鼓山區	2018-11-24T23:51:28+08:00	16440	32334	48774	2461	51235	85876	59.66%	19.14%	61	77
14	高雄市鼓山區	2018-11-24T22:57:46+08:00	10619	21571	32190	1843	34033	57897	58.78%	18.34%	45	77
14	高雄市鼓山區	2018-11-25T00:00:01+08:00	16440	32334	48774	2461	51235	85876	59.66%	19.14%	61	77
14	高雄市鼓山區	2018-11-24T22:23:05+08:00	6921	14464	21385	1361	22746	39206	58.02%	17.65%	33	77
14	高雄市鼓山區	2018-11-24T22:36:54+08:00	8459	17260	25719	1582	27301	46775	58.37%	18.08%	38	77
14	高雄市鼓山區	2018-11-25T01:25:46+08:00	21092	41241	62333	2972	65305	109881	59.43%	19.2%	74	77
14	高雄市鼓山區	2018-11-24T22:19:31+08:00	6619	13793	20412	1323	21735	37461	58.02%	17.67%	32	77
14	高雄市鼓山區	2018-11-25T00:57:30+08:00	20366	39686	60052	2917	62969	106102	59.35%	19.19%	72	77
14	高雄市鼓山區	2018-11-24T23:08:28+08:00	12174	24484	36658	2063	38721	65666	58.97%	18.54%	50	77
14	高雄市鼓山區	2018-11-24T22:40:22+08:00	8662	17722	26384	1617	28001	48016	58.32%	18.04%	39	77
14	高雄市鼓山區	2018-11-24T23:15:57+08:00	12750	25639	38389	2147	40536	68651	59.05%	18.57%	52	77
14	高雄市鼓山區	2018-11-25T03:32:28+08:00	22096	43286	65382	3072	68454	114979	59.54%	19.22%	77	77
14	高雄市鼓山區	2018-11-24T22:45:02+08:00	8893	18308	27201	1643	28844	49409	58.38%	18%	40	77
14	高雄市鼓山區	2018-11-24T22:50:40+08:00	9108	18754	27862	1698	29560	50615	58.4%	17.99%	41	77
14	高雄市鼓山區	2018-11-25T03:49:45+08:00	22096	43286	65382	3072	68454	114979	59.54%	19.22%	77	77
14	高雄市鼓山區	2018-11-25T06:23:54+08:00	22096	43286	65382	3072	68454	114979	59.54%	19.22%	77	77
14	高雄市鼓山區	2018-11-24T22:26:31+08:00	7540	15645	23185	1456	24641	42405	58.11%	17.78%	35	77
14	高雄市鳳山區	2018-11-25T06:29:10+08:00	55389	114830	170219	9270	179489	300510	59.73%	18.43%	228	228
14	高雄市鳳山區	2018-11-24T23:35:04+08:00	42288	86297	128585	7294	135879	226459	60%	18.67%	182	228
14	高雄市鳳山區	2018-11-25T00:14:03+08:00	48300	99341	147641	8164	155805	260234	59.87%	18.56%	205	228
14	高雄市鳳山區	2018-11-24T23:01:25+08:00	35120	72099	107219	6235	113454	188885	60.07%	18.59%	155	228
14	高雄市鳳山區	2018-11-24T23:12:09+08:00	37089	75285	112374	6496	118870	197571	60.17%	18.77%	162	228
14	高雄市鳳山區	2018-11-25T06:08:45+08:00	55389	114830	170219	9270	179489	300510	59.73%	18.43%	228	228
14	高雄市鳳山區	2018-11-24T23:43:11+08:00	42832	87476	130308	7383	137691	229444	60.01%	18.67%	184	228
14	高雄市鳳山區	2018-11-24T23:39:08+08:00	42288	86297	128585	7294	135879	226459	60%	18.67%	182	228
14	高雄市鳳山區	2018-11-25T00:09:27+08:00	46879	96007	142886	7920	150806	251754	59.9%	18.62%	199	228
14	高雄市鳳山區	2018-11-24T22:33:31+08:00	27952	57704	85656	5074	90730	151363	59.94%	18.47%	127	228
14	高雄市鳳山區	2018-11-25T01:12:36+08:00	53583	110579	164162	8963	173125	289719	59.76%	18.49%	222	228
14	高雄市鳳山區	2018-11-25T04:02:42+08:00	55389	114830	170219	9270	179489	300510	59.73%	18.43%	228	228
14	高雄市鳳山區	2018-11-25T01:07:20+08:00	53284	109729	163013	8905	171918	287546	59.79%	18.53%	221	228
14	高雄市鳳山區	2018-11-24T23:31:04+08:00	41580	84557	126137	7125	133262	222305	59.95%	18.7%	179	228
14	高雄市鳳山區	2018-11-25T03:44:15+08:00	55101	114069	169170	9205	178375	298465	59.76%	18.46%	227	228
14	高雄市鳳山區	2018-11-24T22:13:20+08:00	22703	46062	68765	4163	72928	120945	60.3%	18.77%	105	228
14	高雄市鳳山區	2018-11-24T23:55:41+08:00	44393	90819	135212	7610	142822	237968	60.02%	18.66%	190	228
14	高雄市鳳山區	2018-11-24T22:23:06+08:00	24301	49681	73982	4468	78450	130594	60.07%	18.61%	112	228
14	高雄市鳳山區	2018-11-24T23:19:43+08:00	38801	78847	117648	6747	124395	207070	60.07%	18.74%	169	228
14	高雄市鳳山區	2018-11-25T01:17:44+08:00	53880	111227	165107	8994	174101	291431	59.74%	18.49%	223	228
14	高雄市鳳山區	2018-11-24T23:04:58+08:00	36458	73947	110405	6407	116812	194227	60.14%	18.77%	159	228
14	高雄市鳳山區	2018-11-25T00:00:02+08:00	44950	91894	136844	7700	144544	240964	59.99%	18.65%	192	228
14	高雄市鳳山區	2018-11-25T00:04:59+08:00	46411	94901	141312	7845	149157	248959	59.91%	18.64%	197	228
14	高雄市鳳山區	2018-11-25T06:18:51+08:00	55389	114830	170219	9270	179489	300510	59.73%	18.43%	228	228
14	高雄市鳳山區	2018-11-25T01:02:24+08:00	52913	108830	161743	8851	170594	285291	59.8%	18.55%	220	228
14	高雄市鳳山區	2018-11-24T23:27:13+08:00	39859	81087	120946	6937	127883	213270	59.96%	18.69%	173	228
14	高雄市鳳山區	2018-11-25T03:38:49+08:00	55101	114069	169170	9205	178375	298465	59.76%	18.46%	227	228
14	高雄市鳳山區	2018-11-24T22:30:00+08:00	26116	53460	79576	4754	84330	140503	60.02%	18.59%	119	228
14	高雄市鳳山區	2018-11-24T22:54:20+08:00	33553	68731	102284	5950	108234	180365	60.01%	18.6%	148	228
14	高雄市鳳山區	2018-11-25T03:56:05+08:00	55389	114830	170219	9270	179489	300510	59.73%	18.43%	228	228
14	高雄市鳳山區	2018-11-25T00:18:24+08:00	48300	99341	147641	8164	155805	260234	59.87%	18.56%	205	228
14	高雄市鳳山區	2018-11-25T06:13:46+08:00	55389	114830	170219	9270	179489	300510	59.73%	18.43%	228	228
14	高雄市鳳山區	2018-11-25T00:22:57+08:00	49266	101072	150338	8371	158709	265129	59.86%	18.58%	208	228
14	高雄市鳳山區	2018-11-24T23:47:22+08:00	43900	89796	133696	7531	141227	235324	60.01%	18.66%	188	228
14	高雄市鳳山區	2018-11-24T22:41:29+08:00	29909	61932	91841	5366	97207	161908	60.04%	18.47%	135	228
14	高雄市鳳山區	2018-11-24T22:16:03+08:00	23685	48058	71743	4358	76101	126574	60.12%	18.71%	109	228
14	高雄市鳳山區	2018-11-24T23:23:32+08:00	39572	80539	120111	6914	127025	211745	59.99%	18.69%	172	228
14	高雄市鳳山區	2018-11-24T23:51:28+08:00	44393	90819	135212	7610	142822	237968	60.02%	18.66%	190	228
14	高雄市鳳山區	2018-11-24T22:57:47+08:00	34491	70667	105158	6098	111256	185185	60.08%	18.63%	152	228
14	高雄市鳳山區	2018-11-25T01:25:46+08:00	54260	112103	166363	9039	175402	293528	59.76%	18.49%	224	228
14	高雄市鳳山區	2018-11-24T22:19:31+08:00	24059	49283	73342	4447	77789	129373	60.13%	18.6%	111	228
14	高雄市鳳山區	2018-11-25T00:57:30+08:00	52210	107490	159700	8772	168472	281439	59.86%	18.55%	218	228
14	高雄市鳳山區	2018-11-24T22:40:22+08:00	29909	61932	91841	5366	97207	161908	60.04%	18.47%	135	228
14	高雄市鳳山區	2018-11-24T22:36:55+08:00	28888	59625	88513	5222	93735	156199	60.01%	18.49%	131	228
14	高雄市鳳山區	2018-11-24T23:08:29+08:00	36948	74902	111850	6454	118304	196603	60.17%	18.79%	161	228
14	高雄市鳳山區	2018-11-24T23:15:57+08:00	38278	77790	116068	6656	122724	204356	60.05%	18.73%	167	228
14	高雄市鳳山區	2018-11-25T03:32:28+08:00	55101	114069	169170	9205	178375	298465	59.76%	18.46%	227	228
14	高雄市鳳山區	2018-11-25T03:49:45+08:00	55389	114830	170219	9270	179489	300510	59.73%	18.43%	228	228
14	高雄市鳳山區	2018-11-25T06:23:54+08:00	55389	114830	170219	9270	179489	300510	59.73%	18.43%	228	228
14	高雄市鳳山區	2018-11-24T22:26:31+08:00	25277	51729	77006	4607	81613	135788	60.1%	18.62%	116	228
14	高雄市鳳山區	2018-11-24T22:50:41+08:00	33345	68264	101609	5923	107532	179253	59.99%	18.6%	147	228
14	高雄市鳳山區	2018-11-24T22:45:03+08:00	30730	63771	94501	5510	100011	166542	60.05%	18.45%	138	228
14	苗栗縣南庄鄉	2018-11-25T04:02:44+08:00	1088	2956	4044	295	4339	8784	49.4%	12.39%	9	9
14	苗栗縣南庄鄉	2018-11-25T00:09:29+08:00	1088	2956	4044	295	4339	8784	49.4%	12.39%	9	9
14	苗栗縣南庄鄉	2018-11-25T01:12:38+08:00	1088	2956	4044	295	4339	8784	49.4%	12.39%	9	9
14	苗栗縣南庄鄉	2018-11-25T00:14:05+08:00	1088	2956	4044	295	4339	8784	49.4%	12.39%	9	9
14	苗栗縣南庄鄉	2018-11-24T23:19:45+08:00	1088	2956	4044	295	4339	8784	49.4%	12.39%	9	9
14	苗栗縣南庄鄉	2018-11-25T00:00:03+08:00	1088	2956	4044	295	4339	8784	49.4%	12.39%	9	9
14	苗栗縣南庄鄉	2018-11-24T22:23:08+08:00	927	2474	3401	239	3640	7431	48.98%	12.47%	8	9
14	苗栗縣南庄鄉	2018-11-24T23:08:31+08:00	1088	2956	4044	295	4339	8784	49.4%	12.39%	9	9
14	苗栗縣南庄鄉	2018-11-25T03:32:30+08:00	1088	2956	4044	295	4339	8784	49.4%	12.39%	9	9
14	苗栗縣南庄鄉	2018-11-24T23:51:30+08:00	1088	2956	4044	295	4339	8784	49.4%	12.39%	9	9
14	苗栗縣南庄鄉	2018-11-24T22:30:01+08:00	927	2474	3401	239	3640	7431	48.98%	12.47%	8	9
14	苗栗縣南庄鄉	2018-11-24T23:27:14+08:00	1088	2956	4044	295	4339	8784	49.4%	12.39%	9	9
14	苗栗縣南庄鄉	2018-11-24T22:19:33+08:00	927	2474	3401	239	3640	7431	48.98%	12.47%	8	9
14	苗栗縣南庄鄉	2018-11-25T00:57:32+08:00	1088	2956	4044	295	4339	8784	49.4%	12.39%	9	9
14	苗栗縣南庄鄉	2018-11-24T22:36:56+08:00	1088	2956	4044	295	4339	8784	49.4%	12.39%	9	9
14	苗栗縣南庄鄉	2018-11-24T22:50:43+08:00	1088	2956	4044	295	4339	8784	49.4%	12.39%	9	9
14	苗栗縣南庄鄉	2018-11-25T00:18:25+08:00	1088	2956	4044	295	4339	8784	49.4%	12.39%	9	9
14	苗栗縣南庄鄉	2018-11-25T06:23:56+08:00	1088	2956	4044	295	4339	8784	49.4%	12.39%	9	9
14	苗栗縣南庄鄉	2018-11-24T22:26:33+08:00	927	2474	3401	239	3640	7431	48.98%	12.47%	8	9
14	苗栗縣南庄鄉	2018-11-24T23:05:00+08:00	1088	2956	4044	295	4339	8784	49.4%	12.39%	9	9
14	苗栗縣南庄鄉	2018-11-25T03:49:47+08:00	1088	2956	4044	295	4339	8784	49.4%	12.39%	9	9
14	苗栗縣南庄鄉	2018-11-24T22:41:31+08:00	1088	2956	4044	295	4339	8784	49.4%	12.39%	9	9
14	苗栗縣南庄鄉	2018-11-25T00:05:01+08:00	1088	2956	4044	295	4339	8784	49.4%	12.39%	9	9
14	苗栗縣南庄鄉	2018-11-25T06:13:48+08:00	1088	2956	4044	295	4339	8784	49.4%	12.39%	9	9
14	苗栗縣南庄鄉	2018-11-25T00:22:59+08:00	1088	2956	4044	295	4339	8784	49.4%	12.39%	9	9
14	苗栗縣南庄鄉	2018-11-24T23:31:06+08:00	1088	2956	4044	295	4339	8784	49.4%	12.39%	9	9
14	苗栗縣南庄鄉	2018-11-24T22:16:05+08:00	927	2474	3401	239	3640	7431	48.98%	12.47%	8	9
14	苗栗縣南庄鄉	2018-11-25T01:07:22+08:00	1088	2956	4044	295	4339	8784	49.4%	12.39%	9	9
14	苗栗縣南庄鄉	2018-11-24T22:33:33+08:00	927	2474	3401	239	3640	7431	48.98%	12.47%	8	9
14	苗栗縣南庄鄉	2018-11-24T23:43:13+08:00	1088	2956	4044	295	4339	8784	49.4%	12.39%	9	9
14	苗栗縣南庄鄉	2018-11-25T06:08:47+08:00	1088	2956	4044	295	4339	8784	49.4%	12.39%	9	9
14	苗栗縣南庄鄉	2018-11-24T23:01:27+08:00	1088	2956	4044	295	4339	8784	49.4%	12.39%	9	9
14	苗栗縣南庄鄉	2018-11-24T23:35:06+08:00	1088	2956	4044	295	4339	8784	49.4%	12.39%	9	9
14	苗栗縣南庄鄉	2018-11-25T06:29:12+08:00	1088	2956	4044	295	4339	8784	49.4%	12.39%	9	9
14	苗栗縣南庄鄉	2018-11-24T23:47:24+08:00	1088	2956	4044	295	4339	8784	49.4%	12.39%	9	9
14	苗栗縣南庄鄉	2018-11-24T23:55:42+08:00	1088	2956	4044	295	4339	8784	49.4%	12.39%	9	9
14	苗栗縣南庄鄉	2018-11-24T22:57:48+08:00	1088	2956	4044	295	4339	8784	49.4%	12.39%	9	9
14	苗栗縣南庄鄉	2018-11-24T23:23:34+08:00	1088	2956	4044	295	4339	8784	49.4%	12.39%	9	9
14	苗栗縣南庄鄉	2018-11-25T03:38:51+08:00	1088	2956	4044	295	4339	8784	49.4%	12.39%	9	9
14	苗栗縣南庄鄉	2018-11-24T22:13:22+08:00	927	2474	3401	239	3640	7431	48.98%	12.47%	8	9
14	苗栗縣南庄鄉	2018-11-25T01:17:47+08:00	1088	2956	4044	295	4339	8784	49.4%	12.39%	9	9
14	苗栗縣南庄鄉	2018-11-25T03:44:17+08:00	1088	2956	4044	295	4339	8784	49.4%	12.39%	9	9
14	苗栗縣南庄鄉	2018-11-25T01:25:48+08:00	1088	2956	4044	295	4339	8784	49.4%	12.39%	9	9
14	苗栗縣南庄鄉	2018-11-24T22:40:24+08:00	1088	2956	4044	295	4339	8784	49.4%	12.39%	9	9
14	苗栗縣南庄鄉	2018-11-24T23:15:58+08:00	1088	2956	4044	295	4339	8784	49.4%	12.39%	9	9
14	苗栗縣南庄鄉	2018-11-25T01:02:26+08:00	1088	2956	4044	295	4339	8784	49.4%	12.39%	9	9
14	苗栗縣南庄鄉	2018-11-25T06:18:53+08:00	1088	2956	4044	295	4339	8784	49.4%	12.39%	9	9
14	苗栗縣南庄鄉	2018-11-24T23:12:11+08:00	1088	2956	4044	295	4339	8784	49.4%	12.39%	9	9
14	苗栗縣南庄鄉	2018-11-24T23:39:10+08:00	1088	2956	4044	295	4339	8784	49.4%	12.39%	9	9
14	苗栗縣南庄鄉	2018-11-25T03:56:07+08:00	1088	2956	4044	295	4339	8784	49.4%	12.39%	9	9
14	苗栗縣南庄鄉	2018-11-24T22:45:04+08:00	1088	2956	4044	295	4339	8784	49.4%	12.39%	9	9
14	苗栗縣南庄鄉	2018-11-24T22:54:22+08:00	1088	2956	4044	295	4339	8784	49.4%	12.39%	9	9
14	苗栗縣苗栗市	2018-11-25T04:02:44+08:00	11499	29449	40948	2019	42967	74249	57.87%	15.49%	67	67
14	苗栗縣苗栗市	2018-11-24T23:31:05+08:00	11499	29449	40948	2019	42967	74249	57.87%	15.49%	67	67
14	苗栗縣苗栗市	2018-11-25T01:07:21+08:00	11499	29449	40948	2019	42967	74249	57.87%	15.49%	67	67
14	苗栗縣苗栗市	2018-11-25T01:12:38+08:00	11499	29449	40948	2019	42967	74249	57.87%	15.49%	67	67
14	苗栗縣苗栗市	2018-11-25T00:14:05+08:00	11499	29449	40948	2019	42967	74249	57.87%	15.49%	67	67
14	苗栗縣苗栗市	2018-11-25T00:09:28+08:00	11499	29449	40948	2019	42967	74249	57.87%	15.49%	67	67
14	苗栗縣苗栗市	2018-11-24T23:19:45+08:00	11499	29449	40948	2019	42967	74249	57.87%	15.49%	67	67
14	苗栗縣苗栗市	2018-11-24T22:23:07+08:00	7306	18652	25958	1284	27242	47042	57.91%	15.53%	44	67
14	苗栗縣苗栗市	2018-11-25T00:00:03+08:00	11499	29449	40948	2019	42967	74249	57.87%	15.49%	67	67
14	苗栗縣苗栗市	2018-11-24T23:08:30+08:00	10672	27166	37838	1841	39679	68511	57.92%	15.58%	62	67
14	苗栗縣苗栗市	2018-11-24T22:13:21+08:00	6589	16807	23396	1174	24570	42686	57.56%	15.44%	40	67
14	苗栗縣苗栗市	2018-11-25T03:32:30+08:00	11499	29449	40948	2019	42967	74249	57.87%	15.49%	67	67
14	苗栗縣苗栗市	2018-11-24T23:51:30+08:00	11499	29449	40948	2019	42967	74249	57.87%	15.49%	67	67
14	苗栗縣苗栗市	2018-11-24T22:30:01+08:00	7717	19623	27340	1356	28696	49428	58.06%	15.61%	46	67
14	苗栗縣苗栗市	2018-11-24T23:27:14+08:00	11499	29449	40948	2019	42967	74249	57.87%	15.49%	67	67
14	苗栗縣苗栗市	2018-11-24T22:19:32+08:00	6942	17721	24663	1237	25900	44857	57.74%	15.48%	42	67
14	苗栗縣苗栗市	2018-11-25T00:57:32+08:00	11499	29449	40948	2019	42967	74249	57.87%	15.49%	67	67
14	苗栗縣苗栗市	2018-11-24T22:36:56+08:00	8399	21325	29724	1467	31191	53682	58.1%	15.65%	50	67
14	苗栗縣苗栗市	2018-11-25T00:18:25+08:00	11499	29449	40948	2019	42967	74249	57.87%	15.49%	67	67
14	苗栗縣苗栗市	2018-11-24T23:05:00+08:00	10267	26164	36431	1774	38205	65949	57.93%	15.57%	60	67
14	苗栗縣苗栗市	2018-11-25T03:49:47+08:00	11499	29449	40948	2019	42967	74249	57.87%	15.49%	67	67
14	苗栗縣苗栗市	2018-11-24T22:26:32+08:00	7467	19053	26520	1304	27824	48052	57.9%	15.54%	45	67
14	苗栗縣苗栗市	2018-11-25T06:13:48+08:00	11499	29449	40948	2019	42967	74249	57.87%	15.49%	67	67
14	苗栗縣苗栗市	2018-11-24T22:50:42+08:00	9098	23199	32297	1567	33864	58406	57.98%	15.58%	54	67
14	苗栗縣苗栗市	2018-11-24T22:54:21+08:00	9479	24116	33595	1630	35225	60750	57.98%	15.6%	56	67
14	苗栗縣苗栗市	2018-11-25T00:05:00+08:00	11499	29449	40948	2019	42967	74249	57.87%	15.49%	67	67
14	苗栗縣苗栗市	2018-11-24T22:41:30+08:00	8531	21727	30258	1484	31742	54647	58.09%	15.61%	51	67
14	苗栗縣苗栗市	2018-11-25T00:22:59+08:00	11499	29449	40948	2019	42967	74249	57.87%	15.49%	67	67
14	苗栗縣苗栗市	2018-11-24T22:16:05+08:00	6783	17223	24006	1205	25211	43738	57.64%	15.51%	41	67
14	苗栗縣苗栗市	2018-11-24T23:01:26+08:00	9670	24659	34329	1673	36002	62056	58.02%	15.58%	57	67
14	苗栗縣苗栗市	2018-11-24T23:43:12+08:00	11499	29449	40948	2019	42967	74249	57.87%	15.49%	67	67
14	苗栗縣苗栗市	2018-11-24T22:33:33+08:00	8238	20916	29154	1445	30599	52635	58.13%	15.65%	49	67
14	苗栗縣苗栗市	2018-11-25T06:08:47+08:00	11499	29449	40948	2019	42967	74249	57.87%	15.49%	67	67
14	苗栗縣苗栗市	2018-11-24T23:35:06+08:00	11499	29449	40948	2019	42967	74249	57.87%	15.49%	67	67
14	苗栗縣苗栗市	2018-11-24T23:47:23+08:00	11499	29449	40948	2019	42967	74249	57.87%	15.49%	67	67
14	苗栗縣苗栗市	2018-11-25T06:29:12+08:00	11499	29449	40948	2019	42967	74249	57.87%	15.49%	67	67
14	苗栗縣苗栗市	2018-11-24T23:55:42+08:00	11499	29449	40948	2019	42967	74249	57.87%	15.49%	67	67
14	苗栗縣苗栗市	2018-11-25T01:17:46+08:00	11499	29449	40948	2019	42967	74249	57.87%	15.49%	67	67
14	苗栗縣苗栗市	2018-11-24T22:57:48+08:00	9670	24659	34329	1673	36002	62056	58.02%	15.58%	57	67
14	苗栗縣苗栗市	2018-11-25T03:38:50+08:00	11499	29449	40948	2019	42967	74249	57.87%	15.49%	67	67
14	苗栗縣苗栗市	2018-11-24T23:23:34+08:00	11499	29449	40948	2019	42967	74249	57.87%	15.49%	67	67
14	苗栗縣苗栗市	2018-11-25T03:44:17+08:00	11499	29449	40948	2019	42967	74249	57.87%	15.49%	67	67
14	苗栗縣苗栗市	2018-11-25T01:25:48+08:00	11499	29449	40948	2019	42967	74249	57.87%	15.49%	67	67
14	苗栗縣苗栗市	2018-11-24T22:40:23+08:00	8531	21727	30258	1484	31742	54647	58.09%	15.61%	51	67
14	苗栗縣苗栗市	2018-11-24T23:15:58+08:00	11499	29449	40948	2019	42967	74249	57.87%	15.49%	67	67
14	苗栗縣苗栗市	2018-11-25T01:02:26+08:00	11499	29449	40948	2019	42967	74249	57.87%	15.49%	67	67
14	苗栗縣苗栗市	2018-11-25T06:18:53+08:00	11499	29449	40948	2019	42967	74249	57.87%	15.49%	67	67
14	苗栗縣苗栗市	2018-11-25T06:23:55+08:00	11499	29449	40948	2019	42967	74249	57.87%	15.49%	67	67
14	苗栗縣苗栗市	2018-11-24T23:39:10+08:00	11499	29449	40948	2019	42967	74249	57.87%	15.49%	67	67
14	苗栗縣苗栗市	2018-11-25T03:56:07+08:00	11499	29449	40948	2019	42967	74249	57.87%	15.49%	67	67
14	苗栗縣苗栗市	2018-11-24T22:45:04+08:00	8731	22212	30943	1509	32452	55989	57.96%	15.59%	52	67
14	苗栗縣苗栗市	2018-11-24T23:12:10+08:00	11011	28033	39044	1911	40955	70701	57.93%	15.57%	64	67
14	南投縣名間鄉	2018-11-25T01:12:39+08:00	5059	13700	18759	1355	20114	33408	60.21%	15.14%	37	37
14	南投縣名間鄉	2018-11-25T04:02:45+08:00	5059	13700	18759	1355	20114	33408	60.21%	15.14%	37	37
14	南投縣名間鄉	2018-11-24T22:16:07+08:00	3356	9423	12779	887	13666	22722	60.14%	14.77%	27	37
14	南投縣名間鄉	2018-11-24T22:23:09+08:00	3513	9875	13388	927	14315	23777	60.21%	14.77%	28	37
14	南投縣名間鄉	2018-11-25T03:32:31+08:00	5059	13700	18759	1355	20114	33408	60.21%	15.14%	37	37
14	南投縣名間鄉	2018-11-25T00:00:04+08:00	5059	13700	18759	1355	20114	33408	60.21%	15.14%	37	37
14	南投縣名間鄉	2018-11-25T03:38:52+08:00	5059	13700	18759	1355	20114	33408	60.21%	15.14%	37	37
14	南投縣名間鄉	2018-11-25T00:23:00+08:00	5059	13700	18759	1355	20114	33408	60.21%	15.14%	37	37
14	南投縣名間鄉	2018-11-24T22:36:57+08:00	4159	11728	15887	1111	16998	28169	60.34%	14.76%	32	37
14	南投縣名間鄉	2018-11-25T00:57:33+08:00	5059	13700	18759	1355	20114	33408	60.21%	15.14%	37	37
14	南投縣名間鄉	2018-11-24T23:51:31+08:00	5059	13700	18759	1355	20114	33408	60.21%	15.14%	37	37
14	南投縣名間鄉	2018-11-24T23:27:15+08:00	4779	13278	18057	1301	19358	32134	60.24%	14.87%	36	37
14	南投縣名間鄉	2018-11-24T22:19:34+08:00	3513	9875	13388	927	14315	23777	60.21%	14.77%	28	37
14	南投縣名間鄉	2018-11-24T22:50:44+08:00	4159	11728	15887	1111	16998	28169	60.34%	14.76%	32	37
14	南投縣名間鄉	2018-11-24T23:12:12+08:00	4779	13278	18057	1301	19358	32134	60.24%	14.87%	36	37
14	南投縣名間鄉	2018-11-25T06:13:49+08:00	5059	13700	18759	1355	20114	33408	60.21%	15.14%	37	37
14	南投縣名間鄉	2018-11-24T22:26:34+08:00	3513	9875	13388	927	14315	23777	60.21%	14.77%	28	37
14	南投縣名間鄉	2018-11-25T06:23:57+08:00	5059	13700	18759	1355	20114	33408	60.21%	15.14%	37	37
14	南投縣名間鄉	2018-11-25T03:49:48+08:00	5059	13700	18759	1355	20114	33408	60.21%	15.14%	37	37
14	南投縣名間鄉	2018-11-24T23:05:01+08:00	4462	12459	16921	1199	18120	30077	60.25%	14.84%	34	37
14	南投縣名間鄉	2018-11-24T23:01:28+08:00	4462	12459	16921	1199	18120	30077	60.25%	14.84%	34	37
14	南投縣名間鄉	2018-11-24T23:47:25+08:00	5059	13700	18759	1355	20114	33408	60.21%	15.14%	37	37
14	南投縣名間鄉	2018-11-25T06:29:13+08:00	5059	13700	18759	1355	20114	33408	60.21%	15.14%	37	37
14	南投縣名間鄉	2018-11-24T23:35:07+08:00	5059	13700	18759	1355	20114	33408	60.21%	15.14%	37	37
14	南投縣名間鄉	2018-11-24T22:33:34+08:00	4006	11200	15206	1066	16272	26908	60.47%	14.89%	31	37
14	南投縣名間鄉	2018-11-25T01:07:23+08:00	5059	13700	18759	1355	20114	33408	60.21%	15.14%	37	37
14	南投縣名間鄉	2018-11-24T23:43:14+08:00	5059	13700	18759	1355	20114	33408	60.21%	15.14%	37	37
14	南投縣名間鄉	2018-11-24T23:31:07+08:00	5059	13700	18759	1355	20114	33408	60.21%	15.14%	37	37
14	南投縣名間鄉	2018-11-25T06:08:49+08:00	5059	13700	18759	1355	20114	33408	60.21%	15.14%	37	37
14	南投縣名間鄉	2018-11-25T00:14:06+08:00	5059	13700	18759	1355	20114	33408	60.21%	15.14%	37	37
14	南投縣名間鄉	2018-11-24T23:23:35+08:00	4779	13278	18057	1301	19358	32134	60.24%	14.87%	36	37
14	南投縣名間鄉	2018-11-24T22:13:23+08:00	3356	9423	12779	887	13666	22722	60.14%	14.77%	27	37
14	南投縣名間鄉	2018-11-25T01:17:48+08:00	5059	13700	18759	1355	20114	33408	60.21%	15.14%	37	37
14	南投縣名間鄉	2018-11-24T23:55:43+08:00	5059	13700	18759	1355	20114	33408	60.21%	15.14%	37	37
14	南投縣名間鄉	2018-11-24T23:08:32+08:00	4625	12803	17428	1260	18688	31007	60.27%	14.92%	35	37
14	南投縣名間鄉	2018-11-24T23:19:47+08:00	4779	13278	18057	1301	19358	32134	60.24%	14.87%	36	37
14	南投縣名間鄉	2018-11-24T22:57:49+08:00	4462	12459	16921	1199	18120	30077	60.25%	14.84%	34	37
14	南投縣名間鄉	2018-11-25T03:44:19+08:00	5059	13700	18759	1355	20114	33408	60.21%	15.14%	37	37
14	南投縣名間鄉	2018-11-24T22:30:02+08:00	3513	9875	13388	927	14315	23777	60.21%	14.77%	28	37
14	南投縣名間鄉	2018-11-25T01:02:27+08:00	5059	13700	18759	1355	20114	33408	60.21%	15.14%	37	37
14	南投縣名間鄉	2018-11-24T22:40:25+08:00	4159	11728	15887	1111	16998	28169	60.34%	14.76%	32	37
14	南投縣名間鄉	2018-11-25T01:25:49+08:00	5059	13700	18759	1355	20114	33408	60.21%	15.14%	37	37
14	南投縣名間鄉	2018-11-24T23:15:59+08:00	4779	13278	18057	1301	19358	32134	60.24%	14.87%	36	37
14	南投縣名間鄉	2018-11-25T06:18:54+08:00	5059	13700	18759	1355	20114	33408	60.21%	15.14%	37	37
14	南投縣名間鄉	2018-11-25T03:56:08+08:00	5059	13700	18759	1355	20114	33408	60.21%	15.14%	37	37
14	南投縣名間鄉	2018-11-25T00:05:02+08:00	5059	13700	18759	1355	20114	33408	60.21%	15.14%	37	37
14	南投縣名間鄉	2018-11-24T22:41:32+08:00	4159	11728	15887	1111	16998	28169	60.34%	14.76%	32	37
14	南投縣名間鄉	2018-11-24T22:45:05+08:00	4159	11728	15887	1111	16998	28169	60.34%	14.76%	32	37
14	南投縣名間鄉	2018-11-25T00:18:26+08:00	5059	13700	18759	1355	20114	33408	60.21%	15.14%	37	37
14	南投縣名間鄉	2018-11-24T23:39:11+08:00	5059	13700	18759	1355	20114	33408	60.21%	15.14%	37	37
14	南投縣名間鄉	2018-11-25T00:09:30+08:00	5059	13700	18759	1355	20114	33408	60.21%	15.14%	37	37
14	南投縣名間鄉	2018-11-24T22:54:22+08:00	4159	11728	15887	1111	16998	28169	60.34%	14.76%	32	37
14	雲林縣莿桐鄉	2018-11-24T23:16:00+08:00	3806	8512	12318	1193	13511	24570	54.99%	15.49%	22	22
14	雲林縣莿桐鄉	2018-11-24T22:16:07+08:00	2628	5908	8536	824	9360	16884	55.44%	15.57%	16	22
14	雲林縣莿桐鄉	2018-11-25T01:25:50+08:00	3806	8512	12318	1193	13511	24570	54.99%	15.49%	22	22
14	雲林縣莿桐鄉	2018-11-25T00:23:01+08:00	3806	8512	12318	1193	13511	24570	54.99%	15.49%	22	22
14	雲林縣莿桐鄉	2018-11-24T23:23:36+08:00	3806	8512	12318	1193	13511	24570	54.99%	15.49%	22	22
14	雲林縣莿桐鄉	2018-11-25T03:38:52+08:00	3806	8512	12318	1193	13511	24570	54.99%	15.49%	22	22
14	雲林縣莿桐鄉	2018-11-24T22:57:50+08:00	3806	8512	12318	1193	13511	24570	54.99%	15.49%	22	22
14	雲林縣莿桐鄉	2018-11-25T00:57:34+08:00	3806	8512	12318	1193	13511	24570	54.99%	15.49%	22	22
14	雲林縣莿桐鄉	2018-11-24T22:36:58+08:00	3609	8050	11659	1096	12755	23298	54.75%	15.49%	21	22
14	雲林縣莿桐鄉	2018-11-24T22:19:34+08:00	2628	5908	8536	824	9360	16884	55.44%	15.57%	16	22
14	雲林縣莿桐鄉	2018-11-24T22:45:06+08:00	3609	8050	11659	1096	12755	23298	54.75%	15.49%	21	22
14	雲林縣莿桐鄉	2018-11-25T01:12:40+08:00	3806	8512	12318	1193	13511	24570	54.99%	15.49%	22	22
14	雲林縣莿桐鄉	2018-11-24T22:26:34+08:00	3050	6650	9700	919	10619	19169	55.4%	15.91%	18	22
14	雲林縣莿桐鄉	2018-11-25T06:23:57+08:00	3806	8512	12318	1193	13511	24570	54.99%	15.49%	22	22
14	雲林縣莿桐鄉	2018-11-24T23:39:12+08:00	3806	8512	12318	1193	13511	24570	54.99%	15.49%	22	22
14	雲林縣莿桐鄉	2018-11-24T22:50:45+08:00	3806	8512	12318	1193	13511	24570	54.99%	15.49%	22	22
14	雲林縣莿桐鄉	2018-11-24T23:12:13+08:00	3806	8512	12318	1193	13511	24570	54.99%	15.49%	22	22
14	雲林縣莿桐鄉	2018-11-25T03:49:48+08:00	3806	8512	12318	1193	13511	24570	54.99%	15.49%	22	22
14	雲林縣莿桐鄉	2018-11-24T23:31:08+08:00	3806	8512	12318	1193	13511	24570	54.99%	15.49%	22	22
14	雲林縣莿桐鄉	2018-11-24T23:01:28+08:00	3806	8512	12318	1193	13511	24570	54.99%	15.49%	22	22
14	雲林縣莿桐鄉	2018-11-24T23:47:25+08:00	3806	8512	12318	1193	13511	24570	54.99%	15.49%	22	22
14	雲林縣莿桐鄉	2018-11-25T06:29:14+08:00	3806	8512	12318	1193	13511	24570	54.99%	15.49%	22	22
14	雲林縣莿桐鄉	2018-11-24T23:35:07+08:00	3806	8512	12318	1193	13511	24570	54.99%	15.49%	22	22
14	雲林縣莿桐鄉	2018-11-25T01:07:23+08:00	3806	8512	12318	1193	13511	24570	54.99%	15.49%	22	22
14	雲林縣莿桐鄉	2018-11-24T23:43:14+08:00	3806	8512	12318	1193	13511	24570	54.99%	15.49%	22	22
14	雲林縣莿桐鄉	2018-11-25T06:13:50+08:00	3806	8512	12318	1193	13511	24570	54.99%	15.49%	22	22
14	雲林縣莿桐鄉	2018-11-25T06:08:49+08:00	3806	8512	12318	1193	13511	24570	54.99%	15.49%	22	22
14	雲林縣莿桐鄉	2018-11-24T22:33:35+08:00	3429	7561	10990	1036	12026	21809	55.14%	15.72%	20	22
14	雲林縣莿桐鄉	2018-11-25T00:14:06+08:00	3806	8512	12318	1193	13511	24570	54.99%	15.49%	22	22
14	雲林縣莿桐鄉	2018-11-25T04:02:48+08:00	3806	8512	12318	1193	13511	24570	54.99%	15.49%	22	22
14	雲林縣莿桐鄉	2018-11-25T00:00:07+08:00	3806	8512	12318	1193	13511	24570	54.99%	15.49%	22	22
14	雲林縣莿桐鄉	2018-11-24T23:08:33+08:00	3806	8512	12318	1193	13511	24570	54.99%	15.49%	22	22
14	雲林縣莿桐鄉	2018-11-25T03:32:32+08:00	3806	8512	12318	1193	13511	24570	54.99%	15.49%	22	22
14	雲林縣莿桐鄉	2018-11-25T03:44:20+08:00	3806	8512	12318	1193	13511	24570	54.99%	15.49%	22	22
14	雲林縣莿桐鄉	2018-11-24T22:13:24+08:00	2628	5908	8536	824	9360	16884	55.44%	15.57%	16	22
14	雲林縣莿桐鄉	2018-11-24T23:55:44+08:00	3806	8512	12318	1193	13511	24570	54.99%	15.49%	22	22
14	雲林縣莿桐鄉	2018-11-25T01:17:49+08:00	3806	8512	12318	1193	13511	24570	54.99%	15.49%	22	22
14	雲林縣莿桐鄉	2018-11-24T23:19:47+08:00	3806	8512	12318	1193	13511	24570	54.99%	15.49%	22	22
14	雲林縣莿桐鄉	2018-11-25T01:02:27+08:00	3806	8512	12318	1193	13511	24570	54.99%	15.49%	22	22
14	雲林縣莿桐鄉	2018-11-24T23:27:16+08:00	3806	8512	12318	1193	13511	24570	54.99%	15.49%	22	22
14	雲林縣莿桐鄉	2018-11-24T22:40:25+08:00	3609	8050	11659	1096	12755	23298	54.75%	15.49%	21	22
14	雲林縣莿桐鄉	2018-11-24T22:23:10+08:00	2844	6178	9022	886	9908	17869	55.45%	15.92%	17	22
14	雲林縣莿桐鄉	2018-11-24T22:30:03+08:00	3429	7561	10990	1036	12026	21809	55.14%	15.72%	20	22
14	雲林縣莿桐鄉	2018-11-25T06:18:54+08:00	3806	8512	12318	1193	13511	24570	54.99%	15.49%	22	22
14	雲林縣莿桐鄉	2018-11-24T23:51:32+08:00	3806	8512	12318	1193	13511	24570	54.99%	15.49%	22	22
14	雲林縣莿桐鄉	2018-11-25T00:05:02+08:00	3806	8512	12318	1193	13511	24570	54.99%	15.49%	22	22
14	雲林縣莿桐鄉	2018-11-24T22:41:32+08:00	3609	8050	11659	1096	12755	23298	54.75%	15.49%	21	22
14	雲林縣莿桐鄉	2018-11-25T00:09:31+08:00	3806	8512	12318	1193	13511	24570	54.99%	15.49%	22	22
14	雲林縣莿桐鄉	2018-11-24T22:54:23+08:00	3806	8512	12318	1193	13511	24570	54.99%	15.49%	22	22
14	雲林縣莿桐鄉	2018-11-24T23:05:02+08:00	3806	8512	12318	1193	13511	24570	54.99%	15.49%	22	22
14	雲林縣莿桐鄉	2018-11-25T03:56:09+08:00	3806	8512	12318	1193	13511	24570	54.99%	15.49%	22	22
14	雲林縣莿桐鄉	2018-11-25T00:18:27+08:00	3806	8512	12318	1193	13511	24570	54.99%	15.49%	22	22
14	雲林縣口湖鄉	2018-11-24T23:47:26+08:00	2889	7343	10232	1240	11472	24193	47.42%	11.94%	25	25
14	雲林縣口湖鄉	2018-11-24T22:16:08+08:00	2258	5794	8052	893	8945	18934	47.24%	11.93%	21	25
14	雲林縣口湖鄉	2018-11-24T23:16:00+08:00	2889	7343	10232	1240	11472	24193	47.42%	11.94%	25	25
14	雲林縣口湖鄉	2018-11-25T01:25:50+08:00	2889	7343	10232	1240	11472	24193	47.42%	11.94%	25	25
14	雲林縣口湖鄉	2018-11-25T03:38:53+08:00	2889	7343	10232	1240	11472	24193	47.42%	11.94%	25	25
14	雲林縣口湖鄉	2018-11-25T00:23:01+08:00	2889	7343	10232	1240	11472	24193	47.42%	11.94%	25	25
14	雲林縣口湖鄉	2018-11-24T23:23:36+08:00	2889	7343	10232	1240	11472	24193	47.42%	11.94%	25	25
14	雲林縣口湖鄉	2018-11-25T00:57:34+08:00	2889	7343	10232	1240	11472	24193	47.42%	11.94%	25	25
14	雲林縣口湖鄉	2018-11-24T22:36:58+08:00	2408	6131	8539	997	9536	20147	47.33%	11.95%	22	25
14	雲林縣口湖鄉	2018-11-24T22:57:51+08:00	2690	6873	9563	1084	10647	22685	46.93%	11.86%	24	25
14	雲林縣口湖鄉	2018-11-24T22:19:34+08:00	2408	6131	8539	997	9536	20147	47.33%	11.95%	22	25
14	雲林縣口湖鄉	2018-11-24T22:45:06+08:00	2408	6131	8539	997	9536	20147	47.33%	11.95%	22	25
14	雲林縣口湖鄉	2018-11-25T06:08:50+08:00	2889	7343	10232	1240	11472	24193	47.42%	11.94%	25	25
14	雲林縣口湖鄉	2018-11-25T06:23:58+08:00	2889	7343	10232	1240	11472	24193	47.42%	11.94%	25	25
14	雲林縣口湖鄉	2018-11-24T23:39:13+08:00	2889	7343	10232	1240	11472	24193	47.42%	11.94%	25	25
14	雲林縣口湖鄉	2018-11-25T01:12:40+08:00	2889	7343	10232	1240	11472	24193	47.42%	11.94%	25	25
14	雲林縣口湖鄉	2018-11-24T22:26:34+08:00	2408	6131	8539	997	9536	20147	47.33%	11.95%	22	25
14	雲林縣口湖鄉	2018-11-25T03:49:49+08:00	2889	7343	10232	1240	11472	24193	47.42%	11.94%	25	25
14	雲林縣口湖鄉	2018-11-24T22:50:45+08:00	2690	6873	9563	1084	10647	22685	46.93%	11.86%	24	25
14	雲林縣口湖鄉	2018-11-24T23:12:13+08:00	2889	7343	10232	1240	11472	24193	47.42%	11.94%	25	25
14	雲林縣口湖鄉	2018-11-25T04:02:50+08:00	2889	7343	10232	1240	11472	24193	47.42%	11.94%	25	25
14	雲林縣口湖鄉	2018-11-24T23:31:08+08:00	2889	7343	10232	1240	11472	24193	47.42%	11.94%	25	25
14	雲林縣口湖鄉	2018-11-24T23:43:15+08:00	2889	7343	10232	1240	11472	24193	47.42%	11.94%	25	25
14	雲林縣口湖鄉	2018-11-24T23:01:28+08:00	2889	7343	10232	1240	11472	24193	47.42%	11.94%	25	25
14	雲林縣口湖鄉	2018-11-25T06:29:14+08:00	2889	7343	10232	1240	11472	24193	47.42%	11.94%	25	25
14	雲林縣口湖鄉	2018-11-25T00:14:07+08:00	2889	7343	10232	1240	11472	24193	47.42%	11.94%	25	25
14	雲林縣口湖鄉	2018-11-25T01:07:23+08:00	2889	7343	10232	1240	11472	24193	47.42%	11.94%	25	25
14	雲林縣口湖鄉	2018-11-25T06:13:50+08:00	2889	7343	10232	1240	11472	24193	47.42%	11.94%	25	25
14	雲林縣口湖鄉	2018-11-24T23:35:08+08:00	2889	7343	10232	1240	11472	24193	47.42%	11.94%	25	25
14	雲林縣口湖鄉	2018-11-24T22:33:35+08:00	2408	6131	8539	997	9536	20147	47.33%	11.95%	22	25
14	雲林縣口湖鄉	2018-11-24T23:08:33+08:00	2889	7343	10232	1240	11472	24193	47.42%	11.94%	25	25
14	雲林縣口湖鄉	2018-11-25T03:32:32+08:00	2889	7343	10232	1240	11472	24193	47.42%	11.94%	25	25
14	雲林縣口湖鄉	2018-11-24T23:19:48+08:00	2889	7343	10232	1240	11472	24193	47.42%	11.94%	25	25
14	雲林縣口湖鄉	2018-11-25T03:44:20+08:00	2889	7343	10232	1240	11472	24193	47.42%	11.94%	25	25
14	雲林縣口湖鄉	2018-11-24T22:13:24+08:00	2105	5401	7506	857	8363	17497	47.8%	12.03%	20	25
14	雲林縣口湖鄉	2018-11-25T00:00:08+08:00	2889	7343	10232	1240	11472	24193	47.42%	11.94%	25	25
14	雲林縣口湖鄉	2018-11-24T23:55:44+08:00	2889	7343	10232	1240	11472	24193	47.42%	11.94%	25	25
14	雲林縣口湖鄉	2018-11-25T01:17:49+08:00	2889	7343	10232	1240	11472	24193	47.42%	11.94%	25	25
14	雲林縣口湖鄉	2018-11-25T06:18:55+08:00	2889	7343	10232	1240	11472	24193	47.42%	11.94%	25	25
14	雲林縣口湖鄉	2018-11-25T01:02:28+08:00	2889	7343	10232	1240	11472	24193	47.42%	11.94%	25	25
14	雲林縣口湖鄉	2018-11-24T23:27:16+08:00	2889	7343	10232	1240	11472	24193	47.42%	11.94%	25	25
14	雲林縣口湖鄉	2018-11-24T22:40:25+08:00	2408	6131	8539	997	9536	20147	47.33%	11.95%	22	25
14	雲林縣口湖鄉	2018-11-24T22:23:10+08:00	2408	6131	8539	997	9536	20147	47.33%	11.95%	22	25
14	雲林縣口湖鄉	2018-11-24T22:30:03+08:00	2408	6131	8539	997	9536	20147	47.33%	11.95%	22	25
14	雲林縣口湖鄉	2018-11-24T23:51:32+08:00	2889	7343	10232	1240	11472	24193	47.42%	11.94%	25	25
14	雲林縣口湖鄉	2018-11-25T00:05:02+08:00	2889	7343	10232	1240	11472	24193	47.42%	11.94%	25	25
14	雲林縣口湖鄉	2018-11-24T22:41:32+08:00	2408	6131	8539	997	9536	20147	47.33%	11.95%	22	25
14	雲林縣口湖鄉	2018-11-25T00:09:31+08:00	2889	7343	10232	1240	11472	24193	47.42%	11.94%	25	25
14	雲林縣口湖鄉	2018-11-24T22:54:23+08:00	2690	6873	9563	1084	10647	22685	46.93%	11.86%	24	25
14	雲林縣口湖鄉	2018-11-24T23:05:02+08:00	2889	7343	10232	1240	11472	24193	47.42%	11.94%	25	25
14	雲林縣口湖鄉	2018-11-25T03:56:09+08:00	2889	7343	10232	1240	11472	24193	47.42%	11.94%	25	25
14	雲林縣口湖鄉	2018-11-25T00:18:27+08:00	2889	7343	10232	1240	11472	24193	47.42%	11.94%	25	25
14	屏東縣內埔鄉	2018-11-24T23:16:01+08:00	5530	12406	17936	1384	19320	40719	47.45%	13.58%	35	40
14	屏東縣內埔鄉	2018-11-24T23:43:16+08:00	5881	13225	19106	1469	20575	43350	47.46%	13.57%	37	40
14	屏東縣內埔鄉	2018-11-24T22:33:36+08:00	4860	10759	15619	1284	16903	35273	47.92%	13.78%	31	40
14	屏東縣內埔鄉	2018-11-25T03:56:11+08:00	6425	14587	21012	1607	22619	47558	47.56%	13.51%	40	40
14	屏東縣內埔鄉	2018-11-24T23:47:27+08:00	6086	13723	19809	1533	21342	44835	47.6%	13.57%	38	40
14	屏東縣內埔鄉	2018-11-24T22:16:09+08:00	4356	9536	13892	1172	15064	31222	48.25%	13.95%	28	40
14	屏東縣內埔鄉	2018-11-25T03:38:54+08:00	6425	14587	21012	1607	22619	47558	47.56%	13.51%	40	40
14	屏東縣內埔鄉	2018-11-24T23:55:46+08:00	6086	13723	19809	1533	21342	44835	47.6%	13.57%	38	40
14	屏東縣內埔鄉	2018-11-25T01:25:51+08:00	6425	14587	21012	1607	22619	47558	47.56%	13.51%	40	40
14	屏東縣內埔鄉	2018-11-24T23:23:37+08:00	5721	12807	18528	1430	19958	41997	47.52%	13.62%	36	40
14	屏東縣內埔鄉	2018-11-25T06:18:56+08:00	6425	14587	21012	1607	22619	47558	47.56%	13.51%	40	40
14	屏東縣內埔鄉	2018-11-24T22:30:06+08:00	4629	10264	14893	1236	16129	33668	47.91%	13.75%	30	40
14	屏東縣內埔鄉	2018-11-24T22:36:59+08:00	5030	11172	16202	1313	17515	36798	47.6%	13.67%	32	40
14	屏東縣內埔鄉	2018-11-24T22:40:26+08:00	5030	11172	16202	1313	17515	36798	47.6%	13.67%	32	40
14	屏東縣內埔鄉	2018-11-25T00:57:35+08:00	6218	14107	20325	1554	21879	46039	47.52%	13.51%	39	40
14	屏東縣內埔鄉	2018-11-25T01:17:51+08:00	6425	14587	21012	1607	22619	47558	47.56%	13.51%	40	40
14	屏東縣內埔鄉	2018-11-24T23:31:10+08:00	5721	12807	18528	1430	19958	41997	47.52%	13.62%	36	40
14	屏東縣內埔鄉	2018-11-24T23:39:14+08:00	5881	13225	19106	1469	20575	43350	47.46%	13.57%	37	40
14	屏東縣內埔鄉	2018-11-24T23:01:30+08:00	5530	12406	17936	1384	19320	40719	47.45%	13.58%	35	40
14	屏東縣內埔鄉	2018-11-25T04:02:51+08:00	6425	14587	21012	1607	22619	47558	47.56%	13.51%	40	40
14	屏東縣內埔鄉	2018-11-24T22:26:35+08:00	4485	9900	14385	1199	15584	32438	48.04%	13.83%	29	40
14	屏東縣內埔鄉	2018-11-24T23:12:14+08:00	5530	12406	17936	1384	19320	40719	47.45%	13.58%	35	40
14	屏東縣內埔鄉	2018-11-25T06:23:59+08:00	6425	14587	21012	1607	22619	47558	47.56%	13.51%	40	40
14	屏東縣內埔鄉	2018-11-25T00:09:33+08:00	6086	13723	19809	1533	21342	44835	47.6%	13.57%	38	40
14	屏東縣內埔鄉	2018-11-24T22:45:07+08:00	5352	11914	17266	1347	18613	39471	47.16%	13.56%	34	40
14	屏東縣內埔鄉	2018-11-25T06:08:51+08:00	6425	14587	21012	1607	22619	47558	47.56%	13.51%	40	40
14	屏東縣內埔鄉	2018-11-25T01:07:25+08:00	6425	14587	21012	1607	22619	47558	47.56%	13.51%	40	40
14	屏東縣內埔鄉	2018-11-25T06:13:51+08:00	6425	14587	21012	1607	22619	47558	47.56%	13.51%	40	40
14	屏東縣內埔鄉	2018-11-24T23:35:09+08:00	5721	12807	18528	1430	19958	41997	47.52%	13.62%	36	40
14	屏東縣內埔鄉	2018-11-25T03:49:50+08:00	6425	14587	21012	1607	22619	47558	47.56%	13.51%	40	40
14	屏東縣內埔鄉	2018-11-25T00:14:08+08:00	6086	13723	19809	1533	21342	44835	47.6%	13.57%	38	40
14	屏東縣內埔鄉	2018-11-25T06:29:15+08:00	6425	14587	21012	1607	22619	47558	47.56%	13.51%	40	40
14	屏東縣內埔鄉	2018-11-24T23:08:34+08:00	5530	12406	17936	1384	19320	40719	47.45%	13.58%	35	40
14	屏東縣內埔鄉	2018-11-25T00:00:09+08:00	6086	13723	19809	1533	21342	44835	47.6%	13.57%	38	40
14	屏東縣內埔鄉	2018-11-25T00:23:02+08:00	6086	13723	19809	1533	21342	44835	47.6%	13.57%	38	40
14	屏東縣內埔鄉	2018-11-25T03:32:33+08:00	6425	14587	21012	1607	22619	47558	47.56%	13.51%	40	40
14	屏東縣內埔鄉	2018-11-25T03:44:21+08:00	6425	14587	21012	1607	22619	47558	47.56%	13.51%	40	40
14	屏東縣內埔鄉	2018-11-24T22:13:25+08:00	4117	9027	13144	1124	14268	29653	48.12%	13.88%	27	40
14	屏東縣內埔鄉	2018-11-24T23:19:49+08:00	5530	12406	17936	1384	19320	40719	47.45%	13.58%	35	40
14	屏東縣內埔鄉	2018-11-24T22:23:11+08:00	4485	9900	14385	1199	15584	32438	48.04%	13.83%	29	40
14	屏東縣內埔鄉	2018-11-24T23:27:17+08:00	5721	12807	18528	1430	19958	41997	47.52%	13.62%	36	40
14	屏東縣內埔鄉	2018-11-24T22:19:36+08:00	4356	9536	13892	1172	15064	31222	48.25%	13.95%	28	40
14	屏東縣內埔鄉	2018-11-25T01:02:29+08:00	6425	14587	21012	1607	22619	47558	47.56%	13.51%	40	40
14	屏東縣內埔鄉	2018-11-24T23:51:33+08:00	6086	13723	19809	1533	21342	44835	47.6%	13.57%	38	40
14	屏東縣內埔鄉	2018-11-24T22:57:52+08:00	5530	12406	17936	1384	19320	40719	47.45%	13.58%	35	40
14	屏東縣內埔鄉	2018-11-24T23:05:03+08:00	5530	12406	17936	1384	19320	40719	47.45%	13.58%	35	40
14	屏東縣內埔鄉	2018-11-24T22:54:24+08:00	5352	11914	17266	1347	18613	39471	47.16%	13.56%	34	40
14	屏東縣內埔鄉	2018-11-25T00:18:28+08:00	6086	13723	19809	1533	21342	44835	47.6%	13.57%	38	40
14	屏東縣內埔鄉	2018-11-24T22:41:33+08:00	5030	11172	16202	1313	17515	36798	47.6%	13.67%	32	40
14	屏東縣內埔鄉	2018-11-25T00:05:03+08:00	6086	13723	19809	1533	21342	44835	47.6%	13.57%	38	40
14	屏東縣內埔鄉	2018-11-25T01:12:42+08:00	6425	14587	21012	1607	22619	47558	47.56%	13.51%	40	40
14	屏東縣內埔鄉	2018-11-24T22:50:46+08:00	5352	11914	17266	1347	18613	39471	47.16%	13.56%	34	40
14	臺南市中西區	2018-11-25T06:29:10+08:00	12063	22317	34380	1921	36301	65261	55.62%	18.48%	52	52
14	臺南市中西區	2018-11-24T23:35:04+08:00	10953	20656	31609	1736	33345	59503	56.04%	18.41%	48	52
14	臺南市中西區	2018-11-24T23:47:21+08:00	11412	21554	32966	1829	34795	62502	55.67%	18.26%	50	52
14	臺南市中西區	2018-11-24T23:12:09+08:00	9340	17681	27021	1520	28541	51096	55.86%	18.28%	42	52
14	臺南市中西區	2018-11-25T06:08:45+08:00	12063	22317	34380	1921	36301	65261	55.62%	18.48%	52	52
14	臺南市中西區	2018-11-24T23:43:11+08:00	11412	21554	32966	1829	34795	62502	55.67%	18.26%	50	52
14	臺南市中西區	2018-11-25T01:07:19+08:00	12063	22317	34380	1921	36301	65261	55.62%	18.48%	52	52
14	臺南市中西區	2018-11-24T22:33:31+08:00	6626	12366	18992	1120	20112	36391	55.27%	18.21%	30	52
14	臺南市中西區	2018-11-25T00:14:02+08:00	11686	22101	33787	1874	35661	64097	55.64%	18.23%	51	52
14	臺南市中西區	2018-11-25T04:02:42+08:00	12063	22317	34380	1921	36301	65261	55.62%	18.48%	52	52
14	臺南市中西區	2018-11-25T00:09:26+08:00	11686	22101	33787	1874	35661	64097	55.64%	18.23%	51	52
14	臺南市中西區	2018-11-24T23:39:07+08:00	11247	21215	32462	1783	34245	61248	55.91%	18.36%	49	52
14	臺南市中西區	2018-11-24T23:31:03+08:00	10723	20226	30949	1707	32656	58258	56.05%	18.41%	47	52
14	臺南市中西區	2018-11-24T23:01:24+08:00	8813	16702	25515	1446	26961	48340	55.77%	18.23%	40	52
14	臺南市中西區	2018-11-25T03:44:15+08:00	12063	22317	34380	1921	36301	65261	55.62%	18.48%	52	52
14	臺南市中西區	2018-11-24T23:19:42+08:00	9911	18709	28620	1584	30204	54192	55.74%	18.29%	44	52
14	臺南市中西區	2018-11-24T22:13:20+08:00	5781	10616	16397	949	17346	31042	55.88%	18.62%	26	52
14	臺南市中西區	2018-11-25T00:04:58+08:00	11686	22101	33787	1874	35661	64097	55.64%	18.23%	51	52
14	臺南市中西區	2018-11-24T23:04:57+08:00	8813	16702	25515	1446	26961	48340	55.77%	18.23%	40	52
14	臺南市中西區	2018-11-25T01:17:44+08:00	12063	22317	34380	1921	36301	65261	55.62%	18.48%	52	52
14	臺南市中西區	2018-11-24T23:55:40+08:00	11412	21554	32966	1829	34795	62502	55.67%	18.26%	50	52
14	臺南市中西區	2018-11-25T06:18:51+08:00	12063	22317	34380	1921	36301	65261	55.62%	18.48%	52	52
14	臺南市中西區	2018-11-25T01:02:24+08:00	12063	22317	34380	1921	36301	65261	55.62%	18.48%	52	52
14	臺南市中西區	2018-11-25T03:38:49+08:00	12063	22317	34380	1921	36301	65261	55.62%	18.48%	52	52
14	臺南市中西區	2018-11-24T23:27:12+08:00	10138	19111	29249	1624	30873	55326	55.8%	18.32%	45	52
14	臺南市中西區	2018-11-24T22:54:20+08:00	8572	16277	24849	1417	26266	47117	55.75%	18.19%	39	52
14	臺南市中西區	2018-11-25T00:18:23+08:00	11686	22101	33787	1874	35661	64097	55.64%	18.23%	51	52
14	臺南市中西區	2018-11-25T06:13:46+08:00	12063	22317	34380	1921	36301	65261	55.62%	18.48%	52	52
14	臺南市中西區	2018-11-25T00:22:57+08:00	11686	22101	33787	1874	35661	64097	55.64%	18.23%	51	52
14	臺南市中西區	2018-11-25T03:56:04+08:00	12063	22317	34380	1921	36301	65261	55.62%	18.48%	52	52
14	臺南市中西區	2018-11-24T22:41:29+08:00	7243	13633	20876	1224	22100	39828	55.49%	18.19%	33	52
14	臺南市中西區	2018-11-24T22:16:03+08:00	5971	11066	17037	985	18022	32318	55.76%	18.48%	27	52
14	臺南市中西區	2018-11-25T01:12:35+08:00	12063	22317	34380	1921	36301	65261	55.62%	18.48%	52	52
14	臺南市中西區	2018-11-24T22:29:59+08:00	6626	12366	18992	1120	20112	36391	55.27%	18.21%	30	52
14	臺南市中西區	2018-11-24T23:23:32+08:00	10138	19111	29249	1624	30873	55326	55.8%	18.32%	45	52
14	臺南市中西區	2018-11-24T23:51:28+08:00	11412	21554	32966	1829	34795	62502	55.67%	18.26%	50	52
14	臺南市中西區	2018-11-24T22:57:46+08:00	8813	16702	25515	1446	26961	48340	55.77%	18.23%	40	52
14	臺南市中西區	2018-11-25T00:00:01+08:00	11686	22101	33787	1874	35661	64097	55.64%	18.23%	51	52
14	臺南市中西區	2018-11-24T22:23:05+08:00	6414	11953	18367	1061	19428	35190	55.21%	18.23%	29	52
14	臺南市中西區	2018-11-24T22:36:54+08:00	7011	13198	20209	1201	21410	38616	55.44%	18.16%	32	52
14	臺南市中西區	2018-11-25T01:25:46+08:00	12063	22317	34380	1921	36301	65261	55.62%	18.48%	52	52
14	臺南市中西區	2018-11-24T22:19:31+08:00	6209	11563	17772	1027	18799	34022	55.26%	18.25%	28	52
14	臺南市中西區	2018-11-25T00:57:30+08:00	12063	22317	34380	1921	36301	65261	55.62%	18.48%	52	52
14	臺南市中西區	2018-11-24T23:08:28+08:00	9340	17681	27021	1520	28541	51096	55.86%	18.28%	42	52
14	臺南市中西區	2018-11-24T22:40:22+08:00	7243	13633	20876	1224	22100	39828	55.49%	18.19%	33	52
14	臺南市中西區	2018-11-24T23:15:57+08:00	9680	18242	27922	1555	29477	52756	55.87%	18.35%	43	52
14	臺南市中西區	2018-11-25T03:32:28+08:00	12063	22317	34380	1921	36301	65261	55.62%	18.48%	52	52
14	臺南市中西區	2018-11-24T22:45:02+08:00	7615	14406	22021	1293	23314	41932	55.6%	18.16%	35	52
14	臺南市中西區	2018-11-24T22:50:40+08:00	8244	15733	23977	1389	25366	45534	55.71%	18.11%	38	52
14	臺南市中西區	2018-11-25T03:49:45+08:00	12063	22317	34380	1921	36301	65261	55.62%	18.48%	52	52
14	臺南市中西區	2018-11-25T06:23:54+08:00	12063	22317	34380	1921	36301	65261	55.62%	18.48%	52	52
14	臺南市中西區	2018-11-24T22:26:31+08:00	6414	11953	18367	1061	19428	35190	55.21%	18.23%	29	52
14	屏東縣東港鎮	2018-11-25T03:56:10+08:00	5699	13456	19155	1835	20990	39495	53.15%	14.43%	38	38
14	屏東縣東港鎮	2018-11-24T23:16:01+08:00	5699	13456	19155	1835	20990	39495	53.15%	14.43%	38	38
14	屏東縣東港鎮	2018-11-24T23:43:16+08:00	5699	13456	19155	1835	20990	39495	53.15%	14.43%	38	38
14	屏東縣東港鎮	2018-11-24T22:33:36+08:00	5699	13456	19155	1835	20990	39495	53.15%	14.43%	38	38
14	屏東縣東港鎮	2018-11-24T23:47:27+08:00	5699	13456	19155	1835	20990	39495	53.15%	14.43%	38	38
14	屏東縣東港鎮	2018-11-24T22:16:09+08:00	5040	11799	16839	1566	18405	34623	53.16%	14.56%	34	38
14	屏東縣東港鎮	2018-11-25T03:38:53+08:00	5699	13456	19155	1835	20990	39495	53.15%	14.43%	38	38
14	屏東縣東港鎮	2018-11-25T01:25:51+08:00	5699	13456	19155	1835	20990	39495	53.15%	14.43%	38	38
14	屏東縣東港鎮	2018-11-24T23:23:37+08:00	5699	13456	19155	1835	20990	39495	53.15%	14.43%	38	38
14	屏東縣東港鎮	2018-11-25T06:18:56+08:00	5699	13456	19155	1835	20990	39495	53.15%	14.43%	38	38
14	屏東縣東港鎮	2018-11-24T22:19:35+08:00	5192	12171	17363	1677	19040	35730	53.29%	14.53%	35	38
14	屏東縣東港鎮	2018-11-25T01:17:50+08:00	5699	13456	19155	1835	20990	39495	53.15%	14.43%	38	38
14	屏東縣東港鎮	2018-11-24T22:36:59+08:00	5699	13456	19155	1835	20990	39495	53.15%	14.43%	38	38
14	屏東縣東港鎮	2018-11-24T22:40:26+08:00	5699	13456	19155	1835	20990	39495	53.15%	14.43%	38	38
14	屏東縣東港鎮	2018-11-25T00:57:35+08:00	5699	13456	19155	1835	20990	39495	53.15%	14.43%	38	38
14	屏東縣東港鎮	2018-11-24T22:57:51+08:00	5699	13456	19155	1835	20990	39495	53.15%	14.43%	38	38
14	屏東縣東港鎮	2018-11-25T00:09:32+08:00	5699	13456	19155	1835	20990	39495	53.15%	14.43%	38	38
14	屏東縣東港鎮	2018-11-25T06:23:58+08:00	5699	13456	19155	1835	20990	39495	53.15%	14.43%	38	38
14	屏東縣東港鎮	2018-11-24T23:39:14+08:00	5699	13456	19155	1835	20990	39495	53.15%	14.43%	38	38
14	屏東縣東港鎮	2018-11-25T03:49:49+08:00	5699	13456	19155	1835	20990	39495	53.15%	14.43%	38	38
14	屏東縣東港鎮	2018-11-25T01:12:41+08:00	5699	13456	19155	1835	20990	39495	53.15%	14.43%	38	38
14	屏東縣東港鎮	2018-11-24T22:26:35+08:00	5540	13054	18594	1769	20363	38401	53.03%	14.43%	37	38
14	屏東縣東港鎮	2018-11-24T23:12:14+08:00	5699	13456	19155	1835	20990	39495	53.15%	14.43%	38	38
14	屏東縣東港鎮	2018-11-24T22:45:07+08:00	5699	13456	19155	1835	20990	39495	53.15%	14.43%	38	38
14	屏東縣東港鎮	2018-11-25T06:08:51+08:00	5699	13456	19155	1835	20990	39495	53.15%	14.43%	38	38
14	屏東縣東港鎮	2018-11-25T04:02:50+08:00	5699	13456	19155	1835	20990	39495	53.15%	14.43%	38	38
14	屏東縣東港鎮	2018-11-25T06:13:51+08:00	5699	13456	19155	1835	20990	39495	53.15%	14.43%	38	38
14	屏東縣東港鎮	2018-11-25T00:14:07+08:00	5699	13456	19155	1835	20990	39495	53.15%	14.43%	38	38
14	屏東縣東港鎮	2018-11-24T23:35:09+08:00	5699	13456	19155	1835	20990	39495	53.15%	14.43%	38	38
14	屏東縣東港鎮	2018-11-24T23:01:29+08:00	5699	13456	19155	1835	20990	39495	53.15%	14.43%	38	38
14	屏東縣東港鎮	2018-11-25T01:07:24+08:00	5699	13456	19155	1835	20990	39495	53.15%	14.43%	38	38
14	屏東縣東港鎮	2018-11-24T23:31:09+08:00	5699	13456	19155	1835	20990	39495	53.15%	14.43%	38	38
14	屏東縣東港鎮	2018-11-25T06:29:15+08:00	5699	13456	19155	1835	20990	39495	53.15%	14.43%	38	38
14	屏東縣東港鎮	2018-11-24T23:55:45+08:00	5699	13456	19155	1835	20990	39495	53.15%	14.43%	38	38
14	屏東縣東港鎮	2018-11-24T23:08:34+08:00	5699	13456	19155	1835	20990	39495	53.15%	14.43%	38	38
14	屏東縣東港鎮	2018-11-25T00:00:09+08:00	5699	13456	19155	1835	20990	39495	53.15%	14.43%	38	38
14	屏東縣東港鎮	2018-11-25T00:23:02+08:00	5699	13456	19155	1835	20990	39495	53.15%	14.43%	38	38
14	屏東縣東港鎮	2018-11-24T23:19:48+08:00	5699	13456	19155	1835	20990	39495	53.15%	14.43%	38	38
14	屏東縣東港鎮	2018-11-25T03:32:33+08:00	5699	13456	19155	1835	20990	39495	53.15%	14.43%	38	38
14	屏東縣東港鎮	2018-11-25T03:44:21+08:00	5699	13456	19155	1835	20990	39495	53.15%	14.43%	38	38
14	屏東縣東港鎮	2018-11-24T22:13:25+08:00	4859	11387	16246	1478	17724	33419	53.04%	14.54%	33	38
14	屏東縣東港鎮	2018-11-24T22:23:11+08:00	5393	12663	18056	1731	19787	37047	53.41%	14.56%	36	38
14	屏東縣東港鎮	2018-11-24T22:30:05+08:00	5540	13054	18594	1769	20363	38401	53.03%	14.43%	37	38
14	屏東縣東港鎮	2018-11-24T23:27:17+08:00	5699	13456	19155	1835	20990	39495	53.15%	14.43%	38	38
14	屏東縣東港鎮	2018-11-25T01:02:29+08:00	5699	13456	19155	1835	20990	39495	53.15%	14.43%	38	38
14	屏東縣東港鎮	2018-11-24T23:51:33+08:00	5699	13456	19155	1835	20990	39495	53.15%	14.43%	38	38
14	屏東縣東港鎮	2018-11-24T23:05:03+08:00	5699	13456	19155	1835	20990	39495	53.15%	14.43%	38	38
14	屏東縣東港鎮	2018-11-24T22:54:24+08:00	5699	13456	19155	1835	20990	39495	53.15%	14.43%	38	38
14	屏東縣東港鎮	2018-11-25T00:18:28+08:00	5699	13456	19155	1835	20990	39495	53.15%	14.43%	38	38
14	屏東縣東港鎮	2018-11-24T22:41:33+08:00	5699	13456	19155	1835	20990	39495	53.15%	14.43%	38	38
14	屏東縣東港鎮	2018-11-25T00:05:03+08:00	5699	13456	19155	1835	20990	39495	53.15%	14.43%	38	38
14	屏東縣東港鎮	2018-11-24T22:50:46+08:00	5699	13456	19155	1835	20990	39495	53.15%	14.43%	38	38
14	臺南市仁德區	2018-11-24T23:35:04+08:00	10442	22130	32572	1886	34458	64632	53.31%	16.16%	49	49
14	臺南市仁德區	2018-11-24T23:47:21+08:00	10442	22130	32572	1886	34458	64632	53.31%	16.16%	49	49
14	臺南市仁德區	2018-11-25T01:07:19+08:00	10442	22130	32572	1886	34458	64632	53.31%	16.16%	49	49
14	臺南市仁德區	2018-11-24T22:33:31+08:00	5839	12514	18353	1048	19401	36671	52.91%	15.92%	30	49
14	臺南市仁德區	2018-11-25T00:14:02+08:00	10442	22130	32572	1886	34458	64632	53.31%	16.16%	49	49
14	臺南市仁德區	2018-11-25T04:02:42+08:00	10442	22130	32572	1886	34458	64632	53.31%	16.16%	49	49
14	臺南市仁德區	2018-11-24T23:43:10+08:00	10442	22130	32572	1886	34458	64632	53.31%	16.16%	49	49
14	臺南市仁德區	2018-11-25T06:08:44+08:00	10442	22130	32572	1886	34458	64632	53.31%	16.16%	49	49
14	臺南市仁德區	2018-11-25T00:09:26+08:00	10442	22130	32572	1886	34458	64632	53.31%	16.16%	49	49
14	臺南市仁德區	2018-11-24T23:12:08+08:00	8574	18168	26742	1555	28297	53259	53.13%	16.1%	41	49
14	臺南市仁德區	2018-11-24T23:39:07+08:00	10442	22130	32572	1886	34458	64632	53.31%	16.16%	49	49
14	臺南市仁德區	2018-11-24T23:31:03+08:00	10442	22130	32572	1886	34458	64632	53.31%	16.16%	49	49
14	臺南市仁德區	2018-11-24T23:01:24+08:00	8077	17160	25237	1475	26712	50262	53.15%	16.07%	39	49
14	臺南市仁德區	2018-11-24T23:19:42+08:00	9502	20191	29693	1760	31453	58959	53.35%	16.12%	45	49
14	臺南市仁德區	2018-11-25T00:04:58+08:00	10442	22130	32572	1886	34458	64632	53.31%	16.16%	49	49
14	臺南市仁德區	2018-11-24T23:04:57+08:00	8416	17737	26153	1506	27659	51949	53.24%	16.2%	40	49
14	臺南市仁德區	2018-11-25T00:57:29+08:00	10442	22130	32572	1886	34458	64632	53.31%	16.16%	49	49
14	臺南市仁德區	2018-11-24T22:13:19+08:00	4539	9709	14248	830	15078	28601	52.72%	15.87%	24	49
14	臺南市仁德區	2018-11-25T03:44:14+08:00	10442	22130	32572	1886	34458	64632	53.31%	16.16%	49	49
14	臺南市仁德區	2018-11-25T01:17:43+08:00	10442	22130	32572	1886	34458	64632	53.31%	16.16%	49	49
14	臺南市仁德區	2018-11-24T23:55:40+08:00	10442	22130	32572	1886	34458	64632	53.31%	16.16%	49	49
14	臺南市仁德區	2018-11-25T06:18:51+08:00	10442	22130	32572	1886	34458	64632	53.31%	16.16%	49	49
14	臺南市仁德區	2018-11-25T01:02:23+08:00	10442	22130	32572	1886	34458	64632	53.31%	16.16%	49	49
14	臺南市仁德區	2018-11-25T01:25:45+08:00	10442	22130	32572	1886	34458	64632	53.31%	16.16%	49	49
14	臺南市仁德區	2018-11-25T03:38:48+08:00	10442	22130	32572	1886	34458	64632	53.31%	16.16%	49	49
14	臺南市仁德區	2018-11-24T22:40:21+08:00	6296	13432	19728	1135	20863	39576	52.72%	15.91%	32	49
14	臺南市仁德區	2018-11-24T23:27:12+08:00	9994	21156	31150	1839	32989	61762	53.41%	16.18%	47	49
14	臺南市仁德區	2018-11-25T00:18:23+08:00	10442	22130	32572	1886	34458	64632	53.31%	16.16%	49	49
14	臺南市仁德區	2018-11-24T22:54:19+08:00	7336	15633	22969	1304	24273	45855	52.93%	16%	36	49
14	臺南市仁德區	2018-11-25T06:13:46+08:00	10442	22130	32572	1886	34458	64632	53.31%	16.16%	49	49
14	臺南市仁德區	2018-11-25T00:22:57+08:00	10442	22130	32572	1886	34458	64632	53.31%	16.16%	49	49
14	臺南市仁德區	2018-11-25T03:56:04+08:00	10442	22130	32572	1886	34458	64632	53.31%	16.16%	49	49
14	臺南市仁德區	2018-11-24T22:16:02+08:00	4765	10163	14928	881	15809	29919	52.84%	15.93%	25	49
14	臺南市仁德區	2018-11-24T22:41:28+08:00	6296	13432	19728	1135	20863	39576	52.72%	15.91%	32	49
14	臺南市仁德區	2018-11-25T01:12:35+08:00	10442	22130	32572	1886	34458	64632	53.31%	16.16%	49	49
14	臺南市仁德區	2018-11-24T22:29:59+08:00	5607	12027	17634	1030	18664	35200	53.02%	15.93%	29	49
14	臺南市仁德區	2018-11-24T23:23:32+08:00	9743	20653	30396	1798	32194	60372	53.33%	16.14%	46	49
14	臺南市仁德區	2018-11-24T22:57:46+08:00	7814	16612	24426	1433	25859	48809	52.98%	16.01%	38	49
14	臺南市仁德區	2018-11-25T00:00:01+08:00	10442	22130	32572	1886	34458	64632	53.31%	16.16%	49	49
14	臺南市仁德區	2018-11-24T23:51:27+08:00	10442	22130	32572	1886	34458	64632	53.31%	16.16%	49	49
14	臺南市仁德區	2018-11-24T22:23:05+08:00	5201	11065	16266	965	17231	32593	52.87%	15.96%	27	49
14	臺南市仁德區	2018-11-24T22:36:54+08:00	6049	12979	19028	1079	20107	38085	52.8%	15.88%	31	49
14	臺南市仁德區	2018-11-24T23:15:56+08:00	9268	19655	28923	1697	30620	57586	53.17%	16.09%	44	49
14	臺南市仁德區	2018-11-24T23:08:28+08:00	8416	17737	26153	1506	27659	51949	53.24%	16.2%	40	49
14	臺南市仁德區	2018-11-25T03:32:27+08:00	10442	22130	32572	1886	34458	64632	53.31%	16.16%	49	49
14	臺南市仁德區	2018-11-24T22:19:30+08:00	4995	10655	15650	928	16578	31325	52.92%	15.95%	26	49
14	臺南市仁德區	2018-11-24T22:45:02+08:00	6535	13925	20460	1161	21621	40911	52.85%	15.97%	33	49
14	臺南市仁德區	2018-11-24T22:50:40+08:00	7121	15135	22256	1251	23507	44390	52.96%	16.04%	35	49
14	臺南市仁德區	2018-11-24T22:26:30+08:00	5404	11501	16905	990	17895	33870	52.83%	15.96%	28	49
14	臺南市仁德區	2018-11-25T03:49:45+08:00	10442	22130	32572	1886	34458	64632	53.31%	16.16%	49	49
14	臺南市仁德區	2018-11-25T06:29:09+08:00	10442	22130	32572	1886	34458	64632	53.31%	16.16%	49	49
14	臺南市仁德區	2018-11-25T06:23:53+08:00	10442	22130	32572	1886	34458	64632	53.31%	16.16%	49	49
14	桃園市桃園區	2018-11-25T01:07:17+08:00	57280	108466	165746	7393	173139	340679	50.82%	16.81%	206	216
14	桃園市桃園區	2018-11-25T06:08:42+08:00	60327	114427	174754	7782	182536	359790	50.73%	16.77%	216	216
14	桃園市桃園區	2018-11-24T22:26:28+08:00	16796	31543	48339	2265	50604	98139	51.56%	17.11%	66	216
14	桃園市桃園區	2018-11-24T23:47:18+08:00	39455	74696	114151	5147	119298	233909	51%	16.87%	146	216
14	桃園市桃園區	2018-11-24T23:35:02+08:00	35128	66508	101636	4576	106212	207511	51.18%	16.93%	131	216
14	桃園市桃園區	2018-11-24T22:16:00+08:00	15458	29058	44516	2055	46571	90684	51.36%	17.05%	61	216
14	桃園市桃園區	2018-11-24T23:51:25+08:00	39968	75643	115611	5220	120831	236907	51%	16.87%	148	216
14	桃園市桃園區	2018-11-25T00:04:56+08:00	43565	82265	125830	5616	131446	258523	50.84%	16.85%	160	216
14	桃園市桃園區	2018-11-24T22:19:28+08:00	16282	30548	46830	2166	48996	95231	51.45%	17.1%	64	216
14	桃園市桃園區	2018-11-25T00:57:27+08:00	55798	105656	161454	7209	168663	331739	50.84%	16.82%	201	216
14	桃園市桃園區	2018-11-24T22:57:43+08:00	24643	46377	71020	3191	74211	144099	51.5%	17.1%	94	216
14	桃園市桃園區	2018-11-24T22:13:17+08:00	13823	25939	39762	1837	41599	81630	50.96%	16.93%	55	216
14	桃園市桃園區	2018-11-24T23:23:30+08:00	30971	58653	89624	4003	93627	182391	51.33%	16.98%	116	216
14	桃園市桃園區	2018-11-24T22:29:55+08:00	17338	32619	49957	2344	52301	101447	51.55%	17.09%	68	216
14	桃園市桃園區	2018-11-24T23:08:25+08:00	26465	49872	76337	3433	79770	155026	51.46%	17.07%	101	216
14	桃園市桃園區	2018-11-24T23:55:38+08:00	41457	78345	119802	5397	125199	245585	50.98%	16.88%	153	216
14	桃園市桃園區	2018-11-25T03:38:46+08:00	60327	114427	174754	7782	182536	359790	50.73%	16.77%	216	216
14	桃園市桃園區	2018-11-24T23:59:58+08:00	42289	79832	122121	5493	127614	251059	50.83%	16.84%	156	216
14	桃園市桃園區	2018-11-25T03:32:25+08:00	60327	114427	174754	7782	182536	359790	50.73%	16.77%	216	216
14	桃園市桃園區	2018-11-24T23:15:53+08:00	28720	54332	83052	3710	86762	168875	51.38%	17.01%	109	216
14	桃園市桃園區	2018-11-24T22:40:19+08:00	19527	36815	56342	2591	58933	114332	51.55%	17.08%	76	216
14	桃園市桃園區	2018-11-25T01:25:43+08:00	58800	111445	170245	7620	177865	350187	50.79%	16.79%	211	216
14	桃園市桃園區	2018-11-25T06:23:51+08:00	60327	114427	174754	7782	182536	359790	50.73%	16.77%	216	216
14	桃園市桃園區	2018-11-24T22:54:17+08:00	22845	43052	65897	3012	68909	133886	51.47%	17.06%	88	216
14	桃園市桃園區	2018-11-24T22:45:00+08:00	20273	38335	58608	2689	61297	118933	51.54%	17.05%	79	216
14	桃園市桃園區	2018-11-24T23:01:21+08:00	25381	47703	73084	3279	76363	148346	51.48%	17.11%	97	216
14	桃園市桃園區	2018-11-24T23:31:01+08:00	34045	64465	98510	4450	102960	201072	51.21%	16.93%	127	216
14	桃園市桃園區	2018-11-25T00:09:23+08:00	44481	83986	128467	5737	134204	264177	50.8%	16.84%	163	216
14	桃園市桃園區	2018-11-24T22:41:27+08:00	19527	36815	56342	2591	58933	114332	51.55%	17.08%	76	216
14	桃園市桃園區	2018-11-24T22:50:37+08:00	22013	41489	63502	2887	66389	128678	51.59%	17.11%	85	216
14	桃園市桃園區	2018-11-25T00:14:00+08:00	46086	87220	133306	5954	139260	274135	50.8%	16.81%	169	216
14	桃園市桃園區	2018-11-24T23:12:05+08:00	26964	50880	77844	3480	81324	158492	51.31%	17.01%	103	216
14	桃園市桃園區	2018-11-24T23:39:04+08:00	36653	69445	106098	4742	110840	216848	51.11%	16.9%	136	216
14	桃園市桃園區	2018-11-25T01:12:32+08:00	57898	109678	167576	7486	175062	344461	50.82%	16.81%	208	216
14	桃園市桃園區	2018-11-25T03:44:11+08:00	60327	114427	174754	7782	182536	359790	50.73%	16.77%	216	216
14	桃園市桃園區	2018-11-25T06:18:48+08:00	60327	114427	174754	7782	182536	359790	50.73%	16.77%	216	216
14	桃園市桃園區	2018-11-24T23:04:55+08:00	25680	48304	73984	3322	77306	150089	51.51%	17.11%	98	216
14	桃園市桃園區	2018-11-24T22:23:02+08:00	16540	31088	47628	2205	49833	96786	51.49%	17.09%	65	216
14	桃園市桃園區	2018-11-25T01:17:40+08:00	58190	110319	168509	7542	176051	346456	50.81%	16.8%	209	216
14	桃園市桃園區	2018-11-24T23:27:10+08:00	31813	60294	92107	4109	96216	187556	51.3%	16.96%	119	216
14	桃園市桃園區	2018-11-24T22:36:52+08:00	18609	35034	53643	2500	56143	108869	51.57%	17.09%	73	216
14	桃園市桃園區	2018-11-25T01:02:21+08:00	56348	106698	163046	7271	170317	334898	50.86%	16.83%	203	216
14	桃園市桃園區	2018-11-24T23:19:39+08:00	29945	56786	86731	3865	90596	176115	51.44%	17%	113	216
14	桃園市桃園區	2018-11-25T06:29:06+08:00	60327	114427	174754	7782	182536	359790	50.73%	16.77%	216	216
14	桃園市桃園區	2018-11-25T03:56:01+08:00	60327	114427	174754	7782	182536	359790	50.73%	16.77%	216	216
14	桃園市桃園區	2018-11-24T22:33:28+08:00	18083	33959	52042	2447	54489	105697	51.55%	17.11%	71	216
14	桃園市桃園區	2018-11-25T06:13:43+08:00	60327	114427	174754	7782	182536	359790	50.73%	16.77%	216	216
14	桃園市桃園區	2018-11-25T04:02:39+08:00	60327	114427	174754	7782	182536	359790	50.73%	16.77%	216	216
14	桃園市桃園區	2018-11-25T00:18:21+08:00	47593	90254	137847	6144	143991	283460	50.8%	16.79%	174	216
14	桃園市桃園區	2018-11-25T00:22:54+08:00	48816	92434	141250	6296	147546	290422	50.8%	16.81%	178	216
14	桃園市桃園區	2018-11-25T03:49:42+08:00	60327	114427	174754	7782	182536	359790	50.73%	16.77%	216	216
14	桃園市桃園區	2018-11-24T23:43:08+08:00	38639	73218	111857	5048	116905	229113	51.03%	16.86%	143	216
14	桃園市新屋區	2018-11-25T01:07:17+08:00	6086	15647	21733	1409	23142	41461	55.82%	14.68%	30	30
14	桃園市新屋區	2018-11-24T23:01:22+08:00	5526	14268	19794	1295	21089	37573	56.13%	14.71%	28	30
14	桃園市新屋區	2018-11-25T06:08:42+08:00	6086	15647	21733	1409	23142	41461	55.82%	14.68%	30	30
14	桃園市新屋區	2018-11-24T23:47:18+08:00	6086	15647	21733	1409	23142	41461	55.82%	14.68%	30	30
14	桃園市新屋區	2018-11-24T23:35:02+08:00	6086	15647	21733	1409	23142	41461	55.82%	14.68%	30	30
14	桃園市新屋區	2018-11-24T23:12:06+08:00	5526	14268	19794	1295	21089	37573	56.13%	14.71%	28	30
14	桃園市新屋區	2018-11-24T22:26:29+08:00	4703	12104	16807	1128	17935	32117	55.84%	14.64%	25	30
14	桃園市新屋區	2018-11-24T22:16:00+08:00	4472	11607	16079	1075	17154	30846	55.61%	14.5%	24	30
14	桃園市新屋區	2018-11-25T03:44:12+08:00	6086	15647	21733	1409	23142	41461	55.82%	14.68%	30	30
14	桃園市新屋區	2018-11-25T00:04:56+08:00	6086	15647	21733	1409	23142	41461	55.82%	14.68%	30	30
14	桃園市新屋區	2018-11-24T22:19:28+08:00	4472	11607	16079	1075	17154	30846	55.61%	14.5%	24	30
14	桃園市新屋區	2018-11-24T22:57:44+08:00	5526	14268	19794	1295	21089	37573	56.13%	14.71%	28	30
14	桃園市新屋區	2018-11-25T00:57:27+08:00	6086	15647	21733	1409	23142	41461	55.82%	14.68%	30	30
14	桃園市新屋區	2018-11-24T22:13:17+08:00	4472	11607	16079	1075	17154	30846	55.61%	14.5%	24	30
14	桃園市新屋區	2018-11-24T23:23:30+08:00	5526	14268	19794	1295	21089	37573	56.13%	14.71%	28	30
14	桃園市新屋區	2018-11-24T22:29:55+08:00	4703	12104	16807	1128	17935	32117	55.84%	14.64%	25	30
14	桃園市新屋區	2018-11-24T23:55:38+08:00	6086	15647	21733	1409	23142	41461	55.82%	14.68%	30	30
14	桃園市新屋區	2018-11-25T03:32:25+08:00	6086	15647	21733	1409	23142	41461	55.82%	14.68%	30	30
14	桃園市新屋區	2018-11-24T23:15:54+08:00	5526	14268	19794	1295	21089	37573	56.13%	14.71%	28	30
14	桃園市新屋區	2018-11-24T22:40:19+08:00	5246	13455	18701	1255	19956	35581	56.09%	14.74%	27	30
14	桃園市新屋區	2018-11-25T01:25:43+08:00	6086	15647	21733	1409	23142	41461	55.82%	14.68%	30	30
14	桃園市新屋區	2018-11-24T23:59:59+08:00	6086	15647	21733	1409	23142	41461	55.82%	14.68%	30	30
14	桃園市新屋區	2018-11-25T03:38:47+08:00	6086	15647	21733	1409	23142	41461	55.82%	14.68%	30	30
14	桃園市新屋區	2018-11-24T22:54:18+08:00	5526	14268	19794	1295	21089	37573	56.13%	14.71%	28	30
14	桃園市新屋區	2018-11-25T06:23:51+08:00	6086	15647	21733	1409	23142	41461	55.82%	14.68%	30	30
14	桃園市新屋區	2018-11-24T22:45:00+08:00	5526	14268	19794	1295	21089	37573	56.13%	14.71%	28	30
14	桃園市新屋區	2018-11-24T23:31:01+08:00	5768	14847	20615	1335	21950	39429	55.67%	14.63%	29	30
14	桃園市新屋區	2018-11-25T00:09:24+08:00	6086	15647	21733	1409	23142	41461	55.82%	14.68%	30	30
14	桃園市新屋區	2018-11-24T22:41:27+08:00	5246	13455	18701	1255	19956	35581	56.09%	14.74%	27	30
14	桃園市新屋區	2018-11-25T01:12:33+08:00	6086	15647	21733	1409	23142	41461	55.82%	14.68%	30	30
14	桃園市新屋區	2018-11-24T22:50:37+08:00	5526	14268	19794	1295	21089	37573	56.13%	14.71%	28	30
14	桃園市新屋區	2018-11-25T00:14:00+08:00	6086	15647	21733	1409	23142	41461	55.82%	14.68%	30	30
14	桃園市新屋區	2018-11-24T23:39:04+08:00	6086	15647	21733	1409	23142	41461	55.82%	14.68%	30	30
14	桃園市新屋區	2018-11-24T23:51:26+08:00	6086	15647	21733	1409	23142	41461	55.82%	14.68%	30	30
14	桃園市新屋區	2018-11-25T06:18:49+08:00	6086	15647	21733	1409	23142	41461	55.82%	14.68%	30	30
14	桃園市新屋區	2018-11-25T01:17:41+08:00	6086	15647	21733	1409	23142	41461	55.82%	14.68%	30	30
14	桃園市新屋區	2018-11-24T22:23:03+08:00	4703	12104	16807	1128	17935	32117	55.84%	14.64%	25	30
14	桃園市新屋區	2018-11-24T23:04:55+08:00	5526	14268	19794	1295	21089	37573	56.13%	14.71%	28	30
14	桃園市新屋區	2018-11-24T23:19:40+08:00	5526	14268	19794	1295	21089	37573	56.13%	14.71%	28	30
14	桃園市新屋區	2018-11-24T23:27:10+08:00	5526	14268	19794	1295	21089	37573	56.13%	14.71%	28	30
14	桃園市新屋區	2018-11-24T23:08:26+08:00	5526	14268	19794	1295	21089	37573	56.13%	14.71%	28	30
14	桃園市新屋區	2018-11-24T22:36:52+08:00	5028	12918	17946	1193	19139	34212	55.94%	14.7%	26	30
14	桃園市新屋區	2018-11-25T01:02:21+08:00	6086	15647	21733	1409	23142	41461	55.82%	14.68%	30	30
14	桃園市新屋區	2018-11-25T03:49:43+08:00	6086	15647	21733	1409	23142	41461	55.82%	14.68%	30	30
14	桃園市新屋區	2018-11-25T00:22:55+08:00	6086	15647	21733	1409	23142	41461	55.82%	14.68%	30	30
14	桃園市新屋區	2018-11-25T03:56:01+08:00	6086	15647	21733	1409	23142	41461	55.82%	14.68%	30	30
14	桃園市新屋區	2018-11-25T04:02:39+08:00	6086	15647	21733	1409	23142	41461	55.82%	14.68%	30	30
14	桃園市新屋區	2018-11-25T06:13:44+08:00	6086	15647	21733	1409	23142	41461	55.82%	14.68%	30	30
14	桃園市新屋區	2018-11-25T00:18:21+08:00	6086	15647	21733	1409	23142	41461	55.82%	14.68%	30	30
14	桃園市新屋區	2018-11-24T22:33:29+08:00	4703	12104	16807	1128	17935	32117	55.84%	14.64%	25	30
14	桃園市新屋區	2018-11-25T06:29:07+08:00	6086	15647	21733	1409	23142	41461	55.82%	14.68%	30	30
14	桃園市新屋區	2018-11-24T23:43:08+08:00	6086	15647	21733	1409	23142	41461	55.82%	14.68%	30	30
14	臺中市新社區	2018-11-24T23:47:19+08:00	2779	7819	10598	667	11265	20860	54%	13.32%	23	23
14	臺中市新社區	2018-11-24T23:35:03+08:00	2779	7819	10598	667	11265	20860	54%	13.32%	23	23
14	臺中市新社區	2018-11-24T22:16:01+08:00	2779	7819	10598	667	11265	20860	54%	13.32%	23	23
14	臺中市新社區	2018-11-24T23:31:02+08:00	2779	7819	10598	667	11265	20860	54%	13.32%	23	23
14	臺中市新社區	2018-11-24T23:01:22+08:00	2779	7819	10598	667	11265	20860	54%	13.32%	23	23
14	臺中市新社區	2018-11-24T23:12:07+08:00	2779	7819	10598	667	11265	20860	54%	13.32%	23	23
14	臺中市新社區	2018-11-25T01:07:18+08:00	2779	7819	10598	667	11265	20860	54%	13.32%	23	23
14	臺中市新社區	2018-11-25T06:08:43+08:00	2779	7819	10598	667	11265	20860	54%	13.32%	23	23
14	臺中市新社區	2018-11-24T22:26:29+08:00	2779	7819	10598	667	11265	20860	54%	13.32%	23	23
14	臺中市新社區	2018-11-25T01:17:42+08:00	2779	7819	10598	667	11265	20860	54%	13.32%	23	23
14	臺中市新社區	2018-11-24T22:13:18+08:00	2779	7819	10598	667	11265	20860	54%	13.32%	23	23
14	臺中市新社區	2018-11-24T22:19:29+08:00	2779	7819	10598	667	11265	20860	54%	13.32%	23	23
14	臺中市新社區	2018-11-25T00:57:28+08:00	2779	7819	10598	667	11265	20860	54%	13.32%	23	23
14	臺中市新社區	2018-11-24T23:23:31+08:00	2779	7819	10598	667	11265	20860	54%	13.32%	23	23
14	臺中市新社區	2018-11-24T22:57:44+08:00	2779	7819	10598	667	11265	20860	54%	13.32%	23	23
14	臺中市新社區	2018-11-25T03:44:13+08:00	2779	7819	10598	667	11265	20860	54%	13.32%	23	23
14	臺中市新社區	2018-11-25T00:04:57+08:00	2779	7819	10598	667	11265	20860	54%	13.32%	23	23
14	臺中市新社區	2018-11-24T23:04:56+08:00	2779	7819	10598	667	11265	20860	54%	13.32%	23	23
14	臺中市新社區	2018-11-24T23:15:55+08:00	2779	7819	10598	667	11265	20860	54%	13.32%	23	23
14	臺中市新社區	2018-11-24T22:40:20+08:00	2779	7819	10598	667	11265	20860	54%	13.32%	23	23
14	臺中市新社區	2018-11-25T01:25:44+08:00	2779	7819	10598	667	11265	20860	54%	13.32%	23	23
14	臺中市新社區	2018-11-25T01:02:22+08:00	2779	7819	10598	667	11265	20860	54%	13.32%	23	23
14	臺中市新社區	2018-11-25T03:38:47+08:00	2779	7819	10598	667	11265	20860	54%	13.32%	23	23
14	臺中市新社區	2018-11-24T23:55:39+08:00	2779	7819	10598	667	11265	20860	54%	13.32%	23	23
14	臺中市新社區	2018-11-24T22:54:18+08:00	2779	7819	10598	667	11265	20860	54%	13.32%	23	23
14	臺中市新社區	2018-11-24T22:45:01+08:00	2779	7819	10598	667	11265	20860	54%	13.32%	23	23
14	臺中市新社區	2018-11-25T00:18:22+08:00	2779	7819	10598	667	11265	20860	54%	13.32%	23	23
14	臺中市新社區	2018-11-25T00:22:56+08:00	2779	7819	10598	667	11265	20860	54%	13.32%	23	23
14	臺中市新社區	2018-11-25T03:56:02+08:00	2779	7819	10598	667	11265	20860	54%	13.32%	23	23
14	臺中市新社區	2018-11-24T23:39:05+08:00	2779	7819	10598	667	11265	20860	54%	13.32%	23	23
14	臺中市新社區	2018-11-25T00:09:24+08:00	2779	7819	10598	667	11265	20860	54%	13.32%	23	23
14	臺中市新社區	2018-11-25T01:12:34+08:00	2779	7819	10598	667	11265	20860	54%	13.32%	23	23
14	臺中市新社區	2018-11-24T22:41:27+08:00	2779	7819	10598	667	11265	20860	54%	13.32%	23	23
14	臺中市新社區	2018-11-25T04:02:40+08:00	2779	7819	10598	667	11265	20860	54%	13.32%	23	23
14	臺中市新社區	2018-11-25T00:14:01+08:00	2779	7819	10598	667	11265	20860	54%	13.32%	23	23
14	臺中市新社區	2018-11-24T22:50:38+08:00	2779	7819	10598	667	11265	20860	54%	13.32%	23	23
14	臺中市新社區	2018-11-24T23:51:26+08:00	2779	7819	10598	667	11265	20860	54%	13.32%	23	23
14	臺中市新社區	2018-11-25T00:00:00+08:00	2779	7819	10598	667	11265	20860	54%	13.32%	23	23
14	臺中市新社區	2018-11-25T06:18:49+08:00	2779	7819	10598	667	11265	20860	54%	13.32%	23	23
14	臺中市新社區	2018-11-24T22:23:04+08:00	2779	7819	10598	667	11265	20860	54%	13.32%	23	23
14	臺中市新社區	2018-11-24T22:29:56+08:00	2779	7819	10598	667	11265	20860	54%	13.32%	23	23
14	臺中市新社區	2018-11-24T23:19:40+08:00	2779	7819	10598	667	11265	20860	54%	13.32%	23	23
14	臺中市新社區	2018-11-24T22:36:53+08:00	2779	7819	10598	667	11265	20860	54%	13.32%	23	23
14	臺中市新社區	2018-11-24T23:27:11+08:00	2779	7819	10598	667	11265	20860	54%	13.32%	23	23
14	臺中市新社區	2018-11-24T23:08:27+08:00	2779	7819	10598	667	11265	20860	54%	13.32%	23	23
14	臺中市新社區	2018-11-25T03:32:26+08:00	2779	7819	10598	667	11265	20860	54%	13.32%	23	23
14	臺中市新社區	2018-11-25T03:49:43+08:00	2779	7819	10598	667	11265	20860	54%	13.32%	23	23
14	臺中市新社區	2018-11-25T06:29:08+08:00	2779	7819	10598	667	11265	20860	54%	13.32%	23	23
14	臺中市新社區	2018-11-25T06:13:44+08:00	2779	7819	10598	667	11265	20860	54%	13.32%	23	23
14	臺中市新社區	2018-11-25T06:23:52+08:00	2779	7819	10598	667	11265	20860	54%	13.32%	23	23
14	臺中市新社區	2018-11-24T23:43:09+08:00	2779	7819	10598	667	11265	20860	54%	13.32%	23	23
14	臺中市新社區	2018-11-24T22:33:29+08:00	2779	7819	10598	667	11265	20860	54%	13.32%	23	23
14	臺中市豐原區	2018-11-24T23:47:19+08:00	20943	47187	68130	4065	72195	119940	60.19%	17.46%	79	88
14	臺中市豐原區	2018-11-24T22:16:01+08:00	12755	29299	42054	2585	44639	74328	60.06%	17.16%	50	88
14	臺中市豐原區	2018-11-25T01:07:17+08:00	23853	53873	77726	4566	82292	136658	60.22%	17.45%	88	88
14	臺中市豐原區	2018-11-24T23:01:22+08:00	18939	42472	61411	3694	65105	108138	60.21%	17.51%	72	88
14	臺中市豐原區	2018-11-24T23:35:02+08:00	20118	45347	65465	3946	69411	115563	60.06%	17.41%	76	88
14	臺中市豐原區	2018-11-24T23:12:06+08:00	19532	43903	63435	3821	67256	111828	60.14%	17.47%	74	88
14	臺中市豐原區	2018-11-25T06:08:43+08:00	23853	53873	77726	4566	82292	136658	60.22%	17.45%	88	88
14	臺中市豐原區	2018-11-24T22:26:29+08:00	13867	31945	45812	2781	48593	80845	60.11%	17.15%	54	88
14	臺中市豐原區	2018-11-25T03:44:12+08:00	23853	53873	77726	4566	82292	136658	60.22%	17.45%	88	88
14	臺中市豐原區	2018-11-24T22:19:29+08:00	12755	29299	42054	2585	44639	74328	60.06%	17.16%	50	88
14	臺中市豐原區	2018-11-25T00:57:28+08:00	23853	53873	77726	4566	82292	136658	60.22%	17.45%	88	88
14	臺中市豐原區	2018-11-25T00:04:56+08:00	22589	50982	73571	4349	77920	129479	60.18%	17.45%	84	88
14	臺中市豐原區	2018-11-24T22:57:44+08:00	18939	42472	61411	3694	65105	108138	60.21%	17.51%	72	88
14	臺中市豐原區	2018-11-24T22:13:17+08:00	12479	28568	41047	2505	43552	72570	60.01%	17.2%	49	88
14	臺中市豐原區	2018-11-24T23:23:30+08:00	20118	45347	65465	3946	69411	115563	60.06%	17.41%	76	88
14	臺中市豐原區	2018-11-24T23:55:38+08:00	21648	48739	70387	4176	74563	123831	60.21%	17.48%	81	88
14	臺中市豐原區	2018-11-24T22:40:20+08:00	16622	36857	53479	3189	56668	94094	60.22%	17.67%	63	88
14	臺中市豐原區	2018-11-24T23:15:54+08:00	19791	44598	64389	3879	68268	113549	60.12%	17.43%	75	88
14	臺中市豐原區	2018-11-25T01:25:43+08:00	23853	53873	77726	4566	82292	136658	60.22%	17.45%	88	88
14	臺中市豐原區	2018-11-24T23:59:59+08:00	21648	48739	70387	4176	74563	123831	60.21%	17.48%	81	88
14	臺中市豐原區	2018-11-25T01:02:22+08:00	23853	53873	77726	4566	82292	136658	60.22%	17.45%	88	88
14	臺中市豐原區	2018-11-25T03:38:47+08:00	23853	53873	77726	4566	82292	136658	60.22%	17.45%	88	88
14	臺中市豐原區	2018-11-24T22:54:18+08:00	18435	41348	59783	3607	63390	105331	60.18%	17.5%	70	88
14	臺中市豐原區	2018-11-25T03:56:02+08:00	23853	53873	77726	4566	82292	136658	60.22%	17.45%	88	88
14	臺中市豐原區	2018-11-24T22:45:00+08:00	16779	37223	54002	3232	57234	95077	60.2%	17.65%	64	88
14	臺中市豐原區	2018-11-24T23:39:05+08:00	20713	46575	67288	4014	71302	118534	60.15%	17.47%	78	88
14	臺中市豐原區	2018-11-24T23:31:01+08:00	20118	45347	65465	3946	69411	115563	60.06%	17.41%	76	88
14	臺中市豐原區	2018-11-25T00:09:24+08:00	22589	50982	73571	4349	77920	129479	60.18%	17.45%	84	88
14	臺中市豐原區	2018-11-24T22:41:27+08:00	16622	36857	53479	3189	56668	94094	60.22%	17.67%	63	88
14	臺中市豐原區	2018-11-25T04:02:40+08:00	23853	53873	77726	4566	82292	136658	60.22%	17.45%	88	88
14	臺中市豐原區	2018-11-25T01:12:33+08:00	23853	53873	77726	4566	82292	136658	60.22%	17.45%	88	88
14	臺中市豐原區	2018-11-25T00:14:01+08:00	22913	51753	74666	4388	79054	131250	60.23%	17.46%	85	88
14	臺中市豐原區	2018-11-24T22:50:38+08:00	17864	39914	57778	3474	61252	101655	60.25%	17.57%	68	88
14	臺中市豐原區	2018-11-24T23:51:26+08:00	20943	47187	68130	4065	72195	119940	60.19%	17.46%	79	88
14	臺中市豐原區	2018-11-25T06:18:49+08:00	23853	53873	77726	4566	82292	136658	60.22%	17.45%	88	88
14	臺中市豐原區	2018-11-25T01:17:41+08:00	23853	53873	77726	4566	82292	136658	60.22%	17.45%	88	88
14	臺中市豐原區	2018-11-24T22:23:03+08:00	13208	30403	43611	2676	46287	76889	60.2%	17.18%	52	88
14	臺中市豐原區	2018-11-24T22:29:56+08:00	14339	33207	47546	2854	50400	84040	59.97%	17.06%	56	88
14	臺中市豐原區	2018-11-24T23:04:55+08:00	18939	42472	61411	3694	65105	108138	60.21%	17.51%	72	88
14	臺中市豐原區	2018-11-24T23:19:40+08:00	19791	44598	64389	3879	68268	113549	60.12%	17.43%	75	88
14	臺中市豐原區	2018-11-24T22:36:53+08:00	15573	35733	51306	3063	54369	90420	60.13%	17.22%	60	88
14	臺中市豐原區	2018-11-24T23:27:10+08:00	20118	45347	65465	3946	69411	115563	60.06%	17.41%	76	88
14	臺中市豐原區	2018-11-24T23:08:26+08:00	19235	43206	62441	3755	66196	110005	60.18%	17.49%	73	88
14	臺中市豐原區	2018-11-25T03:32:26+08:00	23853	53873	77726	4566	82292	136658	60.22%	17.45%	88	88
14	臺中市豐原區	2018-11-25T03:49:43+08:00	23853	53873	77726	4566	82292	136658	60.22%	17.45%	88	88
14	臺中市豐原區	2018-11-25T00:22:55+08:00	23192	52422	75614	4430	80044	132796	60.28%	17.46%	86	88
14	臺中市豐原區	2018-11-25T06:13:44+08:00	23853	53873	77726	4566	82292	136658	60.22%	17.45%	88	88
14	臺中市豐原區	2018-11-25T00:18:21+08:00	22913	51753	74666	4388	79054	131250	60.23%	17.46%	85	88
14	臺中市豐原區	2018-11-25T06:23:52+08:00	23853	53873	77726	4566	82292	136658	60.22%	17.45%	88	88
14	臺中市豐原區	2018-11-24T23:43:09+08:00	20943	47187	68130	4065	72195	119940	60.19%	17.46%	79	88
14	臺中市豐原區	2018-11-24T22:33:29+08:00	14590	33774	48364	2911	51275	85300	60.11%	17.1%	57	88
14	臺中市豐原區	2018-11-25T06:29:07+08:00	23853	53873	77726	4566	82292	136658	60.22%	17.45%	88	88
14	嘉義縣阿里山鄉	2018-11-25T03:56:10+08:00	437	1639	2076	112	2188	4691	46.64%	9.32%	13	13
14	嘉義縣阿里山鄉	2018-11-24T23:47:26+08:00	437	1639	2076	112	2188	4691	46.64%	9.32%	13	13
14	嘉義縣阿里山鄉	2018-11-24T23:16:01+08:00	437	1639	2076	112	2188	4691	46.64%	9.32%	13	13
14	嘉義縣阿里山鄉	2018-11-24T22:16:08+08:00	282	1104	1386	76	1462	3184	45.92%	8.86%	10	13
14	嘉義縣阿里山鄉	2018-11-24T22:33:36+08:00	337	1298	1635	97	1732	3721	46.55%	9.06%	12	13
14	嘉義縣阿里山鄉	2018-11-25T03:38:53+08:00	437	1639	2076	112	2188	4691	46.64%	9.32%	13	13
14	嘉義縣阿里山鄉	2018-11-24T23:23:36+08:00	437	1639	2076	112	2188	4691	46.64%	9.32%	13	13
14	嘉義縣阿里山鄉	2018-11-25T01:25:51+08:00	437	1639	2076	112	2188	4691	46.64%	9.32%	13	13
14	嘉義縣阿里山鄉	2018-11-24T22:19:35+08:00	282	1104	1386	76	1462	3184	45.92%	8.86%	10	13
14	嘉義縣阿里山鄉	2018-11-25T01:17:50+08:00	437	1639	2076	112	2188	4691	46.64%	9.32%	13	13
14	嘉義縣阿里山鄉	2018-11-24T22:36:59+08:00	437	1639	2076	112	2188	4691	46.64%	9.32%	13	13
14	嘉義縣阿里山鄉	2018-11-24T22:40:26+08:00	437	1639	2076	112	2188	4691	46.64%	9.32%	13	13
14	嘉義縣阿里山鄉	2018-11-25T00:57:35+08:00	437	1639	2076	112	2188	4691	46.64%	9.32%	13	13
14	嘉義縣阿里山鄉	2018-11-24T22:57:51+08:00	437	1639	2076	112	2188	4691	46.64%	9.32%	13	13
14	嘉義縣阿里山鄉	2018-11-25T00:09:32+08:00	437	1639	2076	112	2188	4691	46.64%	9.32%	13	13
14	嘉義縣阿里山鄉	2018-11-25T06:23:58+08:00	437	1639	2076	112	2188	4691	46.64%	9.32%	13	13
14	嘉義縣阿里山鄉	2018-11-24T23:39:13+08:00	437	1639	2076	112	2188	4691	46.64%	9.32%	13	13
14	嘉義縣阿里山鄉	2018-11-25T03:49:49+08:00	437	1639	2076	112	2188	4691	46.64%	9.32%	13	13
14	嘉義縣阿里山鄉	2018-11-25T01:12:41+08:00	437	1639	2076	112	2188	4691	46.64%	9.32%	13	13
14	嘉義縣阿里山鄉	2018-11-24T22:26:35+08:00	282	1104	1386	76	1462	3184	45.92%	8.86%	10	13
14	嘉義縣阿里山鄉	2018-11-24T23:12:14+08:00	437	1639	2076	112	2188	4691	46.64%	9.32%	13	13
14	嘉義縣阿里山鄉	2018-11-24T22:45:07+08:00	437	1639	2076	112	2188	4691	46.64%	9.32%	13	13
14	嘉義縣阿里山鄉	2018-11-25T06:08:51+08:00	437	1639	2076	112	2188	4691	46.64%	9.32%	13	13
14	嘉義縣阿里山鄉	2018-11-25T04:02:50+08:00	437	1639	2076	112	2188	4691	46.64%	9.32%	13	13
14	嘉義縣阿里山鄉	2018-11-25T06:13:51+08:00	437	1639	2076	112	2188	4691	46.64%	9.32%	13	13
14	嘉義縣阿里山鄉	2018-11-24T23:43:15+08:00	437	1639	2076	112	2188	4691	46.64%	9.32%	13	13
14	嘉義縣阿里山鄉	2018-11-25T00:14:07+08:00	437	1639	2076	112	2188	4691	46.64%	9.32%	13	13
14	嘉義縣阿里山鄉	2018-11-24T23:35:09+08:00	437	1639	2076	112	2188	4691	46.64%	9.32%	13	13
14	嘉義縣阿里山鄉	2018-11-24T23:01:29+08:00	437	1639	2076	112	2188	4691	46.64%	9.32%	13	13
14	嘉義縣阿里山鄉	2018-11-25T01:07:24+08:00	437	1639	2076	112	2188	4691	46.64%	9.32%	13	13
14	嘉義縣阿里山鄉	2018-11-24T23:31:09+08:00	437	1639	2076	112	2188	4691	46.64%	9.32%	13	13
14	嘉義縣阿里山鄉	2018-11-25T06:29:15+08:00	437	1639	2076	112	2188	4691	46.64%	9.32%	13	13
14	嘉義縣阿里山鄉	2018-11-24T23:55:45+08:00	437	1639	2076	112	2188	4691	46.64%	9.32%	13	13
14	嘉義縣阿里山鄉	2018-11-24T23:08:34+08:00	437	1639	2076	112	2188	4691	46.64%	9.32%	13	13
14	嘉義縣阿里山鄉	2018-11-25T00:00:09+08:00	437	1639	2076	112	2188	4691	46.64%	9.32%	13	13
14	嘉義縣阿里山鄉	2018-11-25T00:23:02+08:00	437	1639	2076	112	2188	4691	46.64%	9.32%	13	13
14	嘉義縣阿里山鄉	2018-11-24T23:19:48+08:00	437	1639	2076	112	2188	4691	46.64%	9.32%	13	13
14	嘉義縣阿里山鄉	2018-11-25T03:32:33+08:00	437	1639	2076	112	2188	4691	46.64%	9.32%	13	13
14	嘉義縣阿里山鄉	2018-11-25T03:44:21+08:00	437	1639	2076	112	2188	4691	46.64%	9.32%	13	13
14	嘉義縣阿里山鄉	2018-11-24T22:13:25+08:00	282	1104	1386	76	1462	3184	45.92%	8.86%	10	13
14	嘉義縣阿里山鄉	2018-11-24T22:23:11+08:00	282	1104	1386	76	1462	3184	45.92%	8.86%	10	13
14	嘉義縣阿里山鄉	2018-11-24T22:30:05+08:00	309	1221	1530	90	1620	3430	47.23%	9.01%	11	13
14	嘉義縣阿里山鄉	2018-11-24T23:27:17+08:00	437	1639	2076	112	2188	4691	46.64%	9.32%	13	13
14	嘉義縣阿里山鄉	2018-11-25T01:02:29+08:00	437	1639	2076	112	2188	4691	46.64%	9.32%	13	13
14	嘉義縣阿里山鄉	2018-11-24T23:51:33+08:00	437	1639	2076	112	2188	4691	46.64%	9.32%	13	13
14	嘉義縣阿里山鄉	2018-11-25T06:18:55+08:00	437	1639	2076	112	2188	4691	46.64%	9.32%	13	13
14	嘉義縣阿里山鄉	2018-11-24T23:05:03+08:00	437	1639	2076	112	2188	4691	46.64%	9.32%	13	13
14	嘉義縣阿里山鄉	2018-11-24T22:54:24+08:00	437	1639	2076	112	2188	4691	46.64%	9.32%	13	13
14	嘉義縣阿里山鄉	2018-11-25T00:18:28+08:00	437	1639	2076	112	2188	4691	46.64%	9.32%	13	13
14	嘉義縣阿里山鄉	2018-11-24T22:41:33+08:00	437	1639	2076	112	2188	4691	46.64%	9.32%	13	13
14	嘉義縣阿里山鄉	2018-11-25T00:05:03+08:00	437	1639	2076	112	2188	4691	46.64%	9.32%	13	13
14	嘉義縣阿里山鄉	2018-11-24T22:50:46+08:00	437	1639	2076	112	2188	4691	46.64%	9.32%	13	13
14	宜蘭縣頭城鎮	2018-11-24T22:33:37+08:00	4144	8579	12723	1078	13801	25135	54.91%	16.49%	32	32
14	宜蘭縣頭城鎮	2018-11-24T23:47:28+08:00	4144	8579	12723	1078	13801	25135	54.91%	16.49%	32	32
14	宜蘭縣頭城鎮	2018-11-24T22:37:00+08:00	4144	8579	12723	1078	13801	25135	54.91%	16.49%	32	32
14	宜蘭縣頭城鎮	2018-11-25T01:07:26+08:00	4144	8579	12723	1078	13801	25135	54.91%	16.49%	32	32
14	宜蘭縣頭城鎮	2018-11-25T06:13:52+08:00	4144	8579	12723	1078	13801	25135	54.91%	16.49%	32	32
14	宜蘭縣頭城鎮	2018-11-25T06:29:16+08:00	4144	8579	12723	1078	13801	25135	54.91%	16.49%	32	32
14	宜蘭縣頭城鎮	2018-11-24T23:43:17+08:00	4144	8579	12723	1078	13801	25135	54.91%	16.49%	32	32
14	宜蘭縣頭城鎮	2018-11-25T03:38:54+08:00	4144	8579	12723	1078	13801	25135	54.91%	16.49%	32	32
14	宜蘭縣頭城鎮	2018-11-24T23:55:46+08:00	4144	8579	12723	1078	13801	25135	54.91%	16.49%	32	32
14	宜蘭縣頭城鎮	2018-11-24T23:23:38+08:00	4144	8579	12723	1078	13801	25135	54.91%	16.49%	32	32
14	宜蘭縣頭城鎮	2018-11-25T01:02:30+08:00	4144	8579	12723	1078	13801	25135	54.91%	16.49%	32	32
14	宜蘭縣頭城鎮	2018-11-25T03:44:22+08:00	4144	8579	12723	1078	13801	25135	54.91%	16.49%	32	32
14	宜蘭縣頭城鎮	2018-11-24T22:13:26+08:00	4144	8579	12723	1078	13801	25135	54.91%	16.49%	32	32
14	宜蘭縣頭城鎮	2018-11-24T22:23:12+08:00	4144	8579	12723	1078	13801	25135	54.91%	16.49%	32	32
14	宜蘭縣頭城鎮	2018-11-24T22:30:08+08:00	4144	8579	12723	1078	13801	25135	54.91%	16.49%	32	32
14	宜蘭縣頭城鎮	2018-11-24T22:40:27+08:00	4144	8579	12723	1078	13801	25135	54.91%	16.49%	32	32
14	宜蘭縣頭城鎮	2018-11-25T00:00:10+08:00	4144	8579	12723	1078	13801	25135	54.91%	16.49%	32	32
14	宜蘭縣頭城鎮	2018-11-25T06:18:57+08:00	4144	8579	12723	1078	13801	25135	54.91%	16.49%	32	32
14	宜蘭縣頭城鎮	2018-11-24T23:19:51+08:00	4144	8579	12723	1078	13801	25135	54.91%	16.49%	32	32
14	宜蘭縣頭城鎮	2018-11-24T23:12:15+08:00	4144	8579	12723	1078	13801	25135	54.91%	16.49%	32	32
14	宜蘭縣頭城鎮	2018-11-24T22:45:08+08:00	4144	8579	12723	1078	13801	25135	54.91%	16.49%	32	32
14	宜蘭縣頭城鎮	2018-11-24T23:01:30+08:00	4144	8579	12723	1078	13801	25135	54.91%	16.49%	32	32
14	宜蘭縣頭城鎮	2018-11-24T23:39:15+08:00	4144	8579	12723	1078	13801	25135	54.91%	16.49%	32	32
14	宜蘭縣頭城鎮	2018-11-24T23:31:11+08:00	4144	8579	12723	1078	13801	25135	54.91%	16.49%	32	32
14	宜蘭縣頭城鎮	2018-11-25T00:09:34+08:00	4144	8579	12723	1078	13801	25135	54.91%	16.49%	32	32
14	宜蘭縣頭城鎮	2018-11-24T23:35:10+08:00	4144	8579	12723	1078	13801	25135	54.91%	16.49%	32	32
14	宜蘭縣頭城鎮	2018-11-25T00:14:09+08:00	4144	8579	12723	1078	13801	25135	54.91%	16.49%	32	32
14	宜蘭縣頭城鎮	2018-11-25T03:49:51+08:00	4144	8579	12723	1078	13801	25135	54.91%	16.49%	32	32
14	宜蘭縣頭城鎮	2018-11-24T23:16:02+08:00	4144	8579	12723	1078	13801	25135	54.91%	16.49%	32	32
14	宜蘭縣頭城鎮	2018-11-25T03:56:12+08:00	4144	8579	12723	1078	13801	25135	54.91%	16.49%	32	32
14	宜蘭縣頭城鎮	2018-11-25T06:24:00+08:00	4144	8579	12723	1078	13801	25135	54.91%	16.49%	32	32
14	宜蘭縣頭城鎮	2018-11-25T00:23:03+08:00	4144	8579	12723	1078	13801	25135	54.91%	16.49%	32	32
14	宜蘭縣頭城鎮	2018-11-24T23:08:35+08:00	4144	8579	12723	1078	13801	25135	54.91%	16.49%	32	32
14	宜蘭縣頭城鎮	2018-11-25T03:32:34+08:00	4144	8579	12723	1078	13801	25135	54.91%	16.49%	32	32
14	宜蘭縣頭城鎮	2018-11-25T01:25:52+08:00	4144	8579	12723	1078	13801	25135	54.91%	16.49%	32	32
14	宜蘭縣頭城鎮	2018-11-24T22:57:53+08:00	4144	8579	12723	1078	13801	25135	54.91%	16.49%	32	32
14	宜蘭縣頭城鎮	2018-11-24T22:19:36+08:00	4144	8579	12723	1078	13801	25135	54.91%	16.49%	32	32
14	宜蘭縣頭城鎮	2018-11-25T00:57:36+08:00	4144	8579	12723	1078	13801	25135	54.91%	16.49%	32	32
14	宜蘭縣頭城鎮	2018-11-25T01:17:52+08:00	4144	8579	12723	1078	13801	25135	54.91%	16.49%	32	32
14	宜蘭縣頭城鎮	2018-11-24T23:27:18+08:00	4144	8579	12723	1078	13801	25135	54.91%	16.49%	32	32
14	宜蘭縣頭城鎮	2018-11-24T23:51:35+08:00	4144	8579	12723	1078	13801	25135	54.91%	16.49%	32	32
14	宜蘭縣頭城鎮	2018-11-24T23:05:04+08:00	4144	8579	12723	1078	13801	25135	54.91%	16.49%	32	32
14	宜蘭縣頭城鎮	2018-11-25T04:02:52+08:00	4144	8579	12723	1078	13801	25135	54.91%	16.49%	32	32
14	宜蘭縣頭城鎮	2018-11-24T22:50:47+08:00	4144	8579	12723	1078	13801	25135	54.91%	16.49%	32	32
14	宜蘭縣頭城鎮	2018-11-24T22:16:10+08:00	4144	8579	12723	1078	13801	25135	54.91%	16.49%	32	32
14	宜蘭縣頭城鎮	2018-11-25T01:12:43+08:00	4144	8579	12723	1078	13801	25135	54.91%	16.49%	32	32
14	宜蘭縣頭城鎮	2018-11-25T00:05:04+08:00	4144	8579	12723	1078	13801	25135	54.91%	16.49%	32	32
14	宜蘭縣頭城鎮	2018-11-24T22:41:34+08:00	4144	8579	12723	1078	13801	25135	54.91%	16.49%	32	32
14	宜蘭縣頭城鎮	2018-11-24T22:26:36+08:00	4144	8579	12723	1078	13801	25135	54.91%	16.49%	32	32
14	宜蘭縣頭城鎮	2018-11-25T00:18:29+08:00	4144	8579	12723	1078	13801	25135	54.91%	16.49%	32	32
14	宜蘭縣頭城鎮	2018-11-25T06:08:52+08:00	4144	8579	12723	1078	13801	25135	54.91%	16.49%	32	32
14	宜蘭縣頭城鎮	2018-11-24T22:54:25+08:00	4144	8579	12723	1078	13801	25135	54.91%	16.49%	32	32
14	嘉義縣六腳鄉	2018-11-25T03:56:10+08:00	2355	5572	7927	846	8773	20821	42.14%	11.31%	30	30
14	嘉義縣六腳鄉	2018-11-24T23:47:26+08:00	2355	5572	7927	846	8773	20821	42.14%	11.31%	30	30
14	嘉義縣六腳鄉	2018-11-24T23:16:01+08:00	2355	5572	7927	846	8773	20821	42.14%	11.31%	30	30
14	嘉義縣六腳鄉	2018-11-24T22:16:08+08:00	2237	5269	7506	799	8305	19621	42.33%	11.4%	29	30
14	嘉義縣六腳鄉	2018-11-24T22:33:36+08:00	2237	5269	7506	799	8305	19621	42.33%	11.4%	29	30
14	嘉義縣六腳鄉	2018-11-25T01:25:50+08:00	2355	5572	7927	846	8773	20821	42.14%	11.31%	30	30
14	嘉義縣六腳鄉	2018-11-25T03:38:53+08:00	2355	5572	7927	846	8773	20821	42.14%	11.31%	30	30
14	嘉義縣六腳鄉	2018-11-24T23:23:36+08:00	2355	5572	7927	846	8773	20821	42.14%	11.31%	30	30
14	嘉義縣六腳鄉	2018-11-24T22:19:35+08:00	2237	5269	7506	799	8305	19621	42.33%	11.4%	29	30
14	嘉義縣六腳鄉	2018-11-25T00:57:34+08:00	2355	5572	7927	846	8773	20821	42.14%	11.31%	30	30
14	嘉義縣六腳鄉	2018-11-24T22:40:26+08:00	2237	5269	7506	799	8305	19621	42.33%	11.4%	29	30
14	嘉義縣六腳鄉	2018-11-24T22:36:58+08:00	2237	5269	7506	799	8305	19621	42.33%	11.4%	29	30
14	嘉義縣六腳鄉	2018-11-24T22:57:51+08:00	2355	5572	7927	846	8773	20821	42.14%	11.31%	30	30
14	嘉義縣六腳鄉	2018-11-25T00:09:32+08:00	2355	5572	7927	846	8773	20821	42.14%	11.31%	30	30
14	嘉義縣六腳鄉	2018-11-24T22:45:06+08:00	2237	5269	7506	799	8305	19621	42.33%	11.4%	29	30
14	嘉義縣六腳鄉	2018-11-25T06:08:50+08:00	2355	5572	7927	846	8773	20821	42.14%	11.31%	30	30
14	嘉義縣六腳鄉	2018-11-25T06:23:58+08:00	2355	5572	7927	846	8773	20821	42.14%	11.31%	30	30
14	嘉義縣六腳鄉	2018-11-24T23:39:13+08:00	2355	5572	7927	846	8773	20821	42.14%	11.31%	30	30
14	嘉義縣六腳鄉	2018-11-25T03:49:49+08:00	2355	5572	7927	846	8773	20821	42.14%	11.31%	30	30
14	嘉義縣六腳鄉	2018-11-25T01:12:41+08:00	2355	5572	7927	846	8773	20821	42.14%	11.31%	30	30
14	嘉義縣六腳鄉	2018-11-24T22:26:35+08:00	2237	5269	7506	799	8305	19621	42.33%	11.4%	29	30
14	嘉義縣六腳鄉	2018-11-24T22:50:45+08:00	2237	5269	7506	799	8305	19621	42.33%	11.4%	29	30
14	嘉義縣六腳鄉	2018-11-24T23:12:13+08:00	2355	5572	7927	846	8773	20821	42.14%	11.31%	30	30
14	嘉義縣六腳鄉	2018-11-25T04:02:50+08:00	2355	5572	7927	846	8773	20821	42.14%	11.31%	30	30
14	嘉義縣六腳鄉	2018-11-24T23:43:15+08:00	2355	5572	7927	846	8773	20821	42.14%	11.31%	30	30
14	嘉義縣六腳鄉	2018-11-25T00:14:07+08:00	2355	5572	7927	846	8773	20821	42.14%	11.31%	30	30
14	嘉義縣六腳鄉	2018-11-24T23:01:29+08:00	2355	5572	7927	846	8773	20821	42.14%	11.31%	30	30
14	嘉義縣六腳鄉	2018-11-25T01:07:24+08:00	2355	5572	7927	846	8773	20821	42.14%	11.31%	30	30
14	嘉義縣六腳鄉	2018-11-24T23:31:09+08:00	2355	5572	7927	846	8773	20821	42.14%	11.31%	30	30
14	嘉義縣六腳鄉	2018-11-25T06:13:50+08:00	2355	5572	7927	846	8773	20821	42.14%	11.31%	30	30
14	嘉義縣六腳鄉	2018-11-24T23:35:08+08:00	2355	5572	7927	846	8773	20821	42.14%	11.31%	30	30
14	嘉義縣六腳鄉	2018-11-25T06:29:15+08:00	2355	5572	7927	846	8773	20821	42.14%	11.31%	30	30
14	嘉義縣六腳鄉	2018-11-24T23:55:45+08:00	2355	5572	7927	846	8773	20821	42.14%	11.31%	30	30
14	嘉義縣六腳鄉	2018-11-24T23:08:34+08:00	2355	5572	7927	846	8773	20821	42.14%	11.31%	30	30
14	嘉義縣六腳鄉	2018-11-25T03:32:32+08:00	2355	5572	7927	846	8773	20821	42.14%	11.31%	30	30
14	嘉義縣六腳鄉	2018-11-25T00:23:02+08:00	2355	5572	7927	846	8773	20821	42.14%	11.31%	30	30
14	嘉義縣六腳鄉	2018-11-24T23:19:48+08:00	2355	5572	7927	846	8773	20821	42.14%	11.31%	30	30
14	嘉義縣六腳鄉	2018-11-25T03:44:20+08:00	2355	5572	7927	846	8773	20821	42.14%	11.31%	30	30
14	嘉義縣六腳鄉	2018-11-24T22:13:24+08:00	2237	5269	7506	799	8305	19621	42.33%	11.4%	29	30
14	嘉義縣六腳鄉	2018-11-25T00:00:08+08:00	2355	5572	7927	846	8773	20821	42.14%	11.31%	30	30
14	嘉義縣六腳鄉	2018-11-25T01:17:49+08:00	2355	5572	7927	846	8773	20821	42.14%	11.31%	30	30
14	嘉義縣六腳鄉	2018-11-25T06:18:55+08:00	2355	5572	7927	846	8773	20821	42.14%	11.31%	30	30
14	嘉義縣六腳鄉	2018-11-25T01:02:28+08:00	2355	5572	7927	846	8773	20821	42.14%	11.31%	30	30
14	嘉義縣六腳鄉	2018-11-24T23:27:16+08:00	2355	5572	7927	846	8773	20821	42.14%	11.31%	30	30
14	嘉義縣六腳鄉	2018-11-24T22:30:04+08:00	2237	5269	7506	799	8305	19621	42.33%	11.4%	29	30
14	嘉義縣六腳鄉	2018-11-24T22:23:10+08:00	2237	5269	7506	799	8305	19621	42.33%	11.4%	29	30
14	嘉義縣六腳鄉	2018-11-24T23:51:32+08:00	2355	5572	7927	846	8773	20821	42.14%	11.31%	30	30
14	嘉義縣六腳鄉	2018-11-24T22:54:24+08:00	2237	5269	7506	799	8305	19621	42.33%	11.4%	29	30
14	嘉義縣六腳鄉	2018-11-24T22:41:33+08:00	2237	5269	7506	799	8305	19621	42.33%	11.4%	29	30
14	嘉義縣六腳鄉	2018-11-25T00:05:03+08:00	2355	5572	7927	846	8773	20821	42.14%	11.31%	30	30
14	嘉義縣六腳鄉	2018-11-24T23:05:02+08:00	2355	5572	7927	846	8773	20821	42.14%	11.31%	30	30
14	嘉義縣六腳鄉	2018-11-25T00:18:27+08:00	2355	5572	7927	846	8773	20821	42.14%	11.31%	30	30
14	花蓮縣瑞穗鄉	2018-11-25T06:29:17+08:00	1029	3532	4561	516	5077	10279	49.39%	10.01%	13	13
14	花蓮縣瑞穗鄉	2018-11-24T23:47:28+08:00	698	2499	3197	356	3553	7601	46.74%	9.18%	10	13
14	花蓮縣瑞穗鄉	2018-11-25T00:18:30+08:00	796	2844	3640	388	4028	8414	47.87%	9.46%	11	13
14	花蓮縣瑞穗鄉	2018-11-25T01:07:26+08:00	935	3209	4144	456	4600	9416	48.85%	9.93%	12	13
14	花蓮縣瑞穗鄉	2018-11-25T06:13:52+08:00	1029	3532	4561	516	5077	10279	49.39%	10.01%	13	13
14	花蓮縣瑞穗鄉	2018-11-24T22:33:38+08:00	611	2157	2768	321	3089	6187	49.93%	9.88%	8	13
14	花蓮縣瑞穗鄉	2018-11-24T23:43:17+08:00	698	2499	3197	356	3553	7601	46.74%	9.18%	10	13
14	花蓮縣瑞穗鄉	2018-11-24T22:37:01+08:00	611	2157	2768	321	3089	6187	49.93%	9.88%	8	13
14	花蓮縣瑞穗鄉	2018-11-25T03:44:23+08:00	1029	3532	4561	516	5077	10279	49.39%	10.01%	13	13
14	花蓮縣瑞穗鄉	2018-11-24T22:13:27+08:00	514	1761	2275	257	2532	5212	48.58%	9.86%	7	13
14	花蓮縣瑞穗鄉	2018-11-25T01:02:31+08:00	796	2844	3640	388	4028	8414	47.87%	9.46%	11	13
14	花蓮縣瑞穗鄉	2018-11-24T23:23:38+08:00	644	2315	2959	334	3293	7055	46.68%	9.13%	9	13
14	花蓮縣瑞穗鄉	2018-11-25T03:38:55+08:00	1029	3532	4561	516	5077	10279	49.39%	10.01%	13	13
14	花蓮縣瑞穗鄉	2018-11-24T23:55:47+08:00	796	2844	3640	388	4028	8414	47.87%	9.46%	11	13
14	花蓮縣瑞穗鄉	2018-11-24T23:08:36+08:00	644	2315	2959	334	3293	7055	46.68%	9.13%	9	13
14	花蓮縣瑞穗鄉	2018-11-25T00:00:11+08:00	796	2844	3640	388	4028	8414	47.87%	9.46%	11	13
14	花蓮縣瑞穗鄉	2018-11-25T06:18:57+08:00	1029	3532	4561	516	5077	10279	49.39%	10.01%	13	13
14	花蓮縣瑞穗鄉	2018-11-24T22:30:09+08:00	611	2157	2768	321	3089	6187	49.93%	9.88%	8	13
14	花蓮縣瑞穗鄉	2018-11-24T22:40:28+08:00	611	2157	2768	321	3089	6187	49.93%	9.88%	8	13
14	花蓮縣瑞穗鄉	2018-11-24T22:23:13+08:00	611	2157	2768	321	3089	6187	49.93%	9.88%	8	13
14	花蓮縣瑞穗鄉	2018-11-24T23:19:51+08:00	644	2315	2959	334	3293	7055	46.68%	9.13%	9	13
14	花蓮縣瑞穗鄉	2018-11-24T23:35:11+08:00	644	2315	2959	334	3293	7055	46.68%	9.13%	9	13
14	花蓮縣瑞穗鄉	2018-11-24T23:01:31+08:00	611	2157	2768	321	3089	6187	49.93%	9.88%	8	13
14	花蓮縣瑞穗鄉	2018-11-24T22:45:09+08:00	611	2157	2768	321	3089	6187	49.93%	9.88%	8	13
14	花蓮縣瑞穗鄉	2018-11-24T23:31:11+08:00	644	2315	2959	334	3293	7055	46.68%	9.13%	9	13
14	花蓮縣瑞穗鄉	2018-11-25T00:09:34+08:00	796	2844	3640	388	4028	8414	47.87%	9.46%	11	13
14	花蓮縣瑞穗鄉	2018-11-24T22:54:26+08:00	611	2157	2768	321	3089	6187	49.93%	9.88%	8	13
14	花蓮縣瑞穗鄉	2018-11-25T00:14:10+08:00	796	2844	3640	388	4028	8414	47.87%	9.46%	11	13
14	花蓮縣瑞穗鄉	2018-11-25T03:49:51+08:00	1029	3532	4561	516	5077	10279	49.39%	10.01%	13	13
14	花蓮縣瑞穗鄉	2018-11-24T23:16:03+08:00	644	2315	2959	334	3293	7055	46.68%	9.13%	9	13
14	花蓮縣瑞穗鄉	2018-11-25T03:56:12+08:00	1029	3532	4561	516	5077	10279	49.39%	10.01%	13	13
14	花蓮縣瑞穗鄉	2018-11-25T03:32:35+08:00	1029	3532	4561	516	5077	10279	49.39%	10.01%	13	13
14	花蓮縣瑞穗鄉	2018-11-25T06:24:00+08:00	1029	3532	4561	516	5077	10279	49.39%	10.01%	13	13
14	花蓮縣瑞穗鄉	2018-11-25T01:25:53+08:00	935	3209	4144	456	4600	9416	48.85%	9.93%	12	13
14	花蓮縣瑞穗鄉	2018-11-25T00:23:04+08:00	796	2844	3640	388	4028	8414	47.87%	9.46%	11	13
14	花蓮縣瑞穗鄉	2018-11-25T00:57:37+08:00	796	2844	3640	388	4028	8414	47.87%	9.46%	11	13
14	花蓮縣瑞穗鄉	2018-11-24T22:57:53+08:00	611	2157	2768	321	3089	6187	49.93%	9.88%	8	13
14	花蓮縣瑞穗鄉	2018-11-24T22:19:37+08:00	611	2157	2768	321	3089	6187	49.93%	9.88%	8	13
14	花蓮縣瑞穗鄉	2018-11-25T01:17:52+08:00	935	3209	4144	456	4600	9416	48.85%	9.93%	12	13
14	花蓮縣瑞穗鄉	2018-11-24T23:27:18+08:00	644	2315	2959	334	3293	7055	46.68%	9.13%	9	13
14	花蓮縣瑞穗鄉	2018-11-24T23:51:35+08:00	796	2844	3640	388	4028	8414	47.87%	9.46%	11	13
14	花蓮縣瑞穗鄉	2018-11-24T22:41:35+08:00	611	2157	2768	321	3089	6187	49.93%	9.88%	8	13
14	花蓮縣瑞穗鄉	2018-11-25T00:05:05+08:00	796	2844	3640	388	4028	8414	47.87%	9.46%	11	13
14	花蓮縣瑞穗鄉	2018-11-25T04:02:52+08:00	1029	3532	4561	516	5077	10279	49.39%	10.01%	13	13
14	花蓮縣瑞穗鄉	2018-11-24T23:12:16+08:00	644	2315	2959	334	3293	7055	46.68%	9.13%	9	13
14	花蓮縣瑞穗鄉	2018-11-25T06:08:53+08:00	1029	3532	4561	516	5077	10279	49.39%	10.01%	13	13
14	花蓮縣瑞穗鄉	2018-11-25T01:12:43+08:00	935	3209	4144	456	4600	9416	48.85%	9.93%	12	13
14	花蓮縣瑞穗鄉	2018-11-24T22:26:37+08:00	611	2157	2768	321	3089	6187	49.93%	9.88%	8	13
14	花蓮縣瑞穗鄉	2018-11-24T23:05:05+08:00	611	2157	2768	321	3089	6187	49.93%	9.88%	8	13
14	花蓮縣瑞穗鄉	2018-11-24T22:50:48+08:00	611	2157	2768	321	3089	6187	49.93%	9.88%	8	13
14	花蓮縣瑞穗鄉	2018-11-24T22:16:11+08:00	514	1761	2275	257	2532	5212	48.58%	9.86%	7	13
14	花蓮縣瑞穗鄉	2018-11-24T23:39:16+08:00	644	2315	2959	334	3293	7055	46.68%	9.13%	9	13
14	臺中市霧峰區	2018-11-24T23:35:03+08:00	8969	22232	31201	2261	33462	55225	60.59%	16.24%	43	43
14	臺中市霧峰區	2018-11-24T22:33:30+08:00	8115	20125	28240	2048	30288	50025	60.55%	16.22%	39	43
14	臺中市霧峰區	2018-11-24T22:16:01+08:00	6821	16967	23788	1765	25553	42271	60.45%	16.14%	34	43
14	臺中市霧峰區	2018-11-24T23:31:02+08:00	8969	22232	31201	2261	33462	55225	60.59%	16.24%	43	43
14	臺中市霧峰區	2018-11-24T23:01:22+08:00	8723	21576	30299	2197	32496	53652	60.57%	16.26%	42	43
14	臺中市霧峰區	2018-11-24T23:12:07+08:00	8723	21576	30299	2197	32496	53652	60.57%	16.26%	42	43
14	臺中市霧峰區	2018-11-24T23:47:20+08:00	8969	22232	31201	2261	33462	55225	60.59%	16.24%	43	43
14	臺中市霧峰區	2018-11-25T01:07:18+08:00	8969	22232	31201	2261	33462	55225	60.59%	16.24%	43	43
14	臺中市霧峰區	2018-11-25T06:08:43+08:00	8969	22232	31201	2261	33462	55225	60.59%	16.24%	43	43
14	臺中市霧峰區	2018-11-24T22:57:45+08:00	8535	21082	29617	2148	31765	52385	60.64%	16.29%	41	43
14	臺中市霧峰區	2018-11-25T01:17:42+08:00	8969	22232	31201	2261	33462	55225	60.59%	16.24%	43	43
14	臺中市霧峰區	2018-11-24T22:13:18+08:00	6821	16967	23788	1765	25553	42271	60.45%	16.14%	34	43
14	臺中市霧峰區	2018-11-24T22:19:29+08:00	6821	16967	23788	1765	25553	42271	60.45%	16.14%	34	43
14	臺中市霧峰區	2018-11-25T00:57:28+08:00	8969	22232	31201	2261	33462	55225	60.59%	16.24%	43	43
14	臺中市霧峰區	2018-11-24T23:23:31+08:00	8969	22232	31201	2261	33462	55225	60.59%	16.24%	43	43
14	臺中市霧峰區	2018-11-25T03:44:13+08:00	8969	22232	31201	2261	33462	55225	60.59%	16.24%	43	43
14	臺中市霧峰區	2018-11-25T00:04:57+08:00	8969	22232	31201	2261	33462	55225	60.59%	16.24%	43	43
14	臺中市霧峰區	2018-11-24T23:04:56+08:00	8723	21576	30299	2197	32496	53652	60.57%	16.26%	42	43
14	臺中市霧峰區	2018-11-24T23:15:55+08:00	8723	21576	30299	2197	32496	53652	60.57%	16.26%	42	43
14	臺中市霧峰區	2018-11-25T06:18:50+08:00	8969	22232	31201	2261	33462	55225	60.59%	16.24%	43	43
14	臺中市霧峰區	2018-11-25T01:25:44+08:00	8969	22232	31201	2261	33462	55225	60.59%	16.24%	43	43
14	臺中市霧峰區	2018-11-24T22:40:21+08:00	8535	21082	29617	2148	31765	52385	60.64%	16.29%	41	43
14	臺中市霧峰區	2018-11-25T01:02:22+08:00	8969	22232	31201	2261	33462	55225	60.59%	16.24%	43	43
14	臺中市霧峰區	2018-11-25T03:38:47+08:00	8969	22232	31201	2261	33462	55225	60.59%	16.24%	43	43
14	臺中市霧峰區	2018-11-24T23:55:39+08:00	8969	22232	31201	2261	33462	55225	60.59%	16.24%	43	43
14	臺中市霧峰區	2018-11-24T22:54:18+08:00	8535	21082	29617	2148	31765	52385	60.64%	16.29%	41	43
14	臺中市霧峰區	2018-11-24T22:45:01+08:00	8535	21082	29617	2148	31765	52385	60.64%	16.29%	41	43
14	臺中市霧峰區	2018-11-25T00:18:22+08:00	8969	22232	31201	2261	33462	55225	60.59%	16.24%	43	43
14	臺中市霧峰區	2018-11-25T00:22:56+08:00	8969	22232	31201	2261	33462	55225	60.59%	16.24%	43	43
14	臺中市霧峰區	2018-11-25T03:56:03+08:00	8969	22232	31201	2261	33462	55225	60.59%	16.24%	43	43
14	臺中市霧峰區	2018-11-24T23:39:05+08:00	8969	22232	31201	2261	33462	55225	60.59%	16.24%	43	43
14	臺中市霧峰區	2018-11-25T01:12:34+08:00	8969	22232	31201	2261	33462	55225	60.59%	16.24%	43	43
14	臺中市霧峰區	2018-11-25T04:02:40+08:00	8969	22232	31201	2261	33462	55225	60.59%	16.24%	43	43
14	臺中市霧峰區	2018-11-25T00:09:25+08:00	8969	22232	31201	2261	33462	55225	60.59%	16.24%	43	43
14	臺中市霧峰區	2018-11-25T00:14:01+08:00	8969	22232	31201	2261	33462	55225	60.59%	16.24%	43	43
14	臺中市霧峰區	2018-11-24T22:41:28+08:00	8535	21082	29617	2148	31765	52385	60.64%	16.29%	41	43
14	臺中市霧峰區	2018-11-24T22:50:38+08:00	8535	21082	29617	2148	31765	52385	60.64%	16.29%	41	43
14	臺中市霧峰區	2018-11-25T00:00:00+08:00	8969	22232	31201	2261	33462	55225	60.59%	16.24%	43	43
14	臺中市霧峰區	2018-11-24T22:23:04+08:00	6821	16967	23788	1765	25553	42271	60.45%	16.14%	34	43
14	臺中市霧峰區	2018-11-24T23:19:41+08:00	8969	22232	31201	2261	33462	55225	60.59%	16.24%	43	43
14	臺中市霧峰區	2018-11-24T23:51:27+08:00	8969	22232	31201	2261	33462	55225	60.59%	16.24%	43	43
14	臺中市霧峰區	2018-11-24T22:29:58+08:00	7666	18864	26530	1934	28464	47092	60.44%	16.28%	37	43
14	臺中市霧峰區	2018-11-24T22:36:53+08:00	8342	20632	28974	2101	31075	51391	60.47%	16.23%	40	43
14	臺中市霧峰區	2018-11-24T23:27:11+08:00	8969	22232	31201	2261	33462	55225	60.59%	16.24%	43	43
14	臺中市霧峰區	2018-11-24T23:08:27+08:00	8723	21576	30299	2197	32496	53652	60.57%	16.26%	42	43
14	臺中市霧峰區	2018-11-25T03:32:26+08:00	8969	22232	31201	2261	33462	55225	60.59%	16.24%	43	43
14	臺中市霧峰區	2018-11-25T06:29:08+08:00	8969	22232	31201	2261	33462	55225	60.59%	16.24%	43	43
14	臺中市霧峰區	2018-11-25T03:49:44+08:00	8969	22232	31201	2261	33462	55225	60.59%	16.24%	43	43
14	臺中市霧峰區	2018-11-24T22:26:30+08:00	7096	17584	24680	1830	26510	43931	60.34%	16.15%	35	43
14	臺中市霧峰區	2018-11-25T06:23:52+08:00	8969	22232	31201	2261	33462	55225	60.59%	16.24%	43	43
14	臺中市霧峰區	2018-11-24T23:43:09+08:00	8969	22232	31201	2261	33462	55225	60.59%	16.24%	43	43
14	臺中市霧峰區	2018-11-25T06:13:45+08:00	8969	22232	31201	2261	33462	55225	60.59%	16.24%	43	43
14	臺東縣蘭嶼鄉	2018-11-24T22:33:39+08:00	84	284	368	18	386	943	40.93%	8.91%	1	4
14	臺東縣蘭嶼鄉	2018-11-25T03:49:52+08:00	417	1093	1510	90	1600	4181	38.27%	9.97%	4	4
14	臺東縣蘭嶼鄉	2018-11-24T23:43:18+08:00	84	284	368	18	386	943	40.93%	8.91%	1	4
14	臺東縣蘭嶼鄉	2018-11-24T23:47:29+08:00	84	284	368	18	386	943	40.93%	8.91%	1	4
14	臺東縣蘭嶼鄉	2018-11-25T06:29:18+08:00	417	1093	1510	90	1600	4181	38.27%	9.97%	4	4
14	臺東縣蘭嶼鄉	2018-11-25T01:07:27+08:00	417	1093	1510	90	1600	4181	38.27%	9.97%	4	4
14	臺東縣蘭嶼鄉	2018-11-25T06:13:53+08:00	417	1093	1510	90	1600	4181	38.27%	9.97%	4	4
14	臺東縣蘭嶼鄉	2018-11-25T00:18:31+08:00	417	1093	1510	90	1600	4181	38.27%	9.97%	4	4
14	臺東縣蘭嶼鄉	2018-11-24T22:37:01+08:00	84	284	368	18	386	943	40.93%	8.91%	1	4
14	臺東縣蘭嶼鄉	2018-11-25T03:44:24+08:00	417	1093	1510	90	1600	4181	38.27%	9.97%	4	4
14	臺東縣蘭嶼鄉	2018-11-24T23:08:37+08:00	84	284	368	18	386	943	40.93%	8.91%	1	4
14	臺東縣蘭嶼鄉	2018-11-24T23:55:48+08:00	189	570	759	34	793	2183	36.33%	8.66%	2	4
14	臺東縣蘭嶼鄉	2018-11-24T22:13:28+08:00	84	284	368	18	386	943	40.93%	8.91%	1	4
14	臺東縣蘭嶼鄉	2018-11-24T23:23:39+08:00	84	284	368	18	386	943	40.93%	8.91%	1	4
14	臺東縣蘭嶼鄉	2018-11-25T06:18:58+08:00	417	1093	1510	90	1600	4181	38.27%	9.97%	4	4
14	臺東縣蘭嶼鄉	2018-11-24T23:51:36+08:00	84	284	368	18	386	943	40.93%	8.91%	1	4
14	臺東縣蘭嶼鄉	2018-11-24T22:23:14+08:00	84	284	368	18	386	943	40.93%	8.91%	1	4
14	臺東縣蘭嶼鄉	2018-11-24T22:40:28+08:00	84	284	368	18	386	943	40.93%	8.91%	1	4
14	臺東縣蘭嶼鄉	2018-11-25T00:09:35+08:00	276	736	1012	60	1072	2943	36.43%	9.38%	3	4
14	臺東縣蘭嶼鄉	2018-11-25T00:05:06+08:00	276	736	1012	60	1072	2943	36.43%	9.38%	3	4
14	臺東縣蘭嶼鄉	2018-11-24T23:35:11+08:00	84	284	368	18	386	943	40.93%	8.91%	1	4
14	臺東縣蘭嶼鄉	2018-11-24T22:41:36+08:00	84	284	368	18	386	943	40.93%	8.91%	1	4
14	臺東縣蘭嶼鄉	2018-11-24T22:45:09+08:00	84	284	368	18	386	943	40.93%	8.91%	1	4
14	臺東縣蘭嶼鄉	2018-11-24T22:54:26+08:00	84	284	368	18	386	943	40.93%	8.91%	1	4
14	臺東縣蘭嶼鄉	2018-11-25T00:14:10+08:00	276	736	1012	60	1072	2943	36.43%	9.38%	3	4
14	臺東縣蘭嶼鄉	2018-11-25T03:56:13+08:00	417	1093	1510	90	1600	4181	38.27%	9.97%	4	4
14	臺東縣蘭嶼鄉	2018-11-24T23:16:04+08:00	84	284	368	18	386	943	40.93%	8.91%	1	4
14	臺東縣蘭嶼鄉	2018-11-25T03:32:35+08:00	417	1093	1510	90	1600	4181	38.27%	9.97%	4	4
14	臺東縣蘭嶼鄉	2018-11-25T01:25:53+08:00	417	1093	1510	90	1600	4181	38.27%	9.97%	4	4
14	臺東縣蘭嶼鄉	2018-11-25T01:02:32+08:00	417	1093	1510	90	1600	4181	38.27%	9.97%	4	4
14	臺東縣蘭嶼鄉	2018-11-24T22:30:10+08:00	84	284	368	18	386	943	40.93%	8.91%	1	4
14	臺東縣蘭嶼鄉	2018-11-25T00:23:04+08:00	417	1093	1510	90	1600	4181	38.27%	9.97%	4	4
14	臺東縣蘭嶼鄉	2018-11-25T06:24:01+08:00	417	1093	1510	90	1600	4181	38.27%	9.97%	4	4
14	臺東縣蘭嶼鄉	2018-11-25T03:38:56+08:00	417	1093	1510	90	1600	4181	38.27%	9.97%	4	4
14	臺東縣蘭嶼鄉	2018-11-24T23:27:19+08:00	84	284	368	18	386	943	40.93%	8.91%	1	4
14	臺東縣蘭嶼鄉	2018-11-24T22:19:38+08:00	84	284	368	18	386	943	40.93%	8.91%	1	4
14	臺東縣蘭嶼鄉	2018-11-24T22:57:54+08:00	84	284	368	18	386	943	40.93%	8.91%	1	4
14	臺東縣蘭嶼鄉	2018-11-25T01:17:53+08:00	417	1093	1510	90	1600	4181	38.27%	9.97%	4	4
14	臺東縣蘭嶼鄉	2018-11-25T00:00:12+08:00	276	736	1012	60	1072	2943	36.43%	9.38%	3	4
14	臺東縣蘭嶼鄉	2018-11-24T23:19:52+08:00	84	284	368	18	386	943	40.93%	8.91%	1	4
14	臺東縣蘭嶼鄉	2018-11-25T00:57:38+08:00	417	1093	1510	90	1600	4181	38.27%	9.97%	4	4
14	臺東縣蘭嶼鄉	2018-11-25T06:08:54+08:00	417	1093	1510	90	1600	4181	38.27%	9.97%	4	4
14	臺東縣蘭嶼鄉	2018-11-24T23:12:16+08:00	84	284	368	18	386	943	40.93%	8.91%	1	4
14	臺東縣蘭嶼鄉	2018-11-24T23:39:17+08:00	84	284	368	18	386	943	40.93%	8.91%	1	4
14	臺東縣蘭嶼鄉	2018-11-25T01:12:44+08:00	417	1093	1510	90	1600	4181	38.27%	9.97%	4	4
14	臺東縣蘭嶼鄉	2018-11-24T22:50:49+08:00	84	284	368	18	386	943	40.93%	8.91%	1	4
14	臺東縣蘭嶼鄉	2018-11-24T22:26:37+08:00	84	284	368	18	386	943	40.93%	8.91%	1	4
14	臺東縣蘭嶼鄉	2018-11-25T04:02:53+08:00	417	1093	1510	90	1600	4181	38.27%	9.97%	4	4
14	臺東縣蘭嶼鄉	2018-11-24T23:05:05+08:00	84	284	368	18	386	943	40.93%	8.91%	1	4
14	臺東縣蘭嶼鄉	2018-11-24T23:31:12+08:00	84	284	368	18	386	943	40.93%	8.91%	1	4
14	臺東縣蘭嶼鄉	2018-11-24T22:16:11+08:00	84	284	368	18	386	943	40.93%	8.91%	1	4
14	臺東縣蘭嶼鄉	2018-11-24T23:01:32+08:00	84	284	368	18	386	943	40.93%	8.91%	1	4
14	臺東縣池上鄉	2018-11-25T06:29:17+08:00	818	2187	3005	301	3306	7162	46.16%	11.42%	12	12
14	臺東縣池上鄉	2018-11-25T03:49:52+08:00	818	2187	3005	301	3306	7162	46.16%	11.42%	12	12
14	臺東縣池上鄉	2018-11-24T23:47:29+08:00	818	2187	3005	301	3306	7162	46.16%	11.42%	12	12
14	臺東縣池上鄉	2018-11-24T22:33:38+08:00	724	1919	2643	251	2894	6306	45.89%	11.48%	11	12
14	臺東縣池上鄉	2018-11-25T01:07:27+08:00	818	2187	3005	301	3306	7162	46.16%	11.42%	12	12
14	臺東縣池上鄉	2018-11-25T06:13:53+08:00	818	2187	3005	301	3306	7162	46.16%	11.42%	12	12
14	臺東縣池上鄉	2018-11-24T23:43:17+08:00	818	2187	3005	301	3306	7162	46.16%	11.42%	12	12
14	臺東縣池上鄉	2018-11-25T00:18:31+08:00	818	2187	3005	301	3306	7162	46.16%	11.42%	12	12
14	臺東縣池上鄉	2018-11-24T22:37:01+08:00	724	1919	2643	251	2894	6306	45.89%	11.48%	11	12
14	臺東縣池上鄉	2018-11-24T22:13:27+08:00	724	1919	2643	251	2894	6306	45.89%	11.48%	11	12
14	臺東縣池上鄉	2018-11-25T03:44:24+08:00	818	2187	3005	301	3306	7162	46.16%	11.42%	12	12
14	臺東縣池上鄉	2018-11-25T01:02:31+08:00	818	2187	3005	301	3306	7162	46.16%	11.42%	12	12
14	臺東縣池上鄉	2018-11-25T03:38:55+08:00	818	2187	3005	301	3306	7162	46.16%	11.42%	12	12
14	臺東縣池上鄉	2018-11-24T23:55:47+08:00	818	2187	3005	301	3306	7162	46.16%	11.42%	12	12
14	臺東縣池上鄉	2018-11-24T23:08:36+08:00	818	2187	3005	301	3306	7162	46.16%	11.42%	12	12
14	臺東縣池上鄉	2018-11-24T23:23:39+08:00	818	2187	3005	301	3306	7162	46.16%	11.42%	12	12
14	臺東縣池上鄉	2018-11-25T06:18:58+08:00	818	2187	3005	301	3306	7162	46.16%	11.42%	12	12
14	臺東縣池上鄉	2018-11-25T00:00:11+08:00	818	2187	3005	301	3306	7162	46.16%	11.42%	12	12
14	臺東縣池上鄉	2018-11-24T23:51:36+08:00	818	2187	3005	301	3306	7162	46.16%	11.42%	12	12
14	臺東縣池上鄉	2018-11-24T22:30:09+08:00	724	1919	2643	251	2894	6306	45.89%	11.48%	11	12
14	臺東縣池上鄉	2018-11-24T22:23:14+08:00	724	1919	2643	251	2894	6306	45.89%	11.48%	11	12
14	臺東縣池上鄉	2018-11-24T22:40:28+08:00	724	1919	2643	251	2894	6306	45.89%	11.48%	11	12
14	臺東縣池上鄉	2018-11-25T00:09:35+08:00	818	2187	3005	301	3306	7162	46.16%	11.42%	12	12
14	臺東縣池上鄉	2018-11-24T23:35:11+08:00	818	2187	3005	301	3306	7162	46.16%	11.42%	12	12
14	臺東縣池上鄉	2018-11-24T23:01:31+08:00	818	2187	3005	301	3306	7162	46.16%	11.42%	12	12
14	臺東縣池上鄉	2018-11-24T22:45:09+08:00	724	1919	2643	251	2894	6306	45.89%	11.48%	11	12
14	臺東縣池上鄉	2018-11-24T22:54:26+08:00	724	1919	2643	251	2894	6306	45.89%	11.48%	11	12
14	臺東縣池上鄉	2018-11-25T00:14:10+08:00	818	2187	3005	301	3306	7162	46.16%	11.42%	12	12
14	臺東縣池上鄉	2018-11-25T03:56:13+08:00	818	2187	3005	301	3306	7162	46.16%	11.42%	12	12
14	臺東縣池上鄉	2018-11-24T23:16:03+08:00	818	2187	3005	301	3306	7162	46.16%	11.42%	12	12
14	臺東縣池上鄉	2018-11-25T03:32:35+08:00	818	2187	3005	301	3306	7162	46.16%	11.42%	12	12
14	臺東縣池上鄉	2018-11-25T01:25:53+08:00	818	2187	3005	301	3306	7162	46.16%	11.42%	12	12
14	臺東縣池上鄉	2018-11-25T00:23:04+08:00	818	2187	3005	301	3306	7162	46.16%	11.42%	12	12
14	臺東縣池上鄉	2018-11-25T06:24:01+08:00	818	2187	3005	301	3306	7162	46.16%	11.42%	12	12
14	臺東縣池上鄉	2018-11-24T23:27:19+08:00	818	2187	3005	301	3306	7162	46.16%	11.42%	12	12
14	臺東縣池上鄉	2018-11-25T00:57:37+08:00	818	2187	3005	301	3306	7162	46.16%	11.42%	12	12
14	臺東縣池上鄉	2018-11-24T22:57:54+08:00	818	2187	3005	301	3306	7162	46.16%	11.42%	12	12
14	臺東縣池上鄉	2018-11-25T01:17:53+08:00	818	2187	3005	301	3306	7162	46.16%	11.42%	12	12
14	臺東縣池上鄉	2018-11-24T22:19:37+08:00	724	1919	2643	251	2894	6306	45.89%	11.48%	11	12
14	臺東縣池上鄉	2018-11-24T23:19:52+08:00	818	2187	3005	301	3306	7162	46.16%	11.42%	12	12
14	臺東縣池上鄉	2018-11-24T22:41:35+08:00	724	1919	2643	251	2894	6306	45.89%	11.48%	11	12
14	臺東縣池上鄉	2018-11-25T00:05:05+08:00	818	2187	3005	301	3306	7162	46.16%	11.42%	12	12
14	臺東縣池上鄉	2018-11-24T23:12:16+08:00	818	2187	3005	301	3306	7162	46.16%	11.42%	12	12
14	臺東縣池上鄉	2018-11-25T06:08:53+08:00	818	2187	3005	301	3306	7162	46.16%	11.42%	12	12
14	臺東縣池上鄉	2018-11-25T01:12:44+08:00	818	2187	3005	301	3306	7162	46.16%	11.42%	12	12
14	臺東縣池上鄉	2018-11-24T22:50:49+08:00	724	1919	2643	251	2894	6306	45.89%	11.48%	11	12
14	臺東縣池上鄉	2018-11-24T22:26:37+08:00	724	1919	2643	251	2894	6306	45.89%	11.48%	11	12
14	臺東縣池上鄉	2018-11-25T04:02:53+08:00	818	2187	3005	301	3306	7162	46.16%	11.42%	12	12
14	臺東縣池上鄉	2018-11-24T23:05:05+08:00	818	2187	3005	301	3306	7162	46.16%	11.42%	12	12
14	臺東縣池上鄉	2018-11-24T23:31:12+08:00	818	2187	3005	301	3306	7162	46.16%	11.42%	12	12
14	臺東縣池上鄉	2018-11-24T22:16:11+08:00	724	1919	2643	251	2894	6306	45.89%	11.48%	11	12
14	臺東縣池上鄉	2018-11-24T23:39:16+08:00	818	2187	3005	301	3306	7162	46.16%	11.42%	12	12
14	臺南市下營區	2018-11-24T23:35:03+08:00	2968	6079	9047	811	9858	20947	47.06%	14.17%	19	19
14	臺南市下營區	2018-11-24T22:33:30+08:00	2968	6079	9047	811	9858	20947	47.06%	14.17%	19	19
14	臺南市下營區	2018-11-24T23:31:02+08:00	2968	6079	9047	811	9858	20947	47.06%	14.17%	19	19
14	臺南市下營區	2018-11-24T23:39:06+08:00	2968	6079	9047	811	9858	20947	47.06%	14.17%	19	19
14	臺南市下營區	2018-11-24T23:12:07+08:00	2968	6079	9047	811	9858	20947	47.06%	14.17%	19	19
14	臺南市下營區	2018-11-24T23:47:20+08:00	2968	6079	9047	811	9858	20947	47.06%	14.17%	19	19
14	臺南市下營區	2018-11-24T23:43:10+08:00	2968	6079	9047	811	9858	20947	47.06%	14.17%	19	19
14	臺南市下營區	2018-11-25T06:08:44+08:00	2968	6079	9047	811	9858	20947	47.06%	14.17%	19	19
14	臺南市下營區	2018-11-25T01:07:18+08:00	2968	6079	9047	811	9858	20947	47.06%	14.17%	19	19
14	臺南市下營區	2018-11-24T23:01:23+08:00	2968	6079	9047	811	9858	20947	47.06%	14.17%	19	19
14	臺南市下營區	2018-11-24T22:57:45+08:00	2968	6079	9047	811	9858	20947	47.06%	14.17%	19	19
14	臺南市下營區	2018-11-24T22:13:18+08:00	2968	6079	9047	811	9858	20947	47.06%	14.17%	19	19
14	臺南市下營區	2018-11-24T22:19:29+08:00	2968	6079	9047	811	9858	20947	47.06%	14.17%	19	19
14	臺南市下營區	2018-11-25T00:57:28+08:00	2968	6079	9047	811	9858	20947	47.06%	14.17%	19	19
14	臺南市下營區	2018-11-24T23:23:31+08:00	2968	6079	9047	811	9858	20947	47.06%	14.17%	19	19
14	臺南市下營區	2018-11-25T03:44:14+08:00	2968	6079	9047	811	9858	20947	47.06%	14.17%	19	19
14	臺南市下營區	2018-11-25T01:17:43+08:00	2968	6079	9047	811	9858	20947	47.06%	14.17%	19	19
14	臺南市下營區	2018-11-25T00:04:57+08:00	2968	6079	9047	811	9858	20947	47.06%	14.17%	19	19
14	臺南市下營區	2018-11-24T23:04:56+08:00	2968	6079	9047	811	9858	20947	47.06%	14.17%	19	19
14	臺南市下營區	2018-11-24T23:15:55+08:00	2968	6079	9047	811	9858	20947	47.06%	14.17%	19	19
14	臺南市下營區	2018-11-25T01:02:23+08:00	2968	6079	9047	811	9858	20947	47.06%	14.17%	19	19
14	臺南市下營區	2018-11-25T01:25:45+08:00	2968	6079	9047	811	9858	20947	47.06%	14.17%	19	19
14	臺南市下營區	2018-11-25T03:38:48+08:00	2968	6079	9047	811	9858	20947	47.06%	14.17%	19	19
14	臺南市下營區	2018-11-25T06:18:50+08:00	2968	6079	9047	811	9858	20947	47.06%	14.17%	19	19
14	臺南市下營區	2018-11-24T22:40:21+08:00	2968	6079	9047	811	9858	20947	47.06%	14.17%	19	19
14	臺南市下營區	2018-11-24T23:55:39+08:00	2968	6079	9047	811	9858	20947	47.06%	14.17%	19	19
14	臺南市下營區	2018-11-24T22:45:01+08:00	2968	6079	9047	811	9858	20947	47.06%	14.17%	19	19
14	臺南市下營區	2018-11-25T00:18:22+08:00	2968	6079	9047	811	9858	20947	47.06%	14.17%	19	19
14	臺南市下營區	2018-11-25T00:22:56+08:00	2968	6079	9047	811	9858	20947	47.06%	14.17%	19	19
14	臺南市下營區	2018-11-24T22:54:19+08:00	2968	6079	9047	811	9858	20947	47.06%	14.17%	19	19
14	臺南市下營區	2018-11-25T03:56:03+08:00	2968	6079	9047	811	9858	20947	47.06%	14.17%	19	19
14	臺南市下營區	2018-11-24T22:16:02+08:00	2968	6079	9047	811	9858	20947	47.06%	14.17%	19	19
14	臺南市下營區	2018-11-25T01:12:34+08:00	2968	6079	9047	811	9858	20947	47.06%	14.17%	19	19
14	臺南市下營區	2018-11-24T22:50:39+08:00	2968	6079	9047	811	9858	20947	47.06%	14.17%	19	19
14	臺南市下營區	2018-11-25T00:09:25+08:00	2968	6079	9047	811	9858	20947	47.06%	14.17%	19	19
14	臺南市下營區	2018-11-25T00:14:01+08:00	2968	6079	9047	811	9858	20947	47.06%	14.17%	19	19
14	臺南市下營區	2018-11-24T22:41:28+08:00	2968	6079	9047	811	9858	20947	47.06%	14.17%	19	19
14	臺南市下營區	2018-11-25T04:02:41+08:00	2968	6079	9047	811	9858	20947	47.06%	14.17%	19	19
14	臺南市下營區	2018-11-25T00:00:00+08:00	2968	6079	9047	811	9858	20947	47.06%	14.17%	19	19
14	臺南市下營區	2018-11-24T22:23:04+08:00	2968	6079	9047	811	9858	20947	47.06%	14.17%	19	19
14	臺南市下營區	2018-11-24T23:19:41+08:00	2968	6079	9047	811	9858	20947	47.06%	14.17%	19	19
14	臺南市下營區	2018-11-24T23:51:27+08:00	2968	6079	9047	811	9858	20947	47.06%	14.17%	19	19
14	臺南市下營區	2018-11-24T22:29:58+08:00	2968	6079	9047	811	9858	20947	47.06%	14.17%	19	19
14	臺南市下營區	2018-11-24T22:36:53+08:00	2968	6079	9047	811	9858	20947	47.06%	14.17%	19	19
14	臺南市下營區	2018-11-25T03:32:27+08:00	2968	6079	9047	811	9858	20947	47.06%	14.17%	19	19
14	臺南市下營區	2018-11-24T23:27:11+08:00	2968	6079	9047	811	9858	20947	47.06%	14.17%	19	19
14	臺南市下營區	2018-11-24T23:08:27+08:00	2968	6079	9047	811	9858	20947	47.06%	14.17%	19	19
14	臺南市下營區	2018-11-25T03:49:44+08:00	2968	6079	9047	811	9858	20947	47.06%	14.17%	19	19
14	臺南市下營區	2018-11-24T22:26:30+08:00	2968	6079	9047	811	9858	20947	47.06%	14.17%	19	19
14	臺南市下營區	2018-11-25T06:29:09+08:00	2968	6079	9047	811	9858	20947	47.06%	14.17%	19	19
14	臺南市下營區	2018-11-25T06:23:53+08:00	2968	6079	9047	811	9858	20947	47.06%	14.17%	19	19
14	臺南市下營區	2018-11-25T06:13:45+08:00	2968	6079	9047	811	9858	20947	47.06%	14.17%	19	19
14	臺南市新化區	2018-11-24T23:47:21+08:00	5988	12714	18702	1443	20145	37296	54.01%	16.06%	37	37
14	臺南市新化區	2018-11-24T23:35:03+08:00	5988	12714	18702	1443	20145	37296	54.01%	16.06%	37	37
14	臺南市新化區	2018-11-24T22:33:30+08:00	5988	12714	18702	1443	20145	37296	54.01%	16.06%	37	37
14	臺南市新化區	2018-11-24T23:31:02+08:00	5988	12714	18702	1443	20145	37296	54.01%	16.06%	37	37
14	臺南市新化區	2018-11-24T23:39:06+08:00	5988	12714	18702	1443	20145	37296	54.01%	16.06%	37	37
14	臺南市新化區	2018-11-25T01:07:19+08:00	5988	12714	18702	1443	20145	37296	54.01%	16.06%	37	37
14	臺南市新化區	2018-11-25T00:14:02+08:00	5988	12714	18702	1443	20145	37296	54.01%	16.06%	37	37
14	臺南市新化區	2018-11-24T23:43:10+08:00	5988	12714	18702	1443	20145	37296	54.01%	16.06%	37	37
14	臺南市新化區	2018-11-25T06:08:44+08:00	5988	12714	18702	1443	20145	37296	54.01%	16.06%	37	37
14	臺南市新化區	2018-11-25T00:09:26+08:00	5988	12714	18702	1443	20145	37296	54.01%	16.06%	37	37
14	臺南市新化區	2018-11-24T23:01:23+08:00	5988	12714	18702	1443	20145	37296	54.01%	16.06%	37	37
14	臺南市新化區	2018-11-24T23:12:08+08:00	5988	12714	18702	1443	20145	37296	54.01%	16.06%	37	37
14	臺南市新化區	2018-11-24T22:57:45+08:00	5988	12714	18702	1443	20145	37296	54.01%	16.06%	37	37
14	臺南市新化區	2018-11-25T00:04:58+08:00	5988	12714	18702	1443	20145	37296	54.01%	16.06%	37	37
14	臺南市新化區	2018-11-24T23:04:57+08:00	5988	12714	18702	1443	20145	37296	54.01%	16.06%	37	37
14	臺南市新化區	2018-11-24T23:23:31+08:00	5988	12714	18702	1443	20145	37296	54.01%	16.06%	37	37
14	臺南市新化區	2018-11-25T00:57:29+08:00	5988	12714	18702	1443	20145	37296	54.01%	16.06%	37	37
14	臺南市新化區	2018-11-24T22:13:19+08:00	5769	11965	17734	1396	19130	35734	53.53%	16.14%	36	37
14	臺南市新化區	2018-11-25T03:44:14+08:00	5988	12714	18702	1443	20145	37296	54.01%	16.06%	37	37
14	臺南市新化區	2018-11-25T01:17:43+08:00	5988	12714	18702	1443	20145	37296	54.01%	16.06%	37	37
14	臺南市新化區	2018-11-24T23:55:40+08:00	5988	12714	18702	1443	20145	37296	54.01%	16.06%	37	37
14	臺南市新化區	2018-11-25T01:02:23+08:00	5988	12714	18702	1443	20145	37296	54.01%	16.06%	37	37
14	臺南市新化區	2018-11-25T01:25:45+08:00	5988	12714	18702	1443	20145	37296	54.01%	16.06%	37	37
14	臺南市新化區	2018-11-25T03:38:48+08:00	5988	12714	18702	1443	20145	37296	54.01%	16.06%	37	37
14	臺南市新化區	2018-11-25T06:18:50+08:00	5988	12714	18702	1443	20145	37296	54.01%	16.06%	37	37
14	臺南市新化區	2018-11-24T22:40:21+08:00	5988	12714	18702	1443	20145	37296	54.01%	16.06%	37	37
14	臺南市新化區	2018-11-24T23:27:12+08:00	5988	12714	18702	1443	20145	37296	54.01%	16.06%	37	37
14	臺南市新化區	2018-11-25T00:18:22+08:00	5988	12714	18702	1443	20145	37296	54.01%	16.06%	37	37
14	臺南市新化區	2018-11-25T00:22:56+08:00	5988	12714	18702	1443	20145	37296	54.01%	16.06%	37	37
14	臺南市新化區	2018-11-24T22:54:19+08:00	5988	12714	18702	1443	20145	37296	54.01%	16.06%	37	37
14	臺南市新化區	2018-11-25T03:56:04+08:00	5988	12714	18702	1443	20145	37296	54.01%	16.06%	37	37
14	臺南市新化區	2018-11-24T22:16:02+08:00	5988	12714	18702	1443	20145	37296	54.01%	16.06%	37	37
14	臺南市新化區	2018-11-24T22:41:28+08:00	5988	12714	18702	1443	20145	37296	54.01%	16.06%	37	37
14	臺南市新化區	2018-11-25T04:02:41+08:00	5988	12714	18702	1443	20145	37296	54.01%	16.06%	37	37
14	臺南市新化區	2018-11-25T01:12:35+08:00	5988	12714	18702	1443	20145	37296	54.01%	16.06%	37	37
14	臺南市新化區	2018-11-24T23:19:41+08:00	5988	12714	18702	1443	20145	37296	54.01%	16.06%	37	37
14	臺南市新化區	2018-11-25T00:00:01+08:00	5988	12714	18702	1443	20145	37296	54.01%	16.06%	37	37
14	臺南市新化區	2018-11-24T23:51:27+08:00	5988	12714	18702	1443	20145	37296	54.01%	16.06%	37	37
14	臺南市新化區	2018-11-24T22:29:58+08:00	5988	12714	18702	1443	20145	37296	54.01%	16.06%	37	37
14	臺南市新化區	2018-11-24T22:23:05+08:00	5988	12714	18702	1443	20145	37296	54.01%	16.06%	37	37
14	臺南市新化區	2018-11-24T22:36:54+08:00	5988	12714	18702	1443	20145	37296	54.01%	16.06%	37	37
14	臺南市新化區	2018-11-24T23:15:56+08:00	5988	12714	18702	1443	20145	37296	54.01%	16.06%	37	37
14	臺南市新化區	2018-11-24T23:08:28+08:00	5988	12714	18702	1443	20145	37296	54.01%	16.06%	37	37
14	臺南市新化區	2018-11-25T03:32:27+08:00	5988	12714	18702	1443	20145	37296	54.01%	16.06%	37	37
14	臺南市新化區	2018-11-24T22:19:30+08:00	5988	12714	18702	1443	20145	37296	54.01%	16.06%	37	37
14	臺南市新化區	2018-11-25T03:49:44+08:00	5988	12714	18702	1443	20145	37296	54.01%	16.06%	37	37
14	臺南市新化區	2018-11-24T22:45:02+08:00	5988	12714	18702	1443	20145	37296	54.01%	16.06%	37	37
14	臺南市新化區	2018-11-24T22:50:40+08:00	5988	12714	18702	1443	20145	37296	54.01%	16.06%	37	37
14	臺南市新化區	2018-11-24T22:26:30+08:00	5988	12714	18702	1443	20145	37296	54.01%	16.06%	37	37
14	臺南市新化區	2018-11-25T06:29:09+08:00	5988	12714	18702	1443	20145	37296	54.01%	16.06%	37	37
14	臺南市新化區	2018-11-25T06:23:53+08:00	5988	12714	18702	1443	20145	37296	54.01%	16.06%	37	37
14	臺南市新化區	2018-11-25T06:13:45+08:00	5988	12714	18702	1443	20145	37296	54.01%	16.06%	37	37
14	宜蘭縣宜蘭市	2018-11-24T22:33:37+08:00	7481	14879	22360	1244	23604	41707	56.59%	17.94%	44	78
14	宜蘭縣宜蘭市	2018-11-24T23:47:28+08:00	11276	22517	33793	1923	35716	62764	56.91%	17.97%	64	78
14	宜蘭縣宜蘭市	2018-11-24T22:37:00+08:00	7677	15321	22998	1288	24286	42921	56.58%	17.89%	45	78
14	宜蘭縣宜蘭市	2018-11-24T23:43:16+08:00	11111	22193	33304	1879	35183	61888	56.85%	17.95%	63	78
14	宜蘭縣宜蘭市	2018-11-25T01:07:26+08:00	14241	28110	42351	2473	44824	79167	56.62%	17.99%	78	78
14	宜蘭縣宜蘭市	2018-11-25T06:13:52+08:00	14241	28110	42351	2473	44824	79167	56.62%	17.99%	78	78
14	宜蘭縣宜蘭市	2018-11-25T03:56:11+08:00	14241	28110	42351	2473	44824	79167	56.62%	17.99%	78	78
14	宜蘭縣宜蘭市	2018-11-25T06:29:16+08:00	14241	28110	42351	2473	44824	79167	56.62%	17.99%	78	78
14	宜蘭縣宜蘭市	2018-11-25T03:38:54+08:00	14241	28110	42351	2473	44824	79167	56.62%	17.99%	78	78
14	宜蘭縣宜蘭市	2018-11-24T23:55:46+08:00	12277	24511	36788	2124	38912	68430	56.86%	17.94%	69	78
14	宜蘭縣宜蘭市	2018-11-24T23:23:38+08:00	10017	19983	30000	1675	31675	55886	56.68%	17.92%	57	78
14	宜蘭縣宜蘭市	2018-11-25T01:02:30+08:00	14241	28110	42351	2473	44824	79167	56.62%	17.99%	78	78
14	宜蘭縣宜蘭市	2018-11-25T03:44:22+08:00	14241	28110	42351	2473	44824	79167	56.62%	17.99%	78	78
14	宜蘭縣宜蘭市	2018-11-24T22:13:26+08:00	5902	11798	17700	1007	18707	32942	56.79%	17.92%	36	78
14	宜蘭縣宜蘭市	2018-11-24T22:23:12+08:00	6779	13531	20310	1135	21445	37936	56.53%	17.87%	41	78
14	宜蘭縣宜蘭市	2018-11-24T22:30:08+08:00	6950	13883	20833	1163	21996	38882	56.57%	17.87%	42	78
14	宜蘭縣宜蘭市	2018-11-24T22:40:27+08:00	7677	15321	22998	1288	24286	42921	56.58%	17.89%	45	78
14	宜蘭縣宜蘭市	2018-11-25T00:00:10+08:00	12478	24878	37356	2168	39524	69590	56.8%	17.93%	70	78
14	宜蘭縣宜蘭市	2018-11-25T06:18:57+08:00	14241	28110	42351	2473	44824	79167	56.62%	17.99%	78	78
14	宜蘭縣宜蘭市	2018-11-25T01:17:51+08:00	14241	28110	42351	2473	44824	79167	56.62%	17.99%	78	78
14	宜蘭縣宜蘭市	2018-11-24T23:19:51+08:00	10017	19983	30000	1675	31675	55886	56.68%	17.92%	57	78
14	宜蘭縣宜蘭市	2018-11-24T23:12:15+08:00	9408	18744	28152	1570	29722	52308	56.82%	17.99%	54	78
14	宜蘭縣宜蘭市	2018-11-24T22:45:08+08:00	7810	15650	23460	1333	24793	43826	56.57%	17.82%	46	78
14	宜蘭縣宜蘭市	2018-11-24T23:31:10+08:00	10158	20280	30438	1704	32142	56613	56.77%	17.94%	58	78
14	宜蘭縣宜蘭市	2018-11-24T23:01:30+08:00	9204	18400	27604	1540	29144	51342	56.76%	17.93%	53	78
14	宜蘭縣宜蘭市	2018-11-24T23:39:15+08:00	10561	21063	31624	1761	33385	58842	56.74%	17.95%	60	78
14	宜蘭縣宜蘭市	2018-11-25T00:09:34+08:00	13333	26551	39884	2305	42189	74254	56.82%	17.96%	74	78
14	宜蘭縣宜蘭市	2018-11-24T23:35:10+08:00	10357	20696	31053	1737	32790	57747	56.78%	17.94%	59	78
14	宜蘭縣宜蘭市	2018-11-25T00:14:09+08:00	13575	26926	40501	2338	42839	75419	56.8%	18%	75	78
14	宜蘭縣宜蘭市	2018-11-25T03:49:51+08:00	14241	28110	42351	2473	44824	79167	56.62%	17.99%	78	78
14	宜蘭縣宜蘭市	2018-11-24T23:16:02+08:00	9817	19579	29396	1640	31036	54627	56.81%	17.97%	56	78
14	宜蘭縣宜蘭市	2018-11-25T06:24:00+08:00	14241	28110	42351	2473	44824	79167	56.62%	17.99%	78	78
14	宜蘭縣宜蘭市	2018-11-25T00:23:03+08:00	14015	27750	41765	2415	44180	78005	56.64%	17.97%	77	78
14	宜蘭縣宜蘭市	2018-11-24T23:08:35+08:00	9408	18744	28152	1570	29722	52308	56.82%	17.99%	54	78
14	宜蘭縣宜蘭市	2018-11-25T03:32:34+08:00	14241	28110	42351	2473	44824	79167	56.62%	17.99%	78	78
14	宜蘭縣宜蘭市	2018-11-25T01:25:52+08:00	14241	28110	42351	2473	44824	79167	56.62%	17.99%	78	78
14	宜蘭縣宜蘭市	2018-11-24T22:57:53+08:00	8756	17550	26306	1478	27784	49066	56.63%	17.85%	51	78
14	宜蘭縣宜蘭市	2018-11-24T22:19:36+08:00	6453	12840	19293	1080	20373	35849	56.83%	18%	39	78
14	宜蘭縣宜蘭市	2018-11-25T00:57:36+08:00	14241	28110	42351	2473	44824	79167	56.62%	17.99%	78	78
14	宜蘭縣宜蘭市	2018-11-24T23:27:18+08:00	10017	19983	30000	1675	31675	55886	56.68%	17.92%	57	78
14	宜蘭縣宜蘭市	2018-11-24T23:51:35+08:00	12277	24511	36788	2124	38912	68430	56.86%	17.94%	69	78
14	宜蘭縣宜蘭市	2018-11-24T23:05:04+08:00	9204	18400	27604	1540	29144	51342	56.76%	17.93%	53	78
14	宜蘭縣宜蘭市	2018-11-25T04:02:52+08:00	14241	28110	42351	2473	44824	79167	56.62%	17.99%	78	78
14	宜蘭縣宜蘭市	2018-11-24T22:50:47+08:00	8184	16345	24529	1389	25918	45878	56.49%	17.84%	48	78
14	宜蘭縣宜蘭市	2018-11-24T22:16:10+08:00	6074	12109	18183	1017	19200	33790	56.82%	17.98%	37	78
14	宜蘭縣宜蘭市	2018-11-25T01:12:43+08:00	14241	28110	42351	2473	44824	79167	56.62%	17.99%	78	78
14	宜蘭縣宜蘭市	2018-11-25T00:05:04+08:00	13333	26551	39884	2305	42189	74254	56.82%	17.96%	74	78
14	宜蘭縣宜蘭市	2018-11-24T22:41:34+08:00	7677	15321	22998	1288	24286	42921	56.58%	17.89%	45	78
14	宜蘭縣宜蘭市	2018-11-24T22:26:36+08:00	6950	13883	20833	1163	21996	38882	56.57%	17.87%	42	78
14	宜蘭縣宜蘭市	2018-11-25T00:18:29+08:00	13804	27371	41175	2368	43543	76853	56.66%	17.96%	76	78
14	宜蘭縣宜蘭市	2018-11-25T06:08:52+08:00	14241	28110	42351	2473	44824	79167	56.62%	17.99%	78	78
14	宜蘭縣宜蘭市	2018-11-24T22:54:25+08:00	8374	16823	25197	1411	26608	47008	56.6%	17.81%	49	78
14	宜蘭縣大同鄉	2018-11-25T06:29:17+08:00	556	2141	2697	192	2889	4935	58.54%	11.27%	10	10
14	宜蘭縣大同鄉	2018-11-24T22:33:37+08:00	467	1811	2278	175	2453	4251	57.7%	10.99%	9	10
14	宜蘭縣大同鄉	2018-11-24T23:47:28+08:00	556	2141	2697	192	2889	4935	58.54%	11.27%	10	10
14	宜蘭縣大同鄉	2018-11-24T22:37:00+08:00	556	2141	2697	192	2889	4935	58.54%	11.27%	10	10
14	宜蘭縣大同鄉	2018-11-25T00:18:30+08:00	556	2141	2697	192	2889	4935	58.54%	11.27%	10	10
14	宜蘭縣大同鄉	2018-11-25T01:07:26+08:00	556	2141	2697	192	2889	4935	58.54%	11.27%	10	10
14	宜蘭縣大同鄉	2018-11-25T06:13:52+08:00	556	2141	2697	192	2889	4935	58.54%	11.27%	10	10
14	宜蘭縣大同鄉	2018-11-24T23:43:17+08:00	556	2141	2697	192	2889	4935	58.54%	11.27%	10	10
14	宜蘭縣大同鄉	2018-11-25T03:44:23+08:00	556	2141	2697	192	2889	4935	58.54%	11.27%	10	10
14	宜蘭縣大同鄉	2018-11-24T22:13:27+08:00	359	1519	1878	132	2010	3358	59.86%	10.69%	8	10
14	宜蘭縣大同鄉	2018-11-25T01:02:31+08:00	556	2141	2697	192	2889	4935	58.54%	11.27%	10	10
14	宜蘭縣大同鄉	2018-11-24T23:23:38+08:00	556	2141	2697	192	2889	4935	58.54%	11.27%	10	10
14	宜蘭縣大同鄉	2018-11-25T03:38:55+08:00	556	2141	2697	192	2889	4935	58.54%	11.27%	10	10
14	宜蘭縣大同鄉	2018-11-24T23:55:47+08:00	556	2141	2697	192	2889	4935	58.54%	11.27%	10	10
14	宜蘭縣大同鄉	2018-11-24T23:08:36+08:00	556	2141	2697	192	2889	4935	58.54%	11.27%	10	10
14	宜蘭縣大同鄉	2018-11-25T00:00:11+08:00	556	2141	2697	192	2889	4935	58.54%	11.27%	10	10
14	宜蘭縣大同鄉	2018-11-24T22:30:08+08:00	359	1519	1878	132	2010	3358	59.86%	10.69%	8	10
14	宜蘭縣大同鄉	2018-11-24T22:40:27+08:00	556	2141	2697	192	2889	4935	58.54%	11.27%	10	10
14	宜蘭縣大同鄉	2018-11-25T06:18:57+08:00	556	2141	2697	192	2889	4935	58.54%	11.27%	10	10
14	宜蘭縣大同鄉	2018-11-24T22:23:13+08:00	359	1519	1878	132	2010	3358	59.86%	10.69%	8	10
14	宜蘭縣大同鄉	2018-11-24T23:19:51+08:00	556	2141	2697	192	2889	4935	58.54%	11.27%	10	10
14	宜蘭縣大同鄉	2018-11-24T23:12:15+08:00	556	2141	2697	192	2889	4935	58.54%	11.27%	10	10
14	宜蘭縣大同鄉	2018-11-24T22:45:08+08:00	556	2141	2697	192	2889	4935	58.54%	11.27%	10	10
14	宜蘭縣大同鄉	2018-11-24T23:01:30+08:00	556	2141	2697	192	2889	4935	58.54%	11.27%	10	10
14	宜蘭縣大同鄉	2018-11-24T23:35:11+08:00	556	2141	2697	192	2889	4935	58.54%	11.27%	10	10
14	宜蘭縣大同鄉	2018-11-24T23:39:15+08:00	556	2141	2697	192	2889	4935	58.54%	11.27%	10	10
14	宜蘭縣大同鄉	2018-11-24T23:31:11+08:00	556	2141	2697	192	2889	4935	58.54%	11.27%	10	10
14	宜蘭縣大同鄉	2018-11-25T00:09:34+08:00	556	2141	2697	192	2889	4935	58.54%	11.27%	10	10
14	宜蘭縣大同鄉	2018-11-25T00:14:09+08:00	556	2141	2697	192	2889	4935	58.54%	11.27%	10	10
14	宜蘭縣大同鄉	2018-11-25T03:49:51+08:00	556	2141	2697	192	2889	4935	58.54%	11.27%	10	10
14	宜蘭縣大同鄉	2018-11-24T23:16:02+08:00	556	2141	2697	192	2889	4935	58.54%	11.27%	10	10
14	宜蘭縣大同鄉	2018-11-25T03:56:12+08:00	556	2141	2697	192	2889	4935	58.54%	11.27%	10	10
14	宜蘭縣大同鄉	2018-11-25T06:24:00+08:00	556	2141	2697	192	2889	4935	58.54%	11.27%	10	10
14	宜蘭縣大同鄉	2018-11-25T00:23:03+08:00	556	2141	2697	192	2889	4935	58.54%	11.27%	10	10
14	宜蘭縣大同鄉	2018-11-25T03:32:34+08:00	556	2141	2697	192	2889	4935	58.54%	11.27%	10	10
14	宜蘭縣大同鄉	2018-11-25T01:25:52+08:00	556	2141	2697	192	2889	4935	58.54%	11.27%	10	10
14	宜蘭縣大同鄉	2018-11-24T22:57:53+08:00	556	2141	2697	192	2889	4935	58.54%	11.27%	10	10
14	宜蘭縣大同鄉	2018-11-24T22:19:37+08:00	359	1519	1878	132	2010	3358	59.86%	10.69%	8	10
14	宜蘭縣大同鄉	2018-11-25T00:57:36+08:00	556	2141	2697	192	2889	4935	58.54%	11.27%	10	10
14	宜蘭縣大同鄉	2018-11-25T01:17:52+08:00	556	2141	2697	192	2889	4935	58.54%	11.27%	10	10
14	宜蘭縣大同鄉	2018-11-24T23:27:18+08:00	556	2141	2697	192	2889	4935	58.54%	11.27%	10	10
14	宜蘭縣大同鄉	2018-11-24T23:51:35+08:00	556	2141	2697	192	2889	4935	58.54%	11.27%	10	10
14	宜蘭縣大同鄉	2018-11-24T23:05:04+08:00	556	2141	2697	192	2889	4935	58.54%	11.27%	10	10
14	宜蘭縣大同鄉	2018-11-24T22:41:35+08:00	556	2141	2697	192	2889	4935	58.54%	11.27%	10	10
14	宜蘭縣大同鄉	2018-11-25T00:05:05+08:00	556	2141	2697	192	2889	4935	58.54%	11.27%	10	10
14	宜蘭縣大同鄉	2018-11-25T04:02:52+08:00	556	2141	2697	192	2889	4935	58.54%	11.27%	10	10
14	宜蘭縣大同鄉	2018-11-24T22:16:10+08:00	359	1519	1878	132	2010	3358	59.86%	10.69%	8	10
14	宜蘭縣大同鄉	2018-11-25T01:12:43+08:00	556	2141	2697	192	2889	4935	58.54%	11.27%	10	10
14	宜蘭縣大同鄉	2018-11-24T22:50:48+08:00	556	2141	2697	192	2889	4935	58.54%	11.27%	10	10
14	宜蘭縣大同鄉	2018-11-24T22:26:36+08:00	359	1519	1878	132	2010	3358	59.86%	10.69%	8	10
14	宜蘭縣大同鄉	2018-11-25T06:08:52+08:00	556	2141	2697	192	2889	4935	58.54%	11.27%	10	10
14	宜蘭縣大同鄉	2018-11-24T22:54:25+08:00	556	2141	2697	192	2889	4935	58.54%	11.27%	10	10
14	連江縣莒光鄉	2018-11-24T22:33:39+08:00	185	572	757	27	784	1481	52.94%	12.49%	2	2
14	連江縣莒光鄉	2018-11-25T03:49:52+08:00	185	572	757	27	784	1481	52.94%	12.49%	2	2
14	連江縣莒光鄉	2018-11-24T23:43:18+08:00	185	572	757	27	784	1481	52.94%	12.49%	2	2
14	連江縣莒光鄉	2018-11-25T01:07:28+08:00	185	572	757	27	784	1481	52.94%	12.49%	2	2
14	連江縣莒光鄉	2018-11-25T06:29:18+08:00	185	572	757	27	784	1481	52.94%	12.49%	2	2
14	連江縣莒光鄉	2018-11-24T22:50:50+08:00	185	572	757	27	784	1481	52.94%	12.49%	2	2
14	連江縣莒光鄉	2018-11-25T06:13:54+08:00	185	572	757	27	784	1481	52.94%	12.49%	2	2
14	連江縣莒光鄉	2018-11-25T03:32:36+08:00	185	572	757	27	784	1481	52.94%	12.49%	2	2
14	連江縣莒光鄉	2018-11-24T23:55:48+08:00	185	572	757	27	784	1481	52.94%	12.49%	2	2
14	連江縣莒光鄉	2018-11-25T03:44:25+08:00	185	572	757	27	784	1481	52.94%	12.49%	2	2
14	連江縣莒光鄉	2018-11-24T22:13:28+08:00	0	0	0	0	0	0	0%	0%	0	2
14	連江縣莒光鄉	2018-11-24T23:08:38+08:00	185	572	757	27	784	1481	52.94%	12.49%	2	2
14	連江縣莒光鄉	2018-11-24T23:51:37+08:00	185	572	757	27	784	1481	52.94%	12.49%	2	2
14	連江縣莒光鄉	2018-11-24T22:23:15+08:00	0	0	0	0	0	0	0%	0%	0	2
14	連江縣莒光鄉	2018-11-24T22:40:29+08:00	185	572	757	27	784	1481	52.94%	12.49%	2	2
14	連江縣莒光鄉	2018-11-25T06:18:59+08:00	185	572	757	27	784	1481	52.94%	12.49%	2	2
14	連江縣莒光鄉	2018-11-24T23:23:40+08:00	185	572	757	27	784	1481	52.94%	12.49%	2	2
14	連江縣莒光鄉	2018-11-24T22:54:27+08:00	185	572	757	27	784	1481	52.94%	12.49%	2	2
14	連江縣莒光鄉	2018-11-25T00:14:11+08:00	185	572	757	27	784	1481	52.94%	12.49%	2	2
14	連江縣莒光鄉	2018-11-25T00:05:06+08:00	185	572	757	27	784	1481	52.94%	12.49%	2	2
14	連江縣莒光鄉	2018-11-24T22:16:12+08:00	0	0	0	0	0	0	0%	0%	0	2
14	連江縣莒光鄉	2018-11-24T22:41:37+08:00	185	572	757	27	784	1481	52.94%	12.49%	2	2
14	連江縣莒光鄉	2018-11-24T23:05:06+08:00	185	572	757	27	784	1481	52.94%	12.49%	2	2
14	連江縣莒光鄉	2018-11-24T22:45:10+08:00	185	572	757	27	784	1481	52.94%	12.49%	2	2
14	連江縣莒光鄉	2018-11-25T03:56:14+08:00	185	572	757	27	784	1481	52.94%	12.49%	2	2
14	連江縣莒光鄉	2018-11-24T22:37:02+08:00	185	572	757	27	784	1481	52.94%	12.49%	2	2
14	連江縣莒光鄉	2018-11-25T00:18:32+08:00	185	572	757	27	784	1481	52.94%	12.49%	2	2
14	連江縣莒光鄉	2018-11-24T23:16:04+08:00	185	572	757	27	784	1481	52.94%	12.49%	2	2
14	連江縣莒光鄉	2018-11-25T00:23:05+08:00	185	572	757	27	784	1481	52.94%	12.49%	2	2
14	連江縣莒光鄉	2018-11-25T01:25:54+08:00	185	572	757	27	784	1481	52.94%	12.49%	2	2
14	連江縣莒光鄉	2018-11-25T01:02:32+08:00	185	572	757	27	784	1481	52.94%	12.49%	2	2
14	連江縣莒光鄉	2018-11-25T06:24:01+08:00	185	572	757	27	784	1481	52.94%	12.49%	2	2
14	連江縣莒光鄉	2018-11-24T22:30:11+08:00	84	247	331	11	342	698	49%	12.03%	1	2
14	連江縣莒光鄉	2018-11-25T03:38:56+08:00	185	572	757	27	784	1481	52.94%	12.49%	2	2
14	連江縣莒光鄉	2018-11-24T22:19:38+08:00	0	0	0	0	0	0	0%	0%	0	2
14	連江縣莒光鄉	2018-11-24T23:19:53+08:00	185	572	757	27	784	1481	52.94%	12.49%	2	2
14	連江縣莒光鄉	2018-11-25T01:17:54+08:00	185	572	757	27	784	1481	52.94%	12.49%	2	2
14	連江縣莒光鄉	2018-11-25T00:00:12+08:00	185	572	757	27	784	1481	52.94%	12.49%	2	2
14	連江縣莒光鄉	2018-11-24T22:57:55+08:00	185	572	757	27	784	1481	52.94%	12.49%	2	2
14	連江縣莒光鄉	2018-11-24T23:27:20+08:00	185	572	757	27	784	1481	52.94%	12.49%	2	2
14	連江縣莒光鄉	2018-11-25T00:57:38+08:00	185	572	757	27	784	1481	52.94%	12.49%	2	2
14	連江縣莒光鄉	2018-11-24T23:35:12+08:00	185	572	757	27	784	1481	52.94%	12.49%	2	2
14	連江縣莒光鄉	2018-11-24T23:47:30+08:00	185	572	757	27	784	1481	52.94%	12.49%	2	2
14	連江縣莒光鄉	2018-11-25T00:09:36+08:00	185	572	757	27	784	1481	52.94%	12.49%	2	2
14	連江縣莒光鄉	2018-11-24T23:39:17+08:00	185	572	757	27	784	1481	52.94%	12.49%	2	2
14	連江縣莒光鄉	2018-11-24T23:31:13+08:00	185	572	757	27	784	1481	52.94%	12.49%	2	2
14	連江縣莒光鄉	2018-11-25T04:02:53+08:00	185	572	757	27	784	1481	52.94%	12.49%	2	2
14	連江縣莒光鄉	2018-11-24T23:01:32+08:00	185	572	757	27	784	1481	52.94%	12.49%	2	2
14	連江縣莒光鄉	2018-11-25T01:12:45+08:00	185	572	757	27	784	1481	52.94%	12.49%	2	2
14	連江縣莒光鄉	2018-11-24T22:26:38+08:00	0	0	0	0	0	0	0%	0%	0	2
14	連江縣莒光鄉	2018-11-24T23:12:17+08:00	185	572	757	27	784	1481	52.94%	12.49%	2	2
14	連江縣莒光鄉	2018-11-25T06:08:55+08:00	185	572	757	27	784	1481	52.94%	12.49%	2	2
14	高雄市彌陀區	2018-11-25T04:02:43+08:00	3231	6147	9378	837	10215	16487	61.96%	19.6%	18	18
14	高雄市彌陀區	2018-11-25T01:12:37+08:00	3231	6147	9378	837	10215	16487	61.96%	19.6%	18	18
14	高雄市彌陀區	2018-11-25T00:14:03+08:00	3231	6147	9378	837	10215	16487	61.96%	19.6%	18	18
14	高雄市彌陀區	2018-11-24T23:01:25+08:00	3231	6147	9378	837	10215	16487	61.96%	19.6%	18	18
14	高雄市彌陀區	2018-11-25T01:07:21+08:00	3231	6147	9378	837	10215	16487	61.96%	19.6%	18	18
14	高雄市彌陀區	2018-11-25T00:09:27+08:00	3231	6147	9378	837	10215	16487	61.96%	19.6%	18	18
14	高雄市彌陀區	2018-11-24T23:35:05+08:00	3231	6147	9378	837	10215	16487	61.96%	19.6%	18	18
14	高雄市彌陀區	2018-11-25T06:29:11+08:00	3231	6147	9378	837	10215	16487	61.96%	19.6%	18	18
14	高雄市彌陀區	2018-11-24T23:39:09+08:00	3231	6147	9378	837	10215	16487	61.96%	19.6%	18	18
14	高雄市彌陀區	2018-11-24T23:31:04+08:00	3231	6147	9378	837	10215	16487	61.96%	19.6%	18	18
14	高雄市彌陀區	2018-11-25T01:17:45+08:00	3231	6147	9378	837	10215	16487	61.96%	19.6%	18	18
14	高雄市彌陀區	2018-11-24T23:55:41+08:00	3231	6147	9378	837	10215	16487	61.96%	19.6%	18	18
14	高雄市彌陀區	2018-11-24T23:08:30+08:00	3231	6147	9378	837	10215	16487	61.96%	19.6%	18	18
14	高雄市彌陀區	2018-11-24T23:19:44+08:00	3231	6147	9378	837	10215	16487	61.96%	19.6%	18	18
14	高雄市彌陀區	2018-11-24T22:23:06+08:00	3231	6147	9378	837	10215	16487	61.96%	19.6%	18	18
14	高雄市彌陀區	2018-11-24T22:13:21+08:00	3231	6147	9378	837	10215	16487	61.96%	19.6%	18	18
14	高雄市彌陀區	2018-11-24T23:04:58+08:00	3231	6147	9378	837	10215	16487	61.96%	19.6%	18	18
14	高雄市彌陀區	2018-11-25T00:00:02+08:00	3231	6147	9378	837	10215	16487	61.96%	19.6%	18	18
14	高雄市彌陀區	2018-11-25T00:04:59+08:00	3231	6147	9378	837	10215	16487	61.96%	19.6%	18	18
14	高雄市彌陀區	2018-11-24T23:27:13+08:00	3231	6147	9378	837	10215	16487	61.96%	19.6%	18	18
14	高雄市彌陀區	2018-11-24T22:30:00+08:00	3231	6147	9378	837	10215	16487	61.96%	19.6%	18	18
14	高雄市彌陀區	2018-11-25T01:02:25+08:00	3231	6147	9378	837	10215	16487	61.96%	19.6%	18	18
14	高雄市彌陀區	2018-11-25T06:13:47+08:00	3231	6147	9378	837	10215	16487	61.96%	19.6%	18	18
14	高雄市彌陀區	2018-11-25T00:22:58+08:00	3231	6147	9378	837	10215	16487	61.96%	19.6%	18	18
14	高雄市彌陀區	2018-11-24T22:26:32+08:00	3231	6147	9378	837	10215	16487	61.96%	19.6%	18	18
14	高雄市彌陀區	2018-11-25T00:18:24+08:00	3231	6147	9378	837	10215	16487	61.96%	19.6%	18	18
14	高雄市彌陀區	2018-11-24T22:54:21+08:00	3231	6147	9378	837	10215	16487	61.96%	19.6%	18	18
14	高雄市彌陀區	2018-11-24T22:41:30+08:00	3231	6147	9378	837	10215	16487	61.96%	19.6%	18	18
14	高雄市彌陀區	2018-11-25T03:49:46+08:00	3231	6147	9378	837	10215	16487	61.96%	19.6%	18	18
14	高雄市彌陀區	2018-11-25T06:08:46+08:00	3231	6147	9378	837	10215	16487	61.96%	19.6%	18	18
14	高雄市彌陀區	2018-11-24T23:43:12+08:00	3231	6147	9378	837	10215	16487	61.96%	19.6%	18	18
14	高雄市彌陀區	2018-11-24T23:47:22+08:00	3231	6147	9378	837	10215	16487	61.96%	19.6%	18	18
14	高雄市彌陀區	2018-11-24T22:16:04+08:00	3231	6147	9378	837	10215	16487	61.96%	19.6%	18	18
14	高雄市彌陀區	2018-11-24T22:33:32+08:00	3231	6147	9378	837	10215	16487	61.96%	19.6%	18	18
14	高雄市彌陀區	2018-11-25T03:44:16+08:00	3231	6147	9378	837	10215	16487	61.96%	19.6%	18	18
14	高雄市彌陀區	2018-11-25T03:38:50+08:00	3231	6147	9378	837	10215	16487	61.96%	19.6%	18	18
14	高雄市彌陀區	2018-11-24T23:23:33+08:00	3231	6147	9378	837	10215	16487	61.96%	19.6%	18	18
14	高雄市彌陀區	2018-11-24T23:51:29+08:00	3231	6147	9378	837	10215	16487	61.96%	19.6%	18	18
14	高雄市彌陀區	2018-11-24T22:57:47+08:00	3231	6147	9378	837	10215	16487	61.96%	19.6%	18	18
14	高雄市彌陀區	2018-11-24T22:19:31+08:00	3231	6147	9378	837	10215	16487	61.96%	19.6%	18	18
14	高雄市彌陀區	2018-11-24T22:40:23+08:00	3231	6147	9378	837	10215	16487	61.96%	19.6%	18	18
14	高雄市彌陀區	2018-11-25T03:32:29+08:00	3231	6147	9378	837	10215	16487	61.96%	19.6%	18	18
14	高雄市彌陀區	2018-11-25T06:18:52+08:00	3231	6147	9378	837	10215	16487	61.96%	19.6%	18	18
14	高雄市彌陀區	2018-11-25T00:57:31+08:00	3231	6147	9378	837	10215	16487	61.96%	19.6%	18	18
14	高雄市彌陀區	2018-11-25T01:25:47+08:00	3231	6147	9378	837	10215	16487	61.96%	19.6%	18	18
14	高雄市彌陀區	2018-11-24T22:36:55+08:00	3231	6147	9378	837	10215	16487	61.96%	19.6%	18	18
14	高雄市彌陀區	2018-11-24T23:15:57+08:00	3231	6147	9378	837	10215	16487	61.96%	19.6%	18	18
14	高雄市彌陀區	2018-11-25T03:56:06+08:00	3231	6147	9378	837	10215	16487	61.96%	19.6%	18	18
14	高雄市彌陀區	2018-11-25T06:23:55+08:00	3231	6147	9378	837	10215	16487	61.96%	19.6%	18	18
14	高雄市彌陀區	2018-11-24T23:12:10+08:00	3231	6147	9378	837	10215	16487	61.96%	19.6%	18	18
14	高雄市彌陀區	2018-11-24T22:50:41+08:00	3231	6147	9378	837	10215	16487	61.96%	19.6%	18	18
14	高雄市彌陀區	2018-11-24T22:45:03+08:00	3231	6147	9378	837	10215	16487	61.96%	19.6%	18	18
14	高雄市那瑪夏區	2018-11-25T04:02:43+08:00	285	1201	1486	117	1603	2424	66.13%	11.76%	4	4
14	高雄市那瑪夏區	2018-11-25T01:12:37+08:00	285	1201	1486	117	1603	2424	66.13%	11.76%	4	4
14	高雄市那瑪夏區	2018-11-25T00:14:04+08:00	285	1201	1486	117	1603	2424	66.13%	11.76%	4	4
14	高雄市那瑪夏區	2018-11-24T23:31:05+08:00	218	825	1043	88	1131	1815	62.31%	12.01%	3	4
14	高雄市那瑪夏區	2018-11-25T01:07:21+08:00	285	1201	1486	117	1603	2424	66.13%	11.76%	4	4
14	高雄市那瑪夏區	2018-11-24T23:35:05+08:00	218	825	1043	88	1131	1815	62.31%	12.01%	3	4
14	高雄市那瑪夏區	2018-11-25T06:29:11+08:00	285	1201	1486	117	1603	2424	66.13%	11.76%	4	4
14	高雄市那瑪夏區	2018-11-24T23:39:09+08:00	218	825	1043	88	1131	1815	62.31%	12.01%	3	4
14	高雄市那瑪夏區	2018-11-25T00:09:28+08:00	285	1201	1486	117	1603	2424	66.13%	11.76%	4	4
14	高雄市那瑪夏區	2018-11-24T22:23:07+08:00	218	825	1043	88	1131	1815	62.31%	12.01%	3	4
14	高雄市那瑪夏區	2018-11-24T23:08:30+08:00	218	825	1043	88	1131	1815	62.31%	12.01%	3	4
14	高雄市那瑪夏區	2018-11-24T23:19:44+08:00	218	825	1043	88	1131	1815	62.31%	12.01%	3	4
14	高雄市那瑪夏區	2018-11-24T22:13:21+08:00	75	295	370	51	421	585	71.97%	12.82%	1	4
14	高雄市那瑪夏區	2018-11-25T00:00:02+08:00	218	825	1043	88	1131	1815	62.31%	12.01%	3	4
14	高雄市那瑪夏區	2018-11-24T23:27:13+08:00	218	825	1043	88	1131	1815	62.31%	12.01%	3	4
14	高雄市那瑪夏區	2018-11-24T22:19:32+08:00	112	548	660	65	725	1074	67.5%	10.43%	2	4
14	高雄市那瑪夏區	2018-11-24T22:36:56+08:00	218	825	1043	88	1131	1815	62.31%	12.01%	3	4
14	高雄市那瑪夏區	2018-11-24T22:30:00+08:00	218	825	1043	88	1131	1815	62.31%	12.01%	3	4
14	高雄市那瑪夏區	2018-11-25T01:02:25+08:00	285	1201	1486	117	1603	2424	66.13%	11.76%	4	4
14	高雄市那瑪夏區	2018-11-25T06:13:47+08:00	285	1201	1486	117	1603	2424	66.13%	11.76%	4	4
14	高雄市那瑪夏區	2018-11-24T23:05:00+08:00	218	825	1043	88	1131	1815	62.31%	12.01%	3	4
14	高雄市那瑪夏區	2018-11-25T00:22:58+08:00	285	1201	1486	117	1603	2424	66.13%	11.76%	4	4
14	高雄市那瑪夏區	2018-11-24T22:26:32+08:00	218	825	1043	88	1131	1815	62.31%	12.01%	3	4
14	高雄市那瑪夏區	2018-11-25T00:18:24+08:00	285	1201	1486	117	1603	2424	66.13%	11.76%	4	4
14	高雄市那瑪夏區	2018-11-24T22:50:42+08:00	218	825	1043	88	1131	1815	62.31%	12.01%	3	4
14	高雄市那瑪夏區	2018-11-24T22:54:21+08:00	218	825	1043	88	1131	1815	62.31%	12.01%	3	4
14	高雄市那瑪夏區	2018-11-25T00:05:00+08:00	218	825	1043	88	1131	1815	62.31%	12.01%	3	4
14	高雄市那瑪夏區	2018-11-24T22:41:30+08:00	218	825	1043	88	1131	1815	62.31%	12.01%	3	4
14	高雄市那瑪夏區	2018-11-25T03:49:46+08:00	285	1201	1486	117	1603	2424	66.13%	11.76%	4	4
14	高雄市那瑪夏區	2018-11-24T23:01:26+08:00	218	825	1043	88	1131	1815	62.31%	12.01%	3	4
14	高雄市那瑪夏區	2018-11-25T06:08:46+08:00	285	1201	1486	117	1603	2424	66.13%	11.76%	4	4
14	高雄市那瑪夏區	2018-11-24T23:43:12+08:00	218	825	1043	88	1131	1815	62.31%	12.01%	3	4
14	高雄市那瑪夏區	2018-11-24T22:16:04+08:00	75	295	370	51	421	585	71.97%	12.82%	1	4
14	高雄市那瑪夏區	2018-11-24T22:33:32+08:00	218	825	1043	88	1131	1815	62.31%	12.01%	3	4
14	高雄市那瑪夏區	2018-11-24T23:47:23+08:00	218	825	1043	88	1131	1815	62.31%	12.01%	3	4
14	高雄市那瑪夏區	2018-11-24T23:55:42+08:00	218	825	1043	88	1131	1815	62.31%	12.01%	3	4
14	高雄市那瑪夏區	2018-11-25T03:44:16+08:00	285	1201	1486	117	1603	2424	66.13%	11.76%	4	4
14	高雄市那瑪夏區	2018-11-25T01:17:46+08:00	285	1201	1486	117	1603	2424	66.13%	11.76%	4	4
14	高雄市那瑪夏區	2018-11-24T22:57:48+08:00	218	825	1043	88	1131	1815	62.31%	12.01%	3	4
14	高雄市那瑪夏區	2018-11-25T03:38:50+08:00	285	1201	1486	117	1603	2424	66.13%	11.76%	4	4
14	高雄市那瑪夏區	2018-11-24T23:23:33+08:00	218	825	1043	88	1131	1815	62.31%	12.01%	3	4
14	高雄市那瑪夏區	2018-11-24T23:51:29+08:00	218	825	1043	88	1131	1815	62.31%	12.01%	3	4
14	高雄市那瑪夏區	2018-11-24T22:40:23+08:00	218	825	1043	88	1131	1815	62.31%	12.01%	3	4
14	高雄市那瑪夏區	2018-11-25T03:32:29+08:00	285	1201	1486	117	1603	2424	66.13%	11.76%	4	4
14	高雄市那瑪夏區	2018-11-25T06:18:52+08:00	285	1201	1486	117	1603	2424	66.13%	11.76%	4	4
14	高雄市那瑪夏區	2018-11-24T23:15:58+08:00	218	825	1043	88	1131	1815	62.31%	12.01%	3	4
14	高雄市那瑪夏區	2018-11-25T00:57:31+08:00	285	1201	1486	117	1603	2424	66.13%	11.76%	4	4
14	高雄市那瑪夏區	2018-11-25T01:25:47+08:00	285	1201	1486	117	1603	2424	66.13%	11.76%	4	4
14	高雄市那瑪夏區	2018-11-25T03:56:06+08:00	285	1201	1486	117	1603	2424	66.13%	11.76%	4	4
14	高雄市那瑪夏區	2018-11-25T06:23:55+08:00	285	1201	1486	117	1603	2424	66.13%	11.76%	4	4
14	高雄市那瑪夏區	2018-11-24T23:12:10+08:00	218	825	1043	88	1131	1815	62.31%	12.01%	3	4
14	高雄市那瑪夏區	2018-11-24T22:45:03+08:00	218	825	1043	88	1131	1815	62.31%	12.01%	3	4
14	臺東縣關山鎮	2018-11-25T06:29:17+08:00	924	2596	3520	227	3747	7509	49.9%	12.31%	9	9
14	臺東縣關山鎮	2018-11-24T23:47:29+08:00	924	2596	3520	227	3747	7509	49.9%	12.31%	9	9
14	臺東縣關山鎮	2018-11-24T22:33:38+08:00	924	2596	3520	227	3747	7509	49.9%	12.31%	9	9
14	臺東縣關山鎮	2018-11-25T01:07:27+08:00	924	2596	3520	227	3747	7509	49.9%	12.31%	9	9
14	臺東縣關山鎮	2018-11-25T06:13:53+08:00	924	2596	3520	227	3747	7509	49.9%	12.31%	9	9
14	臺東縣關山鎮	2018-11-24T23:43:17+08:00	924	2596	3520	227	3747	7509	49.9%	12.31%	9	9
14	臺東縣關山鎮	2018-11-25T00:18:31+08:00	924	2596	3520	227	3747	7509	49.9%	12.31%	9	9
14	臺東縣關山鎮	2018-11-24T22:37:01+08:00	924	2596	3520	227	3747	7509	49.9%	12.31%	9	9
14	臺東縣關山鎮	2018-11-25T03:44:23+08:00	924	2596	3520	227	3747	7509	49.9%	12.31%	9	9
14	臺東縣關山鎮	2018-11-24T22:13:27+08:00	924	2596	3520	227	3747	7509	49.9%	12.31%	9	9
14	臺東縣關山鎮	2018-11-25T01:02:31+08:00	924	2596	3520	227	3747	7509	49.9%	12.31%	9	9
14	臺東縣關山鎮	2018-11-25T03:38:55+08:00	924	2596	3520	227	3747	7509	49.9%	12.31%	9	9
14	臺東縣關山鎮	2018-11-24T23:55:47+08:00	924	2596	3520	227	3747	7509	49.9%	12.31%	9	9
14	臺東縣關山鎮	2018-11-24T23:08:36+08:00	924	2596	3520	227	3747	7509	49.9%	12.31%	9	9
14	臺東縣關山鎮	2018-11-24T23:23:39+08:00	924	2596	3520	227	3747	7509	49.9%	12.31%	9	9
14	臺東縣關山鎮	2018-11-25T06:18:58+08:00	924	2596	3520	227	3747	7509	49.9%	12.31%	9	9
14	臺東縣關山鎮	2018-11-25T00:00:11+08:00	924	2596	3520	227	3747	7509	49.9%	12.31%	9	9
14	臺東縣關山鎮	2018-11-24T23:51:36+08:00	924	2596	3520	227	3747	7509	49.9%	12.31%	9	9
14	臺東縣關山鎮	2018-11-24T22:30:09+08:00	924	2596	3520	227	3747	7509	49.9%	12.31%	9	9
14	臺東縣關山鎮	2018-11-24T22:40:28+08:00	924	2596	3520	227	3747	7509	49.9%	12.31%	9	9
14	臺東縣關山鎮	2018-11-24T22:23:13+08:00	924	2596	3520	227	3747	7509	49.9%	12.31%	9	9
14	臺東縣關山鎮	2018-11-25T00:09:35+08:00	924	2596	3520	227	3747	7509	49.9%	12.31%	9	9
14	臺東縣關山鎮	2018-11-24T23:35:11+08:00	924	2596	3520	227	3747	7509	49.9%	12.31%	9	9
14	臺東縣關山鎮	2018-11-24T23:01:31+08:00	924	2596	3520	227	3747	7509	49.9%	12.31%	9	9
14	臺東縣關山鎮	2018-11-24T22:45:09+08:00	924	2596	3520	227	3747	7509	49.9%	12.31%	9	9
14	臺東縣關山鎮	2018-11-24T22:54:26+08:00	924	2596	3520	227	3747	7509	49.9%	12.31%	9	9
14	臺東縣關山鎮	2018-11-25T00:14:10+08:00	924	2596	3520	227	3747	7509	49.9%	12.31%	9	9
14	臺東縣關山鎮	2018-11-25T03:56:13+08:00	924	2596	3520	227	3747	7509	49.9%	12.31%	9	9
14	臺東縣關山鎮	2018-11-25T03:49:51+08:00	924	2596	3520	227	3747	7509	49.9%	12.31%	9	9
14	臺東縣關山鎮	2018-11-24T23:16:03+08:00	924	2596	3520	227	3747	7509	49.9%	12.31%	9	9
14	臺東縣關山鎮	2018-11-25T03:32:35+08:00	924	2596	3520	227	3747	7509	49.9%	12.31%	9	9
14	臺東縣關山鎮	2018-11-25T06:24:00+08:00	924	2596	3520	227	3747	7509	49.9%	12.31%	9	9
14	臺東縣關山鎮	2018-11-25T01:25:53+08:00	924	2596	3520	227	3747	7509	49.9%	12.31%	9	9
14	臺東縣關山鎮	2018-11-25T00:23:04+08:00	924	2596	3520	227	3747	7509	49.9%	12.31%	9	9
14	臺東縣關山鎮	2018-11-24T23:27:19+08:00	924	2596	3520	227	3747	7509	49.9%	12.31%	9	9
14	臺東縣關山鎮	2018-11-25T00:57:37+08:00	924	2596	3520	227	3747	7509	49.9%	12.31%	9	9
14	臺東縣關山鎮	2018-11-24T22:57:54+08:00	924	2596	3520	227	3747	7509	49.9%	12.31%	9	9
14	臺東縣關山鎮	2018-11-25T01:17:53+08:00	924	2596	3520	227	3747	7509	49.9%	12.31%	9	9
14	臺東縣關山鎮	2018-11-24T22:19:37+08:00	924	2596	3520	227	3747	7509	49.9%	12.31%	9	9
14	臺東縣關山鎮	2018-11-24T23:19:52+08:00	924	2596	3520	227	3747	7509	49.9%	12.31%	9	9
14	臺東縣關山鎮	2018-11-24T22:41:35+08:00	924	2596	3520	227	3747	7509	49.9%	12.31%	9	9
14	臺東縣關山鎮	2018-11-25T00:05:05+08:00	924	2596	3520	227	3747	7509	49.9%	12.31%	9	9
14	臺東縣關山鎮	2018-11-25T04:02:52+08:00	924	2596	3520	227	3747	7509	49.9%	12.31%	9	9
14	臺東縣關山鎮	2018-11-24T23:12:16+08:00	924	2596	3520	227	3747	7509	49.9%	12.31%	9	9
14	臺東縣關山鎮	2018-11-25T06:08:53+08:00	924	2596	3520	227	3747	7509	49.9%	12.31%	9	9
14	臺東縣關山鎮	2018-11-25T01:12:44+08:00	924	2596	3520	227	3747	7509	49.9%	12.31%	9	9
14	臺東縣關山鎮	2018-11-24T22:26:37+08:00	924	2596	3520	227	3747	7509	49.9%	12.31%	9	9
14	臺東縣關山鎮	2018-11-24T23:05:05+08:00	924	2596	3520	227	3747	7509	49.9%	12.31%	9	9
14	臺東縣關山鎮	2018-11-24T22:50:48+08:00	924	2596	3520	227	3747	7509	49.9%	12.31%	9	9
14	臺東縣關山鎮	2018-11-24T23:31:12+08:00	924	2596	3520	227	3747	7509	49.9%	12.31%	9	9
14	臺東縣關山鎮	2018-11-24T22:16:11+08:00	924	2596	3520	227	3747	7509	49.9%	12.31%	9	9
14	臺東縣關山鎮	2018-11-24T23:39:16+08:00	924	2596	3520	227	3747	7509	49.9%	12.31%	9	9
14	臺東縣延平鄉	2018-11-25T03:49:52+08:00	352	1135	1487	117	1604	2930	54.74%	12.01%	5	5
14	臺東縣延平鄉	2018-11-24T23:47:29+08:00	352	1135	1487	117	1604	2930	54.74%	12.01%	5	5
14	臺東縣延平鄉	2018-11-25T06:29:18+08:00	352	1135	1487	117	1604	2930	54.74%	12.01%	5	5
14	臺東縣延平鄉	2018-11-24T22:33:38+08:00	97	352	449	35	484	911	53.13%	10.65%	2	5
14	臺東縣延平鄉	2018-11-25T01:07:27+08:00	352	1135	1487	117	1604	2930	54.74%	12.01%	5	5
14	臺東縣延平鄉	2018-11-25T06:13:53+08:00	352	1135	1487	117	1604	2930	54.74%	12.01%	5	5
14	臺東縣延平鄉	2018-11-24T23:43:17+08:00	352	1135	1487	117	1604	2930	54.74%	12.01%	5	5
14	臺東縣延平鄉	2018-11-25T00:18:31+08:00	352	1135	1487	117	1604	2930	54.74%	12.01%	5	5
14	臺東縣延平鄉	2018-11-24T22:37:01+08:00	162	547	709	50	759	1490	50.94%	10.87%	3	5
14	臺東縣延平鄉	2018-11-25T03:44:24+08:00	352	1135	1487	117	1604	2930	54.74%	12.01%	5	5
14	臺東縣延平鄉	2018-11-24T23:08:37+08:00	352	1135	1487	117	1604	2930	54.74%	12.01%	5	5
14	臺東縣延平鄉	2018-11-24T23:55:48+08:00	352	1135	1487	117	1604	2930	54.74%	12.01%	5	5
14	臺東縣延平鄉	2018-11-24T22:13:28+08:00	97	352	449	35	484	911	53.13%	10.65%	2	5
14	臺東縣延平鄉	2018-11-24T23:23:39+08:00	352	1135	1487	117	1604	2930	54.74%	12.01%	5	5
14	臺東縣延平鄉	2018-11-25T06:18:58+08:00	352	1135	1487	117	1604	2930	54.74%	12.01%	5	5
14	臺東縣延平鄉	2018-11-25T00:00:11+08:00	352	1135	1487	117	1604	2930	54.74%	12.01%	5	5
14	臺東縣延平鄉	2018-11-24T23:51:36+08:00	352	1135	1487	117	1604	2930	54.74%	12.01%	5	5
14	臺東縣延平鄉	2018-11-24T22:23:14+08:00	97	352	449	35	484	911	53.13%	10.65%	2	5
14	臺東縣延平鄉	2018-11-24T22:40:28+08:00	162	547	709	50	759	1490	50.94%	10.87%	3	5
14	臺東縣延平鄉	2018-11-25T00:09:35+08:00	352	1135	1487	117	1604	2930	54.74%	12.01%	5	5
14	臺東縣延平鄉	2018-11-25T00:05:06+08:00	352	1135	1487	117	1604	2930	54.74%	12.01%	5	5
14	臺東縣延平鄉	2018-11-24T23:35:11+08:00	352	1135	1487	117	1604	2930	54.74%	12.01%	5	5
14	臺東縣延平鄉	2018-11-24T22:41:36+08:00	162	547	709	50	759	1490	50.94%	10.87%	3	5
14	臺東縣延平鄉	2018-11-24T23:01:31+08:00	352	1135	1487	117	1604	2930	54.74%	12.01%	5	5
14	臺東縣延平鄉	2018-11-24T22:45:09+08:00	162	547	709	50	759	1490	50.94%	10.87%	3	5
14	臺東縣延平鄉	2018-11-24T22:54:26+08:00	294	933	1227	79	1306	2504	52.16%	11.74%	4	5
14	臺東縣延平鄉	2018-11-25T00:14:10+08:00	352	1135	1487	117	1604	2930	54.74%	12.01%	5	5
14	臺東縣延平鄉	2018-11-25T03:56:13+08:00	352	1135	1487	117	1604	2930	54.74%	12.01%	5	5
14	臺東縣延平鄉	2018-11-24T23:16:03+08:00	352	1135	1487	117	1604	2930	54.74%	12.01%	5	5
14	臺東縣延平鄉	2018-11-25T03:32:35+08:00	352	1135	1487	117	1604	2930	54.74%	12.01%	5	5
14	臺東縣延平鄉	2018-11-25T01:25:53+08:00	352	1135	1487	117	1604	2930	54.74%	12.01%	5	5
14	臺東縣延平鄉	2018-11-25T01:02:32+08:00	352	1135	1487	117	1604	2930	54.74%	12.01%	5	5
14	臺東縣延平鄉	2018-11-24T22:30:10+08:00	97	352	449	35	484	911	53.13%	10.65%	2	5
14	臺東縣延平鄉	2018-11-25T00:23:04+08:00	352	1135	1487	117	1604	2930	54.74%	12.01%	5	5
14	臺東縣延平鄉	2018-11-25T06:24:01+08:00	352	1135	1487	117	1604	2930	54.74%	12.01%	5	5
14	臺東縣延平鄉	2018-11-25T03:38:56+08:00	352	1135	1487	117	1604	2930	54.74%	12.01%	5	5
14	臺東縣延平鄉	2018-11-24T23:27:19+08:00	352	1135	1487	117	1604	2930	54.74%	12.01%	5	5
14	臺東縣延平鄉	2018-11-24T22:19:38+08:00	97	352	449	35	484	911	53.13%	10.65%	2	5
14	臺東縣延平鄉	2018-11-25T00:57:37+08:00	352	1135	1487	117	1604	2930	54.74%	12.01%	5	5
14	臺東縣延平鄉	2018-11-24T22:57:54+08:00	352	1135	1487	117	1604	2930	54.74%	12.01%	5	5
14	臺東縣延平鄉	2018-11-25T01:17:53+08:00	352	1135	1487	117	1604	2930	54.74%	12.01%	5	5
14	臺東縣延平鄉	2018-11-24T23:19:52+08:00	352	1135	1487	117	1604	2930	54.74%	12.01%	5	5
14	臺東縣延平鄉	2018-11-25T06:08:54+08:00	352	1135	1487	117	1604	2930	54.74%	12.01%	5	5
14	臺東縣延平鄉	2018-11-24T23:12:16+08:00	352	1135	1487	117	1604	2930	54.74%	12.01%	5	5
14	臺東縣延平鄉	2018-11-24T23:39:17+08:00	352	1135	1487	117	1604	2930	54.74%	12.01%	5	5
14	臺東縣延平鄉	2018-11-25T01:12:44+08:00	352	1135	1487	117	1604	2930	54.74%	12.01%	5	5
14	臺東縣延平鄉	2018-11-24T22:50:49+08:00	294	933	1227	79	1306	2504	52.16%	11.74%	4	5
14	臺東縣延平鄉	2018-11-24T22:26:37+08:00	97	352	449	35	484	911	53.13%	10.65%	2	5
14	臺東縣延平鄉	2018-11-25T04:02:53+08:00	352	1135	1487	117	1604	2930	54.74%	12.01%	5	5
14	臺東縣延平鄉	2018-11-24T23:05:05+08:00	352	1135	1487	117	1604	2930	54.74%	12.01%	5	5
14	臺東縣延平鄉	2018-11-24T23:31:12+08:00	352	1135	1487	117	1604	2930	54.74%	12.01%	5	5
14	臺東縣延平鄉	2018-11-24T22:16:11+08:00	97	352	449	35	484	911	53.13%	10.65%	2	5
14	彰化縣	2018-11-25T04:02:44+08:00	169785	406975	576760	37374	614134	1066994	57.56%	15.91%	049	1
14	彰化縣	2018-11-25T00:09:29+08:00	145299	352521	497820	32787	530607	924171	57.41%	15.72%	925	1
14	彰化縣	2018-11-24T22:16:06+08:00	70201	172319	242520	16478	258998	455746	56.83%	15.4%	488	1
14	彰化縣	2018-11-25T01:12:38+08:00	164474	395586	560060	36500	596560	1037898	57.48%	15.85%	023	1
14	彰化縣	2018-11-25T00:14:05+08:00	147400	357611	505011	33237	538248	937662	57.4%	15.72%	936	1
14	彰化縣	2018-11-25T00:00:03+08:00	142367	345797	488164	32227	520391	906718	57.39%	15.7%	911	1
14	彰化縣	2018-11-24T22:23:08+08:00	75090	184312	259402	17541	276943	486014	56.98%	15.45%	517	1
14	彰化縣	2018-11-25T00:23:00+08:00	151463	366915	518378	34061	552439	962216	57.41%	15.74%	956	1
14	彰化縣	2018-11-24T23:08:31+08:00	110208	269742	379950	25491	405441	708183	57.25%	15.56%	729	1
14	彰化縣	2018-11-25T03:32:30+08:00	169785	406975	576760	37374	614134	1066994	57.56%	15.91%	049	1
14	彰化縣	2018-11-24T23:27:14+08:00	125777	305714	431491	28809	460300	802551	57.35%	15.67%	816	1
14	彰化縣	2018-11-24T23:51:31+08:00	138390	336252	474642	31455	506097	881857	57.39%	15.69%	890	1
14	彰化縣	2018-11-24T22:19:33+08:00	72623	178205	250828	16981	267809	470625	56.9%	15.43%	502	1
14	彰化縣	2018-11-25T00:57:32+08:00	163017	392477	555494	36155	591649	1029079	57.49%	15.84%	015	1
14	彰化縣	2018-11-24T22:36:56+08:00	87973	214841	302814	20511	323325	567755	56.95%	15.49%	596	1
14	彰化縣	2018-11-24T22:50:43+08:00	98764	241566	340330	22968	363298	636395	57.09%	15.52%	662	1
14	彰化縣	2018-11-25T06:23:56+08:00	169785	406975	576760	37374	614134	1066994	57.56%	15.91%	049	1
14	彰化縣	2018-11-24T22:26:33+08:00	77649	189377	267026	18057	285083	499969	57.02%	15.53%	530	1
14	彰化縣	2018-11-25T03:49:47+08:00	169785	406975	576760	37374	614134	1066994	57.56%	15.91%	049	1
14	彰化縣	2018-11-24T22:41:31+08:00	91064	222580	313644	21202	334846	587196	57.02%	15.51%	615	1
14	彰化縣	2018-11-25T00:05:01+08:00	144168	349731	493899	32557	526456	917012	57.41%	15.72%	920	1
14	彰化縣	2018-11-25T06:13:48+08:00	169785	406975	576760	37374	614134	1066994	57.56%	15.91%	049	1
14	彰化縣	2018-11-24T23:05:01+08:00	108940	266632	375572	25214	400786	700258	57.23%	15.56%	722	1
14	彰化縣	2018-11-24T23:31:06+08:00	127940	311029	438969	29315	468284	816790	57.33%	15.66%	830	1
14	彰化縣	2018-11-25T06:08:48+08:00	169785	406975	576760	37374	614134	1066994	57.56%	15.91%	049	1
14	彰化縣	2018-11-25T01:07:22+08:00	164113	394528	558641	36418	595059	1035279	57.48%	15.85%	021	1
14	彰化縣	2018-11-24T22:33:34+08:00	85780	209726	295506	20021	315527	553902	56.96%	15.49%	582	1
14	彰化縣	2018-11-24T23:43:13+08:00	134396	326692	461088	30717	491805	857131	57.38%	15.68%	868	1
14	彰化縣	2018-11-24T23:01:27+08:00	107447	262664	370111	24784	394895	690193	57.22%	15.57%	712	1
14	彰化縣	2018-11-24T23:35:06+08:00	130216	316555	446771	29749	476520	830983	57.34%	15.67%	843	1
14	彰化縣	2018-11-25T06:29:12+08:00	169785	406975	576760	37374	614134	1066994	57.56%	15.91%	049	1
14	彰化縣	2018-11-24T23:47:24+08:00	136384	331455	467839	31096	498935	869307	57.39%	15.69%	879	1
14	彰化縣	2018-11-24T23:19:46+08:00	122280	297463	419743	28033	447776	780940	57.34%	15.66%	797	1
14	彰化縣	2018-11-25T03:44:18+08:00	169785	406975	576760	37374	614134	1066994	57.56%	15.91%	049	1
14	彰化縣	2018-11-24T23:23:34+08:00	124455	302592	427047	28552	455599	794620	57.34%	15.66%	809	1
14	彰化縣	2018-11-24T23:55:43+08:00	141569	344027	485596	32075	517671	902080	57.39%	15.69%	907	1
14	彰化縣	2018-11-25T03:38:51+08:00	169785	406975	576760	37374	614134	1066994	57.56%	15.91%	049	1
14	彰化縣	2018-11-24T22:57:49+08:00	105304	257407	362711	24353	387064	677020	57.17%	15.55%	700	1
14	彰化縣	2018-11-24T22:13:22+08:00	66586	164228	230814	15723	246537	434212	56.78%	15.33%	468	1
14	彰化縣	2018-11-25T01:17:47+08:00	164881	396430	561311	36551	597862	1040082	57.48%	15.85%	025	1
14	彰化縣	2018-11-24T22:30:02+08:00	80722	196895	277617	18865	296482	519728	57.05%	15.53%	549	1
14	彰化縣	2018-11-25T01:25:48+08:00	165500	397956	563456	36671	600127	1043601	57.51%	15.86%	028	1
14	彰化縣	2018-11-24T22:40:24+08:00	91064	222580	313644	21202	334846	587196	57.02%	15.51%	615	1
14	彰化縣	2018-11-25T01:02:26+08:00	163192	392960	556152	36194	592346	1030295	57.49%	15.84%	016	1
14	彰化縣	2018-11-24T23:15:59+08:00	119740	292328	412068	27428	439496	766747	57.32%	15.62%	784	1
14	彰化縣	2018-11-25T06:18:53+08:00	169785	406975	576760	37374	614134	1066994	57.56%	15.91%	049	1
14	彰化縣	2018-11-24T23:12:11+08:00	113554	277009	390563	26132	416695	727338	57.29%	15.61%	746	1
14	彰化縣	2018-11-25T00:18:26+08:00	148583	360449	509032	33505	542537	944950	57.41%	15.72%	942	1
14	彰化縣	2018-11-25T03:56:07+08:00	169785	406975	576760	37374	614134	1066994	57.56%	15.91%	049	1
14	彰化縣	2018-11-24T23:39:11+08:00	131637	320166	451803	30090	481893	840137	57.36%	15.67%	852	1
14	彰化縣	2018-11-24T22:45:04+08:00	93708	229170	322878	21899	344777	604651	57.02%	15.5%	632	1
14	彰化縣	2018-11-24T22:54:22+08:00	100882	246935	347817	23353	371170	649827	57.12%	15.52%	675	1
14	臺中市烏日區	2018-11-24T23:35:03+08:00	10429	23671	34100	2151	36251	61705	58.75%	16.9%	40	40
14	臺中市烏日區	2018-11-24T22:33:30+08:00	7309	16408	23717	1537	25254	42589	59.3%	17.16%	29	40
14	臺中市烏日區	2018-11-24T22:16:01+08:00	6512	14535	21047	1377	22424	37846	59.25%	17.21%	26	40
14	臺中市烏日區	2018-11-24T23:31:02+08:00	10429	23671	34100	2151	36251	61705	58.75%	16.9%	40	40
14	臺中市烏日區	2018-11-24T23:01:22+08:00	9205	20725	29930	1862	31792	54084	58.78%	17.02%	36	40
14	臺中市烏日區	2018-11-24T23:12:07+08:00	9205	20725	29930	1862	31792	54084	58.78%	17.02%	36	40
14	臺中市烏日區	2018-11-24T23:47:20+08:00	10429	23671	34100	2151	36251	61705	58.75%	16.9%	40	40
14	臺中市烏日區	2018-11-25T01:07:18+08:00	10429	23671	34100	2151	36251	61705	58.75%	16.9%	40	40
14	臺中市烏日區	2018-11-25T06:08:43+08:00	10429	23671	34100	2151	36251	61705	58.75%	16.9%	40	40
14	臺中市烏日區	2018-11-24T22:57:45+08:00	9205	20725	29930	1862	31792	54084	58.78%	17.02%	36	40
14	臺中市烏日區	2018-11-25T01:17:42+08:00	10429	23671	34100	2151	36251	61705	58.75%	16.9%	40	40
14	臺中市烏日區	2018-11-24T22:13:18+08:00	6252	13843	20095	1293	21388	36024	59.37%	17.36%	25	40
14	臺中市烏日區	2018-11-24T22:19:29+08:00	6785	15158	21943	1441	23384	39393	59.36%	17.22%	27	40
14	臺中市烏日區	2018-11-25T00:57:28+08:00	10429	23671	34100	2151	36251	61705	58.75%	16.9%	40	40
14	臺中市烏日區	2018-11-24T23:23:31+08:00	10161	23025	33186	2073	35259	60131	58.64%	16.9%	39	40
14	臺中市烏日區	2018-11-25T03:44:13+08:00	10429	23671	34100	2151	36251	61705	58.75%	16.9%	40	40
14	臺中市烏日區	2018-11-25T00:04:57+08:00	10429	23671	34100	2151	36251	61705	58.75%	16.9%	40	40
14	臺中市烏日區	2018-11-24T23:04:56+08:00	9205	20725	29930	1862	31792	54084	58.78%	17.02%	36	40
14	臺中市烏日區	2018-11-24T23:15:55+08:00	9205	20725	29930	1862	31792	54084	58.78%	17.02%	36	40
14	臺中市烏日區	2018-11-24T22:40:20+08:00	8329	18740	27069	1719	28788	48768	59.03%	17.08%	33	40
14	臺中市烏日區	2018-11-25T06:18:50+08:00	10429	23671	34100	2151	36251	61705	58.75%	16.9%	40	40
14	臺中市烏日區	2018-11-25T01:25:44+08:00	10429	23671	34100	2151	36251	61705	58.75%	16.9%	40	40
14	臺中市烏日區	2018-11-25T01:02:22+08:00	10429	23671	34100	2151	36251	61705	58.75%	16.9%	40	40
14	臺中市烏日區	2018-11-25T03:38:47+08:00	10429	23671	34100	2151	36251	61705	58.75%	16.9%	40	40
14	臺中市烏日區	2018-11-24T23:55:39+08:00	10429	23671	34100	2151	36251	61705	58.75%	16.9%	40	40
14	臺中市烏日區	2018-11-24T22:54:18+08:00	9205	20725	29930	1862	31792	54084	58.78%	17.02%	36	40
14	臺中市烏日區	2018-11-24T22:45:01+08:00	8329	18740	27069	1719	28788	48768	59.03%	17.08%	33	40
14	臺中市烏日區	2018-11-25T00:18:22+08:00	10429	23671	34100	2151	36251	61705	58.75%	16.9%	40	40
14	臺中市烏日區	2018-11-25T00:22:56+08:00	10429	23671	34100	2151	36251	61705	58.75%	16.9%	40	40
14	臺中市烏日區	2018-11-25T03:56:02+08:00	10429	23671	34100	2151	36251	61705	58.75%	16.9%	40	40
14	臺中市烏日區	2018-11-24T23:39:05+08:00	10429	23671	34100	2151	36251	61705	58.75%	16.9%	40	40
14	臺中市烏日區	2018-11-25T01:12:34+08:00	10429	23671	34100	2151	36251	61705	58.75%	16.9%	40	40
14	臺中市烏日區	2018-11-25T04:02:40+08:00	10429	23671	34100	2151	36251	61705	58.75%	16.9%	40	40
14	臺中市烏日區	2018-11-25T00:09:25+08:00	10429	23671	34100	2151	36251	61705	58.75%	16.9%	40	40
14	臺中市烏日區	2018-11-25T00:14:01+08:00	10429	23671	34100	2151	36251	61705	58.75%	16.9%	40	40
14	臺中市烏日區	2018-11-24T22:41:28+08:00	8329	18740	27069	1719	28788	48768	59.03%	17.08%	33	40
14	臺中市烏日區	2018-11-24T22:50:38+08:00	9205	20725	29930	1862	31792	54084	58.78%	17.02%	36	40
14	臺中市烏日區	2018-11-24T23:51:26+08:00	10429	23671	34100	2151	36251	61705	58.75%	16.9%	40	40
14	臺中市烏日區	2018-11-25T00:00:00+08:00	10429	23671	34100	2151	36251	61705	58.75%	16.9%	40	40
14	臺中市烏日區	2018-11-24T22:23:04+08:00	7309	16408	23717	1537	25254	42589	59.3%	17.16%	29	40
14	臺中市烏日區	2018-11-24T22:29:58+08:00	7309	16408	23717	1537	25254	42589	59.3%	17.16%	29	40
14	臺中市烏日區	2018-11-24T23:19:40+08:00	9552	21473	31025	1921	32946	56145	58.68%	17.01%	37	40
14	臺中市烏日區	2018-11-24T22:36:53+08:00	8047	18057	26104	1680	27784	47077	59.02%	17.09%	32	40
14	臺中市烏日區	2018-11-24T23:27:11+08:00	10161	23025	33186	2073	35259	60131	58.64%	16.9%	39	40
14	臺中市烏日區	2018-11-24T23:08:27+08:00	9205	20725	29930	1862	31792	54084	58.78%	17.02%	36	40
14	臺中市烏日區	2018-11-25T03:32:26+08:00	10429	23671	34100	2151	36251	61705	58.75%	16.9%	40	40
14	臺中市烏日區	2018-11-25T06:29:08+08:00	10429	23671	34100	2151	36251	61705	58.75%	16.9%	40	40
14	臺中市烏日區	2018-11-25T03:49:44+08:00	10429	23671	34100	2151	36251	61705	58.75%	16.9%	40	40
14	臺中市烏日區	2018-11-24T22:26:30+08:00	7309	16408	23717	1537	25254	42589	59.3%	17.16%	29	40
14	臺中市烏日區	2018-11-25T06:23:52+08:00	10429	23671	34100	2151	36251	61705	58.75%	16.9%	40	40
14	臺中市烏日區	2018-11-24T23:43:09+08:00	10429	23671	34100	2151	36251	61705	58.75%	16.9%	40	40
14	臺中市烏日區	2018-11-25T06:13:45+08:00	10429	23671	34100	2151	36251	61705	58.75%	16.9%	40	40
14	屏東縣泰武鄉	2018-11-24T22:33:37+08:00	541	1625	2166	189	2355	3746	62.87%	14.44%	6	7
14	屏東縣泰武鄉	2018-11-24T22:37:00+08:00	541	1625	2166	189	2355	3746	62.87%	14.44%	6	7
14	屏東縣泰武鄉	2018-11-24T23:43:16+08:00	631	1948	2579	228	2807	4344	64.62%	14.53%	7	7
14	屏東縣泰武鄉	2018-11-25T06:13:52+08:00	631	1948	2579	228	2807	4344	64.62%	14.53%	7	7
14	屏東縣泰武鄉	2018-11-25T03:56:11+08:00	631	1948	2579	228	2807	4344	64.62%	14.53%	7	7
14	屏東縣泰武鄉	2018-11-25T06:29:16+08:00	631	1948	2579	228	2807	4344	64.62%	14.53%	7	7
14	屏東縣泰武鄉	2018-11-24T23:47:27+08:00	631	1948	2579	228	2807	4344	64.62%	14.53%	7	7
14	屏東縣泰武鄉	2018-11-25T03:38:54+08:00	631	1948	2579	228	2807	4344	64.62%	14.53%	7	7
14	屏東縣泰武鄉	2018-11-24T23:55:46+08:00	631	1948	2579	228	2807	4344	64.62%	14.53%	7	7
14	屏東縣泰武鄉	2018-11-25T01:02:30+08:00	631	1948	2579	228	2807	4344	64.62%	14.53%	7	7
14	屏東縣泰武鄉	2018-11-25T03:44:22+08:00	631	1948	2579	228	2807	4344	64.62%	14.53%	7	7
14	屏東縣泰武鄉	2018-11-24T22:13:26+08:00	541	1625	2166	189	2355	3746	62.87%	14.44%	6	7
14	屏東縣泰武鄉	2018-11-24T23:23:37+08:00	631	1948	2579	228	2807	4344	64.62%	14.53%	7	7
14	屏東縣泰武鄉	2018-11-25T06:18:56+08:00	631	1948	2579	228	2807	4344	64.62%	14.53%	7	7
14	屏東縣泰武鄉	2018-11-24T22:23:12+08:00	541	1625	2166	189	2355	3746	62.87%	14.44%	6	7
14	屏東縣泰武鄉	2018-11-24T23:19:50+08:00	631	1948	2579	228	2807	4344	64.62%	14.53%	7	7
14	屏東縣泰武鄉	2018-11-24T22:40:27+08:00	631	1948	2579	228	2807	4344	64.62%	14.53%	7	7
14	屏東縣泰武鄉	2018-11-25T00:00:10+08:00	631	1948	2579	228	2807	4344	64.62%	14.53%	7	7
14	屏東縣泰武鄉	2018-11-25T01:17:51+08:00	631	1948	2579	228	2807	4344	64.62%	14.53%	7	7
14	屏東縣泰武鄉	2018-11-24T22:30:07+08:00	541	1625	2166	189	2355	3746	62.87%	14.44%	6	7
14	屏東縣泰武鄉	2018-11-24T23:12:15+08:00	631	1948	2579	228	2807	4344	64.62%	14.53%	7	7
14	屏東縣泰武鄉	2018-11-24T22:45:08+08:00	631	1948	2579	228	2807	4344	64.62%	14.53%	7	7
14	屏東縣泰武鄉	2018-11-24T23:31:10+08:00	631	1948	2579	228	2807	4344	64.62%	14.53%	7	7
14	屏東縣泰武鄉	2018-11-24T23:01:30+08:00	631	1948	2579	228	2807	4344	64.62%	14.53%	7	7
14	屏東縣泰武鄉	2018-11-25T04:02:51+08:00	631	1948	2579	228	2807	4344	64.62%	14.53%	7	7
14	屏東縣泰武鄉	2018-11-24T23:39:15+08:00	631	1948	2579	228	2807	4344	64.62%	14.53%	7	7
14	屏東縣泰武鄉	2018-11-25T06:23:59+08:00	631	1948	2579	228	2807	4344	64.62%	14.53%	7	7
14	屏東縣泰武鄉	2018-11-25T00:09:33+08:00	631	1948	2579	228	2807	4344	64.62%	14.53%	7	7
14	屏東縣泰武鄉	2018-11-24T23:35:10+08:00	631	1948	2579	228	2807	4344	64.62%	14.53%	7	7
14	屏東縣泰武鄉	2018-11-25T01:07:25+08:00	631	1948	2579	228	2807	4344	64.62%	14.53%	7	7
14	屏東縣泰武鄉	2018-11-24T23:16:02+08:00	631	1948	2579	228	2807	4344	64.62%	14.53%	7	7
14	屏東縣泰武鄉	2018-11-25T03:49:50+08:00	631	1948	2579	228	2807	4344	64.62%	14.53%	7	7
14	屏東縣泰武鄉	2018-11-25T00:14:08+08:00	631	1948	2579	228	2807	4344	64.62%	14.53%	7	7
14	屏東縣泰武鄉	2018-11-25T00:23:03+08:00	631	1948	2579	228	2807	4344	64.62%	14.53%	7	7
14	屏東縣泰武鄉	2018-11-24T23:08:35+08:00	631	1948	2579	228	2807	4344	64.62%	14.53%	7	7
14	屏東縣泰武鄉	2018-11-25T03:32:34+08:00	631	1948	2579	228	2807	4344	64.62%	14.53%	7	7
14	屏東縣泰武鄉	2018-11-25T01:25:52+08:00	631	1948	2579	228	2807	4344	64.62%	14.53%	7	7
14	屏東縣泰武鄉	2018-11-24T22:19:36+08:00	541	1625	2166	189	2355	3746	62.87%	14.44%	6	7
14	屏東縣泰武鄉	2018-11-24T22:57:52+08:00	631	1948	2579	228	2807	4344	64.62%	14.53%	7	7
14	屏東縣泰武鄉	2018-11-25T00:57:36+08:00	631	1948	2579	228	2807	4344	64.62%	14.53%	7	7
14	屏東縣泰武鄉	2018-11-24T23:27:18+08:00	631	1948	2579	228	2807	4344	64.62%	14.53%	7	7
14	屏東縣泰武鄉	2018-11-24T23:51:35+08:00	631	1948	2579	228	2807	4344	64.62%	14.53%	7	7
14	屏東縣泰武鄉	2018-11-24T23:05:04+08:00	631	1948	2579	228	2807	4344	64.62%	14.53%	7	7
14	屏東縣泰武鄉	2018-11-24T22:50:47+08:00	631	1948	2579	228	2807	4344	64.62%	14.53%	7	7
14	屏東縣泰武鄉	2018-11-24T22:16:10+08:00	541	1625	2166	189	2355	3746	62.87%	14.44%	6	7
14	屏東縣泰武鄉	2018-11-25T00:05:04+08:00	631	1948	2579	228	2807	4344	64.62%	14.53%	7	7
14	屏東縣泰武鄉	2018-11-24T22:41:34+08:00	631	1948	2579	228	2807	4344	64.62%	14.53%	7	7
14	屏東縣泰武鄉	2018-11-25T01:12:42+08:00	631	1948	2579	228	2807	4344	64.62%	14.53%	7	7
14	屏東縣泰武鄉	2018-11-24T22:26:36+08:00	541	1625	2166	189	2355	3746	62.87%	14.44%	6	7
14	屏東縣泰武鄉	2018-11-25T00:18:29+08:00	631	1948	2579	228	2807	4344	64.62%	14.53%	7	7
14	屏東縣泰武鄉	2018-11-25T06:08:52+08:00	631	1948	2579	228	2807	4344	64.62%	14.53%	7	7
14	屏東縣泰武鄉	2018-11-24T22:54:25+08:00	631	1948	2579	228	2807	4344	64.62%	14.53%	7	7
14	高雄市仁武區	2018-11-25T04:02:43+08:00	13145	28120	41265	1851	43116	73611	58.57%	17.86%	47	47
14	高雄市仁武區	2018-11-25T06:29:10+08:00	13145	28120	41265	1851	43116	73611	58.57%	17.86%	47	47
14	高雄市仁武區	2018-11-25T00:14:03+08:00	11092	23656	34748	1588	36336	61589	59%	18.01%	40	47
14	高雄市仁武區	2018-11-24T23:01:25+08:00	10135	21257	31392	1465	32857	55570	59.13%	18.24%	37	47
14	高雄市仁武區	2018-11-24T23:12:09+08:00	10135	21257	31392	1465	32857	55570	59.13%	18.24%	37	47
14	高雄市仁武區	2018-11-24T23:43:11+08:00	10722	22894	33616	1541	35157	59597	58.99%	17.99%	39	47
14	高雄市仁武區	2018-11-24T23:39:08+08:00	10722	22894	33616	1541	35157	59597	58.99%	17.99%	39	47
14	高雄市仁武區	2018-11-25T00:09:27+08:00	11092	23656	34748	1588	36336	61589	59%	18.01%	40	47
14	高雄市仁武區	2018-11-25T01:12:36+08:00	12534	26852	39386	1771	41157	70315	58.53%	17.83%	45	47
14	高雄市仁武區	2018-11-24T23:35:05+08:00	10722	22894	33616	1541	35157	59597	58.99%	17.99%	39	47
14	高雄市仁武區	2018-11-25T01:07:20+08:00	12534	26852	39386	1771	41157	70315	58.53%	17.83%	45	47
14	高雄市仁武區	2018-11-24T23:31:04+08:00	10722	22894	33616	1541	35157	59597	58.99%	17.99%	39	47
14	高雄市仁武區	2018-11-25T01:17:45+08:00	12534	26852	39386	1771	41157	70315	58.53%	17.83%	45	47
14	高雄市仁武區	2018-11-25T03:44:15+08:00	13145	28120	41265	1851	43116	73611	58.57%	17.86%	47	47
14	高雄市仁武區	2018-11-24T22:13:20+08:00	6839	14784	21623	1109	22732	38395	59.21%	17.81%	27	47
14	高雄市仁武區	2018-11-24T23:55:41+08:00	11092	23656	34748	1588	36336	61589	59%	18.01%	40	47
14	高雄市仁武區	2018-11-24T22:23:06+08:00	7763	17031	24794	1194	25988	43685	59.49%	17.77%	30	47
14	高雄市仁武區	2018-11-24T23:19:43+08:00	10722	22894	33616	1541	35157	59597	58.99%	17.99%	39	47
14	高雄市仁武區	2018-11-24T23:04:58+08:00	10135	21257	31392	1465	32857	55570	59.13%	18.24%	37	47
14	高雄市仁武區	2018-11-25T00:00:02+08:00	11092	23656	34748	1588	36336	61589	59%	18.01%	40	47
14	高雄市仁武區	2018-11-25T00:04:59+08:00	11092	23656	34748	1588	36336	61589	59%	18.01%	40	47
14	高雄市仁武區	2018-11-25T01:02:24+08:00	12534	26852	39386	1771	41157	70315	58.53%	17.83%	45	47
14	高雄市仁武區	2018-11-24T23:27:13+08:00	10722	22894	33616	1541	35157	59597	58.99%	17.99%	39	47
14	高雄市仁武區	2018-11-25T03:38:49+08:00	13145	28120	41265	1851	43116	73611	58.57%	17.86%	47	47
14	高雄市仁武區	2018-11-24T22:30:00+08:00	8572	17870	26442	1264	27706	46572	59.49%	18.41%	32	47
14	高雄市仁武區	2018-11-25T06:13:47+08:00	13145	28120	41265	1851	43116	73611	58.57%	17.86%	47	47
14	高雄市仁武區	2018-11-24T22:54:20+08:00	9798	20469	30267	1416	31683	53747	58.95%	18.23%	36	47
14	高雄市仁武區	2018-11-25T00:22:58+08:00	11850	25284	37134	1673	38807	65776	59%	18.02%	42	47
14	高雄市仁武區	2018-11-25T03:56:05+08:00	13145	28120	41265	1851	43116	73611	58.57%	17.86%	47	47
14	高雄市仁武區	2018-11-25T00:18:24+08:00	11850	25284	37134	1673	38807	65776	59%	18.02%	42	47
14	高雄市仁武區	2018-11-25T06:08:46+08:00	13145	28120	41265	1851	43116	73611	58.57%	17.86%	47	47
14	高雄市仁武區	2018-11-24T23:47:22+08:00	10722	22894	33616	1541	35157	59597	58.99%	17.99%	39	47
14	高雄市仁武區	2018-11-24T22:41:29+08:00	9496	19813	29309	1363	30672	51870	59.13%	18.31%	35	47
14	高雄市仁武區	2018-11-24T22:16:04+08:00	7170	15613	22783	1137	23920	40310	59.34%	17.79%	28	47
14	高雄市仁武區	2018-11-24T22:33:32+08:00	9152	19028	28180	1324	29504	49703	59.36%	18.41%	34	47
14	高雄市仁武區	2018-11-24T23:23:33+08:00	10722	22894	33616	1541	35157	59597	58.99%	17.99%	39	47
14	高雄市仁武區	2018-11-24T23:51:29+08:00	10722	22894	33616	1541	35157	59597	58.99%	17.99%	39	47
14	高雄市仁武區	2018-11-24T22:57:47+08:00	9798	20469	30267	1416	31683	53747	58.95%	18.23%	36	47
14	高雄市仁武區	2018-11-24T22:19:31+08:00	7763	17031	24794	1194	25988	43685	59.49%	17.77%	30	47
14	高雄市仁武區	2018-11-25T00:57:30+08:00	12534	26852	39386	1771	41157	70315	58.53%	17.83%	45	47
14	高雄市仁武區	2018-11-25T03:32:29+08:00	13145	28120	41265	1851	43116	73611	58.57%	17.86%	47	47
14	高雄市仁武區	2018-11-25T06:18:52+08:00	13145	28120	41265	1851	43116	73611	58.57%	17.86%	47	47
14	高雄市仁武區	2018-11-24T22:40:22+08:00	9496	19813	29309	1363	30672	51870	59.13%	18.31%	35	47
14	高雄市仁武區	2018-11-25T01:25:47+08:00	12779	27337	40116	1807	41923	71719	58.45%	17.82%	46	47
14	高雄市仁武區	2018-11-24T22:36:55+08:00	9496	19813	29309	1363	30672	51870	59.13%	18.31%	35	47
14	高雄市仁武區	2018-11-24T23:08:29+08:00	10135	21257	31392	1465	32857	55570	59.13%	18.24%	37	47
14	高雄市仁武區	2018-11-24T23:15:57+08:00	10722	22894	33616	1541	35157	59597	58.99%	17.99%	39	47
14	高雄市仁武區	2018-11-25T03:49:45+08:00	13145	28120	41265	1851	43116	73611	58.57%	17.86%	47	47
14	高雄市仁武區	2018-11-25T06:23:54+08:00	13145	28120	41265	1851	43116	73611	58.57%	17.86%	47	47
14	高雄市仁武區	2018-11-24T22:26:31+08:00	7763	17031	24794	1194	25988	43685	59.49%	17.77%	30	47
14	高雄市仁武區	2018-11-24T22:50:41+08:00	9798	20469	30267	1416	31683	53747	58.95%	18.23%	36	47
14	高雄市仁武區	2018-11-24T22:45:03+08:00	9496	19813	29309	1363	30672	51870	59.13%	18.31%	35	47
14	高雄市前金區	2018-11-25T06:29:10+08:00	4649	9216	13865	685	14550	23928	60.81%	19.43%	22	22
14	高雄市前金區	2018-11-24T23:35:04+08:00	4304	8534	12838	650	13488	22147	60.9%	19.43%	21	22
14	高雄市前金區	2018-11-25T00:14:03+08:00	4649	9216	13865	685	14550	23928	60.81%	19.43%	22	22
14	高雄市前金區	2018-11-24T23:12:09+08:00	4304	8534	12838	650	13488	22147	60.9%	19.43%	21	22
14	高雄市前金區	2018-11-25T06:08:45+08:00	4649	9216	13865	685	14550	23928	60.81%	19.43%	22	22
14	高雄市前金區	2018-11-24T23:43:11+08:00	4304	8534	12838	650	13488	22147	60.9%	19.43%	21	22
14	高雄市前金區	2018-11-25T00:09:27+08:00	4649	9216	13865	685	14550	23928	60.81%	19.43%	22	22
14	高雄市前金區	2018-11-24T22:33:31+08:00	3731	7454	11185	588	11773	19244	61.18%	19.39%	19	22
14	高雄市前金區	2018-11-25T01:12:36+08:00	4649	9216	13865	685	14550	23928	60.81%	19.43%	22	22
14	高雄市前金區	2018-11-25T04:02:42+08:00	4649	9216	13865	685	14550	23928	60.81%	19.43%	22	22
14	高雄市前金區	2018-11-25T01:07:20+08:00	4649	9216	13865	685	14550	23928	60.81%	19.43%	22	22
14	高雄市前金區	2018-11-24T23:39:07+08:00	4304	8534	12838	650	13488	22147	60.9%	19.43%	21	22
14	高雄市前金區	2018-11-24T23:31:03+08:00	4304	8534	12838	650	13488	22147	60.9%	19.43%	21	22
14	高雄市前金區	2018-11-24T23:01:24+08:00	4304	8534	12838	650	13488	22147	60.9%	19.43%	21	22
14	高雄市前金區	2018-11-25T03:44:15+08:00	4649	9216	13865	685	14550	23928	60.81%	19.43%	22	22
14	高雄市前金區	2018-11-24T23:19:42+08:00	4304	8534	12838	650	13488	22147	60.9%	19.43%	21	22
14	高雄市前金區	2018-11-24T22:13:20+08:00	3436	6827	10263	561	10824	17570	61.61%	19.56%	18	22
14	高雄市前金區	2018-11-25T00:04:58+08:00	4649	9216	13865	685	14550	23928	60.81%	19.43%	22	22
14	高雄市前金區	2018-11-24T23:55:41+08:00	4649	9216	13865	685	14550	23928	60.81%	19.43%	22	22
14	高雄市前金區	2018-11-24T22:23:06+08:00	3731	7454	11185	588	11773	19244	61.18%	19.39%	19	22
14	高雄市前金區	2018-11-25T01:17:44+08:00	4649	9216	13865	685	14550	23928	60.81%	19.43%	22	22
14	高雄市前金區	2018-11-24T23:04:58+08:00	4304	8534	12838	650	13488	22147	60.9%	19.43%	21	22
14	高雄市前金區	2018-11-25T06:18:51+08:00	4649	9216	13865	685	14550	23928	60.81%	19.43%	22	22
14	高雄市前金區	2018-11-25T01:02:24+08:00	4649	9216	13865	685	14550	23928	60.81%	19.43%	22	22
14	高雄市前金區	2018-11-25T03:38:49+08:00	4649	9216	13865	685	14550	23928	60.81%	19.43%	22	22
14	高雄市前金區	2018-11-24T23:27:12+08:00	4304	8534	12838	650	13488	22147	60.9%	19.43%	21	22
14	高雄市前金區	2018-11-24T22:54:20+08:00	3731	7454	11185	588	11773	19244	61.18%	19.39%	19	22
14	高雄市前金區	2018-11-25T03:56:05+08:00	4649	9216	13865	685	14550	23928	60.81%	19.43%	22	22
14	高雄市前金區	2018-11-25T00:18:23+08:00	4649	9216	13865	685	14550	23928	60.81%	19.43%	22	22
14	高雄市前金區	2018-11-25T06:13:46+08:00	4649	9216	13865	685	14550	23928	60.81%	19.43%	22	22
14	高雄市前金區	2018-11-25T00:22:57+08:00	4649	9216	13865	685	14550	23928	60.81%	19.43%	22	22
14	高雄市前金區	2018-11-24T23:47:22+08:00	4649	9216	13865	685	14550	23928	60.81%	19.43%	22	22
14	高雄市前金區	2018-11-24T22:41:29+08:00	3731	7454	11185	588	11773	19244	61.18%	19.39%	19	22
14	高雄市前金區	2018-11-24T22:16:03+08:00	3436	6827	10263	561	10824	17570	61.61%	19.56%	18	22
14	高雄市前金區	2018-11-24T22:29:59+08:00	3731	7454	11185	588	11773	19244	61.18%	19.39%	19	22
14	高雄市前金區	2018-11-24T23:23:32+08:00	4304	8534	12838	650	13488	22147	60.9%	19.43%	21	22
14	高雄市前金區	2018-11-24T23:51:28+08:00	4649	9216	13865	685	14550	23928	60.81%	19.43%	22	22
14	高雄市前金區	2018-11-24T22:57:46+08:00	3946	7868	11814	602	12416	20341	61.04%	19.4%	20	22
14	高雄市前金區	2018-11-25T00:00:01+08:00	4649	9216	13865	685	14550	23928	60.81%	19.43%	22	22
14	高雄市前金區	2018-11-25T01:25:46+08:00	4649	9216	13865	685	14550	23928	60.81%	19.43%	22	22
14	高雄市前金區	2018-11-24T22:19:31+08:00	3731	7454	11185	588	11773	19244	61.18%	19.39%	19	22
14	高雄市前金區	2018-11-25T00:57:30+08:00	4649	9216	13865	685	14550	23928	60.81%	19.43%	22	22
14	高雄市前金區	2018-11-24T22:40:22+08:00	3731	7454	11185	588	11773	19244	61.18%	19.39%	19	22
14	高雄市前金區	2018-11-24T22:36:55+08:00	3731	7454	11185	588	11773	19244	61.18%	19.39%	19	22
14	高雄市前金區	2018-11-24T23:08:29+08:00	4304	8534	12838	650	13488	22147	60.9%	19.43%	21	22
14	高雄市前金區	2018-11-24T23:15:57+08:00	4304	8534	12838	650	13488	22147	60.9%	19.43%	21	22
14	高雄市前金區	2018-11-25T03:32:28+08:00	4649	9216	13865	685	14550	23928	60.81%	19.43%	22	22
14	高雄市前金區	2018-11-24T22:45:02+08:00	3731	7454	11185	588	11773	19244	61.18%	19.39%	19	22
14	高雄市前金區	2018-11-25T03:49:45+08:00	4649	9216	13865	685	14550	23928	60.81%	19.43%	22	22
14	高雄市前金區	2018-11-25T06:23:54+08:00	4649	9216	13865	685	14550	23928	60.81%	19.43%	22	22
14	高雄市前金區	2018-11-24T22:26:31+08:00	3731	7454	11185	588	11773	19244	61.18%	19.39%	19	22
14	高雄市前金區	2018-11-24T22:50:41+08:00	3731	7454	11185	588	11773	19244	61.18%	19.39%	19	22
14	苗栗縣竹南鎮	2018-11-25T04:02:44+08:00	11195	25219	36414	1980	38394	68528	56.03%	16.34%	61	61
14	苗栗縣竹南鎮	2018-11-24T23:31:05+08:00	10505	23914	34419	1895	36314	64455	56.34%	16.3%	58	61
14	苗栗縣竹南鎮	2018-11-25T00:09:29+08:00	10919	24742	35661	1949	37610	67040	56.1%	16.29%	60	61
14	苗栗縣竹南鎮	2018-11-25T01:12:38+08:00	11195	25219	36414	1980	38394	68528	56.03%	16.34%	61	61
14	苗栗縣竹南鎮	2018-11-25T00:14:05+08:00	10919	24742	35661	1949	37610	67040	56.1%	16.29%	60	61
14	苗栗縣竹南鎮	2018-11-24T23:19:45+08:00	10236	23431	33667	1865	35532	62911	56.48%	16.27%	57	61
14	苗栗縣竹南鎮	2018-11-25T00:00:03+08:00	10919	24742	35661	1949	37610	67040	56.1%	16.29%	60	61
14	苗栗縣竹南鎮	2018-11-24T22:23:08+08:00	6391	14434	20825	1129	21954	38794	56.59%	16.47%	38	61
14	苗栗縣竹南鎮	2018-11-24T23:08:31+08:00	9813	22342	32155	1799	33954	60048	56.54%	16.34%	55	61
14	苗栗縣竹南鎮	2018-11-25T03:32:30+08:00	11195	25219	36414	1980	38394	68528	56.03%	16.34%	61	61
14	苗栗縣竹南鎮	2018-11-24T23:51:30+08:00	10919	24742	35661	1949	37610	67040	56.1%	16.29%	60	61
14	苗栗縣竹南鎮	2018-11-24T22:30:01+08:00	7198	16249	23447	1273	24720	43626	56.66%	16.5%	42	61
14	苗栗縣竹南鎮	2018-11-24T23:27:14+08:00	10236	23431	33667	1865	35532	62911	56.48%	16.27%	57	61
14	苗栗縣竹南鎮	2018-11-24T22:19:32+08:00	6177	13984	20161	1097	21258	37640	56.48%	16.41%	37	61
14	苗栗縣竹南鎮	2018-11-25T00:57:32+08:00	10919	24742	35661	1949	37610	67040	56.1%	16.29%	60	61
14	苗栗縣竹南鎮	2018-11-24T22:36:56+08:00	7792	17676	25468	1417	26885	47436	56.68%	16.43%	45	61
14	苗栗縣竹南鎮	2018-11-25T00:18:25+08:00	10919	24742	35661	1949	37610	67040	56.1%	16.29%	60	61
14	苗栗縣竹南鎮	2018-11-25T06:23:56+08:00	11195	25219	36414	1980	38394	68528	56.03%	16.34%	61	61
14	苗栗縣竹南鎮	2018-11-24T23:05:00+08:00	9604	21916	31520	1761	33281	58929	56.48%	16.3%	54	61
14	苗栗縣竹南鎮	2018-11-25T03:49:47+08:00	11195	25219	36414	1980	38394	68528	56.03%	16.34%	61	61
14	苗栗縣竹南鎮	2018-11-24T22:41:31+08:00	7924	18062	25986	1450	27436	48602	56.45%	16.3%	46	61
14	苗栗縣竹南鎮	2018-11-24T22:26:32+08:00	6608	14883	21491	1163	22654	40116	56.47%	16.47%	39	61
14	苗栗縣竹南鎮	2018-11-25T06:13:48+08:00	11195	25219	36414	1980	38394	68528	56.03%	16.34%	61	61
14	苗栗縣竹南鎮	2018-11-24T22:50:42+08:00	8528	19544	28072	1559	29631	52227	56.74%	16.33%	49	61
14	苗栗縣竹南鎮	2018-11-24T22:54:21+08:00	8528	19544	28072	1559	29631	52227	56.74%	16.33%	49	61
14	苗栗縣竹南鎮	2018-11-25T00:05:00+08:00	10919	24742	35661	1949	37610	67040	56.1%	16.29%	60	61
14	苗栗縣竹南鎮	2018-11-25T00:22:59+08:00	10919	24742	35661	1949	37610	67040	56.1%	16.29%	60	61
14	苗栗縣竹南鎮	2018-11-24T22:16:05+08:00	5931	13353	19284	1030	20314	36066	56.32%	16.44%	35	61
14	苗栗縣竹南鎮	2018-11-24T23:01:26+08:00	9410	21434	30844	1720	32564	57793	56.35%	16.28%	53	61
14	苗栗縣竹南鎮	2018-11-25T01:07:22+08:00	11195	25219	36414	1980	38394	68528	56.03%	16.34%	61	61
14	苗栗縣竹南鎮	2018-11-24T22:33:33+08:00	7549	17113	24662	1389	26051	45983	56.65%	16.42%	44	61
14	苗栗縣竹南鎮	2018-11-24T23:43:13+08:00	10755	24468	35223	1922	37145	65967	56.31%	16.3%	59	61
14	苗栗縣竹南鎮	2018-11-25T06:08:47+08:00	11195	25219	36414	1980	38394	68528	56.03%	16.34%	61	61
14	苗栗縣竹南鎮	2018-11-24T23:35:06+08:00	10755	24468	35223	1922	37145	65967	56.31%	16.3%	59	61
14	苗栗縣竹南鎮	2018-11-24T23:47:23+08:00	10755	24468	35223	1922	37145	65967	56.31%	16.3%	59	61
14	苗栗縣竹南鎮	2018-11-25T06:29:12+08:00	11195	25219	36414	1980	38394	68528	56.03%	16.34%	61	61
14	苗栗縣竹南鎮	2018-11-24T23:55:42+08:00	10919	24742	35661	1949	37610	67040	56.1%	16.29%	60	61
14	苗栗縣竹南鎮	2018-11-25T01:17:46+08:00	11195	25219	36414	1980	38394	68528	56.03%	16.34%	61	61
14	苗栗縣竹南鎮	2018-11-24T22:57:48+08:00	9160	20940	30100	1684	31784	56330	56.42%	16.26%	52	61
14	苗栗縣竹南鎮	2018-11-25T03:38:50+08:00	11195	25219	36414	1980	38394	68528	56.03%	16.34%	61	61
14	苗栗縣竹南鎮	2018-11-24T23:23:34+08:00	10236	23431	33667	1865	35532	62911	56.48%	16.27%	57	61
14	苗栗縣竹南鎮	2018-11-24T22:13:22+08:00	5493	12363	17856	971	18827	33372	56.42%	16.46%	33	61
14	苗栗縣竹南鎮	2018-11-25T03:44:17+08:00	11195	25219	36414	1980	38394	68528	56.03%	16.34%	61	61
14	苗栗縣竹南鎮	2018-11-25T01:25:48+08:00	11195	25219	36414	1980	38394	68528	56.03%	16.34%	61	61
14	苗栗縣竹南鎮	2018-11-24T22:40:23+08:00	7924	18062	25986	1450	27436	48602	56.45%	16.3%	46	61
14	苗栗縣竹南鎮	2018-11-24T23:15:58+08:00	10035	22921	32956	1832	34788	61618	56.46%	16.29%	56	61
14	苗栗縣竹南鎮	2018-11-25T01:02:26+08:00	11195	25219	36414	1980	38394	68528	56.03%	16.34%	61	61
14	苗栗縣竹南鎮	2018-11-25T06:18:53+08:00	11195	25219	36414	1980	38394	68528	56.03%	16.34%	61	61
14	苗栗縣竹南鎮	2018-11-24T23:12:11+08:00	9813	22342	32155	1799	33954	60048	56.54%	16.34%	55	61
14	苗栗縣竹南鎮	2018-11-24T23:39:10+08:00	10755	24468	35223	1922	37145	65967	56.31%	16.3%	59	61
14	苗栗縣竹南鎮	2018-11-25T03:56:07+08:00	11195	25219	36414	1980	38394	68528	56.03%	16.34%	61	61
14	苗栗縣竹南鎮	2018-11-24T22:45:04+08:00	8152	18577	26729	1496	28225	49943	56.51%	16.32%	47	61
14	苗栗縣西湖鄉	2018-11-25T04:02:44+08:00	927	2377	3304	230	3534	6382	55.37%	14.53%	9	9
14	苗栗縣西湖鄉	2018-11-25T00:09:29+08:00	927	2377	3304	230	3534	6382	55.37%	14.53%	9	9
14	苗栗縣西湖鄉	2018-11-25T01:12:38+08:00	927	2377	3304	230	3534	6382	55.37%	14.53%	9	9
14	苗栗縣西湖鄉	2018-11-25T00:14:05+08:00	927	2377	3304	230	3534	6382	55.37%	14.53%	9	9
14	苗栗縣西湖鄉	2018-11-24T23:19:45+08:00	927	2377	3304	230	3534	6382	55.37%	14.53%	9	9
14	苗栗縣西湖鄉	2018-11-25T00:00:03+08:00	927	2377	3304	230	3534	6382	55.37%	14.53%	9	9
14	苗栗縣西湖鄉	2018-11-24T22:23:08+08:00	927	2377	3304	230	3534	6382	55.37%	14.53%	9	9
14	苗栗縣西湖鄉	2018-11-24T23:08:31+08:00	927	2377	3304	230	3534	6382	55.37%	14.53%	9	9
14	苗栗縣西湖鄉	2018-11-25T03:32:30+08:00	927	2377	3304	230	3534	6382	55.37%	14.53%	9	9
14	苗栗縣西湖鄉	2018-11-24T22:30:01+08:00	927	2377	3304	230	3534	6382	55.37%	14.53%	9	9
14	苗栗縣西湖鄉	2018-11-24T23:27:14+08:00	927	2377	3304	230	3534	6382	55.37%	14.53%	9	9
14	苗栗縣西湖鄉	2018-11-24T23:51:31+08:00	927	2377	3304	230	3534	6382	55.37%	14.53%	9	9
14	苗栗縣西湖鄉	2018-11-24T22:19:33+08:00	927	2377	3304	230	3534	6382	55.37%	14.53%	9	9
14	苗栗縣西湖鄉	2018-11-25T00:57:32+08:00	927	2377	3304	230	3534	6382	55.37%	14.53%	9	9
14	苗栗縣西湖鄉	2018-11-24T22:36:56+08:00	927	2377	3304	230	3534	6382	55.37%	14.53%	9	9
14	苗栗縣西湖鄉	2018-11-24T22:50:43+08:00	927	2377	3304	230	3534	6382	55.37%	14.53%	9	9
14	苗栗縣西湖鄉	2018-11-25T00:18:25+08:00	927	2377	3304	230	3534	6382	55.37%	14.53%	9	9
14	苗栗縣西湖鄉	2018-11-25T06:23:56+08:00	927	2377	3304	230	3534	6382	55.37%	14.53%	9	9
14	苗栗縣西湖鄉	2018-11-24T22:26:33+08:00	927	2377	3304	230	3534	6382	55.37%	14.53%	9	9
14	苗栗縣西湖鄉	2018-11-25T03:49:47+08:00	927	2377	3304	230	3534	6382	55.37%	14.53%	9	9
14	苗栗縣西湖鄉	2018-11-24T22:41:31+08:00	927	2377	3304	230	3534	6382	55.37%	14.53%	9	9
14	苗栗縣西湖鄉	2018-11-25T00:05:01+08:00	927	2377	3304	230	3534	6382	55.37%	14.53%	9	9
14	苗栗縣西湖鄉	2018-11-25T06:13:48+08:00	927	2377	3304	230	3534	6382	55.37%	14.53%	9	9
14	苗栗縣西湖鄉	2018-11-25T00:22:59+08:00	927	2377	3304	230	3534	6382	55.37%	14.53%	9	9
14	苗栗縣西湖鄉	2018-11-24T23:05:01+08:00	927	2377	3304	230	3534	6382	55.37%	14.53%	9	9
14	苗栗縣西湖鄉	2018-11-24T23:31:06+08:00	927	2377	3304	230	3534	6382	55.37%	14.53%	9	9
14	苗栗縣西湖鄉	2018-11-24T22:16:05+08:00	927	2377	3304	230	3534	6382	55.37%	14.53%	9	9
14	苗栗縣西湖鄉	2018-11-25T06:08:48+08:00	927	2377	3304	230	3534	6382	55.37%	14.53%	9	9
14	苗栗縣西湖鄉	2018-11-25T01:07:22+08:00	927	2377	3304	230	3534	6382	55.37%	14.53%	9	9
14	苗栗縣西湖鄉	2018-11-24T22:33:33+08:00	927	2377	3304	230	3534	6382	55.37%	14.53%	9	9
14	苗栗縣西湖鄉	2018-11-24T23:43:13+08:00	927	2377	3304	230	3534	6382	55.37%	14.53%	9	9
14	苗栗縣西湖鄉	2018-11-24T23:01:27+08:00	927	2377	3304	230	3534	6382	55.37%	14.53%	9	9
14	苗栗縣西湖鄉	2018-11-24T23:35:06+08:00	927	2377	3304	230	3534	6382	55.37%	14.53%	9	9
14	苗栗縣西湖鄉	2018-11-25T06:29:12+08:00	927	2377	3304	230	3534	6382	55.37%	14.53%	9	9
14	苗栗縣西湖鄉	2018-11-24T23:47:24+08:00	927	2377	3304	230	3534	6382	55.37%	14.53%	9	9
14	苗栗縣西湖鄉	2018-11-24T23:55:42+08:00	927	2377	3304	230	3534	6382	55.37%	14.53%	9	9
14	苗栗縣西湖鄉	2018-11-24T22:57:48+08:00	927	2377	3304	230	3534	6382	55.37%	14.53%	9	9
14	苗栗縣西湖鄉	2018-11-25T03:44:18+08:00	927	2377	3304	230	3534	6382	55.37%	14.53%	9	9
14	苗栗縣西湖鄉	2018-11-24T23:23:34+08:00	927	2377	3304	230	3534	6382	55.37%	14.53%	9	9
14	苗栗縣西湖鄉	2018-11-25T03:38:51+08:00	927	2377	3304	230	3534	6382	55.37%	14.53%	9	9
14	苗栗縣西湖鄉	2018-11-24T22:13:22+08:00	927	2377	3304	230	3534	6382	55.37%	14.53%	9	9
14	苗栗縣西湖鄉	2018-11-25T01:17:47+08:00	927	2377	3304	230	3534	6382	55.37%	14.53%	9	9
14	苗栗縣西湖鄉	2018-11-25T01:25:48+08:00	927	2377	3304	230	3534	6382	55.37%	14.53%	9	9
14	苗栗縣西湖鄉	2018-11-24T22:40:24+08:00	927	2377	3304	230	3534	6382	55.37%	14.53%	9	9
14	苗栗縣西湖鄉	2018-11-25T01:02:26+08:00	927	2377	3304	230	3534	6382	55.37%	14.53%	9	9
14	苗栗縣西湖鄉	2018-11-24T23:15:59+08:00	927	2377	3304	230	3534	6382	55.37%	14.53%	9	9
14	苗栗縣西湖鄉	2018-11-25T06:18:53+08:00	927	2377	3304	230	3534	6382	55.37%	14.53%	9	9
14	苗栗縣西湖鄉	2018-11-24T23:12:11+08:00	927	2377	3304	230	3534	6382	55.37%	14.53%	9	9
14	苗栗縣西湖鄉	2018-11-24T23:39:10+08:00	927	2377	3304	230	3534	6382	55.37%	14.53%	9	9
14	苗栗縣西湖鄉	2018-11-25T03:56:07+08:00	927	2377	3304	230	3534	6382	55.37%	14.53%	9	9
14	苗栗縣西湖鄉	2018-11-24T22:45:04+08:00	927	2377	3304	230	3534	6382	55.37%	14.53%	9	9
14	苗栗縣西湖鄉	2018-11-24T22:54:22+08:00	927	2377	3304	230	3534	6382	55.37%	14.53%	9	9
14	南投縣草屯鎮	2018-11-25T01:12:39+08:00	13144	32838	45982	2329	48311	82922	58.26%	15.85%	76	76
14	南投縣草屯鎮	2018-11-24T22:16:06+08:00	6025	15059	21084	1095	22179	37661	58.89%	16%	37	76
14	南投縣草屯鎮	2018-11-25T04:02:45+08:00	13144	32838	45982	2329	48311	82922	58.26%	15.85%	76	76
14	南投縣草屯鎮	2018-11-24T22:23:09+08:00	6592	16527	23119	1164	24283	41503	58.51%	15.88%	40	76
14	南投縣草屯鎮	2018-11-25T03:32:31+08:00	13144	32838	45982	2329	48311	82922	58.26%	15.85%	76	76
14	南投縣草屯鎮	2018-11-25T00:00:04+08:00	12894	32262	45156	2290	47446	81599	58.15%	15.8%	75	76
14	南投縣草屯鎮	2018-11-25T03:38:52+08:00	13144	32838	45982	2329	48311	82922	58.26%	15.85%	76	76
14	南投縣草屯鎮	2018-11-25T00:23:00+08:00	12894	32262	45156	2290	47446	81599	58.15%	15.8%	75	76
14	南投縣草屯鎮	2018-11-24T22:36:57+08:00	7752	19279	27031	1365	28396	48517	58.53%	15.98%	46	76
14	南投縣草屯鎮	2018-11-25T00:57:33+08:00	13144	32838	45982	2329	48311	82922	58.26%	15.85%	76	76
14	南投縣草屯鎮	2018-11-24T23:51:31+08:00	12894	32262	45156	2290	47446	81599	58.15%	15.8%	75	76
14	南投縣草屯鎮	2018-11-24T23:27:15+08:00	12634	31760	44394	2263	46657	80272	58.12%	15.74%	74	76
14	南投縣草屯鎮	2018-11-24T22:19:33+08:00	6404	15943	22347	1133	23480	39985	58.72%	16.02%	39	76
14	南投縣草屯鎮	2018-11-24T22:50:44+08:00	8907	22216	31123	1576	32699	55964	58.43%	15.92%	53	76
14	南投縣草屯鎮	2018-11-24T23:12:12+08:00	11674	29350	41024	2065	43089	74057	58.18%	15.76%	69	76
14	南投縣草屯鎮	2018-11-25T06:13:49+08:00	13144	32838	45982	2329	48311	82922	58.26%	15.85%	76	76
14	南投縣草屯鎮	2018-11-24T22:26:33+08:00	6791	16987	23778	1213	24991	42686	58.55%	15.91%	41	76
14	南投縣草屯鎮	2018-11-25T00:05:01+08:00	12894	32262	45156	2290	47446	81599	58.15%	15.8%	75	76
14	南投縣草屯鎮	2018-11-25T06:23:57+08:00	13144	32838	45982	2329	48311	82922	58.26%	15.85%	76	76
14	南投縣草屯鎮	2018-11-25T03:49:48+08:00	13144	32838	45982	2329	48311	82922	58.26%	15.85%	76	76
14	南投縣草屯鎮	2018-11-24T23:05:01+08:00	11129	28013	39142	1980	41122	70561	58.28%	15.77%	66	76
14	南投縣草屯鎮	2018-11-24T23:01:28+08:00	10434	26189	36623	1838	38461	65975	58.3%	15.82%	62	76
14	南投縣草屯鎮	2018-11-24T23:47:25+08:00	12634	31760	44394	2263	46657	80272	58.12%	15.74%	74	76
14	南投縣草屯鎮	2018-11-25T06:29:13+08:00	13144	32838	45982	2329	48311	82922	58.26%	15.85%	76	76
14	南投縣草屯鎮	2018-11-24T23:35:07+08:00	12634	31760	44394	2263	46657	80272	58.12%	15.74%	74	76
14	南投縣草屯鎮	2018-11-24T22:33:34+08:00	7595	18878	26473	1339	27812	47552	58.49%	15.97%	45	76
14	南投縣草屯鎮	2018-11-25T01:07:23+08:00	13144	32838	45982	2329	48311	82922	58.26%	15.85%	76	76
14	南投縣草屯鎮	2018-11-24T23:43:14+08:00	12634	31760	44394	2263	46657	80272	58.12%	15.74%	74	76
14	南投縣草屯鎮	2018-11-24T23:31:07+08:00	12634	31760	44394	2263	46657	80272	58.12%	15.74%	74	76
14	南投縣草屯鎮	2018-11-25T06:08:49+08:00	13144	32838	45982	2329	48311	82922	58.26%	15.85%	76	76
14	南投縣草屯鎮	2018-11-25T00:14:06+08:00	12894	32262	45156	2290	47446	81599	58.15%	15.8%	75	76
14	南投縣草屯鎮	2018-11-24T23:23:35+08:00	12634	31760	44394	2263	46657	80272	58.12%	15.74%	74	76
14	南投縣草屯鎮	2018-11-24T23:19:46+08:00	12634	31760	44394	2263	46657	80272	58.12%	15.74%	74	76
14	南投縣草屯鎮	2018-11-24T22:13:23+08:00	5897	14795	20692	1075	21767	36784	59.18%	16.03%	36	76
14	南投縣草屯鎮	2018-11-25T01:17:48+08:00	13144	32838	45982	2329	48311	82922	58.26%	15.85%	76	76
14	南投縣草屯鎮	2018-11-24T23:55:43+08:00	12894	32262	45156	2290	47446	81599	58.15%	15.8%	75	76
14	南投縣草屯鎮	2018-11-24T23:08:32+08:00	11304	28470	39774	2011	41785	71682	58.29%	15.77%	67	76
14	南投縣草屯鎮	2018-11-24T22:57:49+08:00	10269	25769	36038	1817	37855	64975	58.26%	15.8%	61	76
14	南投縣草屯鎮	2018-11-25T03:44:19+08:00	13144	32838	45982	2329	48311	82922	58.26%	15.85%	76	76
14	南投縣草屯鎮	2018-11-24T22:30:02+08:00	6981	17420	24401	1255	25656	43827	58.54%	15.93%	42	76
14	南投縣草屯鎮	2018-11-25T01:02:27+08:00	13144	32838	45982	2329	48311	82922	58.26%	15.85%	76	76
14	南投縣草屯鎮	2018-11-24T22:40:24+08:00	8097	20199	28296	1444	29740	50852	58.48%	15.92%	48	76
14	南投縣草屯鎮	2018-11-25T01:25:49+08:00	13144	32838	45982	2329	48311	82922	58.26%	15.85%	76	76
14	南投縣草屯鎮	2018-11-24T23:15:59+08:00	12442	31321	43763	2213	45976	78896	58.27%	15.77%	73	76
14	南投縣草屯鎮	2018-11-25T06:18:54+08:00	13144	32838	45982	2329	48311	82922	58.26%	15.85%	76	76
14	南投縣草屯鎮	2018-11-25T03:56:08+08:00	13144	32838	45982	2329	48311	82922	58.26%	15.85%	76	76
14	南投縣草屯鎮	2018-11-24T22:41:32+08:00	8097	20199	28296	1444	29740	50852	58.48%	15.92%	48	76
14	南投縣草屯鎮	2018-11-24T22:45:05+08:00	8249	20577	28826	1472	30298	51784	58.51%	15.93%	49	76
14	南投縣草屯鎮	2018-11-25T00:18:26+08:00	12894	32262	45156	2290	47446	81599	58.15%	15.8%	75	76
14	南投縣草屯鎮	2018-11-24T23:39:11+08:00	12634	31760	44394	2263	46657	80272	58.12%	15.74%	74	76
14	南投縣草屯鎮	2018-11-25T00:09:30+08:00	12894	32262	45156	2290	47446	81599	58.15%	15.8%	75	76
14	南投縣草屯鎮	2018-11-24T22:54:22+08:00	9455	23445	32900	1665	34565	59308	58.28%	15.94%	56	76
14	南投縣仁愛鄉	2018-11-24T23:16:00+08:00	1593	3859	5452	311	5763	10291	56%	15.48%	22	25
14	南投縣仁愛鄉	2018-11-24T22:16:07+08:00	814	3110	3924	239	4163	7558	55.08%	10.77%	18	25
14	南投縣仁愛鄉	2018-11-24T22:23:09+08:00	814	3110	3924	239	4163	7558	55.08%	10.77%	18	25
14	南投縣仁愛鄉	2018-11-25T03:32:31+08:00	1833	4971	6804	375	7179	12589	57.03%	14.56%	25	25
14	南投縣仁愛鄉	2018-11-25T00:23:01+08:00	1781	4657	6438	358	6796	12080	56.26%	14.74%	24	25
14	南投縣仁愛鄉	2018-11-25T03:38:52+08:00	1833	4971	6804	375	7179	12589	57.03%	14.56%	25	25
14	南投縣仁愛鄉	2018-11-24T22:36:57+08:00	1052	3171	4223	245	4468	7967	56.08%	13.2%	19	25
14	南投縣仁愛鄉	2018-11-24T22:57:50+08:00	1534	3615	5149	305	5454	9612	56.74%	15.96%	21	25
14	南投縣仁愛鄉	2018-11-25T00:57:33+08:00	1833	4971	6804	375	7179	12589	57.03%	14.56%	25	25
14	南投縣仁愛鄉	2018-11-24T23:27:15+08:00	1593	3859	5452	311	5763	10291	56%	15.48%	22	25
14	南投縣仁愛鄉	2018-11-24T22:19:34+08:00	814	3110	3924	239	4163	7558	55.08%	10.77%	18	25
14	南投縣仁愛鄉	2018-11-24T22:50:44+08:00	1135	3491	4626	280	4906	8639	56.79%	13.14%	20	25
14	南投縣仁愛鄉	2018-11-24T23:12:12+08:00	1593	3859	5452	311	5763	10291	56%	15.48%	22	25
14	南投縣仁愛鄉	2018-11-24T22:45:06+08:00	1135	3491	4626	280	4906	8639	56.79%	13.14%	20	25
14	南投縣仁愛鄉	2018-11-25T06:13:49+08:00	1833	4971	6804	375	7179	12589	57.03%	14.56%	25	25
14	南投縣仁愛鄉	2018-11-25T01:12:40+08:00	1833	4971	6804	375	7179	12589	57.03%	14.56%	25	25
14	南投縣仁愛鄉	2018-11-24T22:26:34+08:00	814	3110	3924	239	4163	7558	55.08%	10.77%	18	25
14	南投縣仁愛鄉	2018-11-25T06:23:57+08:00	1833	4971	6804	375	7179	12589	57.03%	14.56%	25	25
14	南投縣仁愛鄉	2018-11-24T23:39:12+08:00	1670	4330	6000	341	6341	11180	56.72%	14.94%	23	25
14	南投縣仁愛鄉	2018-11-25T03:49:48+08:00	1833	4971	6804	375	7179	12589	57.03%	14.56%	25	25
14	南投縣仁愛鄉	2018-11-24T23:01:28+08:00	1534	3615	5149	305	5454	9612	56.74%	15.96%	21	25
14	南投縣仁愛鄉	2018-11-25T04:02:47+08:00	1833	4971	6804	375	7179	12589	57.03%	14.56%	25	25
14	南投縣仁愛鄉	2018-11-24T23:47:25+08:00	1670	4330	6000	341	6341	11180	56.72%	14.94%	23	25
14	南投縣仁愛鄉	2018-11-25T06:29:13+08:00	1833	4971	6804	375	7179	12589	57.03%	14.56%	25	25
14	南投縣仁愛鄉	2018-11-24T23:35:07+08:00	1593	3859	5452	311	5763	10291	56%	15.48%	22	25
14	南投縣仁愛鄉	2018-11-25T01:07:23+08:00	1833	4971	6804	375	7179	12589	57.03%	14.56%	25	25
14	南投縣仁愛鄉	2018-11-24T23:43:14+08:00	1670	4330	6000	341	6341	11180	56.72%	14.94%	23	25
14	南投縣仁愛鄉	2018-11-24T23:31:07+08:00	1593	3859	5452	311	5763	10291	56%	15.48%	22	25
14	南投縣仁愛鄉	2018-11-25T06:08:49+08:00	1833	4971	6804	375	7179	12589	57.03%	14.56%	25	25
14	南投縣仁愛鄉	2018-11-24T22:33:35+08:00	814	3110	3924	239	4163	7558	55.08%	10.77%	18	25
14	南投縣仁愛鄉	2018-11-25T00:14:06+08:00	1781	4657	6438	358	6796	12080	56.26%	14.74%	24	25
14	南投縣仁愛鄉	2018-11-24T23:23:35+08:00	1593	3859	5452	311	5763	10291	56%	15.48%	22	25
14	南投縣仁愛鄉	2018-11-24T22:13:23+08:00	718	2693	3411	228	3639	6606	55.09%	10.87%	17	25
14	南投縣仁愛鄉	2018-11-25T01:17:48+08:00	1833	4971	6804	375	7179	12589	57.03%	14.56%	25	25
14	南投縣仁愛鄉	2018-11-24T23:55:44+08:00	1670	4330	6000	341	6341	11180	56.72%	14.94%	23	25
14	南投縣仁愛鄉	2018-11-25T00:00:06+08:00	1670	4330	6000	341	6341	11180	56.72%	14.94%	23	25
14	南投縣仁愛鄉	2018-11-24T23:08:32+08:00	1593	3859	5452	311	5763	10291	56%	15.48%	22	25
14	南投縣仁愛鄉	2018-11-24T23:19:47+08:00	1593	3859	5452	311	5763	10291	56%	15.48%	22	25
14	南投縣仁愛鄉	2018-11-25T03:44:19+08:00	1833	4971	6804	375	7179	12589	57.03%	14.56%	25	25
14	南投縣仁愛鄉	2018-11-25T01:02:27+08:00	1833	4971	6804	375	7179	12589	57.03%	14.56%	25	25
14	南投縣仁愛鄉	2018-11-24T22:40:25+08:00	1135	3491	4626	280	4906	8639	56.79%	13.14%	20	25
14	南投縣仁愛鄉	2018-11-24T22:30:03+08:00	814	3110	3924	239	4163	7558	55.08%	10.77%	18	25
14	南投縣仁愛鄉	2018-11-25T01:25:49+08:00	1833	4971	6804	375	7179	12589	57.03%	14.56%	25	25
14	南投縣仁愛鄉	2018-11-25T06:18:54+08:00	1833	4971	6804	375	7179	12589	57.03%	14.56%	25	25
14	南投縣仁愛鄉	2018-11-24T23:51:32+08:00	1670	4330	6000	341	6341	11180	56.72%	14.94%	23	25
14	南投縣仁愛鄉	2018-11-25T03:56:08+08:00	1833	4971	6804	375	7179	12589	57.03%	14.56%	25	25
14	南投縣仁愛鄉	2018-11-25T00:05:02+08:00	1781	4657	6438	358	6796	12080	56.26%	14.74%	24	25
14	南投縣仁愛鄉	2018-11-24T22:41:32+08:00	1135	3491	4626	280	4906	8639	56.79%	13.14%	20	25
14	南投縣仁愛鄉	2018-11-25T00:09:31+08:00	1781	4657	6438	358	6796	12080	56.26%	14.74%	24	25
14	南投縣仁愛鄉	2018-11-24T22:54:23+08:00	1135	3491	4626	280	4906	8639	56.79%	13.14%	20	25
14	南投縣仁愛鄉	2018-11-24T23:05:02+08:00	1593	3859	5452	311	5763	10291	56%	15.48%	22	25
14	南投縣仁愛鄉	2018-11-25T00:18:27+08:00	1781	4657	6438	358	6796	12080	56.26%	14.74%	24	25
14	屏東縣長治鄉	2018-11-25T03:56:10+08:00	4391	8870	13261	1202	14463	26256	55.08%	16.72%	22	22
14	屏東縣長治鄉	2018-11-24T23:16:01+08:00	4391	8870	13261	1202	14463	26256	55.08%	16.72%	22	22
14	屏東縣長治鄉	2018-11-24T23:43:16+08:00	4391	8870	13261	1202	14463	26256	55.08%	16.72%	22	22
14	屏東縣長治鄉	2018-11-24T22:33:36+08:00	4391	8870	13261	1202	14463	26256	55.08%	16.72%	22	22
14	屏東縣長治鄉	2018-11-24T23:47:27+08:00	4391	8870	13261	1202	14463	26256	55.08%	16.72%	22	22
14	屏東縣長治鄉	2018-11-24T22:16:09+08:00	3433	7785	11218	1002	12220	22195	55.06%	15.47%	19	22
14	屏東縣長治鄉	2018-11-25T03:38:53+08:00	4391	8870	13261	1202	14463	26256	55.08%	16.72%	22	22
14	屏東縣長治鄉	2018-11-25T01:25:51+08:00	4391	8870	13261	1202	14463	26256	55.08%	16.72%	22	22
14	屏東縣長治鄉	2018-11-24T23:23:37+08:00	4391	8870	13261	1202	14463	26256	55.08%	16.72%	22	22
14	屏東縣長治鄉	2018-11-25T06:18:56+08:00	4391	8870	13261	1202	14463	26256	55.08%	16.72%	22	22
14	屏東縣長治鄉	2018-11-24T22:30:06+08:00	4212	8427	12639	1125	13764	25014	55.03%	16.84%	21	22
14	屏東縣長治鄉	2018-11-24T22:19:35+08:00	3433	7785	11218	1002	12220	22195	55.06%	15.47%	19	22
14	屏東縣長治鄉	2018-11-25T01:17:50+08:00	4391	8870	13261	1202	14463	26256	55.08%	16.72%	22	22
14	屏東縣長治鄉	2018-11-24T22:36:59+08:00	4391	8870	13261	1202	14463	26256	55.08%	16.72%	22	22
14	屏東縣長治鄉	2018-11-24T22:40:26+08:00	4391	8870	13261	1202	14463	26256	55.08%	16.72%	22	22
14	屏東縣長治鄉	2018-11-25T00:57:35+08:00	4391	8870	13261	1202	14463	26256	55.08%	16.72%	22	22
14	屏東縣長治鄉	2018-11-25T00:09:32+08:00	4391	8870	13261	1202	14463	26256	55.08%	16.72%	22	22
14	屏東縣長治鄉	2018-11-24T23:39:14+08:00	4391	8870	13261	1202	14463	26256	55.08%	16.72%	22	22
14	屏東縣長治鄉	2018-11-25T04:02:51+08:00	4391	8870	13261	1202	14463	26256	55.08%	16.72%	22	22
14	屏東縣長治鄉	2018-11-24T22:26:35+08:00	3995	8038	12033	1069	13102	23809	55.03%	16.78%	20	22
14	屏東縣長治鄉	2018-11-24T23:12:14+08:00	4391	8870	13261	1202	14463	26256	55.08%	16.72%	22	22
14	屏東縣長治鄉	2018-11-25T06:23:59+08:00	4391	8870	13261	1202	14463	26256	55.08%	16.72%	22	22
14	屏東縣長治鄉	2018-11-24T22:45:07+08:00	4391	8870	13261	1202	14463	26256	55.08%	16.72%	22	22
14	屏東縣長治鄉	2018-11-25T06:08:51+08:00	4391	8870	13261	1202	14463	26256	55.08%	16.72%	22	22
14	屏東縣長治鄉	2018-11-25T01:07:25+08:00	4391	8870	13261	1202	14463	26256	55.08%	16.72%	22	22
14	屏東縣長治鄉	2018-11-25T06:13:51+08:00	4391	8870	13261	1202	14463	26256	55.08%	16.72%	22	22
14	屏東縣長治鄉	2018-11-24T23:35:09+08:00	4391	8870	13261	1202	14463	26256	55.08%	16.72%	22	22
14	屏東縣長治鄉	2018-11-24T23:01:29+08:00	4391	8870	13261	1202	14463	26256	55.08%	16.72%	22	22
14	屏東縣長治鄉	2018-11-24T23:31:09+08:00	4391	8870	13261	1202	14463	26256	55.08%	16.72%	22	22
14	屏東縣長治鄉	2018-11-25T03:49:50+08:00	4391	8870	13261	1202	14463	26256	55.08%	16.72%	22	22
14	屏東縣長治鄉	2018-11-25T00:14:08+08:00	4391	8870	13261	1202	14463	26256	55.08%	16.72%	22	22
14	屏東縣長治鄉	2018-11-25T06:29:15+08:00	4391	8870	13261	1202	14463	26256	55.08%	16.72%	22	22
14	屏東縣長治鄉	2018-11-24T23:55:45+08:00	4391	8870	13261	1202	14463	26256	55.08%	16.72%	22	22
14	屏東縣長治鄉	2018-11-24T23:08:34+08:00	4391	8870	13261	1202	14463	26256	55.08%	16.72%	22	22
14	屏東縣長治鄉	2018-11-25T00:00:09+08:00	4391	8870	13261	1202	14463	26256	55.08%	16.72%	22	22
14	屏東縣長治鄉	2018-11-25T00:23:02+08:00	4391	8870	13261	1202	14463	26256	55.08%	16.72%	22	22
14	屏東縣長治鄉	2018-11-25T03:32:33+08:00	4391	8870	13261	1202	14463	26256	55.08%	16.72%	22	22
14	屏東縣長治鄉	2018-11-25T03:44:21+08:00	4391	8870	13261	1202	14463	26256	55.08%	16.72%	22	22
14	屏東縣長治鄉	2018-11-24T22:13:25+08:00	3147	7236	10383	942	11325	20382	55.56%	15.44%	18	22
14	屏東縣長治鄉	2018-11-24T23:19:49+08:00	4391	8870	13261	1202	14463	26256	55.08%	16.72%	22	22
14	屏東縣長治鄉	2018-11-24T22:23:11+08:00	3433	7785	11218	1002	12220	22195	55.06%	15.47%	19	22
14	屏東縣長治鄉	2018-11-24T23:27:17+08:00	4391	8870	13261	1202	14463	26256	55.08%	16.72%	22	22
14	屏東縣長治鄉	2018-11-25T01:02:29+08:00	4391	8870	13261	1202	14463	26256	55.08%	16.72%	22	22
14	屏東縣長治鄉	2018-11-24T23:51:33+08:00	4391	8870	13261	1202	14463	26256	55.08%	16.72%	22	22
14	屏東縣長治鄉	2018-11-24T22:57:52+08:00	4391	8870	13261	1202	14463	26256	55.08%	16.72%	22	22
14	屏東縣長治鄉	2018-11-24T23:05:03+08:00	4391	8870	13261	1202	14463	26256	55.08%	16.72%	22	22
14	屏東縣長治鄉	2018-11-24T22:54:24+08:00	4391	8870	13261	1202	14463	26256	55.08%	16.72%	22	22
14	屏東縣長治鄉	2018-11-25T00:18:28+08:00	4391	8870	13261	1202	14463	26256	55.08%	16.72%	22	22
14	屏東縣長治鄉	2018-11-24T22:41:33+08:00	4391	8870	13261	1202	14463	26256	55.08%	16.72%	22	22
14	屏東縣長治鄉	2018-11-25T00:05:03+08:00	4391	8870	13261	1202	14463	26256	55.08%	16.72%	22	22
14	屏東縣長治鄉	2018-11-25T01:12:42+08:00	4391	8870	13261	1202	14463	26256	55.08%	16.72%	22	22
14	屏東縣長治鄉	2018-11-24T22:50:46+08:00	4391	8870	13261	1202	14463	26256	55.08%	16.72%	22	22
14	臺南市山上區	2018-11-24T23:35:04+08:00	852	1766	2618	255	2873	6511	44.13%	13.09%	9	9
14	臺南市山上區	2018-11-24T23:47:21+08:00	852	1766	2618	255	2873	6511	44.13%	13.09%	9	9
14	臺南市山上區	2018-11-24T23:39:06+08:00	852	1766	2618	255	2873	6511	44.13%	13.09%	9	9
14	臺南市山上區	2018-11-25T01:07:19+08:00	852	1766	2618	255	2873	6511	44.13%	13.09%	9	9
14	臺南市山上區	2018-11-24T22:33:31+08:00	852	1766	2618	255	2873	6511	44.13%	13.09%	9	9
14	臺南市山上區	2018-11-25T00:14:02+08:00	852	1766	2618	255	2873	6511	44.13%	13.09%	9	9
14	臺南市山上區	2018-11-24T23:43:10+08:00	852	1766	2618	255	2873	6511	44.13%	13.09%	9	9
14	臺南市山上區	2018-11-25T06:08:44+08:00	852	1766	2618	255	2873	6511	44.13%	13.09%	9	9
14	臺南市山上區	2018-11-25T00:09:26+08:00	852	1766	2618	255	2873	6511	44.13%	13.09%	9	9
14	臺南市山上區	2018-11-24T23:12:08+08:00	852	1766	2618	255	2873	6511	44.13%	13.09%	9	9
14	臺南市山上區	2018-11-24T23:31:03+08:00	852	1766	2618	255	2873	6511	44.13%	13.09%	9	9
14	臺南市山上區	2018-11-24T23:01:24+08:00	852	1766	2618	255	2873	6511	44.13%	13.09%	9	9
14	臺南市山上區	2018-11-24T23:19:42+08:00	852	1766	2618	255	2873	6511	44.13%	13.09%	9	9
14	臺南市山上區	2018-11-25T00:04:58+08:00	852	1766	2618	255	2873	6511	44.13%	13.09%	9	9
14	臺南市山上區	2018-11-24T23:04:57+08:00	852	1766	2618	255	2873	6511	44.13%	13.09%	9	9
14	臺南市山上區	2018-11-25T00:57:29+08:00	852	1766	2618	255	2873	6511	44.13%	13.09%	9	9
14	臺南市山上區	2018-11-24T22:13:19+08:00	852	1766	2618	255	2873	6511	44.13%	13.09%	9	9
14	臺南市山上區	2018-11-25T03:44:14+08:00	852	1766	2618	255	2873	6511	44.13%	13.09%	9	9
14	臺南市山上區	2018-11-25T01:17:43+08:00	852	1766	2618	255	2873	6511	44.13%	13.09%	9	9
14	臺南市山上區	2018-11-24T23:55:40+08:00	852	1766	2618	255	2873	6511	44.13%	13.09%	9	9
14	臺南市山上區	2018-11-25T01:02:23+08:00	852	1766	2618	255	2873	6511	44.13%	13.09%	9	9
14	臺南市山上區	2018-11-25T01:25:45+08:00	852	1766	2618	255	2873	6511	44.13%	13.09%	9	9
14	臺南市山上區	2018-11-25T03:38:48+08:00	852	1766	2618	255	2873	6511	44.13%	13.09%	9	9
14	臺南市山上區	2018-11-25T06:18:50+08:00	852	1766	2618	255	2873	6511	44.13%	13.09%	9	9
14	臺南市山上區	2018-11-24T22:40:21+08:00	852	1766	2618	255	2873	6511	44.13%	13.09%	9	9
14	臺南市山上區	2018-11-24T23:27:12+08:00	852	1766	2618	255	2873	6511	44.13%	13.09%	9	9
14	臺南市山上區	2018-11-25T00:18:23+08:00	852	1766	2618	255	2873	6511	44.13%	13.09%	9	9
14	臺南市山上區	2018-11-24T22:54:19+08:00	852	1766	2618	255	2873	6511	44.13%	13.09%	9	9
14	臺南市山上區	2018-11-25T00:22:57+08:00	852	1766	2618	255	2873	6511	44.13%	13.09%	9	9
14	臺南市山上區	2018-11-25T03:56:04+08:00	852	1766	2618	255	2873	6511	44.13%	13.09%	9	9
14	臺南市山上區	2018-11-24T22:16:02+08:00	852	1766	2618	255	2873	6511	44.13%	13.09%	9	9
14	臺南市山上區	2018-11-24T22:41:28+08:00	852	1766	2618	255	2873	6511	44.13%	13.09%	9	9
14	臺南市山上區	2018-11-25T04:02:41+08:00	852	1766	2618	255	2873	6511	44.13%	13.09%	9	9
14	臺南市山上區	2018-11-25T01:12:35+08:00	852	1766	2618	255	2873	6511	44.13%	13.09%	9	9
14	臺南市山上區	2018-11-24T22:29:59+08:00	852	1766	2618	255	2873	6511	44.13%	13.09%	9	9
14	臺南市山上區	2018-11-24T23:23:32+08:00	852	1766	2618	255	2873	6511	44.13%	13.09%	9	9
14	臺南市山上區	2018-11-24T22:57:46+08:00	852	1766	2618	255	2873	6511	44.13%	13.09%	9	9
14	臺南市山上區	2018-11-25T00:00:01+08:00	852	1766	2618	255	2873	6511	44.13%	13.09%	9	9
14	臺南市山上區	2018-11-24T23:51:27+08:00	852	1766	2618	255	2873	6511	44.13%	13.09%	9	9
14	臺南市山上區	2018-11-24T22:23:05+08:00	852	1766	2618	255	2873	6511	44.13%	13.09%	9	9
14	臺南市山上區	2018-11-24T22:36:54+08:00	852	1766	2618	255	2873	6511	44.13%	13.09%	9	9
14	臺南市山上區	2018-11-24T23:15:56+08:00	852	1766	2618	255	2873	6511	44.13%	13.09%	9	9
14	臺南市山上區	2018-11-24T23:08:28+08:00	852	1766	2618	255	2873	6511	44.13%	13.09%	9	9
14	臺南市山上區	2018-11-25T03:32:27+08:00	852	1766	2618	255	2873	6511	44.13%	13.09%	9	9
14	臺南市山上區	2018-11-24T22:19:30+08:00	852	1766	2618	255	2873	6511	44.13%	13.09%	9	9
14	臺南市山上區	2018-11-25T03:49:44+08:00	852	1766	2618	255	2873	6511	44.13%	13.09%	9	9
14	臺南市山上區	2018-11-24T22:45:02+08:00	852	1766	2618	255	2873	6511	44.13%	13.09%	9	9
14	臺南市山上區	2018-11-24T22:50:40+08:00	852	1766	2618	255	2873	6511	44.13%	13.09%	9	9
14	臺南市山上區	2018-11-24T22:26:30+08:00	852	1766	2618	255	2873	6511	44.13%	13.09%	9	9
14	臺南市山上區	2018-11-25T06:29:09+08:00	852	1766	2618	255	2873	6511	44.13%	13.09%	9	9
14	臺南市山上區	2018-11-25T06:23:53+08:00	852	1766	2618	255	2873	6511	44.13%	13.09%	9	9
14	臺南市山上區	2018-11-25T06:13:45+08:00	852	1766	2618	255	2873	6511	44.13%	13.09%	9	9
14	屏東縣枋寮鄉	2018-11-24T23:43:16+08:00	2916	7210	10126	1218	11344	21394	53.02%	13.63%	22	22
14	屏東縣枋寮鄉	2018-11-24T22:33:36+08:00	2289	5779	8068	1006	9074	17138	52.95%	13.36%	19	22
14	屏東縣枋寮鄉	2018-11-25T03:56:11+08:00	2916	7210	10126	1218	11344	21394	53.02%	13.63%	22	22
14	屏東縣枋寮鄉	2018-11-25T06:29:16+08:00	2916	7210	10126	1218	11344	21394	53.02%	13.63%	22	22
14	屏東縣枋寮鄉	2018-11-24T23:47:27+08:00	2916	7210	10126	1218	11344	21394	53.02%	13.63%	22	22
14	屏東縣枋寮鄉	2018-11-24T22:16:09+08:00	2289	5779	8068	1006	9074	17138	52.95%	13.36%	19	22
14	屏東縣枋寮鄉	2018-11-25T03:38:54+08:00	2916	7210	10126	1218	11344	21394	53.02%	13.63%	22	22
14	屏東縣枋寮鄉	2018-11-24T23:55:46+08:00	2916	7210	10126	1218	11344	21394	53.02%	13.63%	22	22
14	屏東縣枋寮鄉	2018-11-25T01:25:51+08:00	2916	7210	10126	1218	11344	21394	53.02%	13.63%	22	22
14	屏東縣枋寮鄉	2018-11-24T23:23:37+08:00	2715	6795	9510	1137	10647	20007	53.22%	13.57%	21	22
14	屏東縣枋寮鄉	2018-11-25T06:18:56+08:00	2916	7210	10126	1218	11344	21394	53.02%	13.63%	22	22
14	屏東縣枋寮鄉	2018-11-24T22:23:12+08:00	2289	5779	8068	1006	9074	17138	52.95%	13.36%	19	22
14	屏東縣枋寮鄉	2018-11-24T22:40:27+08:00	2289	5779	8068	1006	9074	17138	52.95%	13.36%	19	22
14	屏東縣枋寮鄉	2018-11-24T22:36:59+08:00	2289	5779	8068	1006	9074	17138	52.95%	13.36%	19	22
14	屏東縣枋寮鄉	2018-11-25T00:57:35+08:00	2916	7210	10126	1218	11344	21394	53.02%	13.63%	22	22
14	屏東縣枋寮鄉	2018-11-25T01:17:51+08:00	2916	7210	10126	1218	11344	21394	53.02%	13.63%	22	22
14	屏東縣枋寮鄉	2018-11-24T22:30:07+08:00	2289	5779	8068	1006	9074	17138	52.95%	13.36%	19	22
14	屏東縣枋寮鄉	2018-11-24T23:31:10+08:00	2916	7210	10126	1218	11344	21394	53.02%	13.63%	22	22
14	屏東縣枋寮鄉	2018-11-24T23:39:14+08:00	2916	7210	10126	1218	11344	21394	53.02%	13.63%	22	22
14	屏東縣枋寮鄉	2018-11-24T23:01:30+08:00	2503	6333	8836	1057	9893	18640	53.07%	13.43%	20	22
14	屏東縣枋寮鄉	2018-11-25T04:02:51+08:00	2916	7210	10126	1218	11344	21394	53.02%	13.63%	22	22
14	屏東縣枋寮鄉	2018-11-24T23:12:14+08:00	2503	6333	8836	1057	9893	18640	53.07%	13.43%	20	22
14	屏東縣枋寮鄉	2018-11-25T06:23:59+08:00	2916	7210	10126	1218	11344	21394	53.02%	13.63%	22	22
14	屏東縣枋寮鄉	2018-11-25T00:09:33+08:00	2916	7210	10126	1218	11344	21394	53.02%	13.63%	22	22
14	屏東縣枋寮鄉	2018-11-24T22:45:07+08:00	2503	6333	8836	1057	9893	18640	53.07%	13.43%	20	22
14	屏東縣枋寮鄉	2018-11-25T06:08:51+08:00	2916	7210	10126	1218	11344	21394	53.02%	13.63%	22	22
14	屏東縣枋寮鄉	2018-11-25T01:07:25+08:00	2916	7210	10126	1218	11344	21394	53.02%	13.63%	22	22
14	屏東縣枋寮鄉	2018-11-25T06:13:51+08:00	2916	7210	10126	1218	11344	21394	53.02%	13.63%	22	22
14	屏東縣枋寮鄉	2018-11-24T23:16:02+08:00	2503	6333	8836	1057	9893	18640	53.07%	13.43%	20	22
14	屏東縣枋寮鄉	2018-11-24T23:35:09+08:00	2916	7210	10126	1218	11344	21394	53.02%	13.63%	22	22
14	屏東縣枋寮鄉	2018-11-25T03:49:50+08:00	2916	7210	10126	1218	11344	21394	53.02%	13.63%	22	22
14	屏東縣枋寮鄉	2018-11-25T00:14:08+08:00	2916	7210	10126	1218	11344	21394	53.02%	13.63%	22	22
14	屏東縣枋寮鄉	2018-11-25T00:00:09+08:00	2916	7210	10126	1218	11344	21394	53.02%	13.63%	22	22
14	屏東縣枋寮鄉	2018-11-25T00:23:02+08:00	2916	7210	10126	1218	11344	21394	53.02%	13.63%	22	22
14	屏東縣枋寮鄉	2018-11-24T23:08:35+08:00	2503	6333	8836	1057	9893	18640	53.07%	13.43%	20	22
14	屏東縣枋寮鄉	2018-11-25T03:32:33+08:00	2916	7210	10126	1218	11344	21394	53.02%	13.63%	22	22
14	屏東縣枋寮鄉	2018-11-25T03:44:21+08:00	2916	7210	10126	1218	11344	21394	53.02%	13.63%	22	22
14	屏東縣枋寮鄉	2018-11-24T22:13:25+08:00	2130	5345	7475	934	8409	15862	53.01%	13.43%	18	22
14	屏東縣枋寮鄉	2018-11-24T23:19:49+08:00	2503	6333	8836	1057	9893	18640	53.07%	13.43%	20	22
14	屏東縣枋寮鄉	2018-11-24T23:27:17+08:00	2715	6795	9510	1137	10647	20007	53.22%	13.57%	21	22
14	屏東縣枋寮鄉	2018-11-24T22:19:36+08:00	2289	5779	8068	1006	9074	17138	52.95%	13.36%	19	22
14	屏東縣枋寮鄉	2018-11-25T01:02:29+08:00	2916	7210	10126	1218	11344	21394	53.02%	13.63%	22	22
14	屏東縣枋寮鄉	2018-11-24T23:51:34+08:00	2916	7210	10126	1218	11344	21394	53.02%	13.63%	22	22
14	屏東縣枋寮鄉	2018-11-24T22:57:52+08:00	2503	6333	8836	1057	9893	18640	53.07%	13.43%	20	22
14	屏東縣枋寮鄉	2018-11-24T23:05:03+08:00	2503	6333	8836	1057	9893	18640	53.07%	13.43%	20	22
14	屏東縣枋寮鄉	2018-11-24T22:50:47+08:00	2503	6333	8836	1057	9893	18640	53.07%	13.43%	20	22
14	屏東縣枋寮鄉	2018-11-25T00:18:28+08:00	2916	7210	10126	1218	11344	21394	53.02%	13.63%	22	22
14	屏東縣枋寮鄉	2018-11-25T00:05:04+08:00	2916	7210	10126	1218	11344	21394	53.02%	13.63%	22	22
14	屏東縣枋寮鄉	2018-11-24T22:41:34+08:00	2289	5779	8068	1006	9074	17138	52.95%	13.36%	19	22
14	屏東縣枋寮鄉	2018-11-25T01:12:42+08:00	2916	7210	10126	1218	11344	21394	53.02%	13.63%	22	22
14	屏東縣枋寮鄉	2018-11-24T22:26:36+08:00	2289	5779	8068	1006	9074	17138	52.95%	13.36%	19	22
14	屏東縣枋寮鄉	2018-11-24T22:54:25+08:00	2503	6333	8836	1057	9893	18640	53.07%	13.43%	20	22
14	臺南市東區	2018-11-24T23:35:04+08:00	24966	46887	71853	3124	74977	136622	54.88%	18.27%	84	93
14	臺南市東區	2018-11-24T23:47:21+08:00	25397	47696	73093	3160	76253	138864	54.91%	18.29%	85	93
14	臺南市東區	2018-11-25T06:08:45+08:00	27901	52576	80477	3521	83998	153359	54.77%	18.19%	93	93
14	臺南市東區	2018-11-24T23:43:11+08:00	24966	46887	71853	3124	74977	136622	54.88%	18.27%	84	93
14	臺南市東區	2018-11-25T01:07:19+08:00	27502	51773	79275	3477	82752	150996	54.8%	18.21%	92	93
14	臺南市東區	2018-11-24T22:33:31+08:00	14291	26505	40796	1800	42596	77930	54.66%	18.34%	48	93
14	臺南市東區	2018-11-25T00:14:02+08:00	26151	49157	75308	3303	78611	143172	54.91%	18.27%	88	93
14	臺南市東區	2018-11-25T04:02:42+08:00	27901	52576	80477	3521	83998	153359	54.77%	18.19%	93	93
14	臺南市東區	2018-11-25T00:09:26+08:00	25890	48693	74583	3256	77839	141745	54.91%	18.27%	87	93
14	臺南市東區	2018-11-24T23:12:08+08:00	21609	40321	61930	2646	64576	117775	54.83%	18.35%	73	93
14	臺南市東區	2018-11-24T23:39:07+08:00	24966	46887	71853	3124	74977	136622	54.88%	18.27%	84	93
14	臺南市東區	2018-11-24T23:31:03+08:00	24966	46887	71853	3124	74977	136622	54.88%	18.27%	84	93
14	臺南市東區	2018-11-24T23:01:24+08:00	20340	38080	58420	2505	60925	110967	54.9%	18.33%	69	93
14	臺南市東區	2018-11-25T03:44:15+08:00	27901	52576	80477	3521	83998	153359	54.77%	18.19%	93	93
14	臺南市東區	2018-11-24T23:19:42+08:00	23493	44141	67634	2868	70502	128585	54.83%	18.27%	79	93
14	臺南市東區	2018-11-25T00:04:58+08:00	25890	48693	74583	3256	77839	141745	54.91%	18.27%	87	93
14	臺南市東區	2018-11-24T23:04:57+08:00	20740	38789	59529	2558	62087	113307	54.8%	18.3%	70	93
14	臺南市東區	2018-11-25T00:57:29+08:00	27196	51151	78347	3436	81783	148881	54.93%	18.27%	91	93
14	臺南市東區	2018-11-24T22:13:19+08:00	11284	21152	32436	1390	33826	61782	54.75%	18.26%	38	93
14	臺南市東區	2018-11-25T01:17:44+08:00	27901	52576	80477	3521	83998	153359	54.77%	18.19%	93	93
14	臺南市東區	2018-11-24T23:55:40+08:00	25397	47696	73093	3160	76253	138864	54.91%	18.29%	85	93
14	臺南市東區	2018-11-25T06:18:51+08:00	27901	52576	80477	3521	83998	153359	54.77%	18.19%	93	93
14	臺南市東區	2018-11-25T01:02:23+08:00	27502	51773	79275	3477	82752	150996	54.8%	18.21%	92	93
14	臺南市東區	2018-11-25T03:38:49+08:00	27901	52576	80477	3521	83998	153359	54.77%	18.19%	93	93
14	臺南市東區	2018-11-24T23:27:12+08:00	24148	45296	69444	2949	72393	131948	54.86%	18.3%	81	93
14	臺南市東區	2018-11-25T00:18:23+08:00	26439	49731	76170	3341	79511	144727	54.94%	18.27%	89	93
14	臺南市東區	2018-11-24T22:54:19+08:00	18581	34534	53115	2291	55406	101032	54.84%	18.39%	63	93
14	臺南市東區	2018-11-25T06:13:46+08:00	27901	52576	80477	3521	83998	153359	54.77%	18.19%	93	93
14	臺南市東區	2018-11-25T00:22:57+08:00	26765	50398	77163	3411	80574	146794	54.89%	18.23%	90	93
14	臺南市東區	2018-11-25T03:56:04+08:00	27901	52576	80477	3521	83998	153359	54.77%	18.19%	93	93
14	臺南市東區	2018-11-24T22:41:29+08:00	15892	29321	45213	1924	47137	85971	54.83%	18.49%	53	93
14	臺南市東區	2018-11-24T22:16:03+08:00	12109	22598	34707	1525	36232	66189	54.74%	18.29%	41	93
14	臺南市東區	2018-11-25T01:12:35+08:00	27502	51773	79275	3477	82752	150996	54.8%	18.21%	92	93
14	臺南市東區	2018-11-24T22:29:59+08:00	13725	25574	39299	1708	41007	74986	54.69%	18.3%	46	93
14	臺南市東區	2018-11-24T23:23:32+08:00	23820	44726	68546	2904	71450	130224	54.87%	18.29%	80	93
14	臺南市東區	2018-11-24T23:51:28+08:00	25397	47696	73093	3160	76253	138864	54.91%	18.29%	85	93
14	臺南市東區	2018-11-24T22:57:46+08:00	19754	36969	56723	2454	59177	107588	55%	18.36%	67	93
14	臺南市東區	2018-11-25T00:00:01+08:00	25397	47696	73093	3160	76253	138864	54.91%	18.29%	85	93
14	臺南市東區	2018-11-24T22:23:05+08:00	13432	25047	38479	1676	40155	73452	54.67%	18.29%	45	93
14	臺南市東區	2018-11-24T22:36:54+08:00	14814	27345	42159	1834	43993	80428	54.7%	18.42%	50	93
14	臺南市東區	2018-11-25T01:25:46+08:00	27901	52576	80477	3521	83998	153359	54.77%	18.19%	93	93
14	臺南市東區	2018-11-24T23:15:56+08:00	22534	42192	64726	2781	67507	123336	54.73%	18.27%	76	93
14	臺南市東區	2018-11-24T23:08:28+08:00	21105	39343	60448	2600	63048	115071	54.79%	18.34%	71	93
14	臺南市東區	2018-11-24T22:40:22+08:00	15892	29321	45213	1924	47137	85971	54.83%	18.49%	53	93
14	臺南市東區	2018-11-24T22:19:30+08:00	12331	23069	35400	1563	36963	67511	54.75%	18.27%	42	93
14	臺南市東區	2018-11-25T03:32:28+08:00	27901	52576	80477	3521	83998	153359	54.77%	18.19%	93	93
14	臺南市東區	2018-11-24T22:45:02+08:00	16640	30733	47373	2001	49374	89978	54.87%	18.49%	56	93
14	臺南市東區	2018-11-24T22:50:40+08:00	17630	32756	50386	2184	52570	95981	54.77%	18.37%	60	93
14	臺南市東區	2018-11-25T03:49:45+08:00	27901	52576	80477	3521	83998	153359	54.77%	18.19%	93	93
14	臺南市東區	2018-11-25T06:29:09+08:00	27901	52576	80477	3521	83998	153359	54.77%	18.19%	93	93
14	臺南市東區	2018-11-25T06:23:53+08:00	27901	52576	80477	3521	83998	153359	54.77%	18.19%	93	93
14	臺南市東區	2018-11-24T22:26:31+08:00	13432	25047	38479	1676	40155	73452	54.67%	18.29%	45	93
14	桃園市楊梅區	2018-11-25T01:07:17+08:00	19114	46991	66105	3293	69398	135691	51.14%	14.09%	81	82
14	桃園市楊梅區	2018-11-25T06:08:42+08:00	19418	47700	67118	3315	70433	137917	51.07%	14.08%	82	82
14	桃園市楊梅區	2018-11-24T23:47:18+08:00	16345	40375	56720	2884	59604	115090	51.79%	14.2%	71	82
14	桃園市楊梅區	2018-11-24T23:35:02+08:00	15165	37590	52755	2683	55438	106795	51.91%	14.2%	66	82
14	桃園市楊梅區	2018-11-24T22:26:29+08:00	10079	25725	35804	1905	37709	72966	51.68%	13.81%	47	82
14	桃園市楊梅區	2018-11-24T22:16:00+08:00	9255	23661	32916	1714	34630	67230	51.51%	13.77%	43	82
14	桃園市楊梅區	2018-11-24T23:51:25+08:00	16900	41620	58520	2937	61457	118996	51.65%	14.2%	73	82
14	桃園市楊梅區	2018-11-25T00:04:56+08:00	17725	43643	61368	3061	64429	125256	51.44%	14.15%	76	82
14	桃園市楊梅區	2018-11-24T22:19:28+08:00	9618	24571	34189	1799	35988	69693	51.64%	13.8%	45	82
14	桃園市楊梅區	2018-11-25T00:57:27+08:00	18841	46297	65138	3224	68362	133401	51.25%	14.12%	80	82
14	桃園市楊梅區	2018-11-24T22:57:43+08:00	12657	31351	44008	2278	46286	89162	51.91%	14.2%	56	82
14	桃園市楊梅區	2018-11-24T22:13:17+08:00	9031	23098	32129	1684	33813	65814	51.38%	13.72%	42	82
14	桃園市楊梅區	2018-11-24T23:23:30+08:00	13772	34299	48071	2429	50500	97286	51.91%	14.16%	61	82
14	桃園市楊梅區	2018-11-24T22:29:55+08:00	10079	25725	35804	1905	37709	72966	51.68%	13.81%	47	82
14	桃園市楊梅區	2018-11-24T23:08:25+08:00	13270	33144	46414	2390	48804	94030	51.9%	14.11%	59	82
14	桃園市楊梅區	2018-11-24T23:55:38+08:00	17182	42337	59519	2975	62494	121294	51.52%	14.17%	74	82
14	桃園市楊梅區	2018-11-25T03:38:46+08:00	19418	47700	67118	3315	70433	137917	51.07%	14.08%	82	82
14	桃園市楊梅區	2018-11-24T23:59:58+08:00	17408	42992	60400	3027	63427	123155	51.5%	14.14%	75	82
14	桃園市楊梅區	2018-11-25T03:32:25+08:00	19418	47700	67118	3315	70433	137917	51.07%	14.08%	82	82
14	桃園市楊梅區	2018-11-24T23:15:54+08:00	13270	33144	46414	2390	48804	94030	51.9%	14.11%	59	82
14	桃園市楊梅區	2018-11-24T22:40:19+08:00	10612	26938	37550	1981	39531	76326	51.79%	13.9%	49	82
14	桃園市楊梅區	2018-11-25T01:25:43+08:00	19418	47700	67118	3315	70433	137917	51.07%	14.08%	82	82
14	桃園市楊梅區	2018-11-25T06:23:51+08:00	19418	47700	67118	3315	70433	137917	51.07%	14.08%	82	82
14	桃園市楊梅區	2018-11-24T22:54:17+08:00	11734	29506	41240	2128	43368	83883	51.7%	13.99%	53	82
14	桃園市楊梅區	2018-11-24T22:45:00+08:00	10934	27573	38507	2009	40516	78208	51.81%	13.98%	50	82
14	桃園市楊梅區	2018-11-24T23:01:21+08:00	13018	32572	45590	2366	47956	92473	51.86%	14.08%	58	82
14	桃園市楊梅區	2018-11-24T23:31:01+08:00	14884	36964	51848	2642	54490	104775	52.01%	14.21%	65	82
14	桃園市楊梅區	2018-11-25T00:09:23+08:00	17982	44308	62290	3096	65386	127244	51.39%	14.13%	77	82
14	桃園市楊梅區	2018-11-24T22:41:27+08:00	10612	26938	37550	1981	39531	76326	51.79%	13.9%	49	82
14	桃園市楊梅區	2018-11-25T01:12:33+08:00	19418	47700	67118	3315	70433	137917	51.07%	14.08%	82	82
14	桃園市楊梅區	2018-11-24T22:50:37+08:00	11467	28814	40281	2088	42369	81940	51.71%	13.99%	52	82
14	桃園市楊梅區	2018-11-25T00:14:00+08:00	18518	45549	64067	3188	67255	131190	51.27%	14.12%	79	82
14	桃園市楊梅區	2018-11-24T23:12:05+08:00	13270	33144	46414	2390	48804	94030	51.9%	14.11%	59	82
14	桃園市楊梅區	2018-11-24T23:39:04+08:00	15670	38810	54480	2770	57250	110361	51.88%	14.2%	68	82
14	桃園市楊梅區	2018-11-25T01:17:41+08:00	19418	47700	67118	3315	70433	137917	51.07%	14.08%	82	82
14	桃園市楊梅區	2018-11-25T03:44:11+08:00	19418	47700	67118	3315	70433	137917	51.07%	14.08%	82	82
14	桃園市楊梅區	2018-11-24T22:23:03+08:00	9809	25109	34918	1851	36769	71208	51.64%	13.78%	46	82
14	桃園市楊梅區	2018-11-25T06:18:48+08:00	19418	47700	67118	3315	70433	137917	51.07%	14.08%	82	82
14	桃園市楊梅區	2018-11-24T23:04:55+08:00	13018	32572	45590	2366	47956	92473	51.86%	14.08%	58	82
14	桃園市楊梅區	2018-11-24T23:27:10+08:00	14329	35606	49935	2546	52481	101134	51.89%	14.17%	63	82
14	桃園市楊梅區	2018-11-24T22:36:52+08:00	10612	26938	37550	1981	39531	76326	51.79%	13.9%	49	82
14	桃園市楊梅區	2018-11-25T01:02:21+08:00	19114	46991	66105	3293	69398	135691	51.14%	14.09%	81	82
14	桃園市楊梅區	2018-11-24T23:19:39+08:00	13476	33695	47171	2408	49579	95438	51.95%	14.12%	60	82
14	桃園市楊梅區	2018-11-25T00:22:55+08:00	18518	45549	64067	3188	67255	131190	51.27%	14.12%	79	82
14	桃園市楊梅區	2018-11-25T03:56:01+08:00	19418	47700	67118	3315	70433	137917	51.07%	14.08%	82	82
14	桃園市楊梅區	2018-11-24T22:33:28+08:00	10396	26384	36780	1934	38714	74877	51.7%	13.88%	48	82
14	桃園市楊梅區	2018-11-25T06:13:43+08:00	19418	47700	67118	3315	70433	137917	51.07%	14.08%	82	82
14	桃園市楊梅區	2018-11-25T04:02:39+08:00	19418	47700	67118	3315	70433	137917	51.07%	14.08%	82	82
14	桃園市楊梅區	2018-11-25T00:18:21+08:00	18518	45549	64067	3188	67255	131190	51.27%	14.12%	79	82
14	桃園市楊梅區	2018-11-25T06:29:07+08:00	19418	47700	67118	3315	70433	137917	51.07%	14.08%	82	82
14	桃園市楊梅區	2018-11-25T03:49:42+08:00	19418	47700	67118	3315	70433	137917	51.07%	14.08%	82	82
14	桃園市楊梅區	2018-11-24T23:43:08+08:00	16027	39712	55739	2859	58598	113159	51.78%	14.16%	70	82
14	花蓮縣吉安鄉	2018-11-25T06:29:17+08:00	9393	26662	36055	2081	38136	72116	52.88%	13.02%	59	59
14	花蓮縣吉安鄉	2018-11-24T23:47:28+08:00	6735	18868	25603	1418	27021	50748	53.25%	13.27%	43	59
14	花蓮縣吉安鄉	2018-11-25T00:18:30+08:00	7751	21907	29658	1677	31335	59278	52.86%	13.08%	49	59
14	花蓮縣吉安鄉	2018-11-25T01:07:26+08:00	9028	25661	34689	1993	36682	69445	52.82%	13%	57	59
14	花蓮縣吉安鄉	2018-11-25T06:13:52+08:00	9393	26662	36055	2081	38136	72116	52.88%	13.02%	59	59
14	花蓮縣吉安鄉	2018-11-24T22:33:38+08:00	3454	9701	13155	722	13877	25843	53.7%	13.37%	23	59
14	花蓮縣吉安鄉	2018-11-24T23:43:17+08:00	6452	17996	24448	1356	25804	48437	53.27%	13.32%	41	59
14	花蓮縣吉安鄉	2018-11-24T22:37:01+08:00	3454	9701	13155	722	13877	25843	53.7%	13.37%	23	59
14	花蓮縣吉安鄉	2018-11-25T03:44:23+08:00	9393	26662	36055	2081	38136	72116	52.88%	13.02%	59	59
14	花蓮縣吉安鄉	2018-11-24T22:13:27+08:00	2650	7504	10154	560	10714	20075	53.37%	13.2%	18	59
14	花蓮縣吉安鄉	2018-11-25T01:02:31+08:00	8858	25246	34104	1968	36072	68310	52.81%	12.97%	56	59
14	花蓮縣吉安鄉	2018-11-24T23:23:38+08:00	5550	15457	21007	1189	22196	41557	53.41%	13.36%	35	59
14	花蓮縣吉安鄉	2018-11-25T03:38:55+08:00	9393	26662	36055	2081	38136	72116	52.88%	13.02%	59	59
14	花蓮縣吉安鄉	2018-11-24T23:55:47+08:00	6930	19437	26367	1446	27813	52263	53.22%	13.26%	44	59
14	花蓮縣吉安鄉	2018-11-24T23:08:36+08:00	4898	13620	18518	1009	19527	36334	53.74%	13.48%	31	59
14	花蓮縣吉安鄉	2018-11-25T00:00:11+08:00	7266	20407	27673	1508	29181	55119	52.94%	13.18%	46	59
14	花蓮縣吉安鄉	2018-11-25T06:18:57+08:00	9393	26662	36055	2081	38136	72116	52.88%	13.02%	59	59
14	花蓮縣吉安鄉	2018-11-24T22:30:09+08:00	3129	8891	12020	654	12674	23719	53.43%	13.19%	21	59
14	花蓮縣吉安鄉	2018-11-24T22:40:28+08:00	3454	9701	13155	722	13877	25843	53.7%	13.37%	23	59
14	花蓮縣吉安鄉	2018-11-24T22:23:13+08:00	3129	8891	12020	654	12674	23719	53.43%	13.19%	21	59
14	花蓮縣吉安鄉	2018-11-24T23:19:51+08:00	5550	15457	21007	1189	22196	41557	53.41%	13.36%	35	59
14	花蓮縣吉安鄉	2018-11-24T23:12:15+08:00	5048	13998	19046	1042	20088	37393	53.72%	13.5%	32	59
14	花蓮縣吉安鄉	2018-11-24T23:35:11+08:00	5998	16761	22759	1272	24031	45084	53.3%	13.3%	38	59
14	花蓮縣吉安鄉	2018-11-24T23:01:31+08:00	4898	13620	18518	1009	19527	36334	53.74%	13.48%	31	59
14	花蓮縣吉安鄉	2018-11-24T22:45:09+08:00	3454	9701	13155	722	13877	25843	53.7%	13.37%	23	59
14	花蓮縣吉安鄉	2018-11-24T23:31:11+08:00	5703	15921	21624	1215	22839	42714	53.47%	13.35%	36	59
14	花蓮縣吉安鄉	2018-11-25T00:09:34+08:00	7424	20898	28322	1581	29903	56420	53%	13.16%	47	59
14	花蓮縣吉安鄉	2018-11-24T22:54:26+08:00	4120	11529	15649	853	16502	30862	53.47%	13.35%	27	59
14	花蓮縣吉安鄉	2018-11-25T00:14:09+08:00	7424	20898	28322	1581	29903	56420	53%	13.16%	47	59
14	花蓮縣吉安鄉	2018-11-25T03:49:51+08:00	9393	26662	36055	2081	38136	72116	52.88%	13.02%	59	59
14	花蓮縣吉安鄉	2018-11-24T23:16:03+08:00	5048	13998	19046	1042	20088	37393	53.72%	13.5%	32	59
14	花蓮縣吉安鄉	2018-11-25T03:56:12+08:00	9393	26662	36055	2081	38136	72116	52.88%	13.02%	59	59
14	花蓮縣吉安鄉	2018-11-25T06:24:00+08:00	9393	26662	36055	2081	38136	72116	52.88%	13.02%	59	59
14	花蓮縣吉安鄉	2018-11-25T01:25:53+08:00	9028	25661	34689	1993	36682	69445	52.82%	13%	57	59
14	花蓮縣吉安鄉	2018-11-25T00:23:03+08:00	7941	22423	30364	1698	32062	60598	52.91%	13.1%	50	59
14	花蓮縣吉安鄉	2018-11-25T03:32:34+08:00	9393	26662	36055	2081	38136	72116	52.88%	13.02%	59	59
14	花蓮縣吉安鄉	2018-11-25T00:57:37+08:00	8858	25246	34104	1968	36072	68310	52.81%	12.97%	56	59
14	花蓮縣吉安鄉	2018-11-24T22:57:53+08:00	4539	12648	17187	953	18140	33761	53.73%	13.44%	29	59
14	花蓮縣吉安鄉	2018-11-24T22:19:37+08:00	2816	7974	10790	596	11386	21332	53.38%	13.2%	19	59
14	花蓮縣吉安鄉	2018-11-25T01:17:52+08:00	9028	25661	34689	1993	36682	69445	52.82%	13%	57	59
14	花蓮縣吉安鄉	2018-11-24T23:27:18+08:00	5703	15921	21624	1215	22839	42714	53.47%	13.35%	36	59
14	花蓮縣吉安鄉	2018-11-24T23:51:35+08:00	6930	19437	26367	1446	27813	52263	53.22%	13.26%	44	59
14	花蓮縣吉安鄉	2018-11-24T23:05:04+08:00	4898	13620	18518	1009	19527	36334	53.74%	13.48%	31	59
14	花蓮縣吉安鄉	2018-11-24T22:41:35+08:00	3454	9701	13155	722	13877	25843	53.7%	13.37%	23	59
14	花蓮縣吉安鄉	2018-11-25T00:05:05+08:00	7266	20407	27673	1508	29181	55119	52.94%	13.18%	46	59
14	花蓮縣吉安鄉	2018-11-25T04:02:52+08:00	9393	26662	36055	2081	38136	72116	52.88%	13.02%	59	59
14	花蓮縣吉安鄉	2018-11-25T06:08:53+08:00	9393	26662	36055	2081	38136	72116	52.88%	13.02%	59	59
14	花蓮縣吉安鄉	2018-11-24T22:16:10+08:00	2650	7504	10154	560	10714	20075	53.37%	13.2%	18	59
14	花蓮縣吉安鄉	2018-11-25T01:12:43+08:00	9028	25661	34689	1993	36682	69445	52.82%	13%	57	59
14	花蓮縣吉安鄉	2018-11-24T22:26:37+08:00	3129	8891	12020	654	12674	23719	53.43%	13.19%	21	59
14	花蓮縣吉安鄉	2018-11-24T22:50:48+08:00	4120	11529	15649	853	16502	30862	53.47%	13.35%	27	59
14	花蓮縣吉安鄉	2018-11-24T23:39:16+08:00	6106	17081	23187	1312	24499	46110	53.13%	13.24%	39	59
14	新竹市北區	2018-11-25T06:29:19+08:00	22029	43977	66006	3196	69202	123122	56.21%	17.89%	105	105
14	新竹市北區	2018-11-25T01:07:28+08:00	22029	43977	66006	3196	69202	123122	56.21%	17.89%	105	105
14	新竹市北區	2018-11-25T03:49:53+08:00	22029	43977	66006	3196	69202	123122	56.21%	17.89%	105	105
14	新竹市北區	2018-11-24T22:50:50+08:00	10294	20765	31059	1552	32611	57559	56.66%	17.88%	54	105
14	新竹市北區	2018-11-25T06:13:54+08:00	22029	43977	66006	3196	69202	123122	56.21%	17.89%	105	105
14	新竹市北區	2018-11-24T23:43:19+08:00	17855	35574	53429	2558	55987	99977	56%	17.86%	87	105
14	新竹市北區	2018-11-24T22:13:29+08:00	7450	15102	22552	1104	23656	41855	56.52%	17.8%	40	105
14	新竹市北區	2018-11-25T03:32:36+08:00	22029	43977	66006	3196	69202	123122	56.21%	17.89%	105	105
14	新竹市北區	2018-11-25T03:44:25+08:00	22029	43977	66006	3196	69202	123122	56.21%	17.89%	105	105
14	新竹市北區	2018-11-24T23:08:38+08:00	12399	25196	37595	1858	39453	70384	56.05%	17.62%	64	105
14	新竹市北區	2018-11-24T23:55:49+08:00	19694	39115	58809	2803	61612	109791	56.12%	17.94%	95	105
14	新竹市北區	2018-11-25T06:24:02+08:00	22029	43977	66006	3196	69202	123122	56.21%	17.89%	105	105
14	新竹市北區	2018-11-24T23:51:37+08:00	19293	38352	57645	2751	60396	107570	56.15%	17.94%	93	105
14	新竹市北區	2018-11-24T22:23:15+08:00	8177	16485	24662	1213	25875	45778	56.52%	17.86%	44	105
14	新竹市北區	2018-11-24T22:40:29+08:00	9622	19430	29052	1450	30502	54011	56.47%	17.81%	51	105
14	新竹市北區	2018-11-25T06:18:59+08:00	22029	43977	66006	3196	69202	123122	56.21%	17.89%	105	105
14	新竹市北區	2018-11-24T22:57:56+08:00	11355	23079	34434	1689	36123	64381	56.11%	17.64%	59	105
14	新竹市北區	2018-11-24T23:23:40+08:00	14363	29118	43481	2113	45594	81244	56.12%	17.68%	73	105
14	新竹市北區	2018-11-24T22:33:40+08:00	9176	18648	27824	1413	29237	51731	56.52%	17.74%	49	105
14	新竹市北區	2018-11-24T22:54:27+08:00	10733	21532	32265	1603	33868	60564	55.92%	17.72%	56	105
14	新竹市北區	2018-11-25T00:14:11+08:00	22029	43977	66006	3196	69202	123122	56.21%	17.89%	105	105
14	新竹市北區	2018-11-25T01:12:46+08:00	22029	43977	66006	3196	69202	123122	56.21%	17.89%	105	105
14	新竹市北區	2018-11-24T22:16:12+08:00	7712	15594	23306	1130	24436	43251	56.5%	17.83%	41	105
14	新竹市北區	2018-11-24T22:41:37+08:00	9622	19430	29052	1450	30502	54011	56.47%	17.81%	51	105
14	新竹市北區	2018-11-25T00:05:07+08:00	21379	42321	63700	3061	66761	119070	56.07%	17.95%	102	105
14	新竹市北區	2018-11-24T23:05:06+08:00	11977	24313	36290	1785	38075	67874	56.1%	17.65%	62	105
14	新竹市北區	2018-11-24T22:45:10+08:00	10294	20765	31059	1552	32611	57559	56.66%	17.88%	54	105
14	新竹市北區	2018-11-25T03:56:14+08:00	22029	43977	66006	3196	69202	123122	56.21%	17.89%	105	105
14	新竹市北區	2018-11-24T22:37:02+08:00	9622	19430	29052	1450	30502	54011	56.47%	17.81%	51	105
14	新竹市北區	2018-11-25T00:18:32+08:00	22029	43977	66006	3196	69202	123122	56.21%	17.89%	105	105
14	新竹市北區	2018-11-24T23:16:04+08:00	13666	27726	41392	2014	43406	77666	55.89%	17.6%	70	105
14	新竹市北區	2018-11-25T00:23:05+08:00	22029	43977	66006	3196	69202	123122	56.21%	17.89%	105	105
14	新竹市北區	2018-11-25T01:25:54+08:00	22029	43977	66006	3196	69202	123122	56.21%	17.89%	105	105
14	新竹市北區	2018-11-25T03:38:57+08:00	22029	43977	66006	3196	69202	123122	56.21%	17.89%	105	105
14	新竹市北區	2018-11-24T22:30:11+08:00	8510	17256	25766	1266	27032	47930	56.4%	17.76%	46	105
14	新竹市北區	2018-11-25T01:02:33+08:00	22029	43977	66006	3196	69202	123122	56.21%	17.89%	105	105
14	新竹市北區	2018-11-25T00:57:39+08:00	22029	43977	66006	3196	69202	123122	56.21%	17.89%	105	105
14	新竹市北區	2018-11-24T23:19:53+08:00	13864	28185	42049	2035	44084	78755	55.98%	17.6%	71	105
14	新竹市北區	2018-11-25T00:00:12+08:00	20420	40523	60943	2920	63863	113915	56.06%	17.93%	98	105
14	新竹市北區	2018-11-25T01:17:55+08:00	22029	43977	66006	3196	69202	123122	56.21%	17.89%	105	105
14	新竹市北區	2018-11-24T22:19:39+08:00	8055	16217	24272	1180	25452	45073	56.47%	17.87%	43	105
14	新竹市北區	2018-11-24T23:27:20+08:00	14874	30043	44917	2179	47096	83962	56.09%	17.72%	75	105
14	新竹市北區	2018-11-24T23:35:12+08:00	16138	32266	48404	2349	50753	90549	56.05%	17.82%	80	105
14	新竹市北區	2018-11-24T23:47:30+08:00	18265	36431	54696	2637	57333	102278	56.06%	17.86%	89	105
14	新竹市北區	2018-11-25T00:09:36+08:00	21758	43448	65206	3166	68372	121699	56.18%	17.88%	104	105
14	新竹市北區	2018-11-24T23:01:33+08:00	11799	23944	35743	1753	37496	66804	56.13%	17.66%	61	105
14	新竹市北區	2018-11-24T23:31:13+08:00	15637	31372	47009	2270	49279	87632	56.23%	17.84%	78	105
14	新竹市北區	2018-11-25T04:02:54+08:00	22029	43977	66006	3196	69202	123122	56.21%	17.89%	105	105
14	新竹市北區	2018-11-24T22:26:38+08:00	8395	17007	25402	1248	26650	47172	56.5%	17.8%	45	105
14	新竹市北區	2018-11-24T23:12:17+08:00	12562	25494	38056	1878	39934	71145	56.13%	17.66%	65	105
14	新竹市北區	2018-11-24T23:39:18+08:00	16677	33320	49997	2396	52393	93441	56.07%	17.85%	82	105
14	新竹市北區	2018-11-25T06:08:55+08:00	22029	43977	66006	3196	69202	123122	56.21%	17.89%	105	105
14	嘉義市	2018-11-25T06:29:19+08:00	37776	77841	115617	6009	121626	221553	54.9%	17.05%	177	177
14	嘉義市	2018-11-25T01:07:28+08:00	37776	77841	115617	6009	121626	221553	54.9%	17.05%	177	177
14	嘉義市	2018-11-25T03:49:53+08:00	37776	77841	115617	6009	121626	221553	54.9%	17.05%	177	177
14	嘉義市	2018-11-24T22:50:50+08:00	29858	61249	91107	4679	95786	174433	54.91%	17.12%	143	177
14	嘉義市	2018-11-25T06:13:54+08:00	37776	77841	115617	6009	121626	221553	54.9%	17.05%	177	177
14	嘉義市	2018-11-24T23:43:19+08:00	35469	73323	108792	5720	114512	208628	54.89%	17%	168	177
14	嘉義市	2018-11-24T22:13:29+08:00	23616	48075	71691	3603	75294	136498	55.16%	17.3%	116	177
14	嘉義市	2018-11-25T03:32:36+08:00	37776	77841	115617	6009	121626	221553	54.9%	17.05%	177	177
14	嘉義市	2018-11-25T00:23:06+08:00	37776	77841	115617	6009	121626	221553	54.9%	17.05%	177	177
14	嘉義市	2018-11-25T03:44:25+08:00	37776	77841	115617	6009	121626	221553	54.9%	17.05%	177	177
14	嘉義市	2018-11-24T23:08:38+08:00	32216	66257	98473	5101	103574	188010	55.09%	17.14%	154	177
14	嘉義市	2018-11-24T23:55:49+08:00	35715	73905	109620	5764	115384	210046	54.93%	17%	169	177
14	嘉義市	2018-11-25T06:24:02+08:00	37776	77841	115617	6009	121626	221553	54.9%	17.05%	177	177
14	嘉義市	2018-11-24T23:51:37+08:00	35715	73905	109620	5764	115384	210046	54.93%	17%	169	177
14	嘉義市	2018-11-24T22:23:15+08:00	25613	52270	77883	3939	81822	148580	55.07%	17.24%	125	177
14	嘉義市	2018-11-24T22:40:29+08:00	28860	59112	87972	4559	92531	168329	54.97%	17.14%	139	177
14	嘉義市	2018-11-25T06:18:59+08:00	37776	77841	115617	6009	121626	221553	54.9%	17.05%	177	177
14	嘉義市	2018-11-24T22:57:56+08:00	31693	65235	96928	5014	101942	185366	54.99%	17.1%	152	177
14	嘉義市	2018-11-24T23:23:40+08:00	34144	70649	104793	5478	110271	200904	54.89%	17%	163	177
14	嘉義市	2018-11-24T22:33:40+08:00	27700	56815	84515	4350	88865	161593	54.99%	17.14%	134	177
14	嘉義市	2018-11-24T22:54:27+08:00	30289	62154	92443	4769	97212	177061	54.9%	17.11%	145	177
14	嘉義市	2018-11-25T00:14:11+08:00	37776	77841	115617	6009	121626	221553	54.9%	17.05%	177	177
14	嘉義市	2018-11-25T01:12:46+08:00	37776	77841	115617	6009	121626	221553	54.9%	17.05%	177	177
14	嘉義市	2018-11-24T22:16:12+08:00	24974	50826	75800	3848	79648	144660	55.06%	17.26%	122	177
14	嘉義市	2018-11-24T22:41:37+08:00	28860	59112	87972	4559	92531	168329	54.97%	17.14%	139	177
14	嘉義市	2018-11-25T00:05:07+08:00	37363	77040	114403	5987	120390	218966	54.98%	17.06%	175	177
14	嘉義市	2018-11-24T23:05:06+08:00	32372	66614	98986	5115	104101	189145	55.04%	17.11%	155	177
14	嘉義市	2018-11-24T22:45:10+08:00	29611	60681	90292	4633	94925	172888	54.91%	17.13%	142	177
14	嘉義市	2018-11-24T22:37:02+08:00	28418	58237	86655	4462	91117	165889	54.93%	17.13%	137	177
14	嘉義市	2018-11-25T00:18:32+08:00	37776	77841	115617	6009	121626	221553	54.9%	17.05%	177	177
14	嘉義市	2018-11-24T23:16:04+08:00	33080	68402	101482	5237	106719	193873	55.05%	17.06%	158	177
14	嘉義市	2018-11-25T03:56:15+08:00	37776	77841	115617	6009	121626	221553	54.9%	17.05%	177	177
14	嘉義市	2018-11-25T01:25:54+08:00	37776	77841	115617	6009	121626	221553	54.9%	17.05%	177	177
14	嘉義市	2018-11-25T03:38:57+08:00	37776	77841	115617	6009	121626	221553	54.9%	17.05%	177	177
14	嘉義市	2018-11-24T22:30:11+08:00	27010	55260	82270	4202	86472	157344	54.96%	17.17%	131	177
14	嘉義市	2018-11-25T01:02:33+08:00	37776	77841	115617	6009	121626	221553	54.9%	17.05%	177	177
14	嘉義市	2018-11-25T00:57:39+08:00	37776	77841	115617	6009	121626	221553	54.9%	17.05%	177	177
14	嘉義市	2018-11-24T23:19:53+08:00	33782	69827	103609	5375	108984	198366	54.94%	17.03%	161	177
14	嘉義市	2018-11-25T00:00:12+08:00	35975	74456	110431	5816	116247	211613	54.93%	17%	170	177
14	嘉義市	2018-11-25T01:17:55+08:00	37776	77841	115617	6009	121626	221553	54.9%	17.05%	177	177
14	嘉義市	2018-11-24T22:19:39+08:00	25396	51757	77153	3904	81057	147300	55.03%	17.24%	124	177
14	嘉義市	2018-11-24T23:27:20+08:00	34417	71252	105669	5516	111185	202456	54.92%	17%	164	177
14	嘉義市	2018-11-24T23:35:12+08:00	34931	72298	107229	5631	112860	205531	54.91%	17%	166	177
14	嘉義市	2018-11-24T23:47:30+08:00	35724	73831	109555	5761	115316	209986	54.92%	17.01%	169	177
14	嘉義市	2018-11-25T00:09:36+08:00	37776	77841	115617	6009	121626	221553	54.9%	17.05%	177	177
14	嘉義市	2018-11-24T23:01:33+08:00	31693	65235	96928	5014	101942	185366	54.99%	17.1%	152	177
14	嘉義市	2018-11-24T23:31:13+08:00	34417	71252	105669	5516	111185	202456	54.92%	17%	164	177
14	嘉義市	2018-11-25T04:02:54+08:00	37776	77841	115617	6009	121626	221553	54.9%	17.05%	177	177
14	嘉義市	2018-11-24T22:26:38+08:00	26472	54199	80671	4140	84811	153892	55.11%	17.2%	129	177
14	嘉義市	2018-11-24T23:12:17+08:00	32484	66707	99191	5133	104324	189405	55.08%	17.15%	155	177
14	嘉義市	2018-11-24T23:39:18+08:00	35248	72852	108100	5702	113802	207362	54.88%	17%	167	177
14	嘉義市	2018-11-25T06:08:55+08:00	37776	77841	115617	6009	121626	221553	54.9%	17.05%	177	177
14	屏東縣南州鄉	2018-11-24T22:33:37+08:00	1432	2616	4048	416	4464	8517	52.41%	16.81%	10	11
14	屏東縣南州鄉	2018-11-24T22:37:00+08:00	1432	2616	4048	416	4464	8517	52.41%	16.81%	10	11
14	屏東縣南州鄉	2018-11-24T23:43:16+08:00	1592	2968	4560	462	5022	9479	52.98%	16.8%	11	11
14	屏東縣南州鄉	2018-11-25T03:56:11+08:00	1592	2968	4560	462	5022	9479	52.98%	16.8%	11	11
14	屏東縣南州鄉	2018-11-25T06:29:16+08:00	1592	2968	4560	462	5022	9479	52.98%	16.8%	11	11
14	屏東縣南州鄉	2018-11-24T23:47:27+08:00	1592	2968	4560	462	5022	9479	52.98%	16.8%	11	11
14	屏東縣南州鄉	2018-11-24T22:16:09+08:00	1264	2258	3522	351	3873	7473	51.83%	16.91%	9	11
14	屏東縣南州鄉	2018-11-25T03:38:54+08:00	1592	2968	4560	462	5022	9479	52.98%	16.8%	11	11
14	屏東縣南州鄉	2018-11-24T23:55:46+08:00	1592	2968	4560	462	5022	9479	52.98%	16.8%	11	11
14	屏東縣南州鄉	2018-11-25T03:44:22+08:00	1592	2968	4560	462	5022	9479	52.98%	16.8%	11	11
14	屏東縣南州鄉	2018-11-24T22:13:26+08:00	1264	2258	3522	351	3873	7473	51.83%	16.91%	9	11
14	屏東縣南州鄉	2018-11-25T01:25:51+08:00	1592	2968	4560	462	5022	9479	52.98%	16.8%	11	11
14	屏東縣南州鄉	2018-11-24T23:23:37+08:00	1592	2968	4560	462	5022	9479	52.98%	16.8%	11	11
14	屏東縣南州鄉	2018-11-25T06:18:56+08:00	1592	2968	4560	462	5022	9479	52.98%	16.8%	11	11
14	屏東縣南州鄉	2018-11-24T22:23:12+08:00	1432	2616	4048	416	4464	8517	52.41%	16.81%	10	11
14	屏東縣南州鄉	2018-11-24T22:40:27+08:00	1432	2616	4048	416	4464	8517	52.41%	16.81%	10	11
14	屏東縣南州鄉	2018-11-25T00:00:10+08:00	1592	2968	4560	462	5022	9479	52.98%	16.8%	11	11
14	屏東縣南州鄉	2018-11-25T01:17:51+08:00	1592	2968	4560	462	5022	9479	52.98%	16.8%	11	11
14	屏東縣南州鄉	2018-11-24T22:30:07+08:00	1432	2616	4048	416	4464	8517	52.41%	16.81%	10	11
14	屏東縣南州鄉	2018-11-24T23:12:15+08:00	1592	2968	4560	462	5022	9479	52.98%	16.8%	11	11
14	屏東縣南州鄉	2018-11-24T23:31:10+08:00	1592	2968	4560	462	5022	9479	52.98%	16.8%	11	11
14	屏東縣南州鄉	2018-11-24T23:39:14+08:00	1592	2968	4560	462	5022	9479	52.98%	16.8%	11	11
14	屏東縣南州鄉	2018-11-24T23:01:30+08:00	1592	2968	4560	462	5022	9479	52.98%	16.8%	11	11
14	屏東縣南州鄉	2018-11-25T04:02:51+08:00	1592	2968	4560	462	5022	9479	52.98%	16.8%	11	11
14	屏東縣南州鄉	2018-11-25T06:23:59+08:00	1592	2968	4560	462	5022	9479	52.98%	16.8%	11	11
14	屏東縣南州鄉	2018-11-25T00:09:33+08:00	1592	2968	4560	462	5022	9479	52.98%	16.8%	11	11
14	屏東縣南州鄉	2018-11-24T22:45:07+08:00	1432	2616	4048	416	4464	8517	52.41%	16.81%	10	11
14	屏東縣南州鄉	2018-11-25T06:08:51+08:00	1592	2968	4560	462	5022	9479	52.98%	16.8%	11	11
14	屏東縣南州鄉	2018-11-25T01:07:25+08:00	1592	2968	4560	462	5022	9479	52.98%	16.8%	11	11
14	屏東縣南州鄉	2018-11-25T06:13:51+08:00	1592	2968	4560	462	5022	9479	52.98%	16.8%	11	11
14	屏東縣南州鄉	2018-11-24T23:16:02+08:00	1592	2968	4560	462	5022	9479	52.98%	16.8%	11	11
14	屏東縣南州鄉	2018-11-24T23:35:09+08:00	1592	2968	4560	462	5022	9479	52.98%	16.8%	11	11
14	屏東縣南州鄉	2018-11-25T03:49:50+08:00	1592	2968	4560	462	5022	9479	52.98%	16.8%	11	11
14	屏東縣南州鄉	2018-11-25T00:14:08+08:00	1592	2968	4560	462	5022	9479	52.98%	16.8%	11	11
14	屏東縣南州鄉	2018-11-25T00:23:02+08:00	1592	2968	4560	462	5022	9479	52.98%	16.8%	11	11
14	屏東縣南州鄉	2018-11-24T23:08:35+08:00	1592	2968	4560	462	5022	9479	52.98%	16.8%	11	11
14	屏東縣南州鄉	2018-11-25T03:32:33+08:00	1592	2968	4560	462	5022	9479	52.98%	16.8%	11	11
14	屏東縣南州鄉	2018-11-24T23:19:49+08:00	1592	2968	4560	462	5022	9479	52.98%	16.8%	11	11
14	屏東縣南州鄉	2018-11-24T23:27:17+08:00	1592	2968	4560	462	5022	9479	52.98%	16.8%	11	11
14	屏東縣南州鄉	2018-11-24T22:19:36+08:00	1264	2258	3522	351	3873	7473	51.83%	16.91%	9	11
14	屏東縣南州鄉	2018-11-25T01:02:29+08:00	1592	2968	4560	462	5022	9479	52.98%	16.8%	11	11
14	屏東縣南州鄉	2018-11-24T23:51:34+08:00	1592	2968	4560	462	5022	9479	52.98%	16.8%	11	11
14	屏東縣南州鄉	2018-11-24T22:57:52+08:00	1592	2968	4560	462	5022	9479	52.98%	16.8%	11	11
14	屏東縣南州鄉	2018-11-25T00:57:36+08:00	1592	2968	4560	462	5022	9479	52.98%	16.8%	11	11
14	屏東縣南州鄉	2018-11-24T23:05:03+08:00	1592	2968	4560	462	5022	9479	52.98%	16.8%	11	11
14	屏東縣南州鄉	2018-11-24T22:50:47+08:00	1592	2968	4560	462	5022	9479	52.98%	16.8%	11	11
14	屏東縣南州鄉	2018-11-25T00:05:04+08:00	1592	2968	4560	462	5022	9479	52.98%	16.8%	11	11
14	屏東縣南州鄉	2018-11-24T22:41:34+08:00	1432	2616	4048	416	4464	8517	52.41%	16.81%	10	11
14	屏東縣南州鄉	2018-11-25T01:12:42+08:00	1592	2968	4560	462	5022	9479	52.98%	16.8%	11	11
14	屏東縣南州鄉	2018-11-24T22:26:36+08:00	1432	2616	4048	416	4464	8517	52.41%	16.81%	10	11
14	屏東縣南州鄉	2018-11-25T00:18:29+08:00	1592	2968	4560	462	5022	9479	52.98%	16.8%	11	11
14	屏東縣南州鄉	2018-11-24T22:54:25+08:00	1592	2968	4560	462	5022	9479	52.98%	16.8%	11	11
14	臺南市柳營區	2018-11-24T23:35:03+08:00	2607	5834	8441	866	9307	18804	49.49%	13.86%	25	25
14	臺南市柳營區	2018-11-24T22:33:30+08:00	2607	5834	8441	866	9307	18804	49.49%	13.86%	25	25
14	臺南市柳營區	2018-11-24T23:31:02+08:00	2607	5834	8441	866	9307	18804	49.49%	13.86%	25	25
14	臺南市柳營區	2018-11-24T23:39:06+08:00	2607	5834	8441	866	9307	18804	49.49%	13.86%	25	25
14	臺南市柳營區	2018-11-24T23:12:07+08:00	2607	5834	8441	866	9307	18804	49.49%	13.86%	25	25
14	臺南市柳營區	2018-11-24T23:47:20+08:00	2607	5834	8441	866	9307	18804	49.49%	13.86%	25	25
14	臺南市柳營區	2018-11-25T06:08:44+08:00	2607	5834	8441	866	9307	18804	49.49%	13.86%	25	25
14	臺南市柳營區	2018-11-25T01:07:18+08:00	2607	5834	8441	866	9307	18804	49.49%	13.86%	25	25
14	臺南市柳營區	2018-11-24T23:01:23+08:00	2607	5834	8441	866	9307	18804	49.49%	13.86%	25	25
14	臺南市柳營區	2018-11-24T22:57:45+08:00	2607	5834	8441	866	9307	18804	49.49%	13.86%	25	25
14	臺南市柳營區	2018-11-25T01:17:42+08:00	2607	5834	8441	866	9307	18804	49.49%	13.86%	25	25
14	臺南市柳營區	2018-11-24T22:13:18+08:00	2607	5834	8441	866	9307	18804	49.49%	13.86%	25	25
14	臺南市柳營區	2018-11-24T22:19:29+08:00	2607	5834	8441	866	9307	18804	49.49%	13.86%	25	25
14	臺南市柳營區	2018-11-25T00:57:28+08:00	2607	5834	8441	866	9307	18804	49.49%	13.86%	25	25
14	臺南市柳營區	2018-11-24T23:23:31+08:00	2607	5834	8441	866	9307	18804	49.49%	13.86%	25	25
14	臺南市柳營區	2018-11-25T03:44:13+08:00	2607	5834	8441	866	9307	18804	49.49%	13.86%	25	25
14	臺南市柳營區	2018-11-25T00:04:57+08:00	2607	5834	8441	866	9307	18804	49.49%	13.86%	25	25
14	臺南市柳營區	2018-11-24T23:04:56+08:00	2607	5834	8441	866	9307	18804	49.49%	13.86%	25	25
14	臺南市柳營區	2018-11-24T23:15:55+08:00	2607	5834	8441	866	9307	18804	49.49%	13.86%	25	25
14	臺南市柳營區	2018-11-25T03:38:48+08:00	2607	5834	8441	866	9307	18804	49.49%	13.86%	25	25
14	臺南市柳營區	2018-11-25T06:18:50+08:00	2607	5834	8441	866	9307	18804	49.49%	13.86%	25	25
14	臺南市柳營區	2018-11-25T01:25:44+08:00	2607	5834	8441	866	9307	18804	49.49%	13.86%	25	25
14	臺南市柳營區	2018-11-24T22:40:21+08:00	2607	5834	8441	866	9307	18804	49.49%	13.86%	25	25
14	臺南市柳營區	2018-11-25T01:02:22+08:00	2607	5834	8441	866	9307	18804	49.49%	13.86%	25	25
14	臺南市柳營區	2018-11-24T23:55:39+08:00	2607	5834	8441	866	9307	18804	49.49%	13.86%	25	25
14	臺南市柳營區	2018-11-24T22:45:01+08:00	2607	5834	8441	866	9307	18804	49.49%	13.86%	25	25
14	臺南市柳營區	2018-11-25T00:18:22+08:00	2607	5834	8441	866	9307	18804	49.49%	13.86%	25	25
14	臺南市柳營區	2018-11-25T00:22:56+08:00	2607	5834	8441	866	9307	18804	49.49%	13.86%	25	25
14	臺南市柳營區	2018-11-24T22:54:19+08:00	2607	5834	8441	866	9307	18804	49.49%	13.86%	25	25
14	臺南市柳營區	2018-11-25T03:56:03+08:00	2607	5834	8441	866	9307	18804	49.49%	13.86%	25	25
14	臺南市柳營區	2018-11-24T22:16:02+08:00	2607	5834	8441	866	9307	18804	49.49%	13.86%	25	25
14	臺南市柳營區	2018-11-25T01:12:34+08:00	2607	5834	8441	866	9307	18804	49.49%	13.86%	25	25
14	臺南市柳營區	2018-11-24T22:50:39+08:00	2607	5834	8441	866	9307	18804	49.49%	13.86%	25	25
14	臺南市柳營區	2018-11-25T00:09:25+08:00	2607	5834	8441	866	9307	18804	49.49%	13.86%	25	25
14	臺南市柳營區	2018-11-25T00:14:01+08:00	2607	5834	8441	866	9307	18804	49.49%	13.86%	25	25
14	臺南市柳營區	2018-11-24T22:41:28+08:00	2607	5834	8441	866	9307	18804	49.49%	13.86%	25	25
14	臺南市柳營區	2018-11-25T04:02:41+08:00	2607	5834	8441	866	9307	18804	49.49%	13.86%	25	25
14	臺南市柳營區	2018-11-25T00:00:00+08:00	2607	5834	8441	866	9307	18804	49.49%	13.86%	25	25
14	臺南市柳營區	2018-11-24T22:23:04+08:00	2607	5834	8441	866	9307	18804	49.49%	13.86%	25	25
14	臺南市柳營區	2018-11-24T23:19:41+08:00	2607	5834	8441	866	9307	18804	49.49%	13.86%	25	25
14	臺南市柳營區	2018-11-24T23:51:27+08:00	2607	5834	8441	866	9307	18804	49.49%	13.86%	25	25
14	臺南市柳營區	2018-11-24T22:29:58+08:00	2607	5834	8441	866	9307	18804	49.49%	13.86%	25	25
14	臺南市柳營區	2018-11-24T22:36:53+08:00	2607	5834	8441	866	9307	18804	49.49%	13.86%	25	25
14	臺南市柳營區	2018-11-25T03:32:27+08:00	2607	5834	8441	866	9307	18804	49.49%	13.86%	25	25
14	臺南市柳營區	2018-11-24T23:27:11+08:00	2607	5834	8441	866	9307	18804	49.49%	13.86%	25	25
14	臺南市柳營區	2018-11-24T23:08:27+08:00	2607	5834	8441	866	9307	18804	49.49%	13.86%	25	25
14	臺南市柳營區	2018-11-25T06:29:08+08:00	2607	5834	8441	866	9307	18804	49.49%	13.86%	25	25
14	臺南市柳營區	2018-11-25T03:49:44+08:00	2607	5834	8441	866	9307	18804	49.49%	13.86%	25	25
14	臺南市柳營區	2018-11-24T22:26:30+08:00	2607	5834	8441	866	9307	18804	49.49%	13.86%	25	25
14	臺南市柳營區	2018-11-25T06:23:52+08:00	2607	5834	8441	866	9307	18804	49.49%	13.86%	25	25
14	臺南市柳營區	2018-11-24T23:43:09+08:00	2607	5834	8441	866	9307	18804	49.49%	13.86%	25	25
14	臺南市柳營區	2018-11-25T06:13:45+08:00	2607	5834	8441	866	9307	18804	49.49%	13.86%	25	25
14	屏東縣來義鄉	2018-11-24T22:33:37+08:00	264	1144	1408	91	1499	2399	62.48%	11%	5	9
14	屏東縣來義鄉	2018-11-24T22:37:00+08:00	264	1144	1408	91	1499	2399	62.48%	11%	5	9
14	屏東縣來義鄉	2018-11-24T23:43:16+08:00	493	1888	2381	144	2525	4128	61.17%	11.94%	7	9
14	屏東縣來義鄉	2018-11-25T06:13:52+08:00	788	2692	3480	254	3734	6257	59.68%	12.59%	9	9
14	屏東縣來義鄉	2018-11-25T03:56:11+08:00	788	2692	3480	254	3734	6257	59.68%	12.59%	9	9
14	屏東縣來義鄉	2018-11-25T06:29:16+08:00	788	2692	3480	254	3734	6257	59.68%	12.59%	9	9
14	屏東縣來義鄉	2018-11-24T23:47:27+08:00	493	1888	2381	144	2525	4128	61.17%	11.94%	7	9
14	屏東縣來義鄉	2018-11-25T03:38:54+08:00	788	2692	3480	254	3734	6257	59.68%	12.59%	9	9
14	屏東縣來義鄉	2018-11-24T23:55:46+08:00	493	1888	2381	144	2525	4128	61.17%	11.94%	7	9
14	屏東縣來義鄉	2018-11-25T01:02:30+08:00	788	2692	3480	254	3734	6257	59.68%	12.59%	9	9
14	屏東縣來義鄉	2018-11-25T03:44:22+08:00	788	2692	3480	254	3734	6257	59.68%	12.59%	9	9
14	屏東縣來義鄉	2018-11-24T22:13:26+08:00	264	1144	1408	91	1499	2399	62.48%	11%	5	9
14	屏東縣來義鄉	2018-11-24T23:23:37+08:00	493	1888	2381	144	2525	4128	61.17%	11.94%	7	9
14	屏東縣來義鄉	2018-11-25T06:18:56+08:00	788	2692	3480	254	3734	6257	59.68%	12.59%	9	9
14	屏東縣來義鄉	2018-11-24T22:23:12+08:00	264	1144	1408	91	1499	2399	62.48%	11%	5	9
14	屏東縣來義鄉	2018-11-24T23:19:50+08:00	493	1888	2381	144	2525	4128	61.17%	11.94%	7	9
14	屏東縣來義鄉	2018-11-24T22:40:27+08:00	264	1144	1408	91	1499	2399	62.48%	11%	5	9
14	屏東縣來義鄉	2018-11-25T00:00:10+08:00	493	1888	2381	144	2525	4128	61.17%	11.94%	7	9
14	屏東縣來義鄉	2018-11-25T01:17:51+08:00	788	2692	3480	254	3734	6257	59.68%	12.59%	9	9
14	屏東縣來義鄉	2018-11-24T22:30:07+08:00	264	1144	1408	91	1499	2399	62.48%	11%	5	9
14	屏東縣來義鄉	2018-11-24T23:12:15+08:00	493	1888	2381	144	2525	4128	61.17%	11.94%	7	9
14	屏東縣來義鄉	2018-11-24T22:45:08+08:00	264	1144	1408	91	1499	2399	62.48%	11%	5	9
14	屏東縣來義鄉	2018-11-24T23:31:10+08:00	493	1888	2381	144	2525	4128	61.17%	11.94%	7	9
14	屏東縣來義鄉	2018-11-24T23:01:30+08:00	397	1450	1847	114	1961	3288	59.64%	12.07%	6	9
14	屏東縣來義鄉	2018-11-25T04:02:51+08:00	788	2692	3480	254	3734	6257	59.68%	12.59%	9	9
14	屏東縣來義鄉	2018-11-24T23:39:15+08:00	493	1888	2381	144	2525	4128	61.17%	11.94%	7	9
14	屏東縣來義鄉	2018-11-25T06:23:59+08:00	788	2692	3480	254	3734	6257	59.68%	12.59%	9	9
14	屏東縣來義鄉	2018-11-25T00:09:33+08:00	599	2327	2926	214	3140	5045	62.24%	11.87%	8	9
14	屏東縣來義鄉	2018-11-24T23:35:10+08:00	493	1888	2381	144	2525	4128	61.17%	11.94%	7	9
14	屏東縣來義鄉	2018-11-25T01:07:25+08:00	788	2692	3480	254	3734	6257	59.68%	12.59%	9	9
14	屏東縣來義鄉	2018-11-24T23:16:02+08:00	493	1888	2381	144	2525	4128	61.17%	11.94%	7	9
14	屏東縣來義鄉	2018-11-25T03:49:50+08:00	788	2692	3480	254	3734	6257	59.68%	12.59%	9	9
14	屏東縣來義鄉	2018-11-25T00:14:08+08:00	599	2327	2926	214	3140	5045	62.24%	11.87%	8	9
14	屏東縣來義鄉	2018-11-25T00:23:03+08:00	599	2327	2926	214	3140	5045	62.24%	11.87%	8	9
14	屏東縣來義鄉	2018-11-24T23:08:35+08:00	493	1888	2381	144	2525	4128	61.17%	11.94%	7	9
14	屏東縣來義鄉	2018-11-25T03:32:34+08:00	788	2692	3480	254	3734	6257	59.68%	12.59%	9	9
14	屏東縣來義鄉	2018-11-25T01:25:52+08:00	788	2692	3480	254	3734	6257	59.68%	12.59%	9	9
14	屏東縣來義鄉	2018-11-24T22:19:36+08:00	264	1144	1408	91	1499	2399	62.48%	11%	5	9
14	屏東縣來義鄉	2018-11-24T22:57:52+08:00	264	1144	1408	91	1499	2399	62.48%	11%	5	9
14	屏東縣來義鄉	2018-11-25T00:57:36+08:00	788	2692	3480	254	3734	6257	59.68%	12.59%	9	9
14	屏東縣來義鄉	2018-11-24T23:27:18+08:00	493	1888	2381	144	2525	4128	61.17%	11.94%	7	9
14	屏東縣來義鄉	2018-11-24T23:51:35+08:00	493	1888	2381	144	2525	4128	61.17%	11.94%	7	9
14	屏東縣來義鄉	2018-11-24T23:05:04+08:00	397	1450	1847	114	1961	3288	59.64%	12.07%	6	9
14	屏東縣來義鄉	2018-11-24T22:50:47+08:00	264	1144	1408	91	1499	2399	62.48%	11%	5	9
14	屏東縣來義鄉	2018-11-24T22:16:10+08:00	264	1144	1408	91	1499	2399	62.48%	11%	5	9
14	屏東縣來義鄉	2018-11-25T00:05:04+08:00	599	2327	2926	214	3140	5045	62.24%	11.87%	8	9
14	屏東縣來義鄉	2018-11-24T22:41:34+08:00	264	1144	1408	91	1499	2399	62.48%	11%	5	9
14	屏東縣來義鄉	2018-11-25T01:12:42+08:00	788	2692	3480	254	3734	6257	59.68%	12.59%	9	9
14	屏東縣來義鄉	2018-11-24T22:26:36+08:00	264	1144	1408	91	1499	2399	62.48%	11%	5	9
14	屏東縣來義鄉	2018-11-25T00:18:29+08:00	599	2327	2926	214	3140	5045	62.24%	11.87%	8	9
14	屏東縣來義鄉	2018-11-25T06:08:52+08:00	788	2692	3480	254	3734	6257	59.68%	12.59%	9	9
14	屏東縣來義鄉	2018-11-24T22:54:25+08:00	264	1144	1408	91	1499	2399	62.48%	11%	5	9
14	臺南市西港區	2018-11-24T23:35:03+08:00	3094	6473	9567	608	10175	21564	47.19%	14.35%	20	20
14	臺南市西港區	2018-11-24T22:33:30+08:00	3094	6473	9567	608	10175	21564	47.19%	14.35%	20	20
14	臺南市西港區	2018-11-24T23:31:02+08:00	3094	6473	9567	608	10175	21564	47.19%	14.35%	20	20
14	臺南市西港區	2018-11-24T23:39:06+08:00	3094	6473	9567	608	10175	21564	47.19%	14.35%	20	20
14	臺南市西港區	2018-11-25T01:07:19+08:00	3094	6473	9567	608	10175	21564	47.19%	14.35%	20	20
14	臺南市西港區	2018-11-25T00:14:02+08:00	3094	6473	9567	608	10175	21564	47.19%	14.35%	20	20
14	臺南市西港區	2018-11-24T23:47:20+08:00	3094	6473	9567	608	10175	21564	47.19%	14.35%	20	20
14	臺南市西港區	2018-11-24T23:43:10+08:00	3094	6473	9567	608	10175	21564	47.19%	14.35%	20	20
14	臺南市西港區	2018-11-25T06:08:44+08:00	3094	6473	9567	608	10175	21564	47.19%	14.35%	20	20
14	臺南市西港區	2018-11-24T23:01:23+08:00	3094	6473	9567	608	10175	21564	47.19%	14.35%	20	20
14	臺南市西港區	2018-11-24T23:12:08+08:00	3094	6473	9567	608	10175	21564	47.19%	14.35%	20	20
14	臺南市西港區	2018-11-24T22:57:45+08:00	3094	6473	9567	608	10175	21564	47.19%	14.35%	20	20
14	臺南市西港區	2018-11-24T23:04:57+08:00	3094	6473	9567	608	10175	21564	47.19%	14.35%	20	20
14	臺南市西港區	2018-11-24T23:23:31+08:00	3094	6473	9567	608	10175	21564	47.19%	14.35%	20	20
14	臺南市西港區	2018-11-25T00:57:29+08:00	3094	6473	9567	608	10175	21564	47.19%	14.35%	20	20
14	臺南市西港區	2018-11-24T22:13:19+08:00	3094	6473	9567	608	10175	21564	47.19%	14.35%	20	20
14	臺南市西港區	2018-11-25T03:44:14+08:00	3094	6473	9567	608	10175	21564	47.19%	14.35%	20	20
14	臺南市西港區	2018-11-25T01:17:43+08:00	3094	6473	9567	608	10175	21564	47.19%	14.35%	20	20
14	臺南市西港區	2018-11-25T00:04:57+08:00	3094	6473	9567	608	10175	21564	47.19%	14.35%	20	20
14	臺南市西港區	2018-11-24T23:55:40+08:00	3094	6473	9567	608	10175	21564	47.19%	14.35%	20	20
14	臺南市西港區	2018-11-24T23:15:55+08:00	3094	6473	9567	608	10175	21564	47.19%	14.35%	20	20
14	臺南市西港區	2018-11-25T01:02:23+08:00	3094	6473	9567	608	10175	21564	47.19%	14.35%	20	20
14	臺南市西港區	2018-11-25T01:25:45+08:00	3094	6473	9567	608	10175	21564	47.19%	14.35%	20	20
14	臺南市西港區	2018-11-25T03:38:48+08:00	3094	6473	9567	608	10175	21564	47.19%	14.35%	20	20
14	臺南市西港區	2018-11-25T06:18:50+08:00	3094	6473	9567	608	10175	21564	47.19%	14.35%	20	20
14	臺南市西港區	2018-11-24T22:40:21+08:00	3094	6473	9567	608	10175	21564	47.19%	14.35%	20	20
14	臺南市西港區	2018-11-24T22:45:01+08:00	3094	6473	9567	608	10175	21564	47.19%	14.35%	20	20
14	臺南市西港區	2018-11-25T00:18:22+08:00	3094	6473	9567	608	10175	21564	47.19%	14.35%	20	20
14	臺南市西港區	2018-11-25T00:22:56+08:00	3094	6473	9567	608	10175	21564	47.19%	14.35%	20	20
14	臺南市西港區	2018-11-24T22:54:19+08:00	3094	6473	9567	608	10175	21564	47.19%	14.35%	20	20
14	臺南市西港區	2018-11-25T03:56:03+08:00	3094	6473	9567	608	10175	21564	47.19%	14.35%	20	20
14	臺南市西港區	2018-11-24T22:16:02+08:00	3094	6473	9567	608	10175	21564	47.19%	14.35%	20	20
14	臺南市西港區	2018-11-25T01:12:34+08:00	3094	6473	9567	608	10175	21564	47.19%	14.35%	20	20
14	臺南市西港區	2018-11-24T22:50:39+08:00	3094	6473	9567	608	10175	21564	47.19%	14.35%	20	20
14	臺南市西港區	2018-11-25T00:09:25+08:00	3094	6473	9567	608	10175	21564	47.19%	14.35%	20	20
14	臺南市西港區	2018-11-24T22:41:28+08:00	3094	6473	9567	608	10175	21564	47.19%	14.35%	20	20
14	臺南市西港區	2018-11-25T04:02:41+08:00	3094	6473	9567	608	10175	21564	47.19%	14.35%	20	20
14	臺南市西港區	2018-11-25T00:00:00+08:00	3094	6473	9567	608	10175	21564	47.19%	14.35%	20	20
14	臺南市西港區	2018-11-24T23:19:41+08:00	3094	6473	9567	608	10175	21564	47.19%	14.35%	20	20
14	臺南市西港區	2018-11-24T23:51:27+08:00	3094	6473	9567	608	10175	21564	47.19%	14.35%	20	20
14	臺南市西港區	2018-11-24T22:29:58+08:00	3094	6473	9567	608	10175	21564	47.19%	14.35%	20	20
14	臺南市西港區	2018-11-24T22:23:05+08:00	3094	6473	9567	608	10175	21564	47.19%	14.35%	20	20
14	臺南市西港區	2018-11-24T22:36:54+08:00	3094	6473	9567	608	10175	21564	47.19%	14.35%	20	20
14	臺南市西港區	2018-11-25T03:32:27+08:00	3094	6473	9567	608	10175	21564	47.19%	14.35%	20	20
14	臺南市西港區	2018-11-24T23:27:11+08:00	3094	6473	9567	608	10175	21564	47.19%	14.35%	20	20
14	臺南市西港區	2018-11-24T22:19:30+08:00	3094	6473	9567	608	10175	21564	47.19%	14.35%	20	20
14	臺南市西港區	2018-11-24T23:08:27+08:00	3094	6473	9567	608	10175	21564	47.19%	14.35%	20	20
14	臺南市西港區	2018-11-25T03:49:44+08:00	3094	6473	9567	608	10175	21564	47.19%	14.35%	20	20
14	臺南市西港區	2018-11-24T22:26:30+08:00	3094	6473	9567	608	10175	21564	47.19%	14.35%	20	20
14	臺南市西港區	2018-11-25T06:29:09+08:00	3094	6473	9567	608	10175	21564	47.19%	14.35%	20	20
14	臺南市西港區	2018-11-25T06:23:53+08:00	3094	6473	9567	608	10175	21564	47.19%	14.35%	20	20
14	臺南市西港區	2018-11-25T06:13:45+08:00	3094	6473	9567	608	10175	21564	47.19%	14.35%	20	20
14	金門縣金湖鎮	2018-11-24T22:33:39+08:00	1697	5661	7358	377	7735	21300	36.31%	7.97%	14	17
14	金門縣金湖鎮	2018-11-25T03:49:52+08:00	2121	6928	9049	452	9501	25915	36.66%	8.18%	17	17
14	金門縣金湖鎮	2018-11-24T23:43:18+08:00	2121	6928	9049	452	9501	25915	36.66%	8.18%	17	17
14	金門縣金湖鎮	2018-11-25T06:29:18+08:00	2121	6928	9049	452	9501	25915	36.66%	8.18%	17	17
14	金門縣金湖鎮	2018-11-25T01:07:27+08:00	2121	6928	9049	452	9501	25915	36.66%	8.18%	17	17
14	金門縣金湖鎮	2018-11-25T06:13:53+08:00	2121	6928	9049	452	9501	25915	36.66%	8.18%	17	17
14	金門縣金湖鎮	2018-11-25T00:18:31+08:00	2121	6928	9049	452	9501	25915	36.66%	8.18%	17	17
14	金門縣金湖鎮	2018-11-25T03:44:24+08:00	2121	6928	9049	452	9501	25915	36.66%	8.18%	17	17
14	金門縣金湖鎮	2018-11-24T23:08:37+08:00	2018	6534	8552	413	8965	24405	36.73%	8.27%	16	17
14	金門縣金湖鎮	2018-11-25T03:32:36+08:00	2121	6928	9049	452	9501	25915	36.66%	8.18%	17	17
14	金門縣金湖鎮	2018-11-24T23:55:48+08:00	2121	6928	9049	452	9501	25915	36.66%	8.18%	17	17
14	金門縣金湖鎮	2018-11-24T22:13:28+08:00	1363	4455	5818	291	6109	16983	35.97%	8.03%	11	17
14	金門縣金湖鎮	2018-11-24T23:23:39+08:00	2018	6534	8552	413	8965	24405	36.73%	8.27%	16	17
14	金門縣金湖鎮	2018-11-25T06:18:58+08:00	2121	6928	9049	452	9501	25915	36.66%	8.18%	17	17
14	金門縣金湖鎮	2018-11-24T22:40:29+08:00	1697	5661	7358	377	7735	21300	36.31%	7.97%	14	17
14	金門縣金湖鎮	2018-11-24T23:51:36+08:00	2121	6928	9049	452	9501	25915	36.66%	8.18%	17	17
14	金門縣金湖鎮	2018-11-24T22:23:14+08:00	1574	5206	6780	350	7130	19897	35.83%	7.91%	13	17
14	金門縣金湖鎮	2018-11-25T00:09:35+08:00	2121	6928	9049	452	9501	25915	36.66%	8.18%	17	17
14	金門縣金湖鎮	2018-11-24T22:54:27+08:00	1697	5661	7358	377	7735	21300	36.31%	7.97%	14	17
14	金門縣金湖鎮	2018-11-25T00:14:11+08:00	2121	6928	9049	452	9501	25915	36.66%	8.18%	17	17
14	金門縣金湖鎮	2018-11-25T00:05:06+08:00	2121	6928	9049	452	9501	25915	36.66%	8.18%	17	17
14	金門縣金湖鎮	2018-11-24T22:41:36+08:00	1697	5661	7358	377	7735	21300	36.31%	7.97%	14	17
14	金門縣金湖鎮	2018-11-24T22:16:12+08:00	1363	4455	5818	291	6109	16983	35.97%	8.03%	11	17
14	金門縣金湖鎮	2018-11-24T22:45:10+08:00	1697	5661	7358	377	7735	21300	36.31%	7.97%	14	17
14	金門縣金湖鎮	2018-11-25T03:56:14+08:00	2121	6928	9049	452	9501	25915	36.66%	8.18%	17	17
14	金門縣金湖鎮	2018-11-24T22:37:02+08:00	1697	5661	7358	377	7735	21300	36.31%	7.97%	14	17
14	金門縣金湖鎮	2018-11-24T23:16:04+08:00	2018	6534	8552	413	8965	24405	36.73%	8.27%	16	17
14	金門縣金湖鎮	2018-11-25T00:23:05+08:00	2121	6928	9049	452	9501	25915	36.66%	8.18%	17	17
14	金門縣金湖鎮	2018-11-25T01:25:54+08:00	2121	6928	9049	452	9501	25915	36.66%	8.18%	17	17
14	金門縣金湖鎮	2018-11-25T01:02:32+08:00	2121	6928	9049	452	9501	25915	36.66%	8.18%	17	17
14	金門縣金湖鎮	2018-11-24T22:30:10+08:00	1574	5206	6780	350	7130	19897	35.83%	7.91%	13	17
14	金門縣金湖鎮	2018-11-25T06:24:01+08:00	2121	6928	9049	452	9501	25915	36.66%	8.18%	17	17
14	金門縣金湖鎮	2018-11-25T03:38:56+08:00	2121	6928	9049	452	9501	25915	36.66%	8.18%	17	17
14	金門縣金湖鎮	2018-11-24T23:27:19+08:00	2018	6534	8552	413	8965	24405	36.73%	8.27%	16	17
14	金門縣金湖鎮	2018-11-24T22:19:38+08:00	1447	4826	6273	329	6602	18497	35.69%	7.82%	12	17
14	金門縣金湖鎮	2018-11-24T23:19:53+08:00	2018	6534	8552	413	8965	24405	36.73%	8.27%	16	17
14	金門縣金湖鎮	2018-11-25T01:17:54+08:00	2121	6928	9049	452	9501	25915	36.66%	8.18%	17	17
14	金門縣金湖鎮	2018-11-25T00:00:12+08:00	2121	6928	9049	452	9501	25915	36.66%	8.18%	17	17
14	金門縣金湖鎮	2018-11-24T22:57:55+08:00	2018	6534	8552	413	8965	24405	36.73%	8.27%	16	17
14	金門縣金湖鎮	2018-11-25T00:57:38+08:00	2121	6928	9049	452	9501	25915	36.66%	8.18%	17	17
14	金門縣金湖鎮	2018-11-24T23:35:12+08:00	2018	6534	8552	413	8965	24405	36.73%	8.27%	16	17
14	金門縣金湖鎮	2018-11-24T23:47:30+08:00	2121	6928	9049	452	9501	25915	36.66%	8.18%	17	17
14	金門縣金湖鎮	2018-11-25T06:08:54+08:00	2121	6928	9049	452	9501	25915	36.66%	8.18%	17	17
14	金門縣金湖鎮	2018-11-24T23:39:17+08:00	2018	6534	8552	413	8965	24405	36.73%	8.27%	16	17
14	金門縣金湖鎮	2018-11-24T22:50:49+08:00	1697	5661	7358	377	7735	21300	36.31%	7.97%	14	17
14	金門縣金湖鎮	2018-11-24T23:31:13+08:00	2018	6534	8552	413	8965	24405	36.73%	8.27%	16	17
14	金門縣金湖鎮	2018-11-25T04:02:53+08:00	2121	6928	9049	452	9501	25915	36.66%	8.18%	17	17
14	金門縣金湖鎮	2018-11-24T23:05:05+08:00	2018	6534	8552	413	8965	24405	36.73%	8.27%	16	17
14	金門縣金湖鎮	2018-11-24T23:01:32+08:00	2018	6534	8552	413	8965	24405	36.73%	8.27%	16	17
14	金門縣金湖鎮	2018-11-25T01:12:45+08:00	2121	6928	9049	452	9501	25915	36.66%	8.18%	17	17
14	金門縣金湖鎮	2018-11-24T22:26:38+08:00	1574	5206	6780	350	7130	19897	35.83%	7.91%	13	17
14	金門縣金湖鎮	2018-11-24T23:12:17+08:00	2018	6534	8552	413	8965	24405	36.73%	8.27%	16	17
14	嘉義縣竹崎鄉	2018-11-25T03:56:10+08:00	4207	10831	15038	1092	16130	31228	51.65%	13.47%	36	36
14	嘉義縣竹崎鄉	2018-11-24T23:47:26+08:00	4052	10367	14419	1042	15461	29936	51.65%	13.54%	35	36
14	嘉義縣竹崎鄉	2018-11-24T23:16:01+08:00	3642	9302	12944	930	13874	27108	51.18%	13.44%	33	36
14	嘉義縣竹崎鄉	2018-11-24T22:16:08+08:00	2658	6685	9343	681	10024	19886	50.41%	13.37%	27	36
14	嘉義縣竹崎鄉	2018-11-24T22:33:36+08:00	3296	8415	11711	878	12589	24691	50.99%	13.35%	31	36
14	嘉義縣竹崎鄉	2018-11-25T03:38:53+08:00	4207	10831	15038	1092	16130	31228	51.65%	13.47%	36	36
14	嘉義縣竹崎鄉	2018-11-24T23:23:36+08:00	3771	9604	13375	984	14359	27941	51.39%	13.5%	34	36
14	嘉義縣竹崎鄉	2018-11-25T01:25:51+08:00	4207	10831	15038	1092	16130	31228	51.65%	13.47%	36	36
14	嘉義縣竹崎鄉	2018-11-24T22:19:35+08:00	2778	7045	9823	730	10553	20917	50.45%	13.28%	28	36
14	嘉義縣竹崎鄉	2018-11-25T01:17:50+08:00	4207	10831	15038	1092	16130	31228	51.65%	13.47%	36	36
14	嘉義縣竹崎鄉	2018-11-24T22:40:26+08:00	3296	8415	11711	878	12589	24691	50.99%	13.35%	31	36
14	嘉義縣竹崎鄉	2018-11-25T00:57:35+08:00	4207	10831	15038	1092	16130	31228	51.65%	13.47%	36	36
14	嘉義縣竹崎鄉	2018-11-24T22:36:58+08:00	3296	8415	11711	878	12589	24691	50.99%	13.35%	31	36
14	嘉義縣竹崎鄉	2018-11-24T22:57:51+08:00	3642	9302	12944	930	13874	27108	51.18%	13.44%	33	36
14	嘉義縣竹崎鄉	2018-11-25T00:09:32+08:00	4052	10367	14419	1042	15461	29936	51.65%	13.54%	35	36
14	嘉義縣竹崎鄉	2018-11-25T06:08:50+08:00	4207	10831	15038	1092	16130	31228	51.65%	13.47%	36	36
14	嘉義縣竹崎鄉	2018-11-25T06:23:58+08:00	4207	10831	15038	1092	16130	31228	51.65%	13.47%	36	36
14	嘉義縣竹崎鄉	2018-11-24T23:39:13+08:00	3771	9604	13375	984	14359	27941	51.39%	13.5%	34	36
14	嘉義縣竹崎鄉	2018-11-25T03:49:49+08:00	4207	10831	15038	1092	16130	31228	51.65%	13.47%	36	36
14	嘉義縣竹崎鄉	2018-11-25T01:12:41+08:00	4207	10831	15038	1092	16130	31228	51.65%	13.47%	36	36
14	嘉義縣竹崎鄉	2018-11-24T22:26:35+08:00	3077	7814	10891	832	11723	23101	50.75%	13.32%	30	36
14	嘉義縣竹崎鄉	2018-11-24T23:12:14+08:00	3642	9302	12944	930	13874	27108	51.18%	13.44%	33	36
14	嘉義縣竹崎鄉	2018-11-24T22:45:07+08:00	3296	8415	11711	878	12589	24691	50.99%	13.35%	31	36
14	嘉義縣竹崎鄉	2018-11-25T04:02:50+08:00	4207	10831	15038	1092	16130	31228	51.65%	13.47%	36	36
14	嘉義縣竹崎鄉	2018-11-24T23:43:15+08:00	4052	10367	14419	1042	15461	29936	51.65%	13.54%	35	36
14	嘉義縣竹崎鄉	2018-11-25T00:14:07+08:00	4052	10367	14419	1042	15461	29936	51.65%	13.54%	35	36
14	嘉義縣竹崎鄉	2018-11-24T23:01:29+08:00	3642	9302	12944	930	13874	27108	51.18%	13.44%	33	36
14	嘉義縣竹崎鄉	2018-11-25T01:07:24+08:00	4207	10831	15038	1092	16130	31228	51.65%	13.47%	36	36
14	嘉義縣竹崎鄉	2018-11-24T23:31:09+08:00	3771	9604	13375	984	14359	27941	51.39%	13.5%	34	36
14	嘉義縣竹崎鄉	2018-11-25T06:13:50+08:00	4207	10831	15038	1092	16130	31228	51.65%	13.47%	36	36
14	嘉義縣竹崎鄉	2018-11-24T23:35:08+08:00	3771	9604	13375	984	14359	27941	51.39%	13.5%	34	36
14	嘉義縣竹崎鄉	2018-11-25T06:29:15+08:00	4207	10831	15038	1092	16130	31228	51.65%	13.47%	36	36
14	嘉義縣竹崎鄉	2018-11-24T23:55:45+08:00	4052	10367	14419	1042	15461	29936	51.65%	13.54%	35	36
14	嘉義縣竹崎鄉	2018-11-24T23:08:34+08:00	3642	9302	12944	930	13874	27108	51.18%	13.44%	33	36
14	嘉義縣竹崎鄉	2018-11-25T00:00:09+08:00	4052	10367	14419	1042	15461	29936	51.65%	13.54%	35	36
14	嘉義縣竹崎鄉	2018-11-25T00:23:02+08:00	4207	10831	15038	1092	16130	31228	51.65%	13.47%	36	36
14	嘉義縣竹崎鄉	2018-11-24T23:19:48+08:00	3642	9302	12944	930	13874	27108	51.18%	13.44%	33	36
14	嘉義縣竹崎鄉	2018-11-25T03:32:33+08:00	4207	10831	15038	1092	16130	31228	51.65%	13.47%	36	36
14	嘉義縣竹崎鄉	2018-11-25T03:44:21+08:00	4207	10831	15038	1092	16130	31228	51.65%	13.47%	36	36
14	嘉義縣竹崎鄉	2018-11-24T22:13:25+08:00	2658	6685	9343	681	10024	19886	50.41%	13.37%	27	36
14	嘉義縣竹崎鄉	2018-11-24T22:23:11+08:00	2984	7571	10555	813	11368	22485	50.56%	13.27%	29	36
14	嘉義縣竹崎鄉	2018-11-24T23:27:17+08:00	3771	9604	13375	984	14359	27941	51.39%	13.5%	34	36
14	嘉義縣竹崎鄉	2018-11-24T23:51:33+08:00	4052	10367	14419	1042	15461	29936	51.65%	13.54%	35	36
14	嘉義縣竹崎鄉	2018-11-25T06:18:55+08:00	4207	10831	15038	1092	16130	31228	51.65%	13.47%	36	36
14	嘉義縣竹崎鄉	2018-11-25T01:02:28+08:00	4207	10831	15038	1092	16130	31228	51.65%	13.47%	36	36
14	嘉義縣竹崎鄉	2018-11-24T22:30:04+08:00	3077	7814	10891	832	11723	23101	50.75%	13.32%	30	36
14	嘉義縣竹崎鄉	2018-11-24T23:05:03+08:00	3642	9302	12944	930	13874	27108	51.18%	13.44%	33	36
14	嘉義縣竹崎鄉	2018-11-24T22:54:24+08:00	3474	8870	12344	900	13244	25901	51.13%	13.41%	32	36
14	嘉義縣竹崎鄉	2018-11-25T00:18:28+08:00	4207	10831	15038	1092	16130	31228	51.65%	13.47%	36	36
14	嘉義縣竹崎鄉	2018-11-24T22:41:33+08:00	3296	8415	11711	878	12589	24691	50.99%	13.35%	31	36
14	嘉義縣竹崎鄉	2018-11-25T00:05:03+08:00	4052	10367	14419	1042	15461	29936	51.65%	13.54%	35	36
14	嘉義縣竹崎鄉	2018-11-24T22:50:46+08:00	3296	8415	11711	878	12589	24691	50.99%	13.35%	31	36
14	嘉義縣大林鎮	2018-11-24T23:47:26+08:00	3630	8360	11990	930	12920	25099	51.48%	14.46%	24	25
14	嘉義縣大林鎮	2018-11-24T22:16:08+08:00	2500	5962	8462	685	9147	18073	50.61%	13.83%	19	25
14	嘉義縣大林鎮	2018-11-24T23:16:00+08:00	3056	7248	10304	834	11138	21790	51.12%	14.02%	22	25
14	嘉義縣大林鎮	2018-11-25T01:25:50+08:00	3920	9033	12953	988	13941	26922	51.78%	14.56%	25	25
14	嘉義縣大林鎮	2018-11-25T03:38:53+08:00	3920	9033	12953	988	13941	26922	51.78%	14.56%	25	25
14	嘉義縣大林鎮	2018-11-25T00:23:01+08:00	3920	9033	12953	988	13941	26922	51.78%	14.56%	25	25
14	嘉義縣大林鎮	2018-11-24T23:23:36+08:00	3418	7851	11269	890	12159	23520	51.7%	14.53%	23	25
14	嘉義縣大林鎮	2018-11-24T22:19:35+08:00	2500	5962	8462	685	9147	18073	50.61%	13.83%	19	25
14	嘉義縣大林鎮	2018-11-25T00:57:34+08:00	3920	9033	12953	988	13941	26922	51.78%	14.56%	25	25
14	嘉義縣大林鎮	2018-11-24T22:40:26+08:00	2878	6729	9607	772	10379	20325	51.07%	14.16%	21	25
14	嘉義縣大林鎮	2018-11-24T22:36:58+08:00	2878	6729	9607	772	10379	20325	51.07%	14.16%	21	25
14	嘉義縣大林鎮	2018-11-24T22:57:51+08:00	2878	6729	9607	772	10379	20325	51.07%	14.16%	21	25
14	嘉義縣大林鎮	2018-11-25T00:09:32+08:00	3630	8360	11990	930	12920	25099	51.48%	14.46%	24	25
14	嘉義縣大林鎮	2018-11-24T22:45:06+08:00	2878	6729	9607	772	10379	20325	51.07%	14.16%	21	25
14	嘉義縣大林鎮	2018-11-25T06:08:50+08:00	3920	9033	12953	988	13941	26922	51.78%	14.56%	25	25
14	嘉義縣大林鎮	2018-11-25T06:23:58+08:00	3920	9033	12953	988	13941	26922	51.78%	14.56%	25	25
14	嘉義縣大林鎮	2018-11-24T23:39:13+08:00	3630	8360	11990	930	12920	25099	51.48%	14.46%	24	25
14	嘉義縣大林鎮	2018-11-25T03:49:49+08:00	3920	9033	12953	988	13941	26922	51.78%	14.56%	25	25
14	嘉義縣大林鎮	2018-11-25T01:12:41+08:00	3920	9033	12953	988	13941	26922	51.78%	14.56%	25	25
14	嘉義縣大林鎮	2018-11-24T22:26:35+08:00	2500	5962	8462	685	9147	18073	50.61%	13.83%	19	25
14	嘉義縣大林鎮	2018-11-24T22:50:45+08:00	2878	6729	9607	772	10379	20325	51.07%	14.16%	21	25
14	嘉義縣大林鎮	2018-11-24T23:12:13+08:00	3056	7248	10304	834	11138	21790	51.12%	14.02%	22	25
14	嘉義縣大林鎮	2018-11-25T04:02:50+08:00	3920	9033	12953	988	13941	26922	51.78%	14.56%	25	25
14	嘉義縣大林鎮	2018-11-24T23:43:15+08:00	3630	8360	11990	930	12920	25099	51.48%	14.46%	24	25
14	嘉義縣大林鎮	2018-11-25T06:29:14+08:00	3920	9033	12953	988	13941	26922	51.78%	14.56%	25	25
14	嘉義縣大林鎮	2018-11-25T00:14:07+08:00	3920	9033	12953	988	13941	26922	51.78%	14.56%	25	25
14	嘉義縣大林鎮	2018-11-24T23:01:29+08:00	2878	6729	9607	772	10379	20325	51.07%	14.16%	21	25
14	嘉義縣大林鎮	2018-11-25T01:07:24+08:00	3920	9033	12953	988	13941	26922	51.78%	14.56%	25	25
14	嘉義縣大林鎮	2018-11-24T23:31:09+08:00	3630	8360	11990	930	12920	25099	51.48%	14.46%	24	25
14	嘉義縣大林鎮	2018-11-25T06:13:50+08:00	3920	9033	12953	988	13941	26922	51.78%	14.56%	25	25
14	嘉義縣大林鎮	2018-11-24T23:35:08+08:00	3630	8360	11990	930	12920	25099	51.48%	14.46%	24	25
14	嘉義縣大林鎮	2018-11-24T22:33:35+08:00	2878	6729	9607	772	10379	20325	51.07%	14.16%	21	25
14	嘉義縣大林鎮	2018-11-24T23:08:33+08:00	3056	7248	10304	834	11138	21790	51.12%	14.02%	22	25
14	嘉義縣大林鎮	2018-11-25T03:32:32+08:00	3920	9033	12953	988	13941	26922	51.78%	14.56%	25	25
14	嘉義縣大林鎮	2018-11-24T23:19:48+08:00	3056	7248	10304	834	11138	21790	51.12%	14.02%	22	25
14	嘉義縣大林鎮	2018-11-25T03:44:20+08:00	3920	9033	12953	988	13941	26922	51.78%	14.56%	25	25
14	嘉義縣大林鎮	2018-11-24T22:13:24+08:00	2500	5962	8462	685	9147	18073	50.61%	13.83%	19	25
14	嘉義縣大林鎮	2018-11-25T00:00:08+08:00	3630	8360	11990	930	12920	25099	51.48%	14.46%	24	25
14	嘉義縣大林鎮	2018-11-24T23:55:44+08:00	3630	8360	11990	930	12920	25099	51.48%	14.46%	24	25
14	嘉義縣大林鎮	2018-11-25T01:17:49+08:00	3920	9033	12953	988	13941	26922	51.78%	14.56%	25	25
14	嘉義縣大林鎮	2018-11-25T06:18:55+08:00	3920	9033	12953	988	13941	26922	51.78%	14.56%	25	25
14	嘉義縣大林鎮	2018-11-25T01:02:28+08:00	3920	9033	12953	988	13941	26922	51.78%	14.56%	25	25
14	嘉義縣大林鎮	2018-11-24T23:27:16+08:00	3630	8360	11990	930	12920	25099	51.48%	14.46%	24	25
14	嘉義縣大林鎮	2018-11-24T22:30:04+08:00	2771	6521	9292	731	10023	19609	51.11%	14.13%	20	25
14	嘉義縣大林鎮	2018-11-24T22:23:10+08:00	2500	5962	8462	685	9147	18073	50.61%	13.83%	19	25
14	嘉義縣大林鎮	2018-11-24T23:51:32+08:00	3630	8360	11990	930	12920	25099	51.48%	14.46%	24	25
14	嘉義縣大林鎮	2018-11-25T00:05:02+08:00	3630	8360	11990	930	12920	25099	51.48%	14.46%	24	25
14	嘉義縣大林鎮	2018-11-24T22:54:23+08:00	2878	6729	9607	772	10379	20325	51.07%	14.16%	21	25
14	嘉義縣大林鎮	2018-11-24T22:41:33+08:00	2878	6729	9607	772	10379	20325	51.07%	14.16%	21	25
14	嘉義縣大林鎮	2018-11-24T23:05:02+08:00	3056	7248	10304	834	11138	21790	51.12%	14.02%	22	25
14	嘉義縣大林鎮	2018-11-25T03:56:09+08:00	3920	9033	12953	988	13941	26922	51.78%	14.56%	25	25
14	嘉義縣大林鎮	2018-11-25T00:18:27+08:00	3920	9033	12953	988	13941	26922	51.78%	14.56%	25	25
14	宜蘭縣冬山鄉	2018-11-24T22:33:37+08:00	5455	11350	16805	1108	17913	33056	54.19%	16.5%	30	39
14	宜蘭縣冬山鄉	2018-11-24T23:47:28+08:00	7310	14864	22174	1408	23582	43679	53.99%	16.74%	38	39
14	宜蘭縣冬山鄉	2018-11-24T22:37:00+08:00	5636	11762	17398	1145	18543	34303	54.06%	16.43%	31	39
14	宜蘭縣冬山鄉	2018-11-25T00:18:30+08:00	7599	15447	23046	1445	24491	45405	53.94%	16.74%	39	39
14	宜蘭縣冬山鄉	2018-11-25T01:07:26+08:00	7599	15447	23046	1445	24491	45405	53.94%	16.74%	39	39
14	宜蘭縣冬山鄉	2018-11-25T06:13:52+08:00	7599	15447	23046	1445	24491	45405	53.94%	16.74%	39	39
14	宜蘭縣冬山鄉	2018-11-25T06:29:16+08:00	7599	15447	23046	1445	24491	45405	53.94%	16.74%	39	39
14	宜蘭縣冬山鄉	2018-11-24T23:43:17+08:00	7310	14864	22174	1408	23582	43679	53.99%	16.74%	38	39
14	宜蘭縣冬山鄉	2018-11-25T01:02:31+08:00	7599	15447	23046	1445	24491	45405	53.94%	16.74%	39	39
14	宜蘭縣冬山鄉	2018-11-24T23:55:46+08:00	7310	14864	22174	1408	23582	43679	53.99%	16.74%	38	39
14	宜蘭縣冬山鄉	2018-11-24T23:23:38+08:00	6895	13966	20861	1324	22185	40749	54.44%	16.92%	36	39
14	宜蘭縣冬山鄉	2018-11-25T03:38:55+08:00	7599	15447	23046	1445	24491	45405	53.94%	16.74%	39	39
14	宜蘭縣冬山鄉	2018-11-25T03:44:22+08:00	7599	15447	23046	1445	24491	45405	53.94%	16.74%	39	39
14	宜蘭縣冬山鄉	2018-11-24T22:13:26+08:00	4432	9308	13740	888	14628	27101	53.98%	16.35%	25	39
14	宜蘭縣冬山鄉	2018-11-24T23:08:36+08:00	6544	13513	20057	1289	21346	39278	54.35%	16.66%	35	39
14	宜蘭縣冬山鄉	2018-11-24T22:30:08+08:00	5034	10595	15629	1018	16647	30612	54.38%	16.44%	28	39
14	宜蘭縣冬山鄉	2018-11-24T22:40:27+08:00	5878	12262	18140	1184	19324	35822	53.94%	16.41%	32	39
14	宜蘭縣冬山鄉	2018-11-25T00:00:10+08:00	7310	14864	22174	1408	23582	43679	53.99%	16.74%	38	39
14	宜蘭縣冬山鄉	2018-11-25T06:18:57+08:00	7599	15447	23046	1445	24491	45405	53.94%	16.74%	39	39
14	宜蘭縣冬山鄉	2018-11-24T22:23:13+08:00	4760	9973	14733	954	15687	29086	53.93%	16.37%	27	39
14	宜蘭縣冬山鄉	2018-11-24T23:19:51+08:00	6895	13966	20861	1324	22185	40749	54.44%	16.92%	36	39
14	宜蘭縣冬山鄉	2018-11-24T23:12:15+08:00	6544	13513	20057	1289	21346	39278	54.35%	16.66%	35	39
14	宜蘭縣冬山鄉	2018-11-24T22:45:08+08:00	5878	12262	18140	1184	19324	35822	53.94%	16.41%	32	39
14	宜蘭縣冬山鄉	2018-11-24T23:01:30+08:00	6544	13513	20057	1289	21346	39278	54.35%	16.66%	35	39
14	宜蘭縣冬山鄉	2018-11-24T23:39:15+08:00	7310	14864	22174	1408	23582	43679	53.99%	16.74%	38	39
14	宜蘭縣冬山鄉	2018-11-24T23:31:11+08:00	7112	14419	21531	1374	22905	42244	54.22%	16.84%	37	39
14	宜蘭縣冬山鄉	2018-11-25T00:09:34+08:00	7599	15447	23046	1445	24491	45405	53.94%	16.74%	39	39
14	宜蘭縣冬山鄉	2018-11-24T23:35:10+08:00	7310	14864	22174	1408	23582	43679	53.99%	16.74%	38	39
14	宜蘭縣冬山鄉	2018-11-25T00:14:09+08:00	7599	15447	23046	1445	24491	45405	53.94%	16.74%	39	39
14	宜蘭縣冬山鄉	2018-11-25T03:49:51+08:00	7599	15447	23046	1445	24491	45405	53.94%	16.74%	39	39
14	宜蘭縣冬山鄉	2018-11-24T23:16:02+08:00	6895	13966	20861	1324	22185	40749	54.44%	16.92%	36	39
14	宜蘭縣冬山鄉	2018-11-25T03:56:12+08:00	7599	15447	23046	1445	24491	45405	53.94%	16.74%	39	39
14	宜蘭縣冬山鄉	2018-11-25T06:24:00+08:00	7599	15447	23046	1445	24491	45405	53.94%	16.74%	39	39
14	宜蘭縣冬山鄉	2018-11-25T00:23:03+08:00	7599	15447	23046	1445	24491	45405	53.94%	16.74%	39	39
14	宜蘭縣冬山鄉	2018-11-25T03:32:34+08:00	7599	15447	23046	1445	24491	45405	53.94%	16.74%	39	39
14	宜蘭縣冬山鄉	2018-11-25T01:25:52+08:00	7599	15447	23046	1445	24491	45405	53.94%	16.74%	39	39
14	宜蘭縣冬山鄉	2018-11-24T22:57:53+08:00	6544	13513	20057	1289	21346	39278	54.35%	16.66%	35	39
14	宜蘭縣冬山鄉	2018-11-24T22:19:37+08:00	4760	9973	14733	954	15687	29086	53.93%	16.37%	27	39
14	宜蘭縣冬山鄉	2018-11-25T00:57:36+08:00	7599	15447	23046	1445	24491	45405	53.94%	16.74%	39	39
14	宜蘭縣冬山鄉	2018-11-25T01:17:52+08:00	7599	15447	23046	1445	24491	45405	53.94%	16.74%	39	39
14	宜蘭縣冬山鄉	2018-11-24T23:27:18+08:00	6895	13966	20861	1324	22185	40749	54.44%	16.92%	36	39
14	宜蘭縣冬山鄉	2018-11-24T23:51:35+08:00	7310	14864	22174	1408	23582	43679	53.99%	16.74%	38	39
14	宜蘭縣冬山鄉	2018-11-24T23:05:04+08:00	6544	13513	20057	1289	21346	39278	54.35%	16.66%	35	39
14	宜蘭縣冬山鄉	2018-11-25T04:02:52+08:00	7599	15447	23046	1445	24491	45405	53.94%	16.74%	39	39
14	宜蘭縣冬山鄉	2018-11-24T22:16:10+08:00	4573	9626	14199	921	15120	27985	54.03%	16.34%	26	39
14	宜蘭縣冬山鄉	2018-11-25T01:12:43+08:00	7599	15447	23046	1445	24491	45405	53.94%	16.74%	39	39
14	宜蘭縣冬山鄉	2018-11-25T00:05:04+08:00	7310	14864	22174	1408	23582	43679	53.99%	16.74%	38	39
14	宜蘭縣冬山鄉	2018-11-24T22:41:34+08:00	5878	12262	18140	1184	19324	35822	53.94%	16.41%	32	39
14	宜蘭縣冬山鄉	2018-11-24T22:50:48+08:00	6123	12805	18928	1236	20164	37214	54.18%	16.45%	33	39
14	宜蘭縣冬山鄉	2018-11-24T22:26:36+08:00	5034	10595	15629	1018	16647	30612	54.38%	16.44%	28	39
14	宜蘭縣冬山鄉	2018-11-25T06:08:52+08:00	7599	15447	23046	1445	24491	45405	53.94%	16.74%	39	39
14	宜蘭縣冬山鄉	2018-11-24T22:54:25+08:00	6123	12805	18928	1236	20164	37214	54.18%	16.45%	33	39
14	高雄市美濃區	2018-11-25T04:02:43+08:00	4763	13154	17917	1568	19485	35311	55.18%	13.49%	32	32
14	高雄市美濃區	2018-11-25T01:12:37+08:00	4763	13154	17917	1568	19485	35311	55.18%	13.49%	32	32
14	高雄市美濃區	2018-11-25T00:14:04+08:00	4763	13154	17917	1568	19485	35311	55.18%	13.49%	32	32
14	高雄市美濃區	2018-11-24T23:01:25+08:00	4763	13154	17917	1568	19485	35311	55.18%	13.49%	32	32
14	高雄市美濃區	2018-11-25T01:07:21+08:00	4763	13154	17917	1568	19485	35311	55.18%	13.49%	32	32
14	高雄市美濃區	2018-11-24T23:35:05+08:00	4763	13154	17917	1568	19485	35311	55.18%	13.49%	32	32
14	高雄市美濃區	2018-11-25T06:29:11+08:00	4763	13154	17917	1568	19485	35311	55.18%	13.49%	32	32
14	高雄市美濃區	2018-11-24T23:39:09+08:00	4763	13154	17917	1568	19485	35311	55.18%	13.49%	32	32
14	高雄市美濃區	2018-11-24T23:31:04+08:00	4763	13154	17917	1568	19485	35311	55.18%	13.49%	32	32
14	高雄市美濃區	2018-11-25T00:09:28+08:00	4763	13154	17917	1568	19485	35311	55.18%	13.49%	32	32
14	高雄市美濃區	2018-11-25T01:17:45+08:00	4763	13154	17917	1568	19485	35311	55.18%	13.49%	32	32
14	高雄市美濃區	2018-11-24T22:23:07+08:00	4433	12212	16645	1508	18153	32621	55.65%	13.59%	30	32
14	高雄市美濃區	2018-11-24T23:55:41+08:00	4763	13154	17917	1568	19485	35311	55.18%	13.49%	32	32
14	高雄市美濃區	2018-11-24T23:08:30+08:00	4763	13154	17917	1568	19485	35311	55.18%	13.49%	32	32
14	高雄市美濃區	2018-11-24T23:19:44+08:00	4763	13154	17917	1568	19485	35311	55.18%	13.49%	32	32
14	高雄市美濃區	2018-11-24T22:13:21+08:00	4227	11586	15813	1460	17273	31072	55.59%	13.6%	29	32
14	高雄市美濃區	2018-11-24T23:04:58+08:00	4763	13154	17917	1568	19485	35311	55.18%	13.49%	32	32
14	高雄市美濃區	2018-11-25T00:00:02+08:00	4763	13154	17917	1568	19485	35311	55.18%	13.49%	32	32
14	高雄市美濃區	2018-11-25T00:04:59+08:00	4763	13154	17917	1568	19485	35311	55.18%	13.49%	32	32
14	高雄市美濃區	2018-11-24T23:27:13+08:00	4763	13154	17917	1568	19485	35311	55.18%	13.49%	32	32
14	高雄市美濃區	2018-11-24T22:19:32+08:00	4433	12212	16645	1508	18153	32621	55.65%	13.59%	30	32
14	高雄市美濃區	2018-11-24T22:30:00+08:00	4604	12721	17325	1544	18869	34059	55.4%	13.52%	31	32
14	高雄市美濃區	2018-11-25T01:02:25+08:00	4763	13154	17917	1568	19485	35311	55.18%	13.49%	32	32
14	高雄市美濃區	2018-11-25T06:13:47+08:00	4763	13154	17917	1568	19485	35311	55.18%	13.49%	32	32
14	高雄市美濃區	2018-11-25T00:22:58+08:00	4763	13154	17917	1568	19485	35311	55.18%	13.49%	32	32
14	高雄市美濃區	2018-11-24T22:26:32+08:00	4604	12721	17325	1544	18869	34059	55.4%	13.52%	31	32
14	高雄市美濃區	2018-11-25T00:18:24+08:00	4763	13154	17917	1568	19485	35311	55.18%	13.49%	32	32
14	高雄市美濃區	2018-11-24T22:50:42+08:00	4763	13154	17917	1568	19485	35311	55.18%	13.49%	32	32
14	高雄市美濃區	2018-11-24T22:54:21+08:00	4763	13154	17917	1568	19485	35311	55.18%	13.49%	32	32
14	高雄市美濃區	2018-11-24T22:41:30+08:00	4604	12721	17325	1544	18869	34059	55.4%	13.52%	31	32
14	高雄市美濃區	2018-11-25T03:49:46+08:00	4763	13154	17917	1568	19485	35311	55.18%	13.49%	32	32
14	高雄市美濃區	2018-11-25T06:08:46+08:00	4763	13154	17917	1568	19485	35311	55.18%	13.49%	32	32
14	高雄市美濃區	2018-11-24T23:43:12+08:00	4763	13154	17917	1568	19485	35311	55.18%	13.49%	32	32
14	高雄市美濃區	2018-11-24T23:47:22+08:00	4763	13154	17917	1568	19485	35311	55.18%	13.49%	32	32
14	高雄市美濃區	2018-11-24T22:16:04+08:00	4227	11586	15813	1460	17273	31072	55.59%	13.6%	29	32
14	高雄市美濃區	2018-11-24T22:33:32+08:00	4604	12721	17325	1544	18869	34059	55.4%	13.52%	31	32
14	高雄市美濃區	2018-11-25T03:44:16+08:00	4763	13154	17917	1568	19485	35311	55.18%	13.49%	32	32
14	高雄市美濃區	2018-11-25T03:38:50+08:00	4763	13154	17917	1568	19485	35311	55.18%	13.49%	32	32
14	高雄市美濃區	2018-11-24T23:23:33+08:00	4763	13154	17917	1568	19485	35311	55.18%	13.49%	32	32
14	高雄市美濃區	2018-11-24T23:51:29+08:00	4763	13154	17917	1568	19485	35311	55.18%	13.49%	32	32
14	高雄市美濃區	2018-11-24T22:57:47+08:00	4763	13154	17917	1568	19485	35311	55.18%	13.49%	32	32
14	高雄市美濃區	2018-11-24T22:40:23+08:00	4604	12721	17325	1544	18869	34059	55.4%	13.52%	31	32
14	高雄市美濃區	2018-11-25T03:32:29+08:00	4763	13154	17917	1568	19485	35311	55.18%	13.49%	32	32
14	高雄市美濃區	2018-11-25T06:18:52+08:00	4763	13154	17917	1568	19485	35311	55.18%	13.49%	32	32
14	高雄市美濃區	2018-11-24T23:15:58+08:00	4763	13154	17917	1568	19485	35311	55.18%	13.49%	32	32
14	高雄市美濃區	2018-11-25T00:57:31+08:00	4763	13154	17917	1568	19485	35311	55.18%	13.49%	32	32
14	高雄市美濃區	2018-11-25T01:25:47+08:00	4763	13154	17917	1568	19485	35311	55.18%	13.49%	32	32
14	高雄市美濃區	2018-11-24T22:36:55+08:00	4604	12721	17325	1544	18869	34059	55.4%	13.52%	31	32
14	高雄市美濃區	2018-11-25T03:56:06+08:00	4763	13154	17917	1568	19485	35311	55.18%	13.49%	32	32
14	高雄市美濃區	2018-11-25T06:23:55+08:00	4763	13154	17917	1568	19485	35311	55.18%	13.49%	32	32
14	高雄市美濃區	2018-11-24T23:12:10+08:00	4763	13154	17917	1568	19485	35311	55.18%	13.49%	32	32
14	高雄市美濃區	2018-11-24T22:45:03+08:00	4604	12721	17325	1544	18869	34059	55.4%	13.52%	31	32
14	高雄市燕巢區	2018-11-25T04:02:43+08:00	4238	9634	13872	1058	14930	26012	57.4%	16.29%	25	25
14	高雄市燕巢區	2018-11-25T06:29:10+08:00	4238	9634	13872	1058	14930	26012	57.4%	16.29%	25	25
14	高雄市燕巢區	2018-11-25T00:14:03+08:00	4238	9634	13872	1058	14930	26012	57.4%	16.29%	25	25
14	高雄市燕巢區	2018-11-24T23:01:25+08:00	4238	9634	13872	1058	14930	26012	57.4%	16.29%	25	25
14	高雄市燕巢區	2018-11-24T23:12:09+08:00	4238	9634	13872	1058	14930	26012	57.4%	16.29%	25	25
14	高雄市燕巢區	2018-11-24T23:39:08+08:00	4238	9634	13872	1058	14930	26012	57.4%	16.29%	25	25
14	高雄市燕巢區	2018-11-25T00:09:27+08:00	4238	9634	13872	1058	14930	26012	57.4%	16.29%	25	25
14	高雄市燕巢區	2018-11-25T01:12:36+08:00	4238	9634	13872	1058	14930	26012	57.4%	16.29%	25	25
14	高雄市燕巢區	2018-11-24T23:35:05+08:00	4238	9634	13872	1058	14930	26012	57.4%	16.29%	25	25
14	高雄市燕巢區	2018-11-25T01:07:20+08:00	4238	9634	13872	1058	14930	26012	57.4%	16.29%	25	25
14	高雄市燕巢區	2018-11-24T23:31:04+08:00	4238	9634	13872	1058	14930	26012	57.4%	16.29%	25	25
14	高雄市燕巢區	2018-11-25T01:17:45+08:00	4238	9634	13872	1058	14930	26012	57.4%	16.29%	25	25
14	高雄市燕巢區	2018-11-24T22:13:20+08:00	4042	9158	13200	1009	14209	24910	57.04%	16.23%	24	25
14	高雄市燕巢區	2018-11-24T23:55:41+08:00	4238	9634	13872	1058	14930	26012	57.4%	16.29%	25	25
14	高雄市燕巢區	2018-11-24T22:23:06+08:00	4042	9158	13200	1009	14209	24910	57.04%	16.23%	24	25
14	高雄市燕巢區	2018-11-24T23:19:43+08:00	4238	9634	13872	1058	14930	26012	57.4%	16.29%	25	25
14	高雄市燕巢區	2018-11-24T23:04:58+08:00	4238	9634	13872	1058	14930	26012	57.4%	16.29%	25	25
14	高雄市燕巢區	2018-11-25T00:00:02+08:00	4238	9634	13872	1058	14930	26012	57.4%	16.29%	25	25
14	高雄市燕巢區	2018-11-25T00:04:59+08:00	4238	9634	13872	1058	14930	26012	57.4%	16.29%	25	25
14	高雄市燕巢區	2018-11-25T01:02:24+08:00	4238	9634	13872	1058	14930	26012	57.4%	16.29%	25	25
14	高雄市燕巢區	2018-11-24T23:27:13+08:00	4238	9634	13872	1058	14930	26012	57.4%	16.29%	25	25
14	高雄市燕巢區	2018-11-25T03:38:49+08:00	4238	9634	13872	1058	14930	26012	57.4%	16.29%	25	25
14	高雄市燕巢區	2018-11-24T22:30:00+08:00	4042	9158	13200	1009	14209	24910	57.04%	16.23%	24	25
14	高雄市燕巢區	2018-11-25T06:13:47+08:00	4238	9634	13872	1058	14930	26012	57.4%	16.29%	25	25
14	高雄市燕巢區	2018-11-24T22:54:20+08:00	4238	9634	13872	1058	14930	26012	57.4%	16.29%	25	25
14	高雄市燕巢區	2018-11-25T00:22:58+08:00	4238	9634	13872	1058	14930	26012	57.4%	16.29%	25	25
14	高雄市燕巢區	2018-11-25T03:56:05+08:00	4238	9634	13872	1058	14930	26012	57.4%	16.29%	25	25
14	高雄市燕巢區	2018-11-24T22:26:32+08:00	4042	9158	13200	1009	14209	24910	57.04%	16.23%	24	25
14	高雄市燕巢區	2018-11-25T00:18:24+08:00	4238	9634	13872	1058	14930	26012	57.4%	16.29%	25	25
14	高雄市燕巢區	2018-11-25T03:49:46+08:00	4238	9634	13872	1058	14930	26012	57.4%	16.29%	25	25
14	高雄市燕巢區	2018-11-25T06:08:46+08:00	4238	9634	13872	1058	14930	26012	57.4%	16.29%	25	25
14	高雄市燕巢區	2018-11-24T23:43:12+08:00	4238	9634	13872	1058	14930	26012	57.4%	16.29%	25	25
14	高雄市燕巢區	2018-11-24T23:47:22+08:00	4238	9634	13872	1058	14930	26012	57.4%	16.29%	25	25
14	高雄市燕巢區	2018-11-24T22:41:29+08:00	4042	9158	13200	1009	14209	24910	57.04%	16.23%	24	25
14	高雄市燕巢區	2018-11-24T22:16:04+08:00	4042	9158	13200	1009	14209	24910	57.04%	16.23%	24	25
14	高雄市燕巢區	2018-11-24T22:33:32+08:00	4042	9158	13200	1009	14209	24910	57.04%	16.23%	24	25
14	高雄市燕巢區	2018-11-25T03:44:16+08:00	4238	9634	13872	1058	14930	26012	57.4%	16.29%	25	25
14	高雄市燕巢區	2018-11-24T23:23:33+08:00	4238	9634	13872	1058	14930	26012	57.4%	16.29%	25	25
14	高雄市燕巢區	2018-11-24T23:51:29+08:00	4238	9634	13872	1058	14930	26012	57.4%	16.29%	25	25
14	高雄市燕巢區	2018-11-24T22:57:47+08:00	4238	9634	13872	1058	14930	26012	57.4%	16.29%	25	25
14	高雄市燕巢區	2018-11-24T22:19:31+08:00	4042	9158	13200	1009	14209	24910	57.04%	16.23%	24	25
14	高雄市燕巢區	2018-11-25T00:57:30+08:00	4238	9634	13872	1058	14930	26012	57.4%	16.29%	25	25
14	高雄市燕巢區	2018-11-25T03:32:29+08:00	4238	9634	13872	1058	14930	26012	57.4%	16.29%	25	25
14	高雄市燕巢區	2018-11-25T06:18:52+08:00	4238	9634	13872	1058	14930	26012	57.4%	16.29%	25	25
14	高雄市燕巢區	2018-11-24T22:40:22+08:00	4042	9158	13200	1009	14209	24910	57.04%	16.23%	24	25
14	高雄市燕巢區	2018-11-25T01:25:47+08:00	4238	9634	13872	1058	14930	26012	57.4%	16.29%	25	25
14	高雄市燕巢區	2018-11-24T22:36:55+08:00	4042	9158	13200	1009	14209	24910	57.04%	16.23%	24	25
14	高雄市燕巢區	2018-11-24T23:08:29+08:00	4238	9634	13872	1058	14930	26012	57.4%	16.29%	25	25
14	高雄市燕巢區	2018-11-24T23:15:57+08:00	4238	9634	13872	1058	14930	26012	57.4%	16.29%	25	25
14	高雄市燕巢區	2018-11-25T06:23:54+08:00	4238	9634	13872	1058	14930	26012	57.4%	16.29%	25	25
14	高雄市燕巢區	2018-11-24T22:50:41+08:00	4042	9158	13200	1009	14209	24910	57.04%	16.23%	24	25
14	高雄市燕巢區	2018-11-24T22:45:03+08:00	4042	9158	13200	1009	14209	24910	57.04%	16.23%	24	25
14	臺中市后里區	2018-11-24T23:47:19+08:00	7155	17267	24422	1819	26241	44962	58.36%	15.91%	37	37
14	臺中市后里區	2018-11-24T23:35:03+08:00	7155	17267	24422	1819	26241	44962	58.36%	15.91%	37	37
14	臺中市后里區	2018-11-24T22:16:01+08:00	5812	13896	19708	1491	21199	36259	58.47%	16.03%	31	37
14	臺中市后里區	2018-11-24T23:01:22+08:00	7155	17267	24422	1819	26241	44962	58.36%	15.91%	37	37
14	臺中市后里區	2018-11-24T23:12:06+08:00	7155	17267	24422	1819	26241	44962	58.36%	15.91%	37	37
14	臺中市后里區	2018-11-25T01:07:18+08:00	7155	17267	24422	1819	26241	44962	58.36%	15.91%	37	37
14	臺中市后里區	2018-11-25T06:08:43+08:00	7155	17267	24422	1819	26241	44962	58.36%	15.91%	37	37
14	臺中市后里區	2018-11-24T22:26:29+08:00	6252	14952	21204	1579	22783	38945	58.5%	16.05%	33	37
14	臺中市后里區	2018-11-25T01:17:42+08:00	7155	17267	24422	1819	26241	44962	58.36%	15.91%	37	37
14	臺中市后里區	2018-11-24T22:13:18+08:00	5594	13376	18970	1446	20416	35081	58.2%	15.95%	30	37
14	臺中市后里區	2018-11-24T22:19:29+08:00	5982	14353	20335	1520	21855	37354	58.51%	16.01%	32	37
14	臺中市后里區	2018-11-25T00:57:28+08:00	7155	17267	24422	1819	26241	44962	58.36%	15.91%	37	37
14	臺中市后里區	2018-11-24T22:57:44+08:00	7155	17267	24422	1819	26241	44962	58.36%	15.91%	37	37
14	臺中市后里區	2018-11-25T03:44:13+08:00	7155	17267	24422	1819	26241	44962	58.36%	15.91%	37	37
14	臺中市后里區	2018-11-24T23:23:30+08:00	7155	17267	24422	1819	26241	44962	58.36%	15.91%	37	37
14	臺中市后里區	2018-11-25T00:04:57+08:00	7155	17267	24422	1819	26241	44962	58.36%	15.91%	37	37
14	臺中市后里區	2018-11-24T23:04:56+08:00	7155	17267	24422	1819	26241	44962	58.36%	15.91%	37	37
14	臺中市后里區	2018-11-24T22:40:20+08:00	6965	16791	23756	1747	25503	43737	58.31%	15.92%	36	37
14	臺中市后里區	2018-11-24T23:15:54+08:00	7155	17267	24422	1819	26241	44962	58.36%	15.91%	37	37
14	臺中市后里區	2018-11-25T01:25:44+08:00	7155	17267	24422	1819	26241	44962	58.36%	15.91%	37	37
14	臺中市后里區	2018-11-24T23:59:59+08:00	7155	17267	24422	1819	26241	44962	58.36%	15.91%	37	37
14	臺中市后里區	2018-11-25T01:02:22+08:00	7155	17267	24422	1819	26241	44962	58.36%	15.91%	37	37
14	臺中市后里區	2018-11-25T03:38:47+08:00	7155	17267	24422	1819	26241	44962	58.36%	15.91%	37	37
14	臺中市后里區	2018-11-24T23:55:39+08:00	7155	17267	24422	1819	26241	44962	58.36%	15.91%	37	37
14	臺中市后里區	2018-11-24T22:54:18+08:00	7155	17267	24422	1819	26241	44962	58.36%	15.91%	37	37
14	臺中市后里區	2018-11-24T22:45:01+08:00	7155	17267	24422	1819	26241	44962	58.36%	15.91%	37	37
14	臺中市后里區	2018-11-25T03:56:02+08:00	7155	17267	24422	1819	26241	44962	58.36%	15.91%	37	37
14	臺中市后里區	2018-11-24T23:39:05+08:00	7155	17267	24422	1819	26241	44962	58.36%	15.91%	37	37
14	臺中市后里區	2018-11-24T23:31:01+08:00	7155	17267	24422	1819	26241	44962	58.36%	15.91%	37	37
14	臺中市后里區	2018-11-25T00:09:24+08:00	7155	17267	24422	1819	26241	44962	58.36%	15.91%	37	37
14	臺中市后里區	2018-11-24T22:41:27+08:00	6965	16791	23756	1747	25503	43737	58.31%	15.92%	36	37
14	臺中市后里區	2018-11-25T04:02:40+08:00	7155	17267	24422	1819	26241	44962	58.36%	15.91%	37	37
14	臺中市后里區	2018-11-25T01:12:33+08:00	7155	17267	24422	1819	26241	44962	58.36%	15.91%	37	37
14	臺中市后里區	2018-11-25T00:14:01+08:00	7155	17267	24422	1819	26241	44962	58.36%	15.91%	37	37
14	臺中市后里區	2018-11-24T22:50:38+08:00	7155	17267	24422	1819	26241	44962	58.36%	15.91%	37	37
14	臺中市后里區	2018-11-24T23:51:26+08:00	7155	17267	24422	1819	26241	44962	58.36%	15.91%	37	37
14	臺中市后里區	2018-11-25T06:18:49+08:00	7155	17267	24422	1819	26241	44962	58.36%	15.91%	37	37
14	臺中市后里區	2018-11-24T22:23:03+08:00	6252	14952	21204	1579	22783	38945	58.5%	16.05%	33	37
14	臺中市后里區	2018-11-24T22:29:56+08:00	6252	14952	21204	1579	22783	38945	58.5%	16.05%	33	37
14	臺中市后里區	2018-11-24T23:19:40+08:00	7155	17267	24422	1819	26241	44962	58.36%	15.91%	37	37
14	臺中市后里區	2018-11-24T22:36:53+08:00	6515	15643	22158	1651	23809	40614	58.62%	16.04%	34	37
14	臺中市后里區	2018-11-24T23:08:26+08:00	7155	17267	24422	1819	26241	44962	58.36%	15.91%	37	37
14	臺中市后里區	2018-11-24T23:27:11+08:00	7155	17267	24422	1819	26241	44962	58.36%	15.91%	37	37
14	臺中市后里區	2018-11-25T03:32:26+08:00	7155	17267	24422	1819	26241	44962	58.36%	15.91%	37	37
14	臺中市后里區	2018-11-25T03:49:43+08:00	7155	17267	24422	1819	26241	44962	58.36%	15.91%	37	37
14	臺中市后里區	2018-11-25T06:29:08+08:00	7155	17267	24422	1819	26241	44962	58.36%	15.91%	37	37
14	臺中市后里區	2018-11-25T00:22:55+08:00	7155	17267	24422	1819	26241	44962	58.36%	15.91%	37	37
14	臺中市后里區	2018-11-25T06:13:44+08:00	7155	17267	24422	1819	26241	44962	58.36%	15.91%	37	37
14	臺中市后里區	2018-11-25T00:18:21+08:00	7155	17267	24422	1819	26241	44962	58.36%	15.91%	37	37
14	臺中市后里區	2018-11-25T06:23:52+08:00	7155	17267	24422	1819	26241	44962	58.36%	15.91%	37	37
14	臺中市后里區	2018-11-24T23:43:09+08:00	7155	17267	24422	1819	26241	44962	58.36%	15.91%	37	37
14	臺中市后里區	2018-11-24T22:33:29+08:00	6252	14952	21204	1579	22783	38945	58.5%	16.05%	33	37
14	臺中市北區	2018-11-24T23:47:19+08:00	18890	37174	56064	2649	58713	103073	56.96%	18.33%	74	87
14	臺中市北區	2018-11-24T22:16:01+08:00	10676	20427	31103	1463	32566	57063	57.07%	18.71%	43	87
14	臺中市北區	2018-11-25T01:07:17+08:00	21976	43618	65594	3095	68689	120982	56.78%	18.16%	85	87
14	臺中市北區	2018-11-24T23:01:22+08:00	15217	29717	44934	2084	47018	82496	56.99%	18.45%	60	87
14	臺中市北區	2018-11-25T06:08:42+08:00	22588	44811	67399	3166	70565	124621	56.62%	18.13%	87	87
14	臺中市北區	2018-11-24T23:35:02+08:00	17599	34558	52157	2426	54583	95783	56.99%	18.37%	69	87
14	臺中市北區	2018-11-24T23:12:06+08:00	16288	31786	48074	2245	50319	88362	56.95%	18.43%	64	87
14	臺中市北區	2018-11-24T22:26:29+08:00	11111	21262	32373	1503	33876	59432	57%	18.7%	45	87
14	臺中市北區	2018-11-25T03:44:12+08:00	22588	44811	67399	3166	70565	124621	56.62%	18.13%	87	87
14	臺中市北區	2018-11-24T22:19:29+08:00	10676	20427	31103	1463	32566	57063	57.07%	18.71%	43	87
14	臺中市北區	2018-11-25T00:04:56+08:00	19495	38489	57984	2746	60730	106558	56.99%	18.3%	76	87
14	臺中市北區	2018-11-24T22:57:44+08:00	14951	29147	44098	2057	46155	80786	57.13%	18.51%	59	87
14	臺中市北區	2018-11-25T00:57:27+08:00	21976	43618	65594	3095	68689	120982	56.78%	18.16%	85	87
14	臺中市北區	2018-11-24T22:13:17+08:00	9913	18871	28784	1353	30137	52866	57.01%	18.75%	40	87
14	臺中市北區	2018-11-24T23:23:30+08:00	16824	32933	49757	2330	52087	91433	56.97%	18.4%	66	87
14	臺中市北區	2018-11-24T23:55:38+08:00	19090	37816	56906	2694	59600	104626	56.96%	18.25%	75	87
14	臺中市北區	2018-11-24T22:40:20+08:00	14263	27523	41786	1957	43743	76646	57.07%	18.61%	56	87
14	臺中市北區	2018-11-24T23:15:54+08:00	16824	32933	49757	2330	52087	91433	56.97%	18.4%	66	87
14	臺中市北區	2018-11-25T01:25:43+08:00	22285	44184	66469	3122	69591	122743	56.7%	18.16%	86	87
14	臺中市北區	2018-11-24T23:59:59+08:00	19090	37816	56906	2694	59600	104626	56.96%	18.25%	75	87
14	臺中市北區	2018-11-25T01:02:22+08:00	21976	43618	65594	3095	68689	120982	56.78%	18.16%	85	87
14	臺中市北區	2018-11-25T03:38:47+08:00	22588	44811	67399	3166	70565	124621	56.62%	18.13%	87	87
14	臺中市北區	2018-11-24T22:54:18+08:00	14951	29147	44098	2057	46155	80786	57.13%	18.51%	59	87
14	臺中市北區	2018-11-25T03:56:02+08:00	22588	44811	67399	3166	70565	124621	56.62%	18.13%	87	87
14	臺中市北區	2018-11-24T22:45:00+08:00	14484	28142	42626	1983	44609	78150	57.08%	18.53%	57	87
14	臺中市北區	2018-11-24T23:31:01+08:00	17174	33479	50653	2357	53010	93102	56.94%	18.45%	67	87
14	臺中市北區	2018-11-25T00:09:24+08:00	19495	38489	57984	2746	60730	106558	56.99%	18.3%	76	87
14	臺中市北區	2018-11-24T22:41:27+08:00	14263	27523	41786	1957	43743	76646	57.07%	18.61%	56	87
14	臺中市北區	2018-11-25T04:02:40+08:00	22588	44811	67399	3166	70565	124621	56.62%	18.13%	87	87
14	臺中市北區	2018-11-25T01:12:33+08:00	21976	43618	65594	3095	68689	120982	56.78%	18.16%	85	87
14	臺中市北區	2018-11-25T00:14:00+08:00	20324	40221	60545	2881	63426	111396	56.94%	18.24%	79	87
14	臺中市北區	2018-11-24T23:39:04+08:00	18282	35962	54244	2533	56777	99549	57.03%	18.36%	72	87
14	臺中市北區	2018-11-24T22:50:38+08:00	14729	28593	43322	2018	45340	79383	57.12%	18.55%	58	87
14	臺中市北區	2018-11-24T23:51:26+08:00	18890	37174	56064	2649	58713	103073	56.96%	18.33%	74	87
14	臺中市北區	2018-11-25T06:18:49+08:00	22588	44811	67399	3166	70565	124621	56.62%	18.13%	87	87
14	臺中市北區	2018-11-25T01:17:41+08:00	21976	43618	65594	3095	68689	120982	56.78%	18.16%	85	87
14	臺中市北區	2018-11-24T22:23:03+08:00	10884	20854	31738	1478	33216	58282	56.99%	18.67%	44	87
14	臺中市北區	2018-11-24T22:29:56+08:00	11773	22676	34449	1592	36041	63345	56.9%	18.59%	48	87
14	臺中市北區	2018-11-24T23:04:55+08:00	15562	30356	45918	2129	48047	84288	57%	18.46%	61	87
14	臺中市北區	2018-11-24T23:19:40+08:00	16824	32933	49757	2330	52087	91433	56.97%	18.4%	66	87
14	臺中市北區	2018-11-24T22:36:53+08:00	13829	26712	40541	1913	42454	74475	57%	18.57%	54	87
14	臺中市北區	2018-11-24T23:27:10+08:00	16824	32933	49757	2330	52087	91433	56.97%	18.4%	66	87
14	臺中市北區	2018-11-24T23:08:26+08:00	15989	31220	47209	2212	49421	86755	56.97%	18.43%	63	87
14	臺中市北區	2018-11-25T03:32:26+08:00	22588	44811	67399	3166	70565	124621	56.62%	18.13%	87	87
14	臺中市北區	2018-11-25T03:49:43+08:00	22588	44811	67399	3166	70565	124621	56.62%	18.13%	87	87
14	臺中市北區	2018-11-25T00:22:55+08:00	20584	40936	61520	2921	64441	113263	56.9%	18.17%	80	87
14	臺中市北區	2018-11-25T06:13:44+08:00	22588	44811	67399	3166	70565	124621	56.62%	18.13%	87	87
14	臺中市北區	2018-11-25T00:18:21+08:00	20324	40221	60545	2881	63426	111396	56.94%	18.24%	79	87
14	臺中市北區	2018-11-25T06:23:52+08:00	22588	44811	67399	3166	70565	124621	56.62%	18.13%	87	87
14	臺中市北區	2018-11-24T22:33:29+08:00	12432	23972	36404	1700	38104	66751	57.08%	18.62%	50	87
14	臺中市北區	2018-11-25T06:29:07+08:00	22588	44811	67399	3166	70565	124621	56.62%	18.13%	87	87
14	臺中市北區	2018-11-24T23:43:08+08:00	18635	36561	55196	2575	57771	101280	57.04%	18.4%	73	87
14	臺北市萬華區	2018-11-24T23:47:17+08:00	29803	50464	80267	4959	85226	152218	55.99%	19.58%	109	117
14	臺北市萬華區	2018-11-24T22:26:28+08:00	21505	36399	57904	3642	61546	109759	56.07%	19.59%	80	117
14	臺北市萬華區	2018-11-25T01:12:31+08:00	32071	54169	86240	5330	91570	164020	55.83%	19.55%	117	117
14	臺北市萬華區	2018-11-25T01:07:16+08:00	32071	54169	86240	5330	91570	164020	55.83%	19.55%	117	117
14	臺北市萬華區	2018-11-24T22:19:27+08:00	20931	35345	56276	3576	59852	106795	56.04%	19.6%	78	117
14	臺北市萬華區	2018-11-24T22:13:16+08:00	20080	33962	54042	3426	57468	102694	55.96%	19.55%	75	117
14	臺北市萬華區	2018-11-24T22:57:42+08:00	26812	45032	71844	4488	76332	136490	55.92%	19.64%	98	117
14	臺北市萬華區	2018-11-25T00:57:26+08:00	32071	54169	86240	5330	91570	164020	55.83%	19.55%	117	117
14	臺北市萬華區	2018-11-24T23:51:25+08:00	30034	50937	80971	4996	85967	153675	55.94%	19.54%	110	117
14	臺北市萬華區	2018-11-24T22:29:54+08:00	22047	37351	59398	3773	63171	112734	56.04%	19.56%	82	117
14	臺北市萬華區	2018-11-24T23:27:09+08:00	29244	49588	78832	4877	83709	149574	55.96%	19.55%	107	117
14	臺北市萬華區	2018-11-24T22:44:59+08:00	24586	41419	66005	4129	70134	125364	55.94%	19.61%	91	117
14	臺北市萬華區	2018-11-24T22:19:28+08:00	20931	35345	56276	3576	59852	106795	56.04%	19.6%	78	117
14	臺北市萬華區	2018-11-24T22:23:01+08:00	20931	35345	56276	3576	59852	106795	56.04%	19.6%	78	117
14	臺北市萬華區	2018-11-24T23:51:24+08:00	30034	50937	80971	4996	85967	153675	55.94%	19.54%	110	117
14	臺北市萬華區	2018-11-24T23:15:52+08:00	28709	48574	77283	4787	82070	146764	55.92%	19.56%	105	117
14	臺北市萬華區	2018-11-25T03:32:24+08:00	32071	54169	86240	5330	91570	164020	55.83%	19.55%	117	117
14	臺北市萬華區	2018-11-25T03:38:46+08:00	32071	54169	86240	5330	91570	164020	55.83%	19.55%	117	117
14	臺北市萬華區	2018-11-24T23:59:58+08:00	30848	52241	83089	5132	88221	157888	55.88%	19.54%	113	117
14	臺北市萬華區	2018-11-25T01:25:42+08:00	32071	54169	86240	5330	91570	164020	55.83%	19.55%	117	117
14	臺北市萬華區	2018-11-24T23:55:36+08:00	30567	51800	82367	5093	87460	156293	55.96%	19.56%	112	117
14	臺北市萬華區	2018-11-24T22:40:18+08:00	24074	40597	64671	4050	68721	122725	56%	19.62%	89	117
14	臺北市萬華區	2018-11-24T23:08:24+08:00	27328	45924	73252	4589	77841	139152	55.94%	19.64%	100	117
14	臺北市萬華區	2018-11-24T23:15:53+08:00	28709	48574	77283	4787	82070	146764	55.92%	19.56%	105	117
14	臺北市萬華區	2018-11-24T23:59:57+08:00	30848	52241	83089	5132	88221	157888	55.88%	19.54%	113	117
14	臺北市萬華區	2018-11-24T22:40:19+08:00	24074	40597	64671	4050	68721	122725	56%	19.62%	89	117
14	臺北市萬華區	2018-11-24T23:55:37+08:00	30567	51800	82367	5093	87460	156293	55.96%	19.56%	112	117
14	臺北市萬華區	2018-11-25T00:13:59+08:00	31180	52699	83879	5181	89060	159283	55.91%	19.58%	114	117
14	臺北市萬華區	2018-11-24T22:36:51+08:00	23399	39619	63018	3982	67000	119876	55.89%	19.52%	87	117
14	臺北市萬華區	2018-11-24T22:54:16+08:00	25219	42381	67600	4241	71841	128436	55.94%	19.64%	93	117
14	臺北市萬華區	2018-11-25T06:29:05+08:00	32071	54169	86240	5330	91570	164020	55.83%	19.55%	117	117
14	臺北市萬華區	2018-11-24T22:54:17+08:00	25219	42381	67600	4241	71841	128436	55.94%	19.64%	93	117
14	臺北市萬華區	2018-11-25T06:23:50+08:00	32071	54169	86240	5330	91570	164020	55.83%	19.55%	117	117
14	臺北市萬華區	2018-11-25T03:49:41+08:00	32071	54169	86240	5330	91570	164020	55.83%	19.55%	117	117
14	臺北市萬華區	2018-11-24T23:39:02+08:00	29540	50037	79577	4916	84493	150851	56.01%	19.58%	108	117
14	臺北市萬華區	2018-11-24T23:12:04+08:00	27831	47067	74898	4682	79580	142306	55.92%	19.56%	102	117
14	臺北市萬華區	2018-11-25T06:08:41+08:00	32071	54169	86240	5330	91570	164020	55.83%	19.55%	117	117
14	臺北市萬華區	2018-11-25T06:08:40+08:00	32071	54169	86240	5330	91570	164020	55.83%	19.55%	117	117
14	臺北市萬華區	2018-11-25T00:09:22+08:00	31180	52699	83879	5181	89060	159283	55.91%	19.58%	114	117
14	臺北市萬華區	2018-11-24T23:31:00+08:00	29540	50037	79577	4916	84493	150851	56.01%	19.58%	108	117
14	臺北市萬華區	2018-11-24T23:39:03+08:00	29540	50037	79577	4916	84493	150851	56.01%	19.58%	108	117
14	臺北市萬華區	2018-11-24T23:01:20+08:00	26812	45032	71844	4488	76332	136490	55.92%	19.64%	98	117
14	臺北市萬華區	2018-11-24T22:50:36+08:00	24892	41912	66804	4182	70986	126817	55.98%	19.63%	92	117
14	臺北市萬華區	2018-11-25T01:12:32+08:00	32071	54169	86240	5330	91570	164020	55.83%	19.55%	117	117
14	臺北市萬華區	2018-11-24T22:41:26+08:00	24074	40597	64671	4050	68721	122725	56%	19.62%	89	117
14	臺北市萬華區	2018-11-24T23:35:01+08:00	29540	50037	79577	4916	84493	150851	56.01%	19.58%	108	117
14	臺北市萬華區	2018-11-24T23:04:54+08:00	27085	45542	72627	4549	77176	137910	55.96%	19.64%	99	117
14	臺北市萬華區	2018-11-25T06:18:47+08:00	32071	54169	86240	5330	91570	164020	55.83%	19.55%	117	117
14	臺北市萬華區	2018-11-25T00:04:55+08:00	31180	52699	83879	5181	89060	159283	55.91%	19.58%	114	117
14	臺北市萬華區	2018-11-24T22:13:15+08:00	20080	33962	54042	3426	57468	102694	55.96%	19.55%	75	117
14	臺北市萬華區	2018-11-25T06:18:48+08:00	32071	54169	86240	5330	91570	164020	55.83%	19.55%	117	117
14	臺北市萬華區	2018-11-24T22:23:02+08:00	20931	35345	56276	3576	59852	106795	56.04%	19.6%	78	117
14	臺北市萬華區	2018-11-25T03:44:10+08:00	32071	54169	86240	5330	91570	164020	55.83%	19.55%	117	117
14	臺北市萬華區	2018-11-25T01:17:40+08:00	32071	54169	86240	5330	91570	164020	55.83%	19.55%	117	117
14	臺北市萬華區	2018-11-25T01:02:20+08:00	32071	54169	86240	5330	91570	164020	55.83%	19.55%	117	117
14	臺北市萬華區	2018-11-25T03:38:45+08:00	32071	54169	86240	5330	91570	164020	55.83%	19.55%	117	117
14	臺北市萬華區	2018-11-24T23:19:38+08:00	28709	48574	77283	4787	82070	146764	55.92%	19.56%	105	117
14	臺北市萬華區	2018-11-24T23:23:29+08:00	29244	49588	78832	4877	83709	149574	55.96%	19.55%	107	117
14	臺北市萬華區	2018-11-24T22:15:59+08:00	20931	35345	56276	3576	59852	106795	56.04%	19.6%	78	117
14	臺北市萬華區	2018-11-25T01:17:39+08:00	32071	54169	86240	5330	91570	164020	55.83%	19.55%	117	117
14	臺北市萬華區	2018-11-25T06:29:06+08:00	32071	54169	86240	5330	91570	164020	55.83%	19.55%	117	117
14	臺北市萬華區	2018-11-24T22:33:28+08:00	22642	38321	60963	3832	64795	115592	56.05%	19.59%	84	117
14	臺北市萬華區	2018-11-25T06:13:43+08:00	32071	54169	86240	5330	91570	164020	55.83%	19.55%	117	117
14	臺北市萬華區	2018-11-24T23:43:07+08:00	29540	50037	79577	4916	84493	150851	56.01%	19.58%	108	117
14	臺北市萬華區	2018-11-25T00:22:53+08:00	31805	53714	85519	5276	90795	162626	55.83%	19.56%	116	117
14	臺北市萬華區	2018-11-25T03:56:00+08:00	32071	54169	86240	5330	91570	164020	55.83%	19.55%	117	117
14	臺北市萬華區	2018-11-24T22:33:27+08:00	22642	38321	60963	3832	64795	115592	56.05%	19.59%	84	117
14	臺北市萬華區	2018-11-25T03:49:42+08:00	32071	54169	86240	5330	91570	164020	55.83%	19.55%	117	117
14	臺北市萬華區	2018-11-25T00:18:20+08:00	31499	53216	84715	5215	89930	161029	55.85%	19.56%	115	117
14	臺北市萬華區	2018-11-25T06:13:42+08:00	32071	54169	86240	5330	91570	164020	55.83%	19.55%	117	117
14	臺北市萬華區	2018-11-25T04:02:38+08:00	32071	54169	86240	5330	91570	164020	55.83%	19.55%	117	117
14	基隆市中正區	2018-11-24T22:33:39+08:00	4532	9252	13784	949	14733	30625	48.11%	14.8%	27	35
14	基隆市中正區	2018-11-25T03:49:52+08:00	6497	13633	20130	1355	21485	45545	47.17%	14.27%	35	35
14	基隆市中正區	2018-11-24T23:43:18+08:00	5229	11050	16279	1190	17469	36131	48.35%	14.47%	31	35
14	基隆市中正區	2018-11-25T01:07:28+08:00	6497	13633	20130	1355	21485	45545	47.17%	14.27%	35	35
14	基隆市中正區	2018-11-25T06:29:18+08:00	6497	13633	20130	1355	21485	45545	47.17%	14.27%	35	35
14	基隆市中正區	2018-11-24T22:50:50+08:00	4532	9252	13784	949	14733	30625	48.11%	14.8%	27	35
14	基隆市中正區	2018-11-25T06:13:54+08:00	6497	13633	20130	1355	21485	45545	47.17%	14.27%	35	35
14	基隆市中正區	2018-11-24T22:13:29+08:00	3668	7378	11046	811	11857	24457	48.48%	15%	22	35
14	基隆市中正區	2018-11-25T03:32:36+08:00	6497	13633	20130	1355	21485	45545	47.17%	14.27%	35	35
14	基隆市中正區	2018-11-24T23:55:48+08:00	5229	11050	16279	1190	17469	36131	48.35%	14.47%	31	35
14	基隆市中正區	2018-11-25T03:44:25+08:00	6497	13633	20130	1355	21485	45545	47.17%	14.27%	35	35
14	基隆市中正區	2018-11-24T23:08:38+08:00	4714	9872	14586	1023	15609	32378	48.21%	14.56%	28	35
14	基隆市中正區	2018-11-25T06:24:02+08:00	6497	13633	20130	1355	21485	45545	47.17%	14.27%	35	35
14	基隆市中正區	2018-11-24T23:51:37+08:00	5229	11050	16279	1190	17469	36131	48.35%	14.47%	31	35
14	基隆市中正區	2018-11-24T22:23:15+08:00	4351	8793	13144	927	14071	29212	48.17%	14.89%	26	35
14	基隆市中正區	2018-11-24T22:40:29+08:00	4532	9252	13784	949	14733	30625	48.11%	14.8%	27	35
14	基隆市中正區	2018-11-25T06:18:59+08:00	6497	13633	20130	1355	21485	45545	47.17%	14.27%	35	35
14	基隆市中正區	2018-11-24T23:23:40+08:00	4865	10232	15097	1068	16165	33549	48.18%	14.5%	29	35
14	基隆市中正區	2018-11-24T22:54:27+08:00	4714	9872	14586	1023	15609	32378	48.21%	14.56%	28	35
14	基隆市中正區	2018-11-25T00:14:11+08:00	5582	11736	17318	1208	18526	38954	47.56%	14.33%	32	35
14	基隆市中正區	2018-11-25T00:05:06+08:00	5582	11736	17318	1208	18526	38954	47.56%	14.33%	32	35
14	基隆市中正區	2018-11-24T22:16:12+08:00	3823	7743	11566	835	12401	25719	48.22%	14.86%	23	35
14	基隆市中正區	2018-11-24T22:41:37+08:00	4532	9252	13784	949	14733	30625	48.11%	14.8%	27	35
14	基隆市中正區	2018-11-24T23:05:06+08:00	4714	9872	14586	1023	15609	32378	48.21%	14.56%	28	35
14	基隆市中正區	2018-11-24T22:45:10+08:00	4532	9252	13784	949	14733	30625	48.11%	14.8%	27	35
14	基隆市中正區	2018-11-25T03:56:14+08:00	6497	13633	20130	1355	21485	45545	47.17%	14.27%	35	35
14	基隆市中正區	2018-11-24T22:37:02+08:00	4532	9252	13784	949	14733	30625	48.11%	14.8%	27	35
14	基隆市中正區	2018-11-25T00:18:32+08:00	5952	12476	18428	1248	19676	41619	47.28%	14.3%	33	35
14	基隆市中正區	2018-11-24T23:16:04+08:00	4714	9872	14586	1023	15609	32378	48.21%	14.56%	28	35
14	基隆市中正區	2018-11-25T00:23:05+08:00	5952	12476	18428	1248	19676	41619	47.28%	14.3%	33	35
14	基隆市中正區	2018-11-25T01:25:54+08:00	6497	13633	20130	1355	21485	45545	47.17%	14.27%	35	35
14	基隆市中正區	2018-11-25T01:02:32+08:00	6497	13633	20130	1355	21485	45545	47.17%	14.27%	35	35
14	基隆市中正區	2018-11-24T22:30:11+08:00	4351	8793	13144	927	14071	29212	48.17%	14.89%	26	35
14	基隆市中正區	2018-11-25T03:38:56+08:00	6497	13633	20130	1355	21485	45545	47.17%	14.27%	35	35
14	基隆市中正區	2018-11-24T22:19:38+08:00	3823	7743	11566	835	12401	25719	48.22%	14.86%	23	35
14	基隆市中正區	2018-11-24T23:19:53+08:00	4714	9872	14586	1023	15609	32378	48.21%	14.56%	28	35
14	基隆市中正區	2018-11-25T01:17:54+08:00	6497	13633	20130	1355	21485	45545	47.17%	14.27%	35	35
14	基隆市中正區	2018-11-25T00:00:12+08:00	5229	11050	16279	1190	17469	36131	48.35%	14.47%	31	35
14	基隆市中正區	2018-11-24T22:57:55+08:00	4714	9872	14586	1023	15609	32378	48.21%	14.56%	28	35
14	基隆市中正區	2018-11-24T23:27:20+08:00	4865	10232	15097	1068	16165	33549	48.18%	14.5%	29	35
14	基隆市中正區	2018-11-25T00:57:38+08:00	6497	13633	20130	1355	21485	45545	47.17%	14.27%	35	35
14	基隆市中正區	2018-11-24T23:35:12+08:00	5041	10561	15602	1110	16712	34586	48.32%	14.58%	30	35
14	基隆市中正區	2018-11-24T23:47:30+08:00	5229	11050	16279	1190	17469	36131	48.35%	14.47%	31	35
14	基隆市中正區	2018-11-25T00:09:36+08:00	5582	11736	17318	1208	18526	38954	47.56%	14.33%	32	35
14	基隆市中正區	2018-11-24T23:01:33+08:00	4714	9872	14586	1023	15609	32378	48.21%	14.56%	28	35
14	基隆市中正區	2018-11-24T23:31:13+08:00	5041	10561	15602	1110	16712	34586	48.32%	14.58%	30	35
14	基隆市中正區	2018-11-25T04:02:54+08:00	6497	13633	20130	1355	21485	45545	47.17%	14.27%	35	35
14	基隆市中正區	2018-11-25T01:12:45+08:00	6497	13633	20130	1355	21485	45545	47.17%	14.27%	35	35
14	基隆市中正區	2018-11-24T22:26:38+08:00	4351	8793	13144	927	14071	29212	48.17%	14.89%	26	35
14	基隆市中正區	2018-11-24T23:12:17+08:00	4714	9872	14586	1023	15609	32378	48.21%	14.56%	28	35
14	基隆市中正區	2018-11-24T23:39:18+08:00	5229	11050	16279	1190	17469	36131	48.35%	14.47%	31	35
14	基隆市中正區	2018-11-25T06:08:55+08:00	6497	13633	20130	1355	21485	45545	47.17%	14.27%	35	35
14	新竹縣竹東鎮	2018-11-25T04:02:43+08:00	12175	28462	40637	1990	42627	78794	54.1%	15.45%	72	72
14	新竹縣竹東鎮	2018-11-25T01:12:37+08:00	11925	27873	39798	1957	41755	77246	54.05%	15.44%	71	72
14	新竹縣竹東鎮	2018-11-25T00:14:04+08:00	11448	26913	38361	1885	40246	74681	53.89%	15.33%	69	72
14	新竹縣竹東鎮	2018-11-24T23:31:05+08:00	10244	24325	34569	1711	36280	67345	53.87%	15.21%	63	72
14	新竹縣竹東鎮	2018-11-25T01:07:21+08:00	11925	27873	39798	1957	41755	77246	54.05%	15.44%	71	72
14	新竹縣竹東鎮	2018-11-24T23:35:05+08:00	10244	24325	34569	1711	36280	67345	53.87%	15.21%	63	72
14	新竹縣竹東鎮	2018-11-25T06:29:11+08:00	12175	28462	40637	1990	42627	78794	54.1%	15.45%	72	72
14	新竹縣竹東鎮	2018-11-24T23:39:09+08:00	10744	25322	36066	1785	37851	70255	53.88%	15.29%	65	72
14	新竹縣竹東鎮	2018-11-25T00:09:28+08:00	11448	26913	38361	1885	40246	74681	53.89%	15.33%	69	72
14	新竹縣竹東鎮	2018-11-24T22:23:07+08:00	5708	13743	19451	990	20441	37993	53.8%	15.02%	39	72
14	新竹縣竹東鎮	2018-11-24T23:08:30+08:00	9315	22186	31501	1571	33072	61324	53.93%	15.19%	58	72
14	新竹縣竹東鎮	2018-11-24T23:19:44+08:00	9860	23472	33332	1659	34991	64854	53.95%	15.2%	61	72
14	新竹縣竹東鎮	2018-11-24T22:13:21+08:00	4918	11848	16766	862	17628	32846	53.67%	14.97%	34	72
14	新竹縣竹東鎮	2018-11-25T00:00:02+08:00	11085	26088	37173	1832	39005	72270	53.97%	15.34%	67	72
14	新竹縣竹東鎮	2018-11-24T22:30:01+08:00	5902	14218	20120	1016	21136	39208	53.91%	15.05%	40	72
14	新竹縣竹東鎮	2018-11-24T23:27:14+08:00	10055	23911	33966	1683	35649	66099	53.93%	15.21%	62	72
14	新竹縣竹東鎮	2018-11-24T22:19:32+08:00	5389	13025	18414	943	19357	36076	53.66%	14.94%	37	72
14	新竹縣竹東鎮	2018-11-24T22:36:56+08:00	6702	16293	22995	1181	24176	44789	53.98%	14.96%	45	72
14	新竹縣竹東鎮	2018-11-25T01:02:25+08:00	11925	27873	39798	1957	41755	77246	54.05%	15.44%	71	72
14	新竹縣竹東鎮	2018-11-25T06:13:47+08:00	12175	28462	40637	1990	42627	78794	54.1%	15.45%	72	72
14	新竹縣竹東鎮	2018-11-25T00:18:25+08:00	11448	26913	38361	1885	40246	74681	53.89%	15.33%	69	72
14	新竹縣竹東鎮	2018-11-24T23:05:00+08:00	9128	21705	30833	1559	32392	60049	53.94%	15.2%	57	72
14	新竹縣竹東鎮	2018-11-24T22:26:32+08:00	5902	14218	20120	1016	21136	39208	53.91%	15.05%	40	72
14	新竹縣竹東鎮	2018-11-24T22:50:42+08:00	8050	19108	27158	1365	28523	52967	53.85%	15.2%	51	72
14	新竹縣竹東鎮	2018-11-24T22:54:21+08:00	8254	19641	27895	1392	29287	54297	53.94%	15.2%	52	72
14	新竹縣竹東鎮	2018-11-25T00:05:00+08:00	11085	26088	37173	1832	39005	72270	53.97%	15.34%	67	72
14	新竹縣竹東鎮	2018-11-24T22:41:30+08:00	7280	17122	24402	1232	25634	47654	53.79%	15.28%	47	72
14	新竹縣竹東鎮	2018-11-25T00:22:59+08:00	11448	26913	38361	1885	40246	74681	53.89%	15.33%	69	72
14	新竹縣竹東鎮	2018-11-25T03:49:46+08:00	12175	28462	40637	1990	42627	78794	54.1%	15.45%	72	72
14	新竹縣竹東鎮	2018-11-24T22:16:05+08:00	5211	12632	17843	917	18760	35008	53.59%	14.89%	36	72
14	新竹縣竹東鎮	2018-11-24T23:01:26+08:00	9128	21705	30833	1559	32392	60049	53.94%	15.2%	57	72
14	新竹縣竹東鎮	2018-11-24T23:43:12+08:00	10927	25743	36670	1809	38479	71395	53.9%	15.3%	66	72
14	新竹縣竹東鎮	2018-11-25T06:08:47+08:00	12175	28462	40637	1990	42627	78794	54.1%	15.45%	72	72
14	新竹縣竹東鎮	2018-11-24T22:33:32+08:00	6444	15619	22063	1119	23182	43118	53.76%	14.95%	43	72
14	新竹縣竹東鎮	2018-11-24T23:47:23+08:00	10927	25743	36670	1809	38479	71395	53.9%	15.3%	66	72
14	新竹縣竹東鎮	2018-11-24T23:55:42+08:00	11085	26088	37173	1832	39005	72270	53.97%	15.34%	67	72
14	新竹縣竹東鎮	2018-11-25T03:44:16+08:00	12175	28462	40637	1990	42627	78794	54.1%	15.45%	72	72
14	新竹縣竹東鎮	2018-11-25T01:17:46+08:00	11925	27873	39798	1957	41755	77246	54.05%	15.44%	71	72
14	新竹縣竹東鎮	2018-11-24T22:57:48+08:00	8773	20831	29604	1484	31088	57505	54.06%	15.26%	55	72
14	新竹縣竹東鎮	2018-11-25T03:38:50+08:00	12175	28462	40637	1990	42627	78794	54.1%	15.45%	72	72
14	新竹縣竹東鎮	2018-11-24T23:23:33+08:00	10055	23911	33966	1683	35649	66099	53.93%	15.21%	62	72
14	新竹縣竹東鎮	2018-11-24T23:51:29+08:00	10927	25743	36670	1809	38479	71395	53.9%	15.3%	66	72
14	新竹縣竹東鎮	2018-11-24T22:40:23+08:00	7280	17122	24402	1232	25634	47654	53.79%	15.28%	47	72
14	新竹縣竹東鎮	2018-11-25T03:32:29+08:00	12175	28462	40637	1990	42627	78794	54.1%	15.45%	72	72
14	新竹縣竹東鎮	2018-11-25T06:18:52+08:00	12175	28462	40637	1990	42627	78794	54.1%	15.45%	72	72
14	新竹縣竹東鎮	2018-11-24T23:15:58+08:00	9709	23104	32813	1634	34447	63711	54.07%	15.24%	60	72
14	新竹縣竹東鎮	2018-11-25T00:57:31+08:00	11925	27873	39798	1957	41755	77246	54.05%	15.44%	71	72
14	新竹縣竹東鎮	2018-11-25T01:25:47+08:00	11925	27873	39798	1957	41755	77246	54.05%	15.44%	71	72
14	新竹縣竹東鎮	2018-11-25T03:56:06+08:00	12175	28462	40637	1990	42627	78794	54.1%	15.45%	72	72
14	新竹縣竹東鎮	2018-11-25T06:23:55+08:00	12175	28462	40637	1990	42627	78794	54.1%	15.45%	72	72
14	新竹縣竹東鎮	2018-11-24T22:45:04+08:00	7688	18120	25808	1311	27119	50392	53.82%	15.26%	49	72
14	新竹縣竹東鎮	2018-11-24T23:12:10+08:00	9522	22706	32228	1594	33822	62628	54%	15.2%	59	72
14	新竹縣尖石鄉	2018-11-25T04:02:44+08:00	681	2889	3570	198	3768	7364	51.17%	9.25%	15	15
14	新竹縣尖石鄉	2018-11-25T01:12:37+08:00	681	2889	3570	198	3768	7364	51.17%	9.25%	15	15
14	新竹縣尖石鄉	2018-11-25T00:14:04+08:00	681	2889	3570	198	3768	7364	51.17%	9.25%	15	15
14	新竹縣尖石鄉	2018-11-24T23:31:05+08:00	638	2587	3225	181	3406	6704	50.81%	9.52%	14	15
14	新竹縣尖石鄉	2018-11-25T01:07:21+08:00	681	2889	3570	198	3768	7364	51.17%	9.25%	15	15
14	新竹縣尖石鄉	2018-11-25T00:09:28+08:00	681	2889	3570	198	3768	7364	51.17%	9.25%	15	15
14	新竹縣尖石鄉	2018-11-24T23:19:45+08:00	538	2086	2624	129	2753	5592	49.23%	9.62%	12	15
14	新竹縣尖石鄉	2018-11-24T22:23:07+08:00	316	1205	1521	77	1598	3165	50.49%	9.98%	8	15
14	新竹縣尖石鄉	2018-11-25T00:00:03+08:00	638	2587	3225	181	3406	6704	50.81%	9.52%	14	15
14	新竹縣尖石鄉	2018-11-24T23:08:30+08:00	538	2086	2624	129	2753	5592	49.23%	9.62%	12	15
14	新竹縣尖石鄉	2018-11-24T22:13:21+08:00	243	947	1190	71	1261	2392	52.72%	10.16%	7	15
14	新竹縣尖石鄉	2018-11-25T03:32:30+08:00	681	2889	3570	198	3768	7364	51.17%	9.25%	15	15
14	新竹縣尖石鄉	2018-11-24T23:51:30+08:00	638	2587	3225	181	3406	6704	50.81%	9.52%	14	15
14	新竹縣尖石鄉	2018-11-24T22:30:01+08:00	316	1205	1521	77	1598	3165	50.49%	9.98%	8	15
14	新竹縣尖石鄉	2018-11-24T23:27:14+08:00	600	2397	2997	172	3169	6205	51.07%	9.67%	13	15
14	新竹縣尖石鄉	2018-11-24T22:19:32+08:00	316	1205	1521	77	1598	3165	50.49%	9.98%	8	15
14	新竹縣尖石鄉	2018-11-25T00:57:32+08:00	681	2889	3570	198	3768	7364	51.17%	9.25%	15	15
14	新竹縣尖石鄉	2018-11-24T22:36:56+08:00	385	1425	1810	100	1910	3950	48.35%	9.75%	9	15
14	新竹縣尖石鄉	2018-11-25T01:02:25+08:00	681	2889	3570	198	3768	7364	51.17%	9.25%	15	15
14	新竹縣尖石鄉	2018-11-25T00:18:25+08:00	681	2889	3570	198	3768	7364	51.17%	9.25%	15	15
14	新竹縣尖石鄉	2018-11-24T23:05:00+08:00	538	2086	2624	129	2753	5592	49.23%	9.62%	12	15
14	新竹縣尖石鄉	2018-11-25T03:49:47+08:00	681	2889	3570	198	3768	7364	51.17%	9.25%	15	15
14	新竹縣尖石鄉	2018-11-24T22:26:32+08:00	316	1205	1521	77	1598	3165	50.49%	9.98%	8	15
14	新竹縣尖石鄉	2018-11-25T06:13:48+08:00	681	2889	3570	198	3768	7364	51.17%	9.25%	15	15
14	新竹縣尖石鄉	2018-11-24T22:50:42+08:00	490	1915	2405	123	2528	5118	49.39%	9.57%	11	15
14	新竹縣尖石鄉	2018-11-24T22:54:21+08:00	490	1915	2405	123	2528	5118	49.39%	9.57%	11	15
14	新竹縣尖石鄉	2018-11-25T00:05:00+08:00	681	2889	3570	198	3768	7364	51.17%	9.25%	15	15
14	新竹縣尖石鄉	2018-11-24T22:41:30+08:00	385	1425	1810	100	1910	3950	48.35%	9.75%	9	15
14	新竹縣尖石鄉	2018-11-25T00:22:59+08:00	681	2889	3570	198	3768	7364	51.17%	9.25%	15	15
14	新竹縣尖石鄉	2018-11-24T22:16:05+08:00	316	1205	1521	77	1598	3165	50.49%	9.98%	8	15
14	新竹縣尖石鄉	2018-11-24T23:01:26+08:00	490	1915	2405	123	2528	5118	49.39%	9.57%	11	15
14	新竹縣尖石鄉	2018-11-24T23:43:12+08:00	638	2587	3225	181	3406	6704	50.81%	9.52%	14	15
14	新竹縣尖石鄉	2018-11-24T22:33:33+08:00	385	1425	1810	100	1910	3950	48.35%	9.75%	9	15
14	新竹縣尖石鄉	2018-11-25T06:08:47+08:00	681	2889	3570	198	3768	7364	51.17%	9.25%	15	15
14	新竹縣尖石鄉	2018-11-24T23:35:06+08:00	638	2587	3225	181	3406	6704	50.81%	9.52%	14	15
14	新竹縣尖石鄉	2018-11-24T23:47:23+08:00	638	2587	3225	181	3406	6704	50.81%	9.52%	14	15
14	新竹縣尖石鄉	2018-11-25T06:29:12+08:00	681	2889	3570	198	3768	7364	51.17%	9.25%	15	15
14	新竹縣尖石鄉	2018-11-24T23:55:42+08:00	638	2587	3225	181	3406	6704	50.81%	9.52%	14	15
14	新竹縣尖石鄉	2018-11-25T01:17:46+08:00	681	2889	3570	198	3768	7364	51.17%	9.25%	15	15
14	新竹縣尖石鄉	2018-11-24T22:57:48+08:00	490	1915	2405	123	2528	5118	49.39%	9.57%	11	15
14	新竹縣尖石鄉	2018-11-25T03:38:50+08:00	681	2889	3570	198	3768	7364	51.17%	9.25%	15	15
14	新竹縣尖石鄉	2018-11-24T23:23:34+08:00	538	2086	2624	129	2753	5592	49.23%	9.62%	12	15
14	新竹縣尖石鄉	2018-11-25T03:44:17+08:00	681	2889	3570	198	3768	7364	51.17%	9.25%	15	15
14	新竹縣尖石鄉	2018-11-25T01:25:48+08:00	681	2889	3570	198	3768	7364	51.17%	9.25%	15	15
14	新竹縣尖石鄉	2018-11-24T22:40:23+08:00	385	1425	1810	100	1910	3950	48.35%	9.75%	9	15
14	新竹縣尖石鄉	2018-11-24T23:15:58+08:00	538	2086	2624	129	2753	5592	49.23%	9.62%	12	15
14	新竹縣尖石鄉	2018-11-25T06:18:53+08:00	681	2889	3570	198	3768	7364	51.17%	9.25%	15	15
14	新竹縣尖石鄉	2018-11-25T03:56:06+08:00	681	2889	3570	198	3768	7364	51.17%	9.25%	15	15
14	新竹縣尖石鄉	2018-11-25T06:23:55+08:00	681	2889	3570	198	3768	7364	51.17%	9.25%	15	15
14	新竹縣尖石鄉	2018-11-24T23:39:10+08:00	638	2587	3225	181	3406	6704	50.81%	9.52%	14	15
14	新竹縣尖石鄉	2018-11-24T22:45:04+08:00	453	1645	2098	104	2202	4543	48.47%	9.97%	10	15
14	新竹縣尖石鄉	2018-11-24T23:12:10+08:00	538	2086	2624	129	2753	5592	49.23%	9.62%	12	15
14	雲林縣土庫鎮	2018-11-24T23:16:00+08:00	3521	8220	11741	1105	12846	24412	52.62%	14.42%	29	29
14	雲林縣土庫鎮	2018-11-24T22:16:07+08:00	3521	8220	11741	1105	12846	24412	52.62%	14.42%	29	29
14	雲林縣土庫鎮	2018-11-25T01:25:50+08:00	3521	8220	11741	1105	12846	24412	52.62%	14.42%	29	29
14	雲林縣土庫鎮	2018-11-25T00:23:01+08:00	3521	8220	11741	1105	12846	24412	52.62%	14.42%	29	29
14	雲林縣土庫鎮	2018-11-25T03:38:52+08:00	3521	8220	11741	1105	12846	24412	52.62%	14.42%	29	29
14	雲林縣土庫鎮	2018-11-24T22:57:50+08:00	3521	8220	11741	1105	12846	24412	52.62%	14.42%	29	29
14	雲林縣土庫鎮	2018-11-25T00:57:33+08:00	3521	8220	11741	1105	12846	24412	52.62%	14.42%	29	29
14	雲林縣土庫鎮	2018-11-24T23:27:15+08:00	3521	8220	11741	1105	12846	24412	52.62%	14.42%	29	29
14	雲林縣土庫鎮	2018-11-24T22:36:58+08:00	3521	8220	11741	1105	12846	24412	52.62%	14.42%	29	29
14	雲林縣土庫鎮	2018-11-24T22:19:34+08:00	3521	8220	11741	1105	12846	24412	52.62%	14.42%	29	29
14	雲林縣土庫鎮	2018-11-24T22:45:06+08:00	3521	8220	11741	1105	12846	24412	52.62%	14.42%	29	29
14	雲林縣土庫鎮	2018-11-25T06:13:49+08:00	3521	8220	11741	1105	12846	24412	52.62%	14.42%	29	29
14	雲林縣土庫鎮	2018-11-25T01:12:40+08:00	3521	8220	11741	1105	12846	24412	52.62%	14.42%	29	29
14	雲林縣土庫鎮	2018-11-24T22:26:34+08:00	3521	8220	11741	1105	12846	24412	52.62%	14.42%	29	29
14	雲林縣土庫鎮	2018-11-25T06:23:57+08:00	3521	8220	11741	1105	12846	24412	52.62%	14.42%	29	29
14	雲林縣土庫鎮	2018-11-24T23:39:12+08:00	3521	8220	11741	1105	12846	24412	52.62%	14.42%	29	29
14	雲林縣土庫鎮	2018-11-24T22:50:45+08:00	3521	8220	11741	1105	12846	24412	52.62%	14.42%	29	29
14	雲林縣土庫鎮	2018-11-24T23:12:13+08:00	3521	8220	11741	1105	12846	24412	52.62%	14.42%	29	29
14	雲林縣土庫鎮	2018-11-25T03:49:48+08:00	3521	8220	11741	1105	12846	24412	52.62%	14.42%	29	29
14	雲林縣土庫鎮	2018-11-24T23:31:08+08:00	3521	8220	11741	1105	12846	24412	52.62%	14.42%	29	29
14	雲林縣土庫鎮	2018-11-24T23:01:28+08:00	3521	8220	11741	1105	12846	24412	52.62%	14.42%	29	29
14	雲林縣土庫鎮	2018-11-25T04:02:47+08:00	3521	8220	11741	1105	12846	24412	52.62%	14.42%	29	29
14	雲林縣土庫鎮	2018-11-24T23:47:25+08:00	3521	8220	11741	1105	12846	24412	52.62%	14.42%	29	29
14	雲林縣土庫鎮	2018-11-25T06:29:14+08:00	3521	8220	11741	1105	12846	24412	52.62%	14.42%	29	29
14	雲林縣土庫鎮	2018-11-24T23:35:07+08:00	3521	8220	11741	1105	12846	24412	52.62%	14.42%	29	29
14	雲林縣土庫鎮	2018-11-25T01:07:23+08:00	3521	8220	11741	1105	12846	24412	52.62%	14.42%	29	29
14	雲林縣土庫鎮	2018-11-24T23:43:14+08:00	3521	8220	11741	1105	12846	24412	52.62%	14.42%	29	29
14	雲林縣土庫鎮	2018-11-25T06:08:49+08:00	3521	8220	11741	1105	12846	24412	52.62%	14.42%	29	29
14	雲林縣土庫鎮	2018-11-24T22:33:35+08:00	3521	8220	11741	1105	12846	24412	52.62%	14.42%	29	29
14	雲林縣土庫鎮	2018-11-25T00:14:06+08:00	3521	8220	11741	1105	12846	24412	52.62%	14.42%	29	29
14	雲林縣土庫鎮	2018-11-25T00:00:07+08:00	3521	8220	11741	1105	12846	24412	52.62%	14.42%	29	29
14	雲林縣土庫鎮	2018-11-24T23:08:33+08:00	3521	8220	11741	1105	12846	24412	52.62%	14.42%	29	29
14	雲林縣土庫鎮	2018-11-25T03:32:32+08:00	3521	8220	11741	1105	12846	24412	52.62%	14.42%	29	29
14	雲林縣土庫鎮	2018-11-24T23:23:35+08:00	3521	8220	11741	1105	12846	24412	52.62%	14.42%	29	29
14	雲林縣土庫鎮	2018-11-25T01:17:48+08:00	3521	8220	11741	1105	12846	24412	52.62%	14.42%	29	29
14	雲林縣土庫鎮	2018-11-24T22:13:24+08:00	3521	8220	11741	1105	12846	24412	52.62%	14.42%	29	29
14	雲林縣土庫鎮	2018-11-24T23:55:44+08:00	3521	8220	11741	1105	12846	24412	52.62%	14.42%	29	29
14	雲林縣土庫鎮	2018-11-24T23:19:47+08:00	3521	8220	11741	1105	12846	24412	52.62%	14.42%	29	29
14	雲林縣土庫鎮	2018-11-25T03:44:19+08:00	3521	8220	11741	1105	12846	24412	52.62%	14.42%	29	29
14	雲林縣土庫鎮	2018-11-25T01:02:27+08:00	3521	8220	11741	1105	12846	24412	52.62%	14.42%	29	29
14	雲林縣土庫鎮	2018-11-24T22:40:25+08:00	3521	8220	11741	1105	12846	24412	52.62%	14.42%	29	29
14	雲林縣土庫鎮	2018-11-24T22:23:10+08:00	3521	8220	11741	1105	12846	24412	52.62%	14.42%	29	29
14	雲林縣土庫鎮	2018-11-24T22:30:03+08:00	3521	8220	11741	1105	12846	24412	52.62%	14.42%	29	29
14	雲林縣土庫鎮	2018-11-25T06:18:54+08:00	3521	8220	11741	1105	12846	24412	52.62%	14.42%	29	29
14	雲林縣土庫鎮	2018-11-24T23:51:32+08:00	3521	8220	11741	1105	12846	24412	52.62%	14.42%	29	29
14	雲林縣土庫鎮	2018-11-25T00:05:02+08:00	3521	8220	11741	1105	12846	24412	52.62%	14.42%	29	29
14	雲林縣土庫鎮	2018-11-24T22:41:32+08:00	3521	8220	11741	1105	12846	24412	52.62%	14.42%	29	29
14	雲林縣土庫鎮	2018-11-25T00:09:31+08:00	3521	8220	11741	1105	12846	24412	52.62%	14.42%	29	29
14	雲林縣土庫鎮	2018-11-24T22:54:23+08:00	3521	8220	11741	1105	12846	24412	52.62%	14.42%	29	29
14	雲林縣土庫鎮	2018-11-24T23:05:02+08:00	3521	8220	11741	1105	12846	24412	52.62%	14.42%	29	29
14	雲林縣土庫鎮	2018-11-25T03:56:09+08:00	3521	8220	11741	1105	12846	24412	52.62%	14.42%	29	29
14	雲林縣土庫鎮	2018-11-25T00:18:27+08:00	3521	8220	11741	1105	12846	24412	52.62%	14.42%	29	29
14	雲林縣褒忠鄉	2018-11-24T23:47:26+08:00	1690	3767	5457	410	5867	11381	51.55%	14.85%	14	14
14	雲林縣褒忠鄉	2018-11-24T23:16:00+08:00	1690	3767	5457	410	5867	11381	51.55%	14.85%	14	14
14	雲林縣褒忠鄉	2018-11-24T22:16:07+08:00	1499	3372	4871	365	5236	10157	51.55%	14.76%	13	14
14	雲林縣褒忠鄉	2018-11-25T01:25:50+08:00	1690	3767	5457	410	5867	11381	51.55%	14.85%	14	14
14	雲林縣褒忠鄉	2018-11-25T00:23:01+08:00	1690	3767	5457	410	5867	11381	51.55%	14.85%	14	14
14	雲林縣褒忠鄉	2018-11-24T23:23:36+08:00	1690	3767	5457	410	5867	11381	51.55%	14.85%	14	14
14	雲林縣褒忠鄉	2018-11-25T03:38:52+08:00	1690	3767	5457	410	5867	11381	51.55%	14.85%	14	14
14	雲林縣褒忠鄉	2018-11-25T00:57:34+08:00	1690	3767	5457	410	5867	11381	51.55%	14.85%	14	14
14	雲林縣褒忠鄉	2018-11-24T22:36:58+08:00	1690	3767	5457	410	5867	11381	51.55%	14.85%	14	14
14	雲林縣褒忠鄉	2018-11-24T22:57:51+08:00	1690	3767	5457	410	5867	11381	51.55%	14.85%	14	14
14	雲林縣褒忠鄉	2018-11-24T22:19:34+08:00	1499	3372	4871	365	5236	10157	51.55%	14.76%	13	14
14	雲林縣褒忠鄉	2018-11-24T22:45:06+08:00	1690	3767	5457	410	5867	11381	51.55%	14.85%	14	14
14	雲林縣褒忠鄉	2018-11-25T06:08:50+08:00	1690	3767	5457	410	5867	11381	51.55%	14.85%	14	14
14	雲林縣褒忠鄉	2018-11-25T01:12:40+08:00	1690	3767	5457	410	5867	11381	51.55%	14.85%	14	14
14	雲林縣褒忠鄉	2018-11-24T22:26:34+08:00	1690	3767	5457	410	5867	11381	51.55%	14.85%	14	14
14	雲林縣褒忠鄉	2018-11-25T03:49:49+08:00	1690	3767	5457	410	5867	11381	51.55%	14.85%	14	14
14	雲林縣褒忠鄉	2018-11-25T06:23:57+08:00	1690	3767	5457	410	5867	11381	51.55%	14.85%	14	14
14	雲林縣褒忠鄉	2018-11-24T23:39:12+08:00	1690	3767	5457	410	5867	11381	51.55%	14.85%	14	14
14	雲林縣褒忠鄉	2018-11-24T22:50:45+08:00	1690	3767	5457	410	5867	11381	51.55%	14.85%	14	14
14	雲林縣褒忠鄉	2018-11-24T23:12:13+08:00	1690	3767	5457	410	5867	11381	51.55%	14.85%	14	14
14	雲林縣褒忠鄉	2018-11-24T23:31:08+08:00	1690	3767	5457	410	5867	11381	51.55%	14.85%	14	14
14	雲林縣褒忠鄉	2018-11-24T23:43:15+08:00	1690	3767	5457	410	5867	11381	51.55%	14.85%	14	14
14	雲林縣褒忠鄉	2018-11-24T23:01:28+08:00	1690	3767	5457	410	5867	11381	51.55%	14.85%	14	14
14	雲林縣褒忠鄉	2018-11-25T06:29:14+08:00	1690	3767	5457	410	5867	11381	51.55%	14.85%	14	14
14	雲林縣褒忠鄉	2018-11-25T00:14:07+08:00	1690	3767	5457	410	5867	11381	51.55%	14.85%	14	14
14	雲林縣褒忠鄉	2018-11-25T04:02:49+08:00	1690	3767	5457	410	5867	11381	51.55%	14.85%	14	14
14	雲林縣褒忠鄉	2018-11-25T01:07:23+08:00	1690	3767	5457	410	5867	11381	51.55%	14.85%	14	14
14	雲林縣褒忠鄉	2018-11-25T06:13:50+08:00	1690	3767	5457	410	5867	11381	51.55%	14.85%	14	14
14	雲林縣褒忠鄉	2018-11-24T23:35:08+08:00	1690	3767	5457	410	5867	11381	51.55%	14.85%	14	14
14	雲林縣褒忠鄉	2018-11-24T22:33:35+08:00	1690	3767	5457	410	5867	11381	51.55%	14.85%	14	14
14	雲林縣褒忠鄉	2018-11-24T23:08:33+08:00	1690	3767	5457	410	5867	11381	51.55%	14.85%	14	14
14	雲林縣褒忠鄉	2018-11-25T03:32:32+08:00	1690	3767	5457	410	5867	11381	51.55%	14.85%	14	14
14	雲林縣褒忠鄉	2018-11-25T03:44:20+08:00	1690	3767	5457	410	5867	11381	51.55%	14.85%	14	14
14	雲林縣褒忠鄉	2018-11-24T22:13:24+08:00	1499	3372	4871	365	5236	10157	51.55%	14.76%	13	14
14	雲林縣褒忠鄉	2018-11-25T00:00:08+08:00	1690	3767	5457	410	5867	11381	51.55%	14.85%	14	14
14	雲林縣褒忠鄉	2018-11-24T23:55:44+08:00	1690	3767	5457	410	5867	11381	51.55%	14.85%	14	14
14	雲林縣褒忠鄉	2018-11-25T01:17:49+08:00	1690	3767	5457	410	5867	11381	51.55%	14.85%	14	14
14	雲林縣褒忠鄉	2018-11-24T23:19:47+08:00	1690	3767	5457	410	5867	11381	51.55%	14.85%	14	14
14	雲林縣褒忠鄉	2018-11-25T06:18:55+08:00	1690	3767	5457	410	5867	11381	51.55%	14.85%	14	14
14	雲林縣褒忠鄉	2018-11-25T01:02:28+08:00	1690	3767	5457	410	5867	11381	51.55%	14.85%	14	14
14	雲林縣褒忠鄉	2018-11-24T23:27:16+08:00	1690	3767	5457	410	5867	11381	51.55%	14.85%	14	14
14	雲林縣褒忠鄉	2018-11-24T22:40:25+08:00	1690	3767	5457	410	5867	11381	51.55%	14.85%	14	14
14	雲林縣褒忠鄉	2018-11-24T22:23:10+08:00	1499	3372	4871	365	5236	10157	51.55%	14.76%	13	14
14	雲林縣褒忠鄉	2018-11-24T22:30:03+08:00	1690	3767	5457	410	5867	11381	51.55%	14.85%	14	14
14	雲林縣褒忠鄉	2018-11-24T23:51:32+08:00	1690	3767	5457	410	5867	11381	51.55%	14.85%	14	14
14	雲林縣褒忠鄉	2018-11-25T00:05:02+08:00	1690	3767	5457	410	5867	11381	51.55%	14.85%	14	14
14	雲林縣褒忠鄉	2018-11-24T22:41:32+08:00	1690	3767	5457	410	5867	11381	51.55%	14.85%	14	14
14	雲林縣褒忠鄉	2018-11-25T00:09:31+08:00	1690	3767	5457	410	5867	11381	51.55%	14.85%	14	14
14	雲林縣褒忠鄉	2018-11-24T22:54:23+08:00	1690	3767	5457	410	5867	11381	51.55%	14.85%	14	14
14	雲林縣褒忠鄉	2018-11-24T23:05:02+08:00	1690	3767	5457	410	5867	11381	51.55%	14.85%	14	14
14	雲林縣褒忠鄉	2018-11-25T03:56:09+08:00	1690	3767	5457	410	5867	11381	51.55%	14.85%	14	14
14	雲林縣褒忠鄉	2018-11-25T00:18:27+08:00	1690	3767	5457	410	5867	11381	51.55%	14.85%	14	14
14	新竹市香山區	2018-11-25T06:29:19+08:00	11128	23396	34524	1950	36474	64896	56.2%	17.15%	55	55
14	新竹市香山區	2018-11-25T01:07:28+08:00	11128	23396	34524	1950	36474	64896	56.2%	17.15%	55	55
14	新竹市香山區	2018-11-25T03:49:53+08:00	11128	23396	34524	1950	36474	64896	56.2%	17.15%	55	55
14	新竹市香山區	2018-11-24T22:50:50+08:00	7429	15442	22871	1298	24169	42895	56.34%	17.32%	38	55
14	新竹市香山區	2018-11-25T06:13:54+08:00	11128	23396	34524	1950	36474	64896	56.2%	17.15%	55	55
14	新竹市香山區	2018-11-24T23:43:19+08:00	10894	22883	33777	1919	35696	63269	56.42%	17.22%	54	55
14	新竹市香山區	2018-11-24T22:13:29+08:00	6111	12842	18953	1067	20020	36042	55.55%	16.96%	31	55
14	新竹市香山區	2018-11-25T03:32:36+08:00	11128	23396	34524	1950	36474	64896	56.2%	17.15%	55	55
14	新竹市香山區	2018-11-25T03:44:25+08:00	11128	23396	34524	1950	36474	64896	56.2%	17.15%	55	55
14	新竹市香山區	2018-11-24T23:08:38+08:00	8612	17883	26495	1493	27988	49716	56.3%	17.32%	43	55
14	新竹市香山區	2018-11-24T23:55:49+08:00	11128	23396	34524	1950	36474	64896	56.2%	17.15%	55	55
14	新竹市香山區	2018-11-25T06:24:02+08:00	11128	23396	34524	1950	36474	64896	56.2%	17.15%	55	55
14	新竹市香山區	2018-11-24T23:51:37+08:00	11128	23396	34524	1950	36474	64896	56.2%	17.15%	55	55
14	新竹市香山區	2018-11-24T22:23:15+08:00	6265	13177	19442	1093	20535	36932	55.6%	16.96%	32	55
14	新竹市香山區	2018-11-24T22:40:29+08:00	7088	14726	21814	1239	23053	41032	56.18%	17.27%	36	55
14	新竹市香山區	2018-11-25T06:18:59+08:00	11128	23396	34524	1950	36474	64896	56.2%	17.15%	55	55
14	新竹市香山區	2018-11-24T22:57:56+08:00	7933	16331	24264	1359	25623	45420	56.41%	17.47%	40	55
14	新竹市香山區	2018-11-24T23:23:40+08:00	10354	21689	32043	1821	33864	59892	56.54%	17.29%	51	55
14	新竹市香山區	2018-11-24T22:33:40+08:00	6510	13543	20053	1114	21167	37908	55.84%	17.17%	33	55
14	新竹市香山區	2018-11-24T22:54:27+08:00	7933	16331	24264	1359	25623	45420	56.41%	17.47%	40	55
14	新竹市香山區	2018-11-25T00:14:11+08:00	11128	23396	34524	1950	36474	64896	56.2%	17.15%	55	55
14	新竹市香山區	2018-11-25T01:12:46+08:00	11128	23396	34524	1950	36474	64896	56.2%	17.15%	55	55
14	新竹市香山區	2018-11-24T22:16:12+08:00	6265	13177	19442	1093	20535	36932	55.6%	16.96%	32	55
14	新竹市香山區	2018-11-24T22:41:37+08:00	7088	14726	21814	1239	23053	41032	56.18%	17.27%	36	55
14	新竹市香山區	2018-11-25T00:05:07+08:00	11128	23396	34524	1950	36474	64896	56.2%	17.15%	55	55
14	新竹市香山區	2018-11-24T23:05:06+08:00	8107	16740	24847	1403	26250	46506	56.44%	17.43%	41	55
14	新竹市香山區	2018-11-24T22:45:10+08:00	7088	14726	21814	1239	23053	41032	56.18%	17.27%	36	55
14	新竹市香山區	2018-11-25T03:56:14+08:00	11128	23396	34524	1950	36474	64896	56.2%	17.15%	55	55
14	新竹市香山區	2018-11-24T22:37:02+08:00	6883	14298	21181	1185	22366	40009	55.9%	17.2%	35	55
14	新竹市香山區	2018-11-25T00:18:32+08:00	11128	23396	34524	1950	36474	64896	56.2%	17.15%	55	55
14	新竹市香山區	2018-11-24T23:16:04+08:00	9618	20199	29817	1698	31515	55940	56.34%	17.19%	48	55
14	新竹市香山區	2018-11-25T00:23:05+08:00	11128	23396	34524	1950	36474	64896	56.2%	17.15%	55	55
14	新竹市香山區	2018-11-25T01:25:54+08:00	11128	23396	34524	1950	36474	64896	56.2%	17.15%	55	55
14	新竹市香山區	2018-11-25T03:38:57+08:00	11128	23396	34524	1950	36474	64896	56.2%	17.15%	55	55
14	新竹市香山區	2018-11-24T22:30:11+08:00	6265	13177	19442	1093	20535	36932	55.6%	16.96%	32	55
14	新竹市香山區	2018-11-25T01:02:33+08:00	11128	23396	34524	1950	36474	64896	56.2%	17.15%	55	55
14	新竹市香山區	2018-11-25T00:57:39+08:00	11128	23396	34524	1950	36474	64896	56.2%	17.15%	55	55
14	新竹市香山區	2018-11-24T23:19:53+08:00	10085	21104	31189	1771	32960	58428	56.41%	17.26%	50	55
14	新竹市香山區	2018-11-25T00:00:12+08:00	11128	23396	34524	1950	36474	64896	56.2%	17.15%	55	55
14	新竹市香山區	2018-11-25T01:17:55+08:00	11128	23396	34524	1950	36474	64896	56.2%	17.15%	55	55
14	新竹市香山區	2018-11-24T22:19:39+08:00	6265	13177	19442	1093	20535	36932	55.6%	16.96%	32	55
14	新竹市香山區	2018-11-24T23:27:20+08:00	10354	21689	32043	1821	33864	59892	56.54%	17.29%	51	55
14	新竹市香山區	2018-11-24T23:35:12+08:00	10511	22082	32593	1851	34444	61115	56.36%	17.2%	52	55
14	新竹市香山區	2018-11-24T23:47:30+08:00	10894	22883	33777	1919	35696	63269	56.42%	17.22%	54	55
14	新竹市香山區	2018-11-25T00:09:36+08:00	11128	23396	34524	1950	36474	64896	56.2%	17.15%	55	55
14	新竹市香山區	2018-11-24T23:01:33+08:00	8107	16740	24847	1403	26250	46506	56.44%	17.43%	41	55
14	新竹市香山區	2018-11-24T23:31:13+08:00	10511	22082	32593	1851	34444	61115	56.36%	17.2%	52	55
14	新竹市香山區	2018-11-25T04:02:54+08:00	11128	23396	34524	1950	36474	64896	56.2%	17.15%	55	55
14	新竹市香山區	2018-11-24T22:26:38+08:00	6265	13177	19442	1093	20535	36932	55.6%	16.96%	32	55
14	新竹市香山區	2018-11-24T23:12:17+08:00	8974	18703	27677	1559	29236	52122	56.09%	17.22%	45	55
14	新竹市香山區	2018-11-24T23:39:18+08:00	10894	22883	33777	1919	35696	63269	56.42%	17.22%	54	55
14	新竹市香山區	2018-11-25T06:08:55+08:00	11128	23396	34524	1950	36474	64896	56.2%	17.15%	55	55
14	臺南市七股區	2018-11-24T23:35:03+08:00	2603	5898	8501	631	9132	19950	45.77%	13.05%	24	24
14	臺南市七股區	2018-11-24T22:33:30+08:00	2431	5463	7894	565	8459	18775	45.05%	12.95%	23	24
14	臺南市七股區	2018-11-24T23:31:02+08:00	2603	5898	8501	631	9132	19950	45.77%	13.05%	24	24
14	臺南市七股區	2018-11-24T23:39:06+08:00	2603	5898	8501	631	9132	19950	45.77%	13.05%	24	24
14	臺南市七股區	2018-11-25T01:07:19+08:00	2603	5898	8501	631	9132	19950	45.77%	13.05%	24	24
14	臺南市七股區	2018-11-25T00:14:02+08:00	2603	5898	8501	631	9132	19950	45.77%	13.05%	24	24
14	臺南市七股區	2018-11-24T23:47:20+08:00	2603	5898	8501	631	9132	19950	45.77%	13.05%	24	24
14	臺南市七股區	2018-11-24T23:43:10+08:00	2603	5898	8501	631	9132	19950	45.77%	13.05%	24	24
14	臺南市七股區	2018-11-25T06:08:44+08:00	2603	5898	8501	631	9132	19950	45.77%	13.05%	24	24
14	臺南市七股區	2018-11-24T23:01:23+08:00	2603	5898	8501	631	9132	19950	45.77%	13.05%	24	24
14	臺南市七股區	2018-11-24T23:12:08+08:00	2603	5898	8501	631	9132	19950	45.77%	13.05%	24	24
14	臺南市七股區	2018-11-24T22:57:45+08:00	2603	5898	8501	631	9132	19950	45.77%	13.05%	24	24
14	臺南市七股區	2018-11-24T23:04:57+08:00	2603	5898	8501	631	9132	19950	45.77%	13.05%	24	24
14	臺南市七股區	2018-11-24T23:23:31+08:00	2603	5898	8501	631	9132	19950	45.77%	13.05%	24	24
14	臺南市七股區	2018-11-25T00:57:29+08:00	2603	5898	8501	631	9132	19950	45.77%	13.05%	24	24
14	臺南市七股區	2018-11-24T22:13:19+08:00	2196	5000	7196	528	7724	17117	45.12%	12.83%	22	24
14	臺南市七股區	2018-11-25T03:44:14+08:00	2603	5898	8501	631	9132	19950	45.77%	13.05%	24	24
14	臺南市七股區	2018-11-25T01:17:43+08:00	2603	5898	8501	631	9132	19950	45.77%	13.05%	24	24
14	臺南市七股區	2018-11-25T00:04:57+08:00	2603	5898	8501	631	9132	19950	45.77%	13.05%	24	24
14	臺南市七股區	2018-11-24T23:55:40+08:00	2603	5898	8501	631	9132	19950	45.77%	13.05%	24	24
14	臺南市七股區	2018-11-24T23:15:55+08:00	2603	5898	8501	631	9132	19950	45.77%	13.05%	24	24
14	臺南市七股區	2018-11-25T01:02:23+08:00	2603	5898	8501	631	9132	19950	45.77%	13.05%	24	24
14	臺南市七股區	2018-11-25T01:25:45+08:00	2603	5898	8501	631	9132	19950	45.77%	13.05%	24	24
14	臺南市七股區	2018-11-25T03:38:48+08:00	2603	5898	8501	631	9132	19950	45.77%	13.05%	24	24
14	臺南市七股區	2018-11-25T06:18:50+08:00	2603	5898	8501	631	9132	19950	45.77%	13.05%	24	24
14	臺南市七股區	2018-11-24T22:40:21+08:00	2431	5463	7894	565	8459	18775	45.05%	12.95%	23	24
14	臺南市七股區	2018-11-24T22:45:01+08:00	2603	5898	8501	631	9132	19950	45.77%	13.05%	24	24
14	臺南市七股區	2018-11-25T00:18:22+08:00	2603	5898	8501	631	9132	19950	45.77%	13.05%	24	24
14	臺南市七股區	2018-11-25T00:22:56+08:00	2603	5898	8501	631	9132	19950	45.77%	13.05%	24	24
14	臺南市七股區	2018-11-24T22:54:19+08:00	2603	5898	8501	631	9132	19950	45.77%	13.05%	24	24
14	臺南市七股區	2018-11-25T03:56:03+08:00	2603	5898	8501	631	9132	19950	45.77%	13.05%	24	24
14	臺南市七股區	2018-11-24T22:16:02+08:00	2196	5000	7196	528	7724	17117	45.12%	12.83%	22	24
14	臺南市七股區	2018-11-24T22:50:39+08:00	2603	5898	8501	631	9132	19950	45.77%	13.05%	24	24
14	臺南市七股區	2018-11-25T00:09:25+08:00	2603	5898	8501	631	9132	19950	45.77%	13.05%	24	24
14	臺南市七股區	2018-11-24T22:41:28+08:00	2431	5463	7894	565	8459	18775	45.05%	12.95%	23	24
14	臺南市七股區	2018-11-25T04:02:41+08:00	2603	5898	8501	631	9132	19950	45.77%	13.05%	24	24
14	臺南市七股區	2018-11-25T01:12:35+08:00	2603	5898	8501	631	9132	19950	45.77%	13.05%	24	24
14	臺南市七股區	2018-11-25T00:00:00+08:00	2603	5898	8501	631	9132	19950	45.77%	13.05%	24	24
14	臺南市七股區	2018-11-24T23:19:41+08:00	2603	5898	8501	631	9132	19950	45.77%	13.05%	24	24
14	臺南市七股區	2018-11-24T23:51:27+08:00	2603	5898	8501	631	9132	19950	45.77%	13.05%	24	24
14	臺南市七股區	2018-11-24T22:29:58+08:00	2431	5463	7894	565	8459	18775	45.05%	12.95%	23	24
14	臺南市七股區	2018-11-24T22:23:05+08:00	2431	5463	7894	565	8459	18775	45.05%	12.95%	23	24
14	臺南市七股區	2018-11-24T22:36:54+08:00	2431	5463	7894	565	8459	18775	45.05%	12.95%	23	24
14	臺南市七股區	2018-11-25T03:32:27+08:00	2603	5898	8501	631	9132	19950	45.77%	13.05%	24	24
14	臺南市七股區	2018-11-24T23:27:11+08:00	2603	5898	8501	631	9132	19950	45.77%	13.05%	24	24
14	臺南市七股區	2018-11-24T22:19:30+08:00	2196	5000	7196	528	7724	17117	45.12%	12.83%	22	24
14	臺南市七股區	2018-11-24T23:08:27+08:00	2603	5898	8501	631	9132	19950	45.77%	13.05%	24	24
14	臺南市七股區	2018-11-25T03:49:44+08:00	2603	5898	8501	631	9132	19950	45.77%	13.05%	24	24
14	臺南市七股區	2018-11-24T22:26:30+08:00	2431	5463	7894	565	8459	18775	45.05%	12.95%	23	24
14	臺南市七股區	2018-11-25T06:29:09+08:00	2603	5898	8501	631	9132	19950	45.77%	13.05%	24	24
14	臺南市七股區	2018-11-25T06:23:53+08:00	2603	5898	8501	631	9132	19950	45.77%	13.05%	24	24
14	臺南市七股區	2018-11-25T06:13:45+08:00	2603	5898	8501	631	9132	19950	45.77%	13.05%	24	24
14	屏東縣春日鄉	2018-11-24T22:33:37+08:00	432	897	1329	52	1381	3923	35.2%	11.01%	6	6
14	屏東縣春日鄉	2018-11-24T23:47:28+08:00	432	897	1329	52	1381	3923	35.2%	11.01%	6	6
14	屏東縣春日鄉	2018-11-24T22:37:00+08:00	432	897	1329	52	1381	3923	35.2%	11.01%	6	6
14	屏東縣春日鄉	2018-11-24T23:43:16+08:00	432	897	1329	52	1381	3923	35.2%	11.01%	6	6
14	屏東縣春日鄉	2018-11-25T06:13:52+08:00	432	897	1329	52	1381	3923	35.2%	11.01%	6	6
14	屏東縣春日鄉	2018-11-25T03:56:11+08:00	432	897	1329	52	1381	3923	35.2%	11.01%	6	6
14	屏東縣春日鄉	2018-11-25T06:29:16+08:00	432	897	1329	52	1381	3923	35.2%	11.01%	6	6
14	屏東縣春日鄉	2018-11-25T03:38:54+08:00	432	897	1329	52	1381	3923	35.2%	11.01%	6	6
14	屏東縣春日鄉	2018-11-24T23:55:46+08:00	432	897	1329	52	1381	3923	35.2%	11.01%	6	6
14	屏東縣春日鄉	2018-11-25T01:02:30+08:00	432	897	1329	52	1381	3923	35.2%	11.01%	6	6
14	屏東縣春日鄉	2018-11-25T03:44:22+08:00	432	897	1329	52	1381	3923	35.2%	11.01%	6	6
14	屏東縣春日鄉	2018-11-24T22:13:26+08:00	432	897	1329	52	1381	3923	35.2%	11.01%	6	6
14	屏東縣春日鄉	2018-11-24T23:23:37+08:00	432	897	1329	52	1381	3923	35.2%	11.01%	6	6
14	屏東縣春日鄉	2018-11-24T22:23:12+08:00	432	897	1329	52	1381	3923	35.2%	11.01%	6	6
14	屏東縣春日鄉	2018-11-24T23:19:50+08:00	432	897	1329	52	1381	3923	35.2%	11.01%	6	6
14	屏東縣春日鄉	2018-11-24T22:30:08+08:00	432	897	1329	52	1381	3923	35.2%	11.01%	6	6
14	屏東縣春日鄉	2018-11-24T22:40:27+08:00	432	897	1329	52	1381	3923	35.2%	11.01%	6	6
14	屏東縣春日鄉	2018-11-25T00:00:10+08:00	432	897	1329	52	1381	3923	35.2%	11.01%	6	6
14	屏東縣春日鄉	2018-11-25T06:18:57+08:00	432	897	1329	52	1381	3923	35.2%	11.01%	6	6
14	屏東縣春日鄉	2018-11-25T01:17:51+08:00	432	897	1329	52	1381	3923	35.2%	11.01%	6	6
14	屏東縣春日鄉	2018-11-24T23:12:15+08:00	432	897	1329	52	1381	3923	35.2%	11.01%	6	6
14	屏東縣春日鄉	2018-11-24T22:45:08+08:00	432	897	1329	52	1381	3923	35.2%	11.01%	6	6
14	屏東縣春日鄉	2018-11-24T23:31:10+08:00	432	897	1329	52	1381	3923	35.2%	11.01%	6	6
14	屏東縣春日鄉	2018-11-24T23:01:30+08:00	432	897	1329	52	1381	3923	35.2%	11.01%	6	6
14	屏東縣春日鄉	2018-11-25T04:02:51+08:00	432	897	1329	52	1381	3923	35.2%	11.01%	6	6
14	屏東縣春日鄉	2018-11-24T23:39:15+08:00	432	897	1329	52	1381	3923	35.2%	11.01%	6	6
14	屏東縣春日鄉	2018-11-25T06:23:59+08:00	432	897	1329	52	1381	3923	35.2%	11.01%	6	6
14	屏東縣春日鄉	2018-11-25T00:09:33+08:00	432	897	1329	52	1381	3923	35.2%	11.01%	6	6
14	屏東縣春日鄉	2018-11-24T23:35:10+08:00	432	897	1329	52	1381	3923	35.2%	11.01%	6	6
14	屏東縣春日鄉	2018-11-25T01:07:25+08:00	432	897	1329	52	1381	3923	35.2%	11.01%	6	6
14	屏東縣春日鄉	2018-11-24T23:16:02+08:00	432	897	1329	52	1381	3923	35.2%	11.01%	6	6
14	屏東縣春日鄉	2018-11-25T03:49:50+08:00	432	897	1329	52	1381	3923	35.2%	11.01%	6	6
14	屏東縣春日鄉	2018-11-25T00:14:08+08:00	432	897	1329	52	1381	3923	35.2%	11.01%	6	6
14	屏東縣春日鄉	2018-11-25T00:23:03+08:00	432	897	1329	52	1381	3923	35.2%	11.01%	6	6
14	屏東縣春日鄉	2018-11-24T23:08:35+08:00	432	897	1329	52	1381	3923	35.2%	11.01%	6	6
14	屏東縣春日鄉	2018-11-25T03:32:34+08:00	432	897	1329	52	1381	3923	35.2%	11.01%	6	6
14	屏東縣春日鄉	2018-11-25T01:25:52+08:00	432	897	1329	52	1381	3923	35.2%	11.01%	6	6
14	屏東縣春日鄉	2018-11-24T22:19:36+08:00	432	897	1329	52	1381	3923	35.2%	11.01%	6	6
14	屏東縣春日鄉	2018-11-24T22:57:52+08:00	432	897	1329	52	1381	3923	35.2%	11.01%	6	6
14	屏東縣春日鄉	2018-11-25T00:57:36+08:00	432	897	1329	52	1381	3923	35.2%	11.01%	6	6
14	屏東縣春日鄉	2018-11-24T23:27:18+08:00	432	897	1329	52	1381	3923	35.2%	11.01%	6	6
14	屏東縣春日鄉	2018-11-24T23:51:35+08:00	432	897	1329	52	1381	3923	35.2%	11.01%	6	6
14	屏東縣春日鄉	2018-11-24T23:05:04+08:00	432	897	1329	52	1381	3923	35.2%	11.01%	6	6
14	屏東縣春日鄉	2018-11-24T22:50:47+08:00	432	897	1329	52	1381	3923	35.2%	11.01%	6	6
14	屏東縣春日鄉	2018-11-24T22:16:10+08:00	432	897	1329	52	1381	3923	35.2%	11.01%	6	6
14	屏東縣春日鄉	2018-11-25T00:05:04+08:00	432	897	1329	52	1381	3923	35.2%	11.01%	6	6
14	屏東縣春日鄉	2018-11-24T22:41:34+08:00	432	897	1329	52	1381	3923	35.2%	11.01%	6	6
14	屏東縣春日鄉	2018-11-25T01:12:42+08:00	432	897	1329	52	1381	3923	35.2%	11.01%	6	6
14	屏東縣春日鄉	2018-11-24T22:26:36+08:00	432	897	1329	52	1381	3923	35.2%	11.01%	6	6
14	屏東縣春日鄉	2018-11-25T00:18:29+08:00	432	897	1329	52	1381	3923	35.2%	11.01%	6	6
14	屏東縣春日鄉	2018-11-25T06:08:52+08:00	432	897	1329	52	1381	3923	35.2%	11.01%	6	6
14	屏東縣春日鄉	2018-11-24T22:54:25+08:00	432	897	1329	52	1381	3923	35.2%	11.01%	6	6
14	臺南市後壁區	2018-11-24T23:35:03+08:00	2733	5938	8671	964	9635	20841	46.23%	13.11%	29	29
14	臺南市後壁區	2018-11-24T22:33:30+08:00	2733	5938	8671	964	9635	20841	46.23%	13.11%	29	29
14	臺南市後壁區	2018-11-24T23:31:02+08:00	2733	5938	8671	964	9635	20841	46.23%	13.11%	29	29
14	臺南市後壁區	2018-11-24T23:39:06+08:00	2733	5938	8671	964	9635	20841	46.23%	13.11%	29	29
14	臺南市後壁區	2018-11-24T23:12:07+08:00	2733	5938	8671	964	9635	20841	46.23%	13.11%	29	29
14	臺南市後壁區	2018-11-24T23:47:20+08:00	2733	5938	8671	964	9635	20841	46.23%	13.11%	29	29
14	臺南市後壁區	2018-11-25T06:08:44+08:00	2733	5938	8671	964	9635	20841	46.23%	13.11%	29	29
14	臺南市後壁區	2018-11-25T01:07:18+08:00	2733	5938	8671	964	9635	20841	46.23%	13.11%	29	29
14	臺南市後壁區	2018-11-24T23:01:23+08:00	2733	5938	8671	964	9635	20841	46.23%	13.11%	29	29
14	臺南市後壁區	2018-11-24T22:57:45+08:00	2733	5938	8671	964	9635	20841	46.23%	13.11%	29	29
14	臺南市後壁區	2018-11-25T01:17:42+08:00	2733	5938	8671	964	9635	20841	46.23%	13.11%	29	29
14	臺南市後壁區	2018-11-24T22:13:18+08:00	2733	5938	8671	964	9635	20841	46.23%	13.11%	29	29
14	臺南市後壁區	2018-11-24T22:19:29+08:00	2733	5938	8671	964	9635	20841	46.23%	13.11%	29	29
14	臺南市後壁區	2018-11-25T00:57:28+08:00	2733	5938	8671	964	9635	20841	46.23%	13.11%	29	29
14	臺南市後壁區	2018-11-24T23:23:31+08:00	2733	5938	8671	964	9635	20841	46.23%	13.11%	29	29
14	臺南市後壁區	2018-11-25T03:44:13+08:00	2733	5938	8671	964	9635	20841	46.23%	13.11%	29	29
14	臺南市後壁區	2018-11-25T00:04:57+08:00	2733	5938	8671	964	9635	20841	46.23%	13.11%	29	29
14	臺南市後壁區	2018-11-24T23:04:56+08:00	2733	5938	8671	964	9635	20841	46.23%	13.11%	29	29
14	臺南市後壁區	2018-11-24T23:15:55+08:00	2733	5938	8671	964	9635	20841	46.23%	13.11%	29	29
14	臺南市後壁區	2018-11-25T01:02:23+08:00	2733	5938	8671	964	9635	20841	46.23%	13.11%	29	29
14	臺南市後壁區	2018-11-25T03:38:48+08:00	2733	5938	8671	964	9635	20841	46.23%	13.11%	29	29
14	臺南市後壁區	2018-11-25T06:18:50+08:00	2733	5938	8671	964	9635	20841	46.23%	13.11%	29	29
14	臺南市後壁區	2018-11-25T01:25:44+08:00	2733	5938	8671	964	9635	20841	46.23%	13.11%	29	29
14	臺南市後壁區	2018-11-24T22:40:21+08:00	2733	5938	8671	964	9635	20841	46.23%	13.11%	29	29
14	臺南市後壁區	2018-11-24T23:55:39+08:00	2733	5938	8671	964	9635	20841	46.23%	13.11%	29	29
14	臺南市後壁區	2018-11-24T22:45:01+08:00	2733	5938	8671	964	9635	20841	46.23%	13.11%	29	29
14	臺南市後壁區	2018-11-25T00:18:22+08:00	2733	5938	8671	964	9635	20841	46.23%	13.11%	29	29
14	臺南市後壁區	2018-11-25T00:22:56+08:00	2733	5938	8671	964	9635	20841	46.23%	13.11%	29	29
14	臺南市後壁區	2018-11-24T22:54:19+08:00	2733	5938	8671	964	9635	20841	46.23%	13.11%	29	29
14	臺南市後壁區	2018-11-25T03:56:03+08:00	2733	5938	8671	964	9635	20841	46.23%	13.11%	29	29
14	臺南市後壁區	2018-11-24T22:16:02+08:00	2733	5938	8671	964	9635	20841	46.23%	13.11%	29	29
14	臺南市後壁區	2018-11-25T01:12:34+08:00	2733	5938	8671	964	9635	20841	46.23%	13.11%	29	29
14	臺南市後壁區	2018-11-24T22:50:39+08:00	2733	5938	8671	964	9635	20841	46.23%	13.11%	29	29
14	臺南市後壁區	2018-11-25T00:09:25+08:00	2733	5938	8671	964	9635	20841	46.23%	13.11%	29	29
14	臺南市後壁區	2018-11-25T00:14:01+08:00	2733	5938	8671	964	9635	20841	46.23%	13.11%	29	29
14	臺南市後壁區	2018-11-24T22:41:28+08:00	2733	5938	8671	964	9635	20841	46.23%	13.11%	29	29
14	臺南市後壁區	2018-11-25T04:02:41+08:00	2733	5938	8671	964	9635	20841	46.23%	13.11%	29	29
14	臺南市後壁區	2018-11-25T00:00:00+08:00	2733	5938	8671	964	9635	20841	46.23%	13.11%	29	29
14	臺南市後壁區	2018-11-24T22:23:04+08:00	2733	5938	8671	964	9635	20841	46.23%	13.11%	29	29
14	臺南市後壁區	2018-11-24T23:19:41+08:00	2733	5938	8671	964	9635	20841	46.23%	13.11%	29	29
14	臺南市後壁區	2018-11-24T23:51:27+08:00	2733	5938	8671	964	9635	20841	46.23%	13.11%	29	29
14	臺南市後壁區	2018-11-24T22:29:58+08:00	2733	5938	8671	964	9635	20841	46.23%	13.11%	29	29
14	臺南市後壁區	2018-11-24T22:36:53+08:00	2733	5938	8671	964	9635	20841	46.23%	13.11%	29	29
14	臺南市後壁區	2018-11-25T03:32:27+08:00	2733	5938	8671	964	9635	20841	46.23%	13.11%	29	29
14	臺南市後壁區	2018-11-24T23:27:11+08:00	2733	5938	8671	964	9635	20841	46.23%	13.11%	29	29
14	臺南市後壁區	2018-11-24T23:08:27+08:00	2733	5938	8671	964	9635	20841	46.23%	13.11%	29	29
14	臺南市後壁區	2018-11-25T06:29:08+08:00	2733	5938	8671	964	9635	20841	46.23%	13.11%	29	29
14	臺南市後壁區	2018-11-25T03:49:44+08:00	2733	5938	8671	964	9635	20841	46.23%	13.11%	29	29
14	臺南市後壁區	2018-11-24T22:26:30+08:00	2733	5938	8671	964	9635	20841	46.23%	13.11%	29	29
14	臺南市後壁區	2018-11-25T06:23:52+08:00	2733	5938	8671	964	9635	20841	46.23%	13.11%	29	29
14	臺南市後壁區	2018-11-24T23:43:09+08:00	2733	5938	8671	964	9635	20841	46.23%	13.11%	29	29
14	臺南市後壁區	2018-11-25T06:13:45+08:00	2733	5938	8671	964	9635	20841	46.23%	13.11%	29	29
14	屏東縣佳冬鄉	2018-11-24T22:33:37+08:00	2422	5049	7471	981	8452	17063	49.53%	14.19%	16	16
14	屏東縣佳冬鄉	2018-11-24T22:37:00+08:00	2422	5049	7471	981	8452	17063	49.53%	14.19%	16	16
14	屏東縣佳冬鄉	2018-11-24T23:43:16+08:00	2422	5049	7471	981	8452	17063	49.53%	14.19%	16	16
14	屏東縣佳冬鄉	2018-11-25T03:56:11+08:00	2422	5049	7471	981	8452	17063	49.53%	14.19%	16	16
14	屏東縣佳冬鄉	2018-11-25T06:29:16+08:00	2422	5049	7471	981	8452	17063	49.53%	14.19%	16	16
14	屏東縣佳冬鄉	2018-11-24T23:47:27+08:00	2422	5049	7471	981	8452	17063	49.53%	14.19%	16	16
14	屏東縣佳冬鄉	2018-11-24T22:16:09+08:00	2259	4677	6936	913	7849	15703	49.98%	14.39%	15	16
14	屏東縣佳冬鄉	2018-11-25T03:38:54+08:00	2422	5049	7471	981	8452	17063	49.53%	14.19%	16	16
14	屏東縣佳冬鄉	2018-11-24T23:55:46+08:00	2422	5049	7471	981	8452	17063	49.53%	14.19%	16	16
14	屏東縣佳冬鄉	2018-11-25T03:44:22+08:00	2422	5049	7471	981	8452	17063	49.53%	14.19%	16	16
14	屏東縣佳冬鄉	2018-11-24T22:13:26+08:00	2259	4677	6936	913	7849	15703	49.98%	14.39%	15	16
14	屏東縣佳冬鄉	2018-11-24T23:23:37+08:00	2422	5049	7471	981	8452	17063	49.53%	14.19%	16	16
14	屏東縣佳冬鄉	2018-11-25T06:18:56+08:00	2422	5049	7471	981	8452	17063	49.53%	14.19%	16	16
14	屏東縣佳冬鄉	2018-11-24T22:23:12+08:00	2259	4677	6936	913	7849	15703	49.98%	14.39%	15	16
14	屏東縣佳冬鄉	2018-11-24T22:40:27+08:00	2422	5049	7471	981	8452	17063	49.53%	14.19%	16	16
14	屏東縣佳冬鄉	2018-11-25T00:00:10+08:00	2422	5049	7471	981	8452	17063	49.53%	14.19%	16	16
14	屏東縣佳冬鄉	2018-11-25T01:17:51+08:00	2422	5049	7471	981	8452	17063	49.53%	14.19%	16	16
14	屏東縣佳冬鄉	2018-11-24T22:30:07+08:00	2259	4677	6936	913	7849	15703	49.98%	14.39%	15	16
14	屏東縣佳冬鄉	2018-11-24T23:12:15+08:00	2422	5049	7471	981	8452	17063	49.53%	14.19%	16	16
14	屏東縣佳冬鄉	2018-11-24T23:31:10+08:00	2422	5049	7471	981	8452	17063	49.53%	14.19%	16	16
14	屏東縣佳冬鄉	2018-11-24T23:39:14+08:00	2422	5049	7471	981	8452	17063	49.53%	14.19%	16	16
14	屏東縣佳冬鄉	2018-11-24T23:01:30+08:00	2422	5049	7471	981	8452	17063	49.53%	14.19%	16	16
14	屏東縣佳冬鄉	2018-11-25T04:02:51+08:00	2422	5049	7471	981	8452	17063	49.53%	14.19%	16	16
14	屏東縣佳冬鄉	2018-11-25T06:23:59+08:00	2422	5049	7471	981	8452	17063	49.53%	14.19%	16	16
14	屏東縣佳冬鄉	2018-11-25T00:09:33+08:00	2422	5049	7471	981	8452	17063	49.53%	14.19%	16	16
14	屏東縣佳冬鄉	2018-11-24T22:45:07+08:00	2422	5049	7471	981	8452	17063	49.53%	14.19%	16	16
14	屏東縣佳冬鄉	2018-11-25T06:08:51+08:00	2422	5049	7471	981	8452	17063	49.53%	14.19%	16	16
14	屏東縣佳冬鄉	2018-11-25T01:07:25+08:00	2422	5049	7471	981	8452	17063	49.53%	14.19%	16	16
14	屏東縣佳冬鄉	2018-11-25T06:13:51+08:00	2422	5049	7471	981	8452	17063	49.53%	14.19%	16	16
14	屏東縣佳冬鄉	2018-11-24T23:16:02+08:00	2422	5049	7471	981	8452	17063	49.53%	14.19%	16	16
14	屏東縣佳冬鄉	2018-11-24T23:35:09+08:00	2422	5049	7471	981	8452	17063	49.53%	14.19%	16	16
14	屏東縣佳冬鄉	2018-11-25T03:49:50+08:00	2422	5049	7471	981	8452	17063	49.53%	14.19%	16	16
14	屏東縣佳冬鄉	2018-11-25T00:14:08+08:00	2422	5049	7471	981	8452	17063	49.53%	14.19%	16	16
14	屏東縣佳冬鄉	2018-11-25T00:23:02+08:00	2422	5049	7471	981	8452	17063	49.53%	14.19%	16	16
14	屏東縣佳冬鄉	2018-11-24T23:08:35+08:00	2422	5049	7471	981	8452	17063	49.53%	14.19%	16	16
14	屏東縣佳冬鄉	2018-11-25T03:32:33+08:00	2422	5049	7471	981	8452	17063	49.53%	14.19%	16	16
14	屏東縣佳冬鄉	2018-11-25T01:25:52+08:00	2422	5049	7471	981	8452	17063	49.53%	14.19%	16	16
14	屏東縣佳冬鄉	2018-11-24T23:19:49+08:00	2422	5049	7471	981	8452	17063	49.53%	14.19%	16	16
14	屏東縣佳冬鄉	2018-11-24T23:27:17+08:00	2422	5049	7471	981	8452	17063	49.53%	14.19%	16	16
14	屏東縣佳冬鄉	2018-11-24T22:19:36+08:00	2259	4677	6936	913	7849	15703	49.98%	14.39%	15	16
14	屏東縣佳冬鄉	2018-11-25T01:02:29+08:00	2422	5049	7471	981	8452	17063	49.53%	14.19%	16	16
14	屏東縣佳冬鄉	2018-11-24T23:51:34+08:00	2422	5049	7471	981	8452	17063	49.53%	14.19%	16	16
14	屏東縣佳冬鄉	2018-11-24T22:57:52+08:00	2422	5049	7471	981	8452	17063	49.53%	14.19%	16	16
14	屏東縣佳冬鄉	2018-11-25T00:57:36+08:00	2422	5049	7471	981	8452	17063	49.53%	14.19%	16	16
14	屏東縣佳冬鄉	2018-11-24T23:05:03+08:00	2422	5049	7471	981	8452	17063	49.53%	14.19%	16	16
14	屏東縣佳冬鄉	2018-11-24T22:50:47+08:00	2422	5049	7471	981	8452	17063	49.53%	14.19%	16	16
14	屏東縣佳冬鄉	2018-11-25T00:05:04+08:00	2422	5049	7471	981	8452	17063	49.53%	14.19%	16	16
14	屏東縣佳冬鄉	2018-11-24T22:41:34+08:00	2422	5049	7471	981	8452	17063	49.53%	14.19%	16	16
14	屏東縣佳冬鄉	2018-11-25T01:12:42+08:00	2422	5049	7471	981	8452	17063	49.53%	14.19%	16	16
14	屏東縣佳冬鄉	2018-11-24T22:26:36+08:00	2259	4677	6936	913	7849	15703	49.98%	14.39%	15	16
14	屏東縣佳冬鄉	2018-11-25T00:18:29+08:00	2422	5049	7471	981	8452	17063	49.53%	14.19%	16	16
14	屏東縣佳冬鄉	2018-11-24T22:54:25+08:00	2422	5049	7471	981	8452	17063	49.53%	14.19%	16	16
14	嘉義市東區	2018-11-25T06:29:19+08:00	17757	34768	52525	2599	55124	100647	54.77%	17.64%	81	81
14	嘉義市東區	2018-11-25T01:07:28+08:00	17757	34768	52525	2599	55124	100647	54.77%	17.64%	81	81
14	嘉義市東區	2018-11-25T03:49:53+08:00	17757	34768	52525	2599	55124	100647	54.77%	17.64%	81	81
14	嘉義市東區	2018-11-24T22:50:50+08:00	13681	26868	40549	1972	42521	77110	55.14%	17.74%	65	81
14	嘉義市東區	2018-11-25T06:13:54+08:00	17757	34768	52525	2599	55124	100647	54.77%	17.64%	81	81
14	嘉義市東區	2018-11-24T23:43:19+08:00	16793	33129	49922	2528	52450	95609	54.86%	17.56%	78	81
14	嘉義市東區	2018-11-24T22:13:29+08:00	11045	21627	32672	1576	34248	61477	55.71%	17.97%	54	81
14	嘉義市東區	2018-11-25T03:32:36+08:00	17757	34768	52525	2599	55124	100647	54.77%	17.64%	81	81
14	嘉義市東區	2018-11-25T00:23:06+08:00	17757	34768	52525	2599	55124	100647	54.77%	17.64%	81	81
14	嘉義市東區	2018-11-25T03:44:25+08:00	17757	34768	52525	2599	55124	100647	54.77%	17.64%	81	81
14	嘉義市東區	2018-11-24T23:08:38+08:00	14488	28521	43009	2105	45114	81702	55.22%	17.73%	69	81
14	嘉義市東區	2018-11-24T23:55:49+08:00	16533	32578	49111	2476	51587	94042	54.86%	17.58%	77	81
14	嘉義市東區	2018-11-25T06:24:02+08:00	17757	34768	52525	2599	55124	100647	54.77%	17.64%	81	81
14	嘉義市東區	2018-11-24T23:51:37+08:00	16533	32578	49111	2476	51587	94042	54.86%	17.58%	77	81
14	嘉義市東區	2018-11-24T22:23:15+08:00	11758	23092	34850	1699	36549	65692	55.64%	17.9%	57	81
14	嘉義市東區	2018-11-24T22:40:29+08:00	13219	25987	39206	1926	41132	74405	55.28%	17.77%	63	81
14	嘉義市東區	2018-11-25T06:18:59+08:00	17757	34768	52525	2599	55124	100647	54.77%	17.64%	81	81
14	嘉義市東區	2018-11-24T22:57:56+08:00	14303	28201	42504	2068	44572	80722	55.22%	17.72%	68	81
14	嘉義市東區	2018-11-24T23:23:40+08:00	15715	30946	46661	2341	49002	89278	54.89%	17.6%	74	81
14	嘉義市東區	2018-11-24T22:33:40+08:00	12517	24651	37168	1827	38995	70324	55.45%	17.8%	60	81
14	嘉義市東區	2018-11-24T22:54:27+08:00	14042	27686	41728	2048	43776	79294	55.21%	17.71%	67	81
14	嘉義市東區	2018-11-25T00:14:11+08:00	17757	34768	52525	2599	55124	100647	54.77%	17.64%	81	81
14	嘉義市東區	2018-11-25T01:12:46+08:00	17757	34768	52525	2599	55124	100647	54.77%	17.64%	81	81
14	嘉義市東區	2018-11-24T22:16:12+08:00	11522	22558	34080	1669	35749	64272	55.62%	17.93%	56	81
14	嘉義市東區	2018-11-24T22:41:37+08:00	13219	25987	39206	1926	41132	74405	55.28%	17.77%	63	81
14	嘉義市東區	2018-11-25T00:05:07+08:00	17526	34372	51898	2581	54479	99243	54.89%	17.66%	80	81
14	嘉義市東區	2018-11-24T23:05:06+08:00	14488	28521	43009	2105	45114	81702	55.22%	17.73%	69	81
14	嘉義市東區	2018-11-24T22:45:10+08:00	13681	26868	40549	1972	42521	77110	55.14%	17.74%	65	81
14	嘉義市東區	2018-11-24T23:16:05+08:00	15052	29518	44570	2185	46755	84655	55.23%	17.78%	71	81
14	嘉義市東區	2018-11-24T22:37:02+08:00	13011	25638	38649	1901	40550	73325	55.3%	17.74%	62	81
14	嘉義市東區	2018-11-25T00:18:32+08:00	17757	34768	52525	2599	55124	100647	54.77%	17.64%	81	81
14	嘉義市東區	2018-11-25T03:56:15+08:00	17757	34768	52525	2599	55124	100647	54.77%	17.64%	81	81
14	嘉義市東區	2018-11-25T01:25:54+08:00	17757	34768	52525	2599	55124	100647	54.77%	17.64%	81	81
14	嘉義市東區	2018-11-25T03:38:57+08:00	17757	34768	52525	2599	55124	100647	54.77%	17.64%	81	81
14	嘉義市東區	2018-11-24T22:30:11+08:00	12248	24039	36287	1783	38070	68753	55.37%	17.81%	59	81
14	嘉義市東區	2018-11-25T01:02:33+08:00	17757	34768	52525	2599	55124	100647	54.77%	17.64%	81	81
14	嘉義市東區	2018-11-25T00:57:39+08:00	17757	34768	52525	2599	55124	100647	54.77%	17.64%	81	81
14	嘉義市東區	2018-11-24T23:19:53+08:00	15540	30482	46022	2298	48320	87849	55%	17.69%	73	81
14	嘉義市東區	2018-11-25T00:00:12+08:00	16793	33129	49922	2528	52450	95609	54.86%	17.56%	78	81
14	嘉義市東區	2018-11-25T01:17:55+08:00	17757	34768	52525	2599	55124	100647	54.77%	17.64%	81	81
14	嘉義市東區	2018-11-24T22:19:39+08:00	11758	23092	34850	1699	36549	65692	55.64%	17.9%	57	81
14	嘉義市東區	2018-11-24T23:27:20+08:00	15988	31549	47537	2379	49916	90830	54.96%	17.6%	75	81
14	嘉義市東區	2018-11-24T23:35:12+08:00	16255	32104	48359	2439	50798	92512	54.91%	17.57%	76	81
14	嘉義市東區	2018-11-24T23:47:30+08:00	16793	33129	49922	2528	52450	95609	54.86%	17.56%	78	81
14	嘉義市東區	2018-11-25T00:09:36+08:00	17757	34768	52525	2599	55124	100647	54.77%	17.64%	81	81
14	嘉義市東區	2018-11-24T23:01:33+08:00	14303	28201	42504	2068	44572	80722	55.22%	17.72%	68	81
14	嘉義市東區	2018-11-24T23:31:13+08:00	15988	31549	47537	2379	49916	90830	54.96%	17.6%	75	81
14	嘉義市東區	2018-11-25T04:02:54+08:00	17757	34768	52525	2599	55124	100647	54.77%	17.64%	81	81
14	嘉義市東區	2018-11-24T22:26:38+08:00	11978	23544	35522	1765	37287	66930	55.71%	17.9%	58	81
14	嘉義市東區	2018-11-24T23:12:17+08:00	14756	28971	43727	2137	45864	83097	55.19%	17.76%	70	81
14	嘉義市東區	2018-11-24T23:39:18+08:00	16572	32658	49230	2510	51740	94343	54.84%	17.57%	77	81
14	嘉義市東區	2018-11-25T06:08:55+08:00	17757	34768	52525	2599	55124	100647	54.77%	17.64%	81	81
14	花蓮縣新城鄉	2018-11-25T06:29:17+08:00	2336	6293	8629	617	9246	17029	54.3%	13.72%	19	19
14	花蓮縣新城鄉	2018-11-24T23:47:28+08:00	2112	5700	7812	586	8398	15424	54.45%	13.69%	18	19
14	花蓮縣新城鄉	2018-11-25T00:18:30+08:00	2112	5700	7812	586	8398	15424	54.45%	13.69%	18	19
14	花蓮縣新城鄉	2018-11-25T01:07:26+08:00	2336	6293	8629	617	9246	17029	54.3%	13.72%	19	19
14	花蓮縣新城鄉	2018-11-25T06:13:52+08:00	2336	6293	8629	617	9246	17029	54.3%	13.72%	19	19
14	花蓮縣新城鄉	2018-11-24T22:33:38+08:00	1482	3950	5432	416	5848	10634	54.99%	13.94%	14	19
14	花蓮縣新城鄉	2018-11-24T23:43:17+08:00	2112	5700	7812	586	8398	15424	54.45%	13.69%	18	19
14	花蓮縣新城鄉	2018-11-24T22:37:01+08:00	1482	3950	5432	416	5848	10634	54.99%	13.94%	14	19
14	花蓮縣新城鄉	2018-11-25T03:44:23+08:00	2336	6293	8629	617	9246	17029	54.3%	13.72%	19	19
14	花蓮縣新城鄉	2018-11-24T22:13:27+08:00	1303	3399	4702	341	5043	9159	55.06%	14.23%	12	19
14	花蓮縣新城鄉	2018-11-25T01:02:31+08:00	2336	6293	8629	617	9246	17029	54.3%	13.72%	19	19
14	花蓮縣新城鄉	2018-11-24T23:23:38+08:00	1967	5317	7284	556	7840	14354	54.62%	13.7%	17	19
14	花蓮縣新城鄉	2018-11-25T03:38:55+08:00	2336	6293	8629	617	9246	17029	54.3%	13.72%	19	19
14	花蓮縣新城鄉	2018-11-24T23:55:47+08:00	2112	5700	7812	586	8398	15424	54.45%	13.69%	18	19
14	花蓮縣新城鄉	2018-11-24T23:08:36+08:00	1801	4864	6665	518	7183	13160	54.58%	13.69%	16	19
14	花蓮縣新城鄉	2018-11-25T00:00:11+08:00	2112	5700	7812	586	8398	15424	54.45%	13.69%	18	19
14	花蓮縣新城鄉	2018-11-25T06:18:57+08:00	2336	6293	8629	617	9246	17029	54.3%	13.72%	19	19
14	花蓮縣新城鄉	2018-11-24T22:30:09+08:00	1386	3741	5127	366	5493	10044	54.69%	13.8%	13	19
14	花蓮縣新城鄉	2018-11-24T22:40:28+08:00	1482	3950	5432	416	5848	10634	54.99%	13.94%	14	19
14	花蓮縣新城鄉	2018-11-24T22:23:13+08:00	1386	3741	5127	366	5493	10044	54.69%	13.8%	13	19
14	花蓮縣新城鄉	2018-11-24T23:19:51+08:00	1967	5317	7284	556	7840	14354	54.62%	13.7%	17	19
14	花蓮縣新城鄉	2018-11-24T23:12:15+08:00	1801	4864	6665	518	7183	13160	54.58%	13.69%	16	19
14	花蓮縣新城鄉	2018-11-24T23:35:11+08:00	2112	5700	7812	586	8398	15424	54.45%	13.69%	18	19
14	花蓮縣新城鄉	2018-11-24T23:01:31+08:00	1801	4864	6665	518	7183	13160	54.58%	13.69%	16	19
14	花蓮縣新城鄉	2018-11-24T22:45:09+08:00	1482	3950	5432	416	5848	10634	54.99%	13.94%	14	19
14	花蓮縣新城鄉	2018-11-24T23:31:11+08:00	2112	5700	7812	586	8398	15424	54.45%	13.69%	18	19
14	花蓮縣新城鄉	2018-11-25T00:09:34+08:00	2112	5700	7812	586	8398	15424	54.45%	13.69%	18	19
14	花蓮縣新城鄉	2018-11-24T22:54:26+08:00	1801	4864	6665	518	7183	13160	54.58%	13.69%	16	19
14	花蓮縣新城鄉	2018-11-25T00:14:09+08:00	2112	5700	7812	586	8398	15424	54.45%	13.69%	18	19
14	花蓮縣新城鄉	2018-11-25T03:49:51+08:00	2336	6293	8629	617	9246	17029	54.3%	13.72%	19	19
14	花蓮縣新城鄉	2018-11-24T23:16:03+08:00	1801	4864	6665	518	7183	13160	54.58%	13.69%	16	19
14	花蓮縣新城鄉	2018-11-25T03:56:12+08:00	2336	6293	8629	617	9246	17029	54.3%	13.72%	19	19
14	花蓮縣新城鄉	2018-11-25T06:24:00+08:00	2336	6293	8629	617	9246	17029	54.3%	13.72%	19	19
14	花蓮縣新城鄉	2018-11-25T00:23:03+08:00	2112	5700	7812	586	8398	15424	54.45%	13.69%	18	19
14	花蓮縣新城鄉	2018-11-25T03:32:34+08:00	2336	6293	8629	617	9246	17029	54.3%	13.72%	19	19
14	花蓮縣新城鄉	2018-11-25T01:25:52+08:00	2336	6293	8629	617	9246	17029	54.3%	13.72%	19	19
14	花蓮縣新城鄉	2018-11-25T00:57:37+08:00	2336	6293	8629	617	9246	17029	54.3%	13.72%	19	19
14	花蓮縣新城鄉	2018-11-24T22:57:53+08:00	1801	4864	6665	518	7183	13160	54.58%	13.69%	16	19
14	花蓮縣新城鄉	2018-11-24T22:19:37+08:00	1303	3399	4702	341	5043	9159	55.06%	14.23%	12	19
14	花蓮縣新城鄉	2018-11-25T01:17:52+08:00	2336	6293	8629	617	9246	17029	54.3%	13.72%	19	19
14	花蓮縣新城鄉	2018-11-24T23:27:18+08:00	1967	5317	7284	556	7840	14354	54.62%	13.7%	17	19
14	花蓮縣新城鄉	2018-11-24T23:51:35+08:00	2112	5700	7812	586	8398	15424	54.45%	13.69%	18	19
14	花蓮縣新城鄉	2018-11-24T23:05:04+08:00	1801	4864	6665	518	7183	13160	54.58%	13.69%	16	19
14	花蓮縣新城鄉	2018-11-24T22:41:35+08:00	1482	3950	5432	416	5848	10634	54.99%	13.94%	14	19
14	花蓮縣新城鄉	2018-11-25T00:05:05+08:00	2112	5700	7812	586	8398	15424	54.45%	13.69%	18	19
14	花蓮縣新城鄉	2018-11-25T04:02:52+08:00	2336	6293	8629	617	9246	17029	54.3%	13.72%	19	19
14	花蓮縣新城鄉	2018-11-25T06:08:53+08:00	2336	6293	8629	617	9246	17029	54.3%	13.72%	19	19
14	花蓮縣新城鄉	2018-11-24T22:16:10+08:00	1303	3399	4702	341	5043	9159	55.06%	14.23%	12	19
14	花蓮縣新城鄉	2018-11-25T01:12:43+08:00	2336	6293	8629	617	9246	17029	54.3%	13.72%	19	19
14	花蓮縣新城鄉	2018-11-24T22:26:37+08:00	1386	3741	5127	366	5493	10044	54.69%	13.8%	13	19
14	花蓮縣新城鄉	2018-11-24T22:50:48+08:00	1631	4346	5977	465	6442	11797	54.61%	13.83%	15	19
14	花蓮縣新城鄉	2018-11-24T23:39:16+08:00	2112	5700	7812	586	8398	15424	54.45%	13.69%	18	19
14	高雄市橋頭區	2018-11-25T04:02:43+08:00	6068	12780	18848	1400	20248	32565	62.18%	18.63%	31	31
14	高雄市橋頭區	2018-11-25T06:29:10+08:00	6068	12780	18848	1400	20248	32565	62.18%	18.63%	31	31
14	高雄市橋頭區	2018-11-25T00:14:03+08:00	6068	12780	18848	1400	20248	32565	62.18%	18.63%	31	31
14	高雄市橋頭區	2018-11-24T23:01:25+08:00	5875	12363	18238	1369	19607	31474	62.3%	18.67%	30	31
14	高雄市橋頭區	2018-11-24T23:12:09+08:00	5875	12363	18238	1369	19607	31474	62.3%	18.67%	30	31
14	高雄市橋頭區	2018-11-24T23:43:11+08:00	5875	12363	18238	1369	19607	31474	62.3%	18.67%	30	31
14	高雄市橋頭區	2018-11-24T23:39:08+08:00	5875	12363	18238	1369	19607	31474	62.3%	18.67%	30	31
14	高雄市橋頭區	2018-11-25T00:09:27+08:00	6068	12780	18848	1400	20248	32565	62.18%	18.63%	31	31
14	高雄市橋頭區	2018-11-25T01:12:36+08:00	6068	12780	18848	1400	20248	32565	62.18%	18.63%	31	31
14	高雄市橋頭區	2018-11-24T23:35:05+08:00	5875	12363	18238	1369	19607	31474	62.3%	18.67%	30	31
14	高雄市橋頭區	2018-11-25T01:07:20+08:00	6068	12780	18848	1400	20248	32565	62.18%	18.63%	31	31
14	高雄市橋頭區	2018-11-24T23:31:04+08:00	5875	12363	18238	1369	19607	31474	62.3%	18.67%	30	31
14	高雄市橋頭區	2018-11-25T01:17:45+08:00	6068	12780	18848	1400	20248	32565	62.18%	18.63%	31	31
14	高雄市橋頭區	2018-11-24T22:13:20+08:00	5123	10867	15990	1201	17191	27709	62.04%	18.49%	27	31
14	高雄市橋頭區	2018-11-24T23:55:41+08:00	5875	12363	18238	1369	19607	31474	62.3%	18.67%	30	31
14	高雄市橋頭區	2018-11-24T22:23:06+08:00	5347	11369	16716	1279	17995	28964	62.13%	18.46%	28	31
14	高雄市橋頭區	2018-11-24T23:19:43+08:00	5875	12363	18238	1369	19607	31474	62.3%	18.67%	30	31
14	高雄市橋頭區	2018-11-24T23:04:58+08:00	5875	12363	18238	1369	19607	31474	62.3%	18.67%	30	31
14	高雄市橋頭區	2018-11-25T00:00:02+08:00	6068	12780	18848	1400	20248	32565	62.18%	18.63%	31	31
14	高雄市橋頭區	2018-11-25T00:04:59+08:00	6068	12780	18848	1400	20248	32565	62.18%	18.63%	31	31
14	高雄市橋頭區	2018-11-25T01:02:24+08:00	6068	12780	18848	1400	20248	32565	62.18%	18.63%	31	31
14	高雄市橋頭區	2018-11-24T23:27:13+08:00	5875	12363	18238	1369	19607	31474	62.3%	18.67%	30	31
14	高雄市橋頭區	2018-11-25T03:38:49+08:00	6068	12780	18848	1400	20248	32565	62.18%	18.63%	31	31
14	高雄市橋頭區	2018-11-24T22:30:00+08:00	5347	11369	16716	1279	17995	28964	62.13%	18.46%	28	31
14	高雄市橋頭區	2018-11-25T06:13:47+08:00	6068	12780	18848	1400	20248	32565	62.18%	18.63%	31	31
14	高雄市橋頭區	2018-11-24T22:54:20+08:00	5875	12363	18238	1369	19607	31474	62.3%	18.67%	30	31
14	高雄市橋頭區	2018-11-25T00:22:58+08:00	6068	12780	18848	1400	20248	32565	62.18%	18.63%	31	31
14	高雄市橋頭區	2018-11-25T03:56:05+08:00	6068	12780	18848	1400	20248	32565	62.18%	18.63%	31	31
14	高雄市橋頭區	2018-11-25T00:18:24+08:00	6068	12780	18848	1400	20248	32565	62.18%	18.63%	31	31
14	高雄市橋頭區	2018-11-25T03:49:46+08:00	6068	12780	18848	1400	20248	32565	62.18%	18.63%	31	31
14	高雄市橋頭區	2018-11-25T06:08:46+08:00	6068	12780	18848	1400	20248	32565	62.18%	18.63%	31	31
14	高雄市橋頭區	2018-11-24T23:47:22+08:00	5875	12363	18238	1369	19607	31474	62.3%	18.67%	30	31
14	高雄市橋頭區	2018-11-24T22:41:29+08:00	5581	11854	17435	1347	18782	30208	62.18%	18.48%	29	31
14	高雄市橋頭區	2018-11-24T22:16:04+08:00	5123	10867	15990	1201	17191	27709	62.04%	18.49%	27	31
14	高雄市橋頭區	2018-11-24T22:33:32+08:00	5581	11854	17435	1347	18782	30208	62.18%	18.48%	29	31
14	高雄市橋頭區	2018-11-25T03:44:16+08:00	6068	12780	18848	1400	20248	32565	62.18%	18.63%	31	31
14	高雄市橋頭區	2018-11-24T23:23:33+08:00	5875	12363	18238	1369	19607	31474	62.3%	18.67%	30	31
14	高雄市橋頭區	2018-11-24T23:51:29+08:00	5875	12363	18238	1369	19607	31474	62.3%	18.67%	30	31
14	高雄市橋頭區	2018-11-24T22:57:47+08:00	5875	12363	18238	1369	19607	31474	62.3%	18.67%	30	31
14	高雄市橋頭區	2018-11-24T22:19:31+08:00	5123	10867	15990	1201	17191	27709	62.04%	18.49%	27	31
14	高雄市橋頭區	2018-11-25T00:57:30+08:00	6068	12780	18848	1400	20248	32565	62.18%	18.63%	31	31
14	高雄市橋頭區	2018-11-25T03:32:29+08:00	6068	12780	18848	1400	20248	32565	62.18%	18.63%	31	31
14	高雄市橋頭區	2018-11-25T06:18:52+08:00	6068	12780	18848	1400	20248	32565	62.18%	18.63%	31	31
14	高雄市橋頭區	2018-11-24T22:40:22+08:00	5581	11854	17435	1347	18782	30208	62.18%	18.48%	29	31
14	高雄市橋頭區	2018-11-25T01:25:47+08:00	6068	12780	18848	1400	20248	32565	62.18%	18.63%	31	31
14	高雄市橋頭區	2018-11-24T22:36:55+08:00	5581	11854	17435	1347	18782	30208	62.18%	18.48%	29	31
14	高雄市橋頭區	2018-11-24T23:08:29+08:00	5875	12363	18238	1369	19607	31474	62.3%	18.67%	30	31
14	高雄市橋頭區	2018-11-24T23:15:57+08:00	5875	12363	18238	1369	19607	31474	62.3%	18.67%	30	31
14	高雄市橋頭區	2018-11-25T06:23:54+08:00	6068	12780	18848	1400	20248	32565	62.18%	18.63%	31	31
14	高雄市橋頭區	2018-11-24T22:26:31+08:00	5347	11369	16716	1279	17995	28964	62.13%	18.46%	28	31
14	高雄市橋頭區	2018-11-24T22:50:41+08:00	5875	12363	18238	1369	19607	31474	62.3%	18.67%	30	31
14	高雄市橋頭區	2018-11-24T22:45:03+08:00	5581	11854	17435	1347	18782	30208	62.18%	18.48%	29	31
14	高雄市旗山區	2018-11-25T04:02:43+08:00	5161	11400	16561	1326	17887	31996	55.9%	16.13%	35	35
14	高雄市旗山區	2018-11-25T01:12:37+08:00	5161	11400	16561	1326	17887	31996	55.9%	16.13%	35	35
14	高雄市旗山區	2018-11-25T00:14:03+08:00	5161	11400	16561	1326	17887	31996	55.9%	16.13%	35	35
14	高雄市旗山區	2018-11-24T23:01:25+08:00	5161	11400	16561	1326	17887	31996	55.9%	16.13%	35	35
14	高雄市旗山區	2018-11-25T01:07:21+08:00	5161	11400	16561	1326	17887	31996	55.9%	16.13%	35	35
14	高雄市旗山區	2018-11-25T00:09:27+08:00	5161	11400	16561	1326	17887	31996	55.9%	16.13%	35	35
14	高雄市旗山區	2018-11-24T23:35:05+08:00	5161	11400	16561	1326	17887	31996	55.9%	16.13%	35	35
14	高雄市旗山區	2018-11-25T06:29:11+08:00	5161	11400	16561	1326	17887	31996	55.9%	16.13%	35	35
14	高雄市旗山區	2018-11-24T23:39:09+08:00	5161	11400	16561	1326	17887	31996	55.9%	16.13%	35	35
14	高雄市旗山區	2018-11-24T23:31:04+08:00	5161	11400	16561	1326	17887	31996	55.9%	16.13%	35	35
14	高雄市旗山區	2018-11-25T01:17:45+08:00	5161	11400	16561	1326	17887	31996	55.9%	16.13%	35	35
14	高雄市旗山區	2018-11-24T22:23:07+08:00	4968	10890	15858	1270	17128	30667	55.85%	16.2%	34	35
14	高雄市旗山區	2018-11-24T23:55:41+08:00	5161	11400	16561	1326	17887	31996	55.9%	16.13%	35	35
14	高雄市旗山區	2018-11-24T23:08:30+08:00	5161	11400	16561	1326	17887	31996	55.9%	16.13%	35	35
14	高雄市旗山區	2018-11-24T23:19:44+08:00	5161	11400	16561	1326	17887	31996	55.9%	16.13%	35	35
14	高雄市旗山區	2018-11-24T22:13:21+08:00	4869	10603	15472	1255	16727	29779	56.17%	16.35%	33	35
14	高雄市旗山區	2018-11-24T23:04:58+08:00	5161	11400	16561	1326	17887	31996	55.9%	16.13%	35	35
14	高雄市旗山區	2018-11-25T00:00:02+08:00	5161	11400	16561	1326	17887	31996	55.9%	16.13%	35	35
14	高雄市旗山區	2018-11-25T00:04:59+08:00	5161	11400	16561	1326	17887	31996	55.9%	16.13%	35	35
14	高雄市旗山區	2018-11-24T23:27:13+08:00	5161	11400	16561	1326	17887	31996	55.9%	16.13%	35	35
14	高雄市旗山區	2018-11-24T22:30:00+08:00	5161	11400	16561	1326	17887	31996	55.9%	16.13%	35	35
14	高雄市旗山區	2018-11-25T01:02:25+08:00	5161	11400	16561	1326	17887	31996	55.9%	16.13%	35	35
14	高雄市旗山區	2018-11-25T06:13:47+08:00	5161	11400	16561	1326	17887	31996	55.9%	16.13%	35	35
14	高雄市旗山區	2018-11-25T00:22:58+08:00	5161	11400	16561	1326	17887	31996	55.9%	16.13%	35	35
14	高雄市旗山區	2018-11-24T22:26:32+08:00	4968	10890	15858	1270	17128	30667	55.85%	16.2%	34	35
14	高雄市旗山區	2018-11-25T00:18:24+08:00	5161	11400	16561	1326	17887	31996	55.9%	16.13%	35	35
14	高雄市旗山區	2018-11-24T22:54:21+08:00	5161	11400	16561	1326	17887	31996	55.9%	16.13%	35	35
14	高雄市旗山區	2018-11-24T22:41:30+08:00	5161	11400	16561	1326	17887	31996	55.9%	16.13%	35	35
14	高雄市旗山區	2018-11-25T03:49:46+08:00	5161	11400	16561	1326	17887	31996	55.9%	16.13%	35	35
14	高雄市旗山區	2018-11-25T06:08:46+08:00	5161	11400	16561	1326	17887	31996	55.9%	16.13%	35	35
14	高雄市旗山區	2018-11-24T23:43:12+08:00	5161	11400	16561	1326	17887	31996	55.9%	16.13%	35	35
14	高雄市旗山區	2018-11-24T23:47:22+08:00	5161	11400	16561	1326	17887	31996	55.9%	16.13%	35	35
14	高雄市旗山區	2018-11-24T22:16:04+08:00	4869	10603	15472	1255	16727	29779	56.17%	16.35%	33	35
14	高雄市旗山區	2018-11-24T22:33:32+08:00	5161	11400	16561	1326	17887	31996	55.9%	16.13%	35	35
14	高雄市旗山區	2018-11-25T03:44:16+08:00	5161	11400	16561	1326	17887	31996	55.9%	16.13%	35	35
14	高雄市旗山區	2018-11-25T03:38:50+08:00	5161	11400	16561	1326	17887	31996	55.9%	16.13%	35	35
14	高雄市旗山區	2018-11-24T23:23:33+08:00	5161	11400	16561	1326	17887	31996	55.9%	16.13%	35	35
14	高雄市旗山區	2018-11-24T23:51:29+08:00	5161	11400	16561	1326	17887	31996	55.9%	16.13%	35	35
14	高雄市旗山區	2018-11-24T22:57:47+08:00	5161	11400	16561	1326	17887	31996	55.9%	16.13%	35	35
14	高雄市旗山區	2018-11-24T22:19:31+08:00	4968	10890	15858	1270	17128	30667	55.85%	16.2%	34	35
14	高雄市旗山區	2018-11-24T22:40:23+08:00	5161	11400	16561	1326	17887	31996	55.9%	16.13%	35	35
14	高雄市旗山區	2018-11-25T03:32:29+08:00	5161	11400	16561	1326	17887	31996	55.9%	16.13%	35	35
14	高雄市旗山區	2018-11-25T06:18:52+08:00	5161	11400	16561	1326	17887	31996	55.9%	16.13%	35	35
14	高雄市旗山區	2018-11-24T23:15:58+08:00	5161	11400	16561	1326	17887	31996	55.9%	16.13%	35	35
14	高雄市旗山區	2018-11-25T00:57:31+08:00	5161	11400	16561	1326	17887	31996	55.9%	16.13%	35	35
14	高雄市旗山區	2018-11-25T01:25:47+08:00	5161	11400	16561	1326	17887	31996	55.9%	16.13%	35	35
14	高雄市旗山區	2018-11-24T22:36:55+08:00	5161	11400	16561	1326	17887	31996	55.9%	16.13%	35	35
14	高雄市旗山區	2018-11-25T03:56:06+08:00	5161	11400	16561	1326	17887	31996	55.9%	16.13%	35	35
14	高雄市旗山區	2018-11-25T06:23:55+08:00	5161	11400	16561	1326	17887	31996	55.9%	16.13%	35	35
14	高雄市旗山區	2018-11-24T23:12:10+08:00	5161	11400	16561	1326	17887	31996	55.9%	16.13%	35	35
14	高雄市旗山區	2018-11-24T22:50:41+08:00	5161	11400	16561	1326	17887	31996	55.9%	16.13%	35	35
14	高雄市旗山區	2018-11-24T22:45:03+08:00	5161	11400	16561	1326	17887	31996	55.9%	16.13%	35	35
14	嘉義縣民雄鄉	2018-11-25T03:56:10+08:00	9608	20757	30365	2454	32819	61209	53.62%	15.7%	45	45
14	嘉義縣民雄鄉	2018-11-24T23:47:26+08:00	6104	13735	19839	1679	21518	40288	53.41%	15.15%	32	45
14	嘉義縣民雄鄉	2018-11-24T23:16:01+08:00	3857	8933	12790	1059	13849	26027	53.21%	14.82%	22	45
14	嘉義縣民雄鄉	2018-11-24T22:16:08+08:00	1600	3661	5261	402	5663	11077	51.12%	14.44%	11	45
14	嘉義縣民雄鄉	2018-11-25T01:25:50+08:00	9408	20140	29548	2372	31920	59589	53.57%	15.79%	44	45
14	嘉義縣民雄鄉	2018-11-25T03:38:53+08:00	9608	20757	30365	2454	32819	61209	53.62%	15.7%	45	45
14	嘉義縣民雄鄉	2018-11-25T00:23:01+08:00	7767	16281	24048	2016	26064	48437	53.81%	16.04%	37	45
14	嘉義縣民雄鄉	2018-11-24T23:23:36+08:00	4271	9889	14160	1192	15352	28938	53.05%	14.76%	24	45
14	嘉義縣民雄鄉	2018-11-24T22:19:35+08:00	1820	4177	5997	465	6462	12431	51.98%	14.64%	12	45
14	嘉義縣民雄鄉	2018-11-25T00:57:34+08:00	8442	17812	26254	2179	28433	53103	53.54%	15.9%	40	45
14	嘉義縣民雄鄉	2018-11-24T22:40:26+08:00	2696	6252	8948	799	9747	18453	52.82%	14.61%	17	45
14	嘉義縣民雄鄉	2018-11-24T22:36:58+08:00	2696	6252	8948	799	9747	18453	52.82%	14.61%	17	45
14	嘉義縣民雄鄉	2018-11-24T22:57:51+08:00	3411	7899	11310	983	12293	23138	53.13%	14.74%	20	45
14	嘉義縣民雄鄉	2018-11-25T00:09:32+08:00	7767	16281	24048	2016	26064	48437	53.81%	16.04%	37	45
14	嘉義縣民雄鄉	2018-11-24T22:45:06+08:00	2696	6252	8948	799	9747	18453	52.82%	14.61%	17	45
14	嘉義縣民雄鄉	2018-11-25T06:08:50+08:00	9608	20757	30365	2454	32819	61209	53.62%	15.7%	45	45
14	嘉義縣民雄鄉	2018-11-25T06:23:58+08:00	9608	20757	30365	2454	32819	61209	53.62%	15.7%	45	45
14	嘉義縣民雄鄉	2018-11-24T23:39:13+08:00	5199	11835	17034	1462	18496	34658	53.37%	15%	28	45
14	嘉義縣民雄鄉	2018-11-25T03:49:49+08:00	9608	20757	30365	2454	32819	61209	53.62%	15.7%	45	45
14	嘉義縣民雄鄉	2018-11-25T01:12:41+08:00	9166	19561	28727	2343	31070	57977	53.59%	15.81%	43	45
14	嘉義縣民雄鄉	2018-11-24T22:26:35+08:00	2135	4969	7104	567	7671	14586	52.59%	14.64%	14	45
14	嘉義縣民雄鄉	2018-11-24T22:50:45+08:00	2696	6252	8948	799	9747	18453	52.82%	14.61%	17	45
14	嘉義縣民雄鄉	2018-11-24T23:12:13+08:00	3613	8449	12062	1027	13089	24721	52.95%	14.62%	21	45
14	嘉義縣民雄鄉	2018-11-25T04:02:50+08:00	9608	20757	30365	2454	32819	61209	53.62%	15.7%	45	45
14	嘉義縣民雄鄉	2018-11-24T23:43:15+08:00	5867	13274	19141	1643	20784	38865	53.48%	15.1%	31	45
14	嘉義縣民雄鄉	2018-11-25T06:29:14+08:00	9608	20757	30365	2454	32819	61209	53.62%	15.7%	45	45
14	嘉義縣民雄鄉	2018-11-25T00:14:07+08:00	7767	16281	24048	2016	26064	48437	53.81%	16.04%	37	45
14	嘉義縣民雄鄉	2018-11-24T23:01:29+08:00	3613	8449	12062	1027	13089	24721	52.95%	14.62%	21	45
14	嘉義縣民雄鄉	2018-11-25T01:07:24+08:00	9166	19561	28727	2343	31070	57977	53.59%	15.81%	43	45
14	嘉義縣民雄鄉	2018-11-24T23:31:09+08:00	5199	11835	17034	1462	18496	34658	53.37%	15%	28	45
14	嘉義縣民雄鄉	2018-11-25T06:13:50+08:00	9608	20757	30365	2454	32819	61209	53.62%	15.7%	45	45
14	嘉義縣民雄鄉	2018-11-24T23:35:08+08:00	5199	11835	17034	1462	18496	34658	53.37%	15%	28	45
14	嘉義縣民雄鄉	2018-11-24T22:33:35+08:00	2696	6252	8948	799	9747	18453	52.82%	14.61%	17	45
14	嘉義縣民雄鄉	2018-11-24T23:08:33+08:00	3613	8449	12062	1027	13089	24721	52.95%	14.62%	21	45
14	嘉義縣民雄鄉	2018-11-24T23:55:45+08:00	6331	14203	20534	1716	22250	41555	53.54%	15.24%	33	45
14	嘉義縣民雄鄉	2018-11-25T03:32:32+08:00	9608	20757	30365	2454	32819	61209	53.62%	15.7%	45	45
14	嘉義縣民雄鄉	2018-11-24T23:19:48+08:00	4271	9889	14160	1192	15352	28938	53.05%	14.76%	24	45
14	嘉義縣民雄鄉	2018-11-25T03:44:20+08:00	9608	20757	30365	2454	32819	61209	53.62%	15.7%	45	45
14	嘉義縣民雄鄉	2018-11-24T22:13:24+08:00	1391	3122	4513	353	4866	9357	52%	14.87%	10	45
14	嘉義縣民雄鄉	2018-11-25T00:00:08+08:00	6331	14203	20534	1716	22250	41555	53.54%	15.24%	33	45
14	嘉義縣民雄鄉	2018-11-25T01:17:49+08:00	9166	19561	28727	2343	31070	57977	53.59%	15.81%	43	45
14	嘉義縣民雄鄉	2018-11-25T06:18:55+08:00	9608	20757	30365	2454	32819	61209	53.62%	15.7%	45	45
14	嘉義縣民雄鄉	2018-11-25T01:02:28+08:00	8636	18247	26883	2242	29125	54305	53.63%	15.9%	41	45
14	嘉義縣民雄鄉	2018-11-24T23:27:16+08:00	4563	10518	15081	1254	16335	30656	53.28%	14.88%	25	45
14	嘉義縣民雄鄉	2018-11-24T22:30:04+08:00	2356	5549	7905	679	8584	16215	52.94%	14.53%	15	45
14	嘉義縣民雄鄉	2018-11-24T22:23:10+08:00	1985	4574	6559	519	7078	13486	52.48%	14.72%	13	45
14	嘉義縣民雄鄉	2018-11-24T23:51:32+08:00	6331	14203	20534	1716	22250	41555	53.54%	15.24%	33	45
14	嘉義縣民雄鄉	2018-11-24T22:54:23+08:00	2903	6794	9697	851	10548	19929	52.93%	14.57%	18	45
14	嘉義縣民雄鄉	2018-11-24T22:41:33+08:00	2696	6252	8948	799	9747	18453	52.82%	14.61%	17	45
14	嘉義縣民雄鄉	2018-11-25T00:05:03+08:00	6817	15317	22134	1851	23985	44558	53.83%	15.3%	35	45
14	嘉義縣民雄鄉	2018-11-24T23:05:02+08:00	3613	8449	12062	1027	13089	24721	52.95%	14.62%	21	45
14	嘉義縣民雄鄉	2018-11-25T00:18:27+08:00	7767	16281	24048	2016	26064	48437	53.81%	16.04%	37	45
14	宜蘭縣五結鄉	2018-11-24T22:33:37+08:00	4353	8737	13090	999	14089	26118	53.94%	16.67%	26	33
14	宜蘭縣五結鄉	2018-11-24T23:47:28+08:00	5805	11661	17466	1252	18718	34892	53.65%	16.64%	33	33
14	宜蘭縣五結鄉	2018-11-24T22:37:00+08:00	4603	9193	13796	1026	14822	27441	54.01%	16.77%	27	33
14	宜蘭縣五結鄉	2018-11-25T00:18:30+08:00	5805	11661	17466	1252	18718	34892	53.65%	16.64%	33	33
14	宜蘭縣五結鄉	2018-11-25T01:07:26+08:00	5805	11661	17466	1252	18718	34892	53.65%	16.64%	33	33
14	宜蘭縣五結鄉	2018-11-25T06:13:52+08:00	5805	11661	17466	1252	18718	34892	53.65%	16.64%	33	33
14	宜蘭縣五結鄉	2018-11-25T06:29:16+08:00	5805	11661	17466	1252	18718	34892	53.65%	16.64%	33	33
14	宜蘭縣五結鄉	2018-11-24T23:43:17+08:00	5805	11661	17466	1252	18718	34892	53.65%	16.64%	33	33
14	宜蘭縣五結鄉	2018-11-25T03:44:23+08:00	5805	11661	17466	1252	18718	34892	53.65%	16.64%	33	33
14	宜蘭縣五結鄉	2018-11-25T01:02:31+08:00	5805	11661	17466	1252	18718	34892	53.65%	16.64%	33	33
14	宜蘭縣五結鄉	2018-11-24T23:55:46+08:00	5805	11661	17466	1252	18718	34892	53.65%	16.64%	33	33
14	宜蘭縣五結鄉	2018-11-24T23:23:38+08:00	5600	11250	16850	1218	18068	33586	53.8%	16.67%	32	33
14	宜蘭縣五結鄉	2018-11-25T03:38:55+08:00	5805	11661	17466	1252	18718	34892	53.65%	16.64%	33	33
14	宜蘭縣五結鄉	2018-11-24T22:13:26+08:00	3627	7310	10937	846	11783	21782	54.1%	16.65%	23	33
14	宜蘭縣五結鄉	2018-11-24T23:08:36+08:00	5375	10798	16173	1199	17372	32270	53.83%	16.66%	31	33
14	宜蘭縣五結鄉	2018-11-24T22:30:08+08:00	4145	8339	12484	961	13445	24898	54%	16.65%	25	33
14	宜蘭縣五結鄉	2018-11-24T22:40:27+08:00	4603	9193	13796	1026	14822	27441	54.01%	16.77%	27	33
14	宜蘭縣五結鄉	2018-11-25T00:00:10+08:00	5805	11661	17466	1252	18718	34892	53.65%	16.64%	33	33
14	宜蘭縣五結鄉	2018-11-25T06:18:57+08:00	5805	11661	17466	1252	18718	34892	53.65%	16.64%	33	33
14	宜蘭縣五結鄉	2018-11-24T22:23:13+08:00	4145	8339	12484	961	13445	24898	54%	16.65%	25	33
14	宜蘭縣五結鄉	2018-11-24T23:19:51+08:00	5600	11250	16850	1218	18068	33586	53.8%	16.67%	32	33
14	宜蘭縣五結鄉	2018-11-24T23:12:15+08:00	5375	10798	16173	1199	17372	32270	53.83%	16.66%	31	33
14	宜蘭縣五結鄉	2018-11-24T22:45:08+08:00	4603	9193	13796	1026	14822	27441	54.01%	16.77%	27	33
14	宜蘭縣五結鄉	2018-11-24T23:01:30+08:00	5007	10047	15054	1124	16178	30014	53.9%	16.68%	29	33
14	宜蘭縣五結鄉	2018-11-24T23:39:15+08:00	5805	11661	17466	1252	18718	34892	53.65%	16.64%	33	33
14	宜蘭縣五結鄉	2018-11-24T23:31:11+08:00	5600	11250	16850	1218	18068	33586	53.8%	16.67%	32	33
14	宜蘭縣五結鄉	2018-11-25T00:09:34+08:00	5805	11661	17466	1252	18718	34892	53.65%	16.64%	33	33
14	宜蘭縣五結鄉	2018-11-24T23:35:10+08:00	5600	11250	16850	1218	18068	33586	53.8%	16.67%	32	33
14	宜蘭縣五結鄉	2018-11-25T00:14:09+08:00	5805	11661	17466	1252	18718	34892	53.65%	16.64%	33	33
14	宜蘭縣五結鄉	2018-11-25T03:49:51+08:00	5805	11661	17466	1252	18718	34892	53.65%	16.64%	33	33
14	宜蘭縣五結鄉	2018-11-24T23:16:02+08:00	5375	10798	16173	1199	17372	32270	53.83%	16.66%	31	33
14	宜蘭縣五結鄉	2018-11-25T03:56:12+08:00	5805	11661	17466	1252	18718	34892	53.65%	16.64%	33	33
14	宜蘭縣五結鄉	2018-11-25T06:24:00+08:00	5805	11661	17466	1252	18718	34892	53.65%	16.64%	33	33
14	宜蘭縣五結鄉	2018-11-25T00:23:03+08:00	5805	11661	17466	1252	18718	34892	53.65%	16.64%	33	33
14	宜蘭縣五結鄉	2018-11-25T03:32:34+08:00	5805	11661	17466	1252	18718	34892	53.65%	16.64%	33	33
14	宜蘭縣五結鄉	2018-11-25T01:25:52+08:00	5805	11661	17466	1252	18718	34892	53.65%	16.64%	33	33
14	宜蘭縣五結鄉	2018-11-24T22:57:53+08:00	5007	10047	15054	1124	16178	30014	53.9%	16.68%	29	33
14	宜蘭縣五結鄉	2018-11-24T22:19:37+08:00	4145	8339	12484	961	13445	24898	54%	16.65%	25	33
14	宜蘭縣五結鄉	2018-11-25T00:57:36+08:00	5805	11661	17466	1252	18718	34892	53.65%	16.64%	33	33
14	宜蘭縣五結鄉	2018-11-25T01:17:52+08:00	5805	11661	17466	1252	18718	34892	53.65%	16.64%	33	33
14	宜蘭縣五結鄉	2018-11-24T23:27:18+08:00	5600	11250	16850	1218	18068	33586	53.8%	16.67%	32	33
14	宜蘭縣五結鄉	2018-11-24T23:51:35+08:00	5805	11661	17466	1252	18718	34892	53.65%	16.64%	33	33
14	宜蘭縣五結鄉	2018-11-24T23:05:04+08:00	5157	10427	15584	1161	16745	31080	53.88%	16.59%	30	33
14	宜蘭縣五結鄉	2018-11-25T00:05:05+08:00	5805	11661	17466	1252	18718	34892	53.65%	16.64%	33	33
14	宜蘭縣五結鄉	2018-11-25T04:02:52+08:00	5805	11661	17466	1252	18718	34892	53.65%	16.64%	33	33
14	宜蘭縣五結鄉	2018-11-24T22:16:10+08:00	3913	7799	11712	908	12620	23332	54.09%	16.77%	24	33
14	宜蘭縣五結鄉	2018-11-25T01:12:43+08:00	5805	11661	17466	1252	18718	34892	53.65%	16.64%	33	33
14	宜蘭縣五結鄉	2018-11-24T22:41:34+08:00	4603	9193	13796	1026	14822	27441	54.01%	16.77%	27	33
14	宜蘭縣五結鄉	2018-11-24T22:50:48+08:00	4837	9651	14488	1084	15572	28954	53.78%	16.71%	28	33
14	宜蘭縣五結鄉	2018-11-24T22:26:36+08:00	4145	8339	12484	961	13445	24898	54%	16.65%	25	33
14	宜蘭縣五結鄉	2018-11-25T06:08:52+08:00	5805	11661	17466	1252	18718	34892	53.65%	16.64%	33	33
14	宜蘭縣五結鄉	2018-11-24T22:54:25+08:00	4837	9651	14488	1084	15572	28954	53.78%	16.71%	28	33
14	嘉義縣梅山鄉	2018-11-25T03:56:10+08:00	2473	6061	8534	856	9390	17083	54.97%	14.48%	22	22
14	嘉義縣梅山鄉	2018-11-24T23:47:26+08:00	2473	6061	8534	856	9390	17083	54.97%	14.48%	22	22
14	嘉義縣梅山鄉	2018-11-24T23:16:01+08:00	2473	6061	8534	856	9390	17083	54.97%	14.48%	22	22
14	嘉義縣梅山鄉	2018-11-24T22:16:08+08:00	1709	4318	6027	644	6671	12246	54.47%	13.96%	18	22
14	嘉義縣梅山鄉	2018-11-24T22:33:36+08:00	2411	5854	8265	816	9081	16650	54.54%	14.48%	21	22
14	嘉義縣梅山鄉	2018-11-25T03:38:53+08:00	2473	6061	8534	856	9390	17083	54.97%	14.48%	22	22
14	嘉義縣梅山鄉	2018-11-24T23:23:36+08:00	2473	6061	8534	856	9390	17083	54.97%	14.48%	22	22
14	嘉義縣梅山鄉	2018-11-25T01:25:51+08:00	2473	6061	8534	856	9390	17083	54.97%	14.48%	22	22
14	嘉義縣梅山鄉	2018-11-24T22:19:35+08:00	1937	4812	6749	711	7460	13634	54.72%	14.21%	19	22
14	嘉義縣梅山鄉	2018-11-25T01:17:50+08:00	2473	6061	8534	856	9390	17083	54.97%	14.48%	22	22
14	嘉義縣梅山鄉	2018-11-24T22:40:26+08:00	2473	6061	8534	856	9390	17083	54.97%	14.48%	22	22
14	嘉義縣梅山鄉	2018-11-25T00:57:35+08:00	2473	6061	8534	856	9390	17083	54.97%	14.48%	22	22
14	嘉義縣梅山鄉	2018-11-24T22:36:58+08:00	2411	5854	8265	816	9081	16650	54.54%	14.48%	21	22
14	嘉義縣梅山鄉	2018-11-24T22:57:51+08:00	2473	6061	8534	856	9390	17083	54.97%	14.48%	22	22
14	嘉義縣梅山鄉	2018-11-25T00:09:32+08:00	2473	6061	8534	856	9390	17083	54.97%	14.48%	22	22
14	嘉義縣梅山鄉	2018-11-25T06:08:50+08:00	2473	6061	8534	856	9390	17083	54.97%	14.48%	22	22
14	嘉義縣梅山鄉	2018-11-25T06:23:58+08:00	2473	6061	8534	856	9390	17083	54.97%	14.48%	22	22
14	嘉義縣梅山鄉	2018-11-24T23:39:13+08:00	2473	6061	8534	856	9390	17083	54.97%	14.48%	22	22
14	嘉義縣梅山鄉	2018-11-25T03:49:49+08:00	2473	6061	8534	856	9390	17083	54.97%	14.48%	22	22
14	嘉義縣梅山鄉	2018-11-25T01:12:41+08:00	2473	6061	8534	856	9390	17083	54.97%	14.48%	22	22
14	嘉義縣梅山鄉	2018-11-24T22:26:35+08:00	2132	5210	7342	762	8104	14823	54.67%	14.38%	20	22
14	嘉義縣梅山鄉	2018-11-24T23:12:14+08:00	2473	6061	8534	856	9390	17083	54.97%	14.48%	22	22
14	嘉義縣梅山鄉	2018-11-24T22:45:07+08:00	2473	6061	8534	856	9390	17083	54.97%	14.48%	22	22
14	嘉義縣梅山鄉	2018-11-25T04:02:50+08:00	2473	6061	8534	856	9390	17083	54.97%	14.48%	22	22
14	嘉義縣梅山鄉	2018-11-24T23:43:15+08:00	2473	6061	8534	856	9390	17083	54.97%	14.48%	22	22
14	嘉義縣梅山鄉	2018-11-25T00:14:07+08:00	2473	6061	8534	856	9390	17083	54.97%	14.48%	22	22
14	嘉義縣梅山鄉	2018-11-24T23:35:09+08:00	2473	6061	8534	856	9390	17083	54.97%	14.48%	22	22
14	嘉義縣梅山鄉	2018-11-24T23:01:29+08:00	2473	6061	8534	856	9390	17083	54.97%	14.48%	22	22
14	嘉義縣梅山鄉	2018-11-25T01:07:24+08:00	2473	6061	8534	856	9390	17083	54.97%	14.48%	22	22
14	嘉義縣梅山鄉	2018-11-24T23:31:09+08:00	2473	6061	8534	856	9390	17083	54.97%	14.48%	22	22
14	嘉義縣梅山鄉	2018-11-25T06:13:50+08:00	2473	6061	8534	856	9390	17083	54.97%	14.48%	22	22
14	嘉義縣梅山鄉	2018-11-25T06:29:15+08:00	2473	6061	8534	856	9390	17083	54.97%	14.48%	22	22
14	嘉義縣梅山鄉	2018-11-24T23:55:45+08:00	2473	6061	8534	856	9390	17083	54.97%	14.48%	22	22
14	嘉義縣梅山鄉	2018-11-24T23:08:34+08:00	2473	6061	8534	856	9390	17083	54.97%	14.48%	22	22
14	嘉義縣梅山鄉	2018-11-25T00:00:09+08:00	2473	6061	8534	856	9390	17083	54.97%	14.48%	22	22
14	嘉義縣梅山鄉	2018-11-25T00:23:02+08:00	2473	6061	8534	856	9390	17083	54.97%	14.48%	22	22
14	嘉義縣梅山鄉	2018-11-24T23:19:48+08:00	2473	6061	8534	856	9390	17083	54.97%	14.48%	22	22
14	嘉義縣梅山鄉	2018-11-25T03:32:33+08:00	2473	6061	8534	856	9390	17083	54.97%	14.48%	22	22
14	嘉義縣梅山鄉	2018-11-25T03:44:21+08:00	2473	6061	8534	856	9390	17083	54.97%	14.48%	22	22
14	嘉義縣梅山鄉	2018-11-24T22:13:25+08:00	1618	4082	5700	610	6310	11610	54.35%	13.94%	17	22
14	嘉義縣梅山鄉	2018-11-24T22:23:11+08:00	1937	4812	6749	711	7460	13634	54.72%	14.21%	19	22
14	嘉義縣梅山鄉	2018-11-24T23:27:17+08:00	2473	6061	8534	856	9390	17083	54.97%	14.48%	22	22
14	嘉義縣梅山鄉	2018-11-24T23:51:33+08:00	2473	6061	8534	856	9390	17083	54.97%	14.48%	22	22
14	嘉義縣梅山鄉	2018-11-25T06:18:55+08:00	2473	6061	8534	856	9390	17083	54.97%	14.48%	22	22
14	嘉義縣梅山鄉	2018-11-25T01:02:28+08:00	2473	6061	8534	856	9390	17083	54.97%	14.48%	22	22
14	嘉義縣梅山鄉	2018-11-24T22:30:04+08:00	2132	5210	7342	762	8104	14823	54.67%	14.38%	20	22
14	嘉義縣梅山鄉	2018-11-24T23:05:03+08:00	2473	6061	8534	856	9390	17083	54.97%	14.48%	22	22
14	嘉義縣梅山鄉	2018-11-24T22:54:24+08:00	2473	6061	8534	856	9390	17083	54.97%	14.48%	22	22
14	嘉義縣梅山鄉	2018-11-25T00:18:28+08:00	2473	6061	8534	856	9390	17083	54.97%	14.48%	22	22
14	嘉義縣梅山鄉	2018-11-24T22:41:33+08:00	2473	6061	8534	856	9390	17083	54.97%	14.48%	22	22
14	嘉義縣梅山鄉	2018-11-25T00:05:03+08:00	2473	6061	8534	856	9390	17083	54.97%	14.48%	22	22
14	嘉義縣梅山鄉	2018-11-24T22:50:46+08:00	2473	6061	8534	856	9390	17083	54.97%	14.48%	22	22
14	金門縣金沙鎮	2018-11-24T22:33:39+08:00	987	4054	5041	250	5291	15033	35.2%	6.57%	11	13
14	金門縣金沙鎮	2018-11-25T03:49:52+08:00	1191	5049	6240	336	6576	18560	35.43%	6.42%	13	13
14	金門縣金沙鎮	2018-11-24T23:43:18+08:00	1191	5049	6240	336	6576	18560	35.43%	6.42%	13	13
14	金門縣金沙鎮	2018-11-25T06:29:18+08:00	1191	5049	6240	336	6576	18560	35.43%	6.42%	13	13
14	金門縣金沙鎮	2018-11-25T01:07:27+08:00	1191	5049	6240	336	6576	18560	35.43%	6.42%	13	13
14	金門縣金沙鎮	2018-11-25T06:13:53+08:00	1191	5049	6240	336	6576	18560	35.43%	6.42%	13	13
14	金門縣金沙鎮	2018-11-25T00:18:31+08:00	1191	5049	6240	336	6576	18560	35.43%	6.42%	13	13
14	金門縣金沙鎮	2018-11-25T03:44:24+08:00	1191	5049	6240	336	6576	18560	35.43%	6.42%	13	13
14	金門縣金沙鎮	2018-11-24T23:08:37+08:00	1191	5049	6240	336	6576	18560	35.43%	6.42%	13	13
14	金門縣金沙鎮	2018-11-25T03:32:36+08:00	1191	5049	6240	336	6576	18560	35.43%	6.42%	13	13
14	金門縣金沙鎮	2018-11-24T23:55:48+08:00	1191	5049	6240	336	6576	18560	35.43%	6.42%	13	13
14	金門縣金沙鎮	2018-11-24T22:13:28+08:00	987	4054	5041	250	5291	15033	35.2%	6.57%	11	13
14	金門縣金沙鎮	2018-11-24T23:23:39+08:00	1191	5049	6240	336	6576	18560	35.43%	6.42%	13	13
14	金門縣金沙鎮	2018-11-25T06:18:58+08:00	1191	5049	6240	336	6576	18560	35.43%	6.42%	13	13
14	金門縣金沙鎮	2018-11-24T22:40:29+08:00	1080	4579	5659	292	5951	17036	34.93%	6.34%	12	13
14	金門縣金沙鎮	2018-11-24T23:51:36+08:00	1191	5049	6240	336	6576	18560	35.43%	6.42%	13	13
14	金門縣金沙鎮	2018-11-24T22:23:14+08:00	987	4054	5041	250	5291	15033	35.2%	6.57%	11	13
14	金門縣金沙鎮	2018-11-25T00:09:35+08:00	1191	5049	6240	336	6576	18560	35.43%	6.42%	13	13
14	金門縣金沙鎮	2018-11-24T22:54:27+08:00	1191	5049	6240	336	6576	18560	35.43%	6.42%	13	13
14	金門縣金沙鎮	2018-11-25T00:14:11+08:00	1191	5049	6240	336	6576	18560	35.43%	6.42%	13	13
14	金門縣金沙鎮	2018-11-25T00:05:06+08:00	1191	5049	6240	336	6576	18560	35.43%	6.42%	13	13
14	金門縣金沙鎮	2018-11-24T22:41:36+08:00	1080	4579	5659	292	5951	17036	34.93%	6.34%	12	13
14	金門縣金沙鎮	2018-11-24T22:16:12+08:00	987	4054	5041	250	5291	15033	35.2%	6.57%	11	13
14	金門縣金沙鎮	2018-11-24T22:45:10+08:00	1080	4579	5659	292	5951	17036	34.93%	6.34%	12	13
14	金門縣金沙鎮	2018-11-25T03:56:14+08:00	1191	5049	6240	336	6576	18560	35.43%	6.42%	13	13
14	金門縣金沙鎮	2018-11-24T22:37:02+08:00	987	4054	5041	250	5291	15033	35.2%	6.57%	11	13
14	金門縣金沙鎮	2018-11-24T23:16:04+08:00	1191	5049	6240	336	6576	18560	35.43%	6.42%	13	13
14	金門縣金沙鎮	2018-11-25T00:23:05+08:00	1191	5049	6240	336	6576	18560	35.43%	6.42%	13	13
14	金門縣金沙鎮	2018-11-25T01:25:54+08:00	1191	5049	6240	336	6576	18560	35.43%	6.42%	13	13
14	金門縣金沙鎮	2018-11-25T01:02:32+08:00	1191	5049	6240	336	6576	18560	35.43%	6.42%	13	13
14	金門縣金沙鎮	2018-11-24T22:30:10+08:00	987	4054	5041	250	5291	15033	35.2%	6.57%	11	13
14	金門縣金沙鎮	2018-11-25T06:24:01+08:00	1191	5049	6240	336	6576	18560	35.43%	6.42%	13	13
14	金門縣金沙鎮	2018-11-25T03:38:56+08:00	1191	5049	6240	336	6576	18560	35.43%	6.42%	13	13
14	金門縣金沙鎮	2018-11-24T23:27:19+08:00	1191	5049	6240	336	6576	18560	35.43%	6.42%	13	13
14	金門縣金沙鎮	2018-11-24T22:19:38+08:00	987	4054	5041	250	5291	15033	35.2%	6.57%	11	13
14	金門縣金沙鎮	2018-11-24T23:19:53+08:00	1191	5049	6240	336	6576	18560	35.43%	6.42%	13	13
14	金門縣金沙鎮	2018-11-25T01:17:54+08:00	1191	5049	6240	336	6576	18560	35.43%	6.42%	13	13
14	金門縣金沙鎮	2018-11-25T00:00:12+08:00	1191	5049	6240	336	6576	18560	35.43%	6.42%	13	13
14	金門縣金沙鎮	2018-11-24T22:57:55+08:00	1191	5049	6240	336	6576	18560	35.43%	6.42%	13	13
14	金門縣金沙鎮	2018-11-25T00:57:38+08:00	1191	5049	6240	336	6576	18560	35.43%	6.42%	13	13
14	金門縣金沙鎮	2018-11-24T23:35:12+08:00	1191	5049	6240	336	6576	18560	35.43%	6.42%	13	13
14	金門縣金沙鎮	2018-11-24T23:47:30+08:00	1191	5049	6240	336	6576	18560	35.43%	6.42%	13	13
14	金門縣金沙鎮	2018-11-25T06:08:54+08:00	1191	5049	6240	336	6576	18560	35.43%	6.42%	13	13
14	金門縣金沙鎮	2018-11-24T23:39:17+08:00	1191	5049	6240	336	6576	18560	35.43%	6.42%	13	13
14	金門縣金沙鎮	2018-11-24T22:50:49+08:00	1191	5049	6240	336	6576	18560	35.43%	6.42%	13	13
14	金門縣金沙鎮	2018-11-24T23:31:13+08:00	1191	5049	6240	336	6576	18560	35.43%	6.42%	13	13
14	金門縣金沙鎮	2018-11-25T04:02:53+08:00	1191	5049	6240	336	6576	18560	35.43%	6.42%	13	13
14	金門縣金沙鎮	2018-11-24T23:05:05+08:00	1191	5049	6240	336	6576	18560	35.43%	6.42%	13	13
14	金門縣金沙鎮	2018-11-24T23:01:32+08:00	1191	5049	6240	336	6576	18560	35.43%	6.42%	13	13
14	金門縣金沙鎮	2018-11-25T01:12:45+08:00	1191	5049	6240	336	6576	18560	35.43%	6.42%	13	13
14	金門縣金沙鎮	2018-11-24T22:26:38+08:00	987	4054	5041	250	5291	15033	35.2%	6.57%	11	13
14	金門縣金沙鎮	2018-11-24T23:12:17+08:00	1191	5049	6240	336	6576	18560	35.43%	6.42%	13	13
14	臺中市西區	2018-11-24T23:47:19+08:00	18174	34263	52437	2547	54984	93586	58.75%	19.42%	65	66
14	臺中市西區	2018-11-24T22:16:01+08:00	12052	22761	34813	1789	36602	62006	59.03%	19.44%	45	66
14	臺中市西區	2018-11-25T01:07:17+08:00	18475	34789	53264	2577	55841	95040	58.76%	19.44%	66	66
14	臺中市西區	2018-11-24T23:01:22+08:00	16697	31376	48073	2351	50424	85649	58.87%	19.49%	60	66
14	臺中市西區	2018-11-25T06:08:42+08:00	18475	34789	53264	2577	55841	95040	58.76%	19.44%	66	66
14	臺中市西區	2018-11-24T23:35:02+08:00	17878	33617	51495	2496	53991	91768	58.83%	19.48%	64	66
14	臺中市西區	2018-11-24T23:12:06+08:00	17257	32451	49708	2424	52132	88725	58.76%	19.45%	62	66
14	臺中市西區	2018-11-24T22:26:29+08:00	13790	25981	39771	2036	41807	70952	58.92%	19.44%	51	66
14	臺中市西區	2018-11-25T03:44:12+08:00	18475	34789	53264	2577	55841	95040	58.76%	19.44%	66	66
14	臺中市西區	2018-11-24T22:19:29+08:00	13170	24887	38057	1967	40024	68046	58.82%	19.35%	49	66
14	臺中市西區	2018-11-25T00:04:56+08:00	18475	34789	53264	2577	55841	95040	58.76%	19.44%	66	66
14	臺中市西區	2018-11-24T22:57:44+08:00	16697	31376	48073	2351	50424	85649	58.87%	19.49%	60	66
14	臺中市西區	2018-11-25T00:57:27+08:00	18475	34789	53264	2577	55841	95040	58.76%	19.44%	66	66
14	臺中市西區	2018-11-24T22:13:17+08:00	11772	22240	34012	1742	35754	60607	58.99%	19.42%	44	66
14	臺中市西區	2018-11-24T23:23:30+08:00	17573	33067	50640	2458	53098	90338	58.78%	19.45%	63	66
14	臺中市西區	2018-11-24T23:55:38+08:00	18174	34263	52437	2547	54984	93586	58.75%	19.42%	65	66
14	臺中市西區	2018-11-24T22:40:20+08:00	15429	28904	44333	2216	46549	79092	58.85%	19.51%	56	66
14	臺中市西區	2018-11-24T23:15:54+08:00	17573	33067	50640	2458	53098	90338	58.78%	19.45%	63	66
14	臺中市西區	2018-11-25T01:25:43+08:00	18475	34789	53264	2577	55841	95040	58.76%	19.44%	66	66
14	臺中市西區	2018-11-24T23:59:59+08:00	18174	34263	52437	2547	54984	93586	58.75%	19.42%	65	66
14	臺中市西區	2018-11-25T01:02:22+08:00	18475	34789	53264	2577	55841	95040	58.76%	19.44%	66	66
14	臺中市西區	2018-11-25T03:38:47+08:00	18475	34789	53264	2577	55841	95040	58.76%	19.44%	66	66
14	臺中市西區	2018-11-24T22:54:18+08:00	16697	31376	48073	2351	50424	85649	58.87%	19.49%	60	66
14	臺中市西區	2018-11-25T06:23:51+08:00	18475	34789	53264	2577	55841	95040	58.76%	19.44%	66	66
14	臺中市西區	2018-11-25T03:56:02+08:00	18475	34789	53264	2577	55841	95040	58.76%	19.44%	66	66
14	臺中市西區	2018-11-24T22:45:00+08:00	16070	30250	46320	2277	48597	82608	58.83%	19.45%	58	66
14	臺中市西區	2018-11-24T23:31:01+08:00	17878	33617	51495	2496	53991	91768	58.83%	19.48%	64	66
14	臺中市西區	2018-11-25T00:09:24+08:00	18475	34789	53264	2577	55841	95040	58.76%	19.44%	66	66
14	臺中市西區	2018-11-24T22:41:27+08:00	15429	28904	44333	2216	46549	79092	58.85%	19.51%	56	66
14	臺中市西區	2018-11-25T04:02:40+08:00	18475	34789	53264	2577	55841	95040	58.76%	19.44%	66	66
14	臺中市西區	2018-11-25T01:12:33+08:00	18475	34789	53264	2577	55841	95040	58.76%	19.44%	66	66
14	臺中市西區	2018-11-24T22:50:37+08:00	16380	30862	47242	2315	49557	84144	58.9%	19.47%	59	66
14	臺中市西區	2018-11-25T00:14:00+08:00	18475	34789	53264	2577	55841	95040	58.76%	19.44%	66	66
14	臺中市西區	2018-11-24T23:39:04+08:00	17878	33617	51495	2496	53991	91768	58.83%	19.48%	64	66
14	臺中市西區	2018-11-24T23:51:26+08:00	18174	34263	52437	2547	54984	93586	58.75%	19.42%	65	66
14	臺中市西區	2018-11-25T06:18:49+08:00	18475	34789	53264	2577	55841	95040	58.76%	19.44%	66	66
14	臺中市西區	2018-11-25T01:17:41+08:00	18475	34789	53264	2577	55841	95040	58.76%	19.44%	66	66
14	臺中市西區	2018-11-24T22:23:03+08:00	13513	25546	39059	2011	41070	69777	58.86%	19.37%	50	66
14	臺中市西區	2018-11-24T22:29:56+08:00	14346	27056	41402	2095	43497	73791	58.95%	19.44%	53	66
14	臺中市西區	2018-11-24T23:04:55+08:00	17257	32451	49708	2424	52132	88725	58.76%	19.45%	62	66
14	臺中市西區	2018-11-24T23:19:40+08:00	17573	33067	50640	2458	53098	90338	58.78%	19.45%	63	66
14	臺中市西區	2018-11-24T22:36:53+08:00	15429	28904	44333	2216	46549	79092	58.85%	19.51%	56	66
14	臺中市西區	2018-11-24T23:27:10+08:00	17878	33617	51495	2496	53991	91768	58.83%	19.48%	64	66
14	臺中市西區	2018-11-24T23:08:26+08:00	17257	32451	49708	2424	52132	88725	58.76%	19.45%	62	66
14	臺中市西區	2018-11-25T03:32:26+08:00	18475	34789	53264	2577	55841	95040	58.76%	19.44%	66	66
14	臺中市西區	2018-11-25T03:49:43+08:00	18475	34789	53264	2577	55841	95040	58.76%	19.44%	66	66
14	臺中市西區	2018-11-25T00:22:55+08:00	18475	34789	53264	2577	55841	95040	58.76%	19.44%	66	66
14	臺中市西區	2018-11-25T06:13:44+08:00	18475	34789	53264	2577	55841	95040	58.76%	19.44%	66	66
14	臺中市西區	2018-11-25T00:18:21+08:00	18475	34789	53264	2577	55841	95040	58.76%	19.44%	66	66
14	臺中市西區	2018-11-24T22:33:29+08:00	14651	27581	42232	2144	44376	75219	59%	19.48%	54	66
14	臺中市西區	2018-11-25T06:29:07+08:00	18475	34789	53264	2577	55841	95040	58.76%	19.44%	66	66
14	臺中市西區	2018-11-24T23:43:08+08:00	17878	33617	51495	2496	53991	91768	58.83%	19.48%	64	66
14	臺中市梧棲區	2018-11-24T23:47:19+08:00	7603	17622	25225	1685	26910	47040	57.21%	16.16%	36	36
14	臺中市梧棲區	2018-11-24T23:35:03+08:00	7603	17622	25225	1685	26910	47040	57.21%	16.16%	36	36
14	臺中市梧棲區	2018-11-24T22:16:01+08:00	6664	15388	22052	1517	23569	40917	57.6%	16.29%	32	36
14	臺中市梧棲區	2018-11-24T23:01:22+08:00	7384	17077	24461	1648	26109	45590	57.27%	16.2%	35	36
14	臺中市梧棲區	2018-11-24T23:12:06+08:00	7603	17622	25225	1685	26910	47040	57.21%	16.16%	36	36
14	臺中市梧棲區	2018-11-25T01:07:18+08:00	7603	17622	25225	1685	26910	47040	57.21%	16.16%	36	36
14	臺中市梧棲區	2018-11-25T06:08:43+08:00	7603	17622	25225	1685	26910	47040	57.21%	16.16%	36	36
14	臺中市梧棲區	2018-11-24T22:26:29+08:00	7227	16632	23859	1610	25469	44455	57.29%	16.26%	34	36
14	臺中市梧棲區	2018-11-25T03:44:12+08:00	7603	17622	25225	1685	26910	47040	57.21%	16.16%	36	36
14	臺中市梧棲區	2018-11-25T01:17:42+08:00	7603	17622	25225	1685	26910	47040	57.21%	16.16%	36	36
14	臺中市梧棲區	2018-11-24T22:13:18+08:00	6469	14878	21347	1464	22811	39518	57.72%	16.37%	31	36
14	臺中市梧棲區	2018-11-24T22:19:29+08:00	6664	15388	22052	1517	23569	40917	57.6%	16.29%	32	36
14	臺中市梧棲區	2018-11-25T00:57:28+08:00	7603	17622	25225	1685	26910	47040	57.21%	16.16%	36	36
14	臺中市梧棲區	2018-11-24T22:57:44+08:00	7384	17077	24461	1648	26109	45590	57.27%	16.2%	35	36
14	臺中市梧棲區	2018-11-24T23:23:30+08:00	7603	17622	25225	1685	26910	47040	57.21%	16.16%	36	36
14	臺中市梧棲區	2018-11-25T00:04:57+08:00	7603	17622	25225	1685	26910	47040	57.21%	16.16%	36	36
14	臺中市梧棲區	2018-11-24T23:04:56+08:00	7384	17077	24461	1648	26109	45590	57.27%	16.2%	35	36
14	臺中市梧棲區	2018-11-24T22:40:20+08:00	7227	16632	23859	1610	25469	44455	57.29%	16.26%	34	36
14	臺中市梧棲區	2018-11-24T23:15:54+08:00	7603	17622	25225	1685	26910	47040	57.21%	16.16%	36	36
14	臺中市梧棲區	2018-11-25T01:25:44+08:00	7603	17622	25225	1685	26910	47040	57.21%	16.16%	36	36
14	臺中市梧棲區	2018-11-24T23:59:59+08:00	7603	17622	25225	1685	26910	47040	57.21%	16.16%	36	36
14	臺中市梧棲區	2018-11-25T01:02:22+08:00	7603	17622	25225	1685	26910	47040	57.21%	16.16%	36	36
14	臺中市梧棲區	2018-11-25T03:38:47+08:00	7603	17622	25225	1685	26910	47040	57.21%	16.16%	36	36
14	臺中市梧棲區	2018-11-24T23:55:39+08:00	7603	17622	25225	1685	26910	47040	57.21%	16.16%	36	36
14	臺中市梧棲區	2018-11-24T22:54:18+08:00	7384	17077	24461	1648	26109	45590	57.27%	16.2%	35	36
14	臺中市梧棲區	2018-11-24T22:45:01+08:00	7227	16632	23859	1610	25469	44455	57.29%	16.26%	34	36
14	臺中市梧棲區	2018-11-25T03:56:02+08:00	7603	17622	25225	1685	26910	47040	57.21%	16.16%	36	36
14	臺中市梧棲區	2018-11-24T23:39:05+08:00	7603	17622	25225	1685	26910	47040	57.21%	16.16%	36	36
14	臺中市梧棲區	2018-11-24T23:31:01+08:00	7603	17622	25225	1685	26910	47040	57.21%	16.16%	36	36
14	臺中市梧棲區	2018-11-25T00:09:24+08:00	7603	17622	25225	1685	26910	47040	57.21%	16.16%	36	36
14	臺中市梧棲區	2018-11-24T22:41:27+08:00	7227	16632	23859	1610	25469	44455	57.29%	16.26%	34	36
14	臺中市梧棲區	2018-11-25T04:02:40+08:00	7603	17622	25225	1685	26910	47040	57.21%	16.16%	36	36
14	臺中市梧棲區	2018-11-25T01:12:33+08:00	7603	17622	25225	1685	26910	47040	57.21%	16.16%	36	36
14	臺中市梧棲區	2018-11-25T00:14:01+08:00	7603	17622	25225	1685	26910	47040	57.21%	16.16%	36	36
14	臺中市梧棲區	2018-11-24T22:50:38+08:00	7227	16632	23859	1610	25469	44455	57.29%	16.26%	34	36
14	臺中市梧棲區	2018-11-24T23:51:26+08:00	7603	17622	25225	1685	26910	47040	57.21%	16.16%	36	36
14	臺中市梧棲區	2018-11-25T06:18:49+08:00	7603	17622	25225	1685	26910	47040	57.21%	16.16%	36	36
14	臺中市梧棲區	2018-11-24T22:23:03+08:00	6933	16025	22958	1565	24523	42713	57.41%	16.23%	33	36
14	臺中市梧棲區	2018-11-24T22:29:56+08:00	7227	16632	23859	1610	25469	44455	57.29%	16.26%	34	36
14	臺中市梧棲區	2018-11-24T23:19:40+08:00	7603	17622	25225	1685	26910	47040	57.21%	16.16%	36	36
14	臺中市梧棲區	2018-11-24T22:36:53+08:00	7227	16632	23859	1610	25469	44455	57.29%	16.26%	34	36
14	臺中市梧棲區	2018-11-24T23:08:26+08:00	7603	17622	25225	1685	26910	47040	57.21%	16.16%	36	36
14	臺中市梧棲區	2018-11-24T23:27:11+08:00	7603	17622	25225	1685	26910	47040	57.21%	16.16%	36	36
14	臺中市梧棲區	2018-11-25T03:32:26+08:00	7603	17622	25225	1685	26910	47040	57.21%	16.16%	36	36
14	臺中市梧棲區	2018-11-25T03:49:43+08:00	7603	17622	25225	1685	26910	47040	57.21%	16.16%	36	36
14	臺中市梧棲區	2018-11-25T06:29:08+08:00	7603	17622	25225	1685	26910	47040	57.21%	16.16%	36	36
14	臺中市梧棲區	2018-11-25T00:22:55+08:00	7603	17622	25225	1685	26910	47040	57.21%	16.16%	36	36
14	臺中市梧棲區	2018-11-25T06:13:44+08:00	7603	17622	25225	1685	26910	47040	57.21%	16.16%	36	36
14	臺中市梧棲區	2018-11-25T00:18:21+08:00	7603	17622	25225	1685	26910	47040	57.21%	16.16%	36	36
14	臺中市梧棲區	2018-11-25T06:23:52+08:00	7603	17622	25225	1685	26910	47040	57.21%	16.16%	36	36
14	臺中市梧棲區	2018-11-24T23:43:09+08:00	7603	17622	25225	1685	26910	47040	57.21%	16.16%	36	36
14	臺中市梧棲區	2018-11-24T22:33:29+08:00	7227	16632	23859	1610	25469	44455	57.29%	16.26%	34	36
14	臺北市大同區	2018-11-24T23:47:17+08:00	19269	29009	48278	2829	51107	87914	58.13%	21.92%	68	82
14	臺北市大同區	2018-11-24T22:26:28+08:00	12302	18024	30326	1822	32148	54534	58.95%	22.56%	44	82
14	臺北市大同區	2018-11-25T01:12:31+08:00	22961	34598	57559	3323	60882	104675	58.16%	21.94%	80	82
14	臺北市大同區	2018-11-25T01:07:16+08:00	22961	34598	57559	3323	60882	104675	58.16%	21.94%	80	82
14	臺北市大同區	2018-11-24T22:19:27+08:00	11992	17573	29565	1802	31367	53210	58.95%	22.54%	43	82
14	臺北市大同區	2018-11-24T22:13:16+08:00	11677	17083	28760	1768	30528	51748	58.99%	22.57%	42	82
14	臺北市大同區	2018-11-24T22:57:42+08:00	16375	24538	40913	2403	43316	74669	58.01%	21.93%	58	82
14	臺北市大同區	2018-11-25T00:57:26+08:00	22961	34598	57559	3323	60882	104675	58.16%	21.94%	80	82
14	臺北市大同區	2018-11-24T23:51:25+08:00	19269	29009	48278	2829	51107	87914	58.13%	21.92%	68	82
14	臺北市大同區	2018-11-24T22:29:54+08:00	12929	19074	32003	1894	33897	57520	58.93%	22.48%	46	82
14	臺北市大同區	2018-11-24T23:27:09+08:00	18644	28127	46771	2728	49499	85269	58.05%	21.86%	66	82
14	臺北市大同區	2018-11-24T22:44:59+08:00	14250	21400	35650	2090	37740	65037	58.03%	21.91%	51	82
14	臺北市大同區	2018-11-24T22:19:28+08:00	11992	17573	29565	1802	31367	53210	58.95%	22.54%	43	82
14	臺北市大同區	2018-11-24T22:23:01+08:00	12302	18024	30326	1822	32148	54534	58.95%	22.56%	44	82
14	臺北市大同區	2018-11-24T23:51:24+08:00	19269	29009	48278	2829	51107	87914	58.13%	21.92%	68	82
14	臺北市大同區	2018-11-24T23:15:52+08:00	18370	27694	46064	2680	48744	83940	58.07%	21.88%	65	82
14	臺北市大同區	2018-11-25T03:32:24+08:00	23597	35491	59088	3422	62510	107557	58.12%	21.94%	82	82
14	臺北市大同區	2018-11-25T03:38:46+08:00	23597	35491	59088	3422	62510	107557	58.12%	21.94%	82	82
14	臺北市大同區	2018-11-25T01:25:42+08:00	23597	35491	59088	3422	62510	107557	58.12%	21.94%	82	82
14	臺北市大同區	2018-11-24T23:55:36+08:00	19866	29930	49796	2899	52695	90555	58.19%	21.94%	70	82
14	臺北市大同區	2018-11-24T22:40:18+08:00	13976	20892	34868	2034	36902	62578	58.97%	22.33%	50	82
14	臺北市大同區	2018-11-24T23:08:24+08:00	17524	26333	43857	2549	46406	79840	58.12%	21.95%	62	82
14	臺北市大同區	2018-11-24T23:15:53+08:00	18370	27694	46064	2680	48744	83940	58.07%	21.88%	65	82
14	臺北市大同區	2018-11-24T23:59:57+08:00	20126	30366	50492	2938	53430	91831	58.18%	21.92%	71	82
14	臺北市大同區	2018-11-24T22:40:19+08:00	13976	20892	34868	2034	36902	62578	58.97%	22.33%	50	82
14	臺北市大同區	2018-11-24T23:55:37+08:00	19866	29930	49796	2899	52695	90555	58.19%	21.94%	70	82
14	臺北市大同區	2018-11-25T00:13:59+08:00	20126	30366	50492	2938	53430	91831	58.18%	21.92%	71	82
14	臺北市大同區	2018-11-24T22:36:51+08:00	13442	20020	33462	1960	35422	60140	58.9%	22.35%	48	82
14	臺北市大同區	2018-11-24T22:54:16+08:00	16082	24106	40188	2375	42563	73321	58.05%	21.93%	57	82
14	臺北市大同區	2018-11-25T06:29:05+08:00	23597	35491	59088	3422	62510	107557	58.12%	21.94%	82	82
14	臺北市大同區	2018-11-24T22:54:17+08:00	16082	24106	40188	2375	42563	73321	58.05%	21.93%	57	82
14	臺北市大同區	2018-11-25T06:23:50+08:00	23597	35491	59088	3422	62510	107557	58.12%	21.94%	82	82
14	臺北市大同區	2018-11-25T03:49:41+08:00	23597	35491	59088	3422	62510	107557	58.12%	21.94%	82	82
14	臺北市大同區	2018-11-24T23:39:02+08:00	18969	28599	47568	2786	50354	86653	58.11%	21.89%	67	82
14	臺北市大同區	2018-11-24T23:12:04+08:00	17524	26333	43857	2549	46406	79840	58.12%	21.95%	62	82
14	臺北市大同區	2018-11-25T06:08:41+08:00	23597	35491	59088	3422	62510	107557	58.12%	21.94%	82	82
14	臺北市大同區	2018-11-25T06:08:40+08:00	23597	35491	59088	3422	62510	107557	58.12%	21.94%	82	82
14	臺北市大同區	2018-11-25T00:09:22+08:00	20126	30366	50492	2938	53430	91831	58.18%	21.92%	71	82
14	臺北市大同區	2018-11-24T23:31:00+08:00	18644	28127	46771	2728	49499	85269	58.05%	21.86%	66	82
14	臺北市大同區	2018-11-24T23:39:03+08:00	18969	28599	47568	2786	50354	86653	58.11%	21.89%	67	82
14	臺北市大同區	2018-11-24T23:01:20+08:00	16589	25058	41647	2442	44089	75947	58.05%	21.84%	59	82
14	臺北市大同區	2018-11-24T22:50:36+08:00	15520	23234	38754	2254	41008	70796	57.92%	21.92%	55	82
14	臺北市大同區	2018-11-25T01:12:32+08:00	22961	34598	57559	3323	60882	104675	58.16%	21.94%	80	82
14	臺北市大同區	2018-11-24T22:41:26+08:00	13976	20892	34868	2034	36902	62578	58.97%	22.33%	50	82
14	臺北市大同區	2018-11-24T23:35:01+08:00	18644	28127	46771	2728	49499	85269	58.05%	21.86%	66	82
14	臺北市大同區	2018-11-24T23:04:54+08:00	17524	26333	43857	2549	46406	79840	58.12%	21.95%	62	82
14	臺北市大同區	2018-11-25T06:18:47+08:00	23597	35491	59088	3422	62510	107557	58.12%	21.94%	82	82
14	臺北市大同區	2018-11-25T00:04:55+08:00	20126	30366	50492	2938	53430	91831	58.18%	21.92%	71	82
14	臺北市大同區	2018-11-24T22:13:15+08:00	11677	17083	28760	1768	30528	51748	58.99%	22.57%	42	82
14	臺北市大同區	2018-11-25T06:18:48+08:00	23597	35491	59088	3422	62510	107557	58.12%	21.94%	82	82
14	臺北市大同區	2018-11-24T22:23:02+08:00	12302	18024	30326	1822	32148	54534	58.95%	22.56%	44	82
14	臺北市大同區	2018-11-25T03:44:10+08:00	23597	35491	59088	3422	62510	107557	58.12%	21.94%	82	82
14	臺北市大同區	2018-11-25T01:02:20+08:00	22961	34598	57559	3323	60882	104675	58.16%	21.94%	80	82
14	臺北市大同區	2018-11-25T03:38:45+08:00	23597	35491	59088	3422	62510	107557	58.12%	21.94%	82	82
14	臺北市大同區	2018-11-24T23:19:38+08:00	18370	27694	46064	2680	48744	83940	58.07%	21.88%	65	82
14	臺北市大同區	2018-11-24T23:23:29+08:00	18370	27694	46064	2680	48744	83940	58.07%	21.88%	65	82
14	臺北市大同區	2018-11-24T22:15:59+08:00	11677	17083	28760	1768	30528	51748	58.99%	22.57%	42	82
14	臺北市大同區	2018-11-25T01:17:39+08:00	22961	34598	57559	3323	60882	104675	58.16%	21.94%	80	82
14	臺北市大同區	2018-11-25T06:29:06+08:00	23597	35491	59088	3422	62510	107557	58.12%	21.94%	82	82
14	臺北市大同區	2018-11-24T22:33:28+08:00	13208	19534	32742	1941	34683	58776	59.01%	22.47%	47	82
14	臺北市大同區	2018-11-25T06:13:43+08:00	23597	35491	59088	3422	62510	107557	58.12%	21.94%	82	82
14	臺北市大同區	2018-11-24T23:43:07+08:00	19269	29009	48278	2829	51107	87914	58.13%	21.92%	68	82
14	臺北市大同區	2018-11-25T00:22:53+08:00	21389	32123	53512	3085	56597	97669	57.95%	21.9%	75	82
14	臺北市大同區	2018-11-25T03:56:00+08:00	23597	35491	59088	3422	62510	107557	58.12%	21.94%	82	82
14	臺北市大同區	2018-11-24T22:33:27+08:00	13208	19534	32742	1941	34683	58776	59.01%	22.47%	47	82
14	臺北市大同區	2018-11-25T03:49:42+08:00	23597	35491	59088	3422	62510	107557	58.12%	21.94%	82	82
14	臺北市大同區	2018-11-25T00:18:20+08:00	20729	31196	51925	2994	54919	94626	58.04%	21.91%	73	82
14	臺北市大同區	2018-11-25T06:13:42+08:00	23597	35491	59088	3422	62510	107557	58.12%	21.94%	82	82
14	臺北市大同區	2018-11-25T04:02:38+08:00	23597	35491	59088	3422	62510	107557	58.12%	21.94%	82	82
14	雲林縣東勢鄉	2018-11-24T23:47:26+08:00	1805	4192	5997	600	6597	13239	49.83%	13.63%	15	15
14	雲林縣東勢鄉	2018-11-24T23:16:00+08:00	1805	4192	5997	600	6597	13239	49.83%	13.63%	15	15
14	雲林縣東勢鄉	2018-11-24T22:16:07+08:00	1458	3237	4695	512	5207	10684	48.74%	13.65%	13	15
14	雲林縣東勢鄉	2018-11-25T01:25:50+08:00	1805	4192	5997	600	6597	13239	49.83%	13.63%	15	15
14	雲林縣東勢鄉	2018-11-25T00:23:01+08:00	1805	4192	5997	600	6597	13239	49.83%	13.63%	15	15
14	雲林縣東勢鄉	2018-11-24T23:23:36+08:00	1805	4192	5997	600	6597	13239	49.83%	13.63%	15	15
14	雲林縣東勢鄉	2018-11-25T03:38:52+08:00	1805	4192	5997	600	6597	13239	49.83%	13.63%	15	15
14	雲林縣東勢鄉	2018-11-24T22:57:50+08:00	1805	4192	5997	600	6597	13239	49.83%	13.63%	15	15
14	雲林縣東勢鄉	2018-11-25T00:57:34+08:00	1805	4192	5997	600	6597	13239	49.83%	13.63%	15	15
14	雲林縣東勢鄉	2018-11-24T22:36:58+08:00	1590	3585	5175	549	5724	11706	48.9%	13.58%	14	15
14	雲林縣東勢鄉	2018-11-24T22:19:34+08:00	1458	3237	4695	512	5207	10684	48.74%	13.65%	13	15
14	雲林縣東勢鄉	2018-11-24T22:45:06+08:00	1590	3585	5175	549	5724	11706	48.9%	13.58%	14	15
14	雲林縣東勢鄉	2018-11-25T06:08:50+08:00	1805	4192	5997	600	6597	13239	49.83%	13.63%	15	15
14	雲林縣東勢鄉	2018-11-25T01:12:40+08:00	1805	4192	5997	600	6597	13239	49.83%	13.63%	15	15
14	雲林縣東勢鄉	2018-11-24T22:26:34+08:00	1458	3237	4695	512	5207	10684	48.74%	13.65%	13	15
14	雲林縣東勢鄉	2018-11-25T03:49:49+08:00	1805	4192	5997	600	6597	13239	49.83%	13.63%	15	15
14	雲林縣東勢鄉	2018-11-25T06:23:57+08:00	1805	4192	5997	600	6597	13239	49.83%	13.63%	15	15
14	雲林縣東勢鄉	2018-11-24T23:39:12+08:00	1805	4192	5997	600	6597	13239	49.83%	13.63%	15	15
14	雲林縣東勢鄉	2018-11-24T22:50:45+08:00	1590	3585	5175	549	5724	11706	48.9%	13.58%	14	15
14	雲林縣東勢鄉	2018-11-24T23:12:13+08:00	1805	4192	5997	600	6597	13239	49.83%	13.63%	15	15
14	雲林縣東勢鄉	2018-11-24T23:31:08+08:00	1805	4192	5997	600	6597	13239	49.83%	13.63%	15	15
14	雲林縣東勢鄉	2018-11-24T23:43:15+08:00	1805	4192	5997	600	6597	13239	49.83%	13.63%	15	15
14	雲林縣東勢鄉	2018-11-24T23:01:28+08:00	1805	4192	5997	600	6597	13239	49.83%	13.63%	15	15
14	雲林縣東勢鄉	2018-11-25T06:29:14+08:00	1805	4192	5997	600	6597	13239	49.83%	13.63%	15	15
14	雲林縣東勢鄉	2018-11-25T00:14:07+08:00	1805	4192	5997	600	6597	13239	49.83%	13.63%	15	15
14	雲林縣東勢鄉	2018-11-25T04:02:49+08:00	1805	4192	5997	600	6597	13239	49.83%	13.63%	15	15
14	雲林縣東勢鄉	2018-11-25T01:07:23+08:00	1805	4192	5997	600	6597	13239	49.83%	13.63%	15	15
14	雲林縣東勢鄉	2018-11-25T06:13:50+08:00	1805	4192	5997	600	6597	13239	49.83%	13.63%	15	15
14	雲林縣東勢鄉	2018-11-24T23:35:08+08:00	1805	4192	5997	600	6597	13239	49.83%	13.63%	15	15
14	雲林縣東勢鄉	2018-11-24T22:33:35+08:00	1590	3585	5175	549	5724	11706	48.9%	13.58%	14	15
14	雲林縣東勢鄉	2018-11-24T23:08:33+08:00	1805	4192	5997	600	6597	13239	49.83%	13.63%	15	15
14	雲林縣東勢鄉	2018-11-25T03:32:32+08:00	1805	4192	5997	600	6597	13239	49.83%	13.63%	15	15
14	雲林縣東勢鄉	2018-11-25T03:44:20+08:00	1805	4192	5997	600	6597	13239	49.83%	13.63%	15	15
14	雲林縣東勢鄉	2018-11-24T22:13:24+08:00	1458	3237	4695	512	5207	10684	48.74%	13.65%	13	15
14	雲林縣東勢鄉	2018-11-25T00:00:08+08:00	1805	4192	5997	600	6597	13239	49.83%	13.63%	15	15
14	雲林縣東勢鄉	2018-11-24T23:55:44+08:00	1805	4192	5997	600	6597	13239	49.83%	13.63%	15	15
14	雲林縣東勢鄉	2018-11-25T01:17:49+08:00	1805	4192	5997	600	6597	13239	49.83%	13.63%	15	15
14	雲林縣東勢鄉	2018-11-24T23:19:47+08:00	1805	4192	5997	600	6597	13239	49.83%	13.63%	15	15
14	雲林縣東勢鄉	2018-11-25T06:18:55+08:00	1805	4192	5997	600	6597	13239	49.83%	13.63%	15	15
14	雲林縣東勢鄉	2018-11-25T01:02:28+08:00	1805	4192	5997	600	6597	13239	49.83%	13.63%	15	15
14	雲林縣東勢鄉	2018-11-24T23:27:16+08:00	1805	4192	5997	600	6597	13239	49.83%	13.63%	15	15
14	雲林縣東勢鄉	2018-11-24T22:40:25+08:00	1590	3585	5175	549	5724	11706	48.9%	13.58%	14	15
14	雲林縣東勢鄉	2018-11-24T22:23:10+08:00	1458	3237	4695	512	5207	10684	48.74%	13.65%	13	15
14	雲林縣東勢鄉	2018-11-24T22:30:03+08:00	1590	3585	5175	549	5724	11706	48.9%	13.58%	14	15
14	雲林縣東勢鄉	2018-11-24T23:51:32+08:00	1805	4192	5997	600	6597	13239	49.83%	13.63%	15	15
14	雲林縣東勢鄉	2018-11-25T00:05:02+08:00	1805	4192	5997	600	6597	13239	49.83%	13.63%	15	15
14	雲林縣東勢鄉	2018-11-24T22:41:32+08:00	1590	3585	5175	549	5724	11706	48.9%	13.58%	14	15
14	雲林縣東勢鄉	2018-11-25T00:09:31+08:00	1805	4192	5997	600	6597	13239	49.83%	13.63%	15	15
14	雲林縣東勢鄉	2018-11-24T22:54:23+08:00	1805	4192	5997	600	6597	13239	49.83%	13.63%	15	15
14	雲林縣東勢鄉	2018-11-24T23:05:02+08:00	1805	4192	5997	600	6597	13239	49.83%	13.63%	15	15
14	雲林縣東勢鄉	2018-11-25T03:56:09+08:00	1805	4192	5997	600	6597	13239	49.83%	13.63%	15	15
14	雲林縣東勢鄉	2018-11-25T00:18:27+08:00	1805	4192	5997	600	6597	13239	49.83%	13.63%	15	15
14	雲林縣西螺鎮	2018-11-24T23:16:00+08:00	5172	11634	16806	1429	18235	34325	53.12%	15.07%	31	34
14	雲林縣西螺鎮	2018-11-24T22:16:07+08:00	2485	5709	8194	649	8843	16232	54.48%	15.31%	18	34
14	雲林縣西螺鎮	2018-11-25T01:25:50+08:00	5739	12903	18642	1609	20251	38142	53.09%	15.05%	34	34
14	雲林縣西螺鎮	2018-11-24T22:23:09+08:00	3091	6921	10012	912	10924	20287	53.85%	15.24%	21	34
14	雲林縣西螺鎮	2018-11-25T00:23:01+08:00	5739	12903	18642	1609	20251	38142	53.09%	15.05%	34	34
14	雲林縣西螺鎮	2018-11-25T03:38:52+08:00	5739	12903	18642	1609	20251	38142	53.09%	15.05%	34	34
14	雲林縣西螺鎮	2018-11-24T22:36:57+08:00	3672	8437	12109	1049	13158	24442	53.83%	15.02%	24	34
14	雲林縣西螺鎮	2018-11-24T22:57:50+08:00	4729	10697	15426	1310	16736	31601	52.96%	14.96%	29	34
14	雲林縣西螺鎮	2018-11-25T00:57:33+08:00	5739	12903	18642	1609	20251	38142	53.09%	15.05%	34	34
14	雲林縣西螺鎮	2018-11-24T23:27:15+08:00	5496	12326	17822	1547	19369	36564	52.97%	15.03%	33	34
14	雲林縣西螺鎮	2018-11-24T22:19:34+08:00	2871	6515	9386	787	10173	18773	54.19%	15.29%	20	34
14	雲林縣西螺鎮	2018-11-24T22:45:06+08:00	4117	9329	13446	1145	14591	27336	53.38%	15.06%	26	34
14	雲林縣西螺鎮	2018-11-25T06:13:49+08:00	5739	12903	18642	1609	20251	38142	53.09%	15.05%	34	34
14	雲林縣西螺鎮	2018-11-25T01:12:40+08:00	5739	12903	18642	1609	20251	38142	53.09%	15.05%	34	34
14	雲林縣西螺鎮	2018-11-24T22:26:34+08:00	3313	7549	10862	954	11816	21912	53.92%	15.12%	22	34
14	雲林縣西螺鎮	2018-11-25T06:23:57+08:00	5739	12903	18642	1609	20251	38142	53.09%	15.05%	34	34
14	雲林縣西螺鎮	2018-11-24T23:39:12+08:00	5496	12326	17822	1547	19369	36564	52.97%	15.03%	33	34
14	雲林縣西螺鎮	2018-11-24T22:50:45+08:00	4117	9329	13446	1145	14591	27336	53.38%	15.06%	26	34
14	雲林縣西螺鎮	2018-11-24T23:12:13+08:00	5022	11306	16328	1368	17696	33342	53.07%	15.06%	30	34
14	雲林縣西螺鎮	2018-11-25T03:49:48+08:00	5739	12903	18642	1609	20251	38142	53.09%	15.05%	34	34
14	雲林縣西螺鎮	2018-11-24T23:01:28+08:00	5022	11306	16328	1368	17696	33342	53.07%	15.06%	30	34
14	雲林縣西螺鎮	2018-11-25T04:02:47+08:00	5739	12903	18642	1609	20251	38142	53.09%	15.05%	34	34
14	雲林縣西螺鎮	2018-11-24T23:47:25+08:00	5739	12903	18642	1609	20251	38142	53.09%	15.05%	34	34
14	雲林縣西螺鎮	2018-11-25T06:29:14+08:00	5739	12903	18642	1609	20251	38142	53.09%	15.05%	34	34
14	雲林縣西螺鎮	2018-11-24T23:35:07+08:00	5496	12326	17822	1547	19369	36564	52.97%	15.03%	33	34
14	雲林縣西螺鎮	2018-11-25T01:07:23+08:00	5739	12903	18642	1609	20251	38142	53.09%	15.05%	34	34
14	雲林縣西螺鎮	2018-11-24T23:43:14+08:00	5739	12903	18642	1609	20251	38142	53.09%	15.05%	34	34
14	雲林縣西螺鎮	2018-11-24T23:31:07+08:00	5496	12326	17822	1547	19369	36564	52.97%	15.03%	33	34
14	雲林縣西螺鎮	2018-11-25T06:08:49+08:00	5739	12903	18642	1609	20251	38142	53.09%	15.05%	34	34
14	雲林縣西螺鎮	2018-11-24T22:33:35+08:00	3454	7909	11363	999	12362	22926	53.92%	15.07%	23	34
14	雲林縣西螺鎮	2018-11-25T00:14:06+08:00	5739	12903	18642	1609	20251	38142	53.09%	15.05%	34	34
14	雲林縣西螺鎮	2018-11-25T00:00:07+08:00	5739	12903	18642	1609	20251	38142	53.09%	15.05%	34	34
14	雲林縣西螺鎮	2018-11-24T23:08:33+08:00	5022	11306	16328	1368	17696	33342	53.07%	15.06%	30	34
14	雲林縣西螺鎮	2018-11-25T03:32:32+08:00	5739	12903	18642	1609	20251	38142	53.09%	15.05%	34	34
14	雲林縣西螺鎮	2018-11-24T23:23:35+08:00	5374	12042	17416	1505	18921	35698	53%	15.05%	32	34
14	雲林縣西螺鎮	2018-11-25T01:17:48+08:00	5739	12903	18642	1609	20251	38142	53.09%	15.05%	34	34
14	雲林縣西螺鎮	2018-11-24T22:13:24+08:00	2340	5395	7735	590	8325	15261	54.55%	15.33%	17	34
14	雲林縣西螺鎮	2018-11-24T23:55:44+08:00	5739	12903	18642	1609	20251	38142	53.09%	15.05%	34	34
14	雲林縣西螺鎮	2018-11-24T23:19:47+08:00	5172	11634	16806	1429	18235	34325	53.12%	15.07%	31	34
14	雲林縣西螺鎮	2018-11-25T03:44:19+08:00	5739	12903	18642	1609	20251	38142	53.09%	15.05%	34	34
14	雲林縣西螺鎮	2018-11-25T01:02:27+08:00	5739	12903	18642	1609	20251	38142	53.09%	15.05%	34	34
14	雲林縣西螺鎮	2018-11-24T22:40:25+08:00	3943	8950	12893	1095	13988	26032	53.73%	15.15%	25	34
14	雲林縣西螺鎮	2018-11-24T22:30:03+08:00	3454	7909	11363	999	12362	22926	53.92%	15.07%	23	34
14	雲林縣西螺鎮	2018-11-25T06:18:54+08:00	5739	12903	18642	1609	20251	38142	53.09%	15.05%	34	34
14	雲林縣西螺鎮	2018-11-24T23:51:32+08:00	5739	12903	18642	1609	20251	38142	53.09%	15.05%	34	34
14	雲林縣西螺鎮	2018-11-25T00:05:02+08:00	5739	12903	18642	1609	20251	38142	53.09%	15.05%	34	34
14	雲林縣西螺鎮	2018-11-24T22:41:32+08:00	3943	8950	12893	1095	13988	26032	53.73%	15.15%	25	34
14	雲林縣西螺鎮	2018-11-25T00:09:31+08:00	5739	12903	18642	1609	20251	38142	53.09%	15.05%	34	34
14	雲林縣西螺鎮	2018-11-24T22:54:23+08:00	4503	10186	14689	1273	15962	30149	52.94%	14.94%	28	34
14	雲林縣西螺鎮	2018-11-24T23:05:02+08:00	5022	11306	16328	1368	17696	33342	53.07%	15.06%	30	34
14	雲林縣西螺鎮	2018-11-25T03:56:09+08:00	5739	12903	18642	1609	20251	38142	53.09%	15.05%	34	34
14	雲林縣西螺鎮	2018-11-25T00:18:27+08:00	5739	12903	18642	1609	20251	38142	53.09%	15.05%	34	34
14	基隆市	2018-11-24T22:33:39+08:00	33750	66243	99993	5815	105808	203752	51.93%	16.56%	183	257
14	基隆市	2018-11-25T03:49:52+08:00	53224	103741	156965	8372	165337	320030	51.66%	16.63%	257	257
14	基隆市	2018-11-24T23:43:18+08:00	46468	92161	138629	7585	146214	282344	51.79%	16.46%	236	257
14	基隆市	2018-11-25T01:07:28+08:00	52986	103288	156274	8338	164612	318630	51.66%	16.63%	256	257
14	基隆市	2018-11-25T06:29:18+08:00	53224	103741	156965	8372	165337	320030	51.66%	16.63%	257	257
14	基隆市	2018-11-24T22:50:50+08:00	37735	74004	111739	6333	118072	226306	52.17%	16.67%	199	257
14	基隆市	2018-11-25T06:13:54+08:00	53224	103741	156965	8372	165337	320030	51.66%	16.63%	257	257
14	基隆市	2018-11-24T22:13:29+08:00	29287	57389	86676	5039	91715	175846	52.16%	16.65%	162	257
14	基隆市	2018-11-25T03:32:36+08:00	53224	103741	156965	8372	165337	320030	51.66%	16.63%	257	257
14	基隆市	2018-11-24T23:55:48+08:00	47559	94403	141962	7779	149741	288796	51.85%	16.47%	240	257
14	基隆市	2018-11-25T03:44:25+08:00	53224	103741	156965	8372	165337	320030	51.66%	16.63%	257	257
14	基隆市	2018-11-24T23:08:38+08:00	41267	81388	122655	6852	129507	249414	51.92%	16.55%	215	257
14	基隆市	2018-11-25T06:24:02+08:00	53224	103741	156965	8372	165337	320030	51.66%	16.63%	257	257
14	基隆市	2018-11-24T23:51:37+08:00	47559	94403	141962	7779	149741	288796	51.85%	16.47%	240	257
14	基隆市	2018-11-24T22:23:15+08:00	32423	63776	96199	5598	101797	196094	51.91%	16.53%	177	257
14	基隆市	2018-11-24T22:40:29+08:00	34906	68567	103473	5990	109463	210625	51.97%	16.57%	188	257
14	基隆市	2018-11-25T06:18:59+08:00	53224	103741	156965	8372	165337	320030	51.66%	16.63%	257	257
14	基隆市	2018-11-24T23:23:40+08:00	43550	86046	129596	7158	136754	263246	51.95%	16.54%	224	257
14	基隆市	2018-11-24T22:54:27+08:00	38308	75474	113782	6472	120254	230555	52.16%	16.62%	202	257
14	基隆市	2018-11-25T00:14:11+08:00	48997	97279	146276	7904	154180	297873	51.76%	16.45%	245	257
14	基隆市	2018-11-25T00:05:06+08:00	48171	95635	143806	7826	151632	293188	51.72%	16.43%	242	257
14	基隆市	2018-11-24T22:16:12+08:00	31028	60932	91960	5342	97302	187053	52.02%	16.59%	170	257
14	基隆市	2018-11-24T22:41:37+08:00	34906	68567	103473	5990	109463	210625	51.97%	16.57%	188	257
14	基隆市	2018-11-24T23:05:06+08:00	40384	79619	120003	6729	126732	243483	52.05%	16.59%	211	257
14	基隆市	2018-11-24T22:45:10+08:00	35845	70488	106333	6115	112448	215968	52.07%	16.6%	192	257
14	基隆市	2018-11-25T03:56:14+08:00	53224	103741	156965	8372	165337	320030	51.66%	16.63%	257	257
14	基隆市	2018-11-24T22:37:02+08:00	34529	67816	102345	5928	108273	208490	51.93%	16.56%	186	257
14	基隆市	2018-11-25T00:18:32+08:00	50657	99991	150648	8086	158734	307000	51.7%	16.5%	250	257
14	基隆市	2018-11-24T23:16:04+08:00	42835	84584	127419	7047	134466	258604	52%	16.56%	221	257
14	基隆市	2018-11-25T00:23:05+08:00	51170	100553	151723	8099	159822	309040	51.72%	16.56%	251	257
14	基隆市	2018-11-25T01:25:54+08:00	53224	103741	156965	8372	165337	320030	51.66%	16.63%	257	257
14	基隆市	2018-11-25T01:02:32+08:00	52986	103288	156274	8338	164612	318630	51.66%	16.63%	256	257
14	基隆市	2018-11-24T22:30:11+08:00	33501	65828	99329	5800	105129	202374	51.95%	16.55%	182	257
14	基隆市	2018-11-25T03:38:56+08:00	53224	103741	156965	8372	165337	320030	51.66%	16.63%	257	257
14	基隆市	2018-11-24T22:19:38+08:00	31518	61852	93370	5441	98811	190034	52%	16.59%	172	257
14	基隆市	2018-11-24T23:19:53+08:00	43107	85099	128206	7075	135281	260174	52%	16.57%	222	257
14	基隆市	2018-11-25T01:17:54+08:00	53224	103741	156965	8372	165337	320030	51.66%	16.63%	257	257
14	基隆市	2018-11-25T00:00:12+08:00	47818	94949	142767	7808	150575	290365	51.86%	16.47%	241	257
14	基隆市	2018-11-24T22:57:55+08:00	39509	77937	117446	6594	124040	238445	52.02%	16.57%	207	257
14	基隆市	2018-11-24T23:27:20+08:00	44209	87459	131668	7258	138926	267550	51.93%	16.52%	227	257
14	基隆市	2018-11-25T00:57:38+08:00	52986	103288	156274	8338	164612	318630	51.66%	16.63%	256	257
14	基隆市	2018-11-24T23:35:12+08:00	45394	89857	135251	7398	142649	274939	51.88%	16.51%	231	257
14	基隆市	2018-11-24T23:47:30+08:00	46789	92880	139669	7642	147311	284461	51.79%	16.45%	237	257
14	基隆市	2018-11-25T00:09:36+08:00	48480	96193	144673	7849	152522	294756	51.75%	16.45%	243	257
14	基隆市	2018-11-24T23:01:33+08:00	39692	78380	118072	6633	124705	239578	52.05%	16.57%	208	257
14	基隆市	2018-11-24T23:31:13+08:00	45093	89223	134316	7355	141671	272977	51.9%	16.52%	230	257
14	基隆市	2018-11-25T04:02:54+08:00	53224	103741	156965	8372	165337	320030	51.66%	16.63%	257	257
14	基隆市	2018-11-25T01:12:45+08:00	52986	103288	156274	8338	164612	318630	51.66%	16.63%	256	257
14	基隆市	2018-11-24T22:26:38+08:00	33061	65028	98089	5758	103847	199976	51.93%	16.53%	180	257
14	基隆市	2018-11-24T23:12:17+08:00	41747	82505	124252	6950	131202	252417	51.98%	16.54%	217	257
14	基隆市	2018-11-24T23:39:18+08:00	45930	91128	137058	7538	144596	278890	51.85%	16.47%	234	257
14	基隆市	2018-11-25T06:08:55+08:00	53224	103741	156965	8372	165337	320030	51.66%	16.63%	257	257
14	新竹縣五峰鄉	2018-11-25T04:02:44+08:00	393	1513	1906	78	1984	3997	49.64%	9.83%	6	6
14	新竹縣五峰鄉	2018-11-25T00:14:04+08:00	318	1282	1600	65	1665	3284	50.7%	9.68%	5	6
14	新竹縣五峰鄉	2018-11-24T23:31:05+08:00	231	925	1156	43	1199	2388	50.21%	9.67%	4	6
14	新竹縣五峰鄉	2018-11-25T01:07:21+08:00	393	1513	1906	78	1984	3997	49.64%	9.83%	6	6
14	新竹縣五峰鄉	2018-11-25T01:12:38+08:00	393	1513	1906	78	1984	3997	49.64%	9.83%	6	6
14	新竹縣五峰鄉	2018-11-25T00:09:28+08:00	318	1282	1600	65	1665	3284	50.7%	9.68%	5	6
14	新竹縣五峰鄉	2018-11-24T23:19:45+08:00	231	925	1156	43	1199	2388	50.21%	9.67%	4	6
14	新竹縣五峰鄉	2018-11-24T22:23:07+08:00	109	506	615	25	640	1266	50.55%	8.61%	2	6
14	新竹縣五峰鄉	2018-11-25T00:00:03+08:00	318	1282	1600	65	1665	3284	50.7%	9.68%	5	6
14	新竹縣五峰鄉	2018-11-24T23:08:30+08:00	231	925	1156	43	1199	2388	50.21%	9.67%	4	6
14	新竹縣五峰鄉	2018-11-24T22:13:21+08:00	63	313	376	21	397	672	59.08%	9.38%	1	6
14	新竹縣五峰鄉	2018-11-25T03:32:30+08:00	393	1513	1906	78	1984	3997	49.64%	9.83%	6	6
14	新竹縣五峰鄉	2018-11-24T23:51:30+08:00	318	1282	1600	65	1665	3284	50.7%	9.68%	5	6
14	新竹縣五峰鄉	2018-11-24T22:30:01+08:00	109	506	615	25	640	1266	50.55%	8.61%	2	6
14	新竹縣五峰鄉	2018-11-24T23:27:14+08:00	231	925	1156	43	1199	2388	50.21%	9.67%	4	6
14	新竹縣五峰鄉	2018-11-24T22:19:32+08:00	109	506	615	25	640	1266	50.55%	8.61%	2	6
14	新竹縣五峰鄉	2018-11-25T00:57:32+08:00	393	1513	1906	78	1984	3997	49.64%	9.83%	6	6
14	新竹縣五峰鄉	2018-11-24T22:36:56+08:00	109	506	615	25	640	1266	50.55%	8.61%	2	6
14	新竹縣五峰鄉	2018-11-25T00:18:25+08:00	318	1282	1600	65	1665	3284	50.7%	9.68%	5	6
14	新竹縣五峰鄉	2018-11-24T23:05:00+08:00	231	925	1156	43	1199	2388	50.21%	9.67%	4	6
14	新竹縣五峰鄉	2018-11-25T03:49:47+08:00	393	1513	1906	78	1984	3997	49.64%	9.83%	6	6
14	新竹縣五峰鄉	2018-11-24T22:26:32+08:00	109	506	615	25	640	1266	50.55%	8.61%	2	6
14	新竹縣五峰鄉	2018-11-25T06:13:48+08:00	393	1513	1906	78	1984	3997	49.64%	9.83%	6	6
14	新竹縣五峰鄉	2018-11-24T22:50:42+08:00	152	631	783	34	817	1661	49.19%	9.15%	3	6
14	新竹縣五峰鄉	2018-11-24T22:54:21+08:00	152	631	783	34	817	1661	49.19%	9.15%	3	6
14	新竹縣五峰鄉	2018-11-25T00:05:00+08:00	318	1282	1600	65	1665	3284	50.7%	9.68%	5	6
14	新竹縣五峰鄉	2018-11-24T22:41:30+08:00	109	506	615	25	640	1266	50.55%	8.61%	2	6
14	新竹縣五峰鄉	2018-11-25T00:22:59+08:00	318	1282	1600	65	1665	3284	50.7%	9.68%	5	6
14	新竹縣五峰鄉	2018-11-24T22:16:05+08:00	109	506	615	25	640	1266	50.55%	8.61%	2	6
14	新竹縣五峰鄉	2018-11-24T23:01:26+08:00	231	925	1156	43	1199	2388	50.21%	9.67%	4	6
14	新竹縣五峰鄉	2018-11-24T23:43:12+08:00	231	925	1156	43	1199	2388	50.21%	9.67%	4	6
14	新竹縣五峰鄉	2018-11-24T22:33:33+08:00	109	506	615	25	640	1266	50.55%	8.61%	2	6
14	新竹縣五峰鄉	2018-11-25T06:08:47+08:00	393	1513	1906	78	1984	3997	49.64%	9.83%	6	6
14	新竹縣五峰鄉	2018-11-24T23:35:06+08:00	231	925	1156	43	1199	2388	50.21%	9.67%	4	6
14	新竹縣五峰鄉	2018-11-24T23:47:23+08:00	231	925	1156	43	1199	2388	50.21%	9.67%	4	6
14	新竹縣五峰鄉	2018-11-25T06:29:12+08:00	393	1513	1906	78	1984	3997	49.64%	9.83%	6	6
14	新竹縣五峰鄉	2018-11-24T23:55:42+08:00	318	1282	1600	65	1665	3284	50.7%	9.68%	5	6
14	新竹縣五峰鄉	2018-11-25T01:17:46+08:00	393	1513	1906	78	1984	3997	49.64%	9.83%	6	6
14	新竹縣五峰鄉	2018-11-24T22:57:48+08:00	231	925	1156	43	1199	2388	50.21%	9.67%	4	6
14	新竹縣五峰鄉	2018-11-25T03:38:50+08:00	393	1513	1906	78	1984	3997	49.64%	9.83%	6	6
14	新竹縣五峰鄉	2018-11-24T23:23:34+08:00	231	925	1156	43	1199	2388	50.21%	9.67%	4	6
14	新竹縣五峰鄉	2018-11-25T03:44:17+08:00	393	1513	1906	78	1984	3997	49.64%	9.83%	6	6
14	新竹縣五峰鄉	2018-11-25T01:25:48+08:00	393	1513	1906	78	1984	3997	49.64%	9.83%	6	6
14	新竹縣五峰鄉	2018-11-24T22:40:23+08:00	109	506	615	25	640	1266	50.55%	8.61%	2	6
14	新竹縣五峰鄉	2018-11-24T23:15:58+08:00	231	925	1156	43	1199	2388	50.21%	9.67%	4	6
14	新竹縣五峰鄉	2018-11-25T01:02:26+08:00	393	1513	1906	78	1984	3997	49.64%	9.83%	6	6
14	新竹縣五峰鄉	2018-11-25T06:18:53+08:00	393	1513	1906	78	1984	3997	49.64%	9.83%	6	6
14	新竹縣五峰鄉	2018-11-25T03:56:06+08:00	393	1513	1906	78	1984	3997	49.64%	9.83%	6	6
14	新竹縣五峰鄉	2018-11-25T06:23:55+08:00	393	1513	1906	78	1984	3997	49.64%	9.83%	6	6
14	新竹縣五峰鄉	2018-11-24T23:39:10+08:00	231	925	1156	43	1199	2388	50.21%	9.67%	4	6
14	新竹縣五峰鄉	2018-11-24T22:45:04+08:00	152	631	783	34	817	1661	49.19%	9.15%	3	6
14	新竹縣五峰鄉	2018-11-24T23:12:10+08:00	231	925	1156	43	1199	2388	50.21%	9.67%	4	6
14	新竹縣新埔鎮	2018-11-25T04:02:43+08:00	4323	11109	15432	870	16302	28894	56.42%	14.96%	30	30
14	新竹縣新埔鎮	2018-11-25T01:12:37+08:00	4323	11109	15432	870	16302	28894	56.42%	14.96%	30	30
14	新竹縣新埔鎮	2018-11-25T00:14:04+08:00	4323	11109	15432	870	16302	28894	56.42%	14.96%	30	30
14	新竹縣新埔鎮	2018-11-24T23:31:05+08:00	4323	11109	15432	870	16302	28894	56.42%	14.96%	30	30
14	新竹縣新埔鎮	2018-11-25T01:07:21+08:00	4323	11109	15432	870	16302	28894	56.42%	14.96%	30	30
14	新竹縣新埔鎮	2018-11-24T23:35:05+08:00	4323	11109	15432	870	16302	28894	56.42%	14.96%	30	30
14	新竹縣新埔鎮	2018-11-25T06:29:11+08:00	4323	11109	15432	870	16302	28894	56.42%	14.96%	30	30
14	新竹縣新埔鎮	2018-11-24T23:39:09+08:00	4323	11109	15432	870	16302	28894	56.42%	14.96%	30	30
14	新竹縣新埔鎮	2018-11-25T00:09:28+08:00	4323	11109	15432	870	16302	28894	56.42%	14.96%	30	30
14	新竹縣新埔鎮	2018-11-24T22:23:07+08:00	3349	8599	11948	667	12615	22350	56.44%	14.98%	24	30
14	新竹縣新埔鎮	2018-11-24T23:08:30+08:00	4190	10691	14881	825	15706	27877	56.34%	15.03%	29	30
14	新竹縣新埔鎮	2018-11-24T23:19:44+08:00	4323	11109	15432	870	16302	28894	56.42%	14.96%	30	30
14	新竹縣新埔鎮	2018-11-24T22:13:21+08:00	2773	7292	10065	560	10625	18787	56.56%	14.76%	21	30
14	新竹縣新埔鎮	2018-11-25T00:00:02+08:00	4323	11109	15432	870	16302	28894	56.42%	14.96%	30	30
14	新竹縣新埔鎮	2018-11-24T22:30:01+08:00	3349	8599	11948	667	12615	22350	56.44%	14.98%	24	30
14	新竹縣新埔鎮	2018-11-24T23:27:14+08:00	4323	11109	15432	870	16302	28894	56.42%	14.96%	30	30
14	新竹縣新埔鎮	2018-11-24T22:19:32+08:00	3123	8131	11254	621	11875	21069	56.36%	14.82%	23	30
14	新竹縣新埔鎮	2018-11-24T22:36:56+08:00	3538	9086	12624	704	13328	23779	56.05%	14.88%	25	30
14	新竹縣新埔鎮	2018-11-25T01:02:25+08:00	4323	11109	15432	870	16302	28894	56.42%	14.96%	30	30
14	新竹縣新埔鎮	2018-11-25T06:13:47+08:00	4323	11109	15432	870	16302	28894	56.42%	14.96%	30	30
14	新竹縣新埔鎮	2018-11-25T00:18:25+08:00	4323	11109	15432	870	16302	28894	56.42%	14.96%	30	30
14	新竹縣新埔鎮	2018-11-24T23:05:00+08:00	4190	10691	14881	825	15706	27877	56.34%	15.03%	29	30
14	新竹縣新埔鎮	2018-11-24T22:26:32+08:00	3349	8599	11948	667	12615	22350	56.44%	14.98%	24	30
14	新竹縣新埔鎮	2018-11-24T22:50:42+08:00	4048	10305	14353	802	15155	27039	56.05%	14.97%	28	30
14	新竹縣新埔鎮	2018-11-24T22:54:21+08:00	4190	10691	14881	825	15706	27877	56.34%	15.03%	29	30
14	新竹縣新埔鎮	2018-11-25T00:05:00+08:00	4323	11109	15432	870	16302	28894	56.42%	14.96%	30	30
14	新竹縣新埔鎮	2018-11-24T22:41:30+08:00	3733	9551	13284	743	14027	24901	56.33%	14.99%	26	30
14	新竹縣新埔鎮	2018-11-25T00:22:59+08:00	4323	11109	15432	870	16302	28894	56.42%	14.96%	30	30
14	新竹縣新埔鎮	2018-11-25T03:49:46+08:00	4323	11109	15432	870	16302	28894	56.42%	14.96%	30	30
14	新竹縣新埔鎮	2018-11-24T22:16:05+08:00	2960	7719	10679	597	11276	19999	56.38%	14.8%	22	30
14	新竹縣新埔鎮	2018-11-24T23:01:26+08:00	4190	10691	14881	825	15706	27877	56.34%	15.03%	29	30
14	新竹縣新埔鎮	2018-11-24T23:43:12+08:00	4323	11109	15432	870	16302	28894	56.42%	14.96%	30	30
14	新竹縣新埔鎮	2018-11-25T06:08:47+08:00	4323	11109	15432	870	16302	28894	56.42%	14.96%	30	30
14	新竹縣新埔鎮	2018-11-24T22:33:32+08:00	3349	8599	11948	667	12615	22350	56.44%	14.98%	24	30
14	新竹縣新埔鎮	2018-11-24T23:47:23+08:00	4323	11109	15432	870	16302	28894	56.42%	14.96%	30	30
14	新竹縣新埔鎮	2018-11-24T23:55:42+08:00	4323	11109	15432	870	16302	28894	56.42%	14.96%	30	30
14	新竹縣新埔鎮	2018-11-25T03:44:16+08:00	4323	11109	15432	870	16302	28894	56.42%	14.96%	30	30
14	新竹縣新埔鎮	2018-11-25T01:17:46+08:00	4323	11109	15432	870	16302	28894	56.42%	14.96%	30	30
14	新竹縣新埔鎮	2018-11-24T22:57:48+08:00	4190	10691	14881	825	15706	27877	56.34%	15.03%	29	30
14	新竹縣新埔鎮	2018-11-25T03:38:50+08:00	4323	11109	15432	870	16302	28894	56.42%	14.96%	30	30
14	新竹縣新埔鎮	2018-11-24T23:23:33+08:00	4323	11109	15432	870	16302	28894	56.42%	14.96%	30	30
14	新竹縣新埔鎮	2018-11-24T23:51:29+08:00	4323	11109	15432	870	16302	28894	56.42%	14.96%	30	30
14	新竹縣新埔鎮	2018-11-24T22:40:23+08:00	3733	9551	13284	743	14027	24901	56.33%	14.99%	26	30
14	新竹縣新埔鎮	2018-11-25T03:32:29+08:00	4323	11109	15432	870	16302	28894	56.42%	14.96%	30	30
14	新竹縣新埔鎮	2018-11-25T06:18:52+08:00	4323	11109	15432	870	16302	28894	56.42%	14.96%	30	30
14	新竹縣新埔鎮	2018-11-24T23:15:58+08:00	4190	10691	14881	825	15706	27877	56.34%	15.03%	29	30
14	新竹縣新埔鎮	2018-11-25T00:57:31+08:00	4323	11109	15432	870	16302	28894	56.42%	14.96%	30	30
14	新竹縣新埔鎮	2018-11-25T01:25:47+08:00	4323	11109	15432	870	16302	28894	56.42%	14.96%	30	30
14	新竹縣新埔鎮	2018-11-25T03:56:06+08:00	4323	11109	15432	870	16302	28894	56.42%	14.96%	30	30
14	新竹縣新埔鎮	2018-11-25T06:23:55+08:00	4323	11109	15432	870	16302	28894	56.42%	14.96%	30	30
14	新竹縣新埔鎮	2018-11-24T22:45:04+08:00	3864	9900	13764	770	14534	25879	56.16%	14.93%	27	30
14	新竹縣新埔鎮	2018-11-24T23:12:10+08:00	4190	10691	14881	825	15706	27877	56.34%	15.03%	29	30
14	連江縣北竿鄉	2018-11-24T22:33:39+08:00	0	0	0	0	0	0	0%	0%	0	2
14	連江縣北竿鄉	2018-11-25T03:49:52+08:00	247	829	1076	34	1110	2125	52.24%	11.62%	2	2
14	連江縣北竿鄉	2018-11-24T23:43:18+08:00	247	829	1076	34	1110	2125	52.24%	11.62%	2	2
14	連江縣北竿鄉	2018-11-25T06:29:18+08:00	247	829	1076	34	1110	2125	52.24%	11.62%	2	2
14	連江縣北竿鄉	2018-11-24T22:50:50+08:00	0	0	0	0	0	0	0%	0%	0	2
14	連江縣北竿鄉	2018-11-25T01:07:27+08:00	247	829	1076	34	1110	2125	52.24%	11.62%	2	2
14	連江縣北竿鄉	2018-11-25T06:13:54+08:00	247	829	1076	34	1110	2125	52.24%	11.62%	2	2
14	連江縣北竿鄉	2018-11-25T03:32:36+08:00	247	829	1076	34	1110	2125	52.24%	11.62%	2	2
14	連江縣北竿鄉	2018-11-24T23:55:48+08:00	247	829	1076	34	1110	2125	52.24%	11.62%	2	2
14	連江縣北竿鄉	2018-11-25T03:44:25+08:00	247	829	1076	34	1110	2125	52.24%	11.62%	2	2
14	連江縣北竿鄉	2018-11-24T22:13:28+08:00	0	0	0	0	0	0	0%	0%	0	2
14	連江縣北竿鄉	2018-11-24T23:08:38+08:00	0	0	0	0	0	0	0%	0%	0	2
14	連江縣北竿鄉	2018-11-25T06:18:58+08:00	247	829	1076	34	1110	2125	52.24%	11.62%	2	2
14	連江縣北竿鄉	2018-11-24T23:51:37+08:00	247	829	1076	34	1110	2125	52.24%	11.62%	2	2
14	連江縣北竿鄉	2018-11-24T22:23:15+08:00	0	0	0	0	0	0	0%	0%	0	2
14	連江縣北竿鄉	2018-11-24T22:40:29+08:00	0	0	0	0	0	0	0%	0%	0	2
14	連江縣北竿鄉	2018-11-24T23:23:40+08:00	247	829	1076	34	1110	2125	52.24%	11.62%	2	2
14	連江縣北竿鄉	2018-11-24T22:54:27+08:00	0	0	0	0	0	0	0%	0%	0	2
14	連江縣北竿鄉	2018-11-25T00:14:11+08:00	247	829	1076	34	1110	2125	52.24%	11.62%	2	2
14	連江縣北竿鄉	2018-11-25T00:05:06+08:00	247	829	1076	34	1110	2125	52.24%	11.62%	2	2
14	連江縣北竿鄉	2018-11-24T22:41:36+08:00	0	0	0	0	0	0	0%	0%	0	2
14	連江縣北竿鄉	2018-11-24T22:16:12+08:00	0	0	0	0	0	0	0%	0%	0	2
14	連江縣北竿鄉	2018-11-24T23:05:06+08:00	0	0	0	0	0	0	0%	0%	0	2
14	連江縣北竿鄉	2018-11-24T22:45:10+08:00	0	0	0	0	0	0	0%	0%	0	2
14	連江縣北竿鄉	2018-11-25T03:56:14+08:00	247	829	1076	34	1110	2125	52.24%	11.62%	2	2
14	連江縣北竿鄉	2018-11-24T22:37:02+08:00	0	0	0	0	0	0	0%	0%	0	2
14	連江縣北竿鄉	2018-11-25T00:18:32+08:00	247	829	1076	34	1110	2125	52.24%	11.62%	2	2
14	連江縣北竿鄉	2018-11-24T23:16:04+08:00	178	606	784	29	813	1515	53.66%	11.75%	1	2
14	連江縣北竿鄉	2018-11-25T00:23:05+08:00	247	829	1076	34	1110	2125	52.24%	11.62%	2	2
14	連江縣北竿鄉	2018-11-25T01:25:54+08:00	247	829	1076	34	1110	2125	52.24%	11.62%	2	2
14	連江縣北竿鄉	2018-11-25T01:02:32+08:00	247	829	1076	34	1110	2125	52.24%	11.62%	2	2
14	連江縣北竿鄉	2018-11-25T06:24:01+08:00	247	829	1076	34	1110	2125	52.24%	11.62%	2	2
14	連江縣北竿鄉	2018-11-24T22:30:11+08:00	0	0	0	0	0	0	0%	0%	0	2
14	連江縣北竿鄉	2018-11-25T03:38:56+08:00	247	829	1076	34	1110	2125	52.24%	11.62%	2	2
14	連江縣北竿鄉	2018-11-24T22:19:38+08:00	0	0	0	0	0	0	0%	0%	0	2
14	連江縣北竿鄉	2018-11-24T23:19:53+08:00	178	606	784	29	813	1515	53.66%	11.75%	1	2
14	連江縣北竿鄉	2018-11-25T01:17:54+08:00	247	829	1076	34	1110	2125	52.24%	11.62%	2	2
14	連江縣北竿鄉	2018-11-25T00:00:12+08:00	247	829	1076	34	1110	2125	52.24%	11.62%	2	2
14	連江縣北竿鄉	2018-11-24T22:57:55+08:00	0	0	0	0	0	0	0%	0%	0	2
14	連江縣北竿鄉	2018-11-24T23:27:20+08:00	247	829	1076	34	1110	2125	52.24%	11.62%	2	2
14	連江縣北竿鄉	2018-11-25T00:57:38+08:00	247	829	1076	34	1110	2125	52.24%	11.62%	2	2
14	連江縣北竿鄉	2018-11-24T23:35:12+08:00	247	829	1076	34	1110	2125	52.24%	11.62%	2	2
14	連江縣北竿鄉	2018-11-24T23:47:30+08:00	247	829	1076	34	1110	2125	52.24%	11.62%	2	2
14	連江縣北竿鄉	2018-11-25T00:09:36+08:00	247	829	1076	34	1110	2125	52.24%	11.62%	2	2
14	連江縣北竿鄉	2018-11-25T06:08:54+08:00	247	829	1076	34	1110	2125	52.24%	11.62%	2	2
14	連江縣北竿鄉	2018-11-24T23:39:17+08:00	247	829	1076	34	1110	2125	52.24%	11.62%	2	2
14	連江縣北竿鄉	2018-11-24T23:31:13+08:00	247	829	1076	34	1110	2125	52.24%	11.62%	2	2
14	連江縣北竿鄉	2018-11-25T04:02:53+08:00	247	829	1076	34	1110	2125	52.24%	11.62%	2	2
14	連江縣北竿鄉	2018-11-24T23:01:32+08:00	0	0	0	0	0	0	0%	0%	0	2
14	連江縣北竿鄉	2018-11-25T01:12:45+08:00	247	829	1076	34	1110	2125	52.24%	11.62%	2	2
14	連江縣北竿鄉	2018-11-24T22:26:38+08:00	0	0	0	0	0	0	0%	0%	0	2
14	連江縣北竿鄉	2018-11-24T23:12:17+08:00	0	0	0	0	0	0	0%	0%	0	2
14	高雄市梓官區	2018-11-25T04:02:43+08:00	5333	11730	17063	1155	18218	31025	58.72%	17.19%	28	28
14	高雄市梓官區	2018-11-25T01:12:37+08:00	5107	11150	16257	1119	17376	29293	59.32%	17.43%	27	28
14	高雄市梓官區	2018-11-25T00:14:03+08:00	5107	11150	16257	1119	17376	29293	59.32%	17.43%	27	28
14	高雄市梓官區	2018-11-24T23:01:25+08:00	4652	10109	14761	1052	15813	26438	59.81%	17.6%	25	28
14	高雄市梓官區	2018-11-25T01:07:21+08:00	5107	11150	16257	1119	17376	29293	59.32%	17.43%	27	28
14	高雄市梓官區	2018-11-25T00:09:27+08:00	5107	11150	16257	1119	17376	29293	59.32%	17.43%	27	28
14	高雄市梓官區	2018-11-24T23:35:05+08:00	4857	10564	15421	1083	16504	27698	59.59%	17.54%	26	28
14	高雄市梓官區	2018-11-25T06:29:11+08:00	5333	11730	17063	1155	18218	31025	58.72%	17.19%	28	28
14	高雄市梓官區	2018-11-24T23:39:09+08:00	4857	10564	15421	1083	16504	27698	59.59%	17.54%	26	28
14	高雄市梓官區	2018-11-24T23:31:04+08:00	4857	10564	15421	1083	16504	27698	59.59%	17.54%	26	28
14	高雄市梓官區	2018-11-25T01:17:45+08:00	5107	11150	16257	1119	17376	29293	59.32%	17.43%	27	28
14	高雄市梓官區	2018-11-24T23:55:41+08:00	4857	10564	15421	1083	16504	27698	59.59%	17.54%	26	28
14	高雄市梓官區	2018-11-24T23:08:30+08:00	4652	10109	14761	1052	15813	26438	59.81%	17.6%	25	28
14	高雄市梓官區	2018-11-24T23:19:44+08:00	4857	10564	15421	1083	16504	27698	59.59%	17.54%	26	28
14	高雄市梓官區	2018-11-24T22:23:06+08:00	4652	10109	14761	1052	15813	26438	59.81%	17.6%	25	28
14	高雄市梓官區	2018-11-24T22:13:21+08:00	4652	10109	14761	1052	15813	26438	59.81%	17.6%	25	28
14	高雄市梓官區	2018-11-24T23:04:58+08:00	4652	10109	14761	1052	15813	26438	59.81%	17.6%	25	28
14	高雄市梓官區	2018-11-25T00:00:02+08:00	4857	10564	15421	1083	16504	27698	59.59%	17.54%	26	28
14	高雄市梓官區	2018-11-25T00:04:59+08:00	4857	10564	15421	1083	16504	27698	59.59%	17.54%	26	28
14	高雄市梓官區	2018-11-24T23:27:13+08:00	4857	10564	15421	1083	16504	27698	59.59%	17.54%	26	28
14	高雄市梓官區	2018-11-24T22:30:00+08:00	4652	10109	14761	1052	15813	26438	59.81%	17.6%	25	28
14	高雄市梓官區	2018-11-25T01:02:25+08:00	5107	11150	16257	1119	17376	29293	59.32%	17.43%	27	28
14	高雄市梓官區	2018-11-25T06:13:47+08:00	5333	11730	17063	1155	18218	31025	58.72%	17.19%	28	28
14	高雄市梓官區	2018-11-25T00:22:58+08:00	5107	11150	16257	1119	17376	29293	59.32%	17.43%	27	28
14	高雄市梓官區	2018-11-24T22:26:32+08:00	4652	10109	14761	1052	15813	26438	59.81%	17.6%	25	28
14	高雄市梓官區	2018-11-25T00:18:24+08:00	5107	11150	16257	1119	17376	29293	59.32%	17.43%	27	28
14	高雄市梓官區	2018-11-24T22:54:21+08:00	4652	10109	14761	1052	15813	26438	59.81%	17.6%	25	28
14	高雄市梓官區	2018-11-24T22:41:30+08:00	4652	10109	14761	1052	15813	26438	59.81%	17.6%	25	28
14	高雄市梓官區	2018-11-25T03:49:46+08:00	5333	11730	17063	1155	18218	31025	58.72%	17.19%	28	28
14	高雄市梓官區	2018-11-25T06:08:46+08:00	5333	11730	17063	1155	18218	31025	58.72%	17.19%	28	28
14	高雄市梓官區	2018-11-24T23:43:12+08:00	4857	10564	15421	1083	16504	27698	59.59%	17.54%	26	28
14	高雄市梓官區	2018-11-24T23:47:22+08:00	4857	10564	15421	1083	16504	27698	59.59%	17.54%	26	28
14	高雄市梓官區	2018-11-24T22:16:04+08:00	4652	10109	14761	1052	15813	26438	59.81%	17.6%	25	28
14	高雄市梓官區	2018-11-24T22:33:32+08:00	4652	10109	14761	1052	15813	26438	59.81%	17.6%	25	28
14	高雄市梓官區	2018-11-25T03:44:16+08:00	5333	11730	17063	1155	18218	31025	58.72%	17.19%	28	28
14	高雄市梓官區	2018-11-25T03:38:50+08:00	5333	11730	17063	1155	18218	31025	58.72%	17.19%	28	28
14	高雄市梓官區	2018-11-24T23:23:33+08:00	4857	10564	15421	1083	16504	27698	59.59%	17.54%	26	28
14	高雄市梓官區	2018-11-24T23:51:29+08:00	4857	10564	15421	1083	16504	27698	59.59%	17.54%	26	28
14	高雄市梓官區	2018-11-24T22:57:47+08:00	4652	10109	14761	1052	15813	26438	59.81%	17.6%	25	28
14	高雄市梓官區	2018-11-24T22:19:31+08:00	4652	10109	14761	1052	15813	26438	59.81%	17.6%	25	28
14	高雄市梓官區	2018-11-24T22:40:23+08:00	4652	10109	14761	1052	15813	26438	59.81%	17.6%	25	28
14	高雄市梓官區	2018-11-25T03:32:29+08:00	5333	11730	17063	1155	18218	31025	58.72%	17.19%	28	28
14	高雄市梓官區	2018-11-25T06:18:52+08:00	5333	11730	17063	1155	18218	31025	58.72%	17.19%	28	28
14	高雄市梓官區	2018-11-25T00:57:31+08:00	5107	11150	16257	1119	17376	29293	59.32%	17.43%	27	28
14	高雄市梓官區	2018-11-25T01:25:47+08:00	5107	11150	16257	1119	17376	29293	59.32%	17.43%	27	28
14	高雄市梓官區	2018-11-24T22:36:55+08:00	4652	10109	14761	1052	15813	26438	59.81%	17.6%	25	28
14	高雄市梓官區	2018-11-24T23:15:57+08:00	4857	10564	15421	1083	16504	27698	59.59%	17.54%	26	28
14	高雄市梓官區	2018-11-25T03:56:06+08:00	5333	11730	17063	1155	18218	31025	58.72%	17.19%	28	28
14	高雄市梓官區	2018-11-25T06:23:55+08:00	5333	11730	17063	1155	18218	31025	58.72%	17.19%	28	28
14	高雄市梓官區	2018-11-24T23:12:10+08:00	4652	10109	14761	1052	15813	26438	59.81%	17.6%	25	28
14	高雄市梓官區	2018-11-24T22:50:41+08:00	4652	10109	14761	1052	15813	26438	59.81%	17.6%	25	28
14	高雄市梓官區	2018-11-24T22:45:03+08:00	4652	10109	14761	1052	15813	26438	59.81%	17.6%	25	28
14	宜蘭縣三星鄉	2018-11-25T06:29:17+08:00	2905	6235	9140	848	9988	19051	52.43%	15.25%	21	21
14	宜蘭縣三星鄉	2018-11-24T22:33:37+08:00	2680	5851	8531	809	9340	17821	52.41%	15.04%	20	21
14	宜蘭縣三星鄉	2018-11-24T23:47:28+08:00	2905	6235	9140	848	9988	19051	52.43%	15.25%	21	21
14	宜蘭縣三星鄉	2018-11-24T22:37:00+08:00	2680	5851	8531	809	9340	17821	52.41%	15.04%	20	21
14	宜蘭縣三星鄉	2018-11-25T00:18:30+08:00	2905	6235	9140	848	9988	19051	52.43%	15.25%	21	21
14	宜蘭縣三星鄉	2018-11-25T01:07:26+08:00	2905	6235	9140	848	9988	19051	52.43%	15.25%	21	21
14	宜蘭縣三星鄉	2018-11-25T06:13:52+08:00	2905	6235	9140	848	9988	19051	52.43%	15.25%	21	21
14	宜蘭縣三星鄉	2018-11-24T23:43:17+08:00	2905	6235	9140	848	9988	19051	52.43%	15.25%	21	21
14	宜蘭縣三星鄉	2018-11-25T03:44:23+08:00	2905	6235	9140	848	9988	19051	52.43%	15.25%	21	21
14	宜蘭縣三星鄉	2018-11-25T01:02:31+08:00	2905	6235	9140	848	9988	19051	52.43%	15.25%	21	21
14	宜蘭縣三星鄉	2018-11-24T23:55:46+08:00	2905	6235	9140	848	9988	19051	52.43%	15.25%	21	21
14	宜蘭縣三星鄉	2018-11-24T23:23:38+08:00	2905	6235	9140	848	9988	19051	52.43%	15.25%	21	21
14	宜蘭縣三星鄉	2018-11-25T03:38:55+08:00	2905	6235	9140	848	9988	19051	52.43%	15.25%	21	21
14	宜蘭縣三星鄉	2018-11-24T22:13:26+08:00	2454	5396	7850	754	8604	16376	52.54%	14.99%	19	21
14	宜蘭縣三星鄉	2018-11-24T23:08:36+08:00	2680	5851	8531	809	9340	17821	52.41%	15.04%	20	21
14	宜蘭縣三星鄉	2018-11-24T22:30:08+08:00	2680	5851	8531	809	9340	17821	52.41%	15.04%	20	21
14	宜蘭縣三星鄉	2018-11-24T22:40:27+08:00	2680	5851	8531	809	9340	17821	52.41%	15.04%	20	21
14	宜蘭縣三星鄉	2018-11-25T00:00:10+08:00	2905	6235	9140	848	9988	19051	52.43%	15.25%	21	21
14	宜蘭縣三星鄉	2018-11-25T06:18:57+08:00	2905	6235	9140	848	9988	19051	52.43%	15.25%	21	21
14	宜蘭縣三星鄉	2018-11-24T22:23:13+08:00	2454	5396	7850	754	8604	16376	52.54%	14.99%	19	21
14	宜蘭縣三星鄉	2018-11-24T23:19:51+08:00	2905	6235	9140	848	9988	19051	52.43%	15.25%	21	21
14	宜蘭縣三星鄉	2018-11-24T23:12:15+08:00	2905	6235	9140	848	9988	19051	52.43%	15.25%	21	21
14	宜蘭縣三星鄉	2018-11-24T22:45:08+08:00	2680	5851	8531	809	9340	17821	52.41%	15.04%	20	21
14	宜蘭縣三星鄉	2018-11-24T23:01:30+08:00	2680	5851	8531	809	9340	17821	52.41%	15.04%	20	21
14	宜蘭縣三星鄉	2018-11-24T23:39:15+08:00	2905	6235	9140	848	9988	19051	52.43%	15.25%	21	21
14	宜蘭縣三星鄉	2018-11-24T23:31:11+08:00	2905	6235	9140	848	9988	19051	52.43%	15.25%	21	21
14	宜蘭縣三星鄉	2018-11-25T00:09:34+08:00	2905	6235	9140	848	9988	19051	52.43%	15.25%	21	21
14	宜蘭縣三星鄉	2018-11-24T23:35:10+08:00	2905	6235	9140	848	9988	19051	52.43%	15.25%	21	21
14	宜蘭縣三星鄉	2018-11-25T00:14:09+08:00	2905	6235	9140	848	9988	19051	52.43%	15.25%	21	21
14	宜蘭縣三星鄉	2018-11-25T03:49:51+08:00	2905	6235	9140	848	9988	19051	52.43%	15.25%	21	21
14	宜蘭縣三星鄉	2018-11-24T23:16:02+08:00	2905	6235	9140	848	9988	19051	52.43%	15.25%	21	21
14	宜蘭縣三星鄉	2018-11-25T03:56:12+08:00	2905	6235	9140	848	9988	19051	52.43%	15.25%	21	21
14	宜蘭縣三星鄉	2018-11-25T06:24:00+08:00	2905	6235	9140	848	9988	19051	52.43%	15.25%	21	21
14	宜蘭縣三星鄉	2018-11-25T00:23:03+08:00	2905	6235	9140	848	9988	19051	52.43%	15.25%	21	21
14	宜蘭縣三星鄉	2018-11-25T03:32:34+08:00	2905	6235	9140	848	9988	19051	52.43%	15.25%	21	21
14	宜蘭縣三星鄉	2018-11-25T01:25:52+08:00	2905	6235	9140	848	9988	19051	52.43%	15.25%	21	21
14	宜蘭縣三星鄉	2018-11-24T22:57:53+08:00	2680	5851	8531	809	9340	17821	52.41%	15.04%	20	21
14	宜蘭縣三星鄉	2018-11-24T22:19:37+08:00	2454	5396	7850	754	8604	16376	52.54%	14.99%	19	21
14	宜蘭縣三星鄉	2018-11-25T00:57:36+08:00	2905	6235	9140	848	9988	19051	52.43%	15.25%	21	21
14	宜蘭縣三星鄉	2018-11-25T01:17:52+08:00	2905	6235	9140	848	9988	19051	52.43%	15.25%	21	21
14	宜蘭縣三星鄉	2018-11-24T23:27:18+08:00	2905	6235	9140	848	9988	19051	52.43%	15.25%	21	21
14	宜蘭縣三星鄉	2018-11-24T23:51:35+08:00	2905	6235	9140	848	9988	19051	52.43%	15.25%	21	21
14	宜蘭縣三星鄉	2018-11-24T23:05:04+08:00	2680	5851	8531	809	9340	17821	52.41%	15.04%	20	21
14	宜蘭縣三星鄉	2018-11-24T22:41:35+08:00	2680	5851	8531	809	9340	17821	52.41%	15.04%	20	21
14	宜蘭縣三星鄉	2018-11-25T00:05:05+08:00	2905	6235	9140	848	9988	19051	52.43%	15.25%	21	21
14	宜蘭縣三星鄉	2018-11-25T04:02:52+08:00	2905	6235	9140	848	9988	19051	52.43%	15.25%	21	21
14	宜蘭縣三星鄉	2018-11-24T22:16:10+08:00	2454	5396	7850	754	8604	16376	52.54%	14.99%	19	21
14	宜蘭縣三星鄉	2018-11-25T01:12:43+08:00	2905	6235	9140	848	9988	19051	52.43%	15.25%	21	21
14	宜蘭縣三星鄉	2018-11-24T22:50:48+08:00	2680	5851	8531	809	9340	17821	52.41%	15.04%	20	21
14	宜蘭縣三星鄉	2018-11-24T22:26:36+08:00	2680	5851	8531	809	9340	17821	52.41%	15.04%	20	21
14	宜蘭縣三星鄉	2018-11-25T06:08:52+08:00	2905	6235	9140	848	9988	19051	52.43%	15.25%	21	21
14	宜蘭縣三星鄉	2018-11-24T22:54:25+08:00	2680	5851	8531	809	9340	17821	52.41%	15.04%	20	21
14	宜蘭縣	2018-11-24T22:33:37+08:00	50040	101471	151511	11459	162970	293919	55.45%	17.03%	320	399
14	宜蘭縣	2018-11-24T23:47:28+08:00	62713	127129	189842	13940	203782	366998	55.53%	17.09%	383	399
14	宜蘭縣	2018-11-24T22:37:00+08:00	50756	103111	153867	11584	165451	298387	55.45%	17.01%	324	399
14	宜蘭縣	2018-11-24T23:43:16+08:00	62548	126805	189353	13896	203249	366122	55.51%	17.08%	382	399
14	宜蘭縣	2018-11-25T01:07:26+08:00	66039	133819	199858	14588	214446	386089	55.54%	17.1%	399	399
14	宜蘭縣	2018-11-25T06:13:52+08:00	66039	133819	199858	14588	214446	386089	55.54%	17.1%	399	399
14	宜蘭縣	2018-11-25T03:56:11+08:00	66039	133819	199858	14588	214446	386089	55.54%	17.1%	399	399
14	宜蘭縣	2018-11-25T06:29:16+08:00	66039	133819	199858	14588	214446	386089	55.54%	17.1%	399	399
14	宜蘭縣	2018-11-25T03:38:54+08:00	66039	133819	199858	14588	214446	386089	55.54%	17.1%	399	399
14	宜蘭縣	2018-11-24T23:55:46+08:00	63714	129123	192837	14141	206978	372664	55.54%	17.1%	388	399
14	宜蘭縣	2018-11-24T23:23:38+08:00	59498	120359	179857	13291	193148	347560	55.57%	17.12%	367	399
14	宜蘭縣	2018-11-25T01:02:30+08:00	66039	133819	199858	14588	214446	386089	55.54%	17.1%	399	399
14	宜蘭縣	2018-11-25T03:44:22+08:00	66039	133819	199858	14588	214446	386089	55.54%	17.1%	399	399
14	宜蘭縣	2018-11-24T22:13:26+08:00	43164	87817	130981	10061	141042	254690	55.38%	16.95%	287	399
14	宜蘭縣	2018-11-24T22:23:12+08:00	46175	93807	139982	10674	150656	271789	55.43%	16.99%	302	399
14	宜蘭縣	2018-11-24T22:30:08+08:00	47825	97085	144910	10983	155893	281037	55.47%	17.02%	309	399
14	宜蘭縣	2018-11-24T22:40:27+08:00	51228	104066	155294	11652	166946	301045	55.46%	17.02%	326	399
14	宜蘭縣	2018-11-25T00:00:10+08:00	63915	129490	193405	14185	207590	373824	55.53%	17.1%	389	399
14	宜蘭縣	2018-11-25T06:18:57+08:00	66039	133819	199858	14588	214446	386089	55.54%	17.1%	399	399
14	宜蘭縣	2018-11-25T01:17:51+08:00	66039	133819	199858	14588	214446	386089	55.54%	17.1%	399	399
14	宜蘭縣	2018-11-24T23:19:51+08:00	59498	120359	179857	13291	193148	347560	55.57%	17.12%	367	399
14	宜蘭縣	2018-11-24T23:12:15+08:00	57625	116891	174516	12990	187506	337190	55.61%	17.09%	359	399
14	宜蘭縣	2018-11-24T22:45:08+08:00	51846	105299	157145	11804	168949	304664	55.45%	17.02%	330	399
14	宜蘭縣	2018-11-24T23:31:10+08:00	60621	122987	183608	13542	197150	354860	55.56%	17.08%	373	399
14	宜蘭縣	2018-11-24T23:01:30+08:00	56212	114220	170432	12699	183131	329420	55.59%	17.06%	352	399
14	宜蘭縣	2018-11-24T23:39:15+08:00	61427	124626	186053	13667	199720	359830	55.5%	17.07%	377	399
14	宜蘭縣	2018-11-25T00:09:33+08:00	65059	131746	196805	14359	211164	380214	55.54%	17.11%	394	399
14	宜蘭縣	2018-11-24T23:35:10+08:00	61018	123848	184866	13609	198475	357429	55.53%	17.07%	375	399
14	宜蘭縣	2018-11-25T00:14:09+08:00	65373	132635	198008	14453	212461	382341	55.57%	17.1%	396	399
14	宜蘭縣	2018-11-25T03:49:51+08:00	66039	133819	199858	14588	214446	386089	55.54%	17.1%	399	399
14	宜蘭縣	2018-11-24T23:16:02+08:00	59073	119503	178576	13237	191813	344985	55.6%	17.12%	365	399
14	宜蘭縣	2018-11-25T06:24:00+08:00	66039	133819	199858	14588	214446	386089	55.54%	17.1%	399	399
14	宜蘭縣	2018-11-25T00:23:03+08:00	65813	133459	199272	14530	213802	384927	55.54%	17.1%	398	399
14	宜蘭縣	2018-11-24T23:08:35+08:00	57400	116507	173907	12951	186858	335960	55.62%	17.09%	358	399
14	宜蘭縣	2018-11-25T03:32:34+08:00	66039	133819	199858	14588	214446	386089	55.54%	17.1%	399	399
14	宜蘭縣	2018-11-25T01:25:52+08:00	66039	133819	199858	14588	214446	386089	55.54%	17.1%	399	399
14	宜蘭縣	2018-11-24T22:57:53+08:00	55354	112630	167984	12549	180533	324921	55.56%	17.04%	348	399
14	宜蘭縣	2018-11-24T22:19:36+08:00	45119	91675	136794	10479	147273	265788	55.41%	16.98%	297	399
14	宜蘭縣	2018-11-25T00:57:36+08:00	66039	133819	199858	14588	214446	386089	55.54%	17.1%	399	399
14	宜蘭縣	2018-11-24T23:27:18+08:00	59685	120720	180405	13354	193759	348642	55.58%	17.12%	368	399
14	宜蘭縣	2018-11-24T23:51:35+08:00	63714	129123	192837	14141	206978	372664	55.54%	17.1%	388	399
14	宜蘭縣	2018-11-24T23:05:04+08:00	56978	115792	172770	12883	185653	333804	55.62%	17.07%	356	399
14	宜蘭縣	2018-11-25T04:02:52+08:00	66039	133819	199858	14588	214446	386089	55.54%	17.1%	399	399
14	宜蘭縣	2018-11-24T22:50:47+08:00	53268	108487	161755	12125	173880	313470	55.47%	16.99%	338	399
14	宜蘭縣	2018-11-24T22:16:10+08:00	43945	89414	133359	10214	143573	259166	55.4%	16.96%	291	399
14	宜蘭縣	2018-11-25T01:12:43+08:00	66039	133819	199858	14588	214446	386089	55.54%	17.1%	399	399
14	宜蘭縣	2018-11-25T00:05:04+08:00	64770	131163	195933	14322	210255	378488	55.55%	17.11%	393	399
14	宜蘭縣	2018-11-24T22:41:34+08:00	51228	104066	155294	11652	166946	301045	55.46%	17.02%	326	399
14	宜蘭縣	2018-11-24T22:26:36+08:00	47599	96670	144269	10928	155197	279749	55.48%	17.01%	308	399
14	宜蘭縣	2018-11-25T00:18:29+08:00	65373	132635	198008	14453	212461	382341	55.57%	17.1%	396	399
14	宜蘭縣	2018-11-25T06:08:52+08:00	66039	133819	199858	14588	214446	386089	55.54%	17.1%	399	399
14	宜蘭縣	2018-11-24T22:54:25+08:00	53458	108965	162423	12147	174570	314600	55.49%	16.99%	339	399
14	屏東縣瑪家鄉	2018-11-24T22:33:37+08:00	708	2108	2816	182	2998	4606	65.09%	15.37%	7	8
14	屏東縣瑪家鄉	2018-11-24T22:37:00+08:00	708	2108	2816	182	2998	4606	65.09%	15.37%	7	8
14	屏東縣瑪家鄉	2018-11-24T23:43:16+08:00	708	2108	2816	182	2998	4606	65.09%	15.37%	7	8
14	屏東縣瑪家鄉	2018-11-25T03:56:11+08:00	862	2507	3369	199	3568	5663	63.01%	15.22%	8	8
14	屏東縣瑪家鄉	2018-11-25T06:29:16+08:00	862	2507	3369	199	3568	5663	63.01%	15.22%	8	8
14	屏東縣瑪家鄉	2018-11-24T23:47:27+08:00	708	2108	2816	182	2998	4606	65.09%	15.37%	7	8
14	屏東縣瑪家鄉	2018-11-25T03:38:54+08:00	862	2507	3369	199	3568	5663	63.01%	15.22%	8	8
14	屏東縣瑪家鄉	2018-11-24T23:55:46+08:00	708	2108	2816	182	2998	4606	65.09%	15.37%	7	8
14	屏東縣瑪家鄉	2018-11-25T01:02:30+08:00	862	2507	3369	199	3568	5663	63.01%	15.22%	8	8
14	屏東縣瑪家鄉	2018-11-25T03:44:22+08:00	862	2507	3369	199	3568	5663	63.01%	15.22%	8	8
14	屏東縣瑪家鄉	2018-11-24T22:13:26+08:00	576	1746	2322	155	2477	3706	66.84%	15.54%	6	8
14	屏東縣瑪家鄉	2018-11-24T23:23:37+08:00	708	2108	2816	182	2998	4606	65.09%	15.37%	7	8
14	屏東縣瑪家鄉	2018-11-25T06:18:56+08:00	862	2507	3369	199	3568	5663	63.01%	15.22%	8	8
14	屏東縣瑪家鄉	2018-11-24T22:23:12+08:00	708	2108	2816	182	2998	4606	65.09%	15.37%	7	8
14	屏東縣瑪家鄉	2018-11-24T23:19:50+08:00	708	2108	2816	182	2998	4606	65.09%	15.37%	7	8
14	屏東縣瑪家鄉	2018-11-24T22:40:27+08:00	708	2108	2816	182	2998	4606	65.09%	15.37%	7	8
14	屏東縣瑪家鄉	2018-11-25T00:00:10+08:00	708	2108	2816	182	2998	4606	65.09%	15.37%	7	8
14	屏東縣瑪家鄉	2018-11-25T01:17:51+08:00	862	2507	3369	199	3568	5663	63.01%	15.22%	8	8
14	屏東縣瑪家鄉	2018-11-24T22:30:07+08:00	708	2108	2816	182	2998	4606	65.09%	15.37%	7	8
14	屏東縣瑪家鄉	2018-11-24T23:12:15+08:00	708	2108	2816	182	2998	4606	65.09%	15.37%	7	8
14	屏東縣瑪家鄉	2018-11-24T22:45:08+08:00	708	2108	2816	182	2998	4606	65.09%	15.37%	7	8
14	屏東縣瑪家鄉	2018-11-24T23:31:10+08:00	708	2108	2816	182	2998	4606	65.09%	15.37%	7	8
14	屏東縣瑪家鄉	2018-11-24T23:01:30+08:00	708	2108	2816	182	2998	4606	65.09%	15.37%	7	8
14	屏東縣瑪家鄉	2018-11-25T04:02:51+08:00	862	2507	3369	199	3568	5663	63.01%	15.22%	8	8
14	屏東縣瑪家鄉	2018-11-24T23:39:15+08:00	708	2108	2816	182	2998	4606	65.09%	15.37%	7	8
14	屏東縣瑪家鄉	2018-11-25T06:23:59+08:00	862	2507	3369	199	3568	5663	63.01%	15.22%	8	8
14	屏東縣瑪家鄉	2018-11-25T00:09:33+08:00	862	2507	3369	199	3568	5663	63.01%	15.22%	8	8
14	屏東縣瑪家鄉	2018-11-25T01:07:25+08:00	862	2507	3369	199	3568	5663	63.01%	15.22%	8	8
14	屏東縣瑪家鄉	2018-11-25T06:13:51+08:00	862	2507	3369	199	3568	5663	63.01%	15.22%	8	8
14	屏東縣瑪家鄉	2018-11-24T23:16:02+08:00	708	2108	2816	182	2998	4606	65.09%	15.37%	7	8
14	屏東縣瑪家鄉	2018-11-24T23:35:09+08:00	708	2108	2816	182	2998	4606	65.09%	15.37%	7	8
14	屏東縣瑪家鄉	2018-11-25T03:49:50+08:00	862	2507	3369	199	3568	5663	63.01%	15.22%	8	8
14	屏東縣瑪家鄉	2018-11-25T00:14:08+08:00	862	2507	3369	199	3568	5663	63.01%	15.22%	8	8
14	屏東縣瑪家鄉	2018-11-25T00:23:03+08:00	862	2507	3369	199	3568	5663	63.01%	15.22%	8	8
14	屏東縣瑪家鄉	2018-11-24T23:08:35+08:00	708	2108	2816	182	2998	4606	65.09%	15.37%	7	8
14	屏東縣瑪家鄉	2018-11-25T03:32:34+08:00	862	2507	3369	199	3568	5663	63.01%	15.22%	8	8
14	屏東縣瑪家鄉	2018-11-25T01:25:52+08:00	862	2507	3369	199	3568	5663	63.01%	15.22%	8	8
14	屏東縣瑪家鄉	2018-11-24T22:19:36+08:00	576	1746	2322	155	2477	3706	66.84%	15.54%	6	8
14	屏東縣瑪家鄉	2018-11-24T23:51:34+08:00	708	2108	2816	182	2998	4606	65.09%	15.37%	7	8
14	屏東縣瑪家鄉	2018-11-24T22:57:52+08:00	708	2108	2816	182	2998	4606	65.09%	15.37%	7	8
14	屏東縣瑪家鄉	2018-11-25T00:57:36+08:00	862	2507	3369	199	3568	5663	63.01%	15.22%	8	8
14	屏東縣瑪家鄉	2018-11-24T23:27:18+08:00	708	2108	2816	182	2998	4606	65.09%	15.37%	7	8
14	屏東縣瑪家鄉	2018-11-24T23:05:04+08:00	708	2108	2816	182	2998	4606	65.09%	15.37%	7	8
14	屏東縣瑪家鄉	2018-11-24T22:50:47+08:00	708	2108	2816	182	2998	4606	65.09%	15.37%	7	8
14	屏東縣瑪家鄉	2018-11-24T22:16:10+08:00	576	1746	2322	155	2477	3706	66.84%	15.54%	6	8
14	屏東縣瑪家鄉	2018-11-25T00:05:04+08:00	862	2507	3369	199	3568	5663	63.01%	15.22%	8	8
14	屏東縣瑪家鄉	2018-11-24T22:41:34+08:00	708	2108	2816	182	2998	4606	65.09%	15.37%	7	8
14	屏東縣瑪家鄉	2018-11-25T01:12:42+08:00	862	2507	3369	199	3568	5663	63.01%	15.22%	8	8
14	屏東縣瑪家鄉	2018-11-24T22:26:36+08:00	708	2108	2816	182	2998	4606	65.09%	15.37%	7	8
14	屏東縣瑪家鄉	2018-11-25T00:18:29+08:00	862	2507	3369	199	3568	5663	63.01%	15.22%	8	8
14	屏東縣瑪家鄉	2018-11-25T06:08:52+08:00	862	2507	3369	199	3568	5663	63.01%	15.22%	8	8
14	屏東縣瑪家鄉	2018-11-24T22:54:25+08:00	708	2108	2816	182	2998	4606	65.09%	15.37%	7	8
14	臺東縣海端鄉	2018-11-25T03:49:52+08:00	351	1281	1632	124	1756	3278	53.57%	10.71%	6	6
14	臺東縣海端鄉	2018-11-24T23:47:29+08:00	351	1281	1632	124	1756	3278	53.57%	10.71%	6	6
14	臺東縣海端鄉	2018-11-25T06:29:18+08:00	351	1281	1632	124	1756	3278	53.57%	10.71%	6	6
14	臺東縣海端鄉	2018-11-24T22:33:38+08:00	225	959	1184	89	1273	2307	55.18%	9.75%	5	6
14	臺東縣海端鄉	2018-11-25T01:07:27+08:00	351	1281	1632	124	1756	3278	53.57%	10.71%	6	6
14	臺東縣海端鄉	2018-11-25T06:13:53+08:00	351	1281	1632	124	1756	3278	53.57%	10.71%	6	6
14	臺東縣海端鄉	2018-11-24T23:43:17+08:00	351	1281	1632	124	1756	3278	53.57%	10.71%	6	6
14	臺東縣海端鄉	2018-11-25T00:18:31+08:00	351	1281	1632	124	1756	3278	53.57%	10.71%	6	6
14	臺東縣海端鄉	2018-11-24T22:37:01+08:00	225	959	1184	89	1273	2307	55.18%	9.75%	5	6
14	臺東縣海端鄉	2018-11-25T03:44:24+08:00	351	1281	1632	124	1756	3278	53.57%	10.71%	6	6
14	臺東縣海端鄉	2018-11-24T23:08:37+08:00	351	1281	1632	124	1756	3278	53.57%	10.71%	6	6
14	臺東縣海端鄉	2018-11-24T23:55:48+08:00	351	1281	1632	124	1756	3278	53.57%	10.71%	6	6
14	臺東縣海端鄉	2018-11-24T22:13:28+08:00	177	764	941	69	1010	1810	55.8%	9.78%	4	6
14	臺東縣海端鄉	2018-11-24T23:23:39+08:00	351	1281	1632	124	1756	3278	53.57%	10.71%	6	6
14	臺東縣海端鄉	2018-11-25T06:18:58+08:00	351	1281	1632	124	1756	3278	53.57%	10.71%	6	6
14	臺東縣海端鄉	2018-11-25T00:00:11+08:00	351	1281	1632	124	1756	3278	53.57%	10.71%	6	6
14	臺東縣海端鄉	2018-11-24T23:51:36+08:00	351	1281	1632	124	1756	3278	53.57%	10.71%	6	6
14	臺東縣海端鄉	2018-11-24T22:23:14+08:00	225	959	1184	89	1273	2307	55.18%	9.75%	5	6
14	臺東縣海端鄉	2018-11-24T22:40:28+08:00	225	959	1184	89	1273	2307	55.18%	9.75%	5	6
14	臺東縣海端鄉	2018-11-25T00:09:35+08:00	351	1281	1632	124	1756	3278	53.57%	10.71%	6	6
14	臺東縣海端鄉	2018-11-25T00:05:06+08:00	351	1281	1632	124	1756	3278	53.57%	10.71%	6	6
14	臺東縣海端鄉	2018-11-24T23:35:11+08:00	351	1281	1632	124	1756	3278	53.57%	10.71%	6	6
14	臺東縣海端鄉	2018-11-24T22:41:36+08:00	225	959	1184	89	1273	2307	55.18%	9.75%	5	6
14	臺東縣海端鄉	2018-11-24T23:01:31+08:00	351	1281	1632	124	1756	3278	53.57%	10.71%	6	6
14	臺東縣海端鄉	2018-11-24T22:45:09+08:00	351	1281	1632	124	1756	3278	53.57%	10.71%	6	6
14	臺東縣海端鄉	2018-11-24T22:54:26+08:00	351	1281	1632	124	1756	3278	53.57%	10.71%	6	6
14	臺東縣海端鄉	2018-11-25T00:14:10+08:00	351	1281	1632	124	1756	3278	53.57%	10.71%	6	6
14	臺東縣海端鄉	2018-11-25T03:56:13+08:00	351	1281	1632	124	1756	3278	53.57%	10.71%	6	6
14	臺東縣海端鄉	2018-11-24T23:16:03+08:00	351	1281	1632	124	1756	3278	53.57%	10.71%	6	6
14	臺東縣海端鄉	2018-11-25T03:32:35+08:00	351	1281	1632	124	1756	3278	53.57%	10.71%	6	6
14	臺東縣海端鄉	2018-11-25T01:25:53+08:00	351	1281	1632	124	1756	3278	53.57%	10.71%	6	6
14	臺東縣海端鄉	2018-11-25T01:02:32+08:00	351	1281	1632	124	1756	3278	53.57%	10.71%	6	6
14	臺東縣海端鄉	2018-11-24T22:30:10+08:00	225	959	1184	89	1273	2307	55.18%	9.75%	5	6
14	臺東縣海端鄉	2018-11-25T00:23:04+08:00	351	1281	1632	124	1756	3278	53.57%	10.71%	6	6
14	臺東縣海端鄉	2018-11-25T06:24:01+08:00	351	1281	1632	124	1756	3278	53.57%	10.71%	6	6
14	臺東縣海端鄉	2018-11-25T03:38:56+08:00	351	1281	1632	124	1756	3278	53.57%	10.71%	6	6
14	臺東縣海端鄉	2018-11-24T23:27:19+08:00	351	1281	1632	124	1756	3278	53.57%	10.71%	6	6
14	臺東縣海端鄉	2018-11-24T22:19:38+08:00	225	959	1184	89	1273	2307	55.18%	9.75%	5	6
14	臺東縣海端鄉	2018-11-25T00:57:37+08:00	351	1281	1632	124	1756	3278	53.57%	10.71%	6	6
14	臺東縣海端鄉	2018-11-24T22:57:54+08:00	351	1281	1632	124	1756	3278	53.57%	10.71%	6	6
14	臺東縣海端鄉	2018-11-25T01:17:53+08:00	351	1281	1632	124	1756	3278	53.57%	10.71%	6	6
14	臺東縣海端鄉	2018-11-24T23:19:52+08:00	351	1281	1632	124	1756	3278	53.57%	10.71%	6	6
14	臺東縣海端鄉	2018-11-25T06:08:54+08:00	351	1281	1632	124	1756	3278	53.57%	10.71%	6	6
14	臺東縣海端鄉	2018-11-24T23:12:16+08:00	351	1281	1632	124	1756	3278	53.57%	10.71%	6	6
14	臺東縣海端鄉	2018-11-24T23:39:17+08:00	351	1281	1632	124	1756	3278	53.57%	10.71%	6	6
14	臺東縣海端鄉	2018-11-25T01:12:44+08:00	351	1281	1632	124	1756	3278	53.57%	10.71%	6	6
14	臺東縣海端鄉	2018-11-24T22:50:49+08:00	351	1281	1632	124	1756	3278	53.57%	10.71%	6	6
14	臺東縣海端鄉	2018-11-24T22:26:37+08:00	225	959	1184	89	1273	2307	55.18%	9.75%	5	6
14	臺東縣海端鄉	2018-11-25T04:02:53+08:00	351	1281	1632	124	1756	3278	53.57%	10.71%	6	6
14	臺東縣海端鄉	2018-11-24T23:05:05+08:00	351	1281	1632	124	1756	3278	53.57%	10.71%	6	6
14	臺東縣海端鄉	2018-11-24T23:31:12+08:00	351	1281	1632	124	1756	3278	53.57%	10.71%	6	6
14	臺東縣海端鄉	2018-11-24T22:16:11+08:00	225	959	1184	89	1273	2307	55.18%	9.75%	5	6
14	臺東縣成功鎮	2018-11-25T06:29:17+08:00	1189	4309	5498	649	6147	12426	49.47%	9.57%	17	17
14	臺東縣成功鎮	2018-11-25T00:18:30+08:00	1189	4309	5498	649	6147	12426	49.47%	9.57%	17	17
14	臺東縣成功鎮	2018-11-24T23:47:29+08:00	1189	4309	5498	649	6147	12426	49.47%	9.57%	17	17
14	臺東縣成功鎮	2018-11-24T22:33:38+08:00	944	3287	4231	507	4738	9695	48.87%	9.74%	15	17
14	臺東縣成功鎮	2018-11-25T01:07:27+08:00	1189	4309	5498	649	6147	12426	49.47%	9.57%	17	17
14	臺東縣成功鎮	2018-11-25T06:13:53+08:00	1189	4309	5498	649	6147	12426	49.47%	9.57%	17	17
14	臺東縣成功鎮	2018-11-24T23:43:17+08:00	1189	4309	5498	649	6147	12426	49.47%	9.57%	17	17
14	臺東縣成功鎮	2018-11-24T22:37:01+08:00	944	3287	4231	507	4738	9695	48.87%	9.74%	15	17
14	臺東縣成功鎮	2018-11-25T03:44:23+08:00	1189	4309	5498	649	6147	12426	49.47%	9.57%	17	17
14	臺東縣成功鎮	2018-11-24T22:13:27+08:00	944	3287	4231	507	4738	9695	48.87%	9.74%	15	17
14	臺東縣成功鎮	2018-11-25T01:02:31+08:00	1189	4309	5498	649	6147	12426	49.47%	9.57%	17	17
14	臺東縣成功鎮	2018-11-25T03:38:55+08:00	1189	4309	5498	649	6147	12426	49.47%	9.57%	17	17
14	臺東縣成功鎮	2018-11-24T23:55:47+08:00	1189	4309	5498	649	6147	12426	49.47%	9.57%	17	17
14	臺東縣成功鎮	2018-11-24T23:08:36+08:00	1065	3792	4857	575	5432	11060	49.11%	9.63%	16	17
14	臺東縣成功鎮	2018-11-24T23:23:39+08:00	1189	4309	5498	649	6147	12426	49.47%	9.57%	17	17
14	臺東縣成功鎮	2018-11-25T06:18:58+08:00	1189	4309	5498	649	6147	12426	49.47%	9.57%	17	17
14	臺東縣成功鎮	2018-11-25T00:00:11+08:00	1189	4309	5498	649	6147	12426	49.47%	9.57%	17	17
14	臺東縣成功鎮	2018-11-24T23:51:36+08:00	1189	4309	5498	649	6147	12426	49.47%	9.57%	17	17
14	臺東縣成功鎮	2018-11-24T22:30:09+08:00	944	3287	4231	507	4738	9695	48.87%	9.74%	15	17
14	臺東縣成功鎮	2018-11-24T22:40:28+08:00	944	3287	4231	507	4738	9695	48.87%	9.74%	15	17
14	臺東縣成功鎮	2018-11-24T22:23:13+08:00	944	3287	4231	507	4738	9695	48.87%	9.74%	15	17
14	臺東縣成功鎮	2018-11-25T00:09:35+08:00	1189	4309	5498	649	6147	12426	49.47%	9.57%	17	17
14	臺東縣成功鎮	2018-11-24T23:35:11+08:00	1189	4309	5498	649	6147	12426	49.47%	9.57%	17	17
14	臺東縣成功鎮	2018-11-24T23:01:31+08:00	944	3287	4231	507	4738	9695	48.87%	9.74%	15	17
14	臺東縣成功鎮	2018-11-24T22:45:09+08:00	944	3287	4231	507	4738	9695	48.87%	9.74%	15	17
14	臺東縣成功鎮	2018-11-24T22:54:26+08:00	944	3287	4231	507	4738	9695	48.87%	9.74%	15	17
14	臺東縣成功鎮	2018-11-25T00:14:10+08:00	1189	4309	5498	649	6147	12426	49.47%	9.57%	17	17
14	臺東縣成功鎮	2018-11-25T03:56:13+08:00	1189	4309	5498	649	6147	12426	49.47%	9.57%	17	17
14	臺東縣成功鎮	2018-11-25T03:49:51+08:00	1189	4309	5498	649	6147	12426	49.47%	9.57%	17	17
14	臺東縣成功鎮	2018-11-24T23:16:03+08:00	1189	4309	5498	649	6147	12426	49.47%	9.57%	17	17
14	臺東縣成功鎮	2018-11-25T03:32:35+08:00	1189	4309	5498	649	6147	12426	49.47%	9.57%	17	17
14	臺東縣成功鎮	2018-11-25T06:24:00+08:00	1189	4309	5498	649	6147	12426	49.47%	9.57%	17	17
14	臺東縣成功鎮	2018-11-25T01:25:53+08:00	1189	4309	5498	649	6147	12426	49.47%	9.57%	17	17
14	臺東縣成功鎮	2018-11-25T00:23:04+08:00	1189	4309	5498	649	6147	12426	49.47%	9.57%	17	17
14	臺東縣成功鎮	2018-11-24T23:27:19+08:00	1189	4309	5498	649	6147	12426	49.47%	9.57%	17	17
14	臺東縣成功鎮	2018-11-25T00:57:37+08:00	1189	4309	5498	649	6147	12426	49.47%	9.57%	17	17
14	臺東縣成功鎮	2018-11-24T22:57:54+08:00	944	3287	4231	507	4738	9695	48.87%	9.74%	15	17
14	臺東縣成功鎮	2018-11-25T01:17:53+08:00	1189	4309	5498	649	6147	12426	49.47%	9.57%	17	17
14	臺東縣成功鎮	2018-11-24T22:19:37+08:00	944	3287	4231	507	4738	9695	48.87%	9.74%	15	17
14	臺東縣成功鎮	2018-11-24T23:19:52+08:00	1189	4309	5498	649	6147	12426	49.47%	9.57%	17	17
14	臺東縣成功鎮	2018-11-24T22:41:35+08:00	944	3287	4231	507	4738	9695	48.87%	9.74%	15	17
14	臺東縣成功鎮	2018-11-25T00:05:05+08:00	1189	4309	5498	649	6147	12426	49.47%	9.57%	17	17
14	臺東縣成功鎮	2018-11-25T04:02:52+08:00	1189	4309	5498	649	6147	12426	49.47%	9.57%	17	17
14	臺東縣成功鎮	2018-11-24T23:12:16+08:00	1065	3792	4857	575	5432	11060	49.11%	9.63%	16	17
14	臺東縣成功鎮	2018-11-25T06:08:53+08:00	1189	4309	5498	649	6147	12426	49.47%	9.57%	17	17
14	臺東縣成功鎮	2018-11-25T01:12:44+08:00	1189	4309	5498	649	6147	12426	49.47%	9.57%	17	17
14	臺東縣成功鎮	2018-11-24T22:26:37+08:00	944	3287	4231	507	4738	9695	48.87%	9.74%	15	17
14	臺東縣成功鎮	2018-11-24T23:05:05+08:00	944	3287	4231	507	4738	9695	48.87%	9.74%	15	17
14	臺東縣成功鎮	2018-11-24T22:50:48+08:00	944	3287	4231	507	4738	9695	48.87%	9.74%	15	17
14	臺東縣成功鎮	2018-11-24T23:31:12+08:00	1189	4309	5498	649	6147	12426	49.47%	9.57%	17	17
14	臺東縣成功鎮	2018-11-24T22:16:11+08:00	944	3287	4231	507	4738	9695	48.87%	9.74%	15	17
14	臺東縣成功鎮	2018-11-24T23:39:16+08:00	1189	4309	5498	649	6147	12426	49.47%	9.57%	17	17
14	臺中市大安區	2018-11-24T23:35:03+08:00	2478	6446	8924	810	9734	16520	58.92%	15%	16	16
14	臺中市大安區	2018-11-24T22:33:30+08:00	2478	6446	8924	810	9734	16520	58.92%	15%	16	16
14	臺中市大安區	2018-11-24T22:16:01+08:00	2478	6446	8924	810	9734	16520	58.92%	15%	16	16
14	臺中市大安區	2018-11-24T23:31:02+08:00	2478	6446	8924	810	9734	16520	58.92%	15%	16	16
14	臺中市大安區	2018-11-24T23:01:22+08:00	2478	6446	8924	810	9734	16520	58.92%	15%	16	16
14	臺中市大安區	2018-11-24T23:12:07+08:00	2478	6446	8924	810	9734	16520	58.92%	15%	16	16
14	臺中市大安區	2018-11-24T23:47:20+08:00	2478	6446	8924	810	9734	16520	58.92%	15%	16	16
14	臺中市大安區	2018-11-25T01:07:18+08:00	2478	6446	8924	810	9734	16520	58.92%	15%	16	16
14	臺中市大安區	2018-11-25T06:08:43+08:00	2478	6446	8924	810	9734	16520	58.92%	15%	16	16
14	臺中市大安區	2018-11-24T22:57:45+08:00	2478	6446	8924	810	9734	16520	58.92%	15%	16	16
14	臺中市大安區	2018-11-25T01:17:42+08:00	2478	6446	8924	810	9734	16520	58.92%	15%	16	16
14	臺中市大安區	2018-11-24T22:13:18+08:00	2478	6446	8924	810	9734	16520	58.92%	15%	16	16
14	臺中市大安區	2018-11-24T22:19:29+08:00	2478	6446	8924	810	9734	16520	58.92%	15%	16	16
14	臺中市大安區	2018-11-25T00:57:28+08:00	2478	6446	8924	810	9734	16520	58.92%	15%	16	16
14	臺中市大安區	2018-11-24T23:23:31+08:00	2478	6446	8924	810	9734	16520	58.92%	15%	16	16
14	臺中市大安區	2018-11-25T03:44:13+08:00	2478	6446	8924	810	9734	16520	58.92%	15%	16	16
14	臺中市大安區	2018-11-25T00:04:57+08:00	2478	6446	8924	810	9734	16520	58.92%	15%	16	16
14	臺中市大安區	2018-11-24T23:04:56+08:00	2478	6446	8924	810	9734	16520	58.92%	15%	16	16
14	臺中市大安區	2018-11-24T23:15:55+08:00	2478	6446	8924	810	9734	16520	58.92%	15%	16	16
14	臺中市大安區	2018-11-24T22:40:20+08:00	2478	6446	8924	810	9734	16520	58.92%	15%	16	16
14	臺中市大安區	2018-11-25T01:25:44+08:00	2478	6446	8924	810	9734	16520	58.92%	15%	16	16
14	臺中市大安區	2018-11-25T01:02:22+08:00	2478	6446	8924	810	9734	16520	58.92%	15%	16	16
14	臺中市大安區	2018-11-25T03:38:47+08:00	2478	6446	8924	810	9734	16520	58.92%	15%	16	16
14	臺中市大安區	2018-11-24T23:55:39+08:00	2478	6446	8924	810	9734	16520	58.92%	15%	16	16
14	臺中市大安區	2018-11-24T22:54:18+08:00	2478	6446	8924	810	9734	16520	58.92%	15%	16	16
14	臺中市大安區	2018-11-24T22:45:01+08:00	2478	6446	8924	810	9734	16520	58.92%	15%	16	16
14	臺中市大安區	2018-11-25T00:18:22+08:00	2478	6446	8924	810	9734	16520	58.92%	15%	16	16
14	臺中市大安區	2018-11-25T00:22:56+08:00	2478	6446	8924	810	9734	16520	58.92%	15%	16	16
14	臺中市大安區	2018-11-25T03:56:02+08:00	2478	6446	8924	810	9734	16520	58.92%	15%	16	16
14	臺中市大安區	2018-11-24T23:39:05+08:00	2478	6446	8924	810	9734	16520	58.92%	15%	16	16
14	臺中市大安區	2018-11-25T01:12:34+08:00	2478	6446	8924	810	9734	16520	58.92%	15%	16	16
14	臺中市大安區	2018-11-25T04:02:40+08:00	2478	6446	8924	810	9734	16520	58.92%	15%	16	16
14	臺中市大安區	2018-11-25T00:09:25+08:00	2478	6446	8924	810	9734	16520	58.92%	15%	16	16
14	臺中市大安區	2018-11-25T00:14:01+08:00	2478	6446	8924	810	9734	16520	58.92%	15%	16	16
14	臺中市大安區	2018-11-24T22:41:28+08:00	2478	6446	8924	810	9734	16520	58.92%	15%	16	16
14	臺中市大安區	2018-11-24T22:50:38+08:00	2478	6446	8924	810	9734	16520	58.92%	15%	16	16
14	臺中市大安區	2018-11-24T23:51:26+08:00	2478	6446	8924	810	9734	16520	58.92%	15%	16	16
14	臺中市大安區	2018-11-25T00:00:00+08:00	2478	6446	8924	810	9734	16520	58.92%	15%	16	16
14	臺中市大安區	2018-11-25T06:18:49+08:00	2478	6446	8924	810	9734	16520	58.92%	15%	16	16
14	臺中市大安區	2018-11-24T22:23:04+08:00	2478	6446	8924	810	9734	16520	58.92%	15%	16	16
14	臺中市大安區	2018-11-24T22:29:56+08:00	2478	6446	8924	810	9734	16520	58.92%	15%	16	16
14	臺中市大安區	2018-11-24T23:19:40+08:00	2478	6446	8924	810	9734	16520	58.92%	15%	16	16
14	臺中市大安區	2018-11-24T22:36:53+08:00	2478	6446	8924	810	9734	16520	58.92%	15%	16	16
14	臺中市大安區	2018-11-24T23:27:11+08:00	2478	6446	8924	810	9734	16520	58.92%	15%	16	16
14	臺中市大安區	2018-11-24T23:08:27+08:00	2478	6446	8924	810	9734	16520	58.92%	15%	16	16
14	臺中市大安區	2018-11-25T03:32:26+08:00	2478	6446	8924	810	9734	16520	58.92%	15%	16	16
14	臺中市大安區	2018-11-25T03:49:43+08:00	2478	6446	8924	810	9734	16520	58.92%	15%	16	16
14	臺中市大安區	2018-11-25T06:29:08+08:00	2478	6446	8924	810	9734	16520	58.92%	15%	16	16
14	臺中市大安區	2018-11-25T06:13:44+08:00	2478	6446	8924	810	9734	16520	58.92%	15%	16	16
14	臺中市大安區	2018-11-24T22:26:30+08:00	2478	6446	8924	810	9734	16520	58.92%	15%	16	16
14	臺中市大安區	2018-11-25T06:23:52+08:00	2478	6446	8924	810	9734	16520	58.92%	15%	16	16
14	臺中市大安區	2018-11-24T23:43:09+08:00	2478	6446	8924	810	9734	16520	58.92%	15%	16	16
14	彰化縣彰化市	2018-11-25T04:02:44+08:00	35013	74892	109905	5771	115676	190995	60.56%	18.33%	184	184
14	彰化縣彰化市	2018-11-24T22:16:06+08:00	4648	9669	14317	738	15055	23889	63.02%	19.46%	27	184
14	彰化縣彰化市	2018-11-25T01:12:38+08:00	30491	65497	95988	5058	101046	166828	60.57%	18.28%	162	184
14	彰化縣彰化市	2018-11-25T00:14:05+08:00	22294	47900	70194	3731	73925	121444	60.87%	18.36%	121	184
14	彰化縣彰化市	2018-11-25T00:00:03+08:00	21670	46615	68285	3654	71939	118129	60.9%	18.34%	118	184
14	彰化縣彰化市	2018-11-24T22:23:08+08:00	6110	12849	18959	984	19943	32015	62.29%	19.08%	35	184
14	彰化縣彰化市	2018-11-25T00:23:00+08:00	23212	50012	73224	3875	77099	126681	60.86%	18.32%	126	184
14	彰化縣彰化市	2018-11-24T23:08:31+08:00	14216	29992	44208	2304	46512	76506	60.8%	18.58%	79	184
14	彰化縣彰化市	2018-11-25T03:32:30+08:00	35013	74892	109905	5771	115676	190995	60.56%	18.33%	184	184
14	彰化縣彰化市	2018-11-24T23:27:14+08:00	17047	36292	53339	2813	56152	92349	60.8%	18.46%	93	184
14	彰化縣彰化市	2018-11-24T23:51:31+08:00	20573	44471	65044	3502	68546	112502	60.93%	18.29%	113	184
14	彰化縣彰化市	2018-11-24T22:19:33+08:00	5220	10886	16106	814	16920	26922	62.85%	19.39%	30	184
14	彰化縣彰化市	2018-11-25T00:57:32+08:00	30291	65030	95321	5021	100342	165653	60.57%	18.29%	161	184
14	彰化縣彰化市	2018-11-24T22:36:56+08:00	9064	18186	27250	1440	28690	46974	61.08%	19.3%	50	184
14	彰化縣彰化市	2018-11-24T22:50:43+08:00	12192	25353	37545	1967	39512	64861	60.92%	18.8%	68	184
14	彰化縣彰化市	2018-11-25T06:23:56+08:00	35013	74892	109905	5771	115676	190995	60.56%	18.33%	184	184
14	彰化縣彰化市	2018-11-24T22:26:33+08:00	7206	14384	21590	1142	22732	36695	61.95%	19.64%	39	184
14	彰化縣彰化市	2018-11-25T03:49:47+08:00	35013	74892	109905	5771	115676	190995	60.56%	18.33%	184	184
14	彰化縣彰化市	2018-11-24T22:41:31+08:00	9689	19639	29328	1540	30868	50511	61.11%	19.18%	53	184
14	彰化縣彰化市	2018-11-25T00:05:01+08:00	21840	47065	68905	3680	72585	119241	60.87%	18.32%	119	184
14	彰化縣彰化市	2018-11-25T06:13:48+08:00	35013	74892	109905	5771	115676	190995	60.56%	18.33%	184	184
14	彰化縣彰化市	2018-11-24T23:05:01+08:00	13991	29500	43491	2283	45774	75279	60.81%	18.59%	78	184
14	彰化縣彰化市	2018-11-24T23:31:06+08:00	17047	36292	53339	2813	56152	92349	60.8%	18.46%	93	184
14	彰化縣彰化市	2018-11-25T06:08:48+08:00	35013	74892	109905	5771	115676	190995	60.56%	18.33%	184	184
14	彰化縣彰化市	2018-11-25T01:07:22+08:00	30291	65030	95321	5021	100342	165653	60.57%	18.29%	161	184
14	彰化縣彰化市	2018-11-24T22:33:34+08:00	8686	17423	26109	1387	27496	45053	61.03%	19.28%	48	184
14	彰化縣彰化市	2018-11-24T23:43:13+08:00	19055	40976	60031	3205	63236	104013	60.8%	18.32%	105	184
14	彰化縣彰化市	2018-11-24T23:01:27+08:00	13991	29500	43491	2283	45774	75279	60.81%	18.59%	78	184
14	彰化縣彰化市	2018-11-24T23:35:06+08:00	17646	37545	55191	2908	58099	95598	60.77%	18.46%	97	184
14	彰化縣彰化市	2018-11-25T06:29:12+08:00	35013	74892	109905	5771	115676	190995	60.56%	18.33%	184	184
14	彰化縣彰化市	2018-11-24T23:47:24+08:00	19641	42220	61861	3307	65168	107046	60.88%	18.35%	108	184
14	彰化縣彰化市	2018-11-24T23:19:46+08:00	16375	34898	51273	2687	53960	88810	60.76%	18.44%	90	184
14	彰化縣彰化市	2018-11-25T03:44:18+08:00	35013	74892	109905	5771	115676	190995	60.56%	18.33%	184	184
14	彰化縣彰化市	2018-11-24T23:23:34+08:00	16783	35762	52545	2773	55318	90987	60.8%	18.45%	92	184
14	彰化縣彰化市	2018-11-24T23:55:43+08:00	21054	45344	66398	3565	69963	114831	60.93%	18.33%	115	184
14	彰化縣彰化市	2018-11-25T03:38:51+08:00	35013	74892	109905	5771	115676	190995	60.56%	18.33%	184	184
14	彰化縣彰化市	2018-11-24T22:57:49+08:00	13394	28055	41449	2161	43610	71665	60.85%	18.69%	75	184
14	彰化縣彰化市	2018-11-24T22:13:22+08:00	4124	8402	12526	662	13188	20945	62.96%	19.69%	24	184
14	彰化縣彰化市	2018-11-25T01:17:47+08:00	30898	66341	97239	5109	102348	169012	60.56%	18.28%	164	184
14	彰化縣彰化市	2018-11-24T22:30:02+08:00	7601	15203	22804	1208	24012	38794	61.9%	19.59%	41	184
14	彰化縣彰化市	2018-11-25T01:25:48+08:00	31517	67867	99384	5229	104613	172531	60.63%	18.27%	167	184
14	彰化縣彰化市	2018-11-24T22:40:24+08:00	9689	19639	29328	1540	30868	50511	61.11%	19.18%	53	184
14	彰化縣彰化市	2018-11-25T01:02:26+08:00	30291	65030	95321	5021	100342	165653	60.57%	18.29%	161	184
14	彰化縣彰化市	2018-11-24T23:15:59+08:00	15988	34123	50111	2605	52716	86786	60.74%	18.42%	88	184
14	彰化縣彰化市	2018-11-25T06:18:53+08:00	35013	74892	109905	5771	115676	190995	60.56%	18.33%	184	184
14	彰化縣彰化市	2018-11-24T23:12:11+08:00	14755	31226	45981	2341	48322	79455	60.82%	18.57%	81	184
14	彰化縣彰化市	2018-11-25T00:18:26+08:00	22471	48356	70827	3752	74579	122592	60.84%	18.33%	122	184
14	彰化縣彰化市	2018-11-25T03:56:07+08:00	35013	74892	109905	5771	115676	190995	60.56%	18.33%	184	184
14	彰化縣彰化市	2018-11-24T23:39:11+08:00	18200	38898	57098	3010	60108	98863	60.8%	18.41%	100	184
14	彰化縣彰化市	2018-11-25T00:09:30+08:00	21840	47065	68905	3680	72585	119241	60.87%	18.32%	119	184
14	彰化縣彰化市	2018-11-24T22:45:04+08:00	10528	21703	32231	1690	33921	55714	60.88%	18.9%	59	184
14	彰化縣彰化市	2018-11-24T22:54:22+08:00	12308	25715	38023	1996	40019	65661	60.95%	18.74%	69	184
14	南投縣信義鄉	2018-11-24T23:16:00+08:00	1554	4652	6206	494	6700	10903	61.45%	14.25%	18	20
14	南投縣信義鄉	2018-11-24T22:16:07+08:00	820	3045	3865	319	4184	7018	59.62%	11.68%	13	20
14	南投縣信義鄉	2018-11-24T22:23:09+08:00	891	3335	4226	347	4573	7578	60.35%	11.76%	14	20
14	南投縣信義鄉	2018-11-25T03:32:31+08:00	1752	5884	7636	583	8219	13299	61.8%	13.17%	20	20
14	南投縣信義鄉	2018-11-25T00:23:01+08:00	1752	5884	7636	583	8219	13299	61.8%	13.17%	20	20
14	南投縣信義鄉	2018-11-25T03:38:52+08:00	1752	5884	7636	583	8219	13299	61.8%	13.17%	20	20
14	南投縣信義鄉	2018-11-24T22:36:57+08:00	1063	4343	5406	442	5848	9407	62.17%	11.3%	16	20
14	南投縣信義鄉	2018-11-24T22:57:50+08:00	1554	4652	6206	494	6700	10903	61.45%	14.25%	18	20
14	南投縣信義鄉	2018-11-25T00:57:33+08:00	1752	5884	7636	583	8219	13299	61.8%	13.17%	20	20
14	南投縣信義鄉	2018-11-24T23:27:15+08:00	1554	4652	6206	494	6700	10903	61.45%	14.25%	18	20
14	南投縣信義鄉	2018-11-24T22:19:34+08:00	820	3045	3865	319	4184	7018	59.62%	11.68%	13	20
14	南投縣信義鄉	2018-11-24T22:50:44+08:00	1131	4553	5684	469	6153	9924	62%	11.4%	17	20
14	南投縣信義鄉	2018-11-24T23:12:12+08:00	1554	4652	6206	494	6700	10903	61.45%	14.25%	18	20
14	南投縣信義鄉	2018-11-25T06:13:49+08:00	1752	5884	7636	583	8219	13299	61.8%	13.17%	20	20
14	南投縣信義鄉	2018-11-25T01:12:40+08:00	1752	5884	7636	583	8219	13299	61.8%	13.17%	20	20
14	南投縣信義鄉	2018-11-24T22:26:34+08:00	891	3335	4226	347	4573	7578	60.35%	11.76%	14	20
14	南投縣信義鄉	2018-11-25T06:23:57+08:00	1752	5884	7636	583	8219	13299	61.8%	13.17%	20	20
14	南投縣信義鄉	2018-11-24T23:39:12+08:00	1554	4652	6206	494	6700	10903	61.45%	14.25%	18	20
14	南投縣信義鄉	2018-11-25T03:49:48+08:00	1752	5884	7636	583	8219	13299	61.8%	13.17%	20	20
14	南投縣信義鄉	2018-11-24T23:01:28+08:00	1554	4652	6206	494	6700	10903	61.45%	14.25%	18	20
14	南投縣信義鄉	2018-11-25T04:02:47+08:00	1752	5884	7636	583	8219	13299	61.8%	13.17%	20	20
14	南投縣信義鄉	2018-11-24T23:47:25+08:00	1554	4652	6206	494	6700	10903	61.45%	14.25%	18	20
14	南投縣信義鄉	2018-11-25T06:29:13+08:00	1752	5884	7636	583	8219	13299	61.8%	13.17%	20	20
14	南投縣信義鄉	2018-11-24T23:35:07+08:00	1554	4652	6206	494	6700	10903	61.45%	14.25%	18	20
14	南投縣信義鄉	2018-11-25T01:07:23+08:00	1752	5884	7636	583	8219	13299	61.8%	13.17%	20	20
14	南投縣信義鄉	2018-11-24T23:43:14+08:00	1554	4652	6206	494	6700	10903	61.45%	14.25%	18	20
14	南投縣信義鄉	2018-11-24T23:31:07+08:00	1554	4652	6206	494	6700	10903	61.45%	14.25%	18	20
14	南投縣信義鄉	2018-11-25T06:08:49+08:00	1752	5884	7636	583	8219	13299	61.8%	13.17%	20	20
14	南投縣信義鄉	2018-11-24T22:33:35+08:00	1063	4343	5406	442	5848	9407	62.17%	11.3%	16	20
14	南投縣信義鄉	2018-11-25T00:14:06+08:00	1645	5260	6905	557	7462	11923	62.58%	13.8%	19	20
14	南投縣信義鄉	2018-11-24T23:23:35+08:00	1554	4652	6206	494	6700	10903	61.45%	14.25%	18	20
14	南投縣信義鄉	2018-11-24T22:13:23+08:00	820	3045	3865	319	4184	7018	59.62%	11.68%	13	20
14	南投縣信義鄉	2018-11-25T01:17:48+08:00	1752	5884	7636	583	8219	13299	61.8%	13.17%	20	20
14	南投縣信義鄉	2018-11-24T23:55:44+08:00	1554	4652	6206	494	6700	10903	61.45%	14.25%	18	20
14	南投縣信義鄉	2018-11-25T00:00:06+08:00	1554	4652	6206	494	6700	10903	61.45%	14.25%	18	20
14	南投縣信義鄉	2018-11-24T23:08:32+08:00	1554	4652	6206	494	6700	10903	61.45%	14.25%	18	20
14	南投縣信義鄉	2018-11-24T23:19:47+08:00	1554	4652	6206	494	6700	10903	61.45%	14.25%	18	20
14	南投縣信義鄉	2018-11-25T03:44:19+08:00	1752	5884	7636	583	8219	13299	61.8%	13.17%	20	20
14	南投縣信義鄉	2018-11-25T01:02:27+08:00	1752	5884	7636	583	8219	13299	61.8%	13.17%	20	20
14	南投縣信義鄉	2018-11-24T22:40:25+08:00	1063	4343	5406	442	5848	9407	62.17%	11.3%	16	20
14	南投縣信義鄉	2018-11-24T22:30:03+08:00	891	3335	4226	347	4573	7578	60.35%	11.76%	14	20
14	南投縣信義鄉	2018-11-25T01:25:49+08:00	1752	5884	7636	583	8219	13299	61.8%	13.17%	20	20
14	南投縣信義鄉	2018-11-25T06:18:54+08:00	1752	5884	7636	583	8219	13299	61.8%	13.17%	20	20
14	南投縣信義鄉	2018-11-24T23:51:32+08:00	1554	4652	6206	494	6700	10903	61.45%	14.25%	18	20
14	南投縣信義鄉	2018-11-25T03:56:08+08:00	1752	5884	7636	583	8219	13299	61.8%	13.17%	20	20
14	南投縣信義鄉	2018-11-25T00:05:02+08:00	1554	4652	6206	494	6700	10903	61.45%	14.25%	18	20
14	南投縣信義鄉	2018-11-24T22:41:32+08:00	1063	4343	5406	442	5848	9407	62.17%	11.3%	16	20
14	南投縣信義鄉	2018-11-25T00:09:31+08:00	1645	5260	6905	557	7462	11923	62.58%	13.8%	19	20
14	南投縣信義鄉	2018-11-24T22:54:23+08:00	1131	4553	5684	469	6153	9924	62%	11.4%	17	20
14	南投縣信義鄉	2018-11-24T22:45:05+08:00	1063	4343	5406	442	5848	9407	62.17%	11.3%	16	20
14	南投縣信義鄉	2018-11-24T23:05:02+08:00	1554	4652	6206	494	6700	10903	61.45%	14.25%	18	20
14	南投縣信義鄉	2018-11-25T00:18:27+08:00	1645	5260	6905	557	7462	11923	62.58%	13.8%	19	20
14	南投縣埔里鎮	2018-11-25T01:12:39+08:00	9897	27617	37514	2304	39818	68763	57.91%	14.39%	68	68
14	南投縣埔里鎮	2018-11-24T22:16:06+08:00	8796	24322	33118	2004	35122	60324	58.22%	14.58%	61	68
14	南投縣埔里鎮	2018-11-25T04:02:45+08:00	9897	27617	37514	2304	39818	68763	57.91%	14.39%	68	68
14	南投縣埔里鎮	2018-11-24T22:23:09+08:00	9040	25332	34372	2127	36499	62839	58.08%	14.39%	63	68
14	南投縣埔里鎮	2018-11-25T03:32:31+08:00	9897	27617	37514	2304	39818	68763	57.91%	14.39%	68	68
14	南投縣埔里鎮	2018-11-25T00:00:04+08:00	9546	26665	36211	2209	38420	66157	58.07%	14.43%	66	68
14	南投縣埔里鎮	2018-11-25T03:38:52+08:00	9897	27617	37514	2304	39818	68763	57.91%	14.39%	68	68
14	南投縣埔里鎮	2018-11-25T00:23:00+08:00	9897	27617	37514	2304	39818	68763	57.91%	14.39%	68	68
14	南投縣埔里鎮	2018-11-24T22:36:57+08:00	9209	25787	34996	2149	37145	64122	57.93%	14.36%	64	68
14	南投縣埔里鎮	2018-11-25T00:57:33+08:00	9897	27617	37514	2304	39818	68763	57.91%	14.39%	68	68
14	南投縣埔里鎮	2018-11-24T23:51:31+08:00	9546	26665	36211	2209	38420	66157	58.07%	14.43%	66	68
14	南投縣埔里鎮	2018-11-24T23:27:15+08:00	9546	26665	36211	2209	38420	66157	58.07%	14.43%	66	68
14	南投縣埔里鎮	2018-11-24T22:19:33+08:00	8928	24981	33909	2057	35966	61795	58.2%	14.45%	62	68
14	南投縣埔里鎮	2018-11-24T22:50:44+08:00	9370	26230	35600	2173	37773	65228	57.91%	14.36%	65	68
14	南投縣埔里鎮	2018-11-24T23:12:12+08:00	9546	26665	36211	2209	38420	66157	58.07%	14.43%	66	68
14	南投縣埔里鎮	2018-11-25T06:13:49+08:00	9897	27617	37514	2304	39818	68763	57.91%	14.39%	68	68
14	南投縣埔里鎮	2018-11-24T22:26:33+08:00	9209	25787	34996	2149	37145	64122	57.93%	14.36%	64	68
14	南投縣埔里鎮	2018-11-24T22:41:31+08:00	9209	25787	34996	2149	37145	64122	57.93%	14.36%	64	68
14	南投縣埔里鎮	2018-11-25T00:05:01+08:00	9546	26665	36211	2209	38420	66157	58.07%	14.43%	66	68
14	南投縣埔里鎮	2018-11-25T06:23:57+08:00	9897	27617	37514	2304	39818	68763	57.91%	14.39%	68	68
14	南投縣埔里鎮	2018-11-25T03:49:48+08:00	9897	27617	37514	2304	39818	68763	57.91%	14.39%	68	68
14	南投縣埔里鎮	2018-11-24T23:05:01+08:00	9546	26665	36211	2209	38420	66157	58.07%	14.43%	66	68
14	南投縣埔里鎮	2018-11-24T23:47:25+08:00	9546	26665	36211	2209	38420	66157	58.07%	14.43%	66	68
14	南投縣埔里鎮	2018-11-25T06:29:13+08:00	9897	27617	37514	2304	39818	68763	57.91%	14.39%	68	68
14	南投縣埔里鎮	2018-11-24T23:35:07+08:00	9546	26665	36211	2209	38420	66157	58.07%	14.43%	66	68
14	南投縣埔里鎮	2018-11-24T22:33:34+08:00	9209	25787	34996	2149	37145	64122	57.93%	14.36%	64	68
14	南投縣埔里鎮	2018-11-25T01:07:23+08:00	9897	27617	37514	2304	39818	68763	57.91%	14.39%	68	68
14	南投縣埔里鎮	2018-11-24T23:43:14+08:00	9546	26665	36211	2209	38420	66157	58.07%	14.43%	66	68
14	南投縣埔里鎮	2018-11-24T23:01:27+08:00	9546	26665	36211	2209	38420	66157	58.07%	14.43%	66	68
14	南投縣埔里鎮	2018-11-24T23:31:07+08:00	9546	26665	36211	2209	38420	66157	58.07%	14.43%	66	68
14	南投縣埔里鎮	2018-11-25T06:08:49+08:00	9897	27617	37514	2304	39818	68763	57.91%	14.39%	68	68
14	南投縣埔里鎮	2018-11-25T00:14:06+08:00	9725	27182	36907	2239	39146	67439	58.05%	14.42%	67	68
14	南投縣埔里鎮	2018-11-24T23:23:35+08:00	9546	26665	36211	2209	38420	66157	58.07%	14.43%	66	68
14	南投縣埔里鎮	2018-11-24T23:19:46+08:00	9546	26665	36211	2209	38420	66157	58.07%	14.43%	66	68
14	南投縣埔里鎮	2018-11-24T22:13:23+08:00	8796	24322	33118	2004	35122	60324	58.22%	14.58%	61	68
14	南投縣埔里鎮	2018-11-25T01:17:48+08:00	9897	27617	37514	2304	39818	68763	57.91%	14.39%	68	68
14	南投縣埔里鎮	2018-11-24T23:55:43+08:00	9546	26665	36211	2209	38420	66157	58.07%	14.43%	66	68
14	南投縣埔里鎮	2018-11-24T23:08:32+08:00	9546	26665	36211	2209	38420	66157	58.07%	14.43%	66	68
14	南投縣埔里鎮	2018-11-24T22:57:49+08:00	9546	26665	36211	2209	38420	66157	58.07%	14.43%	66	68
14	南投縣埔里鎮	2018-11-25T03:44:19+08:00	9897	27617	37514	2304	39818	68763	57.91%	14.39%	68	68
14	南投縣埔里鎮	2018-11-24T22:30:02+08:00	9209	25787	34996	2149	37145	64122	57.93%	14.36%	64	68
14	南投縣埔里鎮	2018-11-25T01:02:27+08:00	9897	27617	37514	2304	39818	68763	57.91%	14.39%	68	68
14	南投縣埔里鎮	2018-11-24T22:40:24+08:00	9209	25787	34996	2149	37145	64122	57.93%	14.36%	64	68
14	南投縣埔里鎮	2018-11-25T01:25:49+08:00	9897	27617	37514	2304	39818	68763	57.91%	14.39%	68	68
14	南投縣埔里鎮	2018-11-24T23:15:59+08:00	9546	26665	36211	2209	38420	66157	58.07%	14.43%	66	68
14	南投縣埔里鎮	2018-11-25T06:18:54+08:00	9897	27617	37514	2304	39818	68763	57.91%	14.39%	68	68
14	南投縣埔里鎮	2018-11-25T03:56:08+08:00	9897	27617	37514	2304	39818	68763	57.91%	14.39%	68	68
14	南投縣埔里鎮	2018-11-24T22:45:05+08:00	9370	26230	35600	2173	37773	65228	57.91%	14.36%	65	68
14	南投縣埔里鎮	2018-11-25T00:18:26+08:00	9897	27617	37514	2304	39818	68763	57.91%	14.39%	68	68
14	南投縣埔里鎮	2018-11-24T23:39:11+08:00	9546	26665	36211	2209	38420	66157	58.07%	14.43%	66	68
14	南投縣埔里鎮	2018-11-25T00:09:30+08:00	9725	27182	36907	2239	39146	67439	58.05%	14.42%	67	68
14	南投縣埔里鎮	2018-11-24T22:54:22+08:00	9370	26230	35600	2173	37773	65228	57.91%	14.36%	65	68
14	苗栗縣造橋鄉	2018-11-25T04:02:44+08:00	1613	4303	5916	503	6419	11027	58.21%	14.63%	12	12
14	苗栗縣造橋鄉	2018-11-25T00:09:29+08:00	1613	4303	5916	503	6419	11027	58.21%	14.63%	12	12
14	苗栗縣造橋鄉	2018-11-24T22:16:06+08:00	1613	4303	5916	503	6419	11027	58.21%	14.63%	12	12
14	苗栗縣造橋鄉	2018-11-25T01:12:38+08:00	1613	4303	5916	503	6419	11027	58.21%	14.63%	12	12
14	苗栗縣造橋鄉	2018-11-25T00:14:05+08:00	1613	4303	5916	503	6419	11027	58.21%	14.63%	12	12
14	苗栗縣造橋鄉	2018-11-25T00:00:03+08:00	1613	4303	5916	503	6419	11027	58.21%	14.63%	12	12
14	苗栗縣造橋鄉	2018-11-24T22:23:08+08:00	1613	4303	5916	503	6419	11027	58.21%	14.63%	12	12
14	苗栗縣造橋鄉	2018-11-24T23:08:31+08:00	1613	4303	5916	503	6419	11027	58.21%	14.63%	12	12
14	苗栗縣造橋鄉	2018-11-25T03:32:30+08:00	1613	4303	5916	503	6419	11027	58.21%	14.63%	12	12
14	苗栗縣造橋鄉	2018-11-24T22:30:01+08:00	1613	4303	5916	503	6419	11027	58.21%	14.63%	12	12
14	苗栗縣造橋鄉	2018-11-24T23:27:14+08:00	1613	4303	5916	503	6419	11027	58.21%	14.63%	12	12
14	苗栗縣造橋鄉	2018-11-24T23:51:31+08:00	1613	4303	5916	503	6419	11027	58.21%	14.63%	12	12
14	苗栗縣造橋鄉	2018-11-24T22:19:33+08:00	1613	4303	5916	503	6419	11027	58.21%	14.63%	12	12
14	苗栗縣造橋鄉	2018-11-25T00:57:32+08:00	1613	4303	5916	503	6419	11027	58.21%	14.63%	12	12
14	苗栗縣造橋鄉	2018-11-24T22:36:56+08:00	1613	4303	5916	503	6419	11027	58.21%	14.63%	12	12
14	苗栗縣造橋鄉	2018-11-24T22:50:43+08:00	1613	4303	5916	503	6419	11027	58.21%	14.63%	12	12
14	苗栗縣造橋鄉	2018-11-25T00:18:25+08:00	1613	4303	5916	503	6419	11027	58.21%	14.63%	12	12
14	苗栗縣造橋鄉	2018-11-25T06:23:56+08:00	1613	4303	5916	503	6419	11027	58.21%	14.63%	12	12
14	苗栗縣造橋鄉	2018-11-24T22:26:33+08:00	1613	4303	5916	503	6419	11027	58.21%	14.63%	12	12
14	苗栗縣造橋鄉	2018-11-25T03:49:47+08:00	1613	4303	5916	503	6419	11027	58.21%	14.63%	12	12
14	苗栗縣造橋鄉	2018-11-24T22:41:31+08:00	1613	4303	5916	503	6419	11027	58.21%	14.63%	12	12
14	苗栗縣造橋鄉	2018-11-25T00:05:01+08:00	1613	4303	5916	503	6419	11027	58.21%	14.63%	12	12
14	苗栗縣造橋鄉	2018-11-25T06:13:48+08:00	1613	4303	5916	503	6419	11027	58.21%	14.63%	12	12
14	苗栗縣造橋鄉	2018-11-25T00:22:59+08:00	1613	4303	5916	503	6419	11027	58.21%	14.63%	12	12
14	苗栗縣造橋鄉	2018-11-24T23:05:01+08:00	1613	4303	5916	503	6419	11027	58.21%	14.63%	12	12
14	苗栗縣造橋鄉	2018-11-24T23:31:06+08:00	1613	4303	5916	503	6419	11027	58.21%	14.63%	12	12
14	苗栗縣造橋鄉	2018-11-25T06:08:48+08:00	1613	4303	5916	503	6419	11027	58.21%	14.63%	12	12
14	苗栗縣造橋鄉	2018-11-25T01:07:22+08:00	1613	4303	5916	503	6419	11027	58.21%	14.63%	12	12
14	苗栗縣造橋鄉	2018-11-24T22:33:33+08:00	1613	4303	5916	503	6419	11027	58.21%	14.63%	12	12
14	苗栗縣造橋鄉	2018-11-24T23:43:13+08:00	1613	4303	5916	503	6419	11027	58.21%	14.63%	12	12
14	苗栗縣造橋鄉	2018-11-24T23:01:27+08:00	1613	4303	5916	503	6419	11027	58.21%	14.63%	12	12
14	苗栗縣造橋鄉	2018-11-24T23:35:06+08:00	1613	4303	5916	503	6419	11027	58.21%	14.63%	12	12
14	苗栗縣造橋鄉	2018-11-25T06:29:12+08:00	1613	4303	5916	503	6419	11027	58.21%	14.63%	12	12
14	苗栗縣造橋鄉	2018-11-24T23:47:24+08:00	1613	4303	5916	503	6419	11027	58.21%	14.63%	12	12
14	苗栗縣造橋鄉	2018-11-24T23:55:42+08:00	1613	4303	5916	503	6419	11027	58.21%	14.63%	12	12
14	苗栗縣造橋鄉	2018-11-24T23:19:46+08:00	1613	4303	5916	503	6419	11027	58.21%	14.63%	12	12
14	苗栗縣造橋鄉	2018-11-24T22:57:48+08:00	1613	4303	5916	503	6419	11027	58.21%	14.63%	12	12
14	苗栗縣造橋鄉	2018-11-25T03:44:18+08:00	1613	4303	5916	503	6419	11027	58.21%	14.63%	12	12
14	苗栗縣造橋鄉	2018-11-24T23:23:34+08:00	1613	4303	5916	503	6419	11027	58.21%	14.63%	12	12
14	苗栗縣造橋鄉	2018-11-25T03:38:51+08:00	1613	4303	5916	503	6419	11027	58.21%	14.63%	12	12
14	苗栗縣造橋鄉	2018-11-24T22:13:22+08:00	1613	4303	5916	503	6419	11027	58.21%	14.63%	12	12
14	苗栗縣造橋鄉	2018-11-25T01:17:47+08:00	1613	4303	5916	503	6419	11027	58.21%	14.63%	12	12
14	苗栗縣造橋鄉	2018-11-25T01:25:48+08:00	1613	4303	5916	503	6419	11027	58.21%	14.63%	12	12
14	苗栗縣造橋鄉	2018-11-24T22:40:24+08:00	1613	4303	5916	503	6419	11027	58.21%	14.63%	12	12
14	苗栗縣造橋鄉	2018-11-25T01:02:26+08:00	1613	4303	5916	503	6419	11027	58.21%	14.63%	12	12
14	苗栗縣造橋鄉	2018-11-24T23:15:59+08:00	1613	4303	5916	503	6419	11027	58.21%	14.63%	12	12
14	苗栗縣造橋鄉	2018-11-25T06:18:53+08:00	1613	4303	5916	503	6419	11027	58.21%	14.63%	12	12
14	苗栗縣造橋鄉	2018-11-24T23:12:11+08:00	1613	4303	5916	503	6419	11027	58.21%	14.63%	12	12
14	苗栗縣造橋鄉	2018-11-24T23:39:10+08:00	1613	4303	5916	503	6419	11027	58.21%	14.63%	12	12
14	苗栗縣造橋鄉	2018-11-25T03:56:07+08:00	1613	4303	5916	503	6419	11027	58.21%	14.63%	12	12
14	苗栗縣造橋鄉	2018-11-24T22:45:04+08:00	1613	4303	5916	503	6419	11027	58.21%	14.63%	12	12
14	苗栗縣造橋鄉	2018-11-24T22:54:22+08:00	1613	4303	5916	503	6419	11027	58.21%	14.63%	12	12
14	苗栗縣頭份市	2018-11-25T04:02:44+08:00	12822	32287	45109	2293	47402	83617	56.69%	15.33%	71	71
14	苗栗縣頭份市	2018-11-24T23:31:05+08:00	12212	30808	43020	2194	45214	79874	56.61%	15.29%	68	71
14	苗栗縣頭份市	2018-11-25T00:09:29+08:00	12822	32287	45109	2293	47402	83617	56.69%	15.33%	71	71
14	苗栗縣頭份市	2018-11-25T01:12:38+08:00	12822	32287	45109	2293	47402	83617	56.69%	15.33%	71	71
14	苗栗縣頭份市	2018-11-25T00:14:05+08:00	12822	32287	45109	2293	47402	83617	56.69%	15.33%	71	71
14	苗栗縣頭份市	2018-11-24T23:19:45+08:00	12022	30293	42315	2164	44479	78688	56.53%	15.28%	67	71
14	苗栗縣頭份市	2018-11-25T00:00:03+08:00	12822	32287	45109	2293	47402	83617	56.69%	15.33%	71	71
14	苗栗縣頭份市	2018-11-24T22:23:08+08:00	8218	20930	29148	1500	30648	54197	56.55%	15.16%	48	71
14	苗栗縣頭份市	2018-11-24T23:08:31+08:00	10926	27691	38617	1986	40603	71650	56.67%	15.25%	62	71
14	苗栗縣頭份市	2018-11-25T03:32:30+08:00	12822	32287	45109	2293	47402	83617	56.69%	15.33%	71	71
14	苗栗縣頭份市	2018-11-24T23:51:30+08:00	12640	31838	44478	2262	46740	82476	56.67%	15.33%	70	71
14	苗栗縣頭份市	2018-11-24T22:30:01+08:00	8751	22203	30954	1572	32526	57510	56.56%	15.22%	51	71
14	苗栗縣頭份市	2018-11-24T23:27:14+08:00	12212	30808	43020	2194	45214	79874	56.61%	15.29%	68	71
14	苗栗縣頭份市	2018-11-24T22:19:32+08:00	7872	20027	27899	1428	29327	51919	56.49%	15.16%	46	71
14	苗栗縣頭份市	2018-11-25T00:57:32+08:00	12822	32287	45109	2293	47402	83617	56.69%	15.33%	71	71
14	苗栗縣頭份市	2018-11-24T22:36:56+08:00	8912	22647	31559	1623	33182	58639	56.59%	15.2%	52	71
14	苗栗縣頭份市	2018-11-24T22:50:43+08:00	9949	25274	35223	1829	37052	65544	56.53%	15.18%	57	71
14	苗栗縣頭份市	2018-11-25T00:18:25+08:00	12822	32287	45109	2293	47402	83617	56.69%	15.33%	71	71
14	苗栗縣頭份市	2018-11-25T06:23:56+08:00	12822	32287	45109	2293	47402	83617	56.69%	15.33%	71	71
14	苗栗縣頭份市	2018-11-24T23:05:00+08:00	10764	27331	38095	1951	40046	70702	56.64%	15.22%	61	71
14	苗栗縣頭份市	2018-11-25T03:49:47+08:00	12822	32287	45109	2293	47402	83617	56.69%	15.33%	71	71
14	苗栗縣頭份市	2018-11-24T22:41:31+08:00	9152	23150	32302	1648	33950	59965	56.62%	15.26%	53	71
14	苗栗縣頭份市	2018-11-24T22:26:32+08:00	8537	21731	30268	1549	31817	56224	56.59%	15.18%	50	71
14	苗栗縣頭份市	2018-11-25T06:13:48+08:00	12822	32287	45109	2293	47402	83617	56.69%	15.33%	71	71
14	苗栗縣頭份市	2018-11-24T22:54:21+08:00	10115	25691	35806	1846	37652	66560	56.57%	15.2%	58	71
14	苗栗縣頭份市	2018-11-25T00:05:00+08:00	12822	32287	45109	2293	47402	83617	56.69%	15.33%	71	71
14	苗栗縣頭份市	2018-11-25T00:22:59+08:00	12822	32287	45109	2293	47402	83617	56.69%	15.33%	71	71
14	苗栗縣頭份市	2018-11-24T22:16:05+08:00	7635	19540	27175	1407	28582	50676	56.4%	15.07%	45	71
14	苗栗縣頭份市	2018-11-24T23:01:26+08:00	10764	27331	38095	1951	40046	70702	56.64%	15.22%	61	71
14	苗栗縣頭份市	2018-11-25T01:07:22+08:00	12822	32287	45109	2293	47402	83617	56.69%	15.33%	71	71
14	苗栗縣頭份市	2018-11-24T22:33:33+08:00	8912	22647	31559	1623	33182	58639	56.59%	15.2%	52	71
14	苗栗縣頭份市	2018-11-24T23:43:13+08:00	12640	31838	44478	2262	46740	82476	56.67%	15.33%	70	71
14	苗栗縣頭份市	2018-11-25T06:08:47+08:00	12822	32287	45109	2293	47402	83617	56.69%	15.33%	71	71
14	苗栗縣頭份市	2018-11-24T23:35:06+08:00	12418	31323	43741	2228	45969	81138	56.66%	15.3%	69	71
14	苗栗縣頭份市	2018-11-24T23:47:23+08:00	12640	31838	44478	2262	46740	82476	56.67%	15.33%	70	71
14	苗栗縣頭份市	2018-11-25T06:29:12+08:00	12822	32287	45109	2293	47402	83617	56.69%	15.33%	71	71
14	苗栗縣頭份市	2018-11-24T23:55:42+08:00	12822	32287	45109	2293	47402	83617	56.69%	15.33%	71	71
14	苗栗縣頭份市	2018-11-25T01:17:46+08:00	12822	32287	45109	2293	47402	83617	56.69%	15.33%	71	71
14	苗栗縣頭份市	2018-11-24T22:57:48+08:00	10536	26791	37327	1917	39244	69432	56.52%	15.17%	60	71
14	苗栗縣頭份市	2018-11-25T03:38:50+08:00	12822	32287	45109	2293	47402	83617	56.69%	15.33%	71	71
14	苗栗縣頭份市	2018-11-24T23:23:34+08:00	12022	30293	42315	2164	44479	78688	56.53%	15.28%	67	71
14	苗栗縣頭份市	2018-11-24T22:13:22+08:00	6967	17906	24873	1266	26139	46524	56.18%	14.98%	42	71
14	苗栗縣頭份市	2018-11-25T03:44:17+08:00	12822	32287	45109	2293	47402	83617	56.69%	15.33%	71	71
14	苗栗縣頭份市	2018-11-25T01:25:48+08:00	12822	32287	45109	2293	47402	83617	56.69%	15.33%	71	71
14	苗栗縣頭份市	2018-11-24T22:40:23+08:00	9152	23150	32302	1648	33950	59965	56.62%	15.26%	53	71
14	苗栗縣頭份市	2018-11-24T23:15:58+08:00	11547	29070	40617	2088	42705	75439	56.61%	15.31%	65	71
14	苗栗縣頭份市	2018-11-25T01:02:26+08:00	12822	32287	45109	2293	47402	83617	56.69%	15.33%	71	71
14	苗栗縣頭份市	2018-11-25T06:18:53+08:00	12822	32287	45109	2293	47402	83617	56.69%	15.33%	71	71
14	苗栗縣頭份市	2018-11-24T23:12:11+08:00	11266	28439	39705	2053	41758	73680	56.67%	15.29%	64	71
14	苗栗縣頭份市	2018-11-24T23:39:10+08:00	12418	31323	43741	2228	45969	81138	56.66%	15.3%	69	71
14	苗栗縣頭份市	2018-11-25T03:56:07+08:00	12822	32287	45109	2293	47402	83617	56.69%	15.33%	71	71
14	苗栗縣頭份市	2018-11-24T22:45:04+08:00	9560	24228	33788	1720	35508	62908	56.44%	15.2%	55	71
14	高雄市新興區	2018-11-25T06:29:10+08:00	9020	16882	25902	1319	27221	44355	61.37%	20.34%	42	42
14	高雄市新興區	2018-11-24T23:35:04+08:00	9020	16882	25902	1319	27221	44355	61.37%	20.34%	42	42
14	高雄市新興區	2018-11-25T00:14:03+08:00	9020	16882	25902	1319	27221	44355	61.37%	20.34%	42	42
14	高雄市新興區	2018-11-24T23:12:09+08:00	8738	16397	25135	1291	26426	43038	61.4%	20.3%	41	42
14	高雄市新興區	2018-11-25T06:08:45+08:00	9020	16882	25902	1319	27221	44355	61.37%	20.34%	42	42
14	高雄市新興區	2018-11-24T23:43:11+08:00	9020	16882	25902	1319	27221	44355	61.37%	20.34%	42	42
14	高雄市新興區	2018-11-25T00:09:27+08:00	9020	16882	25902	1319	27221	44355	61.37%	20.34%	42	42
14	高雄市新興區	2018-11-24T22:33:31+08:00	8299	15564	23863	1231	25094	40888	61.37%	20.3%	39	42
14	高雄市新興區	2018-11-25T01:12:36+08:00	9020	16882	25902	1319	27221	44355	61.37%	20.34%	42	42
14	高雄市新興區	2018-11-25T04:02:42+08:00	9020	16882	25902	1319	27221	44355	61.37%	20.34%	42	42
14	高雄市新興區	2018-11-25T01:07:20+08:00	9020	16882	25902	1319	27221	44355	61.37%	20.34%	42	42
14	高雄市新興區	2018-11-24T23:39:07+08:00	9020	16882	25902	1319	27221	44355	61.37%	20.34%	42	42
14	高雄市新興區	2018-11-24T23:31:03+08:00	9020	16882	25902	1319	27221	44355	61.37%	20.34%	42	42
14	高雄市新興區	2018-11-24T23:01:24+08:00	8522	16007	24529	1255	25784	41989	61.41%	20.3%	40	42
14	高雄市新興區	2018-11-25T03:44:15+08:00	9020	16882	25902	1319	27221	44355	61.37%	20.34%	42	42
14	高雄市新興區	2018-11-24T23:19:42+08:00	8738	16397	25135	1291	26426	43038	61.4%	20.3%	41	42
14	高雄市新興區	2018-11-24T22:13:20+08:00	7290	13746	21036	1073	22109	35862	61.65%	20.33%	35	42
14	高雄市新興區	2018-11-25T00:04:58+08:00	9020	16882	25902	1319	27221	44355	61.37%	20.34%	42	42
14	高雄市新興區	2018-11-24T23:55:41+08:00	9020	16882	25902	1319	27221	44355	61.37%	20.34%	42	42
14	高雄市新興區	2018-11-24T22:23:06+08:00	8082	15143	23225	1204	24429	39653	61.61%	20.38%	38	42
14	高雄市新興區	2018-11-25T01:17:44+08:00	9020	16882	25902	1319	27221	44355	61.37%	20.34%	42	42
14	高雄市新興區	2018-11-24T23:04:58+08:00	8522	16007	24529	1255	25784	41989	61.41%	20.3%	40	42
14	高雄市新興區	2018-11-25T06:18:51+08:00	9020	16882	25902	1319	27221	44355	61.37%	20.34%	42	42
14	高雄市新興區	2018-11-25T01:02:24+08:00	9020	16882	25902	1319	27221	44355	61.37%	20.34%	42	42
14	高雄市新興區	2018-11-25T03:38:49+08:00	9020	16882	25902	1319	27221	44355	61.37%	20.34%	42	42
14	高雄市新興區	2018-11-24T23:27:12+08:00	9020	16882	25902	1319	27221	44355	61.37%	20.34%	42	42
14	高雄市新興區	2018-11-24T22:54:20+08:00	8522	16007	24529	1255	25784	41989	61.41%	20.3%	40	42
14	高雄市新興區	2018-11-25T03:56:05+08:00	9020	16882	25902	1319	27221	44355	61.37%	20.34%	42	42
14	高雄市新興區	2018-11-25T00:18:23+08:00	9020	16882	25902	1319	27221	44355	61.37%	20.34%	42	42
14	高雄市新興區	2018-11-25T06:13:46+08:00	9020	16882	25902	1319	27221	44355	61.37%	20.34%	42	42
14	高雄市新興區	2018-11-25T00:22:57+08:00	9020	16882	25902	1319	27221	44355	61.37%	20.34%	42	42
14	高雄市新興區	2018-11-24T23:47:22+08:00	9020	16882	25902	1319	27221	44355	61.37%	20.34%	42	42
14	高雄市新興區	2018-11-24T22:41:29+08:00	8522	16007	24529	1255	25784	41989	61.41%	20.3%	40	42
14	高雄市新興區	2018-11-24T22:16:03+08:00	7290	13746	21036	1073	22109	35862	61.65%	20.33%	35	42
14	高雄市新興區	2018-11-24T22:29:59+08:00	8082	15143	23225	1204	24429	39653	61.61%	20.38%	38	42
14	高雄市新興區	2018-11-24T23:23:32+08:00	8738	16397	25135	1291	26426	43038	61.4%	20.3%	41	42
14	高雄市新興區	2018-11-24T23:51:28+08:00	9020	16882	25902	1319	27221	44355	61.37%	20.34%	42	42
14	高雄市新興區	2018-11-24T22:57:46+08:00	8522	16007	24529	1255	25784	41989	61.41%	20.3%	40	42
14	高雄市新興區	2018-11-25T00:00:01+08:00	9020	16882	25902	1319	27221	44355	61.37%	20.34%	42	42
14	高雄市新興區	2018-11-25T01:25:46+08:00	9020	16882	25902	1319	27221	44355	61.37%	20.34%	42	42
14	高雄市新興區	2018-11-24T22:19:31+08:00	7759	14536	22295	1166	23461	38044	61.67%	20.39%	37	42
14	高雄市新興區	2018-11-25T00:57:30+08:00	9020	16882	25902	1319	27221	44355	61.37%	20.34%	42	42
14	高雄市新興區	2018-11-24T22:40:22+08:00	8522	16007	24529	1255	25784	41989	61.41%	20.3%	40	42
14	高雄市新興區	2018-11-24T22:36:55+08:00	8299	15564	23863	1231	25094	40888	61.37%	20.3%	39	42
14	高雄市新興區	2018-11-24T23:08:29+08:00	8522	16007	24529	1255	25784	41989	61.41%	20.3%	40	42
14	高雄市新興區	2018-11-24T23:15:57+08:00	8738	16397	25135	1291	26426	43038	61.4%	20.3%	41	42
14	高雄市新興區	2018-11-25T03:32:28+08:00	9020	16882	25902	1319	27221	44355	61.37%	20.34%	42	42
14	高雄市新興區	2018-11-24T22:45:02+08:00	8522	16007	24529	1255	25784	41989	61.41%	20.3%	40	42
14	高雄市新興區	2018-11-25T03:49:45+08:00	9020	16882	25902	1319	27221	44355	61.37%	20.34%	42	42
14	高雄市新興區	2018-11-25T06:23:54+08:00	9020	16882	25902	1319	27221	44355	61.37%	20.34%	42	42
14	高雄市新興區	2018-11-24T22:26:31+08:00	8082	15143	23225	1204	24429	39653	61.61%	20.38%	38	42
14	高雄市新興區	2018-11-24T22:50:41+08:00	8522	16007	24529	1255	25784	41989	61.41%	20.3%	40	42
14	高雄市大社區	2018-11-25T06:29:10+08:00	5495	10662	16157	1062	17219	30046	57.31%	18.29%	24	24
14	高雄市大社區	2018-11-25T00:14:03+08:00	5316	10313	15629	1017	16646	28930	57.54%	18.38%	23	24
14	高雄市大社區	2018-11-24T23:01:25+08:00	5059	9760	14819	986	15805	27074	58.38%	18.69%	22	24
14	高雄市大社區	2018-11-24T23:12:09+08:00	5059	9760	14819	986	15805	27074	58.38%	18.69%	22	24
14	高雄市大社區	2018-11-24T23:43:11+08:00	5316	10313	15629	1017	16646	28930	57.54%	18.38%	23	24
14	高雄市大社區	2018-11-24T23:39:08+08:00	5316	10313	15629	1017	16646	28930	57.54%	18.38%	23	24
14	高雄市大社區	2018-11-25T00:09:27+08:00	5316	10313	15629	1017	16646	28930	57.54%	18.38%	23	24
14	高雄市大社區	2018-11-25T01:12:36+08:00	5316	10313	15629	1017	16646	28930	57.54%	18.38%	23	24
14	高雄市大社區	2018-11-25T04:02:42+08:00	5495	10662	16157	1062	17219	30046	57.31%	18.29%	24	24
14	高雄市大社區	2018-11-24T23:35:05+08:00	5316	10313	15629	1017	16646	28930	57.54%	18.38%	23	24
14	高雄市大社區	2018-11-25T01:07:20+08:00	5316	10313	15629	1017	16646	28930	57.54%	18.38%	23	24
14	高雄市大社區	2018-11-24T23:31:04+08:00	5316	10313	15629	1017	16646	28930	57.54%	18.38%	23	24
14	高雄市大社區	2018-11-25T01:17:45+08:00	5316	10313	15629	1017	16646	28930	57.54%	18.38%	23	24
14	高雄市大社區	2018-11-25T03:44:15+08:00	5495	10662	16157	1062	17219	30046	57.31%	18.29%	24	24
14	高雄市大社區	2018-11-24T22:13:20+08:00	5059	9760	14819	986	15805	27074	58.38%	18.69%	22	24
14	高雄市大社區	2018-11-24T23:55:41+08:00	5316	10313	15629	1017	16646	28930	57.54%	18.38%	23	24
14	高雄市大社區	2018-11-24T22:23:06+08:00	5059	9760	14819	986	15805	27074	58.38%	18.69%	22	24
14	高雄市大社區	2018-11-24T23:19:43+08:00	5316	10313	15629	1017	16646	28930	57.54%	18.38%	23	24
14	高雄市大社區	2018-11-24T23:04:58+08:00	5059	9760	14819	986	15805	27074	58.38%	18.69%	22	24
14	高雄市大社區	2018-11-25T00:00:02+08:00	5316	10313	15629	1017	16646	28930	57.54%	18.38%	23	24
14	高雄市大社區	2018-11-25T00:04:59+08:00	5316	10313	15629	1017	16646	28930	57.54%	18.38%	23	24
14	高雄市大社區	2018-11-25T06:18:51+08:00	5495	10662	16157	1062	17219	30046	57.31%	18.29%	24	24
14	高雄市大社區	2018-11-25T01:02:24+08:00	5316	10313	15629	1017	16646	28930	57.54%	18.38%	23	24
14	高雄市大社區	2018-11-24T23:27:13+08:00	5316	10313	15629	1017	16646	28930	57.54%	18.38%	23	24
14	高雄市大社區	2018-11-25T03:38:49+08:00	5495	10662	16157	1062	17219	30046	57.31%	18.29%	24	24
14	高雄市大社區	2018-11-24T22:30:00+08:00	5059	9760	14819	986	15805	27074	58.38%	18.69%	22	24
14	高雄市大社區	2018-11-25T06:13:47+08:00	5495	10662	16157	1062	17219	30046	57.31%	18.29%	24	24
14	高雄市大社區	2018-11-24T22:54:20+08:00	5059	9760	14819	986	15805	27074	58.38%	18.69%	22	24
14	高雄市大社區	2018-11-25T00:22:58+08:00	5316	10313	15629	1017	16646	28930	57.54%	18.38%	23	24
14	高雄市大社區	2018-11-25T03:56:05+08:00	5495	10662	16157	1062	17219	30046	57.31%	18.29%	24	24
14	高雄市大社區	2018-11-25T00:18:24+08:00	5316	10313	15629	1017	16646	28930	57.54%	18.38%	23	24
14	高雄市大社區	2018-11-25T06:08:46+08:00	5495	10662	16157	1062	17219	30046	57.31%	18.29%	24	24
14	高雄市大社區	2018-11-24T23:47:22+08:00	5316	10313	15629	1017	16646	28930	57.54%	18.38%	23	24
14	高雄市大社區	2018-11-24T22:41:29+08:00	5059	9760	14819	986	15805	27074	58.38%	18.69%	22	24
14	高雄市大社區	2018-11-24T22:16:04+08:00	5059	9760	14819	986	15805	27074	58.38%	18.69%	22	24
14	高雄市大社區	2018-11-24T22:33:32+08:00	5059	9760	14819	986	15805	27074	58.38%	18.69%	22	24
14	高雄市大社區	2018-11-24T23:51:28+08:00	5316	10313	15629	1017	16646	28930	57.54%	18.38%	23	24
14	高雄市大社區	2018-11-24T23:23:33+08:00	5316	10313	15629	1017	16646	28930	57.54%	18.38%	23	24
14	高雄市大社區	2018-11-24T22:57:47+08:00	5059	9760	14819	986	15805	27074	58.38%	18.69%	22	24
14	高雄市大社區	2018-11-24T22:19:31+08:00	5059	9760	14819	986	15805	27074	58.38%	18.69%	22	24
14	高雄市大社區	2018-11-25T00:57:30+08:00	5316	10313	15629	1017	16646	28930	57.54%	18.38%	23	24
14	高雄市大社區	2018-11-25T03:32:29+08:00	5495	10662	16157	1062	17219	30046	57.31%	18.29%	24	24
14	高雄市大社區	2018-11-24T22:40:22+08:00	5059	9760	14819	986	15805	27074	58.38%	18.69%	22	24
14	高雄市大社區	2018-11-25T01:25:47+08:00	5316	10313	15629	1017	16646	28930	57.54%	18.38%	23	24
14	高雄市大社區	2018-11-24T22:36:55+08:00	5059	9760	14819	986	15805	27074	58.38%	18.69%	22	24
14	高雄市大社區	2018-11-24T23:08:29+08:00	5059	9760	14819	986	15805	27074	58.38%	18.69%	22	24
14	高雄市大社區	2018-11-24T23:15:57+08:00	5059	9760	14819	986	15805	27074	58.38%	18.69%	22	24
14	高雄市大社區	2018-11-25T03:49:45+08:00	5495	10662	16157	1062	17219	30046	57.31%	18.29%	24	24
14	高雄市大社區	2018-11-25T06:23:54+08:00	5495	10662	16157	1062	17219	30046	57.31%	18.29%	24	24
14	高雄市大社區	2018-11-24T22:26:31+08:00	5059	9760	14819	986	15805	27074	58.38%	18.69%	22	24
14	高雄市大社區	2018-11-24T22:50:41+08:00	5059	9760	14819	986	15805	27074	58.38%	18.69%	22	24
14	高雄市大社區	2018-11-24T22:45:03+08:00	5059	9760	14819	986	15805	27074	58.38%	18.69%	22	24
14	澎湖縣七美鄉	2018-11-24T22:33:39+08:00	217	425	642	59	701	2203	31.82%	9.85%	5	6
14	澎湖縣七美鄉	2018-11-25T03:49:52+08:00	317	625	942	79	1021	3374	30.26%	9.4%	6	6
14	澎湖縣七美鄉	2018-11-24T23:43:18+08:00	317	625	942	79	1021	3374	30.26%	9.4%	6	6
14	澎湖縣七美鄉	2018-11-24T23:47:29+08:00	317	625	942	79	1021	3374	30.26%	9.4%	6	6
14	澎湖縣七美鄉	2018-11-25T06:29:18+08:00	317	625	942	79	1021	3374	30.26%	9.4%	6	6
14	澎湖縣七美鄉	2018-11-25T01:07:27+08:00	317	625	942	79	1021	3374	30.26%	9.4%	6	6
14	澎湖縣七美鄉	2018-11-25T06:13:53+08:00	317	625	942	79	1021	3374	30.26%	9.4%	6	6
14	澎湖縣七美鄉	2018-11-25T00:18:31+08:00	317	625	942	79	1021	3374	30.26%	9.4%	6	6
14	澎湖縣七美鄉	2018-11-25T03:44:24+08:00	317	625	942	79	1021	3374	30.26%	9.4%	6	6
14	澎湖縣七美鄉	2018-11-24T23:08:37+08:00	317	625	942	79	1021	3374	30.26%	9.4%	6	6
14	澎湖縣七美鄉	2018-11-25T03:32:36+08:00	317	625	942	79	1021	3374	30.26%	9.4%	6	6
14	澎湖縣七美鄉	2018-11-24T23:55:48+08:00	317	625	942	79	1021	3374	30.26%	9.4%	6	6
14	澎湖縣七美鄉	2018-11-24T22:13:28+08:00	217	425	642	59	701	2203	31.82%	9.85%	5	6
14	澎湖縣七美鄉	2018-11-24T23:23:39+08:00	317	625	942	79	1021	3374	30.26%	9.4%	6	6
14	澎湖縣七美鄉	2018-11-25T06:18:58+08:00	317	625	942	79	1021	3374	30.26%	9.4%	6	6
14	澎湖縣七美鄉	2018-11-24T22:40:29+08:00	317	625	942	79	1021	3374	30.26%	9.4%	6	6
14	澎湖縣七美鄉	2018-11-24T23:51:36+08:00	317	625	942	79	1021	3374	30.26%	9.4%	6	6
14	澎湖縣七美鄉	2018-11-24T22:23:14+08:00	217	425	642	59	701	2203	31.82%	9.85%	5	6
14	澎湖縣七美鄉	2018-11-25T00:09:35+08:00	317	625	942	79	1021	3374	30.26%	9.4%	6	6
14	澎湖縣七美鄉	2018-11-25T00:05:06+08:00	317	625	942	79	1021	3374	30.26%	9.4%	6	6
14	澎湖縣七美鄉	2018-11-24T22:41:36+08:00	317	625	942	79	1021	3374	30.26%	9.4%	6	6
14	澎湖縣七美鄉	2018-11-24T22:45:09+08:00	317	625	942	79	1021	3374	30.26%	9.4%	6	6
14	澎湖縣七美鄉	2018-11-24T22:16:12+08:00	217	425	642	59	701	2203	31.82%	9.85%	5	6
14	澎湖縣七美鄉	2018-11-24T22:54:26+08:00	317	625	942	79	1021	3374	30.26%	9.4%	6	6
14	澎湖縣七美鄉	2018-11-25T00:14:10+08:00	317	625	942	79	1021	3374	30.26%	9.4%	6	6
14	澎湖縣七美鄉	2018-11-25T03:56:14+08:00	317	625	942	79	1021	3374	30.26%	9.4%	6	6
14	澎湖縣七美鄉	2018-11-24T22:37:02+08:00	317	625	942	79	1021	3374	30.26%	9.4%	6	6
14	澎湖縣七美鄉	2018-11-24T23:16:04+08:00	317	625	942	79	1021	3374	30.26%	9.4%	6	6
14	澎湖縣七美鄉	2018-11-25T00:23:05+08:00	317	625	942	79	1021	3374	30.26%	9.4%	6	6
14	澎湖縣七美鄉	2018-11-25T01:25:53+08:00	317	625	942	79	1021	3374	30.26%	9.4%	6	6
14	澎湖縣七美鄉	2018-11-25T01:02:32+08:00	317	625	942	79	1021	3374	30.26%	9.4%	6	6
14	澎湖縣七美鄉	2018-11-24T22:30:10+08:00	217	425	642	59	701	2203	31.82%	9.85%	5	6
14	澎湖縣七美鄉	2018-11-25T06:24:01+08:00	317	625	942	79	1021	3374	30.26%	9.4%	6	6
14	澎湖縣七美鄉	2018-11-25T03:38:56+08:00	317	625	942	79	1021	3374	30.26%	9.4%	6	6
14	澎湖縣七美鄉	2018-11-24T23:27:19+08:00	317	625	942	79	1021	3374	30.26%	9.4%	6	6
14	澎湖縣七美鄉	2018-11-24T22:19:38+08:00	217	425	642	59	701	2203	31.82%	9.85%	5	6
14	澎湖縣七美鄉	2018-11-25T01:17:53+08:00	317	625	942	79	1021	3374	30.26%	9.4%	6	6
14	澎湖縣七美鄉	2018-11-25T00:00:12+08:00	317	625	942	79	1021	3374	30.26%	9.4%	6	6
14	澎湖縣七美鄉	2018-11-24T22:57:55+08:00	317	625	942	79	1021	3374	30.26%	9.4%	6	6
14	澎湖縣七美鄉	2018-11-24T23:19:52+08:00	317	625	942	79	1021	3374	30.26%	9.4%	6	6
14	澎湖縣七美鄉	2018-11-25T00:57:38+08:00	317	625	942	79	1021	3374	30.26%	9.4%	6	6
14	澎湖縣七美鄉	2018-11-24T23:35:12+08:00	317	625	942	79	1021	3374	30.26%	9.4%	6	6
14	澎湖縣七美鄉	2018-11-25T06:08:54+08:00	317	625	942	79	1021	3374	30.26%	9.4%	6	6
14	澎湖縣七美鄉	2018-11-24T23:39:17+08:00	317	625	942	79	1021	3374	30.26%	9.4%	6	6
14	澎湖縣七美鄉	2018-11-25T01:12:44+08:00	317	625	942	79	1021	3374	30.26%	9.4%	6	6
14	澎湖縣七美鄉	2018-11-24T22:50:49+08:00	317	625	942	79	1021	3374	30.26%	9.4%	6	6
14	澎湖縣七美鄉	2018-11-25T04:02:53+08:00	317	625	942	79	1021	3374	30.26%	9.4%	6	6
14	澎湖縣七美鄉	2018-11-24T23:05:05+08:00	317	625	942	79	1021	3374	30.26%	9.4%	6	6
14	澎湖縣七美鄉	2018-11-24T23:31:12+08:00	317	625	942	79	1021	3374	30.26%	9.4%	6	6
14	澎湖縣七美鄉	2018-11-24T23:01:32+08:00	317	625	942	79	1021	3374	30.26%	9.4%	6	6
14	澎湖縣七美鄉	2018-11-24T22:26:38+08:00	217	425	642	59	701	2203	31.82%	9.85%	5	6
14	澎湖縣七美鄉	2018-11-24T23:12:17+08:00	317	625	942	79	1021	3374	30.26%	9.4%	6	6
14	桃園市蘆竹區	2018-11-25T01:07:17+08:00	20705	41836	62541	3072	65613	129252	50.76%	16.02%	76	76
14	桃園市蘆竹區	2018-11-25T06:08:42+08:00	20705	41836	62541	3072	65613	129252	50.76%	16.02%	76	76
14	桃園市蘆竹區	2018-11-24T23:47:18+08:00	19256	38972	58228	2906	61134	119779	51.04%	16.08%	72	76
14	桃園市蘆竹區	2018-11-24T23:35:02+08:00	19256	38972	58228	2906	61134	119779	51.04%	16.08%	72	76
14	桃園市蘆竹區	2018-11-24T22:26:29+08:00	13694	28145	41839	2149	43988	85607	51.38%	16%	54	76
14	桃園市蘆竹區	2018-11-24T22:16:00+08:00	12714	25766	38480	1933	40413	77939	51.85%	16.31%	50	76
14	桃園市蘆竹區	2018-11-24T23:51:25+08:00	19937	40290	60227	2986	63213	124121	50.93%	16.06%	74	76
14	桃園市蘆竹區	2018-11-25T00:04:56+08:00	20705	41836	62541	3072	65613	129252	50.76%	16.02%	76	76
14	桃園市蘆竹區	2018-11-24T22:19:28+08:00	12936	26479	39415	1974	41389	79968	51.76%	16.18%	51	76
14	桃園市蘆竹區	2018-11-24T22:57:44+08:00	17099	34592	51691	2648	54339	106113	51.21%	16.11%	65	76
14	桃園市蘆竹區	2018-11-25T00:57:27+08:00	20705	41836	62541	3072	65613	129252	50.76%	16.02%	76	76
14	桃園市蘆竹區	2018-11-24T22:13:17+08:00	12198	24733	36931	1875	38806	75063	51.7%	16.25%	48	76
14	桃園市蘆竹區	2018-11-24T23:23:30+08:00	18598	37651	56249	2825	59074	115697	51.06%	16.07%	70	76
14	桃園市蘆竹區	2018-11-24T22:29:55+08:00	13999	28642	42641	2195	44836	87165	51.44%	16.06%	55	76
14	桃園市蘆竹區	2018-11-24T23:08:25+08:00	17624	35753	53377	2705	56082	109775	51.09%	16.05%	67	76
14	桃園市蘆竹區	2018-11-24T23:55:38+08:00	20272	40987	61259	3036	64295	126525	50.82%	16.02%	75	76
14	桃園市蘆竹區	2018-11-25T03:38:46+08:00	20705	41836	62541	3072	65613	129252	50.76%	16.02%	76	76
14	桃園市蘆竹區	2018-11-24T23:59:58+08:00	20705	41836	62541	3072	65613	129252	50.76%	16.02%	76	76
14	桃園市蘆竹區	2018-11-25T03:32:25+08:00	20705	41836	62541	3072	65613	129252	50.76%	16.02%	76	76
14	桃園市蘆竹區	2018-11-24T23:15:54+08:00	18037	36549	54586	2746	57332	112297	51.05%	16.06%	68	76
14	桃園市蘆竹區	2018-11-24T22:40:19+08:00	15488	31453	46941	2476	49417	96367	51.28%	16.07%	60	76
14	桃園市蘆竹區	2018-11-25T01:25:43+08:00	20705	41836	62541	3072	65613	129252	50.76%	16.02%	76	76
14	桃園市蘆竹區	2018-11-25T06:23:51+08:00	20705	41836	62541	3072	65613	129252	50.76%	16.02%	76	76
14	桃園市蘆竹區	2018-11-24T22:54:17+08:00	16824	34050	50874	2618	53492	104366	51.25%	16.12%	64	76
14	桃園市蘆竹區	2018-11-24T22:45:00+08:00	15488	31453	46941	2476	49417	96367	51.28%	16.07%	60	76
14	桃園市蘆竹區	2018-11-24T23:01:21+08:00	17423	35269	52692	2675	55367	108328	51.11%	16.08%	66	76
14	桃園市蘆竹區	2018-11-24T23:31:01+08:00	18918	38257	57175	2857	60032	117590	51.05%	16.09%	71	76
14	桃園市蘆竹區	2018-11-25T00:09:23+08:00	20705	41836	62541	3072	65613	129252	50.76%	16.02%	76	76
14	桃園市蘆竹區	2018-11-24T22:41:27+08:00	15488	31453	46941	2476	49417	96367	51.28%	16.07%	60	76
14	桃園市蘆竹區	2018-11-25T01:12:33+08:00	20705	41836	62541	3072	65613	129252	50.76%	16.02%	76	76
14	桃園市蘆竹區	2018-11-24T22:50:37+08:00	16196	32823	49019	2557	51576	100756	51.19%	16.07%	62	76
14	桃園市蘆竹區	2018-11-25T00:14:00+08:00	20705	41836	62541	3072	65613	129252	50.76%	16.02%	76	76
14	桃園市蘆竹區	2018-11-24T23:12:05+08:00	17624	35753	53377	2705	56082	109775	51.09%	16.05%	67	76
14	桃園市蘆竹區	2018-11-24T23:39:04+08:00	19256	38972	58228	2906	61134	119779	51.04%	16.08%	72	76
14	桃園市蘆竹區	2018-11-25T06:18:49+08:00	20705	41836	62541	3072	65613	129252	50.76%	16.02%	76	76
14	桃園市蘆竹區	2018-11-25T01:17:41+08:00	20705	41836	62541	3072	65613	129252	50.76%	16.02%	76	76
14	桃園市蘆竹區	2018-11-25T03:44:11+08:00	20705	41836	62541	3072	65613	129252	50.76%	16.02%	76	76
14	桃園市蘆竹區	2018-11-24T22:23:03+08:00	13180	27028	40208	2036	42244	81800	51.64%	16.11%	52	76
14	桃園市蘆竹區	2018-11-24T23:04:55+08:00	17624	35753	53377	2705	56082	109775	51.09%	16.05%	67	76
14	桃園市蘆竹區	2018-11-24T23:27:10+08:00	18598	37651	56249	2825	59074	115697	51.06%	16.07%	70	76
14	桃園市蘆竹區	2018-11-24T22:36:52+08:00	15218	30902	46120	2453	48573	94734	51.27%	16.06%	59	76
14	桃園市蘆竹區	2018-11-25T01:02:21+08:00	20705	41836	62541	3072	65613	129252	50.76%	16.02%	76	76
14	桃園市蘆竹區	2018-11-24T23:19:39+08:00	18357	37080	55437	2772	58209	114165	50.99%	16.08%	69	76
14	桃園市蘆竹區	2018-11-25T00:22:55+08:00	20705	41836	62541	3072	65613	129252	50.76%	16.02%	76	76
14	桃園市蘆竹區	2018-11-25T03:56:01+08:00	20705	41836	62541	3072	65613	129252	50.76%	16.02%	76	76
14	桃園市蘆竹區	2018-11-25T06:13:43+08:00	20705	41836	62541	3072	65613	129252	50.76%	16.02%	76	76
14	桃園市蘆竹區	2018-11-25T04:02:39+08:00	20705	41836	62541	3072	65613	129252	50.76%	16.02%	76	76
14	桃園市蘆竹區	2018-11-25T00:18:21+08:00	20705	41836	62541	3072	65613	129252	50.76%	16.02%	76	76
14	桃園市蘆竹區	2018-11-24T22:33:29+08:00	14647	29659	44306	2287	46593	90966	51.22%	16.1%	57	76
14	桃園市蘆竹區	2018-11-25T06:29:07+08:00	20705	41836	62541	3072	65613	129252	50.76%	16.02%	76	76
14	桃園市蘆竹區	2018-11-25T03:49:42+08:00	20705	41836	62541	3072	65613	129252	50.76%	16.02%	76	76
14	桃園市蘆竹區	2018-11-24T23:43:08+08:00	19256	38972	58228	2906	61134	119779	51.04%	16.08%	72	76
14	臺南市南區	2018-11-24T23:35:04+08:00	16865	33971	50836	3205	54041	104936	51.5%	16.07%	78	80
14	臺南市南區	2018-11-24T23:47:21+08:00	17165	34610	51775	3234	55009	106876	51.47%	16.06%	79	80
14	臺南市南區	2018-11-25T06:08:45+08:00	17491	35260	52751	3296	56047	108650	51.58%	16.1%	80	80
14	臺南市南區	2018-11-24T23:43:11+08:00	17165	34610	51775	3234	55009	106876	51.47%	16.06%	79	80
14	臺南市南區	2018-11-25T01:07:19+08:00	17491	35260	52751	3296	56047	108650	51.58%	16.1%	80	80
14	臺南市南區	2018-11-24T22:33:31+08:00	12248	24766	37014	2417	39431	76272	51.7%	16.06%	59	80
14	臺南市南區	2018-11-25T00:14:02+08:00	17491	35260	52751	3296	56047	108650	51.58%	16.1%	80	80
14	臺南市南區	2018-11-25T04:02:42+08:00	17491	35260	52751	3296	56047	108650	51.58%	16.1%	80	80
14	臺南市南區	2018-11-25T00:09:26+08:00	17491	35260	52751	3296	56047	108650	51.58%	16.1%	80	80
14	臺南市南區	2018-11-24T23:12:08+08:00	15285	30860	46145	2968	49113	95113	51.64%	16.07%	72	80
14	臺南市南區	2018-11-24T23:39:07+08:00	17165	34610	51775	3234	55009	106876	51.47%	16.06%	79	80
14	臺南市南區	2018-11-24T23:31:03+08:00	16320	32890	49210	3133	52343	101680	51.48%	16.05%	76	80
14	臺南市南區	2018-11-24T23:01:24+08:00	14810	29803	44613	2846	47459	91938	51.62%	16.11%	70	80
14	臺南市南區	2018-11-25T03:44:15+08:00	17491	35260	52751	3296	56047	108650	51.58%	16.1%	80	80
14	臺南市南區	2018-11-24T23:19:42+08:00	15816	31815	47631	3040	50671	98359	51.52%	16.08%	74	80
14	臺南市南區	2018-11-25T00:04:58+08:00	17165	34610	51775	3234	55009	106876	51.47%	16.06%	79	80
14	臺南市南區	2018-11-24T23:04:57+08:00	15079	30307	45386	2925	48311	93655	51.58%	16.1%	71	80
14	臺南市南區	2018-11-25T00:57:29+08:00	17491	35260	52751	3296	56047	108650	51.58%	16.1%	80	80
14	臺南市南區	2018-11-24T22:13:19+08:00	10042	20190	30232	2000	32232	61962	52.02%	16.21%	50	80
14	臺南市南區	2018-11-25T01:17:44+08:00	17491	35260	52751	3296	56047	108650	51.58%	16.1%	80	80
14	臺南市南區	2018-11-24T23:55:40+08:00	17165	34610	51775	3234	55009	106876	51.47%	16.06%	79	80
14	臺南市南區	2018-11-25T06:18:51+08:00	17491	35260	52751	3296	56047	108650	51.58%	16.1%	80	80
14	臺南市南區	2018-11-25T01:02:24+08:00	17491	35260	52751	3296	56047	108650	51.58%	16.1%	80	80
14	臺南市南區	2018-11-25T03:38:49+08:00	17491	35260	52751	3296	56047	108650	51.58%	16.1%	80	80
14	臺南市南區	2018-11-24T23:27:12+08:00	16120	32463	48583	3101	51684	100530	51.41%	16.04%	75	80
14	臺南市南區	2018-11-24T22:54:20+08:00	13899	28005	41904	2677	44581	86157	51.74%	16.13%	66	80
14	臺南市南區	2018-11-25T00:18:23+08:00	17491	35260	52751	3296	56047	108650	51.58%	16.1%	80	80
14	臺南市南區	2018-11-25T06:13:46+08:00	17491	35260	52751	3296	56047	108650	51.58%	16.1%	80	80
14	臺南市南區	2018-11-25T00:22:57+08:00	17491	35260	52751	3296	56047	108650	51.58%	16.1%	80	80
14	臺南市南區	2018-11-25T03:56:04+08:00	17491	35260	52751	3296	56047	108650	51.58%	16.1%	80	80
14	臺南市南區	2018-11-24T22:41:29+08:00	12914	26121	39035	2533	41568	80575	51.59%	16.03%	62	80
14	臺南市南區	2018-11-24T22:16:03+08:00	10488	21187	31675	2116	33791	64811	52.14%	16.18%	52	80
14	臺南市南區	2018-11-25T01:12:35+08:00	17491	35260	52751	3296	56047	108650	51.58%	16.1%	80	80
14	臺南市南區	2018-11-24T22:29:59+08:00	11253	22725	33978	2213	36191	70185	51.57%	16.03%	55	80
14	臺南市南區	2018-11-24T23:23:32+08:00	15816	31815	47631	3040	50671	98359	51.52%	16.08%	74	80
14	臺南市南區	2018-11-24T23:51:28+08:00	17165	34610	51775	3234	55009	106876	51.47%	16.06%	79	80
14	臺南市南區	2018-11-24T22:57:46+08:00	14106	28417	42523	2728	45251	87420	51.76%	16.14%	67	80
14	臺南市南區	2018-11-25T00:00:01+08:00	17165	34610	51775	3234	55009	106876	51.47%	16.06%	79	80
14	臺南市南區	2018-11-24T22:23:05+08:00	10767	21719	32486	2143	34629	66867	51.79%	16.1%	53	80
14	臺南市南區	2018-11-24T22:36:54+08:00	12467	25240	37707	2452	40159	77758	51.65%	16.03%	60	80
14	臺南市南區	2018-11-25T01:25:46+08:00	17491	35260	52751	3296	56047	108650	51.58%	16.1%	80	80
14	臺南市南區	2018-11-24T23:15:56+08:00	15534	31305	46839	3012	49851	96578	51.62%	16.08%	73	80
14	臺南市南區	2018-11-24T23:08:28+08:00	15285	30860	46145	2968	49113	95113	51.64%	16.07%	72	80
14	臺南市南區	2018-11-24T22:40:22+08:00	12914	26121	39035	2533	41568	80575	51.59%	16.03%	62	80
14	臺南市南區	2018-11-24T22:19:30+08:00	10488	21187	31675	2116	33791	64811	52.14%	16.18%	52	80
14	臺南市南區	2018-11-25T03:32:28+08:00	17491	35260	52751	3296	56047	108650	51.58%	16.1%	80	80
14	臺南市南區	2018-11-24T22:45:02+08:00	13179	26572	39751	2564	42315	82145	51.51%	16.04%	63	80
14	臺南市南區	2018-11-24T22:50:40+08:00	13699	27616	41315	2651	43966	84953	51.75%	16.13%	65	80
14	臺南市南區	2018-11-25T03:49:45+08:00	17491	35260	52751	3296	56047	108650	51.58%	16.1%	80	80
14	臺南市南區	2018-11-25T06:29:09+08:00	17491	35260	52751	3296	56047	108650	51.58%	16.1%	80	80
14	臺南市南區	2018-11-25T06:23:53+08:00	17491	35260	52751	3296	56047	108650	51.58%	16.1%	80	80
14	臺南市南區	2018-11-24T22:26:31+08:00	10985	22133	33118	2181	35299	68200	51.76%	16.11%	54	80
14	屏東縣新園鄉	2018-11-24T23:43:16+08:00	4401	10267	14668	1535	16203	30706	52.77%	14.33%	28	28
14	屏東縣新園鄉	2018-11-24T22:33:36+08:00	4401	10267	14668	1535	16203	30706	52.77%	14.33%	28	28
14	屏東縣新園鄉	2018-11-25T03:56:11+08:00	4401	10267	14668	1535	16203	30706	52.77%	14.33%	28	28
14	屏東縣新園鄉	2018-11-25T06:29:16+08:00	4401	10267	14668	1535	16203	30706	52.77%	14.33%	28	28
14	屏東縣新園鄉	2018-11-24T23:47:27+08:00	4401	10267	14668	1535	16203	30706	52.77%	14.33%	28	28
14	屏東縣新園鄉	2018-11-24T22:16:09+08:00	4401	10267	14668	1535	16203	30706	52.77%	14.33%	28	28
14	屏東縣新園鄉	2018-11-25T03:38:54+08:00	4401	10267	14668	1535	16203	30706	52.77%	14.33%	28	28
14	屏東縣新園鄉	2018-11-24T23:55:46+08:00	4401	10267	14668	1535	16203	30706	52.77%	14.33%	28	28
14	屏東縣新園鄉	2018-11-25T01:25:51+08:00	4401	10267	14668	1535	16203	30706	52.77%	14.33%	28	28
14	屏東縣新園鄉	2018-11-24T23:23:37+08:00	4401	10267	14668	1535	16203	30706	52.77%	14.33%	28	28
14	屏東縣新園鄉	2018-11-25T06:18:56+08:00	4401	10267	14668	1535	16203	30706	52.77%	14.33%	28	28
14	屏東縣新園鄉	2018-11-24T22:23:12+08:00	4401	10267	14668	1535	16203	30706	52.77%	14.33%	28	28
14	屏東縣新園鄉	2018-11-24T22:40:27+08:00	4401	10267	14668	1535	16203	30706	52.77%	14.33%	28	28
14	屏東縣新園鄉	2018-11-24T22:36:59+08:00	4401	10267	14668	1535	16203	30706	52.77%	14.33%	28	28
14	屏東縣新園鄉	2018-11-25T00:00:10+08:00	4401	10267	14668	1535	16203	30706	52.77%	14.33%	28	28
14	屏東縣新園鄉	2018-11-25T00:57:35+08:00	4401	10267	14668	1535	16203	30706	52.77%	14.33%	28	28
14	屏東縣新園鄉	2018-11-25T01:17:51+08:00	4401	10267	14668	1535	16203	30706	52.77%	14.33%	28	28
14	屏東縣新園鄉	2018-11-24T22:30:07+08:00	4401	10267	14668	1535	16203	30706	52.77%	14.33%	28	28
14	屏東縣新園鄉	2018-11-24T23:31:10+08:00	4401	10267	14668	1535	16203	30706	52.77%	14.33%	28	28
14	屏東縣新園鄉	2018-11-24T23:39:14+08:00	4401	10267	14668	1535	16203	30706	52.77%	14.33%	28	28
14	屏東縣新園鄉	2018-11-24T23:01:30+08:00	4401	10267	14668	1535	16203	30706	52.77%	14.33%	28	28
14	屏東縣新園鄉	2018-11-25T04:02:51+08:00	4401	10267	14668	1535	16203	30706	52.77%	14.33%	28	28
14	屏東縣新園鄉	2018-11-24T23:12:14+08:00	4401	10267	14668	1535	16203	30706	52.77%	14.33%	28	28
14	屏東縣新園鄉	2018-11-25T06:23:59+08:00	4401	10267	14668	1535	16203	30706	52.77%	14.33%	28	28
14	屏東縣新園鄉	2018-11-25T00:09:33+08:00	4401	10267	14668	1535	16203	30706	52.77%	14.33%	28	28
14	屏東縣新園鄉	2018-11-24T22:45:07+08:00	4401	10267	14668	1535	16203	30706	52.77%	14.33%	28	28
14	屏東縣新園鄉	2018-11-25T06:08:51+08:00	4401	10267	14668	1535	16203	30706	52.77%	14.33%	28	28
14	屏東縣新園鄉	2018-11-25T01:07:25+08:00	4401	10267	14668	1535	16203	30706	52.77%	14.33%	28	28
14	屏東縣新園鄉	2018-11-25T06:13:51+08:00	4401	10267	14668	1535	16203	30706	52.77%	14.33%	28	28
14	屏東縣新園鄉	2018-11-24T23:16:02+08:00	4401	10267	14668	1535	16203	30706	52.77%	14.33%	28	28
14	屏東縣新園鄉	2018-11-24T23:35:09+08:00	4401	10267	14668	1535	16203	30706	52.77%	14.33%	28	28
14	屏東縣新園鄉	2018-11-25T03:49:50+08:00	4401	10267	14668	1535	16203	30706	52.77%	14.33%	28	28
14	屏東縣新園鄉	2018-11-25T00:14:08+08:00	4401	10267	14668	1535	16203	30706	52.77%	14.33%	28	28
14	屏東縣新園鄉	2018-11-25T00:23:02+08:00	4401	10267	14668	1535	16203	30706	52.77%	14.33%	28	28
14	屏東縣新園鄉	2018-11-24T23:08:35+08:00	4401	10267	14668	1535	16203	30706	52.77%	14.33%	28	28
14	屏東縣新園鄉	2018-11-25T03:32:33+08:00	4401	10267	14668	1535	16203	30706	52.77%	14.33%	28	28
14	屏東縣新園鄉	2018-11-25T03:44:21+08:00	4401	10267	14668	1535	16203	30706	52.77%	14.33%	28	28
14	屏東縣新園鄉	2018-11-24T22:13:25+08:00	4401	10267	14668	1535	16203	30706	52.77%	14.33%	28	28
14	屏東縣新園鄉	2018-11-24T23:19:49+08:00	4401	10267	14668	1535	16203	30706	52.77%	14.33%	28	28
14	屏東縣新園鄉	2018-11-24T23:27:17+08:00	4401	10267	14668	1535	16203	30706	52.77%	14.33%	28	28
14	屏東縣新園鄉	2018-11-24T22:19:36+08:00	4401	10267	14668	1535	16203	30706	52.77%	14.33%	28	28
14	屏東縣新園鄉	2018-11-25T01:02:29+08:00	4401	10267	14668	1535	16203	30706	52.77%	14.33%	28	28
14	屏東縣新園鄉	2018-11-24T23:51:34+08:00	4401	10267	14668	1535	16203	30706	52.77%	14.33%	28	28
14	屏東縣新園鄉	2018-11-24T22:57:52+08:00	4401	10267	14668	1535	16203	30706	52.77%	14.33%	28	28
14	屏東縣新園鄉	2018-11-24T23:05:03+08:00	4401	10267	14668	1535	16203	30706	52.77%	14.33%	28	28
14	屏東縣新園鄉	2018-11-24T22:50:47+08:00	4401	10267	14668	1535	16203	30706	52.77%	14.33%	28	28
14	屏東縣新園鄉	2018-11-25T00:05:04+08:00	4401	10267	14668	1535	16203	30706	52.77%	14.33%	28	28
14	屏東縣新園鄉	2018-11-24T22:41:34+08:00	4401	10267	14668	1535	16203	30706	52.77%	14.33%	28	28
14	屏東縣新園鄉	2018-11-25T01:12:42+08:00	4401	10267	14668	1535	16203	30706	52.77%	14.33%	28	28
14	屏東縣新園鄉	2018-11-24T22:26:36+08:00	4401	10267	14668	1535	16203	30706	52.77%	14.33%	28	28
14	屏東縣新園鄉	2018-11-25T00:18:29+08:00	4401	10267	14668	1535	16203	30706	52.77%	14.33%	28	28
14	屏東縣新園鄉	2018-11-24T22:54:25+08:00	4401	10267	14668	1535	16203	30706	52.77%	14.33%	28	28
14	臺南市玉井區	2018-11-24T23:35:04+08:00	1543	4001	5544	469	6013	12357	48.66%	12.49%	16	16
14	臺南市玉井區	2018-11-24T23:47:21+08:00	1543	4001	5544	469	6013	12357	48.66%	12.49%	16	16
14	臺南市玉井區	2018-11-24T23:39:06+08:00	1543	4001	5544	469	6013	12357	48.66%	12.49%	16	16
14	臺南市玉井區	2018-11-25T01:07:19+08:00	1543	4001	5544	469	6013	12357	48.66%	12.49%	16	16
14	臺南市玉井區	2018-11-24T22:33:31+08:00	1543	4001	5544	469	6013	12357	48.66%	12.49%	16	16
14	臺南市玉井區	2018-11-25T00:14:02+08:00	1543	4001	5544	469	6013	12357	48.66%	12.49%	16	16
14	臺南市玉井區	2018-11-24T23:43:10+08:00	1543	4001	5544	469	6013	12357	48.66%	12.49%	16	16
14	臺南市玉井區	2018-11-25T06:08:44+08:00	1543	4001	5544	469	6013	12357	48.66%	12.49%	16	16
14	臺南市玉井區	2018-11-25T00:09:26+08:00	1543	4001	5544	469	6013	12357	48.66%	12.49%	16	16
14	臺南市玉井區	2018-11-24T23:12:08+08:00	1543	4001	5544	469	6013	12357	48.66%	12.49%	16	16
14	臺南市玉井區	2018-11-24T23:31:03+08:00	1543	4001	5544	469	6013	12357	48.66%	12.49%	16	16
14	臺南市玉井區	2018-11-24T23:01:24+08:00	1543	4001	5544	469	6013	12357	48.66%	12.49%	16	16
14	臺南市玉井區	2018-11-24T23:19:42+08:00	1543	4001	5544	469	6013	12357	48.66%	12.49%	16	16
14	臺南市玉井區	2018-11-25T00:04:58+08:00	1543	4001	5544	469	6013	12357	48.66%	12.49%	16	16
14	臺南市玉井區	2018-11-24T23:04:57+08:00	1543	4001	5544	469	6013	12357	48.66%	12.49%	16	16
14	臺南市玉井區	2018-11-25T00:57:29+08:00	1543	4001	5544	469	6013	12357	48.66%	12.49%	16	16
14	臺南市玉井區	2018-11-24T22:13:19+08:00	1543	4001	5544	469	6013	12357	48.66%	12.49%	16	16
14	臺南市玉井區	2018-11-25T03:44:14+08:00	1543	4001	5544	469	6013	12357	48.66%	12.49%	16	16
14	臺南市玉井區	2018-11-25T01:17:43+08:00	1543	4001	5544	469	6013	12357	48.66%	12.49%	16	16
14	臺南市玉井區	2018-11-24T23:55:40+08:00	1543	4001	5544	469	6013	12357	48.66%	12.49%	16	16
14	臺南市玉井區	2018-11-25T01:02:23+08:00	1543	4001	5544	469	6013	12357	48.66%	12.49%	16	16
14	臺南市玉井區	2018-11-25T01:25:45+08:00	1543	4001	5544	469	6013	12357	48.66%	12.49%	16	16
14	臺南市玉井區	2018-11-25T03:38:48+08:00	1543	4001	5544	469	6013	12357	48.66%	12.49%	16	16
14	臺南市玉井區	2018-11-25T06:18:50+08:00	1543	4001	5544	469	6013	12357	48.66%	12.49%	16	16
14	臺南市玉井區	2018-11-24T22:40:21+08:00	1543	4001	5544	469	6013	12357	48.66%	12.49%	16	16
14	臺南市玉井區	2018-11-24T23:27:12+08:00	1543	4001	5544	469	6013	12357	48.66%	12.49%	16	16
14	臺南市玉井區	2018-11-25T00:18:23+08:00	1543	4001	5544	469	6013	12357	48.66%	12.49%	16	16
14	臺南市玉井區	2018-11-24T22:54:19+08:00	1446	3775	5221	449	5670	11659	48.63%	12.4%	15	16
14	臺南市玉井區	2018-11-25T00:22:57+08:00	1543	4001	5544	469	6013	12357	48.66%	12.49%	16	16
14	臺南市玉井區	2018-11-25T03:56:04+08:00	1543	4001	5544	469	6013	12357	48.66%	12.49%	16	16
14	臺南市玉井區	2018-11-24T22:16:02+08:00	1543	4001	5544	469	6013	12357	48.66%	12.49%	16	16
14	臺南市玉井區	2018-11-24T22:41:28+08:00	1543	4001	5544	469	6013	12357	48.66%	12.49%	16	16
14	臺南市玉井區	2018-11-25T04:02:41+08:00	1543	4001	5544	469	6013	12357	48.66%	12.49%	16	16
14	臺南市玉井區	2018-11-25T01:12:35+08:00	1543	4001	5544	469	6013	12357	48.66%	12.49%	16	16
14	臺南市玉井區	2018-11-24T22:29:59+08:00	1543	4001	5544	469	6013	12357	48.66%	12.49%	16	16
14	臺南市玉井區	2018-11-24T23:23:32+08:00	1543	4001	5544	469	6013	12357	48.66%	12.49%	16	16
14	臺南市玉井區	2018-11-24T22:57:46+08:00	1446	3775	5221	449	5670	11659	48.63%	12.4%	15	16
14	臺南市玉井區	2018-11-25T00:00:01+08:00	1543	4001	5544	469	6013	12357	48.66%	12.49%	16	16
14	臺南市玉井區	2018-11-24T23:51:27+08:00	1543	4001	5544	469	6013	12357	48.66%	12.49%	16	16
14	臺南市玉井區	2018-11-24T22:23:05+08:00	1543	4001	5544	469	6013	12357	48.66%	12.49%	16	16
14	臺南市玉井區	2018-11-24T22:36:54+08:00	1543	4001	5544	469	6013	12357	48.66%	12.49%	16	16
14	臺南市玉井區	2018-11-24T23:15:56+08:00	1543	4001	5544	469	6013	12357	48.66%	12.49%	16	16
14	臺南市玉井區	2018-11-24T23:08:28+08:00	1543	4001	5544	469	6013	12357	48.66%	12.49%	16	16
14	臺南市玉井區	2018-11-25T03:32:27+08:00	1543	4001	5544	469	6013	12357	48.66%	12.49%	16	16
14	臺南市玉井區	2018-11-24T22:19:30+08:00	1543	4001	5544	469	6013	12357	48.66%	12.49%	16	16
14	臺南市玉井區	2018-11-25T03:49:44+08:00	1543	4001	5544	469	6013	12357	48.66%	12.49%	16	16
14	臺南市玉井區	2018-11-24T22:45:02+08:00	1446	3775	5221	449	5670	11659	48.63%	12.4%	15	16
14	臺南市玉井區	2018-11-24T22:50:40+08:00	1446	3775	5221	449	5670	11659	48.63%	12.4%	15	16
14	臺南市玉井區	2018-11-24T22:26:30+08:00	1543	4001	5544	469	6013	12357	48.66%	12.49%	16	16
14	臺南市玉井區	2018-11-25T06:29:09+08:00	1543	4001	5544	469	6013	12357	48.66%	12.49%	16	16
14	臺南市玉井區	2018-11-25T06:23:53+08:00	1543	4001	5544	469	6013	12357	48.66%	12.49%	16	16
14	臺南市玉井區	2018-11-25T06:13:45+08:00	1543	4001	5544	469	6013	12357	48.66%	12.49%	16	16
14	屏東縣麟洛鄉	2018-11-25T03:56:10+08:00	1695	3660	5355	371	5726	9970	57.43%	17%	10	10
14	屏東縣麟洛鄉	2018-11-24T23:16:01+08:00	1695	3660	5355	371	5726	9970	57.43%	17%	10	10
14	屏東縣麟洛鄉	2018-11-24T23:43:16+08:00	1695	3660	5355	371	5726	9970	57.43%	17%	10	10
14	屏東縣麟洛鄉	2018-11-24T22:33:36+08:00	1695	3660	5355	371	5726	9970	57.43%	17%	10	10
14	屏東縣麟洛鄉	2018-11-24T23:47:27+08:00	1695	3660	5355	371	5726	9970	57.43%	17%	10	10
14	屏東縣麟洛鄉	2018-11-24T22:16:09+08:00	1495	3062	4557	340	4897	8584	57.05%	17.42%	9	10
14	屏東縣麟洛鄉	2018-11-25T03:38:54+08:00	1695	3660	5355	371	5726	9970	57.43%	17%	10	10
14	屏東縣麟洛鄉	2018-11-25T01:25:51+08:00	1695	3660	5355	371	5726	9970	57.43%	17%	10	10
14	屏東縣麟洛鄉	2018-11-24T23:23:37+08:00	1695	3660	5355	371	5726	9970	57.43%	17%	10	10
14	屏東縣麟洛鄉	2018-11-25T06:18:56+08:00	1695	3660	5355	371	5726	9970	57.43%	17%	10	10
14	屏東縣麟洛鄉	2018-11-24T22:30:06+08:00	1695	3660	5355	371	5726	9970	57.43%	17%	10	10
14	屏東縣麟洛鄉	2018-11-24T22:19:35+08:00	1495	3062	4557	340	4897	8584	57.05%	17.42%	9	10
14	屏東縣麟洛鄉	2018-11-25T01:17:50+08:00	1695	3660	5355	371	5726	9970	57.43%	17%	10	10
14	屏東縣麟洛鄉	2018-11-24T22:36:59+08:00	1695	3660	5355	371	5726	9970	57.43%	17%	10	10
14	屏東縣麟洛鄉	2018-11-24T22:40:26+08:00	1695	3660	5355	371	5726	9970	57.43%	17%	10	10
14	屏東縣麟洛鄉	2018-11-25T00:57:35+08:00	1695	3660	5355	371	5726	9970	57.43%	17%	10	10
14	屏東縣麟洛鄉	2018-11-25T00:09:32+08:00	1695	3660	5355	371	5726	9970	57.43%	17%	10	10
14	屏東縣麟洛鄉	2018-11-24T23:39:14+08:00	1695	3660	5355	371	5726	9970	57.43%	17%	10	10
14	屏東縣麟洛鄉	2018-11-25T04:02:51+08:00	1695	3660	5355	371	5726	9970	57.43%	17%	10	10
14	屏東縣麟洛鄉	2018-11-24T22:26:35+08:00	1695	3660	5355	371	5726	9970	57.43%	17%	10	10
14	屏東縣麟洛鄉	2018-11-24T23:12:14+08:00	1695	3660	5355	371	5726	9970	57.43%	17%	10	10
14	屏東縣麟洛鄉	2018-11-25T06:23:59+08:00	1695	3660	5355	371	5726	9970	57.43%	17%	10	10
14	屏東縣麟洛鄉	2018-11-24T22:45:07+08:00	1695	3660	5355	371	5726	9970	57.43%	17%	10	10
14	屏東縣麟洛鄉	2018-11-25T06:08:51+08:00	1695	3660	5355	371	5726	9970	57.43%	17%	10	10
14	屏東縣麟洛鄉	2018-11-25T01:07:25+08:00	1695	3660	5355	371	5726	9970	57.43%	17%	10	10
14	屏東縣麟洛鄉	2018-11-25T06:13:51+08:00	1695	3660	5355	371	5726	9970	57.43%	17%	10	10
14	屏東縣麟洛鄉	2018-11-24T23:35:09+08:00	1695	3660	5355	371	5726	9970	57.43%	17%	10	10
14	屏東縣麟洛鄉	2018-11-24T23:01:29+08:00	1695	3660	5355	371	5726	9970	57.43%	17%	10	10
14	屏東縣麟洛鄉	2018-11-24T23:31:09+08:00	1695	3660	5355	371	5726	9970	57.43%	17%	10	10
14	屏東縣麟洛鄉	2018-11-25T03:49:50+08:00	1695	3660	5355	371	5726	9970	57.43%	17%	10	10
14	屏東縣麟洛鄉	2018-11-25T00:14:08+08:00	1695	3660	5355	371	5726	9970	57.43%	17%	10	10
14	屏東縣麟洛鄉	2018-11-25T06:29:15+08:00	1695	3660	5355	371	5726	9970	57.43%	17%	10	10
14	屏東縣麟洛鄉	2018-11-24T23:55:45+08:00	1695	3660	5355	371	5726	9970	57.43%	17%	10	10
14	屏東縣麟洛鄉	2018-11-24T23:08:34+08:00	1695	3660	5355	371	5726	9970	57.43%	17%	10	10
14	屏東縣麟洛鄉	2018-11-25T00:00:09+08:00	1695	3660	5355	371	5726	9970	57.43%	17%	10	10
14	屏東縣麟洛鄉	2018-11-25T00:23:02+08:00	1695	3660	5355	371	5726	9970	57.43%	17%	10	10
14	屏東縣麟洛鄉	2018-11-25T03:32:33+08:00	1695	3660	5355	371	5726	9970	57.43%	17%	10	10
14	屏東縣麟洛鄉	2018-11-25T03:44:21+08:00	1695	3660	5355	371	5726	9970	57.43%	17%	10	10
14	屏東縣麟洛鄉	2018-11-24T22:13:25+08:00	1495	3062	4557	340	4897	8584	57.05%	17.42%	9	10
14	屏東縣麟洛鄉	2018-11-24T23:19:49+08:00	1695	3660	5355	371	5726	9970	57.43%	17%	10	10
14	屏東縣麟洛鄉	2018-11-24T22:23:11+08:00	1695	3660	5355	371	5726	9970	57.43%	17%	10	10
14	屏東縣麟洛鄉	2018-11-24T23:27:17+08:00	1695	3660	5355	371	5726	9970	57.43%	17%	10	10
14	屏東縣麟洛鄉	2018-11-25T01:02:29+08:00	1695	3660	5355	371	5726	9970	57.43%	17%	10	10
14	屏東縣麟洛鄉	2018-11-24T23:51:33+08:00	1695	3660	5355	371	5726	9970	57.43%	17%	10	10
14	屏東縣麟洛鄉	2018-11-24T22:57:52+08:00	1695	3660	5355	371	5726	9970	57.43%	17%	10	10
14	屏東縣麟洛鄉	2018-11-24T23:05:03+08:00	1695	3660	5355	371	5726	9970	57.43%	17%	10	10
14	屏東縣麟洛鄉	2018-11-24T22:54:24+08:00	1695	3660	5355	371	5726	9970	57.43%	17%	10	10
14	屏東縣麟洛鄉	2018-11-25T00:18:28+08:00	1695	3660	5355	371	5726	9970	57.43%	17%	10	10
14	屏東縣麟洛鄉	2018-11-24T22:41:33+08:00	1695	3660	5355	371	5726	9970	57.43%	17%	10	10
14	屏東縣麟洛鄉	2018-11-25T00:05:03+08:00	1695	3660	5355	371	5726	9970	57.43%	17%	10	10
14	屏東縣麟洛鄉	2018-11-25T01:12:42+08:00	1695	3660	5355	371	5726	9970	57.43%	17%	10	10
14	屏東縣麟洛鄉	2018-11-24T22:50:46+08:00	1695	3660	5355	371	5726	9970	57.43%	17%	10	10
14	高雄市六龜區	2018-11-25T04:02:43+08:00	1414	3476	4890	591	5481	11501	47.66%	12.29%	12	12
14	高雄市六龜區	2018-11-25T01:12:37+08:00	1414	3476	4890	591	5481	11501	47.66%	12.29%	12	12
14	高雄市六龜區	2018-11-25T00:14:04+08:00	1414	3476	4890	591	5481	11501	47.66%	12.29%	12	12
14	高雄市六龜區	2018-11-25T01:07:21+08:00	1414	3476	4890	591	5481	11501	47.66%	12.29%	12	12
14	高雄市六龜區	2018-11-24T23:35:05+08:00	1287	3135	4422	549	4971	10498	47.35%	12.26%	11	12
14	高雄市六龜區	2018-11-25T06:29:11+08:00	1414	3476	4890	591	5481	11501	47.66%	12.29%	12	12
14	高雄市六龜區	2018-11-24T23:39:09+08:00	1414	3476	4890	591	5481	11501	47.66%	12.29%	12	12
14	高雄市六龜區	2018-11-24T23:31:04+08:00	1287	3135	4422	549	4971	10498	47.35%	12.26%	11	12
14	高雄市六龜區	2018-11-25T00:09:28+08:00	1414	3476	4890	591	5481	11501	47.66%	12.29%	12	12
14	高雄市六龜區	2018-11-25T01:17:45+08:00	1414	3476	4890	591	5481	11501	47.66%	12.29%	12	12
14	高雄市六龜區	2018-11-24T22:23:07+08:00	1287	3135	4422	549	4971	10498	47.35%	12.26%	11	12
14	高雄市六龜區	2018-11-24T23:55:41+08:00	1414	3476	4890	591	5481	11501	47.66%	12.29%	12	12
14	高雄市六龜區	2018-11-24T23:08:30+08:00	1287	3135	4422	549	4971	10498	47.35%	12.26%	11	12
14	高雄市六龜區	2018-11-24T23:19:44+08:00	1287	3135	4422	549	4971	10498	47.35%	12.26%	11	12
14	高雄市六龜區	2018-11-24T22:13:21+08:00	1155	2699	3854	450	4304	9116	47.21%	12.67%	10	12
14	高雄市六龜區	2018-11-24T23:04:58+08:00	1287	3135	4422	549	4971	10498	47.35%	12.26%	11	12
14	高雄市六龜區	2018-11-25T00:00:02+08:00	1414	3476	4890	591	5481	11501	47.66%	12.29%	12	12
14	高雄市六龜區	2018-11-25T00:04:59+08:00	1414	3476	4890	591	5481	11501	47.66%	12.29%	12	12
14	高雄市六龜區	2018-11-24T23:27:13+08:00	1287	3135	4422	549	4971	10498	47.35%	12.26%	11	12
14	高雄市六龜區	2018-11-24T22:19:32+08:00	1155	2699	3854	450	4304	9116	47.21%	12.67%	10	12
14	高雄市六龜區	2018-11-24T22:30:00+08:00	1287	3135	4422	549	4971	10498	47.35%	12.26%	11	12
14	高雄市六龜區	2018-11-25T01:02:25+08:00	1414	3476	4890	591	5481	11501	47.66%	12.29%	12	12
14	高雄市六龜區	2018-11-25T06:13:47+08:00	1414	3476	4890	591	5481	11501	47.66%	12.29%	12	12
14	高雄市六龜區	2018-11-25T00:22:58+08:00	1414	3476	4890	591	5481	11501	47.66%	12.29%	12	12
14	高雄市六龜區	2018-11-24T22:26:32+08:00	1287	3135	4422	549	4971	10498	47.35%	12.26%	11	12
14	高雄市六龜區	2018-11-25T00:18:24+08:00	1414	3476	4890	591	5481	11501	47.66%	12.29%	12	12
14	高雄市六龜區	2018-11-24T22:50:42+08:00	1287	3135	4422	549	4971	10498	47.35%	12.26%	11	12
14	高雄市六龜區	2018-11-24T22:54:21+08:00	1287	3135	4422	549	4971	10498	47.35%	12.26%	11	12
14	高雄市六龜區	2018-11-24T22:41:30+08:00	1287	3135	4422	549	4971	10498	47.35%	12.26%	11	12
14	高雄市六龜區	2018-11-25T03:49:46+08:00	1414	3476	4890	591	5481	11501	47.66%	12.29%	12	12
14	高雄市六龜區	2018-11-24T23:01:26+08:00	1287	3135	4422	549	4971	10498	47.35%	12.26%	11	12
14	高雄市六龜區	2018-11-25T06:08:46+08:00	1414	3476	4890	591	5481	11501	47.66%	12.29%	12	12
14	高雄市六龜區	2018-11-24T23:43:12+08:00	1414	3476	4890	591	5481	11501	47.66%	12.29%	12	12
14	高雄市六龜區	2018-11-24T23:47:22+08:00	1414	3476	4890	591	5481	11501	47.66%	12.29%	12	12
14	高雄市六龜區	2018-11-24T22:16:04+08:00	1155	2699	3854	450	4304	9116	47.21%	12.67%	10	12
14	高雄市六龜區	2018-11-24T22:33:32+08:00	1287	3135	4422	549	4971	10498	47.35%	12.26%	11	12
14	高雄市六龜區	2018-11-25T03:44:16+08:00	1414	3476	4890	591	5481	11501	47.66%	12.29%	12	12
14	高雄市六龜區	2018-11-25T03:38:50+08:00	1414	3476	4890	591	5481	11501	47.66%	12.29%	12	12
14	高雄市六龜區	2018-11-24T23:23:33+08:00	1287	3135	4422	549	4971	10498	47.35%	12.26%	11	12
14	高雄市六龜區	2018-11-24T23:51:29+08:00	1414	3476	4890	591	5481	11501	47.66%	12.29%	12	12
14	高雄市六龜區	2018-11-24T22:57:47+08:00	1287	3135	4422	549	4971	10498	47.35%	12.26%	11	12
14	高雄市六龜區	2018-11-24T22:40:23+08:00	1287	3135	4422	549	4971	10498	47.35%	12.26%	11	12
14	高雄市六龜區	2018-11-25T03:32:29+08:00	1414	3476	4890	591	5481	11501	47.66%	12.29%	12	12
14	高雄市六龜區	2018-11-25T06:18:52+08:00	1414	3476	4890	591	5481	11501	47.66%	12.29%	12	12
14	高雄市六龜區	2018-11-24T23:15:58+08:00	1287	3135	4422	549	4971	10498	47.35%	12.26%	11	12
14	高雄市六龜區	2018-11-25T00:57:31+08:00	1414	3476	4890	591	5481	11501	47.66%	12.29%	12	12
14	高雄市六龜區	2018-11-25T01:25:47+08:00	1414	3476	4890	591	5481	11501	47.66%	12.29%	12	12
14	高雄市六龜區	2018-11-24T22:36:55+08:00	1287	3135	4422	549	4971	10498	47.35%	12.26%	11	12
14	高雄市六龜區	2018-11-25T03:56:06+08:00	1414	3476	4890	591	5481	11501	47.66%	12.29%	12	12
14	高雄市六龜區	2018-11-25T06:23:55+08:00	1414	3476	4890	591	5481	11501	47.66%	12.29%	12	12
14	高雄市六龜區	2018-11-24T23:12:10+08:00	1287	3135	4422	549	4971	10498	47.35%	12.26%	11	12
14	高雄市六龜區	2018-11-24T22:45:03+08:00	1287	3135	4422	549	4971	10498	47.35%	12.26%	11	12
14	高雄市田寮區	2018-11-25T04:02:43+08:00	903	2007	2910	302	3212	6671	48.15%	13.54%	12	12
14	高雄市田寮區	2018-11-25T06:29:10+08:00	903	2007	2910	302	3212	6671	48.15%	13.54%	12	12
14	高雄市田寮區	2018-11-25T00:14:03+08:00	903	2007	2910	302	3212	6671	48.15%	13.54%	12	12
14	高雄市田寮區	2018-11-24T23:01:25+08:00	903	2007	2910	302	3212	6671	48.15%	13.54%	12	12
14	高雄市田寮區	2018-11-24T23:12:09+08:00	903	2007	2910	302	3212	6671	48.15%	13.54%	12	12
14	高雄市田寮區	2018-11-24T23:39:08+08:00	903	2007	2910	302	3212	6671	48.15%	13.54%	12	12
14	高雄市田寮區	2018-11-25T00:09:27+08:00	903	2007	2910	302	3212	6671	48.15%	13.54%	12	12
14	高雄市田寮區	2018-11-25T01:12:36+08:00	903	2007	2910	302	3212	6671	48.15%	13.54%	12	12
14	高雄市田寮區	2018-11-24T23:35:05+08:00	903	2007	2910	302	3212	6671	48.15%	13.54%	12	12
14	高雄市田寮區	2018-11-25T01:07:20+08:00	903	2007	2910	302	3212	6671	48.15%	13.54%	12	12
14	高雄市田寮區	2018-11-24T23:31:04+08:00	903	2007	2910	302	3212	6671	48.15%	13.54%	12	12
14	高雄市田寮區	2018-11-25T01:17:45+08:00	903	2007	2910	302	3212	6671	48.15%	13.54%	12	12
14	高雄市田寮區	2018-11-24T22:13:20+08:00	903	2007	2910	302	3212	6671	48.15%	13.54%	12	12
14	高雄市田寮區	2018-11-24T23:55:41+08:00	903	2007	2910	302	3212	6671	48.15%	13.54%	12	12
14	高雄市田寮區	2018-11-24T22:23:06+08:00	903	2007	2910	302	3212	6671	48.15%	13.54%	12	12
14	高雄市田寮區	2018-11-24T23:19:43+08:00	903	2007	2910	302	3212	6671	48.15%	13.54%	12	12
14	高雄市田寮區	2018-11-24T23:04:58+08:00	903	2007	2910	302	3212	6671	48.15%	13.54%	12	12
14	高雄市田寮區	2018-11-25T00:00:02+08:00	903	2007	2910	302	3212	6671	48.15%	13.54%	12	12
14	高雄市田寮區	2018-11-25T00:04:59+08:00	903	2007	2910	302	3212	6671	48.15%	13.54%	12	12
14	高雄市田寮區	2018-11-25T01:02:24+08:00	903	2007	2910	302	3212	6671	48.15%	13.54%	12	12
14	高雄市田寮區	2018-11-24T23:27:13+08:00	903	2007	2910	302	3212	6671	48.15%	13.54%	12	12
14	高雄市田寮區	2018-11-25T03:38:49+08:00	903	2007	2910	302	3212	6671	48.15%	13.54%	12	12
14	高雄市田寮區	2018-11-24T22:30:00+08:00	903	2007	2910	302	3212	6671	48.15%	13.54%	12	12
14	高雄市田寮區	2018-11-25T06:13:47+08:00	903	2007	2910	302	3212	6671	48.15%	13.54%	12	12
14	高雄市田寮區	2018-11-24T22:54:20+08:00	903	2007	2910	302	3212	6671	48.15%	13.54%	12	12
14	高雄市田寮區	2018-11-25T00:22:58+08:00	903	2007	2910	302	3212	6671	48.15%	13.54%	12	12
14	高雄市田寮區	2018-11-25T03:56:05+08:00	903	2007	2910	302	3212	6671	48.15%	13.54%	12	12
14	高雄市田寮區	2018-11-24T22:26:32+08:00	903	2007	2910	302	3212	6671	48.15%	13.54%	12	12
14	高雄市田寮區	2018-11-25T00:18:24+08:00	903	2007	2910	302	3212	6671	48.15%	13.54%	12	12
14	高雄市田寮區	2018-11-24T22:41:30+08:00	903	2007	2910	302	3212	6671	48.15%	13.54%	12	12
14	高雄市田寮區	2018-11-25T03:49:46+08:00	903	2007	2910	302	3212	6671	48.15%	13.54%	12	12
14	高雄市田寮區	2018-11-25T06:08:46+08:00	903	2007	2910	302	3212	6671	48.15%	13.54%	12	12
14	高雄市田寮區	2018-11-24T23:43:12+08:00	903	2007	2910	302	3212	6671	48.15%	13.54%	12	12
14	高雄市田寮區	2018-11-24T23:47:22+08:00	903	2007	2910	302	3212	6671	48.15%	13.54%	12	12
14	高雄市田寮區	2018-11-24T22:16:04+08:00	903	2007	2910	302	3212	6671	48.15%	13.54%	12	12
14	高雄市田寮區	2018-11-24T22:33:32+08:00	903	2007	2910	302	3212	6671	48.15%	13.54%	12	12
14	高雄市田寮區	2018-11-25T03:44:16+08:00	903	2007	2910	302	3212	6671	48.15%	13.54%	12	12
14	高雄市田寮區	2018-11-24T23:23:33+08:00	903	2007	2910	302	3212	6671	48.15%	13.54%	12	12
14	高雄市田寮區	2018-11-24T23:51:29+08:00	903	2007	2910	302	3212	6671	48.15%	13.54%	12	12
14	高雄市田寮區	2018-11-24T22:57:47+08:00	903	2007	2910	302	3212	6671	48.15%	13.54%	12	12
14	高雄市田寮區	2018-11-24T22:19:31+08:00	903	2007	2910	302	3212	6671	48.15%	13.54%	12	12
14	高雄市田寮區	2018-11-24T22:40:23+08:00	903	2007	2910	302	3212	6671	48.15%	13.54%	12	12
14	高雄市田寮區	2018-11-25T00:57:30+08:00	903	2007	2910	302	3212	6671	48.15%	13.54%	12	12
14	高雄市田寮區	2018-11-25T03:32:29+08:00	903	2007	2910	302	3212	6671	48.15%	13.54%	12	12
14	高雄市田寮區	2018-11-25T06:18:52+08:00	903	2007	2910	302	3212	6671	48.15%	13.54%	12	12
14	高雄市田寮區	2018-11-25T01:25:47+08:00	903	2007	2910	302	3212	6671	48.15%	13.54%	12	12
14	高雄市田寮區	2018-11-24T22:36:55+08:00	903	2007	2910	302	3212	6671	48.15%	13.54%	12	12
14	高雄市田寮區	2018-11-24T23:08:29+08:00	903	2007	2910	302	3212	6671	48.15%	13.54%	12	12
14	高雄市田寮區	2018-11-24T23:15:57+08:00	903	2007	2910	302	3212	6671	48.15%	13.54%	12	12
14	高雄市田寮區	2018-11-25T06:23:54+08:00	903	2007	2910	302	3212	6671	48.15%	13.54%	12	12
14	高雄市田寮區	2018-11-24T22:50:41+08:00	903	2007	2910	302	3212	6671	48.15%	13.54%	12	12
14	高雄市田寮區	2018-11-24T22:45:03+08:00	903	2007	2910	302	3212	6671	48.15%	13.54%	12	12
14	嘉義縣大埔鄉	2018-11-25T03:56:10+08:00	612	1454	2066	121	2187	3999	54.69%	15.3%	9	9
14	嘉義縣大埔鄉	2018-11-24T23:47:26+08:00	371	947	1318	60	1378	2531	54.44%	14.66%	8	9
14	嘉義縣大埔鄉	2018-11-24T23:16:01+08:00	371	947	1318	60	1378	2531	54.44%	14.66%	8	9
14	嘉義縣大埔鄉	2018-11-24T22:16:08+08:00	287	703	990	40	1030	1962	52.5%	14.63%	7	9
14	嘉義縣大埔鄉	2018-11-24T22:33:36+08:00	287	703	990	40	1030	1962	52.5%	14.63%	7	9
14	嘉義縣大埔鄉	2018-11-25T03:38:53+08:00	612	1454	2066	121	2187	3999	54.69%	15.3%	9	9
14	嘉義縣大埔鄉	2018-11-24T23:23:36+08:00	371	947	1318	60	1378	2531	54.44%	14.66%	8	9
14	嘉義縣大埔鄉	2018-11-25T01:25:51+08:00	371	947	1318	60	1378	2531	54.44%	14.66%	8	9
14	嘉義縣大埔鄉	2018-11-24T22:19:35+08:00	287	703	990	40	1030	1962	52.5%	14.63%	7	9
14	嘉義縣大埔鄉	2018-11-25T01:17:50+08:00	371	947	1318	60	1378	2531	54.44%	14.66%	8	9
14	嘉義縣大埔鄉	2018-11-24T22:36:59+08:00	287	703	990	40	1030	1962	52.5%	14.63%	7	9
14	嘉義縣大埔鄉	2018-11-24T22:40:26+08:00	287	703	990	40	1030	1962	52.5%	14.63%	7	9
14	嘉義縣大埔鄉	2018-11-25T00:57:35+08:00	371	947	1318	60	1378	2531	54.44%	14.66%	8	9
14	嘉義縣大埔鄉	2018-11-24T22:57:51+08:00	287	703	990	40	1030	1962	52.5%	14.63%	7	9
14	嘉義縣大埔鄉	2018-11-25T00:09:32+08:00	371	947	1318	60	1378	2531	54.44%	14.66%	8	9
14	嘉義縣大埔鄉	2018-11-25T06:23:58+08:00	612	1454	2066	121	2187	3999	54.69%	15.3%	9	9
14	嘉義縣大埔鄉	2018-11-24T23:39:13+08:00	371	947	1318	60	1378	2531	54.44%	14.66%	8	9
14	嘉義縣大埔鄉	2018-11-25T03:49:49+08:00	612	1454	2066	121	2187	3999	54.69%	15.3%	9	9
14	嘉義縣大埔鄉	2018-11-25T01:12:41+08:00	371	947	1318	60	1378	2531	54.44%	14.66%	8	9
14	嘉義縣大埔鄉	2018-11-24T22:26:35+08:00	287	703	990	40	1030	1962	52.5%	14.63%	7	9
14	嘉義縣大埔鄉	2018-11-24T23:12:14+08:00	371	947	1318	60	1378	2531	54.44%	14.66%	8	9
14	嘉義縣大埔鄉	2018-11-24T22:45:07+08:00	287	703	990	40	1030	1962	52.5%	14.63%	7	9
14	嘉義縣大埔鄉	2018-11-25T06:08:51+08:00	612	1454	2066	121	2187	3999	54.69%	15.3%	9	9
14	嘉義縣大埔鄉	2018-11-25T04:02:50+08:00	612	1454	2066	121	2187	3999	54.69%	15.3%	9	9
14	嘉義縣大埔鄉	2018-11-24T23:43:15+08:00	371	947	1318	60	1378	2531	54.44%	14.66%	8	9
14	嘉義縣大埔鄉	2018-11-25T00:14:07+08:00	371	947	1318	60	1378	2531	54.44%	14.66%	8	9
14	嘉義縣大埔鄉	2018-11-24T23:35:09+08:00	371	947	1318	60	1378	2531	54.44%	14.66%	8	9
14	嘉義縣大埔鄉	2018-11-24T23:01:29+08:00	371	947	1318	60	1378	2531	54.44%	14.66%	8	9
14	嘉義縣大埔鄉	2018-11-25T01:07:24+08:00	371	947	1318	60	1378	2531	54.44%	14.66%	8	9
14	嘉義縣大埔鄉	2018-11-24T23:31:09+08:00	371	947	1318	60	1378	2531	54.44%	14.66%	8	9
14	嘉義縣大埔鄉	2018-11-25T06:13:50+08:00	612	1454	2066	121	2187	3999	54.69%	15.3%	9	9
14	嘉義縣大埔鄉	2018-11-25T06:29:15+08:00	612	1454	2066	121	2187	3999	54.69%	15.3%	9	9
14	嘉義縣大埔鄉	2018-11-24T23:55:45+08:00	371	947	1318	60	1378	2531	54.44%	14.66%	8	9
14	嘉義縣大埔鄉	2018-11-24T23:08:34+08:00	371	947	1318	60	1378	2531	54.44%	14.66%	8	9
14	嘉義縣大埔鄉	2018-11-25T00:00:09+08:00	371	947	1318	60	1378	2531	54.44%	14.66%	8	9
14	嘉義縣大埔鄉	2018-11-25T00:23:02+08:00	371	947	1318	60	1378	2531	54.44%	14.66%	8	9
14	嘉義縣大埔鄉	2018-11-24T23:19:48+08:00	371	947	1318	60	1378	2531	54.44%	14.66%	8	9
14	嘉義縣大埔鄉	2018-11-25T03:32:33+08:00	612	1454	2066	121	2187	3999	54.69%	15.3%	9	9
14	嘉義縣大埔鄉	2018-11-25T03:44:21+08:00	612	1454	2066	121	2187	3999	54.69%	15.3%	9	9
14	嘉義縣大埔鄉	2018-11-24T22:13:25+08:00	287	703	990	40	1030	1962	52.5%	14.63%	7	9
14	嘉義縣大埔鄉	2018-11-24T22:23:11+08:00	287	703	990	40	1030	1962	52.5%	14.63%	7	9
14	嘉義縣大埔鄉	2018-11-24T22:30:05+08:00	287	703	990	40	1030	1962	52.5%	14.63%	7	9
14	嘉義縣大埔鄉	2018-11-24T23:27:17+08:00	371	947	1318	60	1378	2531	54.44%	14.66%	8	9
14	嘉義縣大埔鄉	2018-11-24T23:51:33+08:00	371	947	1318	60	1378	2531	54.44%	14.66%	8	9
14	嘉義縣大埔鄉	2018-11-25T06:18:55+08:00	612	1454	2066	121	2187	3999	54.69%	15.3%	9	9
14	嘉義縣大埔鄉	2018-11-25T01:02:28+08:00	371	947	1318	60	1378	2531	54.44%	14.66%	8	9
14	嘉義縣大埔鄉	2018-11-24T23:05:03+08:00	371	947	1318	60	1378	2531	54.44%	14.66%	8	9
14	嘉義縣大埔鄉	2018-11-24T22:54:24+08:00	287	703	990	40	1030	1962	52.5%	14.63%	7	9
14	嘉義縣大埔鄉	2018-11-25T00:18:28+08:00	371	947	1318	60	1378	2531	54.44%	14.66%	8	9
14	嘉義縣大埔鄉	2018-11-24T22:41:33+08:00	287	703	990	40	1030	1962	52.5%	14.63%	7	9
14	嘉義縣大埔鄉	2018-11-25T00:05:03+08:00	371	947	1318	60	1378	2531	54.44%	14.66%	8	9
14	嘉義縣大埔鄉	2018-11-24T22:50:46+08:00	287	703	990	40	1030	1962	52.5%	14.63%	7	9
14	金門縣	2018-11-24T22:33:39+08:00	8514	26883	35397	1770	37167	104705	35.5%	8.13%	68	78
14	金門縣	2018-11-25T03:49:52+08:00	10414	31439	41853	2076	43929	122695	35.8%	8.49%	78	78
14	金門縣	2018-11-24T23:43:18+08:00	10414	31439	41853	2076	43929	122695	35.8%	8.49%	78	78
14	金門縣	2018-11-24T23:47:29+08:00	10414	31439	41853	2076	43929	122695	35.8%	8.49%	78	78
14	金門縣	2018-11-25T06:29:18+08:00	10414	31439	41853	2076	43929	122695	35.8%	8.49%	78	78
14	金門縣	2018-11-25T01:07:27+08:00	10414	31439	41853	2076	43929	122695	35.8%	8.49%	78	78
14	金門縣	2018-11-25T06:13:53+08:00	10414	31439	41853	2076	43929	122695	35.8%	8.49%	78	78
14	金門縣	2018-11-25T00:18:31+08:00	10414	31439	41853	2076	43929	122695	35.8%	8.49%	78	78
14	金門縣	2018-11-25T03:44:24+08:00	10414	31439	41853	2076	43929	122695	35.8%	8.49%	78	78
14	金門縣	2018-11-24T23:08:37+08:00	10054	30009	40063	1970	42033	117450	35.79%	8.56%	75	78
14	金門縣	2018-11-25T03:32:36+08:00	10414	31439	41853	2076	43929	122695	35.8%	8.49%	78	78
14	金門縣	2018-11-24T23:55:48+08:00	10414	31439	41853	2076	43929	122695	35.8%	8.49%	78	78
14	金門縣	2018-11-24T22:13:28+08:00	8073	25270	33343	1660	35003	98697	35.47%	8.18%	64	78
14	金門縣	2018-11-24T23:23:39+08:00	10054	30009	40063	1970	42033	117450	35.79%	8.56%	75	78
14	金門縣	2018-11-25T06:18:58+08:00	10414	31439	41853	2076	43929	122695	35.8%	8.49%	78	78
14	金門縣	2018-11-24T22:40:29+08:00	8607	27408	36015	1812	37827	106708	35.45%	8.07%	69	78
14	金門縣	2018-11-24T23:51:36+08:00	10414	31439	41853	2076	43929	122695	35.8%	8.49%	78	78
14	金門縣	2018-11-24T22:23:14+08:00	8284	26021	34305	1719	36024	101611	35.45%	8.15%	66	78
14	金門縣	2018-11-25T00:09:35+08:00	10414	31439	41853	2076	43929	122695	35.8%	8.49%	78	78
14	金門縣	2018-11-25T00:14:11+08:00	10414	31439	41853	2076	43929	122695	35.8%	8.49%	78	78
14	金門縣	2018-11-25T00:05:06+08:00	10414	31439	41853	2076	43929	122695	35.8%	8.49%	78	78
14	金門縣	2018-11-24T22:41:36+08:00	8607	27408	36015	1812	37827	106708	35.45%	8.07%	69	78
14	金門縣	2018-11-24T22:45:09+08:00	8753	27772	36525	1838	38363	108383	35.4%	8.08%	70	78
14	金門縣	2018-11-24T22:16:12+08:00	8073	25270	33343	1660	35003	98697	35.47%	8.18%	64	78
14	金門縣	2018-11-24T22:54:26+08:00	9527	28498	38025	1896	39921	111828	35.7%	8.52%	72	78
14	金門縣	2018-11-25T03:56:14+08:00	10414	31439	41853	2076	43929	122695	35.8%	8.49%	78	78
14	金門縣	2018-11-24T22:37:02+08:00	8514	26883	35397	1770	37167	104705	35.5%	8.13%	68	78
14	金門縣	2018-11-24T23:16:04+08:00	10054	30009	40063	1970	42033	117450	35.79%	8.56%	75	78
14	金門縣	2018-11-25T00:23:05+08:00	10414	31439	41853	2076	43929	122695	35.8%	8.49%	78	78
14	金門縣	2018-11-25T01:25:54+08:00	10414	31439	41853	2076	43929	122695	35.8%	8.49%	78	78
14	金門縣	2018-11-25T01:02:32+08:00	10414	31439	41853	2076	43929	122695	35.8%	8.49%	78	78
14	金門縣	2018-11-24T22:30:10+08:00	8284	26021	34305	1719	36024	101611	35.45%	8.15%	66	78
14	金門縣	2018-11-25T06:24:01+08:00	10414	31439	41853	2076	43929	122695	35.8%	8.49%	78	78
14	金門縣	2018-11-25T03:38:56+08:00	10414	31439	41853	2076	43929	122695	35.8%	8.49%	78	78
14	金門縣	2018-11-24T23:27:19+08:00	10054	30009	40063	1970	42033	117450	35.79%	8.56%	75	78
14	金門縣	2018-11-24T22:19:38+08:00	8157	25641	33798	1698	35496	100211	35.42%	8.14%	65	78
14	金門縣	2018-11-24T23:19:53+08:00	10054	30009	40063	1970	42033	117450	35.79%	8.56%	75	78
14	金門縣	2018-11-25T01:17:54+08:00	10414	31439	41853	2076	43929	122695	35.8%	8.49%	78	78
14	金門縣	2018-11-25T00:00:12+08:00	10414	31439	41853	2076	43929	122695	35.8%	8.49%	78	78
14	金門縣	2018-11-24T22:57:55+08:00	9848	29371	39219	1932	41151	114933	35.8%	8.57%	74	78
14	金門縣	2018-11-25T00:57:38+08:00	10414	31439	41853	2076	43929	122695	35.8%	8.49%	78	78
14	金門縣	2018-11-24T23:35:12+08:00	10311	31045	41356	2037	43393	121185	35.81%	8.51%	77	78
14	金門縣	2018-11-25T06:08:54+08:00	10414	31439	41853	2076	43929	122695	35.8%	8.49%	78	78
14	金門縣	2018-11-24T23:39:17+08:00	10311	31045	41356	2037	43393	121185	35.81%	8.51%	77	78
14	金門縣	2018-11-24T22:50:49+08:00	9527	28498	38025	1896	39921	111828	35.7%	8.52%	72	78
14	金門縣	2018-11-25T04:02:53+08:00	10414	31439	41853	2076	43929	122695	35.8%	8.49%	78	78
14	金門縣	2018-11-24T23:05:05+08:00	10054	30009	40063	1970	42033	117450	35.79%	8.56%	75	78
14	金門縣	2018-11-24T23:31:12+08:00	10311	31045	41356	2037	43393	121185	35.81%	8.51%	77	78
14	金門縣	2018-11-24T23:01:32+08:00	10054	30009	40063	1970	42033	117450	35.79%	8.56%	75	78
14	金門縣	2018-11-25T01:12:45+08:00	10414	31439	41853	2076	43929	122695	35.8%	8.49%	78	78
14	金門縣	2018-11-24T22:26:38+08:00	8284	26021	34305	1719	36024	101611	35.45%	8.15%	66	78
14	金門縣	2018-11-24T23:12:17+08:00	10054	30009	40063	1970	42033	117450	35.79%	8.56%	75	78
14	嘉義縣新港鄉	2018-11-25T03:56:10+08:00	4181	9079	13260	1436	14696	27342	53.75%	15.29%	31	31
14	嘉義縣新港鄉	2018-11-24T23:47:26+08:00	4181	9079	13260	1436	14696	27342	53.75%	15.29%	31	31
14	嘉義縣新港鄉	2018-11-24T23:16:01+08:00	4181	9079	13260	1436	14696	27342	53.75%	15.29%	31	31
14	嘉義縣新港鄉	2018-11-24T22:16:08+08:00	3767	8104	11871	1247	13118	24639	53.24%	15.29%	28	31
14	嘉義縣新港鄉	2018-11-24T22:33:36+08:00	3767	8104	11871	1247	13118	24639	53.24%	15.29%	28	31
14	嘉義縣新港鄉	2018-11-25T01:25:50+08:00	4181	9079	13260	1436	14696	27342	53.75%	15.29%	31	31
14	嘉義縣新港鄉	2018-11-25T03:38:53+08:00	4181	9079	13260	1436	14696	27342	53.75%	15.29%	31	31
14	嘉義縣新港鄉	2018-11-25T00:23:01+08:00	4181	9079	13260	1436	14696	27342	53.75%	15.29%	31	31
14	嘉義縣新港鄉	2018-11-24T23:23:36+08:00	4181	9079	13260	1436	14696	27342	53.75%	15.29%	31	31
14	嘉義縣新港鄉	2018-11-24T22:19:35+08:00	3767	8104	11871	1247	13118	24639	53.24%	15.29%	28	31
14	嘉義縣新港鄉	2018-11-25T00:57:34+08:00	4181	9079	13260	1436	14696	27342	53.75%	15.29%	31	31
14	嘉義縣新港鄉	2018-11-24T22:40:26+08:00	3767	8104	11871	1247	13118	24639	53.24%	15.29%	28	31
14	嘉義縣新港鄉	2018-11-24T22:36:58+08:00	3767	8104	11871	1247	13118	24639	53.24%	15.29%	28	31
14	嘉義縣新港鄉	2018-11-24T22:57:51+08:00	3955	8523	12478	1373	13851	25942	53.39%	15.25%	30	31
14	嘉義縣新港鄉	2018-11-25T00:09:32+08:00	4181	9079	13260	1436	14696	27342	53.75%	15.29%	31	31
14	嘉義縣新港鄉	2018-11-24T22:45:06+08:00	3896	8357	12253	1328	13581	25455	53.35%	15.31%	29	31
14	嘉義縣新港鄉	2018-11-25T06:08:50+08:00	4181	9079	13260	1436	14696	27342	53.75%	15.29%	31	31
14	嘉義縣新港鄉	2018-11-25T06:23:58+08:00	4181	9079	13260	1436	14696	27342	53.75%	15.29%	31	31
14	嘉義縣新港鄉	2018-11-24T23:39:13+08:00	4181	9079	13260	1436	14696	27342	53.75%	15.29%	31	31
14	嘉義縣新港鄉	2018-11-25T03:49:49+08:00	4181	9079	13260	1436	14696	27342	53.75%	15.29%	31	31
14	嘉義縣新港鄉	2018-11-25T01:12:41+08:00	4181	9079	13260	1436	14696	27342	53.75%	15.29%	31	31
14	嘉義縣新港鄉	2018-11-24T22:26:35+08:00	3767	8104	11871	1247	13118	24639	53.24%	15.29%	28	31
14	嘉義縣新港鄉	2018-11-24T22:50:45+08:00	3955	8523	12478	1373	13851	25942	53.39%	15.25%	30	31
14	嘉義縣新港鄉	2018-11-24T23:12:13+08:00	4181	9079	13260	1436	14696	27342	53.75%	15.29%	31	31
14	嘉義縣新港鄉	2018-11-25T04:02:50+08:00	4181	9079	13260	1436	14696	27342	53.75%	15.29%	31	31
14	嘉義縣新港鄉	2018-11-24T23:43:15+08:00	4181	9079	13260	1436	14696	27342	53.75%	15.29%	31	31
14	嘉義縣新港鄉	2018-11-25T06:29:14+08:00	4181	9079	13260	1436	14696	27342	53.75%	15.29%	31	31
14	嘉義縣新港鄉	2018-11-25T00:14:07+08:00	4181	9079	13260	1436	14696	27342	53.75%	15.29%	31	31
14	嘉義縣新港鄉	2018-11-24T23:01:29+08:00	3955	8523	12478	1373	13851	25942	53.39%	15.25%	30	31
14	嘉義縣新港鄉	2018-11-25T01:07:24+08:00	4181	9079	13260	1436	14696	27342	53.75%	15.29%	31	31
14	嘉義縣新港鄉	2018-11-24T23:31:09+08:00	4181	9079	13260	1436	14696	27342	53.75%	15.29%	31	31
14	嘉義縣新港鄉	2018-11-25T06:13:50+08:00	4181	9079	13260	1436	14696	27342	53.75%	15.29%	31	31
14	嘉義縣新港鄉	2018-11-24T23:35:08+08:00	4181	9079	13260	1436	14696	27342	53.75%	15.29%	31	31
14	嘉義縣新港鄉	2018-11-24T23:55:45+08:00	4181	9079	13260	1436	14696	27342	53.75%	15.29%	31	31
14	嘉義縣新港鄉	2018-11-24T23:08:34+08:00	4181	9079	13260	1436	14696	27342	53.75%	15.29%	31	31
14	嘉義縣新港鄉	2018-11-25T03:32:32+08:00	4181	9079	13260	1436	14696	27342	53.75%	15.29%	31	31
14	嘉義縣新港鄉	2018-11-24T23:19:48+08:00	4181	9079	13260	1436	14696	27342	53.75%	15.29%	31	31
14	嘉義縣新港鄉	2018-11-25T03:44:20+08:00	4181	9079	13260	1436	14696	27342	53.75%	15.29%	31	31
14	嘉義縣新港鄉	2018-11-24T22:13:24+08:00	3767	8104	11871	1247	13118	24639	53.24%	15.29%	28	31
14	嘉義縣新港鄉	2018-11-25T00:00:08+08:00	4181	9079	13260	1436	14696	27342	53.75%	15.29%	31	31
14	嘉義縣新港鄉	2018-11-25T01:17:49+08:00	4181	9079	13260	1436	14696	27342	53.75%	15.29%	31	31
14	嘉義縣新港鄉	2018-11-25T06:18:55+08:00	4181	9079	13260	1436	14696	27342	53.75%	15.29%	31	31
14	嘉義縣新港鄉	2018-11-25T01:02:28+08:00	4181	9079	13260	1436	14696	27342	53.75%	15.29%	31	31
14	嘉義縣新港鄉	2018-11-24T23:27:16+08:00	4181	9079	13260	1436	14696	27342	53.75%	15.29%	31	31
14	嘉義縣新港鄉	2018-11-24T22:30:04+08:00	3767	8104	11871	1247	13118	24639	53.24%	15.29%	28	31
14	嘉義縣新港鄉	2018-11-24T22:23:10+08:00	3767	8104	11871	1247	13118	24639	53.24%	15.29%	28	31
14	嘉義縣新港鄉	2018-11-24T23:51:32+08:00	4181	9079	13260	1436	14696	27342	53.75%	15.29%	31	31
14	嘉義縣新港鄉	2018-11-24T22:54:24+08:00	3955	8523	12478	1373	13851	25942	53.39%	15.25%	30	31
14	嘉義縣新港鄉	2018-11-24T22:41:33+08:00	3767	8104	11871	1247	13118	24639	53.24%	15.29%	28	31
14	嘉義縣新港鄉	2018-11-25T00:05:03+08:00	4181	9079	13260	1436	14696	27342	53.75%	15.29%	31	31
14	嘉義縣新港鄉	2018-11-24T23:05:02+08:00	3955	8523	12478	1373	13851	25942	53.39%	15.25%	30	31
14	嘉義縣新港鄉	2018-11-25T00:18:27+08:00	4181	9079	13260	1436	14696	27342	53.75%	15.29%	31	31
14	屏東縣車城鄉	2018-11-24T22:33:37+08:00	968	1913	2881	266	3147	7595	41.44%	12.75%	13	13
14	屏東縣車城鄉	2018-11-24T22:37:00+08:00	968	1913	2881	266	3147	7595	41.44%	12.75%	13	13
14	屏東縣車城鄉	2018-11-24T23:43:16+08:00	968	1913	2881	266	3147	7595	41.44%	12.75%	13	13
14	屏東縣車城鄉	2018-11-25T03:56:11+08:00	968	1913	2881	266	3147	7595	41.44%	12.75%	13	13
14	屏東縣車城鄉	2018-11-25T06:29:16+08:00	968	1913	2881	266	3147	7595	41.44%	12.75%	13	13
14	屏東縣車城鄉	2018-11-24T23:47:27+08:00	968	1913	2881	266	3147	7595	41.44%	12.75%	13	13
14	屏東縣車城鄉	2018-11-24T22:16:09+08:00	968	1913	2881	266	3147	7595	41.44%	12.75%	13	13
14	屏東縣車城鄉	2018-11-25T03:38:54+08:00	968	1913	2881	266	3147	7595	41.44%	12.75%	13	13
14	屏東縣車城鄉	2018-11-24T23:55:46+08:00	968	1913	2881	266	3147	7595	41.44%	12.75%	13	13
14	屏東縣車城鄉	2018-11-25T03:44:22+08:00	968	1913	2881	266	3147	7595	41.44%	12.75%	13	13
14	屏東縣車城鄉	2018-11-24T22:13:26+08:00	968	1913	2881	266	3147	7595	41.44%	12.75%	13	13
14	屏東縣車城鄉	2018-11-24T23:23:37+08:00	968	1913	2881	266	3147	7595	41.44%	12.75%	13	13
14	屏東縣車城鄉	2018-11-25T06:18:56+08:00	968	1913	2881	266	3147	7595	41.44%	12.75%	13	13
14	屏東縣車城鄉	2018-11-24T22:23:12+08:00	968	1913	2881	266	3147	7595	41.44%	12.75%	13	13
14	屏東縣車城鄉	2018-11-24T22:40:27+08:00	968	1913	2881	266	3147	7595	41.44%	12.75%	13	13
14	屏東縣車城鄉	2018-11-25T00:00:10+08:00	968	1913	2881	266	3147	7595	41.44%	12.75%	13	13
14	屏東縣車城鄉	2018-11-25T01:17:51+08:00	968	1913	2881	266	3147	7595	41.44%	12.75%	13	13
14	屏東縣車城鄉	2018-11-24T22:30:07+08:00	968	1913	2881	266	3147	7595	41.44%	12.75%	13	13
14	屏東縣車城鄉	2018-11-24T23:12:15+08:00	968	1913	2881	266	3147	7595	41.44%	12.75%	13	13
14	屏東縣車城鄉	2018-11-24T22:45:08+08:00	968	1913	2881	266	3147	7595	41.44%	12.75%	13	13
14	屏東縣車城鄉	2018-11-24T23:31:10+08:00	968	1913	2881	266	3147	7595	41.44%	12.75%	13	13
14	屏東縣車城鄉	2018-11-24T23:39:14+08:00	968	1913	2881	266	3147	7595	41.44%	12.75%	13	13
14	屏東縣車城鄉	2018-11-24T23:01:30+08:00	968	1913	2881	266	3147	7595	41.44%	12.75%	13	13
14	屏東縣車城鄉	2018-11-25T04:02:51+08:00	968	1913	2881	266	3147	7595	41.44%	12.75%	13	13
14	屏東縣車城鄉	2018-11-25T06:23:59+08:00	968	1913	2881	266	3147	7595	41.44%	12.75%	13	13
14	屏東縣車城鄉	2018-11-25T00:09:33+08:00	968	1913	2881	266	3147	7595	41.44%	12.75%	13	13
14	屏東縣車城鄉	2018-11-25T01:07:25+08:00	968	1913	2881	266	3147	7595	41.44%	12.75%	13	13
14	屏東縣車城鄉	2018-11-25T06:13:51+08:00	968	1913	2881	266	3147	7595	41.44%	12.75%	13	13
14	屏東縣車城鄉	2018-11-24T23:16:02+08:00	968	1913	2881	266	3147	7595	41.44%	12.75%	13	13
14	屏東縣車城鄉	2018-11-24T23:35:09+08:00	968	1913	2881	266	3147	7595	41.44%	12.75%	13	13
14	屏東縣車城鄉	2018-11-25T03:49:50+08:00	968	1913	2881	266	3147	7595	41.44%	12.75%	13	13
14	屏東縣車城鄉	2018-11-25T00:14:08+08:00	968	1913	2881	266	3147	7595	41.44%	12.75%	13	13
14	屏東縣車城鄉	2018-11-25T00:23:03+08:00	968	1913	2881	266	3147	7595	41.44%	12.75%	13	13
14	屏東縣車城鄉	2018-11-24T23:08:35+08:00	968	1913	2881	266	3147	7595	41.44%	12.75%	13	13
14	屏東縣車城鄉	2018-11-25T03:32:33+08:00	968	1913	2881	266	3147	7595	41.44%	12.75%	13	13
14	屏東縣車城鄉	2018-11-25T01:25:52+08:00	968	1913	2881	266	3147	7595	41.44%	12.75%	13	13
14	屏東縣車城鄉	2018-11-24T23:19:49+08:00	968	1913	2881	266	3147	7595	41.44%	12.75%	13	13
14	屏東縣車城鄉	2018-11-24T23:27:17+08:00	968	1913	2881	266	3147	7595	41.44%	12.75%	13	13
14	屏東縣車城鄉	2018-11-24T22:19:36+08:00	968	1913	2881	266	3147	7595	41.44%	12.75%	13	13
14	屏東縣車城鄉	2018-11-25T01:02:29+08:00	968	1913	2881	266	3147	7595	41.44%	12.75%	13	13
14	屏東縣車城鄉	2018-11-24T23:51:34+08:00	968	1913	2881	266	3147	7595	41.44%	12.75%	13	13
14	屏東縣車城鄉	2018-11-24T22:57:52+08:00	968	1913	2881	266	3147	7595	41.44%	12.75%	13	13
14	屏東縣車城鄉	2018-11-25T00:57:36+08:00	968	1913	2881	266	3147	7595	41.44%	12.75%	13	13
14	屏東縣車城鄉	2018-11-24T23:05:04+08:00	968	1913	2881	266	3147	7595	41.44%	12.75%	13	13
14	屏東縣車城鄉	2018-11-24T22:50:47+08:00	968	1913	2881	266	3147	7595	41.44%	12.75%	13	13
14	屏東縣車城鄉	2018-11-25T00:05:04+08:00	968	1913	2881	266	3147	7595	41.44%	12.75%	13	13
14	屏東縣車城鄉	2018-11-24T22:41:34+08:00	968	1913	2881	266	3147	7595	41.44%	12.75%	13	13
14	屏東縣車城鄉	2018-11-25T01:12:42+08:00	968	1913	2881	266	3147	7595	41.44%	12.75%	13	13
14	屏東縣車城鄉	2018-11-24T22:26:36+08:00	968	1913	2881	266	3147	7595	41.44%	12.75%	13	13
14	屏東縣車城鄉	2018-11-25T00:18:29+08:00	968	1913	2881	266	3147	7595	41.44%	12.75%	13	13
14	屏東縣車城鄉	2018-11-25T06:08:52+08:00	968	1913	2881	266	3147	7595	41.44%	12.75%	13	13
14	屏東縣車城鄉	2018-11-24T22:54:25+08:00	968	1913	2881	266	3147	7595	41.44%	12.75%	13	13
14	臺南市麻豆區	2018-11-24T23:35:03+08:00	6054	11606	17660	991	18651	37963	49.13%	15.95%	35	35
14	臺南市麻豆區	2018-11-24T22:33:30+08:00	6054	11606	17660	991	18651	37963	49.13%	15.95%	35	35
14	臺南市麻豆區	2018-11-24T23:31:02+08:00	6054	11606	17660	991	18651	37963	49.13%	15.95%	35	35
14	臺南市麻豆區	2018-11-24T23:39:06+08:00	6054	11606	17660	991	18651	37963	49.13%	15.95%	35	35
14	臺南市麻豆區	2018-11-24T23:12:07+08:00	6054	11606	17660	991	18651	37963	49.13%	15.95%	35	35
14	臺南市麻豆區	2018-11-24T23:47:20+08:00	6054	11606	17660	991	18651	37963	49.13%	15.95%	35	35
14	臺南市麻豆區	2018-11-24T23:43:10+08:00	6054	11606	17660	991	18651	37963	49.13%	15.95%	35	35
14	臺南市麻豆區	2018-11-25T06:08:44+08:00	6054	11606	17660	991	18651	37963	49.13%	15.95%	35	35
14	臺南市麻豆區	2018-11-25T01:07:18+08:00	6054	11606	17660	991	18651	37963	49.13%	15.95%	35	35
14	臺南市麻豆區	2018-11-24T23:01:23+08:00	6054	11606	17660	991	18651	37963	49.13%	15.95%	35	35
14	臺南市麻豆區	2018-11-24T22:57:45+08:00	6054	11606	17660	991	18651	37963	49.13%	15.95%	35	35
14	臺南市麻豆區	2018-11-24T22:13:18+08:00	4961	9297	14258	839	15097	30796	49.02%	16.11%	30	35
14	臺南市麻豆區	2018-11-24T22:19:29+08:00	5449	10188	15637	901	16538	33505	49.36%	16.26%	32	35
14	臺南市麻豆區	2018-11-25T00:57:28+08:00	6054	11606	17660	991	18651	37963	49.13%	15.95%	35	35
14	臺南市麻豆區	2018-11-24T23:23:31+08:00	6054	11606	17660	991	18651	37963	49.13%	15.95%	35	35
14	臺南市麻豆區	2018-11-25T01:17:43+08:00	6054	11606	17660	991	18651	37963	49.13%	15.95%	35	35
14	臺南市麻豆區	2018-11-25T03:44:13+08:00	6054	11606	17660	991	18651	37963	49.13%	15.95%	35	35
14	臺南市麻豆區	2018-11-25T00:04:57+08:00	6054	11606	17660	991	18651	37963	49.13%	15.95%	35	35
14	臺南市麻豆區	2018-11-24T23:04:56+08:00	6054	11606	17660	991	18651	37963	49.13%	15.95%	35	35
14	臺南市麻豆區	2018-11-24T23:15:55+08:00	6054	11606	17660	991	18651	37963	49.13%	15.95%	35	35
14	臺南市麻豆區	2018-11-25T01:02:23+08:00	6054	11606	17660	991	18651	37963	49.13%	15.95%	35	35
14	臺南市麻豆區	2018-11-25T01:25:45+08:00	6054	11606	17660	991	18651	37963	49.13%	15.95%	35	35
14	臺南市麻豆區	2018-11-25T03:38:48+08:00	6054	11606	17660	991	18651	37963	49.13%	15.95%	35	35
14	臺南市麻豆區	2018-11-25T06:18:50+08:00	6054	11606	17660	991	18651	37963	49.13%	15.95%	35	35
14	臺南市麻豆區	2018-11-24T22:40:21+08:00	6054	11606	17660	991	18651	37963	49.13%	15.95%	35	35
14	臺南市麻豆區	2018-11-24T23:55:39+08:00	6054	11606	17660	991	18651	37963	49.13%	15.95%	35	35
14	臺南市麻豆區	2018-11-24T22:45:01+08:00	6054	11606	17660	991	18651	37963	49.13%	15.95%	35	35
14	臺南市麻豆區	2018-11-25T00:18:22+08:00	6054	11606	17660	991	18651	37963	49.13%	15.95%	35	35
14	臺南市麻豆區	2018-11-25T00:22:56+08:00	6054	11606	17660	991	18651	37963	49.13%	15.95%	35	35
14	臺南市麻豆區	2018-11-24T22:54:19+08:00	6054	11606	17660	991	18651	37963	49.13%	15.95%	35	35
14	臺南市麻豆區	2018-11-25T03:56:03+08:00	6054	11606	17660	991	18651	37963	49.13%	15.95%	35	35
14	臺南市麻豆區	2018-11-24T22:16:02+08:00	5189	9777	14966	878	15844	32121	49.33%	16.15%	31	35
14	臺南市麻豆區	2018-11-25T01:12:34+08:00	6054	11606	17660	991	18651	37963	49.13%	15.95%	35	35
14	臺南市麻豆區	2018-11-24T22:50:39+08:00	6054	11606	17660	991	18651	37963	49.13%	15.95%	35	35
14	臺南市麻豆區	2018-11-25T00:09:25+08:00	6054	11606	17660	991	18651	37963	49.13%	15.95%	35	35
14	臺南市麻豆區	2018-11-25T00:14:01+08:00	6054	11606	17660	991	18651	37963	49.13%	15.95%	35	35
14	臺南市麻豆區	2018-11-24T22:41:28+08:00	6054	11606	17660	991	18651	37963	49.13%	15.95%	35	35
14	臺南市麻豆區	2018-11-25T04:02:41+08:00	6054	11606	17660	991	18651	37963	49.13%	15.95%	35	35
14	臺南市麻豆區	2018-11-25T00:00:00+08:00	6054	11606	17660	991	18651	37963	49.13%	15.95%	35	35
14	臺南市麻豆區	2018-11-24T22:23:04+08:00	5781	11118	16899	958	17857	36366	49.1%	15.9%	34	35
14	臺南市麻豆區	2018-11-24T23:19:41+08:00	6054	11606	17660	991	18651	37963	49.13%	15.95%	35	35
14	臺南市麻豆區	2018-11-24T23:51:27+08:00	6054	11606	17660	991	18651	37963	49.13%	15.95%	35	35
14	臺南市麻豆區	2018-11-24T22:29:58+08:00	5781	11118	16899	958	17857	36366	49.1%	15.9%	34	35
14	臺南市麻豆區	2018-11-24T22:36:53+08:00	6054	11606	17660	991	18651	37963	49.13%	15.95%	35	35
14	臺南市麻豆區	2018-11-25T03:32:27+08:00	6054	11606	17660	991	18651	37963	49.13%	15.95%	35	35
14	臺南市麻豆區	2018-11-24T23:27:11+08:00	6054	11606	17660	991	18651	37963	49.13%	15.95%	35	35
14	臺南市麻豆區	2018-11-24T23:08:27+08:00	6054	11606	17660	991	18651	37963	49.13%	15.95%	35	35
14	臺南市麻豆區	2018-11-25T06:29:08+08:00	6054	11606	17660	991	18651	37963	49.13%	15.95%	35	35
14	臺南市麻豆區	2018-11-25T03:49:44+08:00	6054	11606	17660	991	18651	37963	49.13%	15.95%	35	35
14	臺南市麻豆區	2018-11-24T22:26:30+08:00	5781	11118	16899	958	17857	36366	49.1%	15.9%	34	35
14	臺南市麻豆區	2018-11-25T06:23:53+08:00	6054	11606	17660	991	18651	37963	49.13%	15.95%	35	35
14	臺南市麻豆區	2018-11-25T06:13:45+08:00	6054	11606	17660	991	18651	37963	49.13%	15.95%	35	35
14	屏東縣牡丹鄉	2018-11-24T22:33:37+08:00	285	642	927	33	960	2571	37.34%	11.09%	5	7
14	屏東縣牡丹鄉	2018-11-24T23:47:28+08:00	527	1196	1723	76	1799	4314	41.7%	12.22%	7	7
14	屏東縣牡丹鄉	2018-11-24T22:37:00+08:00	285	642	927	33	960	2571	37.34%	11.09%	5	7
14	屏東縣牡丹鄉	2018-11-24T23:43:16+08:00	527	1196	1723	76	1799	4314	41.7%	12.22%	7	7
14	屏東縣牡丹鄉	2018-11-25T01:07:26+08:00	527	1196	1723	76	1799	4314	41.7%	12.22%	7	7
14	屏東縣牡丹鄉	2018-11-25T06:13:52+08:00	527	1196	1723	76	1799	4314	41.7%	12.22%	7	7
14	屏東縣牡丹鄉	2018-11-25T03:56:11+08:00	527	1196	1723	76	1799	4314	41.7%	12.22%	7	7
14	屏東縣牡丹鄉	2018-11-25T06:29:16+08:00	527	1196	1723	76	1799	4314	41.7%	12.22%	7	7
14	屏東縣牡丹鄉	2018-11-25T03:38:54+08:00	527	1196	1723	76	1799	4314	41.7%	12.22%	7	7
14	屏東縣牡丹鄉	2018-11-24T23:55:46+08:00	527	1196	1723	76	1799	4314	41.7%	12.22%	7	7
14	屏東縣牡丹鄉	2018-11-25T01:02:30+08:00	527	1196	1723	76	1799	4314	41.7%	12.22%	7	7
14	屏東縣牡丹鄉	2018-11-25T03:44:22+08:00	527	1196	1723	76	1799	4314	41.7%	12.22%	7	7
14	屏東縣牡丹鄉	2018-11-24T22:13:26+08:00	285	642	927	33	960	2571	37.34%	11.09%	5	7
14	屏東縣牡丹鄉	2018-11-24T23:23:37+08:00	527	1196	1723	76	1799	4314	41.7%	12.22%	7	7
14	屏東縣牡丹鄉	2018-11-24T22:23:12+08:00	285	642	927	33	960	2571	37.34%	11.09%	5	7
14	屏東縣牡丹鄉	2018-11-24T22:30:08+08:00	285	642	927	33	960	2571	37.34%	11.09%	5	7
14	屏東縣牡丹鄉	2018-11-24T22:40:27+08:00	333	764	1097	39	1136	3008	37.77%	11.07%	6	7
14	屏東縣牡丹鄉	2018-11-25T00:00:10+08:00	527	1196	1723	76	1799	4314	41.7%	12.22%	7	7
14	屏東縣牡丹鄉	2018-11-25T06:18:57+08:00	527	1196	1723	76	1799	4314	41.7%	12.22%	7	7
14	屏東縣牡丹鄉	2018-11-25T01:17:51+08:00	527	1196	1723	76	1799	4314	41.7%	12.22%	7	7
14	屏東縣牡丹鄉	2018-11-24T23:19:51+08:00	527	1196	1723	76	1799	4314	41.7%	12.22%	7	7
14	屏東縣牡丹鄉	2018-11-24T23:12:15+08:00	527	1196	1723	76	1799	4314	41.7%	12.22%	7	7
14	屏東縣牡丹鄉	2018-11-24T22:45:08+08:00	333	764	1097	39	1136	3008	37.77%	11.07%	6	7
14	屏東縣牡丹鄉	2018-11-24T23:31:10+08:00	527	1196	1723	76	1799	4314	41.7%	12.22%	7	7
14	屏東縣牡丹鄉	2018-11-24T23:01:30+08:00	527	1196	1723	76	1799	4314	41.7%	12.22%	7	7
14	屏東縣牡丹鄉	2018-11-25T04:02:51+08:00	527	1196	1723	76	1799	4314	41.7%	12.22%	7	7
14	屏東縣牡丹鄉	2018-11-24T23:39:15+08:00	527	1196	1723	76	1799	4314	41.7%	12.22%	7	7
14	屏東縣牡丹鄉	2018-11-25T06:23:59+08:00	527	1196	1723	76	1799	4314	41.7%	12.22%	7	7
14	屏東縣牡丹鄉	2018-11-25T00:09:33+08:00	527	1196	1723	76	1799	4314	41.7%	12.22%	7	7
14	屏東縣牡丹鄉	2018-11-24T23:35:10+08:00	527	1196	1723	76	1799	4314	41.7%	12.22%	7	7
14	屏東縣牡丹鄉	2018-11-25T00:14:09+08:00	527	1196	1723	76	1799	4314	41.7%	12.22%	7	7
14	屏東縣牡丹鄉	2018-11-24T23:16:02+08:00	527	1196	1723	76	1799	4314	41.7%	12.22%	7	7
14	屏東縣牡丹鄉	2018-11-25T03:49:50+08:00	527	1196	1723	76	1799	4314	41.7%	12.22%	7	7
14	屏東縣牡丹鄉	2018-11-25T00:23:03+08:00	527	1196	1723	76	1799	4314	41.7%	12.22%	7	7
14	屏東縣牡丹鄉	2018-11-24T23:08:35+08:00	527	1196	1723	76	1799	4314	41.7%	12.22%	7	7
14	屏東縣牡丹鄉	2018-11-25T03:32:34+08:00	527	1196	1723	76	1799	4314	41.7%	12.22%	7	7
14	屏東縣牡丹鄉	2018-11-25T01:25:52+08:00	527	1196	1723	76	1799	4314	41.7%	12.22%	7	7
14	屏東縣牡丹鄉	2018-11-24T22:19:36+08:00	285	642	927	33	960	2571	37.34%	11.09%	5	7
14	屏東縣牡丹鄉	2018-11-24T22:57:52+08:00	527	1196	1723	76	1799	4314	41.7%	12.22%	7	7
14	屏東縣牡丹鄉	2018-11-25T00:57:36+08:00	527	1196	1723	76	1799	4314	41.7%	12.22%	7	7
14	屏東縣牡丹鄉	2018-11-24T23:27:18+08:00	527	1196	1723	76	1799	4314	41.7%	12.22%	7	7
14	屏東縣牡丹鄉	2018-11-24T23:51:35+08:00	527	1196	1723	76	1799	4314	41.7%	12.22%	7	7
14	屏東縣牡丹鄉	2018-11-24T23:05:04+08:00	527	1196	1723	76	1799	4314	41.7%	12.22%	7	7
14	屏東縣牡丹鄉	2018-11-24T22:50:47+08:00	527	1196	1723	76	1799	4314	41.7%	12.22%	7	7
14	屏東縣牡丹鄉	2018-11-24T22:16:10+08:00	285	642	927	33	960	2571	37.34%	11.09%	5	7
14	屏東縣牡丹鄉	2018-11-25T01:12:43+08:00	527	1196	1723	76	1799	4314	41.7%	12.22%	7	7
14	屏東縣牡丹鄉	2018-11-25T00:05:04+08:00	527	1196	1723	76	1799	4314	41.7%	12.22%	7	7
14	屏東縣牡丹鄉	2018-11-24T22:41:34+08:00	333	764	1097	39	1136	3008	37.77%	11.07%	6	7
14	屏東縣牡丹鄉	2018-11-24T22:26:36+08:00	285	642	927	33	960	2571	37.34%	11.09%	5	7
14	屏東縣牡丹鄉	2018-11-25T00:18:29+08:00	527	1196	1723	76	1799	4314	41.7%	12.22%	7	7
14	屏東縣牡丹鄉	2018-11-25T06:08:52+08:00	527	1196	1723	76	1799	4314	41.7%	12.22%	7	7
14	屏東縣牡丹鄉	2018-11-24T22:54:25+08:00	527	1196	1723	76	1799	4314	41.7%	12.22%	7	7
14	臺南市北門區	2018-11-24T23:47:21+08:00	1237	2600	3837	258	4095	9925	41.26%	12.46%	18	18
14	臺南市北門區	2018-11-24T23:35:03+08:00	1237	2600	3837	258	4095	9925	41.26%	12.46%	18	18
14	臺南市北門區	2018-11-24T22:33:30+08:00	1237	2600	3837	258	4095	9925	41.26%	12.46%	18	18
14	臺南市北門區	2018-11-24T23:31:02+08:00	1237	2600	3837	258	4095	9925	41.26%	12.46%	18	18
14	臺南市北門區	2018-11-24T23:39:06+08:00	1237	2600	3837	258	4095	9925	41.26%	12.46%	18	18
14	臺南市北門區	2018-11-25T01:07:19+08:00	1237	2600	3837	258	4095	9925	41.26%	12.46%	18	18
14	臺南市北門區	2018-11-25T00:14:02+08:00	1237	2600	3837	258	4095	9925	41.26%	12.46%	18	18
14	臺南市北門區	2018-11-24T23:43:10+08:00	1237	2600	3837	258	4095	9925	41.26%	12.46%	18	18
14	臺南市北門區	2018-11-25T06:08:44+08:00	1237	2600	3837	258	4095	9925	41.26%	12.46%	18	18
14	臺南市北門區	2018-11-25T00:09:26+08:00	1237	2600	3837	258	4095	9925	41.26%	12.46%	18	18
14	臺南市北門區	2018-11-24T23:01:23+08:00	1237	2600	3837	258	4095	9925	41.26%	12.46%	18	18
14	臺南市北門區	2018-11-24T23:12:08+08:00	1237	2600	3837	258	4095	9925	41.26%	12.46%	18	18
14	臺南市北門區	2018-11-24T22:57:45+08:00	1237	2600	3837	258	4095	9925	41.26%	12.46%	18	18
14	臺南市北門區	2018-11-24T23:04:57+08:00	1237	2600	3837	258	4095	9925	41.26%	12.46%	18	18
14	臺南市北門區	2018-11-24T23:23:31+08:00	1237	2600	3837	258	4095	9925	41.26%	12.46%	18	18
14	臺南市北門區	2018-11-25T00:57:29+08:00	1237	2600	3837	258	4095	9925	41.26%	12.46%	18	18
14	臺南市北門區	2018-11-24T22:13:19+08:00	1237	2600	3837	258	4095	9925	41.26%	12.46%	18	18
14	臺南市北門區	2018-11-25T03:44:14+08:00	1237	2600	3837	258	4095	9925	41.26%	12.46%	18	18
14	臺南市北門區	2018-11-25T01:17:43+08:00	1237	2600	3837	258	4095	9925	41.26%	12.46%	18	18
14	臺南市北門區	2018-11-25T00:04:57+08:00	1237	2600	3837	258	4095	9925	41.26%	12.46%	18	18
14	臺南市北門區	2018-11-24T23:55:40+08:00	1237	2600	3837	258	4095	9925	41.26%	12.46%	18	18
14	臺南市北門區	2018-11-25T01:02:23+08:00	1237	2600	3837	258	4095	9925	41.26%	12.46%	18	18
14	臺南市北門區	2018-11-25T01:25:45+08:00	1237	2600	3837	258	4095	9925	41.26%	12.46%	18	18
14	臺南市北門區	2018-11-25T03:38:48+08:00	1237	2600	3837	258	4095	9925	41.26%	12.46%	18	18
14	臺南市北門區	2018-11-25T06:18:50+08:00	1237	2600	3837	258	4095	9925	41.26%	12.46%	18	18
14	臺南市北門區	2018-11-24T22:40:21+08:00	1237	2600	3837	258	4095	9925	41.26%	12.46%	18	18
14	臺南市北門區	2018-11-24T23:27:12+08:00	1237	2600	3837	258	4095	9925	41.26%	12.46%	18	18
14	臺南市北門區	2018-11-24T22:45:01+08:00	1237	2600	3837	258	4095	9925	41.26%	12.46%	18	18
14	臺南市北門區	2018-11-25T00:18:22+08:00	1237	2600	3837	258	4095	9925	41.26%	12.46%	18	18
14	臺南市北門區	2018-11-25T00:22:56+08:00	1237	2600	3837	258	4095	9925	41.26%	12.46%	18	18
14	臺南市北門區	2018-11-24T22:54:19+08:00	1237	2600	3837	258	4095	9925	41.26%	12.46%	18	18
14	臺南市北門區	2018-11-25T03:56:03+08:00	1237	2600	3837	258	4095	9925	41.26%	12.46%	18	18
14	臺南市北門區	2018-11-24T22:16:02+08:00	1237	2600	3837	258	4095	9925	41.26%	12.46%	18	18
14	臺南市北門區	2018-11-24T22:50:39+08:00	1237	2600	3837	258	4095	9925	41.26%	12.46%	18	18
14	臺南市北門區	2018-11-24T22:41:28+08:00	1237	2600	3837	258	4095	9925	41.26%	12.46%	18	18
14	臺南市北門區	2018-11-25T04:02:41+08:00	1237	2600	3837	258	4095	9925	41.26%	12.46%	18	18
14	臺南市北門區	2018-11-25T01:12:35+08:00	1237	2600	3837	258	4095	9925	41.26%	12.46%	18	18
14	臺南市北門區	2018-11-24T23:19:41+08:00	1237	2600	3837	258	4095	9925	41.26%	12.46%	18	18
14	臺南市北門區	2018-11-25T00:00:01+08:00	1237	2600	3837	258	4095	9925	41.26%	12.46%	18	18
14	臺南市北門區	2018-11-24T23:51:27+08:00	1237	2600	3837	258	4095	9925	41.26%	12.46%	18	18
14	臺南市北門區	2018-11-24T22:29:58+08:00	1237	2600	3837	258	4095	9925	41.26%	12.46%	18	18
14	臺南市北門區	2018-11-24T22:23:05+08:00	1237	2600	3837	258	4095	9925	41.26%	12.46%	18	18
14	臺南市北門區	2018-11-24T22:36:54+08:00	1237	2600	3837	258	4095	9925	41.26%	12.46%	18	18
14	臺南市北門區	2018-11-24T23:15:56+08:00	1237	2600	3837	258	4095	9925	41.26%	12.46%	18	18
14	臺南市北門區	2018-11-24T23:08:28+08:00	1237	2600	3837	258	4095	9925	41.26%	12.46%	18	18
14	臺南市北門區	2018-11-25T03:32:27+08:00	1237	2600	3837	258	4095	9925	41.26%	12.46%	18	18
14	臺南市北門區	2018-11-24T22:19:30+08:00	1237	2600	3837	258	4095	9925	41.26%	12.46%	18	18
14	臺南市北門區	2018-11-25T03:49:44+08:00	1237	2600	3837	258	4095	9925	41.26%	12.46%	18	18
14	臺南市北門區	2018-11-24T22:26:30+08:00	1237	2600	3837	258	4095	9925	41.26%	12.46%	18	18
14	臺南市北門區	2018-11-25T06:29:09+08:00	1237	2600	3837	258	4095	9925	41.26%	12.46%	18	18
14	臺南市北門區	2018-11-25T06:23:53+08:00	1237	2600	3837	258	4095	9925	41.26%	12.46%	18	18
14	臺南市北門區	2018-11-25T06:13:45+08:00	1237	2600	3837	258	4095	9925	41.26%	12.46%	18	18
14	新竹市東區	2018-11-25T06:29:19+08:00	32694	57138	89832	3741	93573	163757	57.14%	19.96%	139	139
14	新竹市東區	2018-11-25T01:07:28+08:00	32694	57138	89832	3741	93573	163757	57.14%	19.96%	139	139
14	新竹市東區	2018-11-25T03:49:53+08:00	32694	57138	89832	3741	93573	163757	57.14%	19.96%	139	139
14	新竹市東區	2018-11-24T22:50:50+08:00	22657	39575	62232	2641	64873	113762	57.03%	19.92%	102	139
14	新竹市東區	2018-11-25T06:13:54+08:00	32694	57138	89832	3741	93573	163757	57.14%	19.96%	139	139
14	新竹市東區	2018-11-24T23:43:19+08:00	30181	52668	82849	3444	86293	151017	57.14%	19.99%	130	139
14	新竹市東區	2018-11-24T22:13:29+08:00	16717	29611	46328	2037	48365	85474	56.58%	19.56%	80	139
14	新竹市東區	2018-11-25T03:32:36+08:00	32694	57138	89832	3741	93573	163757	57.14%	19.96%	139	139
14	新竹市東區	2018-11-25T03:44:25+08:00	32694	57138	89832	3741	93573	163757	57.14%	19.96%	139	139
14	新竹市東區	2018-11-24T23:08:38+08:00	26270	46018	72288	3041	75329	131992	57.07%	19.9%	116	139
14	新竹市東區	2018-11-24T23:55:49+08:00	30822	53698	84520	3516	88036	154235	57.08%	19.98%	132	139
14	新竹市東區	2018-11-25T06:24:02+08:00	32694	57138	89832	3741	93573	163757	57.14%	19.96%	139	139
14	新竹市東區	2018-11-24T23:51:37+08:00	30822	53698	84520	3516	88036	154235	57.08%	19.98%	132	139
14	新竹市東區	2018-11-24T22:23:15+08:00	18574	32584	51158	2209	53367	94118	56.7%	19.73%	86	139
14	新竹市東區	2018-11-24T22:40:29+08:00	22158	38708	60866	2586	63452	111283	57.02%	19.91%	100	139
14	新竹市東區	2018-11-25T06:18:59+08:00	32694	57138	89832	3741	93573	163757	57.14%	19.96%	139	139
14	新竹市東區	2018-11-24T22:57:56+08:00	24409	42886	67295	2824	70119	122958	57.03%	19.85%	109	139
14	新竹市東區	2018-11-24T23:23:40+08:00	28767	49974	78741	3262	82003	143642	57.09%	20.03%	124	139
14	新竹市東區	2018-11-24T22:33:40+08:00	21441	37405	58846	2506	61352	107760	56.93%	19.9%	97	139
14	新竹市東區	2018-11-24T22:54:27+08:00	24162	42406	66568	2799	69367	121691	57%	19.86%	108	139
14	新竹市東區	2018-11-25T00:14:11+08:00	31726	55217	86943	3607	90550	158622	57.09%	20%	135	139
14	新竹市東區	2018-11-24T22:16:12+08:00	17207	30498	47705	2094	49799	88088	56.53%	19.53%	82	139
14	新竹市東區	2018-11-24T22:41:37+08:00	22158	38708	60866	2586	63452	111283	57.02%	19.91%	100	139
14	新竹市東區	2018-11-25T00:05:07+08:00	31162	54257	85419	3550	88969	155855	57.08%	19.99%	133	139
14	新竹市東區	2018-11-24T23:05:06+08:00	25630	44978	70608	2986	73594	129182	56.97%	19.84%	114	139
14	新竹市東區	2018-11-24T22:45:10+08:00	22158	38708	60866	2586	63452	111283	57.02%	19.91%	100	139
14	新竹市東區	2018-11-25T03:56:14+08:00	32694	57138	89832	3741	93573	163757	57.14%	19.96%	139	139
14	新竹市東區	2018-11-24T22:37:02+08:00	21971	38352	60323	2542	62865	110282	57%	19.92%	99	139
14	新竹市東區	2018-11-25T00:18:32+08:00	31970	55700	87670	3636	91306	159939	57.09%	19.99%	136	139
14	新竹市東區	2018-11-24T23:16:04+08:00	28031	48466	76497	3158	79655	139519	57.09%	20.09%	121	139
14	新竹市東區	2018-11-25T00:23:05+08:00	31970	55700	87670	3636	91306	159939	57.09%	19.99%	136	139
14	新竹市東區	2018-11-25T01:25:54+08:00	32694	57138	89832	3741	93573	163757	57.14%	19.96%	139	139
14	新竹市東區	2018-11-25T03:38:57+08:00	32694	57138	89832	3741	93573	163757	57.14%	19.96%	139	139
14	新竹市東區	2018-11-24T22:30:11+08:00	20113	35077	55190	2379	57569	101002	57%	19.91%	92	139
14	新竹市東區	2018-11-25T01:02:33+08:00	32694	57138	89832	3741	93573	163757	57.14%	19.96%	139	139
14	新竹市東區	2018-11-25T00:57:39+08:00	32694	57138	89832	3741	93573	163757	57.14%	19.96%	139	139
14	新竹市東區	2018-11-24T23:19:53+08:00	28323	48997	77320	3203	80523	141088	57.07%	20.07%	122	139
14	新竹市東區	2018-11-25T00:00:12+08:00	30822	53698	84520	3516	88036	154235	57.08%	19.98%	132	139
14	新竹市東區	2018-11-25T01:17:55+08:00	32694	57138	89832	3741	93573	163757	57.14%	19.96%	139	139
14	新竹市東區	2018-11-24T22:19:39+08:00	18028	31550	49578	2157	51735	91293	56.67%	19.75%	84	139
14	新竹市東區	2018-11-24T23:27:20+08:00	28962	50391	79353	3286	82639	144721	57.1%	20.01%	125	139
14	新竹市東區	2018-11-24T23:35:12+08:00	29768	51772	81540	3388	84928	148583	57.16%	20.03%	128	139
14	新竹市東區	2018-11-24T23:47:30+08:00	30822	53698	84520	3516	88036	154235	57.08%	19.98%	132	139
14	新竹市東區	2018-11-25T00:09:36+08:00	31454	54753	86207	3576	89783	157268	57.09%	20%	134	139
14	新竹市東區	2018-11-24T23:01:33+08:00	25085	44142	69227	2917	72144	126663	56.96%	19.8%	112	139
14	新竹市東區	2018-11-24T23:31:13+08:00	29559	51387	80946	3369	84315	147509	57.16%	20.04%	127	139
14	新竹市東區	2018-11-25T04:02:54+08:00	32694	57138	89832	3741	93573	163757	57.14%	19.96%	139	139
14	新竹市東區	2018-11-25T01:12:45+08:00	32694	57138	89832	3741	93573	163757	57.14%	19.96%	139	139
14	新竹市東區	2018-11-24T22:26:38+08:00	19015	33329	52344	2269	54613	96219	56.76%	19.76%	88	139
14	新竹市東區	2018-11-24T23:12:17+08:00	26642	46569	73211	3067	76278	133739	57.03%	19.92%	117	139
14	新竹市東區	2018-11-24T23:39:18+08:00	30181	52668	82849	3444	86293	151017	57.14%	19.99%	130	139
14	新竹市東區	2018-11-25T06:08:55+08:00	32694	57138	89832	3741	93573	163757	57.14%	19.96%	139	139
14	花蓮縣壽豐鄉	2018-11-25T06:29:17+08:00	2161	5885	8046	758	8804	15847	55.56%	13.64%	21	21
14	花蓮縣壽豐鄉	2018-11-24T23:47:28+08:00	2161	5885	8046	758	8804	15847	55.56%	13.64%	21	21
14	花蓮縣壽豐鄉	2018-11-25T00:18:30+08:00	2161	5885	8046	758	8804	15847	55.56%	13.64%	21	21
14	花蓮縣壽豐鄉	2018-11-25T01:07:26+08:00	2161	5885	8046	758	8804	15847	55.56%	13.64%	21	21
14	花蓮縣壽豐鄉	2018-11-25T06:13:52+08:00	2161	5885	8046	758	8804	15847	55.56%	13.64%	21	21
14	花蓮縣壽豐鄉	2018-11-24T22:33:38+08:00	1441	4209	5650	583	6233	11561	53.91%	12.46%	16	21
14	花蓮縣壽豐鄉	2018-11-24T23:43:17+08:00	2161	5885	8046	758	8804	15847	55.56%	13.64%	21	21
14	花蓮縣壽豐鄉	2018-11-24T22:37:01+08:00	1441	4209	5650	583	6233	11561	53.91%	12.46%	16	21
14	花蓮縣壽豐鄉	2018-11-25T03:44:23+08:00	2161	5885	8046	758	8804	15847	55.56%	13.64%	21	21
14	花蓮縣壽豐鄉	2018-11-24T22:13:27+08:00	1281	3755	5036	544	5580	10422	53.54%	12.29%	15	21
14	花蓮縣壽豐鄉	2018-11-25T01:02:31+08:00	2161	5885	8046	758	8804	15847	55.56%	13.64%	21	21
14	花蓮縣壽豐鄉	2018-11-24T23:23:38+08:00	2027	5512	7539	717	8256	14972	55.14%	13.54%	20	21
14	花蓮縣壽豐鄉	2018-11-25T03:38:55+08:00	2161	5885	8046	758	8804	15847	55.56%	13.64%	21	21
14	花蓮縣壽豐鄉	2018-11-24T23:55:47+08:00	2161	5885	8046	758	8804	15847	55.56%	13.64%	21	21
14	花蓮縣壽豐鄉	2018-11-24T23:08:36+08:00	1874	5117	6991	677	7668	13943	55%	13.44%	19	21
14	花蓮縣壽豐鄉	2018-11-25T00:00:11+08:00	2161	5885	8046	758	8804	15847	55.56%	13.64%	21	21
14	花蓮縣壽豐鄉	2018-11-25T06:18:57+08:00	2161	5885	8046	758	8804	15847	55.56%	13.64%	21	21
14	花蓮縣壽豐鄉	2018-11-24T22:30:09+08:00	1281	3755	5036	544	5580	10422	53.54%	12.29%	15	21
14	花蓮縣壽豐鄉	2018-11-24T22:40:28+08:00	1441	4209	5650	583	6233	11561	53.91%	12.46%	16	21
14	花蓮縣壽豐鄉	2018-11-24T22:23:13+08:00	1281	3755	5036	544	5580	10422	53.54%	12.29%	15	21
14	花蓮縣壽豐鄉	2018-11-24T23:19:51+08:00	2027	5512	7539	717	8256	14972	55.14%	13.54%	20	21
14	花蓮縣壽豐鄉	2018-11-24T23:12:15+08:00	1874	5117	6991	677	7668	13943	55%	13.44%	19	21
14	花蓮縣壽豐鄉	2018-11-24T23:35:11+08:00	2161	5885	8046	758	8804	15847	55.56%	13.64%	21	21
14	花蓮縣壽豐鄉	2018-11-24T23:01:31+08:00	1556	4486	6042	615	6657	12252	54.33%	12.7%	17	21
14	花蓮縣壽豐鄉	2018-11-24T22:45:09+08:00	1441	4209	5650	583	6233	11561	53.91%	12.46%	16	21
14	花蓮縣壽豐鄉	2018-11-24T23:31:11+08:00	2161	5885	8046	758	8804	15847	55.56%	13.64%	21	21
14	花蓮縣壽豐鄉	2018-11-25T00:09:34+08:00	2161	5885	8046	758	8804	15847	55.56%	13.64%	21	21
14	花蓮縣壽豐鄉	2018-11-24T22:54:26+08:00	1556	4486	6042	615	6657	12252	54.33%	12.7%	17	21
14	花蓮縣壽豐鄉	2018-11-25T00:14:09+08:00	2161	5885	8046	758	8804	15847	55.56%	13.64%	21	21
14	花蓮縣壽豐鄉	2018-11-25T03:49:51+08:00	2161	5885	8046	758	8804	15847	55.56%	13.64%	21	21
14	花蓮縣壽豐鄉	2018-11-24T23:16:03+08:00	1874	5117	6991	677	7668	13943	55%	13.44%	19	21
14	花蓮縣壽豐鄉	2018-11-25T03:56:12+08:00	2161	5885	8046	758	8804	15847	55.56%	13.64%	21	21
14	花蓮縣壽豐鄉	2018-11-25T06:24:00+08:00	2161	5885	8046	758	8804	15847	55.56%	13.64%	21	21
14	花蓮縣壽豐鄉	2018-11-25T01:25:53+08:00	2161	5885	8046	758	8804	15847	55.56%	13.64%	21	21
14	花蓮縣壽豐鄉	2018-11-25T00:23:03+08:00	2161	5885	8046	758	8804	15847	55.56%	13.64%	21	21
14	花蓮縣壽豐鄉	2018-11-25T03:32:34+08:00	2161	5885	8046	758	8804	15847	55.56%	13.64%	21	21
14	花蓮縣壽豐鄉	2018-11-25T00:57:37+08:00	2161	5885	8046	758	8804	15847	55.56%	13.64%	21	21
14	花蓮縣壽豐鄉	2018-11-24T22:57:53+08:00	1556	4486	6042	615	6657	12252	54.33%	12.7%	17	21
14	花蓮縣壽豐鄉	2018-11-24T22:19:37+08:00	1281	3755	5036	544	5580	10422	53.54%	12.29%	15	21
14	花蓮縣壽豐鄉	2018-11-25T01:17:52+08:00	2161	5885	8046	758	8804	15847	55.56%	13.64%	21	21
14	花蓮縣壽豐鄉	2018-11-24T23:27:18+08:00	2027	5512	7539	717	8256	14972	55.14%	13.54%	20	21
14	花蓮縣壽豐鄉	2018-11-24T23:51:35+08:00	2161	5885	8046	758	8804	15847	55.56%	13.64%	21	21
14	花蓮縣壽豐鄉	2018-11-24T23:05:04+08:00	1669	4780	6449	645	7094	12947	54.79%	12.89%	18	21
14	花蓮縣壽豐鄉	2018-11-24T22:41:35+08:00	1441	4209	5650	583	6233	11561	53.91%	12.46%	16	21
14	花蓮縣壽豐鄉	2018-11-25T00:05:05+08:00	2161	5885	8046	758	8804	15847	55.56%	13.64%	21	21
14	花蓮縣壽豐鄉	2018-11-25T04:02:52+08:00	2161	5885	8046	758	8804	15847	55.56%	13.64%	21	21
14	花蓮縣壽豐鄉	2018-11-25T06:08:53+08:00	2161	5885	8046	758	8804	15847	55.56%	13.64%	21	21
14	花蓮縣壽豐鄉	2018-11-24T22:16:10+08:00	1281	3755	5036	544	5580	10422	53.54%	12.29%	15	21
14	花蓮縣壽豐鄉	2018-11-25T01:12:43+08:00	2161	5885	8046	758	8804	15847	55.56%	13.64%	21	21
14	花蓮縣壽豐鄉	2018-11-24T22:26:37+08:00	1281	3755	5036	544	5580	10422	53.54%	12.29%	15	21
14	花蓮縣壽豐鄉	2018-11-24T22:50:48+08:00	1556	4486	6042	615	6657	12252	54.33%	12.7%	17	21
14	花蓮縣壽豐鄉	2018-11-24T23:39:16+08:00	2161	5885	8046	758	8804	15847	55.56%	13.64%	21	21
14	臺中市和平區	2018-11-24T23:35:03+08:00	1190	4486	5676	327	6003	9498	63.2%	12.53%	17	17
14	臺中市和平區	2018-11-24T22:33:30+08:00	886	3169	4055	213	4268	6811	62.66%	13.01%	14	17
14	臺中市和平區	2018-11-24T23:31:02+08:00	1190	4486	5676	327	6003	9498	63.2%	12.53%	17	17
14	臺中市和平區	2018-11-24T23:12:07+08:00	1190	4486	5676	327	6003	9498	63.2%	12.53%	17	17
14	臺中市和平區	2018-11-24T23:47:20+08:00	1190	4486	5676	327	6003	9498	63.2%	12.53%	17	17
14	臺中市和平區	2018-11-25T01:07:18+08:00	1190	4486	5676	327	6003	9498	63.2%	12.53%	17	17
14	臺中市和平區	2018-11-25T06:08:43+08:00	1190	4486	5676	327	6003	9498	63.2%	12.53%	17	17
14	臺中市和平區	2018-11-24T23:01:23+08:00	959	3514	4473	238	4711	7524	62.61%	12.75%	15	17
14	臺中市和平區	2018-11-24T22:57:45+08:00	886	3169	4055	213	4268	6811	62.66%	13.01%	14	17
14	臺中市和平區	2018-11-25T01:17:42+08:00	1190	4486	5676	327	6003	9498	63.2%	12.53%	17	17
14	臺中市和平區	2018-11-24T22:13:18+08:00	647	2457	3104	167	3271	5219	62.67%	12.4%	12	17
14	臺中市和平區	2018-11-24T22:19:29+08:00	647	2457	3104	167	3271	5219	62.67%	12.4%	12	17
14	臺中市和平區	2018-11-25T00:57:28+08:00	1190	4486	5676	327	6003	9498	63.2%	12.53%	17	17
14	臺中市和平區	2018-11-24T23:23:31+08:00	1190	4486	5676	327	6003	9498	63.2%	12.53%	17	17
14	臺中市和平區	2018-11-25T03:44:13+08:00	1190	4486	5676	327	6003	9498	63.2%	12.53%	17	17
14	臺中市和平區	2018-11-25T00:04:57+08:00	1190	4486	5676	327	6003	9498	63.2%	12.53%	17	17
14	臺中市和平區	2018-11-24T23:04:56+08:00	959	3514	4473	238	4711	7524	62.61%	12.75%	15	17
14	臺中市和平區	2018-11-24T23:15:55+08:00	1190	4486	5676	327	6003	9498	63.2%	12.53%	17	17
14	臺中市和平區	2018-11-25T03:38:48+08:00	1190	4486	5676	327	6003	9498	63.2%	12.53%	17	17
14	臺中市和平區	2018-11-25T06:18:50+08:00	1190	4486	5676	327	6003	9498	63.2%	12.53%	17	17
14	臺中市和平區	2018-11-25T01:25:44+08:00	1190	4486	5676	327	6003	9498	63.2%	12.53%	17	17
14	臺中市和平區	2018-11-24T22:40:21+08:00	886	3169	4055	213	4268	6811	62.66%	13.01%	14	17
14	臺中市和平區	2018-11-25T01:02:22+08:00	1190	4486	5676	327	6003	9498	63.2%	12.53%	17	17
14	臺中市和平區	2018-11-24T23:55:39+08:00	1190	4486	5676	327	6003	9498	63.2%	12.53%	17	17
14	臺中市和平區	2018-11-24T22:54:18+08:00	886	3169	4055	213	4268	6811	62.66%	13.01%	14	17
14	臺中市和平區	2018-11-24T22:45:01+08:00	886	3169	4055	213	4268	6811	62.66%	13.01%	14	17
14	臺中市和平區	2018-11-25T00:18:22+08:00	1190	4486	5676	327	6003	9498	63.2%	12.53%	17	17
14	臺中市和平區	2018-11-25T00:22:56+08:00	1190	4486	5676	327	6003	9498	63.2%	12.53%	17	17
14	臺中市和平區	2018-11-25T03:56:03+08:00	1190	4486	5676	327	6003	9498	63.2%	12.53%	17	17
14	臺中市和平區	2018-11-24T23:39:05+08:00	1190	4486	5676	327	6003	9498	63.2%	12.53%	17	17
14	臺中市和平區	2018-11-24T22:16:02+08:00	647	2457	3104	167	3271	5219	62.67%	12.4%	12	17
14	臺中市和平區	2018-11-25T01:12:34+08:00	1190	4486	5676	327	6003	9498	63.2%	12.53%	17	17
14	臺中市和平區	2018-11-25T04:02:40+08:00	1190	4486	5676	327	6003	9498	63.2%	12.53%	17	17
14	臺中市和平區	2018-11-24T22:50:39+08:00	886	3169	4055	213	4268	6811	62.66%	13.01%	14	17
14	臺中市和平區	2018-11-25T00:09:25+08:00	1190	4486	5676	327	6003	9498	63.2%	12.53%	17	17
14	臺中市和平區	2018-11-25T00:14:01+08:00	1190	4486	5676	327	6003	9498	63.2%	12.53%	17	17
14	臺中市和平區	2018-11-24T22:41:28+08:00	886	3169	4055	213	4268	6811	62.66%	13.01%	14	17
14	臺中市和平區	2018-11-25T00:00:00+08:00	1190	4486	5676	327	6003	9498	63.2%	12.53%	17	17
14	臺中市和平區	2018-11-24T22:23:04+08:00	647	2457	3104	167	3271	5219	62.67%	12.4%	12	17
14	臺中市和平區	2018-11-24T23:19:41+08:00	1190	4486	5676	327	6003	9498	63.2%	12.53%	17	17
14	臺中市和平區	2018-11-24T23:51:27+08:00	1190	4486	5676	327	6003	9498	63.2%	12.53%	17	17
14	臺中市和平區	2018-11-24T22:29:58+08:00	810	2874	3684	199	3883	6175	62.88%	13.12%	13	17
14	臺中市和平區	2018-11-24T22:36:53+08:00	886	3169	4055	213	4268	6811	62.66%	13.01%	14	17
14	臺中市和平區	2018-11-24T23:27:11+08:00	1190	4486	5676	327	6003	9498	63.2%	12.53%	17	17
14	臺中市和平區	2018-11-24T23:08:27+08:00	1075	3991	5066	277	5343	8487	62.96%	12.67%	16	17
14	臺中市和平區	2018-11-25T03:32:26+08:00	1190	4486	5676	327	6003	9498	63.2%	12.53%	17	17
14	臺中市和平區	2018-11-25T06:29:08+08:00	1190	4486	5676	327	6003	9498	63.2%	12.53%	17	17
14	臺中市和平區	2018-11-25T03:49:44+08:00	1190	4486	5676	327	6003	9498	63.2%	12.53%	17	17
14	臺中市和平區	2018-11-24T22:26:30+08:00	647	2457	3104	167	3271	5219	62.67%	12.4%	12	17
14	臺中市和平區	2018-11-25T06:23:52+08:00	1190	4486	5676	327	6003	9498	63.2%	12.53%	17	17
14	臺中市和平區	2018-11-24T23:43:09+08:00	1190	4486	5676	327	6003	9498	63.2%	12.53%	17	17
14	臺中市和平區	2018-11-25T06:13:45+08:00	1190	4486	5676	327	6003	9498	63.2%	12.53%	17	17
14	臺東縣太麻里鄉	2018-11-25T06:29:17+08:00	1099	3268	4367	420	4787	9666	49.52%	11.37%	15	15
14	臺東縣太麻里鄉	2018-11-25T03:49:52+08:00	1099	3268	4367	420	4787	9666	49.52%	11.37%	15	15
14	臺東縣太麻里鄉	2018-11-24T23:47:29+08:00	1099	3268	4367	420	4787	9666	49.52%	11.37%	15	15
14	臺東縣太麻里鄉	2018-11-24T22:33:38+08:00	1099	3268	4367	420	4787	9666	49.52%	11.37%	15	15
14	臺東縣太麻里鄉	2018-11-25T01:07:27+08:00	1099	3268	4367	420	4787	9666	49.52%	11.37%	15	15
14	臺東縣太麻里鄉	2018-11-25T06:13:53+08:00	1099	3268	4367	420	4787	9666	49.52%	11.37%	15	15
14	臺東縣太麻里鄉	2018-11-24T23:43:17+08:00	1099	3268	4367	420	4787	9666	49.52%	11.37%	15	15
14	臺東縣太麻里鄉	2018-11-25T00:18:31+08:00	1099	3268	4367	420	4787	9666	49.52%	11.37%	15	15
14	臺東縣太麻里鄉	2018-11-24T22:37:01+08:00	1099	3268	4367	420	4787	9666	49.52%	11.37%	15	15
14	臺東縣太麻里鄉	2018-11-24T22:13:27+08:00	1018	3006	4024	384	4408	8929	49.37%	11.4%	14	15
14	臺東縣太麻里鄉	2018-11-25T03:44:24+08:00	1099	3268	4367	420	4787	9666	49.52%	11.37%	15	15
14	臺東縣太麻里鄉	2018-11-24T23:08:37+08:00	1099	3268	4367	420	4787	9666	49.52%	11.37%	15	15
14	臺東縣太麻里鄉	2018-11-25T03:38:55+08:00	1099	3268	4367	420	4787	9666	49.52%	11.37%	15	15
14	臺東縣太麻里鄉	2018-11-24T23:55:47+08:00	1099	3268	4367	420	4787	9666	49.52%	11.37%	15	15
14	臺東縣太麻里鄉	2018-11-24T23:23:39+08:00	1099	3268	4367	420	4787	9666	49.52%	11.37%	15	15
14	臺東縣太麻里鄉	2018-11-25T06:18:58+08:00	1099	3268	4367	420	4787	9666	49.52%	11.37%	15	15
14	臺東縣太麻里鄉	2018-11-25T00:00:11+08:00	1099	3268	4367	420	4787	9666	49.52%	11.37%	15	15
14	臺東縣太麻里鄉	2018-11-24T23:51:36+08:00	1099	3268	4367	420	4787	9666	49.52%	11.37%	15	15
14	臺東縣太麻里鄉	2018-11-24T22:23:14+08:00	1099	3268	4367	420	4787	9666	49.52%	11.37%	15	15
14	臺東縣太麻里鄉	2018-11-24T22:40:28+08:00	1099	3268	4367	420	4787	9666	49.52%	11.37%	15	15
14	臺東縣太麻里鄉	2018-11-25T00:09:35+08:00	1099	3268	4367	420	4787	9666	49.52%	11.37%	15	15
14	臺東縣太麻里鄉	2018-11-25T00:05:06+08:00	1099	3268	4367	420	4787	9666	49.52%	11.37%	15	15
14	臺東縣太麻里鄉	2018-11-24T23:35:11+08:00	1099	3268	4367	420	4787	9666	49.52%	11.37%	15	15
14	臺東縣太麻里鄉	2018-11-24T23:01:31+08:00	1099	3268	4367	420	4787	9666	49.52%	11.37%	15	15
14	臺東縣太麻里鄉	2018-11-24T22:45:09+08:00	1099	3268	4367	420	4787	9666	49.52%	11.37%	15	15
14	臺東縣太麻里鄉	2018-11-24T22:54:26+08:00	1099	3268	4367	420	4787	9666	49.52%	11.37%	15	15
14	臺東縣太麻里鄉	2018-11-25T00:14:10+08:00	1099	3268	4367	420	4787	9666	49.52%	11.37%	15	15
14	臺東縣太麻里鄉	2018-11-25T03:56:13+08:00	1099	3268	4367	420	4787	9666	49.52%	11.37%	15	15
14	臺東縣太麻里鄉	2018-11-24T23:16:03+08:00	1099	3268	4367	420	4787	9666	49.52%	11.37%	15	15
14	臺東縣太麻里鄉	2018-11-25T03:32:35+08:00	1099	3268	4367	420	4787	9666	49.52%	11.37%	15	15
14	臺東縣太麻里鄉	2018-11-25T01:25:53+08:00	1099	3268	4367	420	4787	9666	49.52%	11.37%	15	15
14	臺東縣太麻里鄉	2018-11-25T01:02:32+08:00	1099	3268	4367	420	4787	9666	49.52%	11.37%	15	15
14	臺東縣太麻里鄉	2018-11-24T22:30:10+08:00	1099	3268	4367	420	4787	9666	49.52%	11.37%	15	15
14	臺東縣太麻里鄉	2018-11-25T00:23:04+08:00	1099	3268	4367	420	4787	9666	49.52%	11.37%	15	15
14	臺東縣太麻里鄉	2018-11-25T06:24:01+08:00	1099	3268	4367	420	4787	9666	49.52%	11.37%	15	15
14	臺東縣太麻里鄉	2018-11-24T23:27:19+08:00	1099	3268	4367	420	4787	9666	49.52%	11.37%	15	15
14	臺東縣太麻里鄉	2018-11-25T00:57:37+08:00	1099	3268	4367	420	4787	9666	49.52%	11.37%	15	15
14	臺東縣太麻里鄉	2018-11-24T22:57:54+08:00	1099	3268	4367	420	4787	9666	49.52%	11.37%	15	15
14	臺東縣太麻里鄉	2018-11-25T01:17:53+08:00	1099	3268	4367	420	4787	9666	49.52%	11.37%	15	15
14	臺東縣太麻里鄉	2018-11-24T22:19:37+08:00	1099	3268	4367	420	4787	9666	49.52%	11.37%	15	15
14	臺東縣太麻里鄉	2018-11-24T23:19:52+08:00	1099	3268	4367	420	4787	9666	49.52%	11.37%	15	15
14	臺東縣太麻里鄉	2018-11-24T22:41:35+08:00	1099	3268	4367	420	4787	9666	49.52%	11.37%	15	15
14	臺東縣太麻里鄉	2018-11-24T23:12:16+08:00	1099	3268	4367	420	4787	9666	49.52%	11.37%	15	15
14	臺東縣太麻里鄉	2018-11-25T06:08:53+08:00	1099	3268	4367	420	4787	9666	49.52%	11.37%	15	15
14	臺東縣太麻里鄉	2018-11-25T01:12:44+08:00	1099	3268	4367	420	4787	9666	49.52%	11.37%	15	15
14	臺東縣太麻里鄉	2018-11-24T22:50:49+08:00	1099	3268	4367	420	4787	9666	49.52%	11.37%	15	15
14	臺東縣太麻里鄉	2018-11-24T22:26:37+08:00	1099	3268	4367	420	4787	9666	49.52%	11.37%	15	15
14	臺東縣太麻里鄉	2018-11-25T04:02:53+08:00	1099	3268	4367	420	4787	9666	49.52%	11.37%	15	15
14	臺東縣太麻里鄉	2018-11-24T23:05:05+08:00	1099	3268	4367	420	4787	9666	49.52%	11.37%	15	15
14	臺東縣太麻里鄉	2018-11-24T23:31:12+08:00	1099	3268	4367	420	4787	9666	49.52%	11.37%	15	15
14	臺東縣太麻里鄉	2018-11-24T22:16:11+08:00	1018	3006	4024	384	4408	8929	49.37%	11.4%	14	15
14	臺東縣太麻里鄉	2018-11-24T23:39:16+08:00	1099	3268	4367	420	4787	9666	49.52%	11.37%	15	15
14	南投縣魚池鄉	2018-11-25T01:12:39+08:00	2215	4904	7119	507	7626	13958	54.64%	15.87%	25	25
14	南投縣魚池鄉	2018-11-24T23:16:00+08:00	2215	4904	7119	507	7626	13958	54.64%	15.87%	25	25
14	南投縣魚池鄉	2018-11-24T22:16:07+08:00	1875	4150	6025	421	6446	11938	54%	15.71%	23	25
14	南投縣魚池鄉	2018-11-24T22:23:09+08:00	1875	4150	6025	421	6446	11938	54%	15.71%	23	25
14	南投縣魚池鄉	2018-11-25T03:32:31+08:00	2215	4904	7119	507	7626	13958	54.64%	15.87%	25	25
14	南投縣魚池鄉	2018-11-25T00:00:04+08:00	2215	4904	7119	507	7626	13958	54.64%	15.87%	25	25
14	南投縣魚池鄉	2018-11-25T00:23:01+08:00	2215	4904	7119	507	7626	13958	54.64%	15.87%	25	25
14	南投縣魚池鄉	2018-11-25T03:38:52+08:00	2215	4904	7119	507	7626	13958	54.64%	15.87%	25	25
14	南投縣魚池鄉	2018-11-24T22:36:57+08:00	2065	4560	6625	470	7095	13036	54.43%	15.84%	24	25
14	南投縣魚池鄉	2018-11-24T22:57:50+08:00	2215	4904	7119	507	7626	13958	54.64%	15.87%	25	25
14	南投縣魚池鄉	2018-11-25T00:57:33+08:00	2215	4904	7119	507	7626	13958	54.64%	15.87%	25	25
14	南投縣魚池鄉	2018-11-24T23:27:15+08:00	2215	4904	7119	507	7626	13958	54.64%	15.87%	25	25
14	南投縣魚池鄉	2018-11-24T22:19:34+08:00	1875	4150	6025	421	6446	11938	54%	15.71%	23	25
14	南投縣魚池鄉	2018-11-24T22:50:44+08:00	2215	4904	7119	507	7626	13958	54.64%	15.87%	25	25
14	南投縣魚池鄉	2018-11-24T23:12:12+08:00	2215	4904	7119	507	7626	13958	54.64%	15.87%	25	25
14	南投縣魚池鄉	2018-11-25T06:13:49+08:00	2215	4904	7119	507	7626	13958	54.64%	15.87%	25	25
14	南投縣魚池鄉	2018-11-24T22:26:34+08:00	2065	4560	6625	470	7095	13036	54.43%	15.84%	24	25
14	南投縣魚池鄉	2018-11-25T06:23:57+08:00	2215	4904	7119	507	7626	13958	54.64%	15.87%	25	25
14	南投縣魚池鄉	2018-11-24T23:39:12+08:00	2215	4904	7119	507	7626	13958	54.64%	15.87%	25	25
14	南投縣魚池鄉	2018-11-25T03:49:48+08:00	2215	4904	7119	507	7626	13958	54.64%	15.87%	25	25
14	南投縣魚池鄉	2018-11-24T23:01:28+08:00	2215	4904	7119	507	7626	13958	54.64%	15.87%	25	25
14	南投縣魚池鄉	2018-11-24T23:47:25+08:00	2215	4904	7119	507	7626	13958	54.64%	15.87%	25	25
14	南投縣魚池鄉	2018-11-25T06:29:13+08:00	2215	4904	7119	507	7626	13958	54.64%	15.87%	25	25
14	南投縣魚池鄉	2018-11-24T23:35:07+08:00	2215	4904	7119	507	7626	13958	54.64%	15.87%	25	25
14	南投縣魚池鄉	2018-11-24T22:33:34+08:00	2065	4560	6625	470	7095	13036	54.43%	15.84%	24	25
14	南投縣魚池鄉	2018-11-25T01:07:23+08:00	2215	4904	7119	507	7626	13958	54.64%	15.87%	25	25
14	南投縣魚池鄉	2018-11-24T23:43:14+08:00	2215	4904	7119	507	7626	13958	54.64%	15.87%	25	25
14	南投縣魚池鄉	2018-11-24T23:31:07+08:00	2215	4904	7119	507	7626	13958	54.64%	15.87%	25	25
14	南投縣魚池鄉	2018-11-25T06:08:49+08:00	2215	4904	7119	507	7626	13958	54.64%	15.87%	25	25
14	南投縣魚池鄉	2018-11-25T00:14:06+08:00	2215	4904	7119	507	7626	13958	54.64%	15.87%	25	25
14	南投縣魚池鄉	2018-11-25T04:02:46+08:00	2215	4904	7119	507	7626	13958	54.64%	15.87%	25	25
14	南投縣魚池鄉	2018-11-24T23:23:35+08:00	2215	4904	7119	507	7626	13958	54.64%	15.87%	25	25
14	南投縣魚池鄉	2018-11-24T22:13:23+08:00	1875	4150	6025	421	6446	11938	54%	15.71%	23	25
14	南投縣魚池鄉	2018-11-25T01:17:48+08:00	2215	4904	7119	507	7626	13958	54.64%	15.87%	25	25
14	南投縣魚池鄉	2018-11-24T23:55:44+08:00	2215	4904	7119	507	7626	13958	54.64%	15.87%	25	25
14	南投縣魚池鄉	2018-11-24T23:08:32+08:00	2215	4904	7119	507	7626	13958	54.64%	15.87%	25	25
14	南投縣魚池鄉	2018-11-24T23:19:47+08:00	2215	4904	7119	507	7626	13958	54.64%	15.87%	25	25
14	南投縣魚池鄉	2018-11-25T03:44:19+08:00	2215	4904	7119	507	7626	13958	54.64%	15.87%	25	25
14	南投縣魚池鄉	2018-11-25T01:02:27+08:00	2215	4904	7119	507	7626	13958	54.64%	15.87%	25	25
14	南投縣魚池鄉	2018-11-24T22:40:25+08:00	2065	4560	6625	470	7095	13036	54.43%	15.84%	24	25
14	南投縣魚池鄉	2018-11-24T22:30:03+08:00	2065	4560	6625	470	7095	13036	54.43%	15.84%	24	25
14	南投縣魚池鄉	2018-11-25T01:25:49+08:00	2215	4904	7119	507	7626	13958	54.64%	15.87%	25	25
14	南投縣魚池鄉	2018-11-25T06:18:54+08:00	2215	4904	7119	507	7626	13958	54.64%	15.87%	25	25
14	南投縣魚池鄉	2018-11-24T23:51:32+08:00	2215	4904	7119	507	7626	13958	54.64%	15.87%	25	25
14	南投縣魚池鄉	2018-11-25T03:56:08+08:00	2215	4904	7119	507	7626	13958	54.64%	15.87%	25	25
14	南投縣魚池鄉	2018-11-25T00:05:02+08:00	2215	4904	7119	507	7626	13958	54.64%	15.87%	25	25
14	南投縣魚池鄉	2018-11-24T22:41:32+08:00	2065	4560	6625	470	7095	13036	54.43%	15.84%	24	25
14	南投縣魚池鄉	2018-11-25T00:09:31+08:00	2215	4904	7119	507	7626	13958	54.64%	15.87%	25	25
14	南投縣魚池鄉	2018-11-24T22:54:23+08:00	2215	4904	7119	507	7626	13958	54.64%	15.87%	25	25
14	南投縣魚池鄉	2018-11-24T22:45:05+08:00	2065	4560	6625	470	7095	13036	54.43%	15.84%	24	25
14	南投縣魚池鄉	2018-11-24T23:05:02+08:00	2215	4904	7119	507	7626	13958	54.64%	15.87%	25	25
14	南投縣魚池鄉	2018-11-25T00:18:27+08:00	2215	4904	7119	507	7626	13958	54.64%	15.87%	25	25
14	雲林縣北港鎮	2018-11-24T23:16:00+08:00	4738	10216	14954	1422	16376	30032	54.53%	15.78%	38	41
14	雲林縣北港鎮	2018-11-24T22:16:07+08:00	3026	7051	10077	928	11005	20126	54.68%	15.04%	28	41
14	雲林縣北港鎮	2018-11-25T01:25:50+08:00	5355	11642	16997	1559	18556	33958	54.64%	15.77%	41	41
14	雲林縣北港鎮	2018-11-25T00:23:01+08:00	5355	11642	16997	1559	18556	33958	54.64%	15.77%	41	41
14	雲林縣北港鎮	2018-11-25T03:38:52+08:00	5355	11642	16997	1559	18556	33958	54.64%	15.77%	41	41
14	雲林縣北港鎮	2018-11-24T22:57:50+08:00	4738	10216	14954	1422	16376	30032	54.53%	15.78%	38	41
14	雲林縣北港鎮	2018-11-25T00:57:33+08:00	5355	11642	16997	1559	18556	33958	54.64%	15.77%	41	41
14	雲林縣北港鎮	2018-11-24T22:36:58+08:00	4050	8654	12704	1226	13930	25581	54.45%	15.83%	34	41
14	雲林縣北港鎮	2018-11-24T22:19:34+08:00	3131	7320	10451	981	11432	20850	54.83%	15.02%	29	41
14	雲林縣北港鎮	2018-11-24T22:45:06+08:00	4550	9832	14382	1402	15784	29000	54.43%	15.69%	37	41
14	雲林縣北港鎮	2018-11-25T06:13:49+08:00	5355	11642	16997	1559	18556	33958	54.64%	15.77%	41	41
14	雲林縣北港鎮	2018-11-25T01:12:40+08:00	5355	11642	16997	1559	18556	33958	54.64%	15.77%	41	41
14	雲林縣北港鎮	2018-11-24T22:26:34+08:00	3131	7320	10451	981	11432	20850	54.83%	15.02%	29	41
14	雲林縣北港鎮	2018-11-25T06:23:57+08:00	5355	11642	16997	1559	18556	33958	54.64%	15.77%	41	41
14	雲林縣北港鎮	2018-11-24T23:39:12+08:00	5355	11642	16997	1559	18556	33958	54.64%	15.77%	41	41
14	雲林縣北港鎮	2018-11-24T22:50:45+08:00	4738	10216	14954	1422	16376	30032	54.53%	15.78%	38	41
14	雲林縣北港鎮	2018-11-24T23:12:13+08:00	4738	10216	14954	1422	16376	30032	54.53%	15.78%	38	41
14	雲林縣北港鎮	2018-11-25T03:49:48+08:00	5355	11642	16997	1559	18556	33958	54.64%	15.77%	41	41
14	雲林縣北港鎮	2018-11-24T23:31:08+08:00	5355	11642	16997	1559	18556	33958	54.64%	15.77%	41	41
14	雲林縣北港鎮	2018-11-24T23:01:28+08:00	4738	10216	14954	1422	16376	30032	54.53%	15.78%	38	41
14	雲林縣北港鎮	2018-11-24T23:47:25+08:00	5355	11642	16997	1559	18556	33958	54.64%	15.77%	41	41
14	雲林縣北港鎮	2018-11-25T06:29:14+08:00	5355	11642	16997	1559	18556	33958	54.64%	15.77%	41	41
14	雲林縣北港鎮	2018-11-24T23:35:07+08:00	5355	11642	16997	1559	18556	33958	54.64%	15.77%	41	41
14	雲林縣北港鎮	2018-11-25T01:07:23+08:00	5355	11642	16997	1559	18556	33958	54.64%	15.77%	41	41
14	雲林縣北港鎮	2018-11-24T23:43:14+08:00	5355	11642	16997	1559	18556	33958	54.64%	15.77%	41	41
14	雲林縣北港鎮	2018-11-25T06:08:49+08:00	5355	11642	16997	1559	18556	33958	54.64%	15.77%	41	41
14	雲林縣北港鎮	2018-11-24T22:33:35+08:00	3881	8282	12163	1176	13339	24451	54.55%	15.87%	33	41
14	雲林縣北港鎮	2018-11-25T00:14:06+08:00	5355	11642	16997	1559	18556	33958	54.64%	15.77%	41	41
14	雲林縣北港鎮	2018-11-25T04:02:48+08:00	5355	11642	16997	1559	18556	33958	54.64%	15.77%	41	41
14	雲林縣北港鎮	2018-11-25T00:00:07+08:00	5355	11642	16997	1559	18556	33958	54.64%	15.77%	41	41
14	雲林縣北港鎮	2018-11-24T23:08:33+08:00	4738	10216	14954	1422	16376	30032	54.53%	15.78%	38	41
14	雲林縣北港鎮	2018-11-25T03:32:32+08:00	5355	11642	16997	1559	18556	33958	54.64%	15.77%	41	41
14	雲林縣北港鎮	2018-11-24T23:23:35+08:00	4896	10621	15517	1454	16971	31181	54.43%	15.7%	39	41
14	雲林縣北港鎮	2018-11-25T01:17:48+08:00	5355	11642	16997	1559	18556	33958	54.64%	15.77%	41	41
14	雲林縣北港鎮	2018-11-24T22:13:24+08:00	2882	6794	9676	874	10550	19438	54.28%	14.83%	27	41
14	雲林縣北港鎮	2018-11-24T23:55:44+08:00	5355	11642	16997	1559	18556	33958	54.64%	15.77%	41	41
14	雲林縣北港鎮	2018-11-24T23:19:47+08:00	4896	10621	15517	1454	16971	31181	54.43%	15.7%	39	41
14	雲林縣北港鎮	2018-11-25T03:44:19+08:00	5355	11642	16997	1559	18556	33958	54.64%	15.77%	41	41
14	雲林縣北港鎮	2018-11-25T01:02:27+08:00	5355	11642	16997	1559	18556	33958	54.64%	15.77%	41	41
14	雲林縣北港鎮	2018-11-24T23:27:16+08:00	4896	10621	15517	1454	16971	31181	54.43%	15.7%	39	41
14	雲林縣北港鎮	2018-11-24T22:40:25+08:00	4368	9396	13764	1352	15116	27849	54.28%	15.68%	36	41
14	雲林縣北港鎮	2018-11-24T22:23:10+08:00	3131	7320	10451	981	11432	20850	54.83%	15.02%	29	41
14	雲林縣北港鎮	2018-11-24T22:30:03+08:00	3131	7320	10451	981	11432	20850	54.83%	15.02%	29	41
14	雲林縣北港鎮	2018-11-25T06:18:54+08:00	5355	11642	16997	1559	18556	33958	54.64%	15.77%	41	41
14	雲林縣北港鎮	2018-11-24T23:51:32+08:00	5355	11642	16997	1559	18556	33958	54.64%	15.77%	41	41
14	雲林縣北港鎮	2018-11-25T00:05:02+08:00	5355	11642	16997	1559	18556	33958	54.64%	15.77%	41	41
14	雲林縣北港鎮	2018-11-24T22:41:32+08:00	4368	9396	13764	1352	15116	27849	54.28%	15.68%	36	41
14	雲林縣北港鎮	2018-11-25T00:09:31+08:00	5355	11642	16997	1559	18556	33958	54.64%	15.77%	41	41
14	雲林縣北港鎮	2018-11-24T22:54:23+08:00	4738	10216	14954	1422	16376	30032	54.53%	15.78%	38	41
14	雲林縣北港鎮	2018-11-24T23:05:02+08:00	4738	10216	14954	1422	16376	30032	54.53%	15.78%	38	41
14	雲林縣北港鎮	2018-11-25T03:56:09+08:00	5355	11642	16997	1559	18556	33958	54.64%	15.77%	41	41
14	雲林縣北港鎮	2018-11-25T00:18:27+08:00	5355	11642	16997	1559	18556	33958	54.64%	15.77%	41	41
14	雲林縣臺西鄉	2018-11-24T23:47:26+08:00	2308	6511	8819	862	9681	21125	45.83%	10.93%	22	22
14	雲林縣臺西鄉	2018-11-24T23:16:00+08:00	2308	6511	8819	862	9681	21125	45.83%	10.93%	22	22
14	雲林縣臺西鄉	2018-11-24T22:16:07+08:00	2308	6511	8819	862	9681	21125	45.83%	10.93%	22	22
14	雲林縣臺西鄉	2018-11-25T01:25:50+08:00	2308	6511	8819	862	9681	21125	45.83%	10.93%	22	22
14	雲林縣臺西鄉	2018-11-25T03:38:53+08:00	2308	6511	8819	862	9681	21125	45.83%	10.93%	22	22
14	雲林縣臺西鄉	2018-11-25T00:23:01+08:00	2308	6511	8819	862	9681	21125	45.83%	10.93%	22	22
14	雲林縣臺西鄉	2018-11-24T23:23:36+08:00	2308	6511	8819	862	9681	21125	45.83%	10.93%	22	22
14	雲林縣臺西鄉	2018-11-25T00:57:34+08:00	2308	6511	8819	862	9681	21125	45.83%	10.93%	22	22
14	雲林縣臺西鄉	2018-11-24T22:36:58+08:00	2308	6511	8819	862	9681	21125	45.83%	10.93%	22	22
14	雲林縣臺西鄉	2018-11-24T22:57:51+08:00	2308	6511	8819	862	9681	21125	45.83%	10.93%	22	22
14	雲林縣臺西鄉	2018-11-24T22:19:34+08:00	2308	6511	8819	862	9681	21125	45.83%	10.93%	22	22
14	雲林縣臺西鄉	2018-11-24T22:45:06+08:00	2308	6511	8819	862	9681	21125	45.83%	10.93%	22	22
14	雲林縣臺西鄉	2018-11-25T06:08:50+08:00	2308	6511	8819	862	9681	21125	45.83%	10.93%	22	22
14	雲林縣臺西鄉	2018-11-25T06:23:58+08:00	2308	6511	8819	862	9681	21125	45.83%	10.93%	22	22
14	雲林縣臺西鄉	2018-11-25T01:12:40+08:00	2308	6511	8819	862	9681	21125	45.83%	10.93%	22	22
14	雲林縣臺西鄉	2018-11-24T22:26:34+08:00	2308	6511	8819	862	9681	21125	45.83%	10.93%	22	22
14	雲林縣臺西鄉	2018-11-25T03:49:49+08:00	2308	6511	8819	862	9681	21125	45.83%	10.93%	22	22
14	雲林縣臺西鄉	2018-11-24T23:39:12+08:00	2308	6511	8819	862	9681	21125	45.83%	10.93%	22	22
14	雲林縣臺西鄉	2018-11-24T22:50:45+08:00	2308	6511	8819	862	9681	21125	45.83%	10.93%	22	22
14	雲林縣臺西鄉	2018-11-24T23:12:13+08:00	2308	6511	8819	862	9681	21125	45.83%	10.93%	22	22
14	雲林縣臺西鄉	2018-11-24T23:31:08+08:00	2308	6511	8819	862	9681	21125	45.83%	10.93%	22	22
14	雲林縣臺西鄉	2018-11-24T23:43:15+08:00	2308	6511	8819	862	9681	21125	45.83%	10.93%	22	22
14	雲林縣臺西鄉	2018-11-24T23:01:28+08:00	2308	6511	8819	862	9681	21125	45.83%	10.93%	22	22
14	雲林縣臺西鄉	2018-11-25T06:29:14+08:00	2308	6511	8819	862	9681	21125	45.83%	10.93%	22	22
14	雲林縣臺西鄉	2018-11-25T00:14:07+08:00	2308	6511	8819	862	9681	21125	45.83%	10.93%	22	22
14	雲林縣臺西鄉	2018-11-25T04:02:49+08:00	2308	6511	8819	862	9681	21125	45.83%	10.93%	22	22
14	雲林縣臺西鄉	2018-11-25T01:07:23+08:00	2308	6511	8819	862	9681	21125	45.83%	10.93%	22	22
14	雲林縣臺西鄉	2018-11-25T06:13:50+08:00	2308	6511	8819	862	9681	21125	45.83%	10.93%	22	22
14	雲林縣臺西鄉	2018-11-24T23:35:08+08:00	2308	6511	8819	862	9681	21125	45.83%	10.93%	22	22
14	雲林縣臺西鄉	2018-11-24T22:33:35+08:00	2308	6511	8819	862	9681	21125	45.83%	10.93%	22	22
14	雲林縣臺西鄉	2018-11-24T23:08:33+08:00	2308	6511	8819	862	9681	21125	45.83%	10.93%	22	22
14	雲林縣臺西鄉	2018-11-25T03:32:32+08:00	2308	6511	8819	862	9681	21125	45.83%	10.93%	22	22
14	雲林縣臺西鄉	2018-11-25T03:44:20+08:00	2308	6511	8819	862	9681	21125	45.83%	10.93%	22	22
14	雲林縣臺西鄉	2018-11-24T22:13:24+08:00	2308	6511	8819	862	9681	21125	45.83%	10.93%	22	22
14	雲林縣臺西鄉	2018-11-25T00:00:08+08:00	2308	6511	8819	862	9681	21125	45.83%	10.93%	22	22
14	雲林縣臺西鄉	2018-11-24T23:55:44+08:00	2308	6511	8819	862	9681	21125	45.83%	10.93%	22	22
14	雲林縣臺西鄉	2018-11-25T01:17:49+08:00	2308	6511	8819	862	9681	21125	45.83%	10.93%	22	22
14	雲林縣臺西鄉	2018-11-24T23:19:47+08:00	2308	6511	8819	862	9681	21125	45.83%	10.93%	22	22
14	雲林縣臺西鄉	2018-11-25T06:18:55+08:00	2308	6511	8819	862	9681	21125	45.83%	10.93%	22	22
14	雲林縣臺西鄉	2018-11-25T01:02:28+08:00	2308	6511	8819	862	9681	21125	45.83%	10.93%	22	22
14	雲林縣臺西鄉	2018-11-24T23:27:16+08:00	2308	6511	8819	862	9681	21125	45.83%	10.93%	22	22
14	雲林縣臺西鄉	2018-11-24T22:40:25+08:00	2308	6511	8819	862	9681	21125	45.83%	10.93%	22	22
14	雲林縣臺西鄉	2018-11-24T22:23:10+08:00	2308	6511	8819	862	9681	21125	45.83%	10.93%	22	22
14	雲林縣臺西鄉	2018-11-24T22:30:03+08:00	2308	6511	8819	862	9681	21125	45.83%	10.93%	22	22
14	雲林縣臺西鄉	2018-11-24T23:51:32+08:00	2308	6511	8819	862	9681	21125	45.83%	10.93%	22	22
14	雲林縣臺西鄉	2018-11-25T00:05:02+08:00	2308	6511	8819	862	9681	21125	45.83%	10.93%	22	22
14	雲林縣臺西鄉	2018-11-24T22:41:32+08:00	2308	6511	8819	862	9681	21125	45.83%	10.93%	22	22
14	雲林縣臺西鄉	2018-11-25T00:09:31+08:00	2308	6511	8819	862	9681	21125	45.83%	10.93%	22	22
14	雲林縣臺西鄉	2018-11-24T22:54:23+08:00	2308	6511	8819	862	9681	21125	45.83%	10.93%	22	22
14	雲林縣臺西鄉	2018-11-24T23:05:02+08:00	2308	6511	8819	862	9681	21125	45.83%	10.93%	22	22
14	雲林縣臺西鄉	2018-11-25T03:56:09+08:00	2308	6511	8819	862	9681	21125	45.83%	10.93%	22	22
14	雲林縣臺西鄉	2018-11-25T00:18:27+08:00	2308	6511	8819	862	9681	21125	45.83%	10.93%	22	22
14	新竹縣竹北市	2018-11-25T04:02:43+08:00	27093	49966	77059	2904	79963	137129	58.31%	19.76%	103	103
14	新竹縣竹北市	2018-11-25T01:12:37+08:00	26419	48761	75180	2844	78024	133850	58.29%	19.74%	101	103
14	新竹縣竹北市	2018-11-25T00:14:04+08:00	18642	34169	52811	2071	54882	94863	57.85%	19.65%	73	103
14	新竹縣竹北市	2018-11-24T23:31:05+08:00	13649	24857	38506	1513	40019	69461	57.61%	19.65%	54	103
14	新竹縣竹北市	2018-11-25T01:07:21+08:00	26177	48214	74391	2826	77217	132344	58.35%	19.78%	100	103
14	新竹縣竹北市	2018-11-24T23:35:05+08:00	13813	25235	39048	1573	40621	70438	57.67%	19.61%	55	103
14	新竹縣竹北市	2018-11-25T06:29:11+08:00	27093	49966	77059	2904	79963	137129	58.31%	19.76%	103	103
14	新竹縣竹北市	2018-11-24T23:39:09+08:00	14384	26274	40658	1633	42291	73247	57.74%	19.64%	57	103
14	新竹縣竹北市	2018-11-25T00:09:28+08:00	18457	33785	52242	2036	54278	93805	57.86%	19.68%	72	103
14	新竹縣竹北市	2018-11-24T22:23:07+08:00	3727	7291	11018	486	11504	20379	56.45%	18.29%	16	103
14	新竹縣竹北市	2018-11-24T23:08:30+08:00	10497	18883	29380	1204	30584	53124	57.57%	19.76%	41	103
14	新竹縣竹北市	2018-11-24T23:19:44+08:00	12175	22193	34368	1391	35759	61961	57.71%	19.65%	48	103
14	新竹縣竹北市	2018-11-24T22:13:21+08:00	1839	3805	5644	287	5931	10409	56.98%	17.67%	9	103
14	新竹縣竹北市	2018-11-25T00:00:02+08:00	16488	30151	46639	1863	48502	84034	57.72%	19.62%	65	103
14	新竹縣竹北市	2018-11-24T22:30:01+08:00	4430	8568	12998	564	13562	23986	56.54%	18.47%	19	103
14	新竹縣竹北市	2018-11-24T23:27:13+08:00	12693	23066	35759	1429	37188	64400	57.75%	19.71%	50	103
14	新竹縣竹北市	2018-11-24T22:19:32+08:00	3123	6277	9400	439	9839	17132	57.43%	18.23%	14	103
14	新竹縣竹北市	2018-11-24T22:36:56+08:00	5144	10041	15185	641	15826	28048	56.42%	18.34%	22	103
14	新竹縣竹北市	2018-11-25T01:02:25+08:00	25883	47778	73661	2800	76461	131132	58.31%	19.74%	99	103
14	新竹縣竹北市	2018-11-25T06:13:47+08:00	27093	49966	77059	2904	79963	137129	58.31%	19.76%	103	103
14	新竹縣竹北市	2018-11-25T00:18:25+08:00	19147	35243	54390	2118	56508	97820	57.77%	19.57%	75	103
14	新竹縣竹北市	2018-11-24T23:05:00+08:00	9976	17941	27917	1131	29048	50606	57.4%	19.71%	39	103
14	新竹縣竹北市	2018-11-24T22:26:32+08:00	3965	7746	11711	509	12220	21725	56.25%	18.25%	17	103
14	新竹縣竹北市	2018-11-24T22:50:42+08:00	6506	12499	19005	801	19806	34711	57.06%	18.74%	27	103
14	新竹縣竹北市	2018-11-24T22:54:21+08:00	6978	13199	20177	882	21059	36970	56.96%	18.87%	29	103
14	新竹縣竹北市	2018-11-25T00:05:00+08:00	17443	31740	49183	1928	51111	88439	57.79%	19.72%	68	103
14	新竹縣竹北市	2018-11-24T22:41:30+08:00	5414	10497	15911	655	16566	29244	56.65%	18.51%	23	103
14	新竹縣竹北市	2018-11-25T00:22:59+08:00	19698	36486	56184	2213	58397	100867	57.9%	19.53%	77	103
14	新竹縣竹北市	2018-11-25T03:49:46+08:00	27093	49966	77059	2904	79963	137129	58.31%	19.76%	103	103
14	新竹縣竹北市	2018-11-24T23:01:26+08:00	9286	17070	26356	1083	27439	47707	57.52%	19.46%	37	103
14	新竹縣竹北市	2018-11-24T23:43:12+08:00	14759	26821	41580	1652	43232	74998	57.64%	19.68%	58	103
14	新竹縣竹北市	2018-11-25T06:08:47+08:00	27093	49966	77059	2904	79963	137129	58.31%	19.76%	103	103
14	新竹縣竹北市	2018-11-24T22:16:04+08:00	2391	4716	7107	334	7441	13143	56.62%	18.19%	11	103
14	新竹縣竹北市	2018-11-24T22:33:32+08:00	5144	10041	15185	641	15826	28048	56.42%	18.34%	22	103
14	新竹縣竹北市	2018-11-24T23:47:23+08:00	14759	26821	41580	1652	43232	74998	57.64%	19.68%	58	103
14	新竹縣竹北市	2018-11-24T23:55:42+08:00	15797	28692	44489	1742	46231	79837	57.91%	19.79%	62	103
14	新竹縣竹北市	2018-11-25T03:44:16+08:00	27093	49966	77059	2904	79963	137129	58.31%	19.76%	103	103
14	新竹縣竹北市	2018-11-25T01:17:46+08:00	26765	49321	76086	2868	78954	135495	58.27%	19.75%	102	103
14	新竹縣竹北市	2018-11-24T22:57:48+08:00	8069	14577	22646	934	23580	41307	57.08%	19.53%	32	103
14	新竹縣竹北市	2018-11-25T03:38:50+08:00	27093	49966	77059	2904	79963	137129	58.31%	19.76%	103	103
14	新竹縣竹北市	2018-11-24T23:23:33+08:00	12175	22193	34368	1391	35759	61961	57.71%	19.65%	48	103
14	新竹縣竹北市	2018-11-24T23:51:29+08:00	15555	28238	43793	1716	45509	78656	57.86%	19.78%	61	103
14	新竹縣竹北市	2018-11-24T22:40:23+08:00	5414	10497	15911	655	16566	29244	56.65%	18.51%	23	103
14	新竹縣竹北市	2018-11-25T03:32:29+08:00	27093	49966	77059	2904	79963	137129	58.31%	19.76%	103	103
14	新竹縣竹北市	2018-11-25T06:18:52+08:00	27093	49966	77059	2904	79963	137129	58.31%	19.76%	103	103
14	新竹縣竹北市	2018-11-24T23:15:58+08:00	11908	21613	33521	1341	34862	60495	57.63%	19.68%	47	103
14	新竹縣竹北市	2018-11-25T00:57:31+08:00	25883	47778	73661	2800	76461	131132	58.31%	19.74%	99	103
14	新竹縣竹北市	2018-11-25T01:25:47+08:00	26765	49321	76086	2868	78954	135495	58.27%	19.75%	102	103
14	新竹縣竹北市	2018-11-25T03:56:06+08:00	27093	49966	77059	2904	79963	137129	58.31%	19.76%	103	103
14	新竹縣竹北市	2018-11-25T06:23:55+08:00	27093	49966	77059	2904	79963	137129	58.31%	19.76%	103	103
14	新竹縣竹北市	2018-11-24T23:12:10+08:00	10739	19484	30223	1240	31463	54646	57.58%	19.65%	42	103
14	新竹縣竹北市	2018-11-24T22:45:03+08:00	5620	10954	16574	695	17269	30449	56.71%	18.46%	24	103
14	新竹縣峨眉鄉	2018-11-25T04:02:44+08:00	689	2114	2803	253	3056	5068	60.3%	13.6%	8	8
14	新竹縣峨眉鄉	2018-11-25T01:12:37+08:00	689	2114	2803	253	3056	5068	60.3%	13.6%	8	8
14	新竹縣峨眉鄉	2018-11-25T00:14:04+08:00	501	1504	2005	193	2198	3662	60.02%	13.68%	7	8
14	新竹縣峨眉鄉	2018-11-24T23:31:05+08:00	501	1504	2005	193	2198	3662	60.02%	13.68%	7	8
14	新竹縣峨眉鄉	2018-11-25T01:07:21+08:00	689	2114	2803	253	3056	5068	60.3%	13.6%	8	8
14	新竹縣峨眉鄉	2018-11-25T06:29:11+08:00	689	2114	2803	253	3056	5068	60.3%	13.6%	8	8
14	新竹縣峨眉鄉	2018-11-25T00:09:28+08:00	501	1504	2005	193	2198	3662	60.02%	13.68%	7	8
14	新竹縣峨眉鄉	2018-11-24T22:23:07+08:00	501	1504	2005	193	2198	3662	60.02%	13.68%	7	8
14	新竹縣峨眉鄉	2018-11-25T00:00:03+08:00	501	1504	2005	193	2198	3662	60.02%	13.68%	7	8
14	新竹縣峨眉鄉	2018-11-24T23:08:30+08:00	501	1504	2005	193	2198	3662	60.02%	13.68%	7	8
14	新竹縣峨眉鄉	2018-11-24T23:19:44+08:00	501	1504	2005	193	2198	3662	60.02%	13.68%	7	8
14	新竹縣峨眉鄉	2018-11-24T22:13:21+08:00	391	1228	1619	148	1767	2979	59.32%	13.13%	6	8
14	新竹縣峨眉鄉	2018-11-25T03:32:30+08:00	689	2114	2803	253	3056	5068	60.3%	13.6%	8	8
14	新竹縣峨眉鄉	2018-11-24T23:51:30+08:00	501	1504	2005	193	2198	3662	60.02%	13.68%	7	8
14	新竹縣峨眉鄉	2018-11-24T22:30:01+08:00	501	1504	2005	193	2198	3662	60.02%	13.68%	7	8
14	新竹縣峨眉鄉	2018-11-24T23:27:14+08:00	501	1504	2005	193	2198	3662	60.02%	13.68%	7	8
14	新竹縣峨眉鄉	2018-11-24T22:19:32+08:00	501	1504	2005	193	2198	3662	60.02%	13.68%	7	8
14	新竹縣峨眉鄉	2018-11-25T00:57:32+08:00	689	2114	2803	253	3056	5068	60.3%	13.6%	8	8
14	新竹縣峨眉鄉	2018-11-24T22:36:56+08:00	501	1504	2005	193	2198	3662	60.02%	13.68%	7	8
14	新竹縣峨眉鄉	2018-11-25T01:02:25+08:00	689	2114	2803	253	3056	5068	60.3%	13.6%	8	8
14	新竹縣峨眉鄉	2018-11-25T00:18:25+08:00	501	1504	2005	193	2198	3662	60.02%	13.68%	7	8
14	新竹縣峨眉鄉	2018-11-24T23:05:00+08:00	501	1504	2005	193	2198	3662	60.02%	13.68%	7	8
14	新竹縣峨眉鄉	2018-11-24T22:26:32+08:00	501	1504	2005	193	2198	3662	60.02%	13.68%	7	8
14	新竹縣峨眉鄉	2018-11-25T06:13:48+08:00	689	2114	2803	253	3056	5068	60.3%	13.6%	8	8
14	新竹縣峨眉鄉	2018-11-24T22:50:42+08:00	501	1504	2005	193	2198	3662	60.02%	13.68%	7	8
14	新竹縣峨眉鄉	2018-11-24T22:54:21+08:00	501	1504	2005	193	2198	3662	60.02%	13.68%	7	8
14	新竹縣峨眉鄉	2018-11-25T00:05:00+08:00	501	1504	2005	193	2198	3662	60.02%	13.68%	7	8
14	新竹縣峨眉鄉	2018-11-24T22:41:30+08:00	501	1504	2005	193	2198	3662	60.02%	13.68%	7	8
14	新竹縣峨眉鄉	2018-11-25T00:22:59+08:00	501	1504	2005	193	2198	3662	60.02%	13.68%	7	8
14	新竹縣峨眉鄉	2018-11-25T03:49:46+08:00	689	2114	2803	253	3056	5068	60.3%	13.6%	8	8
14	新竹縣峨眉鄉	2018-11-24T22:16:05+08:00	391	1228	1619	148	1767	2979	59.32%	13.13%	6	8
14	新竹縣峨眉鄉	2018-11-24T23:01:26+08:00	501	1504	2005	193	2198	3662	60.02%	13.68%	7	8
14	新竹縣峨眉鄉	2018-11-24T23:43:12+08:00	501	1504	2005	193	2198	3662	60.02%	13.68%	7	8
14	新竹縣峨眉鄉	2018-11-24T22:33:33+08:00	501	1504	2005	193	2198	3662	60.02%	13.68%	7	8
14	新竹縣峨眉鄉	2018-11-25T06:08:47+08:00	689	2114	2803	253	3056	5068	60.3%	13.6%	8	8
14	新竹縣峨眉鄉	2018-11-24T23:35:06+08:00	501	1504	2005	193	2198	3662	60.02%	13.68%	7	8
14	新竹縣峨眉鄉	2018-11-24T23:47:23+08:00	501	1504	2005	193	2198	3662	60.02%	13.68%	7	8
14	新竹縣峨眉鄉	2018-11-24T23:55:42+08:00	501	1504	2005	193	2198	3662	60.02%	13.68%	7	8
14	新竹縣峨眉鄉	2018-11-25T01:17:46+08:00	689	2114	2803	253	3056	5068	60.3%	13.6%	8	8
14	新竹縣峨眉鄉	2018-11-24T22:57:48+08:00	501	1504	2005	193	2198	3662	60.02%	13.68%	7	8
14	新竹縣峨眉鄉	2018-11-25T03:38:50+08:00	689	2114	2803	253	3056	5068	60.3%	13.6%	8	8
14	新竹縣峨眉鄉	2018-11-24T23:23:34+08:00	501	1504	2005	193	2198	3662	60.02%	13.68%	7	8
14	新竹縣峨眉鄉	2018-11-25T03:44:17+08:00	689	2114	2803	253	3056	5068	60.3%	13.6%	8	8
14	新竹縣峨眉鄉	2018-11-25T01:25:48+08:00	689	2114	2803	253	3056	5068	60.3%	13.6%	8	8
14	新竹縣峨眉鄉	2018-11-24T22:40:23+08:00	501	1504	2005	193	2198	3662	60.02%	13.68%	7	8
14	新竹縣峨眉鄉	2018-11-24T23:15:58+08:00	501	1504	2005	193	2198	3662	60.02%	13.68%	7	8
14	新竹縣峨眉鄉	2018-11-25T06:18:53+08:00	689	2114	2803	253	3056	5068	60.3%	13.6%	8	8
14	新竹縣峨眉鄉	2018-11-25T03:56:06+08:00	689	2114	2803	253	3056	5068	60.3%	13.6%	8	8
14	新竹縣峨眉鄉	2018-11-25T06:23:55+08:00	689	2114	2803	253	3056	5068	60.3%	13.6%	8	8
14	新竹縣峨眉鄉	2018-11-24T23:39:10+08:00	501	1504	2005	193	2198	3662	60.02%	13.68%	7	8
14	新竹縣峨眉鄉	2018-11-24T22:45:04+08:00	501	1504	2005	193	2198	3662	60.02%	13.68%	7	8
14	新竹縣峨眉鄉	2018-11-24T23:12:10+08:00	501	1504	2005	193	2198	3662	60.02%	13.68%	7	8
14	基隆市七堵區	2018-11-24T22:33:39+08:00	4258	8635	12893	805	13698	25995	52.69%	16.38%	25	39
14	基隆市七堵區	2018-11-24T23:43:18+08:00	6579	13369	19948	1196	21144	39977	52.89%	16.46%	35	39
14	基隆市七堵區	2018-11-25T01:07:28+08:00	7825	15342	23167	1340	24507	46256	52.98%	16.92%	39	39
14	基隆市七堵區	2018-11-25T06:29:18+08:00	7825	15342	23167	1340	24507	46256	52.98%	16.92%	39	39
14	基隆市七堵區	2018-11-25T03:49:53+08:00	7825	15342	23167	1340	24507	46256	52.98%	16.92%	39	39
14	基隆市七堵區	2018-11-24T22:50:50+08:00	5003	10025	15028	960	15988	30243	52.87%	16.54%	28	39
14	基隆市七堵區	2018-11-25T06:13:54+08:00	7825	15342	23167	1340	24507	46256	52.98%	16.92%	39	39
14	基隆市七堵區	2018-11-24T22:13:29+08:00	3636	7360	10996	690	11686	22182	52.68%	16.39%	22	39
14	基隆市七堵區	2018-11-25T03:32:36+08:00	7825	15342	23167	1340	24507	46256	52.98%	16.92%	39	39
14	基隆市七堵區	2018-11-24T23:55:48+08:00	6579	13369	19948	1196	21144	39977	52.89%	16.46%	35	39
14	基隆市七堵區	2018-11-25T03:44:25+08:00	7825	15342	23167	1340	24507	46256	52.98%	16.92%	39	39
14	基隆市七堵區	2018-11-24T23:08:38+08:00	5921	11869	17790	1070	18860	35731	52.78%	16.57%	32	39
14	基隆市七堵區	2018-11-25T06:24:02+08:00	7825	15342	23167	1340	24507	46256	52.98%	16.92%	39	39
14	基隆市七堵區	2018-11-24T23:51:37+08:00	6579	13369	19948	1196	21144	39977	52.89%	16.46%	35	39
14	基隆市七堵區	2018-11-24T22:23:15+08:00	3779	7759	11538	723	12261	23181	52.89%	16.3%	23	39
14	基隆市七堵區	2018-11-24T22:40:29+08:00	4428	8992	13420	850	14270	26957	52.94%	16.43%	26	39
14	基隆市七堵區	2018-11-25T06:18:59+08:00	7825	15342	23167	1340	24507	46256	52.98%	16.92%	39	39
14	基隆市七堵區	2018-11-24T23:23:40+08:00	6182	12522	18704	1129	19833	37466	52.94%	16.5%	33	39
14	基隆市七堵區	2018-11-24T22:54:27+08:00	5471	10974	16445	1015	17460	32960	52.97%	16.6%	30	39
14	基隆市七堵區	2018-11-25T00:14:11+08:00	6579	13369	19948	1196	21144	39977	52.89%	16.46%	35	39
14	基隆市七堵區	2018-11-25T00:05:06+08:00	6579	13369	19948	1196	21144	39977	52.89%	16.46%	35	39
14	基隆市七堵區	2018-11-24T22:16:12+08:00	3636	7360	10996	690	11686	22182	52.68%	16.39%	22	39
14	基隆市七堵區	2018-11-24T22:41:37+08:00	4428	8992	13420	850	14270	26957	52.94%	16.43%	26	39
14	基隆市七堵區	2018-11-24T23:05:06+08:00	5702	11451	17153	1032	18185	34446	52.79%	16.55%	31	39
14	基隆市七堵區	2018-11-24T22:45:10+08:00	4722	9578	14300	922	15222	28731	52.98%	16.44%	27	39
14	基隆市七堵區	2018-11-25T03:56:14+08:00	7825	15342	23167	1340	24507	46256	52.98%	16.92%	39	39
14	基隆市七堵區	2018-11-24T22:37:02+08:00	4258	8635	12893	805	13698	25995	52.69%	16.38%	25	39
14	基隆市七堵區	2018-11-25T00:18:32+08:00	7213	14100	21313	1264	22577	42552	53.06%	16.95%	37	39
14	基隆市七堵區	2018-11-24T23:16:04+08:00	6182	12522	18704	1129	19833	37466	52.94%	16.5%	33	39
14	基隆市七堵區	2018-11-25T00:23:05+08:00	7213	14100	21313	1264	22577	42552	53.06%	16.95%	37	39
14	基隆市七堵區	2018-11-25T01:25:54+08:00	7825	15342	23167	1340	24507	46256	52.98%	16.92%	39	39
14	基隆市七堵區	2018-11-25T01:02:32+08:00	7825	15342	23167	1340	24507	46256	52.98%	16.92%	39	39
14	基隆市七堵區	2018-11-24T22:30:11+08:00	3961	8103	12064	767	12831	24273	52.86%	16.32%	24	39
14	基隆市七堵區	2018-11-25T03:38:56+08:00	7825	15342	23167	1340	24507	46256	52.98%	16.92%	39	39
14	基隆市七堵區	2018-11-24T22:19:38+08:00	3636	7360	10996	690	11686	22182	52.68%	16.39%	22	39
14	基隆市七堵區	2018-11-24T23:19:53+08:00	6182	12522	18704	1129	19833	37466	52.94%	16.5%	33	39
14	基隆市七堵區	2018-11-25T01:17:54+08:00	7825	15342	23167	1340	24507	46256	52.98%	16.92%	39	39
14	基隆市七堵區	2018-11-25T00:00:12+08:00	6579	13369	19948	1196	21144	39977	52.89%	16.46%	35	39
14	基隆市七堵區	2018-11-24T22:57:55+08:00	5702	11451	17153	1032	18185	34446	52.79%	16.55%	31	39
14	基隆市七堵區	2018-11-24T23:27:20+08:00	6392	12990	19382	1162	20544	38784	52.97%	16.48%	34	39
14	基隆市七堵區	2018-11-25T00:57:38+08:00	7825	15342	23167	1340	24507	46256	52.98%	16.92%	39	39
14	基隆市七堵區	2018-11-24T23:35:12+08:00	6392	12990	19382	1162	20544	38784	52.97%	16.48%	34	39
14	基隆市七堵區	2018-11-24T23:47:30+08:00	6579	13369	19948	1196	21144	39977	52.89%	16.46%	35	39
14	基隆市七堵區	2018-11-25T00:09:36+08:00	6579	13369	19948	1196	21144	39977	52.89%	16.46%	35	39
14	基隆市七堵區	2018-11-24T23:01:33+08:00	5702	11451	17153	1032	18185	34446	52.79%	16.55%	31	39
14	基隆市七堵區	2018-11-24T23:31:13+08:00	6392	12990	19382	1162	20544	38784	52.97%	16.48%	34	39
14	基隆市七堵區	2018-11-25T04:02:54+08:00	7825	15342	23167	1340	24507	46256	52.98%	16.92%	39	39
14	基隆市七堵區	2018-11-25T01:12:45+08:00	7825	15342	23167	1340	24507	46256	52.98%	16.92%	39	39
14	基隆市七堵區	2018-11-24T22:26:38+08:00	3961	8103	12064	767	12831	24273	52.86%	16.32%	24	39
14	基隆市七堵區	2018-11-24T23:12:17+08:00	6182	12522	18704	1129	19833	37466	52.94%	16.5%	33	39
14	基隆市七堵區	2018-11-24T23:39:18+08:00	6579	13369	19948	1196	21144	39977	52.89%	16.46%	35	39
14	基隆市七堵區	2018-11-25T06:08:55+08:00	7825	15342	23167	1340	24507	46256	52.98%	16.92%	39	39
14	臺北市中山區	2018-11-24T23:47:17+08:00	39696	61530	101226	4977	106203	185947	57.11%	21.35%	127	133
14	臺北市中山區	2018-11-24T22:26:28+08:00	28733	43867	72600	3595	76195	133613	57.03%	21.5%	92	133
14	臺北市中山區	2018-11-24T22:50:35+08:00	31786	48878	80664	3956	84620	148355	57.04%	21.43%	102	133
14	臺北市中山區	2018-11-25T01:12:31+08:00	41628	64606	106234	5201	111435	195148	57.1%	21.33%	133	133
14	臺北市中山區	2018-11-25T01:07:16+08:00	41628	64606	106234	5201	111435	195148	57.1%	21.33%	133	133
14	臺北市中山區	2018-11-24T22:19:27+08:00	28159	42946	71105	3543	74648	130885	57.03%	21.51%	90	133
14	臺北市中山區	2018-11-24T22:13:16+08:00	26364	40296	66660	3310	69970	123123	56.83%	21.41%	85	133
14	臺北市中山區	2018-11-24T22:57:42+08:00	31991	49279	81270	3984	85254	149353	57.08%	21.42%	103	133
14	臺北市中山區	2018-11-25T00:57:26+08:00	41259	64015	105274	5167	110441	193464	57.09%	21.33%	132	133
14	臺北市中山區	2018-11-24T23:51:25+08:00	39696	61530	101226	4977	106203	185947	57.11%	21.35%	127	133
14	臺北市中山區	2018-11-24T22:29:54+08:00	28996	44377	73373	3643	77016	135049	57.03%	21.47%	93	133
14	臺北市中山區	2018-11-24T23:27:09+08:00	35867	55275	91142	4515	95657	167628	57.07%	21.4%	115	133
14	臺北市中山區	2018-11-24T22:44:59+08:00	30705	47139	77844	3821	81665	142928	57.14%	21.48%	98	133
14	臺北市中山區	2018-11-24T22:23:01+08:00	28159	42946	71105	3543	74648	130885	57.03%	21.51%	90	133
14	臺北市中山區	2018-11-24T23:51:24+08:00	39696	61530	101226	4977	106203	185947	57.11%	21.35%	127	133
14	臺北市中山區	2018-11-24T23:15:52+08:00	34943	53689	88632	4381	93013	162972	57.07%	21.44%	112	133
14	臺北市中山區	2018-11-25T03:32:24+08:00	41628	64606	106234	5201	111435	195148	57.1%	21.33%	133	133
14	臺北市中山區	2018-11-25T03:38:46+08:00	41628	64606	106234	5201	111435	195148	57.1%	21.33%	133	133
14	臺北市中山區	2018-11-25T01:25:42+08:00	41628	64606	106234	5201	111435	195148	57.1%	21.33%	133	133
14	臺北市中山區	2018-11-24T23:55:36+08:00	40377	62610	102987	5058	108045	189119	57.13%	21.35%	129	133
14	臺北市中山區	2018-11-24T22:40:18+08:00	30314	46603	76917	3784	80701	141341	57.1%	21.45%	97	133
14	臺北市中山區	2018-11-24T23:08:24+08:00	33991	52332	86323	4237	90560	158749	57.05%	21.41%	109	133
14	臺北市中山區	2018-11-24T23:15:53+08:00	34943	53689	88632	4381	93013	162972	57.07%	21.44%	112	133
14	臺北市中山區	2018-11-24T23:59:57+08:00	40377	62610	102987	5058	108045	189119	57.13%	21.35%	129	133
14	臺北市中山區	2018-11-24T22:40:19+08:00	30314	46603	76917	3784	80701	141341	57.1%	21.45%	97	133
14	臺北市中山區	2018-11-24T23:55:37+08:00	40377	62610	102987	5058	108045	189119	57.13%	21.35%	129	133
14	臺北市中山區	2018-11-25T00:13:59+08:00	40928	63498	104426	5124	109550	192014	57.05%	21.32%	131	133
14	臺北市中山區	2018-11-24T22:36:51+08:00	30314	46603	76917	3784	80701	141341	57.1%	21.45%	97	133
14	臺北市中山區	2018-11-24T22:54:16+08:00	31786	48878	80664	3956	84620	148355	57.04%	21.43%	102	133
14	臺北市中山區	2018-11-25T06:29:05+08:00	41628	64606	106234	5201	111435	195148	57.1%	21.33%	133	133
14	臺北市中山區	2018-11-24T22:54:17+08:00	31786	48878	80664	3956	84620	148355	57.04%	21.43%	102	133
14	臺北市中山區	2018-11-25T06:23:50+08:00	41628	64606	106234	5201	111435	195148	57.1%	21.33%	133	133
14	臺北市中山區	2018-11-25T03:49:41+08:00	41628	64606	106234	5201	111435	195148	57.1%	21.33%	133	133
14	臺北市中山區	2018-11-24T23:39:02+08:00	37295	57606	94901	4667	99568	174565	57.04%	21.36%	120	133
14	臺北市中山區	2018-11-24T23:12:04+08:00	34628	53176	87804	4323	92127	161543	57.03%	21.44%	111	133
14	臺北市中山區	2018-11-25T06:08:41+08:00	41628	64606	106234	5201	111435	195148	57.1%	21.33%	133	133
14	臺北市中山區	2018-11-25T06:08:40+08:00	41628	64606	106234	5201	111435	195148	57.1%	21.33%	133	133
14	臺北市中山區	2018-11-25T00:09:22+08:00	40678	63091	103769	5104	108873	190699	57.09%	21.33%	130	133
14	臺北市中山區	2018-11-24T23:31:00+08:00	36398	56331	92729	4574	97303	170364	57.11%	21.36%	117	133
14	臺北市中山區	2018-11-24T23:39:03+08:00	37295	57606	94901	4667	99568	174565	57.04%	21.36%	120	133
14	臺北市中山區	2018-11-24T23:01:20+08:00	32919	50665	83584	4093	87677	153866	56.98%	21.39%	106	133
14	臺北市中山區	2018-11-24T22:50:36+08:00	31786	48878	80664	3956	84620	148355	57.04%	21.43%	102	133
14	臺北市中山區	2018-11-25T01:12:32+08:00	41628	64606	106234	5201	111435	195148	57.1%	21.33%	133	133
14	臺北市中山區	2018-11-24T22:41:26+08:00	30314	46603	76917	3784	80701	141341	57.1%	21.45%	97	133
14	臺北市中山區	2018-11-24T23:35:01+08:00	36398	56331	92729	4574	97303	170364	57.11%	21.36%	117	133
14	臺北市中山區	2018-11-24T23:04:54+08:00	33612	51766	85378	4185	89563	157096	57.01%	21.4%	108	133
14	臺北市中山區	2018-11-25T06:18:47+08:00	41628	64606	106234	5201	111435	195148	57.1%	21.33%	133	133
14	臺北市中山區	2018-11-25T00:04:55+08:00	40678	63091	103769	5104	108873	190699	57.09%	21.33%	130	133
14	臺北市中山區	2018-11-24T22:13:15+08:00	26364	40296	66660	3310	69970	123123	56.83%	21.41%	85	133
14	臺北市中山區	2018-11-25T06:18:48+08:00	41628	64606	106234	5201	111435	195148	57.1%	21.33%	133	133
14	臺北市中山區	2018-11-24T22:23:02+08:00	28159	42946	71105	3543	74648	130885	57.03%	21.51%	90	133
14	臺北市中山區	2018-11-25T03:44:10+08:00	41628	64606	106234	5201	111435	195148	57.1%	21.33%	133	133
14	臺北市中山區	2018-11-25T01:02:20+08:00	41628	64606	106234	5201	111435	195148	57.1%	21.33%	133	133
14	臺北市中山區	2018-11-25T03:38:45+08:00	41628	64606	106234	5201	111435	195148	57.1%	21.33%	133	133
14	臺北市中山區	2018-11-24T23:19:38+08:00	35305	54297	89602	4434	94036	164676	57.1%	21.44%	113	133
14	臺北市中山區	2018-11-24T23:23:29+08:00	35598	54873	90471	4478	94949	166261	57.11%	21.41%	114	133
14	臺北市中山區	2018-11-24T22:15:59+08:00	27402	41880	69282	3448	72730	127734	56.94%	21.45%	88	133
14	臺北市中山區	2018-11-25T01:17:39+08:00	41628	64606	106234	5201	111435	195148	57.1%	21.33%	133	133
14	臺北市中山區	2018-11-25T06:29:06+08:00	41628	64606	106234	5201	111435	195148	57.1%	21.33%	133	133
14	臺北市中山區	2018-11-24T22:33:28+08:00	29946	46018	75964	3746	79710	139687	57.06%	21.44%	96	133
14	臺北市中山區	2018-11-25T06:13:43+08:00	41628	64606	106234	5201	111435	195148	57.1%	21.33%	133	133
14	臺北市中山區	2018-11-24T23:43:07+08:00	38703	59931	98634	4827	103461	181328	57.06%	21.34%	124	133
14	臺北市中山區	2018-11-25T00:22:53+08:00	40928	63498	104426	5124	109550	192014	57.05%	21.32%	131	133
14	臺北市中山區	2018-11-25T03:56:00+08:00	41628	64606	106234	5201	111435	195148	57.1%	21.33%	133	133
14	臺北市中山區	2018-11-24T22:33:27+08:00	29946	46018	75964	3746	79710	139687	57.06%	21.44%	96	133
14	臺北市中山區	2018-11-25T03:49:42+08:00	41628	64606	106234	5201	111435	195148	57.1%	21.33%	133	133
14	臺北市中山區	2018-11-25T00:18:20+08:00	40928	63498	104426	5124	109550	192014	57.05%	21.32%	131	133
14	臺北市中山區	2018-11-25T06:13:42+08:00	41628	64606	106234	5201	111435	195148	57.1%	21.33%	133	133
14	臺北市中山區	2018-11-25T04:02:38+08:00	41628	64606	106234	5201	111435	195148	57.1%	21.33%	133	133
14	臺中市神岡區	2018-11-24T23:47:19+08:00	8920	21601	30521	2080	32601	54565	59.75%	16.35%	42	42
14	臺中市神岡區	2018-11-24T23:35:03+08:00	8920	21601	30521	2080	32601	54565	59.75%	16.35%	42	42
14	臺中市神岡區	2018-11-24T22:16:01+08:00	6697	16115	22812	1618	24430	40579	60.2%	16.5%	32	42
14	臺中市神岡區	2018-11-24T23:01:22+08:00	8177	19833	28010	1940	29950	50077	59.81%	16.33%	39	42
14	臺中市神岡區	2018-11-24T23:12:07+08:00	8419	20440	28859	1997	30856	51667	59.72%	16.29%	40	42
14	臺中市神岡區	2018-11-25T01:07:18+08:00	8920	21601	30521	2080	32601	54565	59.75%	16.35%	42	42
14	臺中市神岡區	2018-11-25T06:08:43+08:00	8920	21601	30521	2080	32601	54565	59.75%	16.35%	42	42
14	臺中市神岡區	2018-11-24T22:26:29+08:00	7312	17763	25075	1778	26853	44476	60.38%	16.44%	35	42
14	臺中市神岡區	2018-11-25T01:17:42+08:00	8920	21601	30521	2080	32601	54565	59.75%	16.35%	42	42
14	臺中市神岡區	2018-11-24T22:13:18+08:00	6697	16115	22812	1618	24430	40579	60.2%	16.5%	32	42
14	臺中市神岡區	2018-11-24T22:19:29+08:00	6921	16687	23608	1676	25284	41889	60.36%	16.52%	33	42
14	臺中市神岡區	2018-11-25T00:57:28+08:00	8920	21601	30521	2080	32601	54565	59.75%	16.35%	42	42
14	臺中市神岡區	2018-11-24T22:57:44+08:00	8177	19833	28010	1940	29950	50077	59.81%	16.33%	39	42
14	臺中市神岡區	2018-11-25T03:44:13+08:00	8920	21601	30521	2080	32601	54565	59.75%	16.35%	42	42
14	臺中市神岡區	2018-11-24T23:23:30+08:00	8920	21601	30521	2080	32601	54565	59.75%	16.35%	42	42
14	臺中市神岡區	2018-11-25T00:04:57+08:00	8920	21601	30521	2080	32601	54565	59.75%	16.35%	42	42
14	臺中市神岡區	2018-11-24T23:04:56+08:00	8177	19833	28010	1940	29950	50077	59.81%	16.33%	39	42
14	臺中市神岡區	2018-11-24T22:40:20+08:00	7741	18792	26533	1844	28377	47222	60.09%	16.39%	37	42
14	臺中市神岡區	2018-11-24T23:15:54+08:00	8663	21103	29766	2047	31813	53150	59.86%	16.3%	41	42
14	臺中市神岡區	2018-11-25T01:25:44+08:00	8920	21601	30521	2080	32601	54565	59.75%	16.35%	42	42
14	臺中市神岡區	2018-11-24T23:59:59+08:00	8920	21601	30521	2080	32601	54565	59.75%	16.35%	42	42
14	臺中市神岡區	2018-11-25T01:02:22+08:00	8920	21601	30521	2080	32601	54565	59.75%	16.35%	42	42
14	臺中市神岡區	2018-11-25T03:38:47+08:00	8920	21601	30521	2080	32601	54565	59.75%	16.35%	42	42
14	臺中市神岡區	2018-11-24T23:55:39+08:00	8920	21601	30521	2080	32601	54565	59.75%	16.35%	42	42
14	臺中市神岡區	2018-11-24T22:54:18+08:00	8177	19833	28010	1940	29950	50077	59.81%	16.33%	39	42
14	臺中市神岡區	2018-11-24T22:45:01+08:00	7985	19364	27349	1896	29245	48789	59.94%	16.37%	38	42
14	臺中市神岡區	2018-11-25T03:56:02+08:00	8920	21601	30521	2080	32601	54565	59.75%	16.35%	42	42
14	臺中市神岡區	2018-11-24T23:39:05+08:00	8920	21601	30521	2080	32601	54565	59.75%	16.35%	42	42
14	臺中市神岡區	2018-11-24T23:31:01+08:00	8920	21601	30521	2080	32601	54565	59.75%	16.35%	42	42
14	臺中市神岡區	2018-11-25T00:09:24+08:00	8920	21601	30521	2080	32601	54565	59.75%	16.35%	42	42
14	臺中市神岡區	2018-11-24T22:41:27+08:00	7741	18792	26533	1844	28377	47222	60.09%	16.39%	37	42
14	臺中市神岡區	2018-11-25T04:02:40+08:00	8920	21601	30521	2080	32601	54565	59.75%	16.35%	42	42
14	臺中市神岡區	2018-11-25T01:12:33+08:00	8920	21601	30521	2080	32601	54565	59.75%	16.35%	42	42
14	臺中市神岡區	2018-11-25T00:14:01+08:00	8920	21601	30521	2080	32601	54565	59.75%	16.35%	42	42
14	臺中市神岡區	2018-11-24T22:50:38+08:00	8177	19833	28010	1940	29950	50077	59.81%	16.33%	39	42
14	臺中市神岡區	2018-11-24T23:51:26+08:00	8920	21601	30521	2080	32601	54565	59.75%	16.35%	42	42
14	臺中市神岡區	2018-11-25T06:18:49+08:00	8920	21601	30521	2080	32601	54565	59.75%	16.35%	42	42
14	臺中市神岡區	2018-11-24T22:23:04+08:00	6921	16687	23608	1676	25284	41889	60.36%	16.52%	33	42
14	臺中市神岡區	2018-11-24T22:29:56+08:00	7533	18270	25803	1809	27612	45820	60.26%	16.44%	36	42
14	臺中市神岡區	2018-11-24T23:19:40+08:00	8663	21103	29766	2047	31813	53150	59.86%	16.3%	41	42
14	臺中市神岡區	2018-11-24T22:36:53+08:00	7741	18792	26533	1844	28377	47222	60.09%	16.39%	37	42
14	臺中市神岡區	2018-11-24T23:08:26+08:00	8419	20440	28859	1997	30856	51667	59.72%	16.29%	40	42
14	臺中市神岡區	2018-11-24T23:27:11+08:00	8920	21601	30521	2080	32601	54565	59.75%	16.35%	42	42
14	臺中市神岡區	2018-11-25T03:32:26+08:00	8920	21601	30521	2080	32601	54565	59.75%	16.35%	42	42
14	臺中市神岡區	2018-11-25T03:49:43+08:00	8920	21601	30521	2080	32601	54565	59.75%	16.35%	42	42
14	臺中市神岡區	2018-11-25T06:29:08+08:00	8920	21601	30521	2080	32601	54565	59.75%	16.35%	42	42
14	臺中市神岡區	2018-11-25T00:22:55+08:00	8920	21601	30521	2080	32601	54565	59.75%	16.35%	42	42
14	臺中市神岡區	2018-11-25T06:13:44+08:00	8920	21601	30521	2080	32601	54565	59.75%	16.35%	42	42
14	臺中市神岡區	2018-11-25T00:18:21+08:00	8920	21601	30521	2080	32601	54565	59.75%	16.35%	42	42
14	臺中市神岡區	2018-11-25T06:23:52+08:00	8920	21601	30521	2080	32601	54565	59.75%	16.35%	42	42
14	臺中市神岡區	2018-11-24T23:43:09+08:00	8920	21601	30521	2080	32601	54565	59.75%	16.35%	42	42
14	臺中市神岡區	2018-11-24T22:33:29+08:00	7741	18792	26533	1844	28377	47222	60.09%	16.39%	37	42
14	臺中市西屯區	2018-11-24T23:47:19+08:00	32661	64583	97244	4783	102027	175550	58.12%	18.6%	115	120
14	臺中市西屯區	2018-11-24T22:16:01+08:00	19650	39108	58758	2966	61724	106090	58.18%	18.52%	72	120
14	臺中市西屯區	2018-11-25T01:07:17+08:00	34071	67645	101716	4986	106702	183814	58.05%	18.54%	120	120
14	臺中市西屯區	2018-11-24T23:01:22+08:00	28113	55734	83847	4109	87956	151005	58.25%	18.62%	100	120
14	臺中市西屯區	2018-11-25T06:08:42+08:00	34071	67645	101716	4986	106702	183814	58.05%	18.54%	120	120
14	臺中市西屯區	2018-11-24T23:35:02+08:00	31386	62190	93576	4633	98209	168831	58.17%	18.59%	111	120
14	臺中市西屯區	2018-11-24T23:12:06+08:00	28698	56828	85526	4169	89695	154166	58.18%	18.61%	102	120
14	臺中市西屯區	2018-11-24T22:26:29+08:00	21557	42696	64253	3214	67467	116076	58.12%	18.57%	78	120
14	臺中市西屯區	2018-11-25T03:44:12+08:00	34071	67645	101716	4986	106702	183814	58.05%	18.54%	120	120
14	臺中市西屯區	2018-11-24T22:19:29+08:00	19650	39108	58758	2966	61724	106090	58.18%	18.52%	72	120
14	臺中市西屯區	2018-11-25T00:04:56+08:00	34071	67645	101716	4986	106702	183814	58.05%	18.54%	120	120
14	臺中市西屯區	2018-11-24T22:57:44+08:00	27798	55137	82935	4086	87021	149511	58.2%	18.59%	99	120
14	臺中市西屯區	2018-11-25T00:57:27+08:00	34071	67645	101716	4986	106702	183814	58.05%	18.54%	120	120
14	臺中市西屯區	2018-11-24T22:13:17+08:00	19013	37857	56870	2884	59754	102837	58.11%	18.49%	70	120
14	臺中市西屯區	2018-11-24T23:23:30+08:00	29910	59157	89067	4386	93453	160675	58.16%	18.62%	106	120
14	臺中市西屯區	2018-11-24T23:55:38+08:00	33234	65826	99060	4843	103903	178710	58.14%	18.6%	117	120
14	臺中市西屯區	2018-11-24T22:40:20+08:00	24038	47933	71971	3583	75554	130090	58.08%	18.48%	87	120
14	臺中市西屯區	2018-11-24T23:15:54+08:00	29327	58011	87338	4257	91595	157576	58.13%	18.61%	104	120
14	臺中市西屯區	2018-11-25T01:25:43+08:00	34071	67645	101716	4986	106702	183814	58.05%	18.54%	120	120
14	臺中市西屯區	2018-11-24T23:59:59+08:00	33234	65826	99060	4843	103903	178710	58.14%	18.6%	117	120
14	臺中市西屯區	2018-11-25T01:02:22+08:00	34071	67645	101716	4986	106702	183814	58.05%	18.54%	120	120
14	臺中市西屯區	2018-11-25T03:38:47+08:00	34071	67645	101716	4986	106702	183814	58.05%	18.54%	120	120
14	臺中市西屯區	2018-11-24T22:54:18+08:00	25871	51532	77403	3844	81247	139570	58.21%	18.54%	93	120
14	臺中市西屯區	2018-11-25T03:56:02+08:00	34071	67645	101716	4986	106702	183814	58.05%	18.54%	120	120
14	臺中市西屯區	2018-11-24T22:45:00+08:00	24594	49085	73679	3665	77344	133086	58.12%	18.48%	89	120
14	臺中市西屯區	2018-11-24T23:31:01+08:00	31010	61564	92574	4575	97149	167054	58.15%	18.56%	110	120
14	臺中市西屯區	2018-11-25T00:09:24+08:00	34071	67645	101716	4986	106702	183814	58.05%	18.54%	120	120
14	臺中市西屯區	2018-11-24T22:41:27+08:00	24038	47933	71971	3583	75554	130090	58.08%	18.48%	87	120
14	臺中市西屯區	2018-11-25T04:02:40+08:00	34071	67645	101716	4986	106702	183814	58.05%	18.54%	120	120
14	臺中市西屯區	2018-11-25T01:12:33+08:00	34071	67645	101716	4986	106702	183814	58.05%	18.54%	120	120
14	臺中市西屯區	2018-11-25T00:14:00+08:00	34071	67645	101716	4986	106702	183814	58.05%	18.54%	120	120
14	臺中市西屯區	2018-11-24T23:39:04+08:00	32054	63456	95510	4711	100221	172374	58.14%	18.6%	113	120
14	臺中市西屯區	2018-11-24T22:50:38+08:00	25569	50883	76452	3804	80256	137896	58.2%	18.54%	92	120
14	臺中市西屯區	2018-11-24T23:51:26+08:00	32894	65169	98063	4807	102870	176934	58.14%	18.59%	116	120
14	臺中市西屯區	2018-11-25T06:18:49+08:00	34071	67645	101716	4986	106702	183814	58.05%	18.54%	120	120
14	臺中市西屯區	2018-11-25T01:17:41+08:00	34071	67645	101716	4986	106702	183814	58.05%	18.54%	120	120
14	臺中市西屯區	2018-11-24T22:23:03+08:00	20252	40380	60632	3047	63679	109423	58.2%	18.51%	74	120
14	臺中市西屯區	2018-11-24T22:29:56+08:00	22313	44453	66766	3318	70084	120959	57.94%	18.45%	81	120
14	臺中市西屯區	2018-11-24T23:04:55+08:00	28396	56325	84721	4140	88861	152664	58.21%	18.6%	101	120
14	臺中市西屯區	2018-11-24T23:19:40+08:00	29910	59157	89067	4386	93453	160675	58.16%	18.62%	106	120
14	臺中市西屯區	2018-11-24T22:36:53+08:00	23691	47247	70938	3541	74479	128155	58.12%	18.49%	86	120
14	臺中市西屯區	2018-11-24T23:27:10+08:00	30209	59809	90018	4433	94451	162341	58.18%	18.61%	107	120
14	臺中市西屯區	2018-11-24T23:08:26+08:00	28396	56325	84721	4140	88861	152664	58.21%	18.6%	101	120
14	臺中市西屯區	2018-11-25T03:32:26+08:00	34071	67645	101716	4986	106702	183814	58.05%	18.54%	120	120
14	臺中市西屯區	2018-11-25T03:49:43+08:00	34071	67645	101716	4986	106702	183814	58.05%	18.54%	120	120
14	臺中市西屯區	2018-11-25T00:22:55+08:00	34071	67645	101716	4986	106702	183814	58.05%	18.54%	120	120
14	臺中市西屯區	2018-11-25T06:13:44+08:00	34071	67645	101716	4986	106702	183814	58.05%	18.54%	120	120
14	臺中市西屯區	2018-11-25T00:18:21+08:00	34071	67645	101716	4986	106702	183814	58.05%	18.54%	120	120
14	臺中市西屯區	2018-11-25T06:23:52+08:00	34071	67645	101716	4986	106702	183814	58.05%	18.54%	120	120
14	臺中市西屯區	2018-11-24T22:33:29+08:00	22841	45550	68391	3408	71799	123774	58.01%	18.45%	83	120
14	臺中市西屯區	2018-11-25T06:29:07+08:00	34071	67645	101716	4986	106702	183814	58.05%	18.54%	120	120
14	臺中市西屯區	2018-11-24T23:43:08+08:00	32326	64014	96340	4743	101083	173894	58.13%	18.59%	114	120
14	臺南市歸仁區	2018-11-24T23:35:04+08:00	9985	18947	28932	1603	30535	57387	53.21%	17.4%	46	46
14	臺南市歸仁區	2018-11-24T23:47:21+08:00	9985	18947	28932	1603	30535	57387	53.21%	17.4%	46	46
14	臺南市歸仁區	2018-11-25T01:07:19+08:00	9985	18947	28932	1603	30535	57387	53.21%	17.4%	46	46
14	臺南市歸仁區	2018-11-24T22:33:31+08:00	9527	18047	27574	1554	29128	54646	53.3%	17.43%	44	46
14	臺南市歸仁區	2018-11-25T00:14:02+08:00	9985	18947	28932	1603	30535	57387	53.21%	17.4%	46	46
14	臺南市歸仁區	2018-11-25T04:02:42+08:00	9985	18947	28932	1603	30535	57387	53.21%	17.4%	46	46
14	臺南市歸仁區	2018-11-24T23:43:10+08:00	9985	18947	28932	1603	30535	57387	53.21%	17.4%	46	46
14	臺南市歸仁區	2018-11-25T06:08:44+08:00	9985	18947	28932	1603	30535	57387	53.21%	17.4%	46	46
14	臺南市歸仁區	2018-11-25T00:09:26+08:00	9985	18947	28932	1603	30535	57387	53.21%	17.4%	46	46
14	臺南市歸仁區	2018-11-24T23:12:08+08:00	9985	18947	28932	1603	30535	57387	53.21%	17.4%	46	46
14	臺南市歸仁區	2018-11-24T23:39:07+08:00	9985	18947	28932	1603	30535	57387	53.21%	17.4%	46	46
14	臺南市歸仁區	2018-11-24T23:31:03+08:00	9985	18947	28932	1603	30535	57387	53.21%	17.4%	46	46
14	臺南市歸仁區	2018-11-24T23:01:24+08:00	9985	18947	28932	1603	30535	57387	53.21%	17.4%	46	46
14	臺南市歸仁區	2018-11-24T23:19:42+08:00	9985	18947	28932	1603	30535	57387	53.21%	17.4%	46	46
14	臺南市歸仁區	2018-11-25T00:04:58+08:00	9985	18947	28932	1603	30535	57387	53.21%	17.4%	46	46
14	臺南市歸仁區	2018-11-24T23:04:57+08:00	9985	18947	28932	1603	30535	57387	53.21%	17.4%	46	46
14	臺南市歸仁區	2018-11-25T00:57:29+08:00	9985	18947	28932	1603	30535	57387	53.21%	17.4%	46	46
14	臺南市歸仁區	2018-11-24T22:13:19+08:00	9050	17141	26191	1464	27655	52004	53.18%	17.4%	42	46
14	臺南市歸仁區	2018-11-25T03:44:14+08:00	9985	18947	28932	1603	30535	57387	53.21%	17.4%	46	46
14	臺南市歸仁區	2018-11-25T01:17:43+08:00	9985	18947	28932	1603	30535	57387	53.21%	17.4%	46	46
14	臺南市歸仁區	2018-11-24T23:55:40+08:00	9985	18947	28932	1603	30535	57387	53.21%	17.4%	46	46
14	臺南市歸仁區	2018-11-25T06:18:51+08:00	9985	18947	28932	1603	30535	57387	53.21%	17.4%	46	46
14	臺南市歸仁區	2018-11-25T01:02:23+08:00	9985	18947	28932	1603	30535	57387	53.21%	17.4%	46	46
14	臺南市歸仁區	2018-11-25T01:25:45+08:00	9985	18947	28932	1603	30535	57387	53.21%	17.4%	46	46
14	臺南市歸仁區	2018-11-25T03:38:48+08:00	9985	18947	28932	1603	30535	57387	53.21%	17.4%	46	46
14	臺南市歸仁區	2018-11-24T23:27:12+08:00	9985	18947	28932	1603	30535	57387	53.21%	17.4%	46	46
14	臺南市歸仁區	2018-11-25T00:18:23+08:00	9985	18947	28932	1603	30535	57387	53.21%	17.4%	46	46
14	臺南市歸仁區	2018-11-24T22:54:19+08:00	9985	18947	28932	1603	30535	57387	53.21%	17.4%	46	46
14	臺南市歸仁區	2018-11-25T06:13:46+08:00	9985	18947	28932	1603	30535	57387	53.21%	17.4%	46	46
14	臺南市歸仁區	2018-11-25T00:22:57+08:00	9985	18947	28932	1603	30535	57387	53.21%	17.4%	46	46
14	臺南市歸仁區	2018-11-25T03:56:04+08:00	9985	18947	28932	1603	30535	57387	53.21%	17.4%	46	46
14	臺南市歸仁區	2018-11-24T22:41:29+08:00	9985	18947	28932	1603	30535	57387	53.21%	17.4%	46	46
14	臺南市歸仁區	2018-11-24T22:16:03+08:00	9239	17517	26756	1516	28272	53132	53.21%	17.39%	43	46
14	臺南市歸仁區	2018-11-25T01:12:35+08:00	9985	18947	28932	1603	30535	57387	53.21%	17.4%	46	46
14	臺南市歸仁區	2018-11-24T22:29:59+08:00	9527	18047	27574	1554	29128	54646	53.3%	17.43%	44	46
14	臺南市歸仁區	2018-11-24T23:23:32+08:00	9985	18947	28932	1603	30535	57387	53.21%	17.4%	46	46
14	臺南市歸仁區	2018-11-24T23:51:28+08:00	9985	18947	28932	1603	30535	57387	53.21%	17.4%	46	46
14	臺南市歸仁區	2018-11-24T22:57:46+08:00	9985	18947	28932	1603	30535	57387	53.21%	17.4%	46	46
14	臺南市歸仁區	2018-11-25T00:00:01+08:00	9985	18947	28932	1603	30535	57387	53.21%	17.4%	46	46
14	臺南市歸仁區	2018-11-24T22:23:05+08:00	9527	18047	27574	1554	29128	54646	53.3%	17.43%	44	46
14	臺南市歸仁區	2018-11-24T22:36:54+08:00	9985	18947	28932	1603	30535	57387	53.21%	17.4%	46	46
14	臺南市歸仁區	2018-11-24T23:15:56+08:00	9985	18947	28932	1603	30535	57387	53.21%	17.4%	46	46
14	臺南市歸仁區	2018-11-24T23:08:28+08:00	9985	18947	28932	1603	30535	57387	53.21%	17.4%	46	46
14	臺南市歸仁區	2018-11-25T03:32:27+08:00	9985	18947	28932	1603	30535	57387	53.21%	17.4%	46	46
14	臺南市歸仁區	2018-11-24T22:40:22+08:00	9985	18947	28932	1603	30535	57387	53.21%	17.4%	46	46
14	臺南市歸仁區	2018-11-24T22:19:30+08:00	9239	17517	26756	1516	28272	53132	53.21%	17.39%	43	46
14	臺南市歸仁區	2018-11-24T22:45:02+08:00	9985	18947	28932	1603	30535	57387	53.21%	17.4%	46	46
14	臺南市歸仁區	2018-11-24T22:50:40+08:00	9985	18947	28932	1603	30535	57387	53.21%	17.4%	46	46
14	臺南市歸仁區	2018-11-25T03:49:45+08:00	9985	18947	28932	1603	30535	57387	53.21%	17.4%	46	46
14	臺南市歸仁區	2018-11-25T06:29:09+08:00	9985	18947	28932	1603	30535	57387	53.21%	17.4%	46	46
14	臺南市歸仁區	2018-11-25T06:23:53+08:00	9985	18947	28932	1603	30535	57387	53.21%	17.4%	46	46
14	臺南市歸仁區	2018-11-24T22:26:31+08:00	9527	18047	27574	1554	29128	54646	53.3%	17.43%	44	46
14	臺中市石岡區	2018-11-24T23:35:03+08:00	1890	5229	7119	531	7650	12880	59.39%	14.67%	10	10
14	臺中市石岡區	2018-11-24T22:16:01+08:00	1890	5229	7119	531	7650	12880	59.39%	14.67%	10	10
14	臺中市石岡區	2018-11-24T23:31:02+08:00	1890	5229	7119	531	7650	12880	59.39%	14.67%	10	10
14	臺中市石岡區	2018-11-24T23:01:22+08:00	1890	5229	7119	531	7650	12880	59.39%	14.67%	10	10
14	臺中市石岡區	2018-11-24T23:12:07+08:00	1890	5229	7119	531	7650	12880	59.39%	14.67%	10	10
14	臺中市石岡區	2018-11-24T23:47:20+08:00	1890	5229	7119	531	7650	12880	59.39%	14.67%	10	10
14	臺中市石岡區	2018-11-25T01:07:18+08:00	1890	5229	7119	531	7650	12880	59.39%	14.67%	10	10
14	臺中市石岡區	2018-11-25T06:08:43+08:00	1890	5229	7119	531	7650	12880	59.39%	14.67%	10	10
14	臺中市石岡區	2018-11-24T22:26:29+08:00	1890	5229	7119	531	7650	12880	59.39%	14.67%	10	10
14	臺中市石岡區	2018-11-25T01:17:42+08:00	1890	5229	7119	531	7650	12880	59.39%	14.67%	10	10
14	臺中市石岡區	2018-11-24T22:13:18+08:00	1890	5229	7119	531	7650	12880	59.39%	14.67%	10	10
14	臺中市石岡區	2018-11-24T22:19:29+08:00	1890	5229	7119	531	7650	12880	59.39%	14.67%	10	10
14	臺中市石岡區	2018-11-25T00:57:28+08:00	1890	5229	7119	531	7650	12880	59.39%	14.67%	10	10
14	臺中市石岡區	2018-11-24T23:23:31+08:00	1890	5229	7119	531	7650	12880	59.39%	14.67%	10	10
14	臺中市石岡區	2018-11-24T22:57:44+08:00	1890	5229	7119	531	7650	12880	59.39%	14.67%	10	10
14	臺中市石岡區	2018-11-25T03:44:13+08:00	1890	5229	7119	531	7650	12880	59.39%	14.67%	10	10
14	臺中市石岡區	2018-11-25T00:04:57+08:00	1890	5229	7119	531	7650	12880	59.39%	14.67%	10	10
14	臺中市石岡區	2018-11-24T23:04:56+08:00	1890	5229	7119	531	7650	12880	59.39%	14.67%	10	10
14	臺中市石岡區	2018-11-24T23:15:55+08:00	1890	5229	7119	531	7650	12880	59.39%	14.67%	10	10
14	臺中市石岡區	2018-11-24T22:40:20+08:00	1890	5229	7119	531	7650	12880	59.39%	14.67%	10	10
14	臺中市石岡區	2018-11-25T01:25:44+08:00	1890	5229	7119	531	7650	12880	59.39%	14.67%	10	10
14	臺中市石岡區	2018-11-25T01:02:22+08:00	1890	5229	7119	531	7650	12880	59.39%	14.67%	10	10
14	臺中市石岡區	2018-11-25T03:38:47+08:00	1890	5229	7119	531	7650	12880	59.39%	14.67%	10	10
14	臺中市石岡區	2018-11-24T23:55:39+08:00	1890	5229	7119	531	7650	12880	59.39%	14.67%	10	10
14	臺中市石岡區	2018-11-24T22:54:18+08:00	1890	5229	7119	531	7650	12880	59.39%	14.67%	10	10
14	臺中市石岡區	2018-11-24T22:45:01+08:00	1890	5229	7119	531	7650	12880	59.39%	14.67%	10	10
14	臺中市石岡區	2018-11-25T00:18:22+08:00	1890	5229	7119	531	7650	12880	59.39%	14.67%	10	10
14	臺中市石岡區	2018-11-25T00:22:56+08:00	1890	5229	7119	531	7650	12880	59.39%	14.67%	10	10
14	臺中市石岡區	2018-11-25T03:56:02+08:00	1890	5229	7119	531	7650	12880	59.39%	14.67%	10	10
14	臺中市石岡區	2018-11-24T23:39:05+08:00	1890	5229	7119	531	7650	12880	59.39%	14.67%	10	10
14	臺中市石岡區	2018-11-25T00:09:24+08:00	1890	5229	7119	531	7650	12880	59.39%	14.67%	10	10
14	臺中市石岡區	2018-11-25T01:12:34+08:00	1890	5229	7119	531	7650	12880	59.39%	14.67%	10	10
14	臺中市石岡區	2018-11-24T22:41:27+08:00	1890	5229	7119	531	7650	12880	59.39%	14.67%	10	10
14	臺中市石岡區	2018-11-25T04:02:40+08:00	1890	5229	7119	531	7650	12880	59.39%	14.67%	10	10
14	臺中市石岡區	2018-11-25T00:14:01+08:00	1890	5229	7119	531	7650	12880	59.39%	14.67%	10	10
14	臺中市石岡區	2018-11-24T22:50:38+08:00	1890	5229	7119	531	7650	12880	59.39%	14.67%	10	10
14	臺中市石岡區	2018-11-24T23:51:26+08:00	1890	5229	7119	531	7650	12880	59.39%	14.67%	10	10
14	臺中市石岡區	2018-11-25T00:00:00+08:00	1890	5229	7119	531	7650	12880	59.39%	14.67%	10	10
14	臺中市石岡區	2018-11-25T06:18:49+08:00	1890	5229	7119	531	7650	12880	59.39%	14.67%	10	10
14	臺中市石岡區	2018-11-24T22:23:04+08:00	1890	5229	7119	531	7650	12880	59.39%	14.67%	10	10
14	臺中市石岡區	2018-11-24T22:29:56+08:00	1890	5229	7119	531	7650	12880	59.39%	14.67%	10	10
14	臺中市石岡區	2018-11-24T23:19:40+08:00	1890	5229	7119	531	7650	12880	59.39%	14.67%	10	10
14	臺中市石岡區	2018-11-24T22:36:53+08:00	1890	5229	7119	531	7650	12880	59.39%	14.67%	10	10
14	臺中市石岡區	2018-11-24T23:27:11+08:00	1890	5229	7119	531	7650	12880	59.39%	14.67%	10	10
14	臺中市石岡區	2018-11-24T23:08:27+08:00	1890	5229	7119	531	7650	12880	59.39%	14.67%	10	10
14	臺中市石岡區	2018-11-25T03:32:26+08:00	1890	5229	7119	531	7650	12880	59.39%	14.67%	10	10
14	臺中市石岡區	2018-11-25T03:49:43+08:00	1890	5229	7119	531	7650	12880	59.39%	14.67%	10	10
14	臺中市石岡區	2018-11-25T06:29:08+08:00	1890	5229	7119	531	7650	12880	59.39%	14.67%	10	10
14	臺中市石岡區	2018-11-25T06:13:44+08:00	1890	5229	7119	531	7650	12880	59.39%	14.67%	10	10
14	臺中市石岡區	2018-11-25T06:23:52+08:00	1890	5229	7119	531	7650	12880	59.39%	14.67%	10	10
14	臺中市石岡區	2018-11-24T23:43:09+08:00	1890	5229	7119	531	7650	12880	59.39%	14.67%	10	10
14	臺中市石岡區	2018-11-24T22:33:29+08:00	1890	5229	7119	531	7650	12880	59.39%	14.67%	10	10
14	臺東縣	2018-11-25T06:29:17+08:00	23365	65685	89050	6940	95990	185996	51.61%	12.56%	213	213
14	臺東縣	2018-11-25T00:18:30+08:00	21916	61406	83322	6622	89944	174939	51.41%	12.53%	206	213
14	臺東縣	2018-11-25T01:07:26+08:00	22656	63636	86292	6791	93083	180678	51.52%	12.54%	210	213
14	臺東縣	2018-11-24T23:47:29+08:00	19892	56080	75972	6235	82207	159258	51.62%	12.49%	195	213
14	臺東縣	2018-11-24T22:33:38+08:00	12207	34815	47022	4116	51138	102344	49.97%	11.93%	148	213
14	臺東縣	2018-11-25T06:13:53+08:00	23365	65685	89050	6940	95990	185996	51.61%	12.56%	213	213
14	臺東縣	2018-11-24T23:43:17+08:00	19746	55697	75443	6195	81638	158026	51.66%	12.5%	194	213
14	臺東縣	2018-11-24T22:37:01+08:00	13241	37627	50868	4421	55289	110051	50.24%	12.03%	155	213
14	臺東縣	2018-11-25T03:44:23+08:00	23365	65685	89050	6940	95990	185996	51.61%	12.56%	213	213
14	臺東縣	2018-11-24T22:13:27+08:00	10826	31084	41910	3670	45580	91505	49.81%	11.83%	137	213
14	臺東縣	2018-11-25T01:02:31+08:00	22656	63636	86292	6791	93083	180678	51.52%	12.54%	210	213
14	臺東縣	2018-11-25T03:38:55+08:00	23365	65685	89050	6940	95990	185996	51.61%	12.56%	213	213
14	臺東縣	2018-11-24T23:55:47+08:00	20685	58293	78978	6398	85376	165584	51.56%	12.49%	199	213
14	臺東縣	2018-11-24T23:08:36+08:00	16433	46936	63369	5435	68804	134646	51.1%	12.2%	176	213
14	臺東縣	2018-11-24T23:23:39+08:00	17026	48629	65655	5630	71285	138994	51.29%	12.25%	180	213
14	臺東縣	2018-11-25T00:00:11+08:00	21222	59646	80868	6484	87352	169594	51.51%	12.51%	202	213
14	臺東縣	2018-11-24T23:51:36+08:00	20133	56759	76892	6268	83160	160896	51.69%	12.51%	196	213
14	臺東縣	2018-11-25T06:18:57+08:00	23365	65685	89050	6940	95990	185996	51.61%	12.56%	213	213
14	臺東縣	2018-11-24T22:30:09+08:00	12074	34524	46598	4103	50701	101405	50%	11.91%	147	213
14	臺東縣	2018-11-24T22:40:28+08:00	13336	37905	51241	4447	55688	110652	50.33%	12.05%	156	213
14	臺東縣	2018-11-24T22:23:13+08:00	11350	32508	43858	3843	47701	95534	49.93%	11.88%	141	213
14	臺東縣	2018-11-24T23:35:11+08:00	18307	52167	70474	5895	76369	148314	51.49%	12.34%	186	213
14	臺東縣	2018-11-24T23:01:31+08:00	15421	43941	59362	4974	64336	126359	50.92%	12.2%	170	213
14	臺東縣	2018-11-24T22:45:09+08:00	13725	38930	52655	4518	57173	113483	50.38%	12.09%	159	213
14	臺東縣	2018-11-25T00:09:34+08:00	21581	60588	82169	6586	88755	172351	51.5%	12.52%	204	213
14	臺東縣	2018-11-24T22:54:26+08:00	14573	41499	56072	4723	60795	119886	50.71%	12.16%	164	213
14	臺東縣	2018-11-25T00:14:10+08:00	21581	60588	82169	6586	88755	172351	51.5%	12.52%	204	213
14	臺東縣	2018-11-25T03:56:13+08:00	23365	65685	89050	6940	95990	185996	51.61%	12.56%	213	213
14	臺東縣	2018-11-25T03:49:51+08:00	23365	65685	89050	6940	95990	185996	51.61%	12.56%	213	213
14	臺東縣	2018-11-24T23:16:03+08:00	16673	47771	64444	5551	69995	136879	51.14%	12.18%	178	213
14	臺東縣	2018-11-25T03:32:35+08:00	23365	65685	89050	6940	95990	185996	51.61%	12.56%	213	213
14	臺東縣	2018-11-25T06:24:00+08:00	23365	65685	89050	6940	95990	185996	51.61%	12.56%	213	213
14	臺東縣	2018-11-25T01:25:53+08:00	22780	63976	86756	6824	93580	181736	51.49%	12.53%	211	213
14	臺東縣	2018-11-25T00:23:04+08:00	21916	61406	83322	6622	89944	174939	51.41%	12.53%	206	213
14	臺東縣	2018-11-24T23:27:19+08:00	17026	48629	65655	5630	71285	138994	51.29%	12.25%	180	213
14	臺東縣	2018-11-25T00:57:37+08:00	22656	63636	86292	6791	93083	180678	51.52%	12.54%	210	213
14	臺東縣	2018-11-24T22:57:54+08:00	15048	42852	57900	4881	62781	123649	50.77%	12.17%	168	213
14	臺東縣	2018-11-25T01:17:53+08:00	22656	63636	86292	6791	93083	180678	51.52%	12.54%	210	213
14	臺東縣	2018-11-24T22:19:37+08:00	11350	32508	43858	3843	47701	95534	49.93%	11.88%	141	213
14	臺東縣	2018-11-24T23:19:52+08:00	16901	48388	65289	5603	70892	138474	51.2%	12.21%	179	213
14	臺東縣	2018-11-24T22:41:35+08:00	13336	37905	51241	4447	55688	110652	50.33%	12.05%	156	213
14	臺東縣	2018-11-25T00:05:05+08:00	21581	60588	82169	6586	88755	172351	51.5%	12.52%	204	213
14	臺東縣	2018-11-25T04:02:52+08:00	23365	65685	89050	6940	95990	185996	51.61%	12.56%	213	213
14	臺東縣	2018-11-24T23:12:16+08:00	16433	46936	63369	5435	68804	134646	51.1%	12.2%	176	213
14	臺東縣	2018-11-25T06:08:53+08:00	23365	65685	89050	6940	95990	185996	51.61%	12.56%	213	213
14	臺東縣	2018-11-25T01:12:43+08:00	22656	63636	86292	6791	93083	180678	51.52%	12.54%	210	213
14	臺東縣	2018-11-24T22:26:37+08:00	11846	33916	45762	3989	49751	99633	49.93%	11.89%	145	213
14	臺東縣	2018-11-24T23:05:05+08:00	16158	45906	62064	5269	67333	131776	51.1%	12.26%	174	213
14	臺東縣	2018-11-24T22:50:48+08:00	14353	40841	55194	4682	59876	118396	50.57%	12.12%	163	213
14	臺東縣	2018-11-24T23:31:12+08:00	17934	51005	68939	5810	74749	145133	51.5%	12.36%	184	213
14	臺東縣	2018-11-24T22:16:11+08:00	11120	31853	42973	3753	46726	93681	49.88%	11.87%	139	213
14	臺東縣	2018-11-24T23:39:16+08:00	18542	52746	71288	5923	77211	149677	51.59%	12.39%	187	213
14	臺東縣大武鄉	2018-11-25T06:29:17+08:00	621	1713	2334	376	2710	5266	51.46%	11.79%	6	6
14	臺東縣大武鄉	2018-11-25T03:49:52+08:00	621	1713	2334	376	2710	5266	51.46%	11.79%	6	6
14	臺東縣大武鄉	2018-11-24T23:47:29+08:00	621	1713	2334	376	2710	5266	51.46%	11.79%	6	6
14	臺東縣大武鄉	2018-11-24T22:33:38+08:00	246	692	938	163	1101	2090	52.68%	11.77%	3	6
14	臺東縣大武鄉	2018-11-25T01:07:27+08:00	621	1713	2334	376	2710	5266	51.46%	11.79%	6	6
14	臺東縣大武鄉	2018-11-25T06:13:53+08:00	621	1713	2334	376	2710	5266	51.46%	11.79%	6	6
14	臺東縣大武鄉	2018-11-24T23:43:17+08:00	621	1713	2334	376	2710	5266	51.46%	11.79%	6	6
14	臺東縣大武鄉	2018-11-25T00:18:31+08:00	621	1713	2334	376	2710	5266	51.46%	11.79%	6	6
14	臺東縣大武鄉	2018-11-24T22:37:01+08:00	246	692	938	163	1101	2090	52.68%	11.77%	3	6
14	臺東縣大武鄉	2018-11-24T22:13:27+08:00	75	242	317	76	393	763	51.51%	9.83%	2	6
14	臺東縣大武鄉	2018-11-25T03:44:24+08:00	621	1713	2334	376	2710	5266	51.46%	11.79%	6	6
14	臺東縣大武鄉	2018-11-24T23:08:37+08:00	483	1387	1870	305	2175	4132	52.64%	11.69%	5	6
14	臺東縣大武鄉	2018-11-25T03:38:55+08:00	621	1713	2334	376	2710	5266	51.46%	11.79%	6	6
14	臺東縣大武鄉	2018-11-24T23:55:47+08:00	621	1713	2334	376	2710	5266	51.46%	11.79%	6	6
14	臺東縣大武鄉	2018-11-24T23:23:39+08:00	483	1387	1870	305	2175	4132	52.64%	11.69%	5	6
14	臺東縣大武鄉	2018-11-25T06:18:58+08:00	621	1713	2334	376	2710	5266	51.46%	11.79%	6	6
14	臺東縣大武鄉	2018-11-25T00:00:11+08:00	621	1713	2334	376	2710	5266	51.46%	11.79%	6	6
14	臺東縣大武鄉	2018-11-24T23:51:36+08:00	621	1713	2334	376	2710	5266	51.46%	11.79%	6	6
14	臺東縣大武鄉	2018-11-24T22:23:14+08:00	75	242	317	76	393	763	51.51%	9.83%	2	6
14	臺東縣大武鄉	2018-11-24T22:40:28+08:00	246	692	938	163	1101	2090	52.68%	11.77%	3	6
14	臺東縣大武鄉	2018-11-25T00:09:35+08:00	621	1713	2334	376	2710	5266	51.46%	11.79%	6	6
14	臺東縣大武鄉	2018-11-25T00:05:06+08:00	621	1713	2334	376	2710	5266	51.46%	11.79%	6	6
14	臺東縣大武鄉	2018-11-24T23:35:11+08:00	483	1387	1870	305	2175	4132	52.64%	11.69%	5	6
14	臺東縣大武鄉	2018-11-24T22:41:36+08:00	246	692	938	163	1101	2090	52.68%	11.77%	3	6
14	臺東縣大武鄉	2018-11-24T23:01:31+08:00	298	945	1243	201	1444	2658	54.33%	11.21%	4	6
14	臺東縣大武鄉	2018-11-24T22:45:09+08:00	246	692	938	163	1101	2090	52.68%	11.77%	3	6
14	臺東縣大武鄉	2018-11-24T22:54:26+08:00	298	945	1243	201	1444	2658	54.33%	11.21%	4	6
14	臺東縣大武鄉	2018-11-25T00:14:10+08:00	621	1713	2334	376	2710	5266	51.46%	11.79%	6	6
14	臺東縣大武鄉	2018-11-25T03:56:13+08:00	621	1713	2334	376	2710	5266	51.46%	11.79%	6	6
14	臺東縣大武鄉	2018-11-24T23:16:03+08:00	483	1387	1870	305	2175	4132	52.64%	11.69%	5	6
14	臺東縣大武鄉	2018-11-25T03:32:35+08:00	621	1713	2334	376	2710	5266	51.46%	11.79%	6	6
14	臺東縣大武鄉	2018-11-25T01:25:53+08:00	621	1713	2334	376	2710	5266	51.46%	11.79%	6	6
14	臺東縣大武鄉	2018-11-25T01:02:32+08:00	621	1713	2334	376	2710	5266	51.46%	11.79%	6	6
14	臺東縣大武鄉	2018-11-24T22:30:10+08:00	75	242	317	76	393	763	51.51%	9.83%	2	6
14	臺東縣大武鄉	2018-11-25T00:23:04+08:00	621	1713	2334	376	2710	5266	51.46%	11.79%	6	6
14	臺東縣大武鄉	2018-11-25T06:24:01+08:00	621	1713	2334	376	2710	5266	51.46%	11.79%	6	6
14	臺東縣大武鄉	2018-11-24T23:27:19+08:00	483	1387	1870	305	2175	4132	52.64%	11.69%	5	6
14	臺東縣大武鄉	2018-11-25T00:57:37+08:00	621	1713	2334	376	2710	5266	51.46%	11.79%	6	6
14	臺東縣大武鄉	2018-11-24T22:57:54+08:00	298	945	1243	201	1444	2658	54.33%	11.21%	4	6
14	臺東縣大武鄉	2018-11-25T01:17:53+08:00	621	1713	2334	376	2710	5266	51.46%	11.79%	6	6
14	臺東縣大武鄉	2018-11-24T22:19:37+08:00	75	242	317	76	393	763	51.51%	9.83%	2	6
14	臺東縣大武鄉	2018-11-24T23:19:52+08:00	483	1387	1870	305	2175	4132	52.64%	11.69%	5	6
14	臺東縣大武鄉	2018-11-25T06:08:54+08:00	621	1713	2334	376	2710	5266	51.46%	11.79%	6	6
14	臺東縣大武鄉	2018-11-24T23:12:16+08:00	483	1387	1870	305	2175	4132	52.64%	11.69%	5	6
14	臺東縣大武鄉	2018-11-24T23:39:17+08:00	483	1387	1870	305	2175	4132	52.64%	11.69%	5	6
14	臺東縣大武鄉	2018-11-25T01:12:44+08:00	621	1713	2334	376	2710	5266	51.46%	11.79%	6	6
14	臺東縣大武鄉	2018-11-24T22:50:49+08:00	298	945	1243	201	1444	2658	54.33%	11.21%	4	6
14	臺東縣大武鄉	2018-11-24T22:26:37+08:00	75	242	317	76	393	763	51.51%	9.83%	2	6
14	臺東縣大武鄉	2018-11-25T04:02:53+08:00	621	1713	2334	376	2710	5266	51.46%	11.79%	6	6
14	臺東縣大武鄉	2018-11-24T23:05:05+08:00	483	1387	1870	305	2175	4132	52.64%	11.69%	5	6
14	臺東縣大武鄉	2018-11-24T23:31:12+08:00	483	1387	1870	305	2175	4132	52.64%	11.69%	5	6
14	臺東縣大武鄉	2018-11-24T22:16:11+08:00	75	242	317	76	393	763	51.51%	9.83%	2	6
14	連江縣	2018-11-24T22:33:39+08:00	185	572	757	27	784	1481	52.94%	12.49%	2	9
14	連江縣	2018-11-25T03:49:52+08:00	1493	4083	5576	183	5759	11205	51.4%	13.32%	9	9
14	連江縣	2018-11-24T23:43:18+08:00	703	1686	2389	82	2471	4744	52.09%	14.82%	5	9
14	連江縣	2018-11-25T06:29:18+08:00	1493	4083	5576	183	5759	11205	51.4%	13.32%	9	9
14	連江縣	2018-11-25T01:07:27+08:00	1493	4083	5576	183	5759	11205	51.4%	13.32%	9	9
14	連江縣	2018-11-25T06:13:54+08:00	1493	4083	5576	183	5759	11205	51.4%	13.32%	9	9
14	連江縣	2018-11-24T23:08:37+08:00	456	857	1313	48	1361	2619	51.97%	17.41%	3	9
14	連江縣	2018-11-25T03:32:36+08:00	1493	4083	5576	183	5759	11205	51.4%	13.32%	9	9
14	連江縣	2018-11-24T23:55:48+08:00	703	1686	2389	82	2471	4744	52.09%	14.82%	5	9
14	連江縣	2018-11-25T03:44:25+08:00	1493	4083	5576	183	5759	11205	51.4%	13.32%	9	9
14	連江縣	2018-11-24T22:13:28+08:00	0	0	0	0	0	0	0%	0%	0	9
14	連江縣	2018-11-25T06:18:58+08:00	1493	4083	5576	183	5759	11205	51.4%	13.32%	9	9
14	連江縣	2018-11-24T23:51:37+08:00	703	1686	2389	82	2471	4744	52.09%	14.82%	5	9
14	連江縣	2018-11-24T22:23:15+08:00	0	0	0	0	0	0	0%	0%	0	9
14	連江縣	2018-11-24T22:40:29+08:00	185	572	757	27	784	1481	52.94%	12.49%	2	9
14	連江縣	2018-11-24T23:23:40+08:00	703	1686	2389	82	2471	4744	52.09%	14.82%	5	9
14	連江縣	2018-11-24T22:54:27+08:00	456	857	1313	48	1361	2619	51.97%	17.41%	3	9
14	連江縣	2018-11-25T00:14:11+08:00	703	1686	2389	82	2471	4744	52.09%	14.82%	5	9
14	連江縣	2018-11-25T00:05:06+08:00	703	1686	2389	82	2471	4744	52.09%	14.82%	5	9
14	連江縣	2018-11-24T22:41:36+08:00	185	572	757	27	784	1481	52.94%	12.49%	2	9
14	連江縣	2018-11-24T22:16:12+08:00	0	0	0	0	0	0	0%	0%	0	9
14	連江縣	2018-11-24T23:05:06+08:00	456	857	1313	48	1361	2619	51.97%	17.41%	3	9
14	連江縣	2018-11-24T22:45:10+08:00	456	857	1313	48	1361	2619	51.97%	17.41%	3	9
14	連江縣	2018-11-25T03:56:14+08:00	1493	4083	5576	183	5759	11205	51.4%	13.32%	9	9
14	連江縣	2018-11-24T22:37:02+08:00	185	572	757	27	784	1481	52.94%	12.49%	2	9
14	連江縣	2018-11-25T00:18:32+08:00	703	1686	2389	82	2471	4744	52.09%	14.82%	5	9
14	連江縣	2018-11-24T23:16:04+08:00	634	1463	2097	77	2174	4134	52.59%	15.34%	4	9
14	連江縣	2018-11-25T00:23:05+08:00	703	1686	2389	82	2471	4744	52.09%	14.82%	5	9
14	連江縣	2018-11-25T01:25:54+08:00	1493	4083	5576	183	5759	11205	51.4%	13.32%	9	9
14	連江縣	2018-11-25T01:02:32+08:00	1336	3453	4789	166	4955	9662	51.28%	13.83%	8	9
14	連江縣	2018-11-25T06:24:01+08:00	1493	4083	5576	183	5759	11205	51.4%	13.32%	9	9
14	連江縣	2018-11-24T22:30:11+08:00	84	247	331	11	342	698	49%	12.03%	1	9
14	連江縣	2018-11-25T03:38:56+08:00	1493	4083	5576	183	5759	11205	51.4%	13.32%	9	9
14	連江縣	2018-11-24T22:19:38+08:00	0	0	0	0	0	0	0%	0%	0	9
14	連江縣	2018-11-24T23:19:53+08:00	634	1463	2097	77	2174	4134	52.59%	15.34%	4	9
14	連江縣	2018-11-25T01:17:54+08:00	1493	4083	5576	183	5759	11205	51.4%	13.32%	9	9
14	連江縣	2018-11-25T00:00:12+08:00	703	1686	2389	82	2471	4744	52.09%	14.82%	5	9
14	連江縣	2018-11-24T22:57:55+08:00	456	857	1313	48	1361	2619	51.97%	17.41%	3	9
14	連江縣	2018-11-24T23:27:20+08:00	703	1686	2389	82	2471	4744	52.09%	14.82%	5	9
14	連江縣	2018-11-25T00:57:38+08:00	1185	3035	4220	148	4368	8548	51.1%	13.86%	7	9
14	連江縣	2018-11-24T23:35:12+08:00	703	1686	2389	82	2471	4744	52.09%	14.82%	5	9
14	連江縣	2018-11-24T23:47:30+08:00	703	1686	2389	82	2471	4744	52.09%	14.82%	5	9
14	連江縣	2018-11-25T00:09:36+08:00	703	1686	2389	82	2471	4744	52.09%	14.82%	5	9
14	連江縣	2018-11-25T06:08:54+08:00	1493	4083	5576	183	5759	11205	51.4%	13.32%	9	9
14	連江縣	2018-11-24T23:39:17+08:00	703	1686	2389	82	2471	4744	52.09%	14.82%	5	9
14	連江縣	2018-11-24T22:50:49+08:00	456	857	1313	48	1361	2619	51.97%	17.41%	3	9
14	連江縣	2018-11-24T23:31:13+08:00	703	1686	2389	82	2471	4744	52.09%	14.82%	5	9
14	連江縣	2018-11-25T04:02:53+08:00	1493	4083	5576	183	5759	11205	51.4%	13.32%	9	9
14	連江縣	2018-11-24T23:01:32+08:00	456	857	1313	48	1361	2619	51.97%	17.41%	3	9
14	連江縣	2018-11-25T01:12:45+08:00	1493	4083	5576	183	5759	11205	51.4%	13.32%	9	9
14	連江縣	2018-11-24T22:26:38+08:00	0	0	0	0	0	0	0%	0%	0	9
14	連江縣	2018-11-24T23:12:17+08:00	456	857	1313	48	1361	2619	51.97%	17.41%	3	9
14	雲林縣水林鄉	2018-11-24T23:47:26+08:00	2789	6007	8796	973	9769	22508	43.4%	12.39%	26	26
14	雲林縣水林鄉	2018-11-24T22:16:08+08:00	2789	6007	8796	973	9769	22508	43.4%	12.39%	26	26
14	雲林縣水林鄉	2018-11-24T23:16:00+08:00	2789	6007	8796	973	9769	22508	43.4%	12.39%	26	26
14	雲林縣水林鄉	2018-11-25T01:25:50+08:00	2789	6007	8796	973	9769	22508	43.4%	12.39%	26	26
14	雲林縣水林鄉	2018-11-25T03:38:53+08:00	2789	6007	8796	973	9769	22508	43.4%	12.39%	26	26
14	雲林縣水林鄉	2018-11-25T00:23:01+08:00	2789	6007	8796	973	9769	22508	43.4%	12.39%	26	26
14	雲林縣水林鄉	2018-11-24T23:23:36+08:00	2789	6007	8796	973	9769	22508	43.4%	12.39%	26	26
14	雲林縣水林鄉	2018-11-24T22:19:35+08:00	2789	6007	8796	973	9769	22508	43.4%	12.39%	26	26
14	雲林縣水林鄉	2018-11-25T00:57:34+08:00	2789	6007	8796	973	9769	22508	43.4%	12.39%	26	26
14	雲林縣水林鄉	2018-11-24T22:36:58+08:00	2789	6007	8796	973	9769	22508	43.4%	12.39%	26	26
14	雲林縣水林鄉	2018-11-24T22:57:51+08:00	2789	6007	8796	973	9769	22508	43.4%	12.39%	26	26
14	雲林縣水林鄉	2018-11-24T22:45:06+08:00	2789	6007	8796	973	9769	22508	43.4%	12.39%	26	26
14	雲林縣水林鄉	2018-11-25T06:08:50+08:00	2789	6007	8796	973	9769	22508	43.4%	12.39%	26	26
14	雲林縣水林鄉	2018-11-25T06:23:58+08:00	2789	6007	8796	973	9769	22508	43.4%	12.39%	26	26
14	雲林縣水林鄉	2018-11-24T23:39:13+08:00	2789	6007	8796	973	9769	22508	43.4%	12.39%	26	26
14	雲林縣水林鄉	2018-11-25T01:12:40+08:00	2789	6007	8796	973	9769	22508	43.4%	12.39%	26	26
14	雲林縣水林鄉	2018-11-24T22:26:34+08:00	2789	6007	8796	973	9769	22508	43.4%	12.39%	26	26
14	雲林縣水林鄉	2018-11-25T03:49:49+08:00	2789	6007	8796	973	9769	22508	43.4%	12.39%	26	26
14	雲林縣水林鄉	2018-11-24T22:50:45+08:00	2789	6007	8796	973	9769	22508	43.4%	12.39%	26	26
14	雲林縣水林鄉	2018-11-24T23:12:13+08:00	2789	6007	8796	973	9769	22508	43.4%	12.39%	26	26
14	雲林縣水林鄉	2018-11-25T04:02:50+08:00	2789	6007	8796	973	9769	22508	43.4%	12.39%	26	26
14	雲林縣水林鄉	2018-11-24T23:31:08+08:00	2789	6007	8796	973	9769	22508	43.4%	12.39%	26	26
14	雲林縣水林鄉	2018-11-24T23:43:15+08:00	2789	6007	8796	973	9769	22508	43.4%	12.39%	26	26
14	雲林縣水林鄉	2018-11-25T06:29:14+08:00	2789	6007	8796	973	9769	22508	43.4%	12.39%	26	26
14	雲林縣水林鄉	2018-11-25T00:14:07+08:00	2789	6007	8796	973	9769	22508	43.4%	12.39%	26	26
14	雲林縣水林鄉	2018-11-24T23:01:29+08:00	2789	6007	8796	973	9769	22508	43.4%	12.39%	26	26
14	雲林縣水林鄉	2018-11-25T01:07:24+08:00	2789	6007	8796	973	9769	22508	43.4%	12.39%	26	26
14	雲林縣水林鄉	2018-11-25T06:13:50+08:00	2789	6007	8796	973	9769	22508	43.4%	12.39%	26	26
14	雲林縣水林鄉	2018-11-24T23:35:08+08:00	2789	6007	8796	973	9769	22508	43.4%	12.39%	26	26
14	雲林縣水林鄉	2018-11-24T22:33:35+08:00	2789	6007	8796	973	9769	22508	43.4%	12.39%	26	26
14	雲林縣水林鄉	2018-11-24T23:08:33+08:00	2789	6007	8796	973	9769	22508	43.4%	12.39%	26	26
14	雲林縣水林鄉	2018-11-25T03:32:32+08:00	2789	6007	8796	973	9769	22508	43.4%	12.39%	26	26
14	雲林縣水林鄉	2018-11-24T23:19:48+08:00	2789	6007	8796	973	9769	22508	43.4%	12.39%	26	26
14	雲林縣水林鄉	2018-11-25T03:44:20+08:00	2789	6007	8796	973	9769	22508	43.4%	12.39%	26	26
14	雲林縣水林鄉	2018-11-24T22:13:24+08:00	2676	5700	8376	892	9268	21453	43.2%	12.47%	25	26
14	雲林縣水林鄉	2018-11-25T00:00:08+08:00	2789	6007	8796	973	9769	22508	43.4%	12.39%	26	26
14	雲林縣水林鄉	2018-11-24T23:55:44+08:00	2789	6007	8796	973	9769	22508	43.4%	12.39%	26	26
14	雲林縣水林鄉	2018-11-25T01:17:49+08:00	2789	6007	8796	973	9769	22508	43.4%	12.39%	26	26
14	雲林縣水林鄉	2018-11-25T06:18:55+08:00	2789	6007	8796	973	9769	22508	43.4%	12.39%	26	26
14	雲林縣水林鄉	2018-11-25T01:02:28+08:00	2789	6007	8796	973	9769	22508	43.4%	12.39%	26	26
14	雲林縣水林鄉	2018-11-24T23:27:16+08:00	2789	6007	8796	973	9769	22508	43.4%	12.39%	26	26
14	雲林縣水林鄉	2018-11-24T22:40:25+08:00	2789	6007	8796	973	9769	22508	43.4%	12.39%	26	26
14	雲林縣水林鄉	2018-11-24T22:23:10+08:00	2789	6007	8796	973	9769	22508	43.4%	12.39%	26	26
14	雲林縣水林鄉	2018-11-24T22:30:03+08:00	2789	6007	8796	973	9769	22508	43.4%	12.39%	26	26
14	雲林縣水林鄉	2018-11-24T23:51:32+08:00	2789	6007	8796	973	9769	22508	43.4%	12.39%	26	26
14	雲林縣水林鄉	2018-11-25T00:05:02+08:00	2789	6007	8796	973	9769	22508	43.4%	12.39%	26	26
14	雲林縣水林鄉	2018-11-24T22:41:32+08:00	2789	6007	8796	973	9769	22508	43.4%	12.39%	26	26
14	雲林縣水林鄉	2018-11-25T00:09:31+08:00	2789	6007	8796	973	9769	22508	43.4%	12.39%	26	26
14	雲林縣水林鄉	2018-11-24T22:54:23+08:00	2789	6007	8796	973	9769	22508	43.4%	12.39%	26	26
14	雲林縣水林鄉	2018-11-24T23:05:02+08:00	2789	6007	8796	973	9769	22508	43.4%	12.39%	26	26
14	雲林縣水林鄉	2018-11-25T03:56:09+08:00	2789	6007	8796	973	9769	22508	43.4%	12.39%	26	26
14	雲林縣水林鄉	2018-11-25T00:18:27+08:00	2789	6007	8796	973	9769	22508	43.4%	12.39%	26	26
14	宜蘭縣羅東鎮	2018-11-24T22:33:37+08:00	8262	15663	23925	1485	25410	44010	57.74%	18.77%	40	50
14	宜蘭縣羅東鎮	2018-11-24T23:47:28+08:00	10777	20418	31195	2004	33199	57686	57.55%	18.68%	50	50
14	宜蘭縣羅東鎮	2018-11-24T22:37:00+08:00	8262	15663	23925	1485	25410	44010	57.74%	18.77%	40	50
14	宜蘭縣羅東鎮	2018-11-25T01:07:26+08:00	10777	20418	31195	2004	33199	57686	57.55%	18.68%	50	50
14	宜蘭縣羅東鎮	2018-11-25T06:13:52+08:00	10777	20418	31195	2004	33199	57686	57.55%	18.68%	50	50
14	宜蘭縣羅東鎮	2018-11-25T06:29:16+08:00	10777	20418	31195	2004	33199	57686	57.55%	18.68%	50	50
14	宜蘭縣羅東鎮	2018-11-24T23:43:17+08:00	10777	20418	31195	2004	33199	57686	57.55%	18.68%	50	50
14	宜蘭縣羅東鎮	2018-11-25T03:38:54+08:00	10777	20418	31195	2004	33199	57686	57.55%	18.68%	50	50
14	宜蘭縣羅東鎮	2018-11-24T23:55:46+08:00	10777	20418	31195	2004	33199	57686	57.55%	18.68%	50	50
14	宜蘭縣羅東鎮	2018-11-24T23:23:38+08:00	9953	18843	28796	1853	30649	53010	57.82%	18.78%	47	50
14	宜蘭縣羅東鎮	2018-11-25T01:02:30+08:00	10777	20418	31195	2004	33199	57686	57.55%	18.68%	50	50
14	宜蘭縣羅東鎮	2018-11-25T03:44:22+08:00	10777	20418	31195	2004	33199	57686	57.55%	18.68%	50	50
14	宜蘭縣羅東鎮	2018-11-24T22:13:26+08:00	6288	11820	18108	1125	19233	33471	57.46%	18.79%	32	50
14	宜蘭縣羅東鎮	2018-11-24T22:23:12+08:00	7029	13230	20259	1267	21526	37242	57.8%	18.87%	35	50
14	宜蘭縣羅東鎮	2018-11-24T22:30:08+08:00	7780	14696	22476	1401	23877	41448	57.61%	18.77%	38	50
14	宜蘭縣羅東鎮	2018-11-24T22:40:27+08:00	8492	16118	24610	1514	26124	45149	57.86%	18.81%	41	50
14	宜蘭縣羅東鎮	2018-11-25T00:00:10+08:00	10777	20418	31195	2004	33199	57686	57.55%	18.68%	50	50
14	宜蘭縣羅東鎮	2018-11-25T06:18:57+08:00	10777	20418	31195	2004	33199	57686	57.55%	18.68%	50	50
14	宜蘭縣羅東鎮	2018-11-25T01:17:51+08:00	10777	20418	31195	2004	33199	57686	57.55%	18.68%	50	50
14	宜蘭縣羅東鎮	2018-11-24T23:19:51+08:00	9953	18843	28796	1853	30649	53010	57.82%	18.78%	47	50
14	宜蘭縣羅東鎮	2018-11-24T23:12:15+08:00	9422	17841	27263	1742	29005	50137	57.85%	18.79%	45	50
14	宜蘭縣羅東鎮	2018-11-24T22:45:08+08:00	8941	16870	25811	1615	27426	47452	57.8%	18.84%	43	50
14	宜蘭縣羅東鎮	2018-11-24T23:01:30+08:00	9422	17841	27263	1742	29005	50137	57.85%	18.79%	45	50
14	宜蘭縣羅東鎮	2018-11-24T23:39:15+08:00	10206	19369	29575	1893	31468	54440	57.8%	18.75%	48	50
14	宜蘭縣羅東鎮	2018-11-24T23:31:11+08:00	10206	19369	29575	1893	31468	54440	57.8%	18.75%	48	50
14	宜蘭縣羅東鎮	2018-11-25T00:09:34+08:00	10777	20418	31195	2004	33199	57686	57.55%	18.68%	50	50
14	宜蘭縣羅東鎮	2018-11-24T23:35:10+08:00	10206	19369	29575	1893	31468	54440	57.8%	18.75%	48	50
14	宜蘭縣羅東鎮	2018-11-25T00:14:09+08:00	10777	20418	31195	2004	33199	57686	57.55%	18.68%	50	50
14	宜蘭縣羅東鎮	2018-11-25T03:49:51+08:00	10777	20418	31195	2004	33199	57686	57.55%	18.68%	50	50
14	宜蘭縣羅東鎮	2018-11-24T23:16:02+08:00	9953	18843	28796	1853	30649	53010	57.82%	18.78%	47	50
14	宜蘭縣羅東鎮	2018-11-25T03:56:12+08:00	10777	20418	31195	2004	33199	57686	57.55%	18.68%	50	50
14	宜蘭縣羅東鎮	2018-11-25T06:24:00+08:00	10777	20418	31195	2004	33199	57686	57.55%	18.68%	50	50
14	宜蘭縣羅東鎮	2018-11-25T00:23:03+08:00	10777	20418	31195	2004	33199	57686	57.55%	18.68%	50	50
14	宜蘭縣羅東鎮	2018-11-24T23:08:35+08:00	9422	17841	27263	1742	29005	50137	57.85%	18.79%	45	50
14	宜蘭縣羅東鎮	2018-11-25T03:32:34+08:00	10777	20418	31195	2004	33199	57686	57.55%	18.68%	50	50
14	宜蘭縣羅東鎮	2018-11-25T01:25:52+08:00	10777	20418	31195	2004	33199	57686	57.55%	18.68%	50	50
14	宜蘭縣羅東鎮	2018-11-24T22:57:53+08:00	9422	17841	27263	1742	29005	50137	57.85%	18.79%	45	50
14	宜蘭縣羅東鎮	2018-11-24T22:19:36+08:00	6481	12176	18657	1166	19823	34456	57.53%	18.81%	33	50
14	宜蘭縣羅東鎮	2018-11-25T00:57:36+08:00	10777	20418	31195	2004	33199	57686	57.55%	18.68%	50	50
14	宜蘭縣羅東鎮	2018-11-24T23:27:18+08:00	9953	18843	28796	1853	30649	53010	57.82%	18.78%	47	50
14	宜蘭縣羅東鎮	2018-11-24T23:51:35+08:00	10777	20418	31195	2004	33199	57686	57.55%	18.68%	50	50
14	宜蘭縣羅東鎮	2018-11-24T23:05:04+08:00	9422	17841	27263	1742	29005	50137	57.85%	18.79%	45	50
14	宜蘭縣羅東鎮	2018-11-25T04:02:52+08:00	10777	20418	31195	2004	33199	57686	57.55%	18.68%	50	50
14	宜蘭縣羅東鎮	2018-11-24T22:50:47+08:00	8941	16870	25811	1615	27426	47452	57.8%	18.84%	43	50
14	宜蘭縣羅東鎮	2018-11-24T22:16:10+08:00	6288	11820	18108	1125	19233	33471	57.46%	18.79%	32	50
14	宜蘭縣羅東鎮	2018-11-25T01:12:43+08:00	10777	20418	31195	2004	33199	57686	57.55%	18.68%	50	50
14	宜蘭縣羅東鎮	2018-11-25T00:05:04+08:00	10777	20418	31195	2004	33199	57686	57.55%	18.68%	50	50
14	宜蘭縣羅東鎮	2018-11-24T22:41:34+08:00	8492	16118	24610	1514	26124	45149	57.86%	18.81%	41	50
14	宜蘭縣羅東鎮	2018-11-24T22:26:36+08:00	7554	14281	21835	1346	23181	40160	57.72%	18.81%	37	50
14	宜蘭縣羅東鎮	2018-11-25T00:18:29+08:00	10777	20418	31195	2004	33199	57686	57.55%	18.68%	50	50
14	宜蘭縣羅東鎮	2018-11-25T06:08:52+08:00	10777	20418	31195	2004	33199	57686	57.55%	18.68%	50	50
14	宜蘭縣羅東鎮	2018-11-24T22:54:25+08:00	8941	16870	25811	1615	27426	47452	57.8%	18.84%	43	50
14	宜蘭縣南澳鄉	2018-11-25T06:29:17+08:00	486	2151	2637	175	2812	4644	60.55%	10.47%	7	7
14	宜蘭縣南澳鄉	2018-11-24T22:33:37+08:00	129	453	582	37	619	919	67.36%	14.04%	2	7
14	宜蘭縣南澳鄉	2018-11-24T23:47:28+08:00	414	1637	2051	114	2165	3682	58.8%	11.24%	6	7
14	宜蘭縣南澳鄉	2018-11-24T22:37:00+08:00	129	453	582	37	619	919	67.36%	14.04%	2	7
14	宜蘭縣南澳鄉	2018-11-25T00:18:30+08:00	486	2151	2637	175	2812	4644	60.55%	10.47%	7	7
14	宜蘭縣南澳鄉	2018-11-25T01:07:26+08:00	486	2151	2637	175	2812	4644	60.55%	10.47%	7	7
14	宜蘭縣南澳鄉	2018-11-25T06:13:52+08:00	486	2151	2637	175	2812	4644	60.55%	10.47%	7	7
14	宜蘭縣南澳鄉	2018-11-24T23:43:17+08:00	414	1637	2051	114	2165	3682	58.8%	11.24%	6	7
14	宜蘭縣南澳鄉	2018-11-25T03:44:23+08:00	486	2151	2637	175	2812	4644	60.55%	10.47%	7	7
14	宜蘭縣南澳鄉	2018-11-24T22:13:27+08:00	129	453	582	37	619	919	67.36%	14.04%	2	7
14	宜蘭縣南澳鄉	2018-11-25T01:02:31+08:00	486	2151	2637	175	2812	4644	60.55%	10.47%	7	7
14	宜蘭縣南澳鄉	2018-11-24T23:23:38+08:00	289	1156	1445	94	1539	2472	62.26%	11.69%	5	7
14	宜蘭縣南澳鄉	2018-11-25T03:38:55+08:00	486	2151	2637	175	2812	4644	60.55%	10.47%	7	7
14	宜蘭縣南澳鄉	2018-11-24T23:55:47+08:00	414	1637	2051	114	2165	3682	58.8%	11.24%	6	7
14	宜蘭縣南澳鄉	2018-11-24T23:08:36+08:00	289	1156	1445	94	1539	2472	62.26%	11.69%	5	7
14	宜蘭縣南澳鄉	2018-11-25T00:00:11+08:00	414	1637	2051	114	2165	3682	58.8%	11.24%	6	7
14	宜蘭縣南澳鄉	2018-11-24T22:30:08+08:00	129	453	582	37	619	919	67.36%	14.04%	2	7
14	宜蘭縣南澳鄉	2018-11-24T22:40:27+08:00	129	453	582	37	619	919	67.36%	14.04%	2	7
14	宜蘭縣南澳鄉	2018-11-25T06:18:57+08:00	486	2151	2637	175	2812	4644	60.55%	10.47%	7	7
14	宜蘭縣南澳鄉	2018-11-24T22:23:13+08:00	129	453	582	37	619	919	67.36%	14.04%	2	7
14	宜蘭縣南澳鄉	2018-11-24T23:19:51+08:00	289	1156	1445	94	1539	2472	62.26%	11.69%	5	7
14	宜蘭縣南澳鄉	2018-11-24T23:12:15+08:00	289	1156	1445	94	1539	2472	62.26%	11.69%	5	7
14	宜蘭縣南澳鄉	2018-11-24T22:45:08+08:00	165	605	770	43	813	1330	61.13%	12.41%	3	7
14	宜蘭縣南澳鄉	2018-11-24T23:35:11+08:00	414	1637	2051	114	2165	3682	58.8%	11.24%	6	7
14	宜蘭縣南澳鄉	2018-11-24T23:39:15+08:00	414	1637	2051	114	2165	3682	58.8%	11.24%	6	7
14	宜蘭縣南澳鄉	2018-11-24T23:01:31+08:00	289	1156	1445	94	1539	2472	62.26%	11.69%	5	7
14	宜蘭縣南澳鄉	2018-11-24T23:31:11+08:00	414	1637	2051	114	2165	3682	58.8%	11.24%	6	7
14	宜蘭縣南澳鄉	2018-11-25T00:09:34+08:00	414	1637	2051	114	2165	3682	58.8%	11.24%	6	7
14	宜蘭縣南澳鄉	2018-11-25T00:14:09+08:00	486	2151	2637	175	2812	4644	60.55%	10.47%	7	7
14	宜蘭縣南澳鄉	2018-11-25T03:49:51+08:00	486	2151	2637	175	2812	4644	60.55%	10.47%	7	7
14	宜蘭縣南澳鄉	2018-11-24T23:16:03+08:00	289	1156	1445	94	1539	2472	62.26%	11.69%	5	7
14	宜蘭縣南澳鄉	2018-11-25T03:56:12+08:00	486	2151	2637	175	2812	4644	60.55%	10.47%	7	7
14	宜蘭縣南澳鄉	2018-11-25T06:24:00+08:00	486	2151	2637	175	2812	4644	60.55%	10.47%	7	7
14	宜蘭縣南澳鄉	2018-11-25T00:23:03+08:00	486	2151	2637	175	2812	4644	60.55%	10.47%	7	7
14	宜蘭縣南澳鄉	2018-11-25T03:32:34+08:00	486	2151	2637	175	2812	4644	60.55%	10.47%	7	7
14	宜蘭縣南澳鄉	2018-11-25T01:25:52+08:00	486	2151	2637	175	2812	4644	60.55%	10.47%	7	7
14	宜蘭縣南澳鄉	2018-11-24T22:57:53+08:00	289	1156	1445	94	1539	2472	62.26%	11.69%	5	7
14	宜蘭縣南澳鄉	2018-11-24T22:19:37+08:00	129	453	582	37	619	919	67.36%	14.04%	2	7
14	宜蘭縣南澳鄉	2018-11-25T00:57:36+08:00	486	2151	2637	175	2812	4644	60.55%	10.47%	7	7
14	宜蘭縣南澳鄉	2018-11-25T01:17:52+08:00	486	2151	2637	175	2812	4644	60.55%	10.47%	7	7
14	宜蘭縣南澳鄉	2018-11-24T23:27:18+08:00	289	1156	1445	94	1539	2472	62.26%	11.69%	5	7
14	宜蘭縣南澳鄉	2018-11-24T23:51:35+08:00	414	1637	2051	114	2165	3682	58.8%	11.24%	6	7
14	宜蘭縣南澳鄉	2018-11-24T23:05:04+08:00	289	1156	1445	94	1539	2472	62.26%	11.69%	5	7
14	宜蘭縣南澳鄉	2018-11-24T22:41:35+08:00	129	453	582	37	619	919	67.36%	14.04%	2	7
14	宜蘭縣南澳鄉	2018-11-25T00:05:05+08:00	414	1637	2051	114	2165	3682	58.8%	11.24%	6	7
14	宜蘭縣南澳鄉	2018-11-25T04:02:52+08:00	486	2151	2637	175	2812	4644	60.55%	10.47%	7	7
14	宜蘭縣南澳鄉	2018-11-24T22:16:10+08:00	129	453	582	37	619	919	67.36%	14.04%	2	7
14	宜蘭縣南澳鄉	2018-11-25T01:12:43+08:00	486	2151	2637	175	2812	4644	60.55%	10.47%	7	7
14	宜蘭縣南澳鄉	2018-11-24T22:50:48+08:00	289	1156	1445	94	1539	2472	62.26%	11.69%	5	7
14	宜蘭縣南澳鄉	2018-11-24T22:26:36+08:00	129	453	582	37	619	919	67.36%	14.04%	2	7
14	宜蘭縣南澳鄉	2018-11-25T06:08:52+08:00	486	2151	2637	175	2812	4644	60.55%	10.47%	7	7
14	宜蘭縣南澳鄉	2018-11-24T22:54:25+08:00	289	1156	1445	94	1539	2472	62.26%	11.69%	5	7
14	桃園市龜山區	2018-11-25T01:07:17+08:00	18174	35304	53478	2784	56262	114152	49.29%	15.92%	69	78
14	桃園市龜山區	2018-11-25T06:08:42+08:00	21039	40715	61754	3114	64868	131702	49.25%	15.97%	78	78
14	桃園市龜山區	2018-11-24T23:47:18+08:00	13277	26004	39281	2073	41354	84540	48.92%	15.7%	53	78
14	桃園市龜山區	2018-11-24T23:35:02+08:00	12454	24460	36914	1978	38892	79569	48.88%	15.65%	50	78
14	桃園市龜山區	2018-11-24T22:26:29+08:00	7482	14966	22448	1216	23664	48191	49.1%	15.53%	33	78
14	桃園市龜山區	2018-11-24T22:16:00+08:00	6933	13909	20842	1163	22005	45054	48.84%	15.39%	31	78
14	桃園市龜山區	2018-11-25T00:04:56+08:00	14477	28354	42831	2224	45055	91998	48.97%	15.74%	57	78
14	桃園市龜山區	2018-11-24T22:19:28+08:00	6933	13909	20842	1163	22005	45054	48.84%	15.39%	31	78
14	桃園市龜山區	2018-11-24T22:57:44+08:00	9812	19645	29457	1624	31081	63486	48.96%	15.46%	42	78
14	桃園市龜山區	2018-11-25T00:57:27+08:00	17702	34369	52071	2681	54752	110981	49.33%	15.95%	67	78
14	桃園市龜山區	2018-11-24T22:13:17+08:00	6933	13909	20842	1163	22005	45054	48.84%	15.39%	31	78
14	桃園市龜山區	2018-11-24T23:23:30+08:00	12212	23986	36198	1951	38149	78114	48.84%	15.63%	49	78
14	桃園市龜山區	2018-11-24T22:29:55+08:00	7961	15960	23921	1299	25220	51777	48.71%	15.38%	35	78
14	桃園市龜山區	2018-11-24T23:08:25+08:00	10445	21007	31452	1734	33186	67737	48.99%	15.42%	44	78
14	桃園市龜山區	2018-11-24T23:55:38+08:00	14140	27615	41755	2171	43926	89820	48.9%	15.74%	56	78
14	桃園市龜山區	2018-11-25T03:38:46+08:00	21039	40715	61754	3114	64868	131702	49.25%	15.97%	78	78
14	桃園市龜山區	2018-11-24T23:59:58+08:00	14140	27615	41755	2171	43926	89820	48.9%	15.74%	56	78
14	桃園市龜山區	2018-11-25T03:32:25+08:00	21039	40715	61754	3114	64868	131702	49.25%	15.97%	78	78
14	桃園市龜山區	2018-11-24T23:15:54+08:00	11035	22112	33147	1815	34962	71603	48.83%	15.41%	46	78
14	桃園市龜山區	2018-11-24T22:40:19+08:00	8484	16977	25461	1385	26846	54815	48.98%	15.48%	37	78
14	桃園市龜山區	2018-11-25T01:25:43+08:00	19277	36940	56217	2879	59096	119685	49.38%	16.11%	72	78
14	桃園市龜山區	2018-11-25T06:23:51+08:00	21039	40715	61754	3114	64868	131702	49.25%	15.97%	78	78
14	桃園市龜山區	2018-11-24T22:54:17+08:00	8980	18028	27008	1481	28489	58433	48.75%	15.37%	39	78
14	桃園市龜山區	2018-11-24T22:45:00+08:00	8785	17585	26370	1427	27797	56774	48.96%	15.47%	38	78
14	桃園市龜山區	2018-11-24T23:01:21+08:00	10183	20275	30458	1674	32132	65723	48.89%	15.49%	43	78
14	桃園市龜山區	2018-11-24T23:31:01+08:00	12454	24460	36914	1978	38892	79569	48.88%	15.65%	50	78
14	桃園市龜山區	2018-11-25T00:09:23+08:00	14477	28354	42831	2224	45055	91998	48.97%	15.74%	57	78
14	桃園市龜山區	2018-11-24T22:41:27+08:00	8484	16977	25461	1385	26846	54815	48.98%	15.48%	37	78
14	桃園市龜山區	2018-11-25T01:12:33+08:00	18566	35937	54503	2809	57312	116297	49.28%	15.96%	70	78
14	桃園市龜山區	2018-11-24T22:50:37+08:00	8785	17585	26370	1427	27797	56774	48.96%	15.47%	38	78
14	桃園市龜山區	2018-11-25T00:14:00+08:00	14870	29121	43991	2283	46274	94278	49.08%	15.77%	58	78
14	桃園市龜山區	2018-11-24T23:12:05+08:00	10730	21567	32297	1780	34077	69851	48.79%	15.36%	45	78
14	桃園市龜山區	2018-11-24T23:39:04+08:00	12782	25009	37791	2012	39803	81373	48.91%	15.71%	51	78
14	桃園市龜山區	2018-11-24T23:51:26+08:00	13277	26004	39281	2073	41354	84540	48.92%	15.7%	53	78
14	桃園市龜山區	2018-11-25T06:18:49+08:00	21039	40715	61754	3114	64868	131702	49.25%	15.97%	78	78
14	桃園市龜山區	2018-11-25T01:17:41+08:00	19277	36940	56217	2879	59096	119685	49.38%	16.11%	72	78
14	桃園市龜山區	2018-11-25T03:44:11+08:00	21039	40715	61754	3114	64868	131702	49.25%	15.97%	78	78
14	桃園市龜山區	2018-11-24T22:23:03+08:00	7172	14372	21544	1193	22737	46373	49.03%	15.47%	32	78
14	桃園市龜山區	2018-11-24T23:04:55+08:00	10445	21007	31452	1734	33186	67737	48.99%	15.42%	44	78
14	桃園市龜山區	2018-11-24T23:19:40+08:00	11443	22841	34284	1862	36146	73832	48.96%	15.5%	47	78
14	桃園市龜山區	2018-11-24T23:27:10+08:00	12212	23986	36198	1951	38149	78114	48.84%	15.63%	49	78
14	桃園市龜山區	2018-11-24T22:36:52+08:00	8217	16372	24589	1356	25945	53275	48.7%	15.42%	36	78
14	桃園市龜山區	2018-11-25T01:02:21+08:00	17998	34892	52890	2717	55607	112924	49.24%	15.94%	68	78
14	桃園市龜山區	2018-11-25T03:49:43+08:00	21039	40715	61754	3114	64868	131702	49.25%	15.97%	78	78
14	桃園市龜山區	2018-11-25T00:22:55+08:00	15239	29684	44923	2326	47249	96298	49.07%	15.82%	59	78
14	桃園市龜山區	2018-11-25T03:56:01+08:00	21039	40715	61754	3114	64868	131702	49.25%	15.97%	78	78
14	桃園市龜山區	2018-11-25T04:02:39+08:00	21039	40715	61754	3114	64868	131702	49.25%	15.97%	78	78
14	桃園市龜山區	2018-11-25T06:13:44+08:00	21039	40715	61754	3114	64868	131702	49.25%	15.97%	78	78
14	桃園市龜山區	2018-11-25T00:18:21+08:00	14870	29121	43991	2283	46274	94278	49.08%	15.77%	58	78
14	桃園市龜山區	2018-11-24T22:33:29+08:00	8217	16372	24589	1356	25945	53275	48.7%	15.42%	36	78
14	桃園市龜山區	2018-11-25T06:29:07+08:00	21039	40715	61754	3114	64868	131702	49.25%	15.97%	78	78
14	桃園市龜山區	2018-11-24T23:43:08+08:00	13277	26004	39281	2073	41354	84540	48.92%	15.7%	53	78
14	屏東縣萬丹鄉	2018-11-25T03:56:10+08:00	6538	14763	21301	1917	23218	43478	53.4%	15.04%	39	39
14	屏東縣萬丹鄉	2018-11-24T23:16:01+08:00	6538	14763	21301	1917	23218	43478	53.4%	15.04%	39	39
14	屏東縣萬丹鄉	2018-11-24T23:43:16+08:00	6538	14763	21301	1917	23218	43478	53.4%	15.04%	39	39
14	屏東縣萬丹鄉	2018-11-24T22:33:36+08:00	6297	14248	20545	1865	22410	42075	53.26%	14.97%	38	39
14	屏東縣萬丹鄉	2018-11-24T23:47:27+08:00	6538	14763	21301	1917	23218	43478	53.4%	15.04%	39	39
14	屏東縣萬丹鄉	2018-11-24T22:16:09+08:00	6127	13782	19909	1805	21714	40664	53.4%	15.07%	37	39
14	屏東縣萬丹鄉	2018-11-25T03:38:53+08:00	6538	14763	21301	1917	23218	43478	53.4%	15.04%	39	39
14	屏東縣萬丹鄉	2018-11-25T01:25:51+08:00	6538	14763	21301	1917	23218	43478	53.4%	15.04%	39	39
14	屏東縣萬丹鄉	2018-11-24T23:23:37+08:00	6538	14763	21301	1917	23218	43478	53.4%	15.04%	39	39
14	屏東縣萬丹鄉	2018-11-25T06:18:56+08:00	6538	14763	21301	1917	23218	43478	53.4%	15.04%	39	39
14	屏東縣萬丹鄉	2018-11-24T22:19:35+08:00	6127	13782	19909	1805	21714	40664	53.4%	15.07%	37	39
14	屏東縣萬丹鄉	2018-11-25T01:17:50+08:00	6538	14763	21301	1917	23218	43478	53.4%	15.04%	39	39
14	屏東縣萬丹鄉	2018-11-24T22:36:59+08:00	6297	14248	20545	1865	22410	42075	53.26%	14.97%	38	39
14	屏東縣萬丹鄉	2018-11-24T22:40:26+08:00	6297	14248	20545	1865	22410	42075	53.26%	14.97%	38	39
14	屏東縣萬丹鄉	2018-11-25T00:57:35+08:00	6538	14763	21301	1917	23218	43478	53.4%	15.04%	39	39
14	屏東縣萬丹鄉	2018-11-25T00:09:32+08:00	6538	14763	21301	1917	23218	43478	53.4%	15.04%	39	39
14	屏東縣萬丹鄉	2018-11-24T23:39:14+08:00	6538	14763	21301	1917	23218	43478	53.4%	15.04%	39	39
14	屏東縣萬丹鄉	2018-11-24T22:26:35+08:00	6127	13782	19909	1805	21714	40664	53.4%	15.07%	37	39
14	屏東縣萬丹鄉	2018-11-24T23:12:14+08:00	6297	14248	20545	1865	22410	42075	53.26%	14.97%	38	39
14	屏東縣萬丹鄉	2018-11-25T06:23:59+08:00	6538	14763	21301	1917	23218	43478	53.4%	15.04%	39	39
14	屏東縣萬丹鄉	2018-11-24T22:45:07+08:00	6297	14248	20545	1865	22410	42075	53.26%	14.97%	38	39
14	屏東縣萬丹鄉	2018-11-25T06:08:51+08:00	6538	14763	21301	1917	23218	43478	53.4%	15.04%	39	39
14	屏東縣萬丹鄉	2018-11-25T04:02:50+08:00	6538	14763	21301	1917	23218	43478	53.4%	15.04%	39	39
14	屏東縣萬丹鄉	2018-11-25T06:13:51+08:00	6538	14763	21301	1917	23218	43478	53.4%	15.04%	39	39
14	屏東縣萬丹鄉	2018-11-25T00:14:07+08:00	6538	14763	21301	1917	23218	43478	53.4%	15.04%	39	39
14	屏東縣萬丹鄉	2018-11-24T23:35:09+08:00	6538	14763	21301	1917	23218	43478	53.4%	15.04%	39	39
14	屏東縣萬丹鄉	2018-11-24T23:01:29+08:00	6297	14248	20545	1865	22410	42075	53.26%	14.97%	38	39
14	屏東縣萬丹鄉	2018-11-25T01:07:24+08:00	6538	14763	21301	1917	23218	43478	53.4%	15.04%	39	39
14	屏東縣萬丹鄉	2018-11-24T23:31:09+08:00	6538	14763	21301	1917	23218	43478	53.4%	15.04%	39	39
14	屏東縣萬丹鄉	2018-11-25T03:49:50+08:00	6538	14763	21301	1917	23218	43478	53.4%	15.04%	39	39
14	屏東縣萬丹鄉	2018-11-25T06:29:15+08:00	6538	14763	21301	1917	23218	43478	53.4%	15.04%	39	39
14	屏東縣萬丹鄉	2018-11-24T23:55:45+08:00	6538	14763	21301	1917	23218	43478	53.4%	15.04%	39	39
14	屏東縣萬丹鄉	2018-11-24T23:08:34+08:00	6297	14248	20545	1865	22410	42075	53.26%	14.97%	38	39
14	屏東縣萬丹鄉	2018-11-25T00:00:09+08:00	6538	14763	21301	1917	23218	43478	53.4%	15.04%	39	39
14	屏東縣萬丹鄉	2018-11-25T00:23:02+08:00	6538	14763	21301	1917	23218	43478	53.4%	15.04%	39	39
14	屏東縣萬丹鄉	2018-11-24T23:19:48+08:00	6538	14763	21301	1917	23218	43478	53.4%	15.04%	39	39
14	屏東縣萬丹鄉	2018-11-25T03:32:33+08:00	6538	14763	21301	1917	23218	43478	53.4%	15.04%	39	39
14	屏東縣萬丹鄉	2018-11-25T03:44:21+08:00	6538	14763	21301	1917	23218	43478	53.4%	15.04%	39	39
14	屏東縣萬丹鄉	2018-11-24T22:13:25+08:00	6127	13782	19909	1805	21714	40664	53.4%	15.07%	37	39
14	屏東縣萬丹鄉	2018-11-24T22:23:11+08:00	6127	13782	19909	1805	21714	40664	53.4%	15.07%	37	39
14	屏東縣萬丹鄉	2018-11-24T22:30:05+08:00	6127	13782	19909	1805	21714	40664	53.4%	15.07%	37	39
14	屏東縣萬丹鄉	2018-11-24T23:27:17+08:00	6538	14763	21301	1917	23218	43478	53.4%	15.04%	39	39
14	屏東縣萬丹鄉	2018-11-25T01:02:29+08:00	6538	14763	21301	1917	23218	43478	53.4%	15.04%	39	39
14	屏東縣萬丹鄉	2018-11-24T23:51:33+08:00	6538	14763	21301	1917	23218	43478	53.4%	15.04%	39	39
14	屏東縣萬丹鄉	2018-11-24T22:57:52+08:00	6297	14248	20545	1865	22410	42075	53.26%	14.97%	38	39
14	屏東縣萬丹鄉	2018-11-24T23:05:03+08:00	6297	14248	20545	1865	22410	42075	53.26%	14.97%	38	39
14	屏東縣萬丹鄉	2018-11-24T22:54:24+08:00	6297	14248	20545	1865	22410	42075	53.26%	14.97%	38	39
14	屏東縣萬丹鄉	2018-11-25T00:18:28+08:00	6538	14763	21301	1917	23218	43478	53.4%	15.04%	39	39
14	屏東縣萬丹鄉	2018-11-24T22:41:33+08:00	6297	14248	20545	1865	22410	42075	53.26%	14.97%	38	39
14	屏東縣萬丹鄉	2018-11-25T00:05:03+08:00	6538	14763	21301	1917	23218	43478	53.4%	15.04%	39	39
14	屏東縣萬丹鄉	2018-11-25T01:12:42+08:00	6538	14763	21301	1917	23218	43478	53.4%	15.04%	39	39
14	屏東縣萬丹鄉	2018-11-24T22:50:46+08:00	6297	14248	20545	1865	22410	42075	53.26%	14.97%	38	39
14	臺南市安定區	2018-11-24T23:35:04+08:00	4048	8901	12949	1132	14081	26104	53.94%	15.51%	24	24
14	臺南市安定區	2018-11-24T23:47:21+08:00	4048	8901	12949	1132	14081	26104	53.94%	15.51%	24	24
14	臺南市安定區	2018-11-24T22:33:30+08:00	4048	8901	12949	1132	14081	26104	53.94%	15.51%	24	24
14	臺南市安定區	2018-11-24T23:31:02+08:00	4048	8901	12949	1132	14081	26104	53.94%	15.51%	24	24
14	臺南市安定區	2018-11-24T23:39:06+08:00	4048	8901	12949	1132	14081	26104	53.94%	15.51%	24	24
14	臺南市安定區	2018-11-25T01:07:19+08:00	4048	8901	12949	1132	14081	26104	53.94%	15.51%	24	24
14	臺南市安定區	2018-11-25T00:14:02+08:00	4048	8901	12949	1132	14081	26104	53.94%	15.51%	24	24
14	臺南市安定區	2018-11-24T23:43:10+08:00	4048	8901	12949	1132	14081	26104	53.94%	15.51%	24	24
14	臺南市安定區	2018-11-25T06:08:44+08:00	4048	8901	12949	1132	14081	26104	53.94%	15.51%	24	24
14	臺南市安定區	2018-11-25T00:09:26+08:00	4048	8901	12949	1132	14081	26104	53.94%	15.51%	24	24
14	臺南市安定區	2018-11-24T23:01:23+08:00	4048	8901	12949	1132	14081	26104	53.94%	15.51%	24	24
14	臺南市安定區	2018-11-24T23:12:08+08:00	4048	8901	12949	1132	14081	26104	53.94%	15.51%	24	24
14	臺南市安定區	2018-11-24T23:19:42+08:00	4048	8901	12949	1132	14081	26104	53.94%	15.51%	24	24
14	臺南市安定區	2018-11-25T00:04:58+08:00	4048	8901	12949	1132	14081	26104	53.94%	15.51%	24	24
14	臺南市安定區	2018-11-24T23:04:57+08:00	4048	8901	12949	1132	14081	26104	53.94%	15.51%	24	24
14	臺南市安定區	2018-11-25T00:57:29+08:00	4048	8901	12949	1132	14081	26104	53.94%	15.51%	24	24
14	臺南市安定區	2018-11-24T22:13:19+08:00	4048	8901	12949	1132	14081	26104	53.94%	15.51%	24	24
14	臺南市安定區	2018-11-25T03:44:14+08:00	4048	8901	12949	1132	14081	26104	53.94%	15.51%	24	24
14	臺南市安定區	2018-11-25T01:17:43+08:00	4048	8901	12949	1132	14081	26104	53.94%	15.51%	24	24
14	臺南市安定區	2018-11-24T23:55:40+08:00	4048	8901	12949	1132	14081	26104	53.94%	15.51%	24	24
14	臺南市安定區	2018-11-25T01:02:23+08:00	4048	8901	12949	1132	14081	26104	53.94%	15.51%	24	24
14	臺南市安定區	2018-11-25T01:25:45+08:00	4048	8901	12949	1132	14081	26104	53.94%	15.51%	24	24
14	臺南市安定區	2018-11-25T03:38:48+08:00	4048	8901	12949	1132	14081	26104	53.94%	15.51%	24	24
14	臺南市安定區	2018-11-25T06:18:50+08:00	4048	8901	12949	1132	14081	26104	53.94%	15.51%	24	24
14	臺南市安定區	2018-11-24T22:40:21+08:00	4048	8901	12949	1132	14081	26104	53.94%	15.51%	24	24
14	臺南市安定區	2018-11-24T23:27:12+08:00	4048	8901	12949	1132	14081	26104	53.94%	15.51%	24	24
14	臺南市安定區	2018-11-25T00:18:22+08:00	4048	8901	12949	1132	14081	26104	53.94%	15.51%	24	24
14	臺南市安定區	2018-11-24T22:54:19+08:00	4048	8901	12949	1132	14081	26104	53.94%	15.51%	24	24
14	臺南市安定區	2018-11-25T00:22:57+08:00	4048	8901	12949	1132	14081	26104	53.94%	15.51%	24	24
14	臺南市安定區	2018-11-25T03:56:04+08:00	4048	8901	12949	1132	14081	26104	53.94%	15.51%	24	24
14	臺南市安定區	2018-11-24T22:16:02+08:00	4048	8901	12949	1132	14081	26104	53.94%	15.51%	24	24
14	臺南市安定區	2018-11-24T22:41:28+08:00	4048	8901	12949	1132	14081	26104	53.94%	15.51%	24	24
14	臺南市安定區	2018-11-25T04:02:41+08:00	4048	8901	12949	1132	14081	26104	53.94%	15.51%	24	24
14	臺南市安定區	2018-11-25T01:12:35+08:00	4048	8901	12949	1132	14081	26104	53.94%	15.51%	24	24
14	臺南市安定區	2018-11-24T23:23:32+08:00	4048	8901	12949	1132	14081	26104	53.94%	15.51%	24	24
14	臺南市安定區	2018-11-24T22:57:46+08:00	4048	8901	12949	1132	14081	26104	53.94%	15.51%	24	24
14	臺南市安定區	2018-11-25T00:00:01+08:00	4048	8901	12949	1132	14081	26104	53.94%	15.51%	24	24
14	臺南市安定區	2018-11-24T23:51:27+08:00	4048	8901	12949	1132	14081	26104	53.94%	15.51%	24	24
14	臺南市安定區	2018-11-24T22:29:58+08:00	4048	8901	12949	1132	14081	26104	53.94%	15.51%	24	24
14	臺南市安定區	2018-11-24T22:23:05+08:00	4048	8901	12949	1132	14081	26104	53.94%	15.51%	24	24
14	臺南市安定區	2018-11-24T22:36:54+08:00	4048	8901	12949	1132	14081	26104	53.94%	15.51%	24	24
14	臺南市安定區	2018-11-24T23:15:56+08:00	4048	8901	12949	1132	14081	26104	53.94%	15.51%	24	24
14	臺南市安定區	2018-11-24T23:08:28+08:00	4048	8901	12949	1132	14081	26104	53.94%	15.51%	24	24
14	臺南市安定區	2018-11-25T03:32:27+08:00	4048	8901	12949	1132	14081	26104	53.94%	15.51%	24	24
14	臺南市安定區	2018-11-24T22:19:30+08:00	4048	8901	12949	1132	14081	26104	53.94%	15.51%	24	24
14	臺南市安定區	2018-11-25T03:49:44+08:00	4048	8901	12949	1132	14081	26104	53.94%	15.51%	24	24
14	臺南市安定區	2018-11-24T22:45:02+08:00	4048	8901	12949	1132	14081	26104	53.94%	15.51%	24	24
14	臺南市安定區	2018-11-24T22:50:40+08:00	4048	8901	12949	1132	14081	26104	53.94%	15.51%	24	24
14	臺南市安定區	2018-11-24T22:26:30+08:00	4048	8901	12949	1132	14081	26104	53.94%	15.51%	24	24
14	臺南市安定區	2018-11-25T06:29:09+08:00	4048	8901	12949	1132	14081	26104	53.94%	15.51%	24	24
14	臺南市安定區	2018-11-25T06:23:53+08:00	4048	8901	12949	1132	14081	26104	53.94%	15.51%	24	24
14	臺南市安定區	2018-11-25T06:13:45+08:00	4048	8901	12949	1132	14081	26104	53.94%	15.51%	24	24
14	屏東縣新埤鄉	2018-11-24T23:43:16+08:00	1201	2953	4154	407	4561	9033	50.49%	13.3%	12	12
14	屏東縣新埤鄉	2018-11-24T22:33:36+08:00	1048	2613	3661	355	4016	7710	52.09%	13.59%	11	12
14	屏東縣新埤鄉	2018-11-25T03:56:11+08:00	1201	2953	4154	407	4561	9033	50.49%	13.3%	12	12
14	屏東縣新埤鄉	2018-11-24T23:47:27+08:00	1201	2953	4154	407	4561	9033	50.49%	13.3%	12	12
14	屏東縣新埤鄉	2018-11-24T22:16:09+08:00	1048	2613	3661	355	4016	7710	52.09%	13.59%	11	12
14	屏東縣新埤鄉	2018-11-25T03:38:54+08:00	1201	2953	4154	407	4561	9033	50.49%	13.3%	12	12
14	屏東縣新埤鄉	2018-11-24T23:55:46+08:00	1201	2953	4154	407	4561	9033	50.49%	13.3%	12	12
14	屏東縣新埤鄉	2018-11-25T01:25:51+08:00	1201	2953	4154	407	4561	9033	50.49%	13.3%	12	12
14	屏東縣新埤鄉	2018-11-24T23:23:37+08:00	1201	2953	4154	407	4561	9033	50.49%	13.3%	12	12
14	屏東縣新埤鄉	2018-11-25T06:18:56+08:00	1201	2953	4154	407	4561	9033	50.49%	13.3%	12	12
14	屏東縣新埤鄉	2018-11-24T22:30:06+08:00	1048	2613	3661	355	4016	7710	52.09%	13.59%	11	12
14	屏東縣新埤鄉	2018-11-24T22:40:27+08:00	1048	2613	3661	355	4016	7710	52.09%	13.59%	11	12
14	屏東縣新埤鄉	2018-11-24T22:36:59+08:00	1048	2613	3661	355	4016	7710	52.09%	13.59%	11	12
14	屏東縣新埤鄉	2018-11-25T00:57:35+08:00	1201	2953	4154	407	4561	9033	50.49%	13.3%	12	12
14	屏東縣新埤鄉	2018-11-25T01:17:51+08:00	1201	2953	4154	407	4561	9033	50.49%	13.3%	12	12
14	屏東縣新埤鄉	2018-11-24T23:31:10+08:00	1201	2953	4154	407	4561	9033	50.49%	13.3%	12	12
14	屏東縣新埤鄉	2018-11-24T23:39:14+08:00	1201	2953	4154	407	4561	9033	50.49%	13.3%	12	12
14	屏東縣新埤鄉	2018-11-24T23:01:30+08:00	1048	2613	3661	355	4016	7710	52.09%	13.59%	11	12
14	屏東縣新埤鄉	2018-11-25T04:02:51+08:00	1201	2953	4154	407	4561	9033	50.49%	13.3%	12	12
14	屏東縣新埤鄉	2018-11-24T23:12:14+08:00	1201	2953	4154	407	4561	9033	50.49%	13.3%	12	12
14	屏東縣新埤鄉	2018-11-25T06:23:59+08:00	1201	2953	4154	407	4561	9033	50.49%	13.3%	12	12
14	屏東縣新埤鄉	2018-11-25T00:09:33+08:00	1201	2953	4154	407	4561	9033	50.49%	13.3%	12	12
14	屏東縣新埤鄉	2018-11-24T22:45:07+08:00	1048	2613	3661	355	4016	7710	52.09%	13.59%	11	12
14	屏東縣新埤鄉	2018-11-25T06:08:51+08:00	1201	2953	4154	407	4561	9033	50.49%	13.3%	12	12
14	屏東縣新埤鄉	2018-11-25T01:07:25+08:00	1201	2953	4154	407	4561	9033	50.49%	13.3%	12	12
14	屏東縣新埤鄉	2018-11-25T06:13:51+08:00	1201	2953	4154	407	4561	9033	50.49%	13.3%	12	12
14	屏東縣新埤鄉	2018-11-24T23:16:02+08:00	1201	2953	4154	407	4561	9033	50.49%	13.3%	12	12
14	屏東縣新埤鄉	2018-11-24T23:35:09+08:00	1201	2953	4154	407	4561	9033	50.49%	13.3%	12	12
14	屏東縣新埤鄉	2018-11-25T03:49:50+08:00	1201	2953	4154	407	4561	9033	50.49%	13.3%	12	12
14	屏東縣新埤鄉	2018-11-25T00:14:08+08:00	1201	2953	4154	407	4561	9033	50.49%	13.3%	12	12
14	屏東縣新埤鄉	2018-11-25T06:29:15+08:00	1201	2953	4154	407	4561	9033	50.49%	13.3%	12	12
14	屏東縣新埤鄉	2018-11-25T00:00:09+08:00	1201	2953	4154	407	4561	9033	50.49%	13.3%	12	12
14	屏東縣新埤鄉	2018-11-25T00:23:02+08:00	1201	2953	4154	407	4561	9033	50.49%	13.3%	12	12
14	屏東縣新埤鄉	2018-11-24T23:08:35+08:00	1201	2953	4154	407	4561	9033	50.49%	13.3%	12	12
14	屏東縣新埤鄉	2018-11-25T03:32:33+08:00	1201	2953	4154	407	4561	9033	50.49%	13.3%	12	12
14	屏東縣新埤鄉	2018-11-25T03:44:21+08:00	1201	2953	4154	407	4561	9033	50.49%	13.3%	12	12
14	屏東縣新埤鄉	2018-11-24T22:13:25+08:00	1048	2613	3661	355	4016	7710	52.09%	13.59%	11	12
14	屏東縣新埤鄉	2018-11-24T23:19:49+08:00	1201	2953	4154	407	4561	9033	50.49%	13.3%	12	12
14	屏東縣新埤鄉	2018-11-24T22:23:11+08:00	1048	2613	3661	355	4016	7710	52.09%	13.59%	11	12
14	屏東縣新埤鄉	2018-11-24T23:27:17+08:00	1201	2953	4154	407	4561	9033	50.49%	13.3%	12	12
14	屏東縣新埤鄉	2018-11-24T22:19:36+08:00	1048	2613	3661	355	4016	7710	52.09%	13.59%	11	12
14	屏東縣新埤鄉	2018-11-25T01:02:29+08:00	1201	2953	4154	407	4561	9033	50.49%	13.3%	12	12
14	屏東縣新埤鄉	2018-11-24T23:51:34+08:00	1201	2953	4154	407	4561	9033	50.49%	13.3%	12	12
14	屏東縣新埤鄉	2018-11-24T22:57:52+08:00	1048	2613	3661	355	4016	7710	52.09%	13.59%	11	12
14	屏東縣新埤鄉	2018-11-24T23:05:03+08:00	1048	2613	3661	355	4016	7710	52.09%	13.59%	11	12
14	屏東縣新埤鄉	2018-11-24T22:54:24+08:00	1048	2613	3661	355	4016	7710	52.09%	13.59%	11	12
14	屏東縣新埤鄉	2018-11-24T22:50:47+08:00	1048	2613	3661	355	4016	7710	52.09%	13.59%	11	12
14	屏東縣新埤鄉	2018-11-25T00:18:28+08:00	1201	2953	4154	407	4561	9033	50.49%	13.3%	12	12
14	屏東縣新埤鄉	2018-11-25T00:05:04+08:00	1201	2953	4154	407	4561	9033	50.49%	13.3%	12	12
14	屏東縣新埤鄉	2018-11-24T22:41:34+08:00	1048	2613	3661	355	4016	7710	52.09%	13.59%	11	12
14	屏東縣新埤鄉	2018-11-25T01:12:42+08:00	1201	2953	4154	407	4561	9033	50.49%	13.3%	12	12
14	屏東縣新埤鄉	2018-11-24T22:26:36+08:00	1048	2613	3661	355	4016	7710	52.09%	13.59%	11	12
14	臺南市永康區	2018-11-24T23:35:04+08:00	32371	62635	95006	4812	99818	191857	52.03%	16.87%	140	142
14	臺南市永康區	2018-11-24T23:47:21+08:00	32371	62635	95006	4812	99818	191857	52.03%	16.87%	140	142
14	臺南市永康區	2018-11-25T06:08:45+08:00	32872	63632	96504	4864	101368	195001	51.98%	16.86%	142	142
14	臺南市永康區	2018-11-24T23:43:11+08:00	32371	62635	95006	4812	99818	191857	52.03%	16.87%	140	142
14	臺南市永康區	2018-11-25T01:07:19+08:00	32872	63632	96504	4864	101368	195001	51.98%	16.86%	142	142
14	臺南市永康區	2018-11-24T22:33:31+08:00	29399	57132	86531	4410	90941	174275	52.18%	16.87%	128	142
14	臺南市永康區	2018-11-25T00:14:02+08:00	32603	63151	95754	4837	100591	193411	52.01%	16.86%	141	142
14	臺南市永康區	2018-11-25T04:02:42+08:00	32872	63632	96504	4864	101368	195001	51.98%	16.86%	142	142
14	臺南市永康區	2018-11-25T00:09:26+08:00	32603	63151	95754	4837	100591	193411	52.01%	16.86%	141	142
14	臺南市永康區	2018-11-24T23:12:08+08:00	32371	62635	95006	4812	99818	191857	52.03%	16.87%	140	142
14	臺南市永康區	2018-11-24T23:39:07+08:00	32371	62635	95006	4812	99818	191857	52.03%	16.87%	140	142
14	臺南市永康區	2018-11-24T23:31:03+08:00	32371	62635	95006	4812	99818	191857	52.03%	16.87%	140	142
14	臺南市永康區	2018-11-24T23:01:24+08:00	31751	61386	93137	4714	97851	187919	52.07%	16.9%	137	142
14	臺南市永康區	2018-11-24T23:19:42+08:00	32371	62635	95006	4812	99818	191857	52.03%	16.87%	140	142
14	臺南市永康區	2018-11-25T00:04:58+08:00	32603	63151	95754	4837	100591	193411	52.01%	16.86%	141	142
14	臺南市永康區	2018-11-24T23:04:57+08:00	31965	61924	93889	4759	98648	189484	52.06%	16.87%	138	142
14	臺南市永康區	2018-11-25T00:57:29+08:00	32872	63632	96504	4864	101368	195001	51.98%	16.86%	142	142
14	臺南市永康區	2018-11-24T22:13:19+08:00	24147	47760	71907	3645	75552	144377	52.33%	16.72%	109	142
14	臺南市永康區	2018-11-25T03:44:14+08:00	32872	63632	96504	4864	101368	195001	51.98%	16.86%	142	142
14	臺南市永康區	2018-11-25T01:17:43+08:00	32872	63632	96504	4864	101368	195001	51.98%	16.86%	142	142
14	臺南市永康區	2018-11-24T23:55:40+08:00	32371	62635	95006	4812	99818	191857	52.03%	16.87%	140	142
14	臺南市永康區	2018-11-25T06:18:51+08:00	32872	63632	96504	4864	101368	195001	51.98%	16.86%	142	142
14	臺南市永康區	2018-11-25T01:02:23+08:00	32872	63632	96504	4864	101368	195001	51.98%	16.86%	142	142
14	臺南市永康區	2018-11-25T03:38:49+08:00	32872	63632	96504	4864	101368	195001	51.98%	16.86%	142	142
14	臺南市永康區	2018-11-24T23:27:12+08:00	32371	62635	95006	4812	99818	191857	52.03%	16.87%	140	142
14	臺南市永康區	2018-11-25T00:18:23+08:00	32603	63151	95754	4837	100591	193411	52.01%	16.86%	141	142
14	臺南市永康區	2018-11-24T22:54:19+08:00	30398	58983	89381	4566	93947	180346	52.09%	16.86%	132	142
14	臺南市永康區	2018-11-25T06:13:46+08:00	32872	63632	96504	4864	101368	195001	51.98%	16.86%	142	142
14	臺南市永康區	2018-11-25T00:22:57+08:00	32603	63151	95754	4837	100591	193411	52.01%	16.86%	141	142
14	臺南市永康區	2018-11-25T03:56:04+08:00	32872	63632	96504	4864	101368	195001	51.98%	16.86%	142	142
14	臺南市永康區	2018-11-24T22:41:29+08:00	29626	57541	87167	4439	91606	175753	52.12%	16.86%	129	142
14	臺南市永康區	2018-11-24T22:16:03+08:00	25032	49203	74235	3742	77977	148825	52.4%	16.82%	112	142
14	臺南市永康區	2018-11-25T01:12:35+08:00	32872	63632	96504	4864	101368	195001	51.98%	16.86%	142	142
14	臺南市永康區	2018-11-24T22:29:59+08:00	27894	54733	82627	4192	86819	166223	52.23%	16.78%	123	142
14	臺南市永康區	2018-11-24T23:23:32+08:00	32371	62635	95006	4812	99818	191857	52.03%	16.87%	140	142
14	臺南市永康區	2018-11-24T23:51:28+08:00	32371	62635	95006	4812	99818	191857	52.03%	16.87%	140	142
14	臺南市永康區	2018-11-24T22:57:46+08:00	31268	60391	91659	4625	96284	185206	51.99%	16.88%	135	142
14	臺南市永康區	2018-11-25T00:00:01+08:00	32603	63151	95754	4837	100591	193411	52.01%	16.86%	141	142
14	臺南市永康區	2018-11-24T22:23:05+08:00	26890	52849	79739	4021	83760	160253	52.27%	16.78%	119	142
14	臺南市永康區	2018-11-24T22:36:54+08:00	29626	57541	87167	4439	91606	175753	52.12%	16.86%	129	142
14	臺南市永康區	2018-11-25T01:25:46+08:00	32872	63632	96504	4864	101368	195001	51.98%	16.86%	142	142
14	臺南市永康區	2018-11-24T23:15:56+08:00	32371	62635	95006	4812	99818	191857	52.03%	16.87%	140	142
14	臺南市永康區	2018-11-24T23:08:28+08:00	32082	62163	94245	4772	99017	190156	52.07%	16.87%	139	142
14	臺南市永康區	2018-11-25T03:32:27+08:00	32872	63632	96504	4864	101368	195001	51.98%	16.86%	142	142
14	臺南市永康區	2018-11-24T22:40:22+08:00	29626	57541	87167	4439	91606	175753	52.12%	16.86%	129	142
14	臺南市永康區	2018-11-24T22:19:30+08:00	26077	51301	77378	3899	81277	155304	52.33%	16.79%	116	142
14	臺南市永康區	2018-11-24T22:45:02+08:00	30398	58983	89381	4566	93947	180346	52.09%	16.86%	132	142
14	臺南市永康區	2018-11-24T22:50:40+08:00	30398	58983	89381	4566	93947	180346	52.09%	16.86%	132	142
14	臺南市永康區	2018-11-25T03:49:45+08:00	32872	63632	96504	4864	101368	195001	51.98%	16.86%	142	142
14	臺南市永康區	2018-11-25T06:29:09+08:00	32872	63632	96504	4864	101368	195001	51.98%	16.86%	142	142
14	臺南市永康區	2018-11-25T06:23:53+08:00	32872	63632	96504	4864	101368	195001	51.98%	16.86%	142	142
14	臺南市永康區	2018-11-24T22:26:31+08:00	27429	53888	81317	4096	85413	163535	52.23%	16.77%	121	142
14	南投縣	2018-11-25T01:12:39+08:00	64424	169616	234040	14360	248400	427089	58.16%	15.08%	488	488
14	南投縣	2018-11-24T22:16:06+08:00	44588	119215	163803	10330	174133	300951	57.86%	14.82%	373	488
14	南投縣	2018-11-25T04:02:45+08:00	64424	169616	234040	14360	248400	427089	58.16%	15.08%	488	488
14	南投縣	2018-11-24T22:23:09+08:00	46466	124438	170904	10743	181647	314097	57.83%	14.79%	385	488
14	南投縣	2018-11-25T03:32:31+08:00	64424	169616	234040	14360	248400	427089	58.16%	15.08%	488	488
14	南投縣	2018-11-25T00:00:04+08:00	63298	165736	229034	14078	243112	418277	58.12%	15.13%	480	488
14	南投縣	2018-11-25T00:23:00+08:00	64122	168726	232848	14304	247152	425257	58.12%	15.08%	486	488
14	南投縣	2018-11-24T22:36:57+08:00	50135	133715	183850	11581	195431	337090	57.98%	14.87%	407	488
14	南投縣	2018-11-25T00:57:33+08:00	64424	169616	234040	14360	248400	427089	58.16%	15.08%	488	488
14	南投縣	2018-11-24T23:51:31+08:00	63298	165736	229034	14078	243112	418277	58.12%	15.13%	480	488
14	南投縣	2018-11-24T23:27:15+08:00	61768	161949	223717	13782	237499	409109	58.05%	15.1%	472	488
14	南投縣	2018-11-24T22:19:33+08:00	45882	122731	168613	10594	179207	309682	57.87%	14.82%	381	488
14	南投縣	2018-11-24T22:50:44+08:00	52709	140487	193196	12106	205302	353954	58%	14.89%	424	488
14	南投縣	2018-11-24T23:12:12+08:00	59231	155472	214703	13294	227997	393149	57.99%	15.07%	459	488
14	南投縣	2018-11-25T06:13:49+08:00	64424	169616	234040	14360	248400	427089	58.16%	15.08%	488	488
14	南投縣	2018-11-24T22:26:33+08:00	47024	125763	172787	10863	183650	317661	57.81%	14.8%	388	488
14	南投縣	2018-11-24T22:41:31+08:00	51032	136133	187165	11810	198975	343015	58.01%	14.88%	413	488
14	南投縣	2018-11-25T00:05:01+08:00	63573	166542	230115	14120	244235	420255	58.12%	15.13%	482	488
14	南投縣	2018-11-25T06:23:57+08:00	64424	169616	234040	14360	248400	427089	58.16%	15.08%	488	488
14	南投縣	2018-11-25T03:49:48+08:00	64424	169616	234040	14360	248400	427089	58.16%	15.08%	488	488
14	南投縣	2018-11-24T23:05:01+08:00	57317	150560	207877	12875	220752	380581	58%	15.06%	448	488
14	南投縣	2018-11-25T01:07:22+08:00	64424	169616	234040	14360	248400	427089	58.16%	15.08%	488	488
14	南投縣	2018-11-24T23:47:25+08:00	62862	164742	227604	14003	241607	415756	58.11%	15.12%	478	488
14	南投縣	2018-11-25T06:29:13+08:00	64424	169616	234040	14360	248400	427089	58.16%	15.08%	488	488
14	南投縣	2018-11-24T23:35:07+08:00	62418	163402	225820	13918	239738	412773	58.08%	15.12%	475	488
14	南投縣	2018-11-24T22:33:34+08:00	49249	131942	181191	11456	192647	332624	57.92%	14.81%	402	488
14	南投縣	2018-11-24T23:43:14+08:00	62764	164477	227241	13985	241226	415142	58.11%	15.12%	477	488
14	南投縣	2018-11-24T23:01:27+08:00	56138	147393	203531	12658	216189	372578	58.03%	15.07%	441	488
14	南投縣	2018-11-24T23:31:07+08:00	62418	163402	225820	13918	239738	412773	58.08%	15.12%	475	488
14	南投縣	2018-11-25T06:08:49+08:00	64424	169616	234040	14360	248400	427089	58.16%	15.08%	488	488
14	南投縣	2018-11-25T00:14:06+08:00	63843	167667	231510	14213	245723	422557	58.15%	15.11%	484	488
14	南投縣	2018-11-24T23:23:35+08:00	61201	160485	221686	13687	235373	405532	58.04%	15.09%	469	488
14	南投縣	2018-11-24T23:19:46+08:00	60815	159452	220267	13600	233867	403074	58.02%	15.09%	467	488
14	南投縣	2018-11-24T22:13:23+08:00	43828	117223	161051	10197	171248	295999	57.85%	14.81%	368	488
14	南投縣	2018-11-25T03:44:18+08:00	64424	169616	234040	14360	248400	427089	58.16%	15.08%	488	488
14	南投縣	2018-11-25T01:17:48+08:00	64424	169616	234040	14360	248400	427089	58.16%	15.08%	488	488
14	南投縣	2018-11-24T23:55:43+08:00	63298	165736	229034	14078	243112	418277	58.12%	15.13%	480	488
14	南投縣	2018-11-24T23:08:32+08:00	58271	152913	211184	13093	224277	386599	58.01%	15.07%	453	488
14	南投縣	2018-11-25T03:38:51+08:00	64424	169616	234040	14360	248400	427089	58.16%	15.08%	488	488
14	南投縣	2018-11-24T22:57:49+08:00	55973	146973	202946	12637	215583	371578	58.02%	15.06%	440	488
14	南投縣	2018-11-24T22:30:02+08:00	47388	126649	174037	10944	184981	319923	57.82%	14.81%	390	488
14	南投縣	2018-11-25T01:02:27+08:00	64424	169616	234040	14360	248400	427089	58.16%	15.08%	488	488
14	南投縣	2018-11-24T22:40:24+08:00	51032	136133	187165	11810	198975	343015	58.01%	14.88%	413	488
14	南投縣	2018-11-25T01:25:49+08:00	64424	169616	234040	14360	248400	427089	58.16%	15.08%	488	488
14	南投縣	2018-11-24T23:15:59+08:00	60623	159013	219636	13550	233186	401698	58.05%	15.09%	466	488
14	南投縣	2018-11-25T06:18:54+08:00	64424	169616	234040	14360	248400	427089	58.16%	15.08%	488	488
14	南投縣	2018-11-25T03:56:08+08:00	64424	169616	234040	14360	248400	427089	58.16%	15.08%	488	488
14	南投縣	2018-11-24T22:45:05+08:00	51467	137350	188817	11894	200711	346026	58%	14.87%	416	488
14	南投縣	2018-11-25T00:18:26+08:00	64015	168102	232117	14278	246395	423881	58.13%	15.1%	485	488
14	南投縣	2018-11-24T23:39:11+08:00	62672	164280	226952	13975	240927	414686	58.1%	15.11%	477	488
14	南投縣	2018-11-25T00:09:30+08:00	63711	167255	230966	14182	245148	421567	58.15%	15.11%	483	488
14	南投縣	2018-11-24T22:54:22+08:00	53422	142235	195657	12247	207904	358519	57.99%	14.9%	428	488
14	南投縣國姓鄉	2018-11-24T23:16:00+08:00	2278	6513	8791	613	9404	16597	56.66%	13.73%	20	20
14	南投縣國姓鄉	2018-11-24T22:16:07+08:00	2104	6066	8170	578	8748	15502	56.43%	13.57%	19	20
14	南投縣國姓鄉	2018-11-24T22:23:09+08:00	2278	6513	8791	613	9404	16597	56.66%	13.73%	20	20
14	南投縣國姓鄉	2018-11-25T03:32:31+08:00	2278	6513	8791	613	9404	16597	56.66%	13.73%	20	20
14	南投縣國姓鄉	2018-11-25T00:00:04+08:00	2278	6513	8791	613	9404	16597	56.66%	13.73%	20	20
14	南投縣國姓鄉	2018-11-25T00:23:01+08:00	2278	6513	8791	613	9404	16597	56.66%	13.73%	20	20
14	南投縣國姓鄉	2018-11-25T03:38:52+08:00	2278	6513	8791	613	9404	16597	56.66%	13.73%	20	20
14	南投縣國姓鄉	2018-11-24T22:36:57+08:00	2278	6513	8791	613	9404	16597	56.66%	13.73%	20	20
14	南投縣國姓鄉	2018-11-24T22:57:50+08:00	2278	6513	8791	613	9404	16597	56.66%	13.73%	20	20
14	南投縣國姓鄉	2018-11-25T00:57:33+08:00	2278	6513	8791	613	9404	16597	56.66%	13.73%	20	20
14	南投縣國姓鄉	2018-11-24T23:27:15+08:00	2278	6513	8791	613	9404	16597	56.66%	13.73%	20	20
14	南投縣國姓鄉	2018-11-24T22:19:34+08:00	2278	6513	8791	613	9404	16597	56.66%	13.73%	20	20
14	南投縣國姓鄉	2018-11-24T22:50:44+08:00	2278	6513	8791	613	9404	16597	56.66%	13.73%	20	20
14	南投縣國姓鄉	2018-11-24T23:12:12+08:00	2278	6513	8791	613	9404	16597	56.66%	13.73%	20	20
14	南投縣國姓鄉	2018-11-25T06:13:49+08:00	2278	6513	8791	613	9404	16597	56.66%	13.73%	20	20
14	南投縣國姓鄉	2018-11-25T01:12:40+08:00	2278	6513	8791	613	9404	16597	56.66%	13.73%	20	20
14	南投縣國姓鄉	2018-11-24T22:26:34+08:00	2278	6513	8791	613	9404	16597	56.66%	13.73%	20	20
14	南投縣國姓鄉	2018-11-25T06:23:57+08:00	2278	6513	8791	613	9404	16597	56.66%	13.73%	20	20
14	南投縣國姓鄉	2018-11-24T23:39:12+08:00	2278	6513	8791	613	9404	16597	56.66%	13.73%	20	20
14	南投縣國姓鄉	2018-11-25T03:49:48+08:00	2278	6513	8791	613	9404	16597	56.66%	13.73%	20	20
14	南投縣國姓鄉	2018-11-24T23:01:28+08:00	2278	6513	8791	613	9404	16597	56.66%	13.73%	20	20
14	南投縣國姓鄉	2018-11-24T23:47:25+08:00	2278	6513	8791	613	9404	16597	56.66%	13.73%	20	20
14	南投縣國姓鄉	2018-11-25T06:29:13+08:00	2278	6513	8791	613	9404	16597	56.66%	13.73%	20	20
14	南投縣國姓鄉	2018-11-24T23:35:07+08:00	2278	6513	8791	613	9404	16597	56.66%	13.73%	20	20
14	南投縣國姓鄉	2018-11-24T22:33:34+08:00	2278	6513	8791	613	9404	16597	56.66%	13.73%	20	20
14	南投縣國姓鄉	2018-11-25T01:07:23+08:00	2278	6513	8791	613	9404	16597	56.66%	13.73%	20	20
14	南投縣國姓鄉	2018-11-24T23:43:14+08:00	2278	6513	8791	613	9404	16597	56.66%	13.73%	20	20
14	南投縣國姓鄉	2018-11-24T23:31:07+08:00	2278	6513	8791	613	9404	16597	56.66%	13.73%	20	20
14	南投縣國姓鄉	2018-11-25T06:08:49+08:00	2278	6513	8791	613	9404	16597	56.66%	13.73%	20	20
14	南投縣國姓鄉	2018-11-25T00:14:06+08:00	2278	6513	8791	613	9404	16597	56.66%	13.73%	20	20
14	南投縣國姓鄉	2018-11-25T04:02:46+08:00	2278	6513	8791	613	9404	16597	56.66%	13.73%	20	20
14	南投縣國姓鄉	2018-11-24T23:23:35+08:00	2278	6513	8791	613	9404	16597	56.66%	13.73%	20	20
14	南投縣國姓鄉	2018-11-24T22:13:23+08:00	2104	6066	8170	578	8748	15502	56.43%	13.57%	19	20
14	南投縣國姓鄉	2018-11-25T01:17:48+08:00	2278	6513	8791	613	9404	16597	56.66%	13.73%	20	20
14	南投縣國姓鄉	2018-11-24T23:55:44+08:00	2278	6513	8791	613	9404	16597	56.66%	13.73%	20	20
14	南投縣國姓鄉	2018-11-24T23:08:32+08:00	2278	6513	8791	613	9404	16597	56.66%	13.73%	20	20
14	南投縣國姓鄉	2018-11-24T23:19:47+08:00	2278	6513	8791	613	9404	16597	56.66%	13.73%	20	20
14	南投縣國姓鄉	2018-11-25T03:44:19+08:00	2278	6513	8791	613	9404	16597	56.66%	13.73%	20	20
14	南投縣國姓鄉	2018-11-25T01:02:27+08:00	2278	6513	8791	613	9404	16597	56.66%	13.73%	20	20
14	南投縣國姓鄉	2018-11-24T22:40:25+08:00	2278	6513	8791	613	9404	16597	56.66%	13.73%	20	20
14	南投縣國姓鄉	2018-11-24T22:30:03+08:00	2278	6513	8791	613	9404	16597	56.66%	13.73%	20	20
14	南投縣國姓鄉	2018-11-25T01:25:49+08:00	2278	6513	8791	613	9404	16597	56.66%	13.73%	20	20
14	南投縣國姓鄉	2018-11-25T06:18:54+08:00	2278	6513	8791	613	9404	16597	56.66%	13.73%	20	20
14	南投縣國姓鄉	2018-11-24T23:51:32+08:00	2278	6513	8791	613	9404	16597	56.66%	13.73%	20	20
14	南投縣國姓鄉	2018-11-25T03:56:08+08:00	2278	6513	8791	613	9404	16597	56.66%	13.73%	20	20
14	南投縣國姓鄉	2018-11-25T00:05:02+08:00	2278	6513	8791	613	9404	16597	56.66%	13.73%	20	20
14	南投縣國姓鄉	2018-11-24T22:41:32+08:00	2278	6513	8791	613	9404	16597	56.66%	13.73%	20	20
14	南投縣國姓鄉	2018-11-25T00:09:31+08:00	2278	6513	8791	613	9404	16597	56.66%	13.73%	20	20
14	南投縣國姓鄉	2018-11-24T22:54:23+08:00	2278	6513	8791	613	9404	16597	56.66%	13.73%	20	20
14	南投縣國姓鄉	2018-11-24T22:45:05+08:00	2278	6513	8791	613	9404	16597	56.66%	13.73%	20	20
14	南投縣國姓鄉	2018-11-24T23:05:02+08:00	2278	6513	8791	613	9404	16597	56.66%	13.73%	20	20
14	南投縣國姓鄉	2018-11-25T00:18:27+08:00	2278	6513	8791	613	9404	16597	56.66%	13.73%	20	20
14	澎湖縣西嶼鄉	2018-11-24T22:33:39+08:00	666	1618	2284	270	2554	7382	34.6%	9.02%	12	12
14	澎湖縣西嶼鄉	2018-11-25T03:49:52+08:00	666	1618	2284	270	2554	7382	34.6%	9.02%	12	12
14	澎湖縣西嶼鄉	2018-11-24T23:43:18+08:00	666	1618	2284	270	2554	7382	34.6%	9.02%	12	12
14	澎湖縣西嶼鄉	2018-11-24T23:47:29+08:00	666	1618	2284	270	2554	7382	34.6%	9.02%	12	12
14	澎湖縣西嶼鄉	2018-11-25T06:29:18+08:00	666	1618	2284	270	2554	7382	34.6%	9.02%	12	12
14	澎湖縣西嶼鄉	2018-11-25T01:07:27+08:00	666	1618	2284	270	2554	7382	34.6%	9.02%	12	12
14	澎湖縣西嶼鄉	2018-11-25T06:13:53+08:00	666	1618	2284	270	2554	7382	34.6%	9.02%	12	12
14	澎湖縣西嶼鄉	2018-11-25T00:18:31+08:00	666	1618	2284	270	2554	7382	34.6%	9.02%	12	12
14	澎湖縣西嶼鄉	2018-11-24T22:37:01+08:00	666	1618	2284	270	2554	7382	34.6%	9.02%	12	12
14	澎湖縣西嶼鄉	2018-11-25T03:44:24+08:00	666	1618	2284	270	2554	7382	34.6%	9.02%	12	12
14	澎湖縣西嶼鄉	2018-11-24T23:08:37+08:00	666	1618	2284	270	2554	7382	34.6%	9.02%	12	12
14	澎湖縣西嶼鄉	2018-11-24T23:55:48+08:00	666	1618	2284	270	2554	7382	34.6%	9.02%	12	12
14	澎湖縣西嶼鄉	2018-11-24T22:13:28+08:00	666	1618	2284	270	2554	7382	34.6%	9.02%	12	12
14	澎湖縣西嶼鄉	2018-11-24T23:23:39+08:00	666	1618	2284	270	2554	7382	34.6%	9.02%	12	12
14	澎湖縣西嶼鄉	2018-11-25T06:18:58+08:00	666	1618	2284	270	2554	7382	34.6%	9.02%	12	12
14	澎湖縣西嶼鄉	2018-11-24T23:51:36+08:00	666	1618	2284	270	2554	7382	34.6%	9.02%	12	12
14	澎湖縣西嶼鄉	2018-11-24T22:23:14+08:00	666	1618	2284	270	2554	7382	34.6%	9.02%	12	12
14	澎湖縣西嶼鄉	2018-11-24T22:40:28+08:00	666	1618	2284	270	2554	7382	34.6%	9.02%	12	12
14	澎湖縣西嶼鄉	2018-11-25T00:09:35+08:00	666	1618	2284	270	2554	7382	34.6%	9.02%	12	12
14	澎湖縣西嶼鄉	2018-11-25T00:05:06+08:00	666	1618	2284	270	2554	7382	34.6%	9.02%	12	12
14	澎湖縣西嶼鄉	2018-11-24T22:41:36+08:00	666	1618	2284	270	2554	7382	34.6%	9.02%	12	12
14	澎湖縣西嶼鄉	2018-11-24T22:45:09+08:00	666	1618	2284	270	2554	7382	34.6%	9.02%	12	12
14	澎湖縣西嶼鄉	2018-11-24T22:16:12+08:00	666	1618	2284	270	2554	7382	34.6%	9.02%	12	12
14	澎湖縣西嶼鄉	2018-11-24T22:54:26+08:00	666	1618	2284	270	2554	7382	34.6%	9.02%	12	12
14	澎湖縣西嶼鄉	2018-11-25T00:14:10+08:00	666	1618	2284	270	2554	7382	34.6%	9.02%	12	12
14	澎湖縣西嶼鄉	2018-11-25T03:56:14+08:00	666	1618	2284	270	2554	7382	34.6%	9.02%	12	12
14	澎湖縣西嶼鄉	2018-11-24T23:16:04+08:00	666	1618	2284	270	2554	7382	34.6%	9.02%	12	12
14	澎湖縣西嶼鄉	2018-11-25T03:32:35+08:00	666	1618	2284	270	2554	7382	34.6%	9.02%	12	12
14	澎湖縣西嶼鄉	2018-11-25T01:25:53+08:00	666	1618	2284	270	2554	7382	34.6%	9.02%	12	12
14	澎湖縣西嶼鄉	2018-11-25T01:02:32+08:00	666	1618	2284	270	2554	7382	34.6%	9.02%	12	12
14	澎湖縣西嶼鄉	2018-11-24T22:30:10+08:00	666	1618	2284	270	2554	7382	34.6%	9.02%	12	12
14	澎湖縣西嶼鄉	2018-11-25T00:23:04+08:00	666	1618	2284	270	2554	7382	34.6%	9.02%	12	12
14	澎湖縣西嶼鄉	2018-11-25T06:24:01+08:00	666	1618	2284	270	2554	7382	34.6%	9.02%	12	12
14	澎湖縣西嶼鄉	2018-11-25T03:38:56+08:00	666	1618	2284	270	2554	7382	34.6%	9.02%	12	12
14	澎湖縣西嶼鄉	2018-11-24T23:27:19+08:00	666	1618	2284	270	2554	7382	34.6%	9.02%	12	12
14	澎湖縣西嶼鄉	2018-11-24T22:19:38+08:00	666	1618	2284	270	2554	7382	34.6%	9.02%	12	12
14	澎湖縣西嶼鄉	2018-11-25T01:17:53+08:00	666	1618	2284	270	2554	7382	34.6%	9.02%	12	12
14	澎湖縣西嶼鄉	2018-11-25T00:00:12+08:00	666	1618	2284	270	2554	7382	34.6%	9.02%	12	12
14	澎湖縣西嶼鄉	2018-11-24T22:57:55+08:00	666	1618	2284	270	2554	7382	34.6%	9.02%	12	12
14	澎湖縣西嶼鄉	2018-11-24T23:19:52+08:00	666	1618	2284	270	2554	7382	34.6%	9.02%	12	12
14	澎湖縣西嶼鄉	2018-11-25T00:57:38+08:00	666	1618	2284	270	2554	7382	34.6%	9.02%	12	12
14	澎湖縣西嶼鄉	2018-11-24T23:35:12+08:00	666	1618	2284	270	2554	7382	34.6%	9.02%	12	12
14	澎湖縣西嶼鄉	2018-11-25T06:08:54+08:00	666	1618	2284	270	2554	7382	34.6%	9.02%	12	12
14	澎湖縣西嶼鄉	2018-11-24T23:12:16+08:00	666	1618	2284	270	2554	7382	34.6%	9.02%	12	12
14	澎湖縣西嶼鄉	2018-11-24T23:39:17+08:00	666	1618	2284	270	2554	7382	34.6%	9.02%	12	12
14	澎湖縣西嶼鄉	2018-11-25T01:12:44+08:00	666	1618	2284	270	2554	7382	34.6%	9.02%	12	12
14	澎湖縣西嶼鄉	2018-11-24T22:50:49+08:00	666	1618	2284	270	2554	7382	34.6%	9.02%	12	12
14	澎湖縣西嶼鄉	2018-11-25T04:02:53+08:00	666	1618	2284	270	2554	7382	34.6%	9.02%	12	12
14	澎湖縣西嶼鄉	2018-11-24T23:05:05+08:00	666	1618	2284	270	2554	7382	34.6%	9.02%	12	12
14	澎湖縣西嶼鄉	2018-11-24T23:31:12+08:00	666	1618	2284	270	2554	7382	34.6%	9.02%	12	12
14	澎湖縣西嶼鄉	2018-11-24T23:01:32+08:00	666	1618	2284	270	2554	7382	34.6%	9.02%	12	12
14	澎湖縣西嶼鄉	2018-11-24T22:26:38+08:00	666	1618	2284	270	2554	7382	34.6%	9.02%	12	12
14	新竹縣橫山鄉	2018-11-25T04:02:44+08:00	1624	4608	6232	479	6711	11346	59.15%	14.31%	16	16
14	新竹縣橫山鄉	2018-11-25T01:12:37+08:00	1624	4608	6232	479	6711	11346	59.15%	14.31%	16	16
14	新竹縣橫山鄉	2018-11-25T00:14:04+08:00	1624	4608	6232	479	6711	11346	59.15%	14.31%	16	16
14	新竹縣橫山鄉	2018-11-24T23:31:05+08:00	1624	4608	6232	479	6711	11346	59.15%	14.31%	16	16
14	新竹縣橫山鄉	2018-11-25T01:07:21+08:00	1624	4608	6232	479	6711	11346	59.15%	14.31%	16	16
14	新竹縣橫山鄉	2018-11-25T06:29:11+08:00	1624	4608	6232	479	6711	11346	59.15%	14.31%	16	16
14	新竹縣橫山鄉	2018-11-25T00:09:28+08:00	1624	4608	6232	479	6711	11346	59.15%	14.31%	16	16
14	新竹縣橫山鄉	2018-11-24T22:23:07+08:00	1112	3058	4170	349	4519	7785	58.05%	14.28%	13	16
14	新竹縣橫山鄉	2018-11-25T00:00:03+08:00	1624	4608	6232	479	6711	11346	59.15%	14.31%	16	16
14	新竹縣橫山鄉	2018-11-24T23:08:30+08:00	1624	4608	6232	479	6711	11346	59.15%	14.31%	16	16
14	新竹縣橫山鄉	2018-11-24T23:19:44+08:00	1624	4608	6232	479	6711	11346	59.15%	14.31%	16	16
14	新竹縣橫山鄉	2018-11-24T22:13:21+08:00	1112	3058	4170	349	4519	7785	58.05%	14.28%	13	16
14	新竹縣橫山鄉	2018-11-25T03:32:30+08:00	1624	4608	6232	479	6711	11346	59.15%	14.31%	16	16
14	新竹縣橫山鄉	2018-11-24T23:51:30+08:00	1624	4608	6232	479	6711	11346	59.15%	14.31%	16	16
14	新竹縣橫山鄉	2018-11-24T22:30:01+08:00	1112	3058	4170	349	4519	7785	58.05%	14.28%	13	16
14	新竹縣橫山鄉	2018-11-24T23:27:14+08:00	1624	4608	6232	479	6711	11346	59.15%	14.31%	16	16
14	新竹縣橫山鄉	2018-11-24T22:19:32+08:00	1112	3058	4170	349	4519	7785	58.05%	14.28%	13	16
14	新竹縣橫山鄉	2018-11-24T22:36:56+08:00	1331	3745	5076	410	5486	9346	58.7%	14.24%	14	16
14	新竹縣橫山鄉	2018-11-25T01:02:25+08:00	1624	4608	6232	479	6711	11346	59.15%	14.31%	16	16
14	新竹縣橫山鄉	2018-11-25T06:13:47+08:00	1624	4608	6232	479	6711	11346	59.15%	14.31%	16	16
14	新竹縣橫山鄉	2018-11-25T00:18:25+08:00	1624	4608	6232	479	6711	11346	59.15%	14.31%	16	16
14	新竹縣橫山鄉	2018-11-24T23:05:00+08:00	1624	4608	6232	479	6711	11346	59.15%	14.31%	16	16
14	新竹縣橫山鄉	2018-11-24T22:26:32+08:00	1112	3058	4170	349	4519	7785	58.05%	14.28%	13	16
14	新竹縣橫山鄉	2018-11-24T22:50:42+08:00	1331	3745	5076	410	5486	9346	58.7%	14.24%	14	16
14	新竹縣橫山鄉	2018-11-24T22:54:21+08:00	1624	4608	6232	479	6711	11346	59.15%	14.31%	16	16
14	新竹縣橫山鄉	2018-11-25T00:05:00+08:00	1624	4608	6232	479	6711	11346	59.15%	14.31%	16	16
14	新竹縣橫山鄉	2018-11-24T22:41:30+08:00	1331	3745	5076	410	5486	9346	58.7%	14.24%	14	16
14	新竹縣橫山鄉	2018-11-25T00:22:59+08:00	1624	4608	6232	479	6711	11346	59.15%	14.31%	16	16
14	新竹縣橫山鄉	2018-11-25T03:49:46+08:00	1624	4608	6232	479	6711	11346	59.15%	14.31%	16	16
14	新竹縣橫山鄉	2018-11-24T22:16:05+08:00	1112	3058	4170	349	4519	7785	58.05%	14.28%	13	16
14	新竹縣橫山鄉	2018-11-24T23:01:26+08:00	1624	4608	6232	479	6711	11346	59.15%	14.31%	16	16
14	新竹縣橫山鄉	2018-11-24T23:43:12+08:00	1624	4608	6232	479	6711	11346	59.15%	14.31%	16	16
14	新竹縣橫山鄉	2018-11-24T22:33:33+08:00	1331	3745	5076	410	5486	9346	58.7%	14.24%	14	16
14	新竹縣橫山鄉	2018-11-25T06:08:47+08:00	1624	4608	6232	479	6711	11346	59.15%	14.31%	16	16
14	新竹縣橫山鄉	2018-11-24T23:35:06+08:00	1624	4608	6232	479	6711	11346	59.15%	14.31%	16	16
14	新竹縣橫山鄉	2018-11-24T23:47:23+08:00	1624	4608	6232	479	6711	11346	59.15%	14.31%	16	16
14	新竹縣橫山鄉	2018-11-24T23:55:42+08:00	1624	4608	6232	479	6711	11346	59.15%	14.31%	16	16
14	新竹縣橫山鄉	2018-11-25T01:17:46+08:00	1624	4608	6232	479	6711	11346	59.15%	14.31%	16	16
14	新竹縣橫山鄉	2018-11-24T22:57:48+08:00	1624	4608	6232	479	6711	11346	59.15%	14.31%	16	16
14	新竹縣橫山鄉	2018-11-25T03:38:50+08:00	1624	4608	6232	479	6711	11346	59.15%	14.31%	16	16
14	新竹縣橫山鄉	2018-11-24T23:23:34+08:00	1624	4608	6232	479	6711	11346	59.15%	14.31%	16	16
14	新竹縣橫山鄉	2018-11-25T03:44:17+08:00	1624	4608	6232	479	6711	11346	59.15%	14.31%	16	16
14	新竹縣橫山鄉	2018-11-25T01:25:48+08:00	1624	4608	6232	479	6711	11346	59.15%	14.31%	16	16
14	新竹縣橫山鄉	2018-11-24T22:40:23+08:00	1331	3745	5076	410	5486	9346	58.7%	14.24%	14	16
14	新竹縣橫山鄉	2018-11-25T06:18:52+08:00	1624	4608	6232	479	6711	11346	59.15%	14.31%	16	16
14	新竹縣橫山鄉	2018-11-24T23:15:58+08:00	1624	4608	6232	479	6711	11346	59.15%	14.31%	16	16
14	新竹縣橫山鄉	2018-11-25T00:57:31+08:00	1624	4608	6232	479	6711	11346	59.15%	14.31%	16	16
14	新竹縣橫山鄉	2018-11-25T03:56:06+08:00	1624	4608	6232	479	6711	11346	59.15%	14.31%	16	16
14	新竹縣橫山鄉	2018-11-25T06:23:55+08:00	1624	4608	6232	479	6711	11346	59.15%	14.31%	16	16
14	新竹縣橫山鄉	2018-11-24T23:39:10+08:00	1624	4608	6232	479	6711	11346	59.15%	14.31%	16	16
14	新竹縣橫山鄉	2018-11-24T22:45:04+08:00	1331	3745	5076	410	5486	9346	58.7%	14.24%	14	16
14	新竹縣橫山鄉	2018-11-24T23:12:10+08:00	1624	4608	6232	479	6711	11346	59.15%	14.31%	16	16
14	高雄市大寮區	2018-11-25T06:29:10+08:00	16625	35779	52404	3199	55603	97309	57.14%	17.08%	81	81
14	高雄市大寮區	2018-11-25T00:14:03+08:00	16149	34630	50779	3094	53873	94400	57.07%	17.11%	79	81
14	高雄市大寮區	2018-11-24T23:01:25+08:00	14791	31429	46220	2834	49054	85818	57.16%	17.24%	73	81
14	高雄市大寮區	2018-11-24T23:12:09+08:00	15236	32404	47640	2912	50552	88471	57.14%	17.22%	75	81
14	高雄市大寮區	2018-11-25T06:08:45+08:00	16625	35779	52404	3199	55603	97309	57.14%	17.08%	81	81
14	高雄市大寮區	2018-11-24T23:43:11+08:00	15709	33503	49212	2995	52207	91481	57.07%	17.17%	77	81
14	高雄市大寮區	2018-11-24T23:39:08+08:00	15709	33503	49212	2995	52207	91481	57.07%	17.17%	77	81
14	高雄市大寮區	2018-11-25T00:09:27+08:00	15939	33998	49937	3053	52990	92882	57.05%	17.16%	78	81
14	高雄市大寮區	2018-11-25T01:12:36+08:00	16625	35779	52404	3199	55603	97309	57.14%	17.08%	81	81
14	高雄市大寮區	2018-11-25T04:02:42+08:00	16625	35779	52404	3199	55603	97309	57.14%	17.08%	81	81
14	高雄市大寮區	2018-11-24T23:35:05+08:00	15709	33503	49212	2995	52207	91481	57.07%	17.17%	77	81
14	高雄市大寮區	2018-11-25T01:07:20+08:00	16625	35779	52404	3199	55603	97309	57.14%	17.08%	81	81
14	高雄市大寮區	2018-11-24T23:31:04+08:00	15452	32924	48376	2935	51311	89861	57.1%	17.2%	76	81
14	高雄市大寮區	2018-11-25T03:44:15+08:00	16625	35779	52404	3199	55603	97309	57.14%	17.08%	81	81
14	高雄市大寮區	2018-11-24T22:13:20+08:00	12768	26869	39637	2370	42007	73712	56.99%	17.32%	64	81
14	高雄市大寮區	2018-11-24T23:55:41+08:00	15939	33998	49937	3053	52990	92882	57.05%	17.16%	78	81
14	高雄市大寮區	2018-11-24T22:23:06+08:00	13111	27744	40855	2483	43338	75997	57.03%	17.25%	66	81
14	高雄市大寮區	2018-11-24T23:19:43+08:00	15452	32924	48376	2935	51311	89861	57.1%	17.2%	76	81
14	高雄市大寮區	2018-11-25T01:17:44+08:00	16625	35779	52404	3199	55603	97309	57.14%	17.08%	81	81
14	高雄市大寮區	2018-11-24T23:04:58+08:00	14791	31429	46220	2834	49054	85818	57.16%	17.24%	73	81
14	高雄市大寮區	2018-11-25T00:00:02+08:00	15939	33998	49937	3053	52990	92882	57.05%	17.16%	78	81
14	高雄市大寮區	2018-11-25T00:04:59+08:00	15939	33998	49937	3053	52990	92882	57.05%	17.16%	78	81
14	高雄市大寮區	2018-11-25T06:18:51+08:00	16625	35779	52404	3199	55603	97309	57.14%	17.08%	81	81
14	高雄市大寮區	2018-11-25T01:02:24+08:00	16625	35779	52404	3199	55603	97309	57.14%	17.08%	81	81
14	高雄市大寮區	2018-11-24T23:27:13+08:00	15452	32924	48376	2935	51311	89861	57.1%	17.2%	76	81
14	高雄市大寮區	2018-11-25T03:38:49+08:00	16625	35779	52404	3199	55603	97309	57.14%	17.08%	81	81
14	高雄市大寮區	2018-11-24T22:30:00+08:00	13373	28334	41707	2535	44242	77632	56.99%	17.23%	67	81
14	高雄市大寮區	2018-11-24T22:54:20+08:00	14367	30446	44813	2733	47546	83440	56.98%	17.22%	71	81
14	高雄市大寮區	2018-11-25T00:22:58+08:00	16369	35136	51505	3166	54671	95680	57.14%	17.11%	80	81
14	高雄市大寮區	2018-11-25T03:56:05+08:00	16625	35779	52404	3199	55603	97309	57.14%	17.08%	81	81
14	高雄市大寮區	2018-11-25T00:18:24+08:00	16369	35136	51505	3166	54671	95680	57.14%	17.11%	80	81
14	高雄市大寮區	2018-11-25T06:13:46+08:00	16625	35779	52404	3199	55603	97309	57.14%	17.08%	81	81
14	高雄市大寮區	2018-11-24T23:47:22+08:00	15709	33503	49212	2995	52207	91481	57.07%	17.17%	77	81
14	高雄市大寮區	2018-11-24T22:41:29+08:00	13893	29481	43374	2665	46039	80777	57%	17.2%	69	81
14	高雄市大寮區	2018-11-24T22:16:03+08:00	12941	27315	40256	2447	42703	74891	57.02%	17.28%	65	81
14	高雄市大寮區	2018-11-24T22:33:32+08:00	13373	28334	41707	2535	44242	77632	56.99%	17.23%	67	81
14	高雄市大寮區	2018-11-24T23:51:28+08:00	15939	33998	49937	3053	52990	92882	57.05%	17.16%	78	81
14	高雄市大寮區	2018-11-24T23:23:33+08:00	15452	32924	48376	2935	51311	89861	57.1%	17.2%	76	81
14	高雄市大寮區	2018-11-24T22:57:47+08:00	14604	30970	45574	2793	48367	84698	57.11%	17.24%	72	81
14	高雄市大寮區	2018-11-25T01:25:46+08:00	16625	35779	52404	3199	55603	97309	57.14%	17.08%	81	81
14	高雄市大寮區	2018-11-24T22:19:31+08:00	13111	27744	40855	2483	43338	75997	57.03%	17.25%	66	81
14	高雄市大寮區	2018-11-25T00:57:30+08:00	16625	35779	52404	3199	55603	97309	57.14%	17.08%	81	81
14	高雄市大寮區	2018-11-24T22:40:22+08:00	13893	29481	43374	2665	46039	80777	57%	17.2%	69	81
14	高雄市大寮區	2018-11-24T22:36:55+08:00	13893	29481	43374	2665	46039	80777	57%	17.2%	69	81
14	高雄市大寮區	2018-11-24T23:08:29+08:00	14791	31429	46220	2834	49054	85818	57.16%	17.24%	73	81
14	高雄市大寮區	2018-11-24T23:15:57+08:00	15452	32924	48376	2935	51311	89861	57.1%	17.2%	76	81
14	高雄市大寮區	2018-11-25T03:32:28+08:00	16625	35779	52404	3199	55603	97309	57.14%	17.08%	81	81
14	高雄市大寮區	2018-11-25T03:49:45+08:00	16625	35779	52404	3199	55603	97309	57.14%	17.08%	81	81
14	高雄市大寮區	2018-11-25T06:23:54+08:00	16625	35779	52404	3199	55603	97309	57.14%	17.08%	81	81
14	高雄市大寮區	2018-11-24T22:26:31+08:00	13111	27744	40855	2483	43338	75997	57.03%	17.25%	66	81
14	高雄市大寮區	2018-11-24T22:50:41+08:00	14367	30446	44813	2733	47546	83440	56.98%	17.22%	71	81
14	高雄市大寮區	2018-11-24T22:45:03+08:00	14367	30446	44813	2733	47546	83440	56.98%	17.22%	71	81
14	高雄市楠梓區	2018-11-25T06:29:10+08:00	28203	58257	86460	5454	91914	153132	60.02%	18.42%	99	99
14	高雄市楠梓區	2018-11-24T23:35:04+08:00	24153	49841	73994	4457	78451	131001	59.89%	18.44%	85	99
14	高雄市楠梓區	2018-11-24T23:47:21+08:00	26337	54067	80404	5000	85404	142545	59.91%	18.48%	92	99
14	高雄市楠梓區	2018-11-25T00:14:03+08:00	28036	57885	85921	5381	91302	152218	59.98%	18.42%	98	99
14	高雄市楠梓區	2018-11-24T23:12:09+08:00	20246	41495	61741	3828	65569	109124	60.09%	18.55%	73	99
14	高雄市楠梓區	2018-11-25T06:08:45+08:00	28203	58257	86460	5454	91914	153132	60.02%	18.42%	99	99
14	高雄市楠梓區	2018-11-24T23:43:11+08:00	26337	54067	80404	5000	85404	142545	59.91%	18.48%	92	99
14	高雄市楠梓區	2018-11-25T00:09:27+08:00	27436	56653	84089	5239	89328	148754	60.05%	18.44%	96	99
14	高雄市楠梓區	2018-11-24T22:33:31+08:00	15812	32624	48436	2874	51310	84880	60.45%	18.63%	58	99
14	高雄市楠梓區	2018-11-25T01:12:36+08:00	28203	58257	86460	5454	91914	153132	60.02%	18.42%	99	99
14	高雄市楠梓區	2018-11-25T04:02:42+08:00	28203	58257	86460	5454	91914	153132	60.02%	18.42%	99	99
14	高雄市楠梓區	2018-11-25T01:07:20+08:00	28203	58257	86460	5454	91914	153132	60.02%	18.42%	99	99
14	高雄市楠梓區	2018-11-24T23:39:07+08:00	24789	51204	75993	4588	80581	134698	59.82%	18.4%	87	99
14	高雄市楠梓區	2018-11-24T23:31:03+08:00	23885	49212	73097	4431	77528	129252	59.98%	18.48%	84	99
14	高雄市楠梓區	2018-11-24T23:01:24+08:00	19342	39780	59122	3651	62773	104172	60.26%	18.57%	70	99
14	高雄市楠梓區	2018-11-25T03:44:15+08:00	28203	58257	86460	5454	91914	153132	60.02%	18.42%	99	99
14	高雄市楠梓區	2018-11-24T23:19:42+08:00	22203	45490	67693	4130	71823	119682	60.01%	18.55%	79	99
14	高雄市楠梓區	2018-11-24T22:13:20+08:00	12009	25003	37012	2237	39249	65007	60.38%	18.47%	45	99
14	高雄市楠梓區	2018-11-25T00:04:58+08:00	27436	56653	84089	5239	89328	148754	60.05%	18.44%	96	99
14	高雄市楠梓區	2018-11-24T23:55:41+08:00	26909	55426	82335	5131	87466	145669	60.04%	18.47%	94	99
14	高雄市楠梓區	2018-11-24T22:23:06+08:00	14040	29290	43330	2574	45904	75938	60.45%	18.49%	52	99
14	高雄市楠梓區	2018-11-25T01:17:44+08:00	28203	58257	86460	5454	91914	153132	60.02%	18.42%	99	99
14	高雄市楠梓區	2018-11-24T23:04:58+08:00	19958	41009	60967	3757	64724	107596	60.15%	18.55%	72	99
14	高雄市楠梓區	2018-11-25T06:18:51+08:00	28203	58257	86460	5454	91914	153132	60.02%	18.42%	99	99
14	高雄市楠梓區	2018-11-25T01:02:24+08:00	28203	58257	86460	5454	91914	153132	60.02%	18.42%	99	99
14	高雄市楠梓區	2018-11-25T03:38:49+08:00	28203	58257	86460	5454	91914	153132	60.02%	18.42%	99	99
14	高雄市楠梓區	2018-11-24T23:27:12+08:00	22853	46921	69774	4264	74038	123370	60.01%	18.52%	81	99
14	高雄市楠梓區	2018-11-24T22:54:20+08:00	18775	38388	57163	3524	60687	100737	60.24%	18.64%	68	99
14	高雄市楠梓區	2018-11-25T00:18:23+08:00	28036	57885	85921	5381	91302	152218	59.98%	18.42%	98	99
14	高雄市楠梓區	2018-11-25T06:13:46+08:00	28203	58257	86460	5454	91914	153132	60.02%	18.42%	99	99
14	高雄市楠梓區	2018-11-25T00:22:57+08:00	28203	58257	86460	5454	91914	153132	60.02%	18.42%	99	99
14	高雄市楠梓區	2018-11-25T03:56:04+08:00	28203	58257	86460	5454	91914	153132	60.02%	18.42%	99	99
14	高雄市楠梓區	2018-11-24T22:41:29+08:00	16961	34955	51916	3197	55113	91217	60.42%	18.59%	62	99
14	高雄市楠梓區	2018-11-24T22:16:03+08:00	12555	26361	38916	2340	41256	68271	60.43%	18.39%	47	99
14	高雄市楠梓區	2018-11-24T22:29:59+08:00	15168	31611	46779	2791	49570	82103	60.38%	18.47%	56	99
14	高雄市楠梓區	2018-11-24T23:23:32+08:00	22203	45490	67693	4130	71823	119682	60.01%	18.55%	79	99
14	高雄市楠梓區	2018-11-24T23:51:28+08:00	26909	55426	82335	5131	87466	145669	60.04%	18.47%	94	99
14	高雄市楠梓區	2018-11-24T22:57:46+08:00	19342	39780	59122	3651	62773	104172	60.26%	18.57%	70	99
14	高雄市楠梓區	2018-11-25T00:00:01+08:00	27238	56090	83328	5179	88507	147315	60.08%	18.49%	95	99
14	高雄市楠梓區	2018-11-25T01:25:46+08:00	28203	58257	86460	5454	91914	153132	60.02%	18.42%	99	99
14	高雄市楠梓區	2018-11-24T22:19:31+08:00	13119	27305	40424	2419	42843	70893	60.43%	18.51%	49	99
14	高雄市楠梓區	2018-11-25T00:57:30+08:00	28203	58257	86460	5454	91914	153132	60.02%	18.42%	99	99
14	高雄市楠梓區	2018-11-24T22:40:22+08:00	16961	34955	51916	3197	55113	91217	60.42%	18.59%	62	99
14	高雄市楠梓區	2018-11-24T22:36:55+08:00	16695	34449	51144	3083	54227	89724	60.44%	18.61%	61	99
14	高雄市楠梓區	2018-11-24T23:08:29+08:00	20246	41495	61741	3828	65569	109124	60.09%	18.55%	73	99
14	高雄市楠梓區	2018-11-24T23:15:57+08:00	21900	44891	66791	4062	70853	118186	59.95%	18.53%	78	99
14	高雄市楠梓區	2018-11-25T03:32:28+08:00	28203	58257	86460	5454	91914	153132	60.02%	18.42%	99	99
14	高雄市楠梓區	2018-11-24T22:45:02+08:00	17801	36596	54397	3354	57751	95686	60.35%	18.6%	65	99
14	高雄市楠梓區	2018-11-24T22:50:40+08:00	18132	37201	55333	3385	58718	97277	60.36%	18.64%	66	99
14	高雄市楠梓區	2018-11-25T03:49:45+08:00	28203	58257	86460	5454	91914	153132	60.02%	18.42%	99	99
14	高雄市楠梓區	2018-11-25T06:23:54+08:00	28203	58257	86460	5454	91914	153132	60.02%	18.42%	99	99
14	高雄市楠梓區	2018-11-24T22:26:31+08:00	14623	30584	45207	2661	47868	79328	60.34%	18.43%	54	99
14	苗栗縣卓蘭鎮	2018-11-25T04:02:44+08:00	2247	5873	8120	567	8687	14772	58.81%	15.21%	19	19
14	苗栗縣卓蘭鎮	2018-11-25T00:09:29+08:00	2247	5873	8120	567	8687	14772	58.81%	15.21%	19	19
14	苗栗縣卓蘭鎮	2018-11-25T01:12:38+08:00	2247	5873	8120	567	8687	14772	58.81%	15.21%	19	19
14	苗栗縣卓蘭鎮	2018-11-25T00:14:05+08:00	2247	5873	8120	567	8687	14772	58.81%	15.21%	19	19
14	苗栗縣卓蘭鎮	2018-11-24T23:19:45+08:00	2052	5414	7466	516	7982	13677	58.36%	15%	18	19
14	苗栗縣卓蘭鎮	2018-11-25T00:00:03+08:00	2052	5414	7466	516	7982	13677	58.36%	15%	18	19
14	苗栗縣卓蘭鎮	2018-11-24T22:23:08+08:00	1930	5031	6961	502	7463	12737	58.59%	15.15%	17	19
14	苗栗縣卓蘭鎮	2018-11-24T23:08:31+08:00	2052	5414	7466	516	7982	13677	58.36%	15%	18	19
14	苗栗縣卓蘭鎮	2018-11-25T03:32:30+08:00	2247	5873	8120	567	8687	14772	58.81%	15.21%	19	19
14	苗栗縣卓蘭鎮	2018-11-24T23:51:30+08:00	2052	5414	7466	516	7982	13677	58.36%	15%	18	19
14	苗栗縣卓蘭鎮	2018-11-24T22:30:01+08:00	1930	5031	6961	502	7463	12737	58.59%	15.15%	17	19
14	苗栗縣卓蘭鎮	2018-11-24T23:27:14+08:00	2052	5414	7466	516	7982	13677	58.36%	15%	18	19
14	苗栗縣卓蘭鎮	2018-11-24T22:19:32+08:00	1930	5031	6961	502	7463	12737	58.59%	15.15%	17	19
14	苗栗縣卓蘭鎮	2018-11-25T00:57:32+08:00	2247	5873	8120	567	8687	14772	58.81%	15.21%	19	19
14	苗栗縣卓蘭鎮	2018-11-24T22:36:56+08:00	2052	5414	7466	516	7982	13677	58.36%	15%	18	19
14	苗栗縣卓蘭鎮	2018-11-24T22:50:43+08:00	2052	5414	7466	516	7982	13677	58.36%	15%	18	19
14	苗栗縣卓蘭鎮	2018-11-25T00:18:25+08:00	2247	5873	8120	567	8687	14772	58.81%	15.21%	19	19
14	苗栗縣卓蘭鎮	2018-11-25T06:23:56+08:00	2247	5873	8120	567	8687	14772	58.81%	15.21%	19	19
14	苗栗縣卓蘭鎮	2018-11-24T22:26:33+08:00	1930	5031	6961	502	7463	12737	58.59%	15.15%	17	19
14	苗栗縣卓蘭鎮	2018-11-24T23:05:00+08:00	2052	5414	7466	516	7982	13677	58.36%	15%	18	19
14	苗栗縣卓蘭鎮	2018-11-25T03:49:47+08:00	2247	5873	8120	567	8687	14772	58.81%	15.21%	19	19
14	苗栗縣卓蘭鎮	2018-11-24T22:41:31+08:00	2052	5414	7466	516	7982	13677	58.36%	15%	18	19
14	苗栗縣卓蘭鎮	2018-11-25T06:13:48+08:00	2247	5873	8120	567	8687	14772	58.81%	15.21%	19	19
14	苗栗縣卓蘭鎮	2018-11-25T00:05:00+08:00	2052	5414	7466	516	7982	13677	58.36%	15%	18	19
14	苗栗縣卓蘭鎮	2018-11-25T00:22:59+08:00	2247	5873	8120	567	8687	14772	58.81%	15.21%	19	19
14	苗栗縣卓蘭鎮	2018-11-24T23:31:06+08:00	2052	5414	7466	516	7982	13677	58.36%	15%	18	19
14	苗栗縣卓蘭鎮	2018-11-24T22:16:05+08:00	1930	5031	6961	502	7463	12737	58.59%	15.15%	17	19
14	苗栗縣卓蘭鎮	2018-11-24T23:01:26+08:00	2052	5414	7466	516	7982	13677	58.36%	15%	18	19
14	苗栗縣卓蘭鎮	2018-11-25T01:07:22+08:00	2247	5873	8120	567	8687	14772	58.81%	15.21%	19	19
14	苗栗縣卓蘭鎮	2018-11-24T22:33:33+08:00	1930	5031	6961	502	7463	12737	58.59%	15.15%	17	19
14	苗栗縣卓蘭鎮	2018-11-24T23:43:13+08:00	2052	5414	7466	516	7982	13677	58.36%	15%	18	19
14	苗栗縣卓蘭鎮	2018-11-25T06:08:47+08:00	2247	5873	8120	567	8687	14772	58.81%	15.21%	19	19
14	苗栗縣卓蘭鎮	2018-11-24T23:35:06+08:00	2052	5414	7466	516	7982	13677	58.36%	15%	18	19
14	苗栗縣卓蘭鎮	2018-11-24T23:47:23+08:00	2052	5414	7466	516	7982	13677	58.36%	15%	18	19
14	苗栗縣卓蘭鎮	2018-11-25T06:29:12+08:00	2247	5873	8120	567	8687	14772	58.81%	15.21%	19	19
14	苗栗縣卓蘭鎮	2018-11-24T23:55:42+08:00	2052	5414	7466	516	7982	13677	58.36%	15%	18	19
14	苗栗縣卓蘭鎮	2018-11-25T01:17:46+08:00	2247	5873	8120	567	8687	14772	58.81%	15.21%	19	19
14	苗栗縣卓蘭鎮	2018-11-24T22:57:48+08:00	2052	5414	7466	516	7982	13677	58.36%	15%	18	19
14	苗栗縣卓蘭鎮	2018-11-24T23:23:34+08:00	2052	5414	7466	516	7982	13677	58.36%	15%	18	19
14	苗栗縣卓蘭鎮	2018-11-25T03:38:51+08:00	2247	5873	8120	567	8687	14772	58.81%	15.21%	19	19
14	苗栗縣卓蘭鎮	2018-11-24T22:13:22+08:00	1930	5031	6961	502	7463	12737	58.59%	15.15%	17	19
14	苗栗縣卓蘭鎮	2018-11-25T03:44:17+08:00	2247	5873	8120	567	8687	14772	58.81%	15.21%	19	19
14	苗栗縣卓蘭鎮	2018-11-25T01:25:48+08:00	2247	5873	8120	567	8687	14772	58.81%	15.21%	19	19
14	苗栗縣卓蘭鎮	2018-11-24T22:40:24+08:00	2052	5414	7466	516	7982	13677	58.36%	15%	18	19
14	苗栗縣卓蘭鎮	2018-11-24T23:15:58+08:00	2052	5414	7466	516	7982	13677	58.36%	15%	18	19
14	苗栗縣卓蘭鎮	2018-11-25T01:02:26+08:00	2247	5873	8120	567	8687	14772	58.81%	15.21%	19	19
14	苗栗縣卓蘭鎮	2018-11-25T06:18:53+08:00	2247	5873	8120	567	8687	14772	58.81%	15.21%	19	19
14	苗栗縣卓蘭鎮	2018-11-24T23:12:11+08:00	2052	5414	7466	516	7982	13677	58.36%	15%	18	19
14	苗栗縣卓蘭鎮	2018-11-24T23:39:10+08:00	2052	5414	7466	516	7982	13677	58.36%	15%	18	19
14	苗栗縣卓蘭鎮	2018-11-25T03:56:07+08:00	2247	5873	8120	567	8687	14772	58.81%	15.21%	19	19
14	苗栗縣卓蘭鎮	2018-11-24T22:45:04+08:00	2052	5414	7466	516	7982	13677	58.36%	15%	18	19
14	苗栗縣卓蘭鎮	2018-11-24T22:54:22+08:00	2052	5414	7466	516	7982	13677	58.36%	15%	18	19
14	苗栗縣獅潭鄉	2018-11-25T04:02:44+08:00	436	1421	1857	183	2040	3968	51.41%	10.99%	7	7
14	苗栗縣獅潭鄉	2018-11-25T00:09:29+08:00	436	1421	1857	183	2040	3968	51.41%	10.99%	7	7
14	苗栗縣獅潭鄉	2018-11-24T22:16:06+08:00	436	1421	1857	183	2040	3968	51.41%	10.99%	7	7
14	苗栗縣獅潭鄉	2018-11-25T01:12:38+08:00	436	1421	1857	183	2040	3968	51.41%	10.99%	7	7
14	苗栗縣獅潭鄉	2018-11-25T00:14:05+08:00	436	1421	1857	183	2040	3968	51.41%	10.99%	7	7
14	苗栗縣獅潭鄉	2018-11-25T00:00:03+08:00	436	1421	1857	183	2040	3968	51.41%	10.99%	7	7
14	苗栗縣獅潭鄉	2018-11-24T22:23:08+08:00	436	1421	1857	183	2040	3968	51.41%	10.99%	7	7
14	苗栗縣獅潭鄉	2018-11-24T23:08:31+08:00	436	1421	1857	183	2040	3968	51.41%	10.99%	7	7
14	苗栗縣獅潭鄉	2018-11-25T03:32:30+08:00	436	1421	1857	183	2040	3968	51.41%	10.99%	7	7
14	苗栗縣獅潭鄉	2018-11-24T23:27:14+08:00	436	1421	1857	183	2040	3968	51.41%	10.99%	7	7
14	苗栗縣獅潭鄉	2018-11-24T23:51:31+08:00	436	1421	1857	183	2040	3968	51.41%	10.99%	7	7
14	苗栗縣獅潭鄉	2018-11-24T22:19:33+08:00	436	1421	1857	183	2040	3968	51.41%	10.99%	7	7
14	苗栗縣獅潭鄉	2018-11-25T00:57:32+08:00	436	1421	1857	183	2040	3968	51.41%	10.99%	7	7
14	苗栗縣獅潭鄉	2018-11-24T22:36:56+08:00	436	1421	1857	183	2040	3968	51.41%	10.99%	7	7
14	苗栗縣獅潭鄉	2018-11-24T22:50:43+08:00	436	1421	1857	183	2040	3968	51.41%	10.99%	7	7
14	苗栗縣獅潭鄉	2018-11-25T06:23:56+08:00	436	1421	1857	183	2040	3968	51.41%	10.99%	7	7
14	苗栗縣獅潭鄉	2018-11-24T22:26:33+08:00	436	1421	1857	183	2040	3968	51.41%	10.99%	7	7
14	苗栗縣獅潭鄉	2018-11-25T03:49:47+08:00	436	1421	1857	183	2040	3968	51.41%	10.99%	7	7
14	苗栗縣獅潭鄉	2018-11-24T22:41:31+08:00	436	1421	1857	183	2040	3968	51.41%	10.99%	7	7
14	苗栗縣獅潭鄉	2018-11-25T00:05:01+08:00	436	1421	1857	183	2040	3968	51.41%	10.99%	7	7
14	苗栗縣獅潭鄉	2018-11-25T06:13:48+08:00	436	1421	1857	183	2040	3968	51.41%	10.99%	7	7
14	苗栗縣獅潭鄉	2018-11-25T00:22:59+08:00	436	1421	1857	183	2040	3968	51.41%	10.99%	7	7
14	苗栗縣獅潭鄉	2018-11-24T23:05:01+08:00	436	1421	1857	183	2040	3968	51.41%	10.99%	7	7
14	苗栗縣獅潭鄉	2018-11-24T23:31:06+08:00	436	1421	1857	183	2040	3968	51.41%	10.99%	7	7
14	苗栗縣獅潭鄉	2018-11-25T06:08:48+08:00	436	1421	1857	183	2040	3968	51.41%	10.99%	7	7
14	苗栗縣獅潭鄉	2018-11-25T01:07:22+08:00	436	1421	1857	183	2040	3968	51.41%	10.99%	7	7
14	苗栗縣獅潭鄉	2018-11-24T22:33:33+08:00	436	1421	1857	183	2040	3968	51.41%	10.99%	7	7
14	苗栗縣獅潭鄉	2018-11-24T23:43:13+08:00	436	1421	1857	183	2040	3968	51.41%	10.99%	7	7
14	苗栗縣獅潭鄉	2018-11-24T23:01:27+08:00	436	1421	1857	183	2040	3968	51.41%	10.99%	7	7
14	苗栗縣獅潭鄉	2018-11-24T23:35:06+08:00	436	1421	1857	183	2040	3968	51.41%	10.99%	7	7
14	苗栗縣獅潭鄉	2018-11-25T06:29:12+08:00	436	1421	1857	183	2040	3968	51.41%	10.99%	7	7
14	苗栗縣獅潭鄉	2018-11-24T23:47:24+08:00	436	1421	1857	183	2040	3968	51.41%	10.99%	7	7
14	苗栗縣獅潭鄉	2018-11-24T23:19:46+08:00	436	1421	1857	183	2040	3968	51.41%	10.99%	7	7
14	苗栗縣獅潭鄉	2018-11-25T03:44:18+08:00	436	1421	1857	183	2040	3968	51.41%	10.99%	7	7
14	苗栗縣獅潭鄉	2018-11-24T23:23:34+08:00	436	1421	1857	183	2040	3968	51.41%	10.99%	7	7
14	苗栗縣獅潭鄉	2018-11-24T23:55:43+08:00	436	1421	1857	183	2040	3968	51.41%	10.99%	7	7
14	苗栗縣獅潭鄉	2018-11-25T03:38:51+08:00	436	1421	1857	183	2040	3968	51.41%	10.99%	7	7
14	苗栗縣獅潭鄉	2018-11-24T22:57:49+08:00	436	1421	1857	183	2040	3968	51.41%	10.99%	7	7
14	苗栗縣獅潭鄉	2018-11-24T22:13:22+08:00	436	1421	1857	183	2040	3968	51.41%	10.99%	7	7
14	苗栗縣獅潭鄉	2018-11-25T01:17:47+08:00	436	1421	1857	183	2040	3968	51.41%	10.99%	7	7
14	苗栗縣獅潭鄉	2018-11-24T22:30:02+08:00	436	1421	1857	183	2040	3968	51.41%	10.99%	7	7
14	苗栗縣獅潭鄉	2018-11-25T01:25:48+08:00	436	1421	1857	183	2040	3968	51.41%	10.99%	7	7
14	苗栗縣獅潭鄉	2018-11-24T22:40:24+08:00	436	1421	1857	183	2040	3968	51.41%	10.99%	7	7
14	苗栗縣獅潭鄉	2018-11-25T01:02:26+08:00	436	1421	1857	183	2040	3968	51.41%	10.99%	7	7
14	苗栗縣獅潭鄉	2018-11-24T23:15:59+08:00	436	1421	1857	183	2040	3968	51.41%	10.99%	7	7
14	苗栗縣獅潭鄉	2018-11-25T06:18:53+08:00	436	1421	1857	183	2040	3968	51.41%	10.99%	7	7
14	苗栗縣獅潭鄉	2018-11-24T23:12:11+08:00	436	1421	1857	183	2040	3968	51.41%	10.99%	7	7
14	苗栗縣獅潭鄉	2018-11-25T00:18:26+08:00	436	1421	1857	183	2040	3968	51.41%	10.99%	7	7
14	苗栗縣獅潭鄉	2018-11-24T23:39:10+08:00	436	1421	1857	183	2040	3968	51.41%	10.99%	7	7
14	苗栗縣獅潭鄉	2018-11-25T03:56:07+08:00	436	1421	1857	183	2040	3968	51.41%	10.99%	7	7
14	苗栗縣獅潭鄉	2018-11-24T22:45:04+08:00	436	1421	1857	183	2040	3968	51.41%	10.99%	7	7
14	苗栗縣獅潭鄉	2018-11-24T22:54:22+08:00	436	1421	1857	183	2040	3968	51.41%	10.99%	7	7
14	臺中市外埔區	2018-11-24T23:35:03+08:00	3965	10906	14871	999	15870	27059	58.65%	14.65%	20	20
14	臺中市外埔區	2018-11-24T22:16:01+08:00	3692	10182	13874	925	14799	25157	58.83%	14.68%	19	20
14	臺中市外埔區	2018-11-24T23:31:02+08:00	3965	10906	14871	999	15870	27059	58.65%	14.65%	20	20
14	臺中市外埔區	2018-11-24T23:01:22+08:00	3965	10906	14871	999	15870	27059	58.65%	14.65%	20	20
14	臺中市外埔區	2018-11-24T23:12:07+08:00	3965	10906	14871	999	15870	27059	58.65%	14.65%	20	20
14	臺中市外埔區	2018-11-24T23:47:20+08:00	3965	10906	14871	999	15870	27059	58.65%	14.65%	20	20
14	臺中市外埔區	2018-11-25T01:07:18+08:00	3965	10906	14871	999	15870	27059	58.65%	14.65%	20	20
14	臺中市外埔區	2018-11-25T06:08:43+08:00	3965	10906	14871	999	15870	27059	58.65%	14.65%	20	20
14	臺中市外埔區	2018-11-24T22:26:29+08:00	3692	10182	13874	925	14799	25157	58.83%	14.68%	19	20
14	臺中市外埔區	2018-11-24T22:57:45+08:00	3965	10906	14871	999	15870	27059	58.65%	14.65%	20	20
14	臺中市外埔區	2018-11-25T01:17:42+08:00	3965	10906	14871	999	15870	27059	58.65%	14.65%	20	20
14	臺中市外埔區	2018-11-24T22:13:18+08:00	3692	10182	13874	925	14799	25157	58.83%	14.68%	19	20
14	臺中市外埔區	2018-11-24T22:19:29+08:00	3692	10182	13874	925	14799	25157	58.83%	14.68%	19	20
14	臺中市外埔區	2018-11-25T00:57:28+08:00	3965	10906	14871	999	15870	27059	58.65%	14.65%	20	20
14	臺中市外埔區	2018-11-24T23:23:31+08:00	3965	10906	14871	999	15870	27059	58.65%	14.65%	20	20
14	臺中市外埔區	2018-11-25T03:44:13+08:00	3965	10906	14871	999	15870	27059	58.65%	14.65%	20	20
14	臺中市外埔區	2018-11-25T00:04:57+08:00	3965	10906	14871	999	15870	27059	58.65%	14.65%	20	20
14	臺中市外埔區	2018-11-24T23:04:56+08:00	3965	10906	14871	999	15870	27059	58.65%	14.65%	20	20
14	臺中市外埔區	2018-11-24T23:15:55+08:00	3965	10906	14871	999	15870	27059	58.65%	14.65%	20	20
14	臺中市外埔區	2018-11-24T22:40:20+08:00	3965	10906	14871	999	15870	27059	58.65%	14.65%	20	20
14	臺中市外埔區	2018-11-25T01:25:44+08:00	3965	10906	14871	999	15870	27059	58.65%	14.65%	20	20
14	臺中市外埔區	2018-11-25T01:02:22+08:00	3965	10906	14871	999	15870	27059	58.65%	14.65%	20	20
14	臺中市外埔區	2018-11-25T03:38:47+08:00	3965	10906	14871	999	15870	27059	58.65%	14.65%	20	20
14	臺中市外埔區	2018-11-24T23:55:39+08:00	3965	10906	14871	999	15870	27059	58.65%	14.65%	20	20
14	臺中市外埔區	2018-11-24T22:54:18+08:00	3965	10906	14871	999	15870	27059	58.65%	14.65%	20	20
14	臺中市外埔區	2018-11-24T22:45:01+08:00	3965	10906	14871	999	15870	27059	58.65%	14.65%	20	20
14	臺中市外埔區	2018-11-25T00:18:22+08:00	3965	10906	14871	999	15870	27059	58.65%	14.65%	20	20
14	臺中市外埔區	2018-11-25T00:22:56+08:00	3965	10906	14871	999	15870	27059	58.65%	14.65%	20	20
14	臺中市外埔區	2018-11-25T03:56:02+08:00	3965	10906	14871	999	15870	27059	58.65%	14.65%	20	20
14	臺中市外埔區	2018-11-24T23:39:05+08:00	3965	10906	14871	999	15870	27059	58.65%	14.65%	20	20
14	臺中市外埔區	2018-11-25T01:12:34+08:00	3965	10906	14871	999	15870	27059	58.65%	14.65%	20	20
14	臺中市外埔區	2018-11-24T22:41:27+08:00	3965	10906	14871	999	15870	27059	58.65%	14.65%	20	20
14	臺中市外埔區	2018-11-25T04:02:40+08:00	3965	10906	14871	999	15870	27059	58.65%	14.65%	20	20
14	臺中市外埔區	2018-11-25T00:09:25+08:00	3965	10906	14871	999	15870	27059	58.65%	14.65%	20	20
14	臺中市外埔區	2018-11-25T00:14:01+08:00	3965	10906	14871	999	15870	27059	58.65%	14.65%	20	20
14	臺中市外埔區	2018-11-24T22:50:38+08:00	3965	10906	14871	999	15870	27059	58.65%	14.65%	20	20
14	臺中市外埔區	2018-11-24T23:51:26+08:00	3965	10906	14871	999	15870	27059	58.65%	14.65%	20	20
14	臺中市外埔區	2018-11-25T00:00:00+08:00	3965	10906	14871	999	15870	27059	58.65%	14.65%	20	20
14	臺中市外埔區	2018-11-25T06:18:49+08:00	3965	10906	14871	999	15870	27059	58.65%	14.65%	20	20
14	臺中市外埔區	2018-11-24T22:23:04+08:00	3692	10182	13874	925	14799	25157	58.83%	14.68%	19	20
14	臺中市外埔區	2018-11-24T22:29:56+08:00	3965	10906	14871	999	15870	27059	58.65%	14.65%	20	20
14	臺中市外埔區	2018-11-24T23:19:40+08:00	3965	10906	14871	999	15870	27059	58.65%	14.65%	20	20
14	臺中市外埔區	2018-11-24T22:36:53+08:00	3965	10906	14871	999	15870	27059	58.65%	14.65%	20	20
14	臺中市外埔區	2018-11-24T23:27:11+08:00	3965	10906	14871	999	15870	27059	58.65%	14.65%	20	20
14	臺中市外埔區	2018-11-24T23:08:27+08:00	3965	10906	14871	999	15870	27059	58.65%	14.65%	20	20
14	臺中市外埔區	2018-11-25T03:32:26+08:00	3965	10906	14871	999	15870	27059	58.65%	14.65%	20	20
14	臺中市外埔區	2018-11-25T03:49:43+08:00	3965	10906	14871	999	15870	27059	58.65%	14.65%	20	20
14	臺中市外埔區	2018-11-25T06:29:08+08:00	3965	10906	14871	999	15870	27059	58.65%	14.65%	20	20
14	臺中市外埔區	2018-11-25T06:13:44+08:00	3965	10906	14871	999	15870	27059	58.65%	14.65%	20	20
14	臺中市外埔區	2018-11-25T06:23:52+08:00	3965	10906	14871	999	15870	27059	58.65%	14.65%	20	20
14	臺中市外埔區	2018-11-24T23:43:09+08:00	3965	10906	14871	999	15870	27059	58.65%	14.65%	20	20
14	臺中市外埔區	2018-11-24T22:33:29+08:00	3965	10906	14871	999	15870	27059	58.65%	14.65%	20	20
14	彰化縣鹿港鎮	2018-11-25T01:12:39+08:00	10989	27443	38432	2624	41056	70505	58.23%	15.59%	65	65
14	彰化縣鹿港鎮	2018-11-24T22:16:06+08:00	6181	15056	21237	1463	22700	38439	59.05%	16.08%	37	65
14	彰化縣鹿港鎮	2018-11-25T00:14:05+08:00	10080	25144	35224	2411	37635	64417	58.42%	15.65%	60	65
14	彰化縣鹿港鎮	2018-11-25T04:02:45+08:00	10989	27443	38432	2624	41056	70505	58.23%	15.59%	65	65
14	彰化縣鹿港鎮	2018-11-24T22:23:09+08:00	6353	15520	21873	1500	23373	39600	59.02%	16.04%	38	65
14	彰化縣鹿港鎮	2018-11-25T03:32:31+08:00	10989	27443	38432	2624	41056	70505	58.23%	15.59%	65	65
14	彰化縣鹿港鎮	2018-11-25T00:00:04+08:00	9926	24635	34561	2368	36929	63144	58.48%	15.72%	59	65
14	彰化縣鹿港鎮	2018-11-25T00:23:00+08:00	10264	25640	35904	2445	38349	65713	58.36%	15.62%	61	65
14	彰化縣鹿港鎮	2018-11-24T22:36:57+08:00	6648	16251	22899	1578	24477	41464	59.03%	16.03%	40	65
14	彰化縣鹿港鎮	2018-11-25T00:57:33+08:00	10828	26852	37680	2579	40259	69061	58.29%	15.68%	64	65
14	彰化縣鹿港鎮	2018-11-24T23:51:31+08:00	9609	23718	33327	2272	35599	60754	58.6%	15.82%	57	65
14	彰化縣鹿港鎮	2018-11-24T23:27:15+08:00	8650	21253	29903	1999	31902	53905	59.18%	16.05%	51	65
14	彰化縣鹿港鎮	2018-11-24T22:19:33+08:00	6353	15520	21873	1500	23373	39600	59.02%	16.04%	38	65
14	彰化縣鹿港鎮	2018-11-24T23:12:12+08:00	7306	18042	25348	1712	27060	45809	59.07%	15.95%	44	65
14	彰化縣鹿港鎮	2018-11-24T22:50:43+08:00	6648	16251	22899	1578	24477	41464	59.03%	16.03%	40	65
14	彰化縣鹿港鎮	2018-11-25T06:13:49+08:00	10989	27443	38432	2624	41056	70505	58.23%	15.59%	65	65
14	彰化縣鹿港鎮	2018-11-25T06:23:56+08:00	10989	27443	38432	2624	41056	70505	58.23%	15.59%	65	65
14	彰化縣鹿港鎮	2018-11-24T22:26:33+08:00	6353	15520	21873	1500	23373	39600	59.02%	16.04%	38	65
14	彰化縣鹿港鎮	2018-11-25T03:49:47+08:00	10989	27443	38432	2624	41056	70505	58.23%	15.59%	65	65
14	彰化縣鹿港鎮	2018-11-24T22:41:31+08:00	6648	16251	22899	1578	24477	41464	59.03%	16.03%	40	65
14	彰化縣鹿港鎮	2018-11-25T00:05:01+08:00	9926	24635	34561	2368	36929	63144	58.48%	15.72%	59	65
14	彰化縣鹿港鎮	2018-11-24T23:05:01+08:00	7122	17533	24655	1669	26324	44582	59.05%	15.98%	43	65
14	彰化縣鹿港鎮	2018-11-24T23:31:06+08:00	8841	21614	30455	2078	32533	55042	59.11%	16.06%	52	65
14	彰化縣鹿港鎮	2018-11-25T06:08:48+08:00	10989	27443	38432	2624	41056	70505	58.23%	15.59%	65	65
14	彰化縣鹿港鎮	2018-11-25T01:07:22+08:00	10828	26852	37680	2579	40259	69061	58.29%	15.68%	64	65
14	彰化縣鹿港鎮	2018-11-25T06:29:13+08:00	10989	27443	38432	2624	41056	70505	58.23%	15.59%	65	65
14	彰化縣鹿港鎮	2018-11-24T23:35:07+08:00	9035	22178	31213	2113	33326	56614	58.87%	15.96%	53	65
14	彰化縣鹿港鎮	2018-11-24T22:33:34+08:00	6495	15899	22394	1526	23920	40584	58.94%	16%	39	65
14	彰化縣鹿港鎮	2018-11-24T23:43:13+08:00	9283	22907	32190	2187	34377	58539	58.72%	15.86%	55	65
14	彰化縣鹿港鎮	2018-11-24T23:01:27+08:00	6960	17114	24074	1632	25706	43579	58.99%	15.97%	42	65
14	彰化縣鹿港鎮	2018-11-24T23:47:24+08:00	9283	22907	32190	2187	34377	58539	58.72%	15.86%	55	65
14	彰化縣鹿港鎮	2018-11-24T23:23:35+08:00	8502	20903	29405	1982	31387	52998	59.22%	16.04%	50	65
14	彰化縣鹿港鎮	2018-11-24T23:19:46+08:00	8140	20010	28150	1885	30035	50764	59.17%	16.03%	48	65
14	彰化縣鹿港鎮	2018-11-24T22:13:23+08:00	6007	14611	20618	1427	22045	37342	59.04%	16.09%	36	65
14	彰化縣鹿港鎮	2018-11-25T03:44:18+08:00	10989	27443	38432	2624	41056	70505	58.23%	15.59%	65	65
14	彰化縣鹿港鎮	2018-11-24T23:55:43+08:00	9926	24635	34561	2368	36929	63144	58.48%	15.72%	59	65
14	彰化縣鹿港鎮	2018-11-24T23:08:32+08:00	7122	17533	24655	1669	26324	44582	59.05%	15.98%	43	65
14	彰化縣鹿港鎮	2018-11-25T03:38:51+08:00	10989	27443	38432	2624	41056	70505	58.23%	15.59%	65	65
14	彰化縣鹿港鎮	2018-11-24T22:57:49+08:00	6960	17114	24074	1632	25706	43579	58.99%	15.97%	42	65
14	彰化縣鹿港鎮	2018-11-25T01:17:47+08:00	10989	27443	38432	2624	41056	70505	58.23%	15.59%	65	65
14	彰化縣鹿港鎮	2018-11-24T22:30:02+08:00	6353	15520	21873	1500	23373	39600	59.02%	16.04%	38	65
14	彰化縣鹿港鎮	2018-11-24T22:40:24+08:00	6648	16251	22899	1578	24477	41464	59.03%	16.03%	40	65
14	彰化縣鹿港鎮	2018-11-25T01:02:26+08:00	10828	26852	37680	2579	40259	69061	58.29%	15.68%	64	65
14	彰化縣鹿港鎮	2018-11-25T01:25:49+08:00	10989	27443	38432	2624	41056	70505	58.23%	15.59%	65	65
14	彰化縣鹿港鎮	2018-11-24T23:15:59+08:00	7967	19573	27540	1833	29373	49539	59.29%	16.08%	47	65
14	彰化縣鹿港鎮	2018-11-25T06:18:53+08:00	10989	27443	38432	2624	41056	70505	58.23%	15.59%	65	65
14	彰化縣鹿港鎮	2018-11-25T03:56:08+08:00	10989	27443	38432	2624	41056	70505	58.23%	15.59%	65	65
14	彰化縣鹿港鎮	2018-11-24T22:45:05+08:00	6648	16251	22899	1578	24477	41464	59.03%	16.03%	40	65
14	彰化縣鹿港鎮	2018-11-25T00:18:26+08:00	10264	25640	35904	2445	38349	65713	58.36%	15.62%	61	65
14	彰化縣鹿港鎮	2018-11-24T23:39:11+08:00	9283	22907	32190	2187	34377	58539	58.72%	15.86%	55	65
14	彰化縣鹿港鎮	2018-11-25T00:09:30+08:00	9926	24635	34561	2368	36929	63144	58.48%	15.72%	59	65
14	彰化縣鹿港鎮	2018-11-24T22:54:22+08:00	6821	16667	23488	1599	25087	42561	58.94%	16.03%	41	65
14	臺東縣綠島鄉	2018-11-25T06:29:17+08:00	481	1040	1521	58	1579	3579	44.12%	13.44%	4	4
14	臺東縣綠島鄉	2018-11-25T03:49:52+08:00	481	1040	1521	58	1579	3579	44.12%	13.44%	4	4
14	臺東縣綠島鄉	2018-11-24T23:47:29+08:00	481	1040	1521	58	1579	3579	44.12%	13.44%	4	4
14	臺東縣綠島鄉	2018-11-24T22:33:38+08:00	332	735	1067	39	1106	2497	44.29%	13.3%	3	4
14	臺東縣綠島鄉	2018-11-25T01:07:27+08:00	481	1040	1521	58	1579	3579	44.12%	13.44%	4	4
14	臺東縣綠島鄉	2018-11-25T06:13:53+08:00	481	1040	1521	58	1579	3579	44.12%	13.44%	4	4
14	臺東縣綠島鄉	2018-11-24T23:43:17+08:00	481	1040	1521	58	1579	3579	44.12%	13.44%	4	4
14	臺東縣綠島鄉	2018-11-25T00:18:31+08:00	481	1040	1521	58	1579	3579	44.12%	13.44%	4	4
14	臺東縣綠島鄉	2018-11-24T22:37:01+08:00	332	735	1067	39	1106	2497	44.29%	13.3%	3	4
14	臺東縣綠島鄉	2018-11-25T03:44:24+08:00	481	1040	1521	58	1579	3579	44.12%	13.44%	4	4
14	臺東縣綠島鄉	2018-11-24T23:08:37+08:00	332	735	1067	39	1106	2497	44.29%	13.3%	3	4
14	臺東縣綠島鄉	2018-11-24T22:13:28+08:00	163	302	465	18	483	1023	47.21%	15.93%	2	4
14	臺東縣綠島鄉	2018-11-24T23:55:47+08:00	481	1040	1521	58	1579	3579	44.12%	13.44%	4	4
14	臺東縣綠島鄉	2018-11-24T23:23:39+08:00	332	735	1067	39	1106	2497	44.29%	13.3%	3	4
14	臺東縣綠島鄉	2018-11-25T06:18:58+08:00	481	1040	1521	58	1579	3579	44.12%	13.44%	4	4
14	臺東縣綠島鄉	2018-11-25T00:00:11+08:00	481	1040	1521	58	1579	3579	44.12%	13.44%	4	4
14	臺東縣綠島鄉	2018-11-24T23:51:36+08:00	481	1040	1521	58	1579	3579	44.12%	13.44%	4	4
14	臺東縣綠島鄉	2018-11-24T22:23:14+08:00	163	302	465	18	483	1023	47.21%	15.93%	2	4
14	臺東縣綠島鄉	2018-11-24T22:40:28+08:00	332	735	1067	39	1106	2497	44.29%	13.3%	3	4
14	臺東縣綠島鄉	2018-11-25T00:09:35+08:00	481	1040	1521	58	1579	3579	44.12%	13.44%	4	4
14	臺東縣綠島鄉	2018-11-25T00:05:06+08:00	481	1040	1521	58	1579	3579	44.12%	13.44%	4	4
14	臺東縣綠島鄉	2018-11-24T23:35:11+08:00	332	735	1067	39	1106	2497	44.29%	13.3%	3	4
14	臺東縣綠島鄉	2018-11-24T22:41:36+08:00	332	735	1067	39	1106	2497	44.29%	13.3%	3	4
14	臺東縣綠島鄉	2018-11-24T23:01:31+08:00	332	735	1067	39	1106	2497	44.29%	13.3%	3	4
14	臺東縣綠島鄉	2018-11-24T22:45:09+08:00	332	735	1067	39	1106	2497	44.29%	13.3%	3	4
14	臺東縣綠島鄉	2018-11-24T22:54:26+08:00	332	735	1067	39	1106	2497	44.29%	13.3%	3	4
14	臺東縣綠島鄉	2018-11-25T00:14:10+08:00	481	1040	1521	58	1579	3579	44.12%	13.44%	4	4
14	臺東縣綠島鄉	2018-11-25T03:56:13+08:00	481	1040	1521	58	1579	3579	44.12%	13.44%	4	4
14	臺東縣綠島鄉	2018-11-24T23:16:03+08:00	332	735	1067	39	1106	2497	44.29%	13.3%	3	4
14	臺東縣綠島鄉	2018-11-25T03:32:35+08:00	481	1040	1521	58	1579	3579	44.12%	13.44%	4	4
14	臺東縣綠島鄉	2018-11-25T01:25:53+08:00	481	1040	1521	58	1579	3579	44.12%	13.44%	4	4
14	臺東縣綠島鄉	2018-11-25T01:02:32+08:00	481	1040	1521	58	1579	3579	44.12%	13.44%	4	4
14	臺東縣綠島鄉	2018-11-24T22:30:10+08:00	332	735	1067	39	1106	2497	44.29%	13.3%	3	4
14	臺東縣綠島鄉	2018-11-25T00:23:04+08:00	481	1040	1521	58	1579	3579	44.12%	13.44%	4	4
14	臺東縣綠島鄉	2018-11-25T06:24:01+08:00	481	1040	1521	58	1579	3579	44.12%	13.44%	4	4
14	臺東縣綠島鄉	2018-11-25T03:38:56+08:00	481	1040	1521	58	1579	3579	44.12%	13.44%	4	4
14	臺東縣綠島鄉	2018-11-24T23:27:19+08:00	332	735	1067	39	1106	2497	44.29%	13.3%	3	4
14	臺東縣綠島鄉	2018-11-24T22:19:38+08:00	163	302	465	18	483	1023	47.21%	15.93%	2	4
14	臺東縣綠島鄉	2018-11-25T00:57:37+08:00	481	1040	1521	58	1579	3579	44.12%	13.44%	4	4
14	臺東縣綠島鄉	2018-11-24T22:57:54+08:00	332	735	1067	39	1106	2497	44.29%	13.3%	3	4
14	臺東縣綠島鄉	2018-11-25T01:17:53+08:00	481	1040	1521	58	1579	3579	44.12%	13.44%	4	4
14	臺東縣綠島鄉	2018-11-24T23:19:52+08:00	332	735	1067	39	1106	2497	44.29%	13.3%	3	4
14	臺東縣綠島鄉	2018-11-25T06:08:54+08:00	481	1040	1521	58	1579	3579	44.12%	13.44%	4	4
14	臺東縣綠島鄉	2018-11-24T23:12:16+08:00	332	735	1067	39	1106	2497	44.29%	13.3%	3	4
14	臺東縣綠島鄉	2018-11-24T23:39:17+08:00	332	735	1067	39	1106	2497	44.29%	13.3%	3	4
14	臺東縣綠島鄉	2018-11-25T01:12:44+08:00	481	1040	1521	58	1579	3579	44.12%	13.44%	4	4
14	臺東縣綠島鄉	2018-11-24T22:50:49+08:00	332	735	1067	39	1106	2497	44.29%	13.3%	3	4
14	臺東縣綠島鄉	2018-11-24T22:26:37+08:00	332	735	1067	39	1106	2497	44.29%	13.3%	3	4
14	臺東縣綠島鄉	2018-11-25T04:02:53+08:00	481	1040	1521	58	1579	3579	44.12%	13.44%	4	4
14	臺東縣綠島鄉	2018-11-24T23:05:05+08:00	332	735	1067	39	1106	2497	44.29%	13.3%	3	4
14	臺東縣綠島鄉	2018-11-24T23:31:12+08:00	332	735	1067	39	1106	2497	44.29%	13.3%	3	4
14	臺東縣綠島鄉	2018-11-24T22:16:11+08:00	163	302	465	18	483	1023	47.21%	15.93%	2	4
14	臺東縣臺東市	2018-11-25T06:29:17+08:00	12117	33290	45407	2640	48047	87803	54.72%	13.8%	69	69
14	臺東縣臺東市	2018-11-25T00:18:30+08:00	10822	29417	40239	2365	42604	77987	54.63%	13.88%	63	69
14	臺東縣臺東市	2018-11-24T23:47:29+08:00	9131	24900	34031	2050	36081	65544	55.05%	13.93%	55	69
14	臺東縣臺東市	2018-11-24T22:33:38+08:00	4186	11193	15379	991	16370	29952	54.65%	13.98%	30	69
14	臺東縣臺東市	2018-11-25T01:07:27+08:00	11408	31241	42649	2491	45140	82485	54.73%	13.83%	66	69
14	臺東縣臺東市	2018-11-25T06:13:53+08:00	12117	33290	45407	2640	48047	87803	54.72%	13.8%	69	69
14	臺東縣臺東市	2018-11-24T23:43:17+08:00	8985	24517	33502	2010	35512	64312	55.22%	13.97%	54	69
14	臺東縣臺東市	2018-11-24T22:37:01+08:00	4545	12224	16769	1076	17845	32575	54.78%	13.95%	32	69
14	臺東縣臺東市	2018-11-25T03:44:23+08:00	12117	33290	45407	2640	48047	87803	54.72%	13.8%	69	69
14	臺東縣臺東市	2018-11-24T22:13:27+08:00	3003	8180	11183	672	11855	21601	54.88%	13.9%	23	69
14	臺東縣臺東市	2018-11-25T01:02:31+08:00	11408	31241	42649	2491	45140	82485	54.73%	13.83%	66	69
14	臺東縣臺東市	2018-11-25T03:38:55+08:00	12117	33290	45407	2640	48047	87803	54.72%	13.8%	69	69
14	臺東縣臺東市	2018-11-24T23:55:47+08:00	9819	26827	36646	2197	38843	70630	55%	13.9%	58	69
14	臺東縣臺東市	2018-11-24T23:08:36+08:00	6558	18112	24670	1573	26243	47731	54.98%	13.74%	43	69
14	臺東縣臺東市	2018-11-24T23:23:39+08:00	6786	18729	25515	1625	27140	49326	55.02%	13.76%	44	69
14	臺東縣臺東市	2018-11-25T00:00:11+08:00	10269	28014	38283	2257	40540	73880	54.87%	13.9%	60	69
14	臺東縣臺東市	2018-11-24T23:51:36+08:00	9372	25579	34951	2083	37034	67182	55.12%	13.95%	56	69
14	臺東縣臺東市	2018-11-25T06:18:57+08:00	12117	33290	45407	2640	48047	87803	54.72%	13.8%	69	69
14	臺東縣臺東市	2018-11-24T22:30:09+08:00	3811	10293	14104	922	15026	27544	54.55%	13.84%	28	69
14	臺東縣臺東市	2018-11-24T22:40:28+08:00	4545	12224	16769	1076	17845	32575	54.78%	13.95%	32	69
14	臺東縣臺東市	2018-11-24T22:23:13+08:00	3398	9147	12545	789	13334	24396	54.66%	13.93%	25	69
14	臺東縣臺東市	2018-11-24T23:35:11+08:00	8067	22267	30334	1890	32224	58646	54.95%	13.76%	50	69
14	臺東縣臺東市	2018-11-24T23:01:31+08:00	6051	16522	22573	1366	23939	43479	55.06%	13.92%	40	69
14	臺東縣臺東市	2018-11-24T22:45:09+08:00	4808	12927	17735	1112	18847	34435	54.73%	13.96%	34	69
14	臺東縣臺東市	2018-11-25T00:09:34+08:00	10628	28956	39584	2359	41943	76637	54.73%	13.87%	62	69
14	臺東縣臺東市	2018-11-24T22:54:26+08:00	5472	14857	20329	1250	21579	39256	54.97%	13.94%	37	69
14	臺東縣臺東市	2018-11-25T00:14:10+08:00	10628	28956	39584	2359	41943	76637	54.73%	13.87%	62	69
14	臺東縣臺東市	2018-11-25T03:56:13+08:00	12117	33290	45407	2640	48047	87803	54.72%	13.8%	69	69
14	臺東縣臺東市	2018-11-25T03:49:51+08:00	12117	33290	45407	2640	48047	87803	54.72%	13.8%	69	69
14	臺東縣臺東市	2018-11-24T23:16:03+08:00	6558	18112	24670	1573	26243	47731	54.98%	13.74%	43	69
14	臺東縣臺東市	2018-11-25T03:32:35+08:00	12117	33290	45407	2640	48047	87803	54.72%	13.8%	69	69
14	臺東縣臺東市	2018-11-25T06:24:00+08:00	12117	33290	45407	2640	48047	87803	54.72%	13.8%	69	69
14	臺東縣臺東市	2018-11-25T01:25:53+08:00	11532	31581	43113	2524	45637	83543	54.63%	13.8%	67	69
14	臺東縣臺東市	2018-11-25T00:23:04+08:00	10822	29417	40239	2365	42604	77987	54.63%	13.88%	63	69
14	臺東縣臺東市	2018-11-24T23:27:19+08:00	6786	18729	25515	1625	27140	49326	55.02%	13.76%	44	69
14	臺東縣臺東市	2018-11-25T00:57:37+08:00	11408	31241	42649	2491	45140	82485	54.73%	13.83%	66	69
14	臺東縣臺東市	2018-11-24T22:57:54+08:00	5678	15433	21111	1273	22384	40769	54.9%	13.93%	38	69
14	臺東縣臺東市	2018-11-25T01:17:53+08:00	11408	31241	42649	2491	45140	82485	54.73%	13.83%	66	69
14	臺東縣臺東市	2018-11-24T22:19:37+08:00	3398	9147	12545	789	13334	24396	54.66%	13.93%	25	69
14	臺東縣臺東市	2018-11-24T23:19:52+08:00	6786	18729	25515	1625	27140	49326	55.02%	13.76%	44	69
14	臺東縣臺東市	2018-11-24T22:41:35+08:00	4545	12224	16769	1076	17845	32575	54.78%	13.95%	32	69
14	臺東縣臺東市	2018-11-25T00:05:05+08:00	10628	28956	39584	2359	41943	76637	54.73%	13.87%	62	69
14	臺東縣臺東市	2018-11-25T04:02:52+08:00	12117	33290	45407	2640	48047	87803	54.72%	13.8%	69	69
14	臺東縣臺東市	2018-11-24T23:12:16+08:00	6558	18112	24670	1573	26243	47731	54.98%	13.74%	43	69
14	臺東縣臺東市	2018-11-25T06:08:53+08:00	12117	33290	45407	2640	48047	87803	54.72%	13.8%	69	69
14	臺東縣臺東市	2018-11-25T01:12:44+08:00	11408	31241	42649	2491	45140	82485	54.73%	13.83%	66	69
14	臺東縣臺東市	2018-11-24T22:26:37+08:00	3691	9984	13675	893	14568	26685	54.59%	13.83%	27	69
14	臺東縣臺東市	2018-11-24T23:05:05+08:00	6404	17587	23991	1475	25466	46226	55.09%	13.85%	42	69
14	臺東縣臺東市	2018-11-24T22:50:48+08:00	5252	14199	19451	1209	20660	37766	54.71%	13.91%	36	69
14	臺東縣臺東市	2018-11-24T23:31:12+08:00	7694	21105	28799	1805	30604	55465	55.18%	13.87%	48	69
14	臺東縣臺東市	2018-11-24T22:16:11+08:00	3249	8754	12003	735	12738	23280	54.72%	13.96%	24	69
14	臺東縣臺東市	2018-11-24T23:39:16+08:00	8302	22846	31148	1918	33066	60009	55.1%	13.83%	51	69
14	宜蘭縣蘇澳鎮	2018-11-24T22:33:37+08:00	5344	11104	16448	1506	17954	32058	56%	16.67%	41	43
14	宜蘭縣蘇澳鎮	2018-11-24T23:47:28+08:00	5786	11967	17753	1621	19374	34512	56.14%	16.77%	43	43
14	宜蘭縣蘇澳鎮	2018-11-24T22:37:00+08:00	5344	11104	16448	1506	17954	32058	56%	16.67%	41	43
14	宜蘭縣蘇澳鎮	2018-11-25T01:07:26+08:00	5786	11967	17753	1621	19374	34512	56.14%	16.77%	43	43
14	宜蘭縣蘇澳鎮	2018-11-25T06:13:52+08:00	5786	11967	17753	1621	19374	34512	56.14%	16.77%	43	43
14	宜蘭縣蘇澳鎮	2018-11-25T06:29:16+08:00	5786	11967	17753	1621	19374	34512	56.14%	16.77%	43	43
14	宜蘭縣蘇澳鎮	2018-11-24T23:43:17+08:00	5786	11967	17753	1621	19374	34512	56.14%	16.77%	43	43
14	宜蘭縣蘇澳鎮	2018-11-25T03:38:54+08:00	5786	11967	17753	1621	19374	34512	56.14%	16.77%	43	43
14	宜蘭縣蘇澳鎮	2018-11-24T23:55:46+08:00	5786	11967	17753	1621	19374	34512	56.14%	16.77%	43	43
14	宜蘭縣蘇澳鎮	2018-11-24T23:23:38+08:00	5786	11967	17753	1621	19374	34512	56.14%	16.77%	43	43
14	宜蘭縣蘇澳鎮	2018-11-25T01:02:30+08:00	5786	11967	17753	1621	19374	34512	56.14%	16.77%	43	43
14	宜蘭縣蘇澳鎮	2018-11-25T03:44:22+08:00	5786	11967	17753	1621	19374	34512	56.14%	16.77%	43	43
14	宜蘭縣蘇澳鎮	2018-11-24T22:13:26+08:00	5162	10717	15879	1467	17346	30930	56.08%	16.69%	40	43
14	宜蘭縣蘇澳鎮	2018-11-24T22:23:12+08:00	5344	11104	16448	1506	17954	32058	56%	16.67%	41	43
14	宜蘭縣蘇澳鎮	2018-11-24T22:30:08+08:00	5344	11104	16448	1506	17954	32058	56%	16.67%	41	43
14	宜蘭縣蘇澳鎮	2018-11-24T22:40:27+08:00	5344	11104	16448	1506	17954	32058	56%	16.67%	41	43
14	宜蘭縣蘇澳鎮	2018-11-25T00:00:10+08:00	5786	11967	17753	1621	19374	34512	56.14%	16.77%	43	43
14	宜蘭縣蘇澳鎮	2018-11-25T06:18:57+08:00	5786	11967	17753	1621	19374	34512	56.14%	16.77%	43	43
14	宜蘭縣蘇澳鎮	2018-11-24T23:19:51+08:00	5786	11967	17753	1621	19374	34512	56.14%	16.77%	43	43
14	宜蘭縣蘇澳鎮	2018-11-24T23:12:15+08:00	5786	11967	17753	1621	19374	34512	56.14%	16.77%	43	43
14	宜蘭縣蘇澳鎮	2018-11-24T22:45:08+08:00	5344	11104	16448	1506	17954	32058	56%	16.67%	41	43
14	宜蘭縣蘇澳鎮	2018-11-24T23:01:30+08:00	5786	11967	17753	1621	19374	34512	56.14%	16.77%	43	43
14	宜蘭縣蘇澳鎮	2018-11-24T23:39:15+08:00	5786	11967	17753	1621	19374	34512	56.14%	16.77%	43	43
14	宜蘭縣蘇澳鎮	2018-11-24T23:31:11+08:00	5786	11967	17753	1621	19374	34512	56.14%	16.77%	43	43
14	宜蘭縣蘇澳鎮	2018-11-25T00:09:34+08:00	5786	11967	17753	1621	19374	34512	56.14%	16.77%	43	43
14	宜蘭縣蘇澳鎮	2018-11-24T23:35:10+08:00	5786	11967	17753	1621	19374	34512	56.14%	16.77%	43	43
14	宜蘭縣蘇澳鎮	2018-11-25T00:14:09+08:00	5786	11967	17753	1621	19374	34512	56.14%	16.77%	43	43
14	宜蘭縣蘇澳鎮	2018-11-25T03:49:51+08:00	5786	11967	17753	1621	19374	34512	56.14%	16.77%	43	43
14	宜蘭縣蘇澳鎮	2018-11-24T23:16:02+08:00	5786	11967	17753	1621	19374	34512	56.14%	16.77%	43	43
14	宜蘭縣蘇澳鎮	2018-11-25T03:56:12+08:00	5786	11967	17753	1621	19374	34512	56.14%	16.77%	43	43
14	宜蘭縣蘇澳鎮	2018-11-25T06:24:00+08:00	5786	11967	17753	1621	19374	34512	56.14%	16.77%	43	43
14	宜蘭縣蘇澳鎮	2018-11-25T00:23:03+08:00	5786	11967	17753	1621	19374	34512	56.14%	16.77%	43	43
14	宜蘭縣蘇澳鎮	2018-11-24T23:08:35+08:00	5786	11967	17753	1621	19374	34512	56.14%	16.77%	43	43
14	宜蘭縣蘇澳鎮	2018-11-25T03:32:34+08:00	5786	11967	17753	1621	19374	34512	56.14%	16.77%	43	43
14	宜蘭縣蘇澳鎮	2018-11-25T01:25:52+08:00	5786	11967	17753	1621	19374	34512	56.14%	16.77%	43	43
14	宜蘭縣蘇澳鎮	2018-11-24T22:57:53+08:00	5786	11967	17753	1621	19374	34512	56.14%	16.77%	43	43
14	宜蘭縣蘇澳鎮	2018-11-24T22:19:36+08:00	5162	10717	15879	1467	17346	30930	56.08%	16.69%	40	43
14	宜蘭縣蘇澳鎮	2018-11-25T00:57:36+08:00	5786	11967	17753	1621	19374	34512	56.14%	16.77%	43	43
14	宜蘭縣蘇澳鎮	2018-11-25T01:17:52+08:00	5786	11967	17753	1621	19374	34512	56.14%	16.77%	43	43
14	宜蘭縣蘇澳鎮	2018-11-24T23:27:18+08:00	5786	11967	17753	1621	19374	34512	56.14%	16.77%	43	43
14	宜蘭縣蘇澳鎮	2018-11-24T23:51:35+08:00	5786	11967	17753	1621	19374	34512	56.14%	16.77%	43	43
14	宜蘭縣蘇澳鎮	2018-11-24T23:05:04+08:00	5786	11967	17753	1621	19374	34512	56.14%	16.77%	43	43
14	宜蘭縣蘇澳鎮	2018-11-25T04:02:52+08:00	5786	11967	17753	1621	19374	34512	56.14%	16.77%	43	43
14	宜蘭縣蘇澳鎮	2018-11-24T22:50:47+08:00	5344	11104	16448	1506	17954	32058	56%	16.67%	41	43
14	宜蘭縣蘇澳鎮	2018-11-24T22:16:10+08:00	5162	10717	15879	1467	17346	30930	56.08%	16.69%	40	43
14	宜蘭縣蘇澳鎮	2018-11-25T01:12:43+08:00	5786	11967	17753	1621	19374	34512	56.14%	16.77%	43	43
14	宜蘭縣蘇澳鎮	2018-11-25T00:05:04+08:00	5786	11967	17753	1621	19374	34512	56.14%	16.77%	43	43
14	宜蘭縣蘇澳鎮	2018-11-24T22:41:34+08:00	5344	11104	16448	1506	17954	32058	56%	16.67%	41	43
14	宜蘭縣蘇澳鎮	2018-11-24T22:26:36+08:00	5344	11104	16448	1506	17954	32058	56%	16.67%	41	43
14	宜蘭縣蘇澳鎮	2018-11-25T00:18:29+08:00	5786	11967	17753	1621	19374	34512	56.14%	16.77%	43	43
14	宜蘭縣蘇澳鎮	2018-11-25T06:08:52+08:00	5786	11967	17753	1621	19374	34512	56.14%	16.77%	43	43
14	宜蘭縣蘇澳鎮	2018-11-24T22:54:25+08:00	5344	11104	16448	1506	17954	32058	56%	16.67%	41	43
14	連江縣南竿鄉	2018-11-24T22:33:39+08:00	0	0	0	0	0	0	0%	0%	0	4
14	連江縣南竿鄉	2018-11-25T03:49:52+08:00	790	2397	3187	101	3288	6461	50.89%	12.23%	4	4
14	連江縣南竿鄉	2018-11-24T23:43:18+08:00	0	0	0	0	0	0	0%	0%	0	4
14	連江縣南竿鄉	2018-11-25T06:29:18+08:00	790	2397	3187	101	3288	6461	50.89%	12.23%	4	4
14	連江縣南竿鄉	2018-11-24T22:50:50+08:00	0	0	0	0	0	0	0%	0%	0	4
14	連江縣南竿鄉	2018-11-25T01:07:27+08:00	790	2397	3187	101	3288	6461	50.89%	12.23%	4	4
14	連江縣南竿鄉	2018-11-25T06:13:54+08:00	790	2397	3187	101	3288	6461	50.89%	12.23%	4	4
14	連江縣南竿鄉	2018-11-24T23:08:37+08:00	0	0	0	0	0	0	0%	0%	0	4
14	連江縣南竿鄉	2018-11-25T03:32:36+08:00	790	2397	3187	101	3288	6461	50.89%	12.23%	4	4
14	連江縣南竿鄉	2018-11-24T23:55:48+08:00	0	0	0	0	0	0	0%	0%	0	4
14	連江縣南竿鄉	2018-11-25T03:44:25+08:00	790	2397	3187	101	3288	6461	50.89%	12.23%	4	4
14	連江縣南竿鄉	2018-11-24T22:13:28+08:00	0	0	0	0	0	0	0%	0%	0	4
14	連江縣南竿鄉	2018-11-25T06:18:58+08:00	790	2397	3187	101	3288	6461	50.89%	12.23%	4	4
14	連江縣南竿鄉	2018-11-24T23:51:37+08:00	0	0	0	0	0	0	0%	0%	0	4
14	連江縣南竿鄉	2018-11-24T22:23:15+08:00	0	0	0	0	0	0	0%	0%	0	4
14	連江縣南竿鄉	2018-11-24T22:40:29+08:00	0	0	0	0	0	0	0%	0%	0	4
14	連江縣南竿鄉	2018-11-24T23:23:40+08:00	0	0	0	0	0	0	0%	0%	0	4
14	連江縣南竿鄉	2018-11-24T22:54:27+08:00	0	0	0	0	0	0	0%	0%	0	4
14	連江縣南竿鄉	2018-11-25T00:14:11+08:00	0	0	0	0	0	0	0%	0%	0	4
14	連江縣南竿鄉	2018-11-25T00:05:06+08:00	0	0	0	0	0	0	0%	0%	0	4
14	連江縣南竿鄉	2018-11-24T22:41:36+08:00	0	0	0	0	0	0	0%	0%	0	4
14	連江縣南竿鄉	2018-11-24T22:16:12+08:00	0	0	0	0	0	0	0%	0%	0	4
14	連江縣南竿鄉	2018-11-24T23:05:06+08:00	0	0	0	0	0	0	0%	0%	0	4
14	連江縣南竿鄉	2018-11-24T22:45:10+08:00	0	0	0	0	0	0	0%	0%	0	4
14	連江縣南竿鄉	2018-11-25T03:56:14+08:00	790	2397	3187	101	3288	6461	50.89%	12.23%	4	4
14	連江縣南竿鄉	2018-11-24T22:37:02+08:00	0	0	0	0	0	0	0%	0%	0	4
14	連江縣南竿鄉	2018-11-25T00:18:32+08:00	0	0	0	0	0	0	0%	0%	0	4
14	連江縣南竿鄉	2018-11-24T23:16:04+08:00	0	0	0	0	0	0	0%	0%	0	4
14	連江縣南竿鄉	2018-11-25T00:23:05+08:00	0	0	0	0	0	0	0%	0%	0	4
14	連江縣南竿鄉	2018-11-25T01:25:54+08:00	790	2397	3187	101	3288	6461	50.89%	12.23%	4	4
14	連江縣南竿鄉	2018-11-25T01:02:32+08:00	633	1767	2400	84	2484	4918	50.51%	12.87%	3	4
14	連江縣南竿鄉	2018-11-25T06:24:01+08:00	790	2397	3187	101	3288	6461	50.89%	12.23%	4	4
14	連江縣南竿鄉	2018-11-24T22:30:11+08:00	0	0	0	0	0	0	0%	0%	0	4
14	連江縣南竿鄉	2018-11-25T03:38:56+08:00	790	2397	3187	101	3288	6461	50.89%	12.23%	4	4
14	連江縣南竿鄉	2018-11-24T22:19:38+08:00	0	0	0	0	0	0	0%	0%	0	4
14	連江縣南竿鄉	2018-11-24T23:19:53+08:00	0	0	0	0	0	0	0%	0%	0	4
14	連江縣南竿鄉	2018-11-25T01:17:54+08:00	790	2397	3187	101	3288	6461	50.89%	12.23%	4	4
14	連江縣南竿鄉	2018-11-25T00:00:12+08:00	0	0	0	0	0	0	0%	0%	0	4
14	連江縣南竿鄉	2018-11-24T22:57:55+08:00	0	0	0	0	0	0	0%	0%	0	4
14	連江縣南竿鄉	2018-11-24T23:27:20+08:00	0	0	0	0	0	0	0%	0%	0	4
14	連江縣南竿鄉	2018-11-25T00:57:38+08:00	482	1349	1831	66	1897	3804	49.87%	12.67%	2	4
14	連江縣南竿鄉	2018-11-24T23:35:12+08:00	0	0	0	0	0	0	0%	0%	0	4
14	連江縣南竿鄉	2018-11-24T23:47:30+08:00	0	0	0	0	0	0	0%	0%	0	4
14	連江縣南竿鄉	2018-11-25T00:09:36+08:00	0	0	0	0	0	0	0%	0%	0	4
14	連江縣南竿鄉	2018-11-25T06:08:54+08:00	790	2397	3187	101	3288	6461	50.89%	12.23%	4	4
14	連江縣南竿鄉	2018-11-24T23:39:17+08:00	0	0	0	0	0	0	0%	0%	0	4
14	連江縣南竿鄉	2018-11-24T23:31:13+08:00	0	0	0	0	0	0	0%	0%	0	4
14	連江縣南竿鄉	2018-11-25T04:02:53+08:00	790	2397	3187	101	3288	6461	50.89%	12.23%	4	4
14	連江縣南竿鄉	2018-11-24T23:01:32+08:00	0	0	0	0	0	0	0%	0%	0	4
14	連江縣南竿鄉	2018-11-25T01:12:45+08:00	790	2397	3187	101	3288	6461	50.89%	12.23%	4	4
14	連江縣南竿鄉	2018-11-24T22:26:38+08:00	0	0	0	0	0	0	0%	0%	0	4
14	連江縣南竿鄉	2018-11-24T23:12:17+08:00	0	0	0	0	0	0	0%	0%	0	4
14	臺南市龍崎區	2018-11-24T23:35:04+08:00	483	1180	1663	151	1814	3713	48.86%	13.01%	8	8
14	臺南市龍崎區	2018-11-24T23:47:21+08:00	483	1180	1663	151	1814	3713	48.86%	13.01%	8	8
14	臺南市龍崎區	2018-11-25T06:08:45+08:00	483	1180	1663	151	1814	3713	48.86%	13.01%	8	8
14	臺南市龍崎區	2018-11-24T23:43:11+08:00	483	1180	1663	151	1814	3713	48.86%	13.01%	8	8
14	臺南市龍崎區	2018-11-25T01:07:19+08:00	483	1180	1663	151	1814	3713	48.86%	13.01%	8	8
14	臺南市龍崎區	2018-11-24T22:33:31+08:00	483	1180	1663	151	1814	3713	48.86%	13.01%	8	8
14	臺南市龍崎區	2018-11-25T00:14:02+08:00	483	1180	1663	151	1814	3713	48.86%	13.01%	8	8
14	臺南市龍崎區	2018-11-25T04:02:42+08:00	483	1180	1663	151	1814	3713	48.86%	13.01%	8	8
14	臺南市龍崎區	2018-11-25T00:09:26+08:00	483	1180	1663	151	1814	3713	48.86%	13.01%	8	8
14	臺南市龍崎區	2018-11-24T23:12:08+08:00	483	1180	1663	151	1814	3713	48.86%	13.01%	8	8
14	臺南市龍崎區	2018-11-24T23:39:07+08:00	483	1180	1663	151	1814	3713	48.86%	13.01%	8	8
14	臺南市龍崎區	2018-11-24T23:31:03+08:00	483	1180	1663	151	1814	3713	48.86%	13.01%	8	8
14	臺南市龍崎區	2018-11-24T23:01:24+08:00	483	1180	1663	151	1814	3713	48.86%	13.01%	8	8
14	臺南市龍崎區	2018-11-24T23:19:42+08:00	483	1180	1663	151	1814	3713	48.86%	13.01%	8	8
14	臺南市龍崎區	2018-11-25T00:04:58+08:00	483	1180	1663	151	1814	3713	48.86%	13.01%	8	8
14	臺南市龍崎區	2018-11-24T23:04:57+08:00	483	1180	1663	151	1814	3713	48.86%	13.01%	8	8
14	臺南市龍崎區	2018-11-25T00:57:29+08:00	483	1180	1663	151	1814	3713	48.86%	13.01%	8	8
14	臺南市龍崎區	2018-11-24T22:13:19+08:00	483	1180	1663	151	1814	3713	48.86%	13.01%	8	8
14	臺南市龍崎區	2018-11-25T03:44:14+08:00	483	1180	1663	151	1814	3713	48.86%	13.01%	8	8
14	臺南市龍崎區	2018-11-25T01:17:43+08:00	483	1180	1663	151	1814	3713	48.86%	13.01%	8	8
14	臺南市龍崎區	2018-11-24T23:55:40+08:00	483	1180	1663	151	1814	3713	48.86%	13.01%	8	8
14	臺南市龍崎區	2018-11-25T06:18:51+08:00	483	1180	1663	151	1814	3713	48.86%	13.01%	8	8
14	臺南市龍崎區	2018-11-25T01:02:23+08:00	483	1180	1663	151	1814	3713	48.86%	13.01%	8	8
14	臺南市龍崎區	2018-11-25T01:25:45+08:00	483	1180	1663	151	1814	3713	48.86%	13.01%	8	8
14	臺南市龍崎區	2018-11-25T03:38:48+08:00	483	1180	1663	151	1814	3713	48.86%	13.01%	8	8
14	臺南市龍崎區	2018-11-24T23:27:12+08:00	483	1180	1663	151	1814	3713	48.86%	13.01%	8	8
14	臺南市龍崎區	2018-11-25T00:18:23+08:00	483	1180	1663	151	1814	3713	48.86%	13.01%	8	8
14	臺南市龍崎區	2018-11-24T22:54:19+08:00	483	1180	1663	151	1814	3713	48.86%	13.01%	8	8
14	臺南市龍崎區	2018-11-25T06:13:46+08:00	483	1180	1663	151	1814	3713	48.86%	13.01%	8	8
14	臺南市龍崎區	2018-11-25T00:22:57+08:00	483	1180	1663	151	1814	3713	48.86%	13.01%	8	8
14	臺南市龍崎區	2018-11-25T03:56:04+08:00	483	1180	1663	151	1814	3713	48.86%	13.01%	8	8
14	臺南市龍崎區	2018-11-24T22:41:29+08:00	483	1180	1663	151	1814	3713	48.86%	13.01%	8	8
14	臺南市龍崎區	2018-11-24T22:16:03+08:00	483	1180	1663	151	1814	3713	48.86%	13.01%	8	8
14	臺南市龍崎區	2018-11-25T01:12:35+08:00	483	1180	1663	151	1814	3713	48.86%	13.01%	8	8
14	臺南市龍崎區	2018-11-24T22:29:59+08:00	483	1180	1663	151	1814	3713	48.86%	13.01%	8	8
14	臺南市龍崎區	2018-11-24T23:23:32+08:00	483	1180	1663	151	1814	3713	48.86%	13.01%	8	8
14	臺南市龍崎區	2018-11-24T23:51:28+08:00	483	1180	1663	151	1814	3713	48.86%	13.01%	8	8
14	臺南市龍崎區	2018-11-24T22:57:46+08:00	483	1180	1663	151	1814	3713	48.86%	13.01%	8	8
14	臺南市龍崎區	2018-11-25T00:00:01+08:00	483	1180	1663	151	1814	3713	48.86%	13.01%	8	8
14	臺南市龍崎區	2018-11-24T22:23:05+08:00	483	1180	1663	151	1814	3713	48.86%	13.01%	8	8
14	臺南市龍崎區	2018-11-24T22:36:54+08:00	483	1180	1663	151	1814	3713	48.86%	13.01%	8	8
14	臺南市龍崎區	2018-11-24T23:15:56+08:00	483	1180	1663	151	1814	3713	48.86%	13.01%	8	8
14	臺南市龍崎區	2018-11-24T23:08:28+08:00	483	1180	1663	151	1814	3713	48.86%	13.01%	8	8
14	臺南市龍崎區	2018-11-25T03:32:27+08:00	483	1180	1663	151	1814	3713	48.86%	13.01%	8	8
14	臺南市龍崎區	2018-11-24T22:40:22+08:00	483	1180	1663	151	1814	3713	48.86%	13.01%	8	8
14	臺南市龍崎區	2018-11-24T22:19:30+08:00	483	1180	1663	151	1814	3713	48.86%	13.01%	8	8
14	臺南市龍崎區	2018-11-24T22:45:02+08:00	483	1180	1663	151	1814	3713	48.86%	13.01%	8	8
14	臺南市龍崎區	2018-11-24T22:50:40+08:00	483	1180	1663	151	1814	3713	48.86%	13.01%	8	8
14	臺南市龍崎區	2018-11-25T03:49:45+08:00	483	1180	1663	151	1814	3713	48.86%	13.01%	8	8
14	臺南市龍崎區	2018-11-25T06:29:09+08:00	483	1180	1663	151	1814	3713	48.86%	13.01%	8	8
14	臺南市龍崎區	2018-11-25T06:23:53+08:00	483	1180	1663	151	1814	3713	48.86%	13.01%	8	8
14	臺南市龍崎區	2018-11-24T22:26:31+08:00	483	1180	1663	151	1814	3713	48.86%	13.01%	8	8
14	屏東縣竹田鄉	2018-11-24T23:16:01+08:00	2276	5021	7297	802	8099	14126	57.33%	16.11%	15	16
14	屏東縣竹田鄉	2018-11-24T23:43:16+08:00	2276	5021	7297	802	8099	14126	57.33%	16.11%	15	16
14	屏東縣竹田鄉	2018-11-24T22:33:36+08:00	1669	3609	5278	610	5888	10172	57.88%	16.41%	12	16
14	屏東縣竹田鄉	2018-11-25T03:56:11+08:00	2437	5438	7875	865	8740	15353	56.93%	15.87%	16	16
14	屏東縣竹田鄉	2018-11-24T23:47:27+08:00	2276	5021	7297	802	8099	14126	57.33%	16.11%	15	16
14	屏東縣竹田鄉	2018-11-24T22:16:09+08:00	1044	2337	3381	390	3771	6149	61.33%	16.98%	8	16
14	屏東縣竹田鄉	2018-11-25T03:38:54+08:00	2437	5438	7875	865	8740	15353	56.93%	15.87%	16	16
14	屏東縣竹田鄉	2018-11-24T23:55:46+08:00	2276	5021	7297	802	8099	14126	57.33%	16.11%	15	16
14	屏東縣竹田鄉	2018-11-25T01:25:51+08:00	2437	5438	7875	865	8740	15353	56.93%	15.87%	16	16
14	屏東縣竹田鄉	2018-11-24T23:23:37+08:00	2276	5021	7297	802	8099	14126	57.33%	16.11%	15	16
14	屏東縣竹田鄉	2018-11-25T06:18:56+08:00	2437	5438	7875	865	8740	15353	56.93%	15.87%	16	16
14	屏東縣竹田鄉	2018-11-24T22:30:06+08:00	1596	3172	4768	551	5319	8943	59.48%	17.85%	11	16
14	屏東縣竹田鄉	2018-11-24T22:36:59+08:00	1669	3609	5278	610	5888	10172	57.88%	16.41%	12	16
14	屏東縣竹田鄉	2018-11-24T22:40:26+08:00	1877	4167	6044	688	6732	11675	57.66%	16.08%	13	16
14	屏東縣竹田鄉	2018-11-25T00:57:35+08:00	2437	5438	7875	865	8740	15353	56.93%	15.87%	16	16
14	屏東縣竹田鄉	2018-11-25T01:17:51+08:00	2437	5438	7875	865	8740	15353	56.93%	15.87%	16	16
14	屏東縣竹田鄉	2018-11-24T23:31:10+08:00	2276	5021	7297	802	8099	14126	57.33%	16.11%	15	16
14	屏東縣竹田鄉	2018-11-24T23:39:14+08:00	2276	5021	7297	802	8099	14126	57.33%	16.11%	15	16
14	屏東縣竹田鄉	2018-11-24T23:01:30+08:00	2276	5021	7297	802	8099	14126	57.33%	16.11%	15	16
14	屏東縣竹田鄉	2018-11-25T04:02:51+08:00	2437	5438	7875	865	8740	15353	56.93%	15.87%	16	16
14	屏東縣竹田鄉	2018-11-24T23:12:14+08:00	2276	5021	7297	802	8099	14126	57.33%	16.11%	15	16
14	屏東縣竹田鄉	2018-11-25T06:23:59+08:00	2437	5438	7875	865	8740	15353	56.93%	15.87%	16	16
14	屏東縣竹田鄉	2018-11-25T00:09:33+08:00	2437	5438	7875	865	8740	15353	56.93%	15.87%	16	16
14	屏東縣竹田鄉	2018-11-24T22:45:07+08:00	2070	4554	6624	738	7362	12867	57.22%	16.09%	14	16
14	屏東縣竹田鄉	2018-11-25T06:08:51+08:00	2437	5438	7875	865	8740	15353	56.93%	15.87%	16	16
14	屏東縣竹田鄉	2018-11-25T01:07:25+08:00	2437	5438	7875	865	8740	15353	56.93%	15.87%	16	16
14	屏東縣竹田鄉	2018-11-25T06:13:51+08:00	2437	5438	7875	865	8740	15353	56.93%	15.87%	16	16
14	屏東縣竹田鄉	2018-11-24T23:35:09+08:00	2276	5021	7297	802	8099	14126	57.33%	16.11%	15	16
14	屏東縣竹田鄉	2018-11-25T03:49:50+08:00	2437	5438	7875	865	8740	15353	56.93%	15.87%	16	16
14	屏東縣竹田鄉	2018-11-25T00:14:08+08:00	2437	5438	7875	865	8740	15353	56.93%	15.87%	16	16
14	屏東縣竹田鄉	2018-11-25T06:29:15+08:00	2437	5438	7875	865	8740	15353	56.93%	15.87%	16	16
14	屏東縣竹田鄉	2018-11-24T23:08:34+08:00	2276	5021	7297	802	8099	14126	57.33%	16.11%	15	16
14	屏東縣竹田鄉	2018-11-25T00:00:09+08:00	2276	5021	7297	802	8099	14126	57.33%	16.11%	15	16
14	屏東縣竹田鄉	2018-11-25T00:23:02+08:00	2437	5438	7875	865	8740	15353	56.93%	15.87%	16	16
14	屏東縣竹田鄉	2018-11-25T03:32:33+08:00	2437	5438	7875	865	8740	15353	56.93%	15.87%	16	16
14	屏東縣竹田鄉	2018-11-25T03:44:21+08:00	2437	5438	7875	865	8740	15353	56.93%	15.87%	16	16
14	屏東縣竹田鄉	2018-11-24T22:13:25+08:00	953	2147	3100	349	3449	5645	61.1%	16.88%	7	16
14	屏東縣竹田鄉	2018-11-24T23:19:49+08:00	2276	5021	7297	802	8099	14126	57.33%	16.11%	15	16
14	屏東縣竹田鄉	2018-11-24T22:23:11+08:00	1596	3172	4768	551	5319	8943	59.48%	17.85%	11	16
14	屏東縣竹田鄉	2018-11-24T23:27:17+08:00	2276	5021	7297	802	8099	14126	57.33%	16.11%	15	16
14	屏東縣竹田鄉	2018-11-24T22:19:36+08:00	1424	2769	4193	467	4660	7809	59.67%	18.24%	10	16
14	屏東縣竹田鄉	2018-11-25T01:02:29+08:00	2437	5438	7875	865	8740	15353	56.93%	15.87%	16	16
14	屏東縣竹田鄉	2018-11-24T23:51:34+08:00	2276	5021	7297	802	8099	14126	57.33%	16.11%	15	16
14	屏東縣竹田鄉	2018-11-24T22:57:52+08:00	2276	5021	7297	802	8099	14126	57.33%	16.11%	15	16
14	屏東縣竹田鄉	2018-11-24T23:05:03+08:00	2276	5021	7297	802	8099	14126	57.33%	16.11%	15	16
14	屏東縣竹田鄉	2018-11-24T22:54:24+08:00	2276	5021	7297	802	8099	14126	57.33%	16.11%	15	16
14	屏東縣竹田鄉	2018-11-25T00:18:28+08:00	2437	5438	7875	865	8740	15353	56.93%	15.87%	16	16
14	屏東縣竹田鄉	2018-11-25T00:05:04+08:00	2276	5021	7297	802	8099	14126	57.33%	16.11%	15	16
14	屏東縣竹田鄉	2018-11-24T22:41:34+08:00	1877	4167	6044	688	6732	11675	57.66%	16.08%	13	16
14	屏東縣竹田鄉	2018-11-25T01:12:42+08:00	2437	5438	7875	865	8740	15353	56.93%	15.87%	16	16
14	屏東縣竹田鄉	2018-11-24T22:26:36+08:00	1596	3172	4768	551	5319	8943	59.48%	17.85%	11	16
14	屏東縣竹田鄉	2018-11-24T22:50:46+08:00	2276	5021	7297	802	8099	14126	57.33%	16.11%	15	16
14	臺南市新市區	2018-11-24T23:35:04+08:00	4981	10371	15352	957	16309	30386	53.67%	16.39%	27	27
14	臺南市新市區	2018-11-24T23:47:21+08:00	4981	10371	15352	957	16309	30386	53.67%	16.39%	27	27
14	臺南市新市區	2018-11-24T22:33:30+08:00	4981	10371	15352	957	16309	30386	53.67%	16.39%	27	27
14	臺南市新市區	2018-11-24T23:31:02+08:00	4981	10371	15352	957	16309	30386	53.67%	16.39%	27	27
14	臺南市新市區	2018-11-24T23:39:06+08:00	4981	10371	15352	957	16309	30386	53.67%	16.39%	27	27
14	臺南市新市區	2018-11-25T01:07:19+08:00	4981	10371	15352	957	16309	30386	53.67%	16.39%	27	27
14	臺南市新市區	2018-11-25T00:14:02+08:00	4981	10371	15352	957	16309	30386	53.67%	16.39%	27	27
14	臺南市新市區	2018-11-24T23:43:10+08:00	4981	10371	15352	957	16309	30386	53.67%	16.39%	27	27
14	臺南市新市區	2018-11-25T06:08:44+08:00	4981	10371	15352	957	16309	30386	53.67%	16.39%	27	27
14	臺南市新市區	2018-11-25T00:09:26+08:00	4981	10371	15352	957	16309	30386	53.67%	16.39%	27	27
14	臺南市新市區	2018-11-24T23:01:23+08:00	4981	10371	15352	957	16309	30386	53.67%	16.39%	27	27
14	臺南市新市區	2018-11-24T23:12:08+08:00	4981	10371	15352	957	16309	30386	53.67%	16.39%	27	27
14	臺南市新市區	2018-11-25T00:04:58+08:00	4981	10371	15352	957	16309	30386	53.67%	16.39%	27	27
14	臺南市新市區	2018-11-24T23:04:57+08:00	4981	10371	15352	957	16309	30386	53.67%	16.39%	27	27
14	臺南市新市區	2018-11-25T00:57:29+08:00	4981	10371	15352	957	16309	30386	53.67%	16.39%	27	27
14	臺南市新市區	2018-11-24T22:13:19+08:00	4811	10052	14863	931	15794	29475	53.58%	16.32%	26	27
14	臺南市新市區	2018-11-25T03:44:14+08:00	4981	10371	15352	957	16309	30386	53.67%	16.39%	27	27
14	臺南市新市區	2018-11-25T01:17:43+08:00	4981	10371	15352	957	16309	30386	53.67%	16.39%	27	27
14	臺南市新市區	2018-11-24T23:55:40+08:00	4981	10371	15352	957	16309	30386	53.67%	16.39%	27	27
14	臺南市新市區	2018-11-25T01:02:23+08:00	4981	10371	15352	957	16309	30386	53.67%	16.39%	27	27
14	臺南市新市區	2018-11-25T01:25:45+08:00	4981	10371	15352	957	16309	30386	53.67%	16.39%	27	27
14	臺南市新市區	2018-11-25T03:38:48+08:00	4981	10371	15352	957	16309	30386	53.67%	16.39%	27	27
14	臺南市新市區	2018-11-25T06:18:50+08:00	4981	10371	15352	957	16309	30386	53.67%	16.39%	27	27
14	臺南市新市區	2018-11-24T22:40:21+08:00	4981	10371	15352	957	16309	30386	53.67%	16.39%	27	27
14	臺南市新市區	2018-11-24T23:27:12+08:00	4981	10371	15352	957	16309	30386	53.67%	16.39%	27	27
14	臺南市新市區	2018-11-25T00:18:22+08:00	4981	10371	15352	957	16309	30386	53.67%	16.39%	27	27
14	臺南市新市區	2018-11-24T22:54:19+08:00	4981	10371	15352	957	16309	30386	53.67%	16.39%	27	27
14	臺南市新市區	2018-11-25T00:22:57+08:00	4981	10371	15352	957	16309	30386	53.67%	16.39%	27	27
14	臺南市新市區	2018-11-25T03:56:04+08:00	4981	10371	15352	957	16309	30386	53.67%	16.39%	27	27
14	臺南市新市區	2018-11-24T22:16:02+08:00	4981	10371	15352	957	16309	30386	53.67%	16.39%	27	27
14	臺南市新市區	2018-11-24T22:41:28+08:00	4981	10371	15352	957	16309	30386	53.67%	16.39%	27	27
14	臺南市新市區	2018-11-25T04:02:41+08:00	4981	10371	15352	957	16309	30386	53.67%	16.39%	27	27
14	臺南市新市區	2018-11-25T01:12:35+08:00	4981	10371	15352	957	16309	30386	53.67%	16.39%	27	27
14	臺南市新市區	2018-11-24T23:23:32+08:00	4981	10371	15352	957	16309	30386	53.67%	16.39%	27	27
14	臺南市新市區	2018-11-24T22:57:46+08:00	4981	10371	15352	957	16309	30386	53.67%	16.39%	27	27
14	臺南市新市區	2018-11-24T23:19:41+08:00	4981	10371	15352	957	16309	30386	53.67%	16.39%	27	27
14	臺南市新市區	2018-11-25T00:00:01+08:00	4981	10371	15352	957	16309	30386	53.67%	16.39%	27	27
14	臺南市新市區	2018-11-24T23:51:27+08:00	4981	10371	15352	957	16309	30386	53.67%	16.39%	27	27
14	臺南市新市區	2018-11-24T22:29:58+08:00	4981	10371	15352	957	16309	30386	53.67%	16.39%	27	27
14	臺南市新市區	2018-11-24T22:23:05+08:00	4981	10371	15352	957	16309	30386	53.67%	16.39%	27	27
14	臺南市新市區	2018-11-24T22:36:54+08:00	4981	10371	15352	957	16309	30386	53.67%	16.39%	27	27
14	臺南市新市區	2018-11-24T23:15:56+08:00	4981	10371	15352	957	16309	30386	53.67%	16.39%	27	27
14	臺南市新市區	2018-11-24T23:08:28+08:00	4981	10371	15352	957	16309	30386	53.67%	16.39%	27	27
14	臺南市新市區	2018-11-25T03:32:27+08:00	4981	10371	15352	957	16309	30386	53.67%	16.39%	27	27
14	臺南市新市區	2018-11-24T22:19:30+08:00	4981	10371	15352	957	16309	30386	53.67%	16.39%	27	27
14	臺南市新市區	2018-11-25T03:49:44+08:00	4981	10371	15352	957	16309	30386	53.67%	16.39%	27	27
14	臺南市新市區	2018-11-24T22:45:02+08:00	4981	10371	15352	957	16309	30386	53.67%	16.39%	27	27
14	臺南市新市區	2018-11-24T22:50:40+08:00	4981	10371	15352	957	16309	30386	53.67%	16.39%	27	27
14	臺南市新市區	2018-11-24T22:26:30+08:00	4981	10371	15352	957	16309	30386	53.67%	16.39%	27	27
14	臺南市新市區	2018-11-25T06:29:09+08:00	4981	10371	15352	957	16309	30386	53.67%	16.39%	27	27
14	臺南市新市區	2018-11-25T06:23:53+08:00	4981	10371	15352	957	16309	30386	53.67%	16.39%	27	27
14	臺南市新市區	2018-11-25T06:13:45+08:00	4981	10371	15352	957	16309	30386	53.67%	16.39%	27	27
14	屏東縣恆春鎮	2018-11-25T03:56:10+08:00	3613	7664	11277	786	12063	25661	47.01%	14.08%	25	25
14	屏東縣恆春鎮	2018-11-24T23:16:01+08:00	2077	4855	6932	552	7484	16011	46.74%	12.97%	17	25
14	屏東縣恆春鎮	2018-11-24T23:43:16+08:00	2513	5872	8385	637	9022	18964	47.57%	13.25%	20	25
14	屏東縣恆春鎮	2018-11-24T22:33:36+08:00	1355	3142	4497	378	4875	10356	47.07%	13.08%	12	25
14	屏東縣恆春鎮	2018-11-24T23:47:27+08:00	2814	6607	9421	684	10105	21418	47.18%	13.14%	22	25
14	屏東縣恆春鎮	2018-11-24T22:16:09+08:00	732	1653	2385	221	2606	5421	48.07%	13.5%	7	25
14	屏東縣恆春鎮	2018-11-25T03:38:53+08:00	3613	7664	11277	786	12063	25661	47.01%	14.08%	25	25
14	屏東縣恆春鎮	2018-11-25T01:25:51+08:00	3613	7664	11277	786	12063	25661	47.01%	14.08%	25	25
14	屏東縣恆春鎮	2018-11-24T23:23:37+08:00	2077	4855	6932	552	7484	16011	46.74%	12.97%	17	25
14	屏東縣恆春鎮	2018-11-25T06:18:56+08:00	3613	7664	11277	786	12063	25661	47.01%	14.08%	25	25
14	屏東縣恆春鎮	2018-11-24T22:19:35+08:00	872	1985	2857	265	3122	6532	47.8%	13.35%	8	25
14	屏東縣恆春鎮	2018-11-25T01:17:50+08:00	3613	7664	11277	786	12063	25661	47.01%	14.08%	25	25
14	屏東縣恆春鎮	2018-11-24T22:36:59+08:00	1537	3633	5170	412	5582	11899	46.91%	12.92%	13	25
14	屏東縣恆春鎮	2018-11-24T22:40:26+08:00	1670	3977	5647	458	6105	13003	46.95%	12.84%	14	25
14	屏東縣恆春鎮	2018-11-25T00:57:35+08:00	3613	7664	11277	786	12063	25661	47.01%	14.08%	25	25
14	屏東縣恆春鎮	2018-11-24T22:57:51+08:00	1882	4464	6346	508	6854	14731	46.53%	12.78%	16	25
14	屏東縣恆春鎮	2018-11-25T00:09:32+08:00	3241	6889	10130	701	10831	22923	47.25%	14.14%	23	25
14	屏東縣恆春鎮	2018-11-25T06:23:58+08:00	3613	7664	11277	786	12063	25661	47.01%	14.08%	25	25
14	屏東縣恆春鎮	2018-11-24T23:39:14+08:00	2403	5542	7945	595	8540	18068	47.27%	13.3%	19	25
14	屏東縣恆春鎮	2018-11-25T01:12:41+08:00	3613	7664	11277	786	12063	25661	47.01%	14.08%	25	25
14	屏東縣恆春鎮	2018-11-24T22:26:35+08:00	1083	2492	3575	314	3889	8151	47.71%	13.29%	10	25
14	屏東縣恆春鎮	2018-11-24T23:12:14+08:00	2077	4855	6932	552	7484	16011	46.74%	12.97%	17	25
14	屏東縣恆春鎮	2018-11-24T22:45:07+08:00	1670	3977	5647	458	6105	13003	46.95%	12.84%	14	25
14	屏東縣恆春鎮	2018-11-25T06:08:51+08:00	3613	7664	11277	786	12063	25661	47.01%	14.08%	25	25
14	屏東縣恆春鎮	2018-11-25T04:02:50+08:00	3613	7664	11277	786	12063	25661	47.01%	14.08%	25	25
14	屏東縣恆春鎮	2018-11-25T06:13:51+08:00	3613	7664	11277	786	12063	25661	47.01%	14.08%	25	25
14	屏東縣恆春鎮	2018-11-25T00:14:07+08:00	3423	7283	10706	748	11454	24408	46.93%	14.02%	24	25
14	屏東縣恆春鎮	2018-11-24T23:35:09+08:00	2403	5542	7945	595	8540	18068	47.27%	13.3%	19	25
14	屏東縣恆春鎮	2018-11-24T23:01:29+08:00	2077	4855	6932	552	7484	16011	46.74%	12.97%	17	25
14	屏東縣恆春鎮	2018-11-25T01:07:24+08:00	3613	7664	11277	786	12063	25661	47.01%	14.08%	25	25
14	屏東縣恆春鎮	2018-11-24T23:31:09+08:00	2252	5268	7520	574	8094	17144	47.21%	13.14%	18	25
14	屏東縣恆春鎮	2018-11-25T03:49:50+08:00	3613	7664	11277	786	12063	25661	47.01%	14.08%	25	25
14	屏東縣恆春鎮	2018-11-25T06:29:15+08:00	3613	7664	11277	786	12063	25661	47.01%	14.08%	25	25
14	屏東縣恆春鎮	2018-11-24T23:55:45+08:00	2814	6607	9421	684	10105	21418	47.18%	13.14%	22	25
14	屏東縣恆春鎮	2018-11-24T23:08:34+08:00	2077	4855	6932	552	7484	16011	46.74%	12.97%	17	25
14	屏東縣恆春鎮	2018-11-25T00:00:09+08:00	2814	6607	9421	684	10105	21418	47.18%	13.14%	22	25
14	屏東縣恆春鎮	2018-11-25T00:23:02+08:00	3423	7283	10706	748	11454	24408	46.93%	14.02%	24	25
14	屏東縣恆春鎮	2018-11-24T23:19:48+08:00	2077	4855	6932	552	7484	16011	46.74%	12.97%	17	25
14	屏東縣恆春鎮	2018-11-25T03:32:33+08:00	3613	7664	11277	786	12063	25661	47.01%	14.08%	25	25
14	屏東縣恆春鎮	2018-11-25T03:44:21+08:00	3613	7664	11277	786	12063	25661	47.01%	14.08%	25	25
14	屏東縣恆春鎮	2018-11-24T22:13:25+08:00	732	1653	2385	221	2606	5421	48.07%	13.5%	7	25
14	屏東縣恆春鎮	2018-11-24T22:23:11+08:00	1009	2263	3272	294	3566	7376	48.35%	13.68%	9	25
14	屏東縣恆春鎮	2018-11-24T22:30:05+08:00	1083	2492	3575	314	3889	8151	47.71%	13.29%	10	25
14	屏東縣恆春鎮	2018-11-24T23:27:17+08:00	2077	4855	6932	552	7484	16011	46.74%	12.97%	17	25
14	屏東縣恆春鎮	2018-11-25T01:02:29+08:00	3613	7664	11277	786	12063	25661	47.01%	14.08%	25	25
14	屏東縣恆春鎮	2018-11-24T23:51:33+08:00	2814	6607	9421	684	10105	21418	47.18%	13.14%	22	25
14	屏東縣恆春鎮	2018-11-24T23:05:03+08:00	2077	4855	6932	552	7484	16011	46.74%	12.97%	17	25
14	屏東縣恆春鎮	2018-11-24T22:54:24+08:00	1809	4287	6096	498	6594	14023	47.02%	12.9%	15	25
14	屏東縣恆春鎮	2018-11-25T00:18:28+08:00	3423	7283	10706	748	11454	24408	46.93%	14.02%	24	25
14	屏東縣恆春鎮	2018-11-24T22:41:33+08:00	1670	3977	5647	458	6105	13003	46.95%	12.84%	14	25
14	屏東縣恆春鎮	2018-11-25T00:05:03+08:00	3241	6889	10130	701	10831	22923	47.25%	14.14%	23	25
14	屏東縣恆春鎮	2018-11-24T22:50:46+08:00	1809	4287	6096	498	6594	14023	47.02%	12.9%	15	25
14	桃園市大園區	2018-11-25T01:07:17+08:00	11241	23944	35185	1753	36938	73900	49.98%	15.21%	50	50
14	桃園市大園區	2018-11-25T06:08:42+08:00	11241	23944	35185	1753	36938	73900	49.98%	15.21%	50	50
14	桃園市大園區	2018-11-24T23:47:18+08:00	8728	18832	27560	1456	29016	57929	50.09%	15.07%	40	50
14	桃園市大園區	2018-11-24T23:35:02+08:00	8030	17303	25333	1366	26699	52935	50.44%	15.17%	37	50
14	桃園市大園區	2018-11-24T22:26:29+08:00	5495	11985	17480	953	18433	36463	50.55%	15.07%	26	50
14	桃園市大園區	2018-11-24T22:16:00+08:00	5045	10942	15987	884	16871	33704	50.06%	14.97%	24	50
14	桃園市大園區	2018-11-24T23:51:25+08:00	8965	19341	28306	1488	29794	59566	50.02%	15.05%	41	50
14	桃園市大園區	2018-11-25T00:04:56+08:00	9510	20399	29909	1517	31426	62917	49.95%	15.12%	43	50
14	桃園市大園區	2018-11-24T22:19:28+08:00	5045	10942	15987	884	16871	33704	50.06%	14.97%	24	50
14	桃園市大園區	2018-11-24T22:57:44+08:00	6649	14512	21161	1158	22319	44058	50.66%	15.09%	31	50
14	桃園市大園區	2018-11-25T00:57:27+08:00	11241	23944	35185	1753	36938	73900	49.98%	15.21%	50	50
14	桃園市大園區	2018-11-24T22:13:17+08:00	4840	10414	15254	832	16086	32290	49.82%	14.99%	23	50
14	桃園市大園區	2018-11-24T23:23:30+08:00	7842	16820	24662	1332	25994	51516	50.46%	15.22%	36	50
14	桃園市大園區	2018-11-24T22:29:55+08:00	5495	11985	17480	953	18433	36463	50.55%	15.07%	26	50
14	桃園市大園區	2018-11-24T23:08:25+08:00	7065	15377	22442	1227	23669	46781	50.6%	15.1%	33	50
14	桃園市大園區	2018-11-24T23:55:38+08:00	8965	19341	28306	1488	29794	59566	50.02%	15.05%	41	50
14	桃園市大園區	2018-11-25T03:38:46+08:00	11241	23944	35185	1753	36938	73900	49.98%	15.21%	50	50
14	桃園市大園區	2018-11-24T23:59:58+08:00	9223	19848	29071	1507	30578	61267	49.91%	15.05%	42	50
14	桃園市大園區	2018-11-25T03:32:25+08:00	11241	23944	35185	1753	36938	73900	49.98%	15.21%	50	50
14	桃園市大園區	2018-11-24T23:15:54+08:00	7842	16820	24662	1332	25994	51516	50.46%	15.22%	36	50
14	桃園市大園區	2018-11-24T22:40:19+08:00	6206	13563	19769	1082	20851	41342	50.44%	15.01%	29	50
14	桃園市大園區	2018-11-25T01:25:43+08:00	11241	23944	35185	1753	36938	73900	49.98%	15.21%	50	50
14	桃園市大園區	2018-11-25T06:23:51+08:00	11241	23944	35185	1753	36938	73900	49.98%	15.21%	50	50
14	桃園市大園區	2018-11-24T22:54:17+08:00	6649	14512	21161	1158	22319	44058	50.66%	15.09%	31	50
14	桃園市大園區	2018-11-24T22:45:00+08:00	6419	13978	20397	1103	21500	42603	50.47%	15.07%	30	50
14	桃園市大園區	2018-11-24T23:01:21+08:00	6859	14907	21766	1200	22966	45384	50.6%	15.11%	32	50
14	桃園市大園區	2018-11-24T23:31:01+08:00	8030	17303	25333	1366	26699	52935	50.44%	15.17%	37	50
14	桃園市大園區	2018-11-25T00:09:23+08:00	9510	20399	29909	1517	31426	62917	49.95%	15.12%	43	50
14	桃園市大園區	2018-11-24T22:41:27+08:00	6206	13563	19769	1082	20851	41342	50.44%	15.01%	29	50
14	桃園市大園區	2018-11-25T01:12:33+08:00	11241	23944	35185	1753	36938	73900	49.98%	15.21%	50	50
14	桃園市大園區	2018-11-24T22:50:37+08:00	6649	14512	21161	1158	22319	44058	50.66%	15.09%	31	50
14	桃園市大園區	2018-11-25T00:14:00+08:00	10098	21390	31488	1582	33070	65963	50.13%	15.31%	45	50
14	桃園市大園區	2018-11-24T23:12:05+08:00	7321	15895	23216	1258	24474	48468	50.5%	15.1%	34	50
14	桃園市大園區	2018-11-24T23:39:04+08:00	8284	17844	26128	1392	27520	54779	50.24%	15.12%	38	50
14	桃園市大園區	2018-11-25T06:18:49+08:00	11241	23944	35185	1753	36938	73900	49.98%	15.21%	50	50
14	桃園市大園區	2018-11-25T01:17:41+08:00	11241	23944	35185	1753	36938	73900	49.98%	15.21%	50	50
14	桃園市大園區	2018-11-25T03:44:11+08:00	11241	23944	35185	1753	36938	73900	49.98%	15.21%	50	50
14	桃園市大園區	2018-11-24T22:23:03+08:00	5495	11985	17480	953	18433	36463	50.55%	15.07%	26	50
14	桃園市大園區	2018-11-24T23:04:55+08:00	6859	14907	21766	1200	22966	45384	50.6%	15.11%	32	50
14	桃園市大園區	2018-11-24T23:27:10+08:00	8030	17303	25333	1366	26699	52935	50.44%	15.17%	37	50
14	桃園市大園區	2018-11-24T22:36:52+08:00	6206	13563	19769	1082	20851	41342	50.44%	15.01%	29	50
14	桃園市大園區	2018-11-25T01:02:21+08:00	11241	23944	35185	1753	36938	73900	49.98%	15.21%	50	50
14	桃園市大園區	2018-11-24T23:19:39+08:00	7842	16820	24662	1332	25994	51516	50.46%	15.22%	36	50
14	桃園市大園區	2018-11-25T00:22:55+08:00	10772	22899	33671	1688	35359	70946	49.84%	15.18%	48	50
14	桃園市大園區	2018-11-25T03:56:01+08:00	11241	23944	35185	1753	36938	73900	49.98%	15.21%	50	50
14	桃園市大園區	2018-11-25T04:02:39+08:00	11241	23944	35185	1753	36938	73900	49.98%	15.21%	50	50
14	桃園市大園區	2018-11-25T06:13:44+08:00	11241	23944	35185	1753	36938	73900	49.98%	15.21%	50	50
14	桃園市大園區	2018-11-25T00:18:21+08:00	10339	21965	32304	1618	33922	67517	50.24%	15.31%	46	50
14	桃園市大園區	2018-11-24T22:33:29+08:00	5724	12550	18274	1008	19282	38113	50.59%	15.02%	27	50
14	桃園市大園區	2018-11-25T06:29:07+08:00	11241	23944	35185	1753	36938	73900	49.98%	15.21%	50	50
14	桃園市大園區	2018-11-25T03:49:42+08:00	11241	23944	35185	1753	36938	73900	49.98%	15.21%	50	50
14	桃園市大園區	2018-11-24T23:43:08+08:00	8555	18371	26926	1435	28361	56341	50.34%	15.18%	39	50
14	澎湖縣望安鄉	2018-11-24T22:33:39+08:00	431	1058	1489	154	1643	4152	39.57%	10.38%	9	10
14	澎湖縣望安鄉	2018-11-25T03:49:52+08:00	495	1193	1688	156	1844	4628	39.84%	10.7%	10	10
14	澎湖縣望安鄉	2018-11-24T23:43:18+08:00	495	1193	1688	156	1844	4628	39.84%	10.7%	10	10
14	澎湖縣望安鄉	2018-11-24T23:47:29+08:00	495	1193	1688	156	1844	4628	39.84%	10.7%	10	10
14	澎湖縣望安鄉	2018-11-25T06:29:18+08:00	495	1193	1688	156	1844	4628	39.84%	10.7%	10	10
14	澎湖縣望安鄉	2018-11-25T01:07:27+08:00	495	1193	1688	156	1844	4628	39.84%	10.7%	10	10
14	澎湖縣望安鄉	2018-11-25T06:13:53+08:00	495	1193	1688	156	1844	4628	39.84%	10.7%	10	10
14	澎湖縣望安鄉	2018-11-25T00:18:31+08:00	495	1193	1688	156	1844	4628	39.84%	10.7%	10	10
14	澎湖縣望安鄉	2018-11-24T22:37:01+08:00	431	1058	1489	154	1643	4152	39.57%	10.38%	9	10
14	澎湖縣望安鄉	2018-11-25T03:44:24+08:00	495	1193	1688	156	1844	4628	39.84%	10.7%	10	10
14	澎湖縣望安鄉	2018-11-24T23:08:37+08:00	431	1058	1489	154	1643	4152	39.57%	10.38%	9	10
14	澎湖縣望安鄉	2018-11-25T03:32:36+08:00	495	1193	1688	156	1844	4628	39.84%	10.7%	10	10
14	澎湖縣望安鄉	2018-11-24T23:55:48+08:00	495	1193	1688	156	1844	4628	39.84%	10.7%	10	10
14	澎湖縣望安鄉	2018-11-24T22:13:28+08:00	320	770	1090	101	1191	3117	38.21%	10.27%	6	10
14	澎湖縣望安鄉	2018-11-24T23:23:39+08:00	431	1058	1489	154	1643	4152	39.57%	10.38%	9	10
14	澎湖縣望安鄉	2018-11-25T06:18:58+08:00	495	1193	1688	156	1844	4628	39.84%	10.7%	10	10
14	澎湖縣望安鄉	2018-11-24T23:51:36+08:00	495	1193	1688	156	1844	4628	39.84%	10.7%	10	10
14	澎湖縣望安鄉	2018-11-24T22:23:14+08:00	320	770	1090	101	1191	3117	38.21%	10.27%	6	10
14	澎湖縣望安鄉	2018-11-24T22:40:28+08:00	431	1058	1489	154	1643	4152	39.57%	10.38%	9	10
14	澎湖縣望安鄉	2018-11-25T00:09:35+08:00	495	1193	1688	156	1844	4628	39.84%	10.7%	10	10
14	澎湖縣望安鄉	2018-11-25T00:05:06+08:00	495	1193	1688	156	1844	4628	39.84%	10.7%	10	10
14	澎湖縣望安鄉	2018-11-24T22:41:36+08:00	431	1058	1489	154	1643	4152	39.57%	10.38%	9	10
14	澎湖縣望安鄉	2018-11-24T22:45:09+08:00	431	1058	1489	154	1643	4152	39.57%	10.38%	9	10
14	澎湖縣望安鄉	2018-11-24T22:16:12+08:00	320	770	1090	101	1191	3117	38.21%	10.27%	6	10
14	澎湖縣望安鄉	2018-11-24T22:54:26+08:00	431	1058	1489	154	1643	4152	39.57%	10.38%	9	10
14	澎湖縣望安鄉	2018-11-25T00:14:10+08:00	495	1193	1688	156	1844	4628	39.84%	10.7%	10	10
14	澎湖縣望安鄉	2018-11-25T03:56:14+08:00	495	1193	1688	156	1844	4628	39.84%	10.7%	10	10
14	澎湖縣望安鄉	2018-11-24T23:16:04+08:00	431	1058	1489	154	1643	4152	39.57%	10.38%	9	10
14	澎湖縣望安鄉	2018-11-25T01:25:53+08:00	495	1193	1688	156	1844	4628	39.84%	10.7%	10	10
14	澎湖縣望安鄉	2018-11-25T01:02:32+08:00	495	1193	1688	156	1844	4628	39.84%	10.7%	10	10
14	澎湖縣望安鄉	2018-11-24T22:30:10+08:00	431	1058	1489	154	1643	4152	39.57%	10.38%	9	10
14	澎湖縣望安鄉	2018-11-25T00:23:04+08:00	495	1193	1688	156	1844	4628	39.84%	10.7%	10	10
14	澎湖縣望安鄉	2018-11-25T06:24:01+08:00	495	1193	1688	156	1844	4628	39.84%	10.7%	10	10
14	澎湖縣望安鄉	2018-11-25T03:38:56+08:00	495	1193	1688	156	1844	4628	39.84%	10.7%	10	10
14	澎湖縣望安鄉	2018-11-24T23:27:19+08:00	431	1058	1489	154	1643	4152	39.57%	10.38%	9	10
14	澎湖縣望安鄉	2018-11-24T22:19:38+08:00	320	770	1090	101	1191	3117	38.21%	10.27%	6	10
14	澎湖縣望安鄉	2018-11-25T01:17:53+08:00	495	1193	1688	156	1844	4628	39.84%	10.7%	10	10
14	澎湖縣望安鄉	2018-11-25T00:00:12+08:00	495	1193	1688	156	1844	4628	39.84%	10.7%	10	10
14	澎湖縣望安鄉	2018-11-24T22:57:55+08:00	431	1058	1489	154	1643	4152	39.57%	10.38%	9	10
14	澎湖縣望安鄉	2018-11-24T23:19:52+08:00	431	1058	1489	154	1643	4152	39.57%	10.38%	9	10
14	澎湖縣望安鄉	2018-11-25T00:57:38+08:00	495	1193	1688	156	1844	4628	39.84%	10.7%	10	10
14	澎湖縣望安鄉	2018-11-24T23:35:12+08:00	495	1193	1688	156	1844	4628	39.84%	10.7%	10	10
14	澎湖縣望安鄉	2018-11-25T06:08:54+08:00	495	1193	1688	156	1844	4628	39.84%	10.7%	10	10
14	澎湖縣望安鄉	2018-11-24T23:12:16+08:00	431	1058	1489	154	1643	4152	39.57%	10.38%	9	10
14	澎湖縣望安鄉	2018-11-24T23:39:17+08:00	495	1193	1688	156	1844	4628	39.84%	10.7%	10	10
14	澎湖縣望安鄉	2018-11-25T01:12:44+08:00	495	1193	1688	156	1844	4628	39.84%	10.7%	10	10
14	澎湖縣望安鄉	2018-11-24T22:50:49+08:00	431	1058	1489	154	1643	4152	39.57%	10.38%	9	10
14	澎湖縣望安鄉	2018-11-25T04:02:53+08:00	495	1193	1688	156	1844	4628	39.84%	10.7%	10	10
14	澎湖縣望安鄉	2018-11-24T23:05:05+08:00	431	1058	1489	154	1643	4152	39.57%	10.38%	9	10
14	澎湖縣望安鄉	2018-11-24T23:31:12+08:00	431	1058	1489	154	1643	4152	39.57%	10.38%	9	10
14	澎湖縣望安鄉	2018-11-24T23:01:32+08:00	431	1058	1489	154	1643	4152	39.57%	10.38%	9	10
14	澎湖縣望安鄉	2018-11-24T22:26:38+08:00	374	925	1299	131	1430	3588	39.86%	10.42%	7	10
14	新竹縣北埔鄉	2018-11-25T04:02:44+08:00	1229	3165	4394	248	4642	8180	56.75%	15.02%	10	10
14	新竹縣北埔鄉	2018-11-25T01:12:37+08:00	1229	3165	4394	248	4642	8180	56.75%	15.02%	10	10
14	新竹縣北埔鄉	2018-11-25T00:14:04+08:00	1229	3165	4394	248	4642	8180	56.75%	15.02%	10	10
14	新竹縣北埔鄉	2018-11-24T23:31:05+08:00	987	2530	3517	191	3708	6527	56.81%	15.12%	9	10
14	新竹縣北埔鄉	2018-11-25T01:07:21+08:00	1229	3165	4394	248	4642	8180	56.75%	15.02%	10	10
14	新竹縣北埔鄉	2018-11-25T06:29:11+08:00	1229	3165	4394	248	4642	8180	56.75%	15.02%	10	10
14	新竹縣北埔鄉	2018-11-25T00:09:28+08:00	1229	3165	4394	248	4642	8180	56.75%	15.02%	10	10
14	新竹縣北埔鄉	2018-11-24T22:23:07+08:00	878	2218	3096	176	3272	5764	56.77%	15.23%	8	10
14	新竹縣北埔鄉	2018-11-25T00:00:03+08:00	1229	3165	4394	248	4642	8180	56.75%	15.02%	10	10
14	新竹縣北埔鄉	2018-11-24T23:08:30+08:00	878	2218	3096	176	3272	5764	56.77%	15.23%	8	10
14	新竹縣北埔鄉	2018-11-24T23:19:44+08:00	878	2218	3096	176	3272	5764	56.77%	15.23%	8	10
14	新竹縣北埔鄉	2018-11-24T22:13:21+08:00	878	2218	3096	176	3272	5764	56.77%	15.23%	8	10
14	新竹縣北埔鄉	2018-11-25T03:32:30+08:00	1229	3165	4394	248	4642	8180	56.75%	15.02%	10	10
14	新竹縣北埔鄉	2018-11-24T23:51:30+08:00	1229	3165	4394	248	4642	8180	56.75%	15.02%	10	10
14	新竹縣北埔鄉	2018-11-24T22:30:01+08:00	878	2218	3096	176	3272	5764	56.77%	15.23%	8	10
14	新竹縣北埔鄉	2018-11-24T23:27:14+08:00	878	2218	3096	176	3272	5764	56.77%	15.23%	8	10
14	新竹縣北埔鄉	2018-11-24T22:19:32+08:00	878	2218	3096	176	3272	5764	56.77%	15.23%	8	10
14	新竹縣北埔鄉	2018-11-24T22:36:56+08:00	878	2218	3096	176	3272	5764	56.77%	15.23%	8	10
14	新竹縣北埔鄉	2018-11-25T01:02:25+08:00	1229	3165	4394	248	4642	8180	56.75%	15.02%	10	10
14	新竹縣北埔鄉	2018-11-25T00:18:25+08:00	1229	3165	4394	248	4642	8180	56.75%	15.02%	10	10
14	新竹縣北埔鄉	2018-11-24T23:05:00+08:00	878	2218	3096	176	3272	5764	56.77%	15.23%	8	10
14	新竹縣北埔鄉	2018-11-24T22:26:32+08:00	878	2218	3096	176	3272	5764	56.77%	15.23%	8	10
14	新竹縣北埔鄉	2018-11-25T06:13:48+08:00	1229	3165	4394	248	4642	8180	56.75%	15.02%	10	10
14	新竹縣北埔鄉	2018-11-24T22:50:42+08:00	878	2218	3096	176	3272	5764	56.77%	15.23%	8	10
14	新竹縣北埔鄉	2018-11-24T22:54:21+08:00	878	2218	3096	176	3272	5764	56.77%	15.23%	8	10
14	新竹縣北埔鄉	2018-11-25T00:05:00+08:00	1229	3165	4394	248	4642	8180	56.75%	15.02%	10	10
14	新竹縣北埔鄉	2018-11-24T22:41:30+08:00	878	2218	3096	176	3272	5764	56.77%	15.23%	8	10
14	新竹縣北埔鄉	2018-11-25T00:22:59+08:00	1229	3165	4394	248	4642	8180	56.75%	15.02%	10	10
14	新竹縣北埔鄉	2018-11-25T03:49:46+08:00	1229	3165	4394	248	4642	8180	56.75%	15.02%	10	10
14	新竹縣北埔鄉	2018-11-24T22:16:05+08:00	878	2218	3096	176	3272	5764	56.77%	15.23%	8	10
14	新竹縣北埔鄉	2018-11-24T23:01:26+08:00	878	2218	3096	176	3272	5764	56.77%	15.23%	8	10
14	新竹縣北埔鄉	2018-11-24T23:43:12+08:00	987	2530	3517	191	3708	6527	56.81%	15.12%	9	10
14	新竹縣北埔鄉	2018-11-24T22:33:33+08:00	878	2218	3096	176	3272	5764	56.77%	15.23%	8	10
14	新竹縣北埔鄉	2018-11-25T06:08:47+08:00	1229	3165	4394	248	4642	8180	56.75%	15.02%	10	10
14	新竹縣北埔鄉	2018-11-24T23:35:06+08:00	987	2530	3517	191	3708	6527	56.81%	15.12%	9	10
14	新竹縣北埔鄉	2018-11-24T23:47:23+08:00	1229	3165	4394	248	4642	8180	56.75%	15.02%	10	10
14	新竹縣北埔鄉	2018-11-24T23:55:42+08:00	1229	3165	4394	248	4642	8180	56.75%	15.02%	10	10
14	新竹縣北埔鄉	2018-11-25T01:17:46+08:00	1229	3165	4394	248	4642	8180	56.75%	15.02%	10	10
14	新竹縣北埔鄉	2018-11-24T22:57:48+08:00	878	2218	3096	176	3272	5764	56.77%	15.23%	8	10
14	新竹縣北埔鄉	2018-11-25T03:38:50+08:00	1229	3165	4394	248	4642	8180	56.75%	15.02%	10	10
14	新竹縣北埔鄉	2018-11-24T23:23:34+08:00	878	2218	3096	176	3272	5764	56.77%	15.23%	8	10
14	新竹縣北埔鄉	2018-11-25T03:44:17+08:00	1229	3165	4394	248	4642	8180	56.75%	15.02%	10	10
14	新竹縣北埔鄉	2018-11-25T01:25:48+08:00	1229	3165	4394	248	4642	8180	56.75%	15.02%	10	10
14	新竹縣北埔鄉	2018-11-24T22:40:23+08:00	878	2218	3096	176	3272	5764	56.77%	15.23%	8	10
14	新竹縣北埔鄉	2018-11-25T06:18:52+08:00	1229	3165	4394	248	4642	8180	56.75%	15.02%	10	10
14	新竹縣北埔鄉	2018-11-24T23:15:58+08:00	878	2218	3096	176	3272	5764	56.77%	15.23%	8	10
14	新竹縣北埔鄉	2018-11-25T00:57:31+08:00	1229	3165	4394	248	4642	8180	56.75%	15.02%	10	10
14	新竹縣北埔鄉	2018-11-25T03:56:06+08:00	1229	3165	4394	248	4642	8180	56.75%	15.02%	10	10
14	新竹縣北埔鄉	2018-11-25T06:23:55+08:00	1229	3165	4394	248	4642	8180	56.75%	15.02%	10	10
14	新竹縣北埔鄉	2018-11-24T23:39:10+08:00	987	2530	3517	191	3708	6527	56.81%	15.12%	9	10
14	新竹縣北埔鄉	2018-11-24T22:45:04+08:00	878	2218	3096	176	3272	5764	56.77%	15.23%	8	10
14	新竹縣北埔鄉	2018-11-24T23:12:10+08:00	878	2218	3096	176	3272	5764	56.77%	15.23%	8	10
14	苗栗縣三灣鄉	2018-11-25T04:02:44+08:00	800	2345	3145	236	3381	5852	57.78%	13.67%	9	9
14	苗栗縣三灣鄉	2018-11-25T00:09:29+08:00	800	2345	3145	236	3381	5852	57.78%	13.67%	9	9
14	苗栗縣三灣鄉	2018-11-24T22:16:06+08:00	800	2345	3145	236	3381	5852	57.78%	13.67%	9	9
14	苗栗縣三灣鄉	2018-11-25T01:12:38+08:00	800	2345	3145	236	3381	5852	57.78%	13.67%	9	9
14	苗栗縣三灣鄉	2018-11-25T00:14:05+08:00	800	2345	3145	236	3381	5852	57.78%	13.67%	9	9
14	苗栗縣三灣鄉	2018-11-25T00:00:03+08:00	800	2345	3145	236	3381	5852	57.78%	13.67%	9	9
14	苗栗縣三灣鄉	2018-11-24T22:23:08+08:00	800	2345	3145	236	3381	5852	57.78%	13.67%	9	9
14	苗栗縣三灣鄉	2018-11-24T23:08:31+08:00	800	2345	3145	236	3381	5852	57.78%	13.67%	9	9
14	苗栗縣三灣鄉	2018-11-25T03:32:30+08:00	800	2345	3145	236	3381	5852	57.78%	13.67%	9	9
14	苗栗縣三灣鄉	2018-11-24T22:30:01+08:00	800	2345	3145	236	3381	5852	57.78%	13.67%	9	9
14	苗栗縣三灣鄉	2018-11-24T23:27:14+08:00	800	2345	3145	236	3381	5852	57.78%	13.67%	9	9
14	苗栗縣三灣鄉	2018-11-24T23:51:31+08:00	800	2345	3145	236	3381	5852	57.78%	13.67%	9	9
14	苗栗縣三灣鄉	2018-11-24T22:19:33+08:00	800	2345	3145	236	3381	5852	57.78%	13.67%	9	9
14	苗栗縣三灣鄉	2018-11-25T00:57:32+08:00	800	2345	3145	236	3381	5852	57.78%	13.67%	9	9
14	苗栗縣三灣鄉	2018-11-24T22:36:56+08:00	800	2345	3145	236	3381	5852	57.78%	13.67%	9	9
14	苗栗縣三灣鄉	2018-11-24T22:50:43+08:00	800	2345	3145	236	3381	5852	57.78%	13.67%	9	9
14	苗栗縣三灣鄉	2018-11-25T00:18:25+08:00	800	2345	3145	236	3381	5852	57.78%	13.67%	9	9
14	苗栗縣三灣鄉	2018-11-25T06:23:56+08:00	800	2345	3145	236	3381	5852	57.78%	13.67%	9	9
14	苗栗縣三灣鄉	2018-11-24T22:26:33+08:00	800	2345	3145	236	3381	5852	57.78%	13.67%	9	9
14	苗栗縣三灣鄉	2018-11-25T03:49:47+08:00	800	2345	3145	236	3381	5852	57.78%	13.67%	9	9
14	苗栗縣三灣鄉	2018-11-24T22:41:31+08:00	800	2345	3145	236	3381	5852	57.78%	13.67%	9	9
14	苗栗縣三灣鄉	2018-11-25T00:05:01+08:00	800	2345	3145	236	3381	5852	57.78%	13.67%	9	9
14	苗栗縣三灣鄉	2018-11-25T06:13:48+08:00	800	2345	3145	236	3381	5852	57.78%	13.67%	9	9
14	苗栗縣三灣鄉	2018-11-25T00:22:59+08:00	800	2345	3145	236	3381	5852	57.78%	13.67%	9	9
14	苗栗縣三灣鄉	2018-11-24T23:05:01+08:00	800	2345	3145	236	3381	5852	57.78%	13.67%	9	9
14	苗栗縣三灣鄉	2018-11-24T23:31:06+08:00	800	2345	3145	236	3381	5852	57.78%	13.67%	9	9
14	苗栗縣三灣鄉	2018-11-25T06:08:48+08:00	800	2345	3145	236	3381	5852	57.78%	13.67%	9	9
14	苗栗縣三灣鄉	2018-11-25T01:07:22+08:00	800	2345	3145	236	3381	5852	57.78%	13.67%	9	9
14	苗栗縣三灣鄉	2018-11-24T22:33:33+08:00	800	2345	3145	236	3381	5852	57.78%	13.67%	9	9
14	苗栗縣三灣鄉	2018-11-24T23:43:13+08:00	800	2345	3145	236	3381	5852	57.78%	13.67%	9	9
14	苗栗縣三灣鄉	2018-11-24T23:01:27+08:00	800	2345	3145	236	3381	5852	57.78%	13.67%	9	9
14	苗栗縣三灣鄉	2018-11-24T23:35:06+08:00	800	2345	3145	236	3381	5852	57.78%	13.67%	9	9
14	苗栗縣三灣鄉	2018-11-25T06:29:12+08:00	800	2345	3145	236	3381	5852	57.78%	13.67%	9	9
14	苗栗縣三灣鄉	2018-11-24T23:47:24+08:00	800	2345	3145	236	3381	5852	57.78%	13.67%	9	9
14	苗栗縣三灣鄉	2018-11-24T23:55:42+08:00	800	2345	3145	236	3381	5852	57.78%	13.67%	9	9
14	苗栗縣三灣鄉	2018-11-24T23:19:46+08:00	800	2345	3145	236	3381	5852	57.78%	13.67%	9	9
14	苗栗縣三灣鄉	2018-11-25T03:44:18+08:00	800	2345	3145	236	3381	5852	57.78%	13.67%	9	9
14	苗栗縣三灣鄉	2018-11-24T23:23:34+08:00	800	2345	3145	236	3381	5852	57.78%	13.67%	9	9
14	苗栗縣三灣鄉	2018-11-25T03:38:51+08:00	800	2345	3145	236	3381	5852	57.78%	13.67%	9	9
14	苗栗縣三灣鄉	2018-11-24T22:57:49+08:00	800	2345	3145	236	3381	5852	57.78%	13.67%	9	9
14	苗栗縣三灣鄉	2018-11-24T22:13:22+08:00	800	2345	3145	236	3381	5852	57.78%	13.67%	9	9
14	苗栗縣三灣鄉	2018-11-25T01:17:47+08:00	800	2345	3145	236	3381	5852	57.78%	13.67%	9	9
14	苗栗縣三灣鄉	2018-11-25T01:25:48+08:00	800	2345	3145	236	3381	5852	57.78%	13.67%	9	9
14	苗栗縣三灣鄉	2018-11-24T22:40:24+08:00	800	2345	3145	236	3381	5852	57.78%	13.67%	9	9
14	苗栗縣三灣鄉	2018-11-25T01:02:26+08:00	800	2345	3145	236	3381	5852	57.78%	13.67%	9	9
14	苗栗縣三灣鄉	2018-11-24T23:15:59+08:00	800	2345	3145	236	3381	5852	57.78%	13.67%	9	9
14	苗栗縣三灣鄉	2018-11-25T06:18:53+08:00	800	2345	3145	236	3381	5852	57.78%	13.67%	9	9
14	苗栗縣三灣鄉	2018-11-24T23:12:11+08:00	800	2345	3145	236	3381	5852	57.78%	13.67%	9	9
14	苗栗縣三灣鄉	2018-11-24T23:39:10+08:00	800	2345	3145	236	3381	5852	57.78%	13.67%	9	9
14	苗栗縣三灣鄉	2018-11-25T03:56:07+08:00	800	2345	3145	236	3381	5852	57.78%	13.67%	9	9
14	苗栗縣三灣鄉	2018-11-24T22:45:04+08:00	800	2345	3145	236	3381	5852	57.78%	13.67%	9	9
14	苗栗縣三灣鄉	2018-11-24T22:54:22+08:00	800	2345	3145	236	3381	5852	57.78%	13.67%	9	9
14	苗栗縣後龍鎮	2018-11-25T04:02:44+08:00	4624	11173	15797	1316	17113	30948	55.3%	14.94%	35	35
14	苗栗縣後龍鎮	2018-11-24T23:31:05+08:00	4624	11173	15797	1316	17113	30948	55.3%	14.94%	35	35
14	苗栗縣後龍鎮	2018-11-25T00:09:29+08:00	4624	11173	15797	1316	17113	30948	55.3%	14.94%	35	35
14	苗栗縣後龍鎮	2018-11-25T01:12:38+08:00	4624	11173	15797	1316	17113	30948	55.3%	14.94%	35	35
14	苗栗縣後龍鎮	2018-11-25T00:14:05+08:00	4624	11173	15797	1316	17113	30948	55.3%	14.94%	35	35
14	苗栗縣後龍鎮	2018-11-24T23:19:45+08:00	4624	11173	15797	1316	17113	30948	55.3%	14.94%	35	35
14	苗栗縣後龍鎮	2018-11-25T00:00:03+08:00	4624	11173	15797	1316	17113	30948	55.3%	14.94%	35	35
14	苗栗縣後龍鎮	2018-11-24T22:23:08+08:00	3494	8522	12016	982	12998	23885	54.42%	14.63%	28	35
14	苗栗縣後龍鎮	2018-11-24T23:08:31+08:00	4506	10815	15321	1264	16585	29912	55.45%	15.06%	34	35
14	苗栗縣後龍鎮	2018-11-25T03:32:30+08:00	4624	11173	15797	1316	17113	30948	55.3%	14.94%	35	35
14	苗栗縣後龍鎮	2018-11-24T23:51:30+08:00	4624	11173	15797	1316	17113	30948	55.3%	14.94%	35	35
14	苗栗縣後龍鎮	2018-11-24T22:30:01+08:00	3597	8767	12364	1013	13377	24686	54.19%	14.57%	29	35
14	苗栗縣後龍鎮	2018-11-24T23:27:14+08:00	4624	11173	15797	1316	17113	30948	55.3%	14.94%	35	35
14	苗栗縣後龍鎮	2018-11-24T22:19:32+08:00	3357	8191	11548	947	12495	22920	54.52%	14.65%	27	35
14	苗栗縣後龍鎮	2018-11-25T00:57:32+08:00	4624	11173	15797	1316	17113	30948	55.3%	14.94%	35	35
14	苗栗縣後龍鎮	2018-11-24T22:36:56+08:00	3795	9369	13164	1065	14229	25902	54.93%	14.65%	30	35
14	苗栗縣後龍鎮	2018-11-24T22:50:43+08:00	3956	9721	13677	1111	14788	26785	55.21%	14.77%	31	35
14	苗栗縣後龍鎮	2018-11-25T00:18:25+08:00	4624	11173	15797	1316	17113	30948	55.3%	14.94%	35	35
14	苗栗縣後龍鎮	2018-11-25T06:23:56+08:00	4624	11173	15797	1316	17113	30948	55.3%	14.94%	35	35
14	苗栗縣後龍鎮	2018-11-24T23:05:00+08:00	4224	10479	14703	1217	15920	28799	55.28%	14.67%	33	35
14	苗栗縣後龍鎮	2018-11-25T03:49:47+08:00	4624	11173	15797	1316	17113	30948	55.3%	14.94%	35	35
14	苗栗縣後龍鎮	2018-11-24T22:41:31+08:00	3956	9721	13677	1111	14788	26785	55.21%	14.77%	31	35
14	苗栗縣後龍鎮	2018-11-24T22:26:32+08:00	3494	8522	12016	982	12998	23885	54.42%	14.63%	28	35
14	苗栗縣後龍鎮	2018-11-25T06:13:48+08:00	4624	11173	15797	1316	17113	30948	55.3%	14.94%	35	35
14	苗栗縣後龍鎮	2018-11-24T22:54:21+08:00	4088	10084	14172	1149	15321	27762	55.19%	14.73%	32	35
14	苗栗縣後龍鎮	2018-11-25T00:05:00+08:00	4624	11173	15797	1316	17113	30948	55.3%	14.94%	35	35
14	苗栗縣後龍鎮	2018-11-25T00:22:59+08:00	4624	11173	15797	1316	17113	30948	55.3%	14.94%	35	35
14	苗栗縣後龍鎮	2018-11-24T22:16:05+08:00	3357	8191	11548	947	12495	22920	54.52%	14.65%	27	35
14	苗栗縣後龍鎮	2018-11-24T23:01:26+08:00	4224	10479	14703	1217	15920	28799	55.28%	14.67%	33	35
14	苗栗縣後龍鎮	2018-11-25T01:07:22+08:00	4624	11173	15797	1316	17113	30948	55.3%	14.94%	35	35
14	苗栗縣後龍鎮	2018-11-24T22:33:33+08:00	3795	9369	13164	1065	14229	25902	54.93%	14.65%	30	35
14	苗栗縣後龍鎮	2018-11-24T23:43:13+08:00	4624	11173	15797	1316	17113	30948	55.3%	14.94%	35	35
14	苗栗縣後龍鎮	2018-11-25T06:08:47+08:00	4624	11173	15797	1316	17113	30948	55.3%	14.94%	35	35
14	苗栗縣後龍鎮	2018-11-24T23:35:06+08:00	4624	11173	15797	1316	17113	30948	55.3%	14.94%	35	35
14	苗栗縣後龍鎮	2018-11-24T23:47:23+08:00	4624	11173	15797	1316	17113	30948	55.3%	14.94%	35	35
14	苗栗縣後龍鎮	2018-11-25T06:29:12+08:00	4624	11173	15797	1316	17113	30948	55.3%	14.94%	35	35
14	苗栗縣後龍鎮	2018-11-24T23:55:42+08:00	4624	11173	15797	1316	17113	30948	55.3%	14.94%	35	35
14	苗栗縣後龍鎮	2018-11-25T01:17:46+08:00	4624	11173	15797	1316	17113	30948	55.3%	14.94%	35	35
14	苗栗縣後龍鎮	2018-11-24T22:57:48+08:00	4224	10479	14703	1217	15920	28799	55.28%	14.67%	33	35
14	苗栗縣後龍鎮	2018-11-24T23:23:34+08:00	4624	11173	15797	1316	17113	30948	55.3%	14.94%	35	35
14	苗栗縣後龍鎮	2018-11-25T03:38:51+08:00	4624	11173	15797	1316	17113	30948	55.3%	14.94%	35	35
14	苗栗縣後龍鎮	2018-11-24T22:13:22+08:00	3357	8191	11548	947	12495	22920	54.52%	14.65%	27	35
14	苗栗縣後龍鎮	2018-11-25T03:44:17+08:00	4624	11173	15797	1316	17113	30948	55.3%	14.94%	35	35
14	苗栗縣後龍鎮	2018-11-25T01:25:48+08:00	4624	11173	15797	1316	17113	30948	55.3%	14.94%	35	35
14	苗栗縣後龍鎮	2018-11-24T22:40:24+08:00	3956	9721	13677	1111	14788	26785	55.21%	14.77%	31	35
14	苗栗縣後龍鎮	2018-11-24T23:15:58+08:00	4624	11173	15797	1316	17113	30948	55.3%	14.94%	35	35
14	苗栗縣後龍鎮	2018-11-25T01:02:26+08:00	4624	11173	15797	1316	17113	30948	55.3%	14.94%	35	35
14	苗栗縣後龍鎮	2018-11-25T06:18:53+08:00	4624	11173	15797	1316	17113	30948	55.3%	14.94%	35	35
14	苗栗縣後龍鎮	2018-11-24T23:12:11+08:00	4506	10815	15321	1264	16585	29912	55.45%	15.06%	34	35
14	苗栗縣後龍鎮	2018-11-24T23:39:10+08:00	4624	11173	15797	1316	17113	30948	55.3%	14.94%	35	35
14	苗栗縣後龍鎮	2018-11-25T03:56:07+08:00	4624	11173	15797	1316	17113	30948	55.3%	14.94%	35	35
14	苗栗縣後龍鎮	2018-11-24T22:45:04+08:00	3956	9721	13677	1111	14788	26785	55.21%	14.77%	31	35
14	高雄市三民區	2018-11-25T06:29:10+08:00	56428	107656	164084	7746	171830	289519	59.35%	19.49%	189	189
14	高雄市三民區	2018-11-24T23:35:04+08:00	41806	79337	121143	6062	127205	213325	59.63%	19.6%	147	189
14	高雄市三民區	2018-11-24T23:47:21+08:00	45340	85907	131247	6418	137665	231299	59.52%	19.6%	157	189
14	高雄市三民區	2018-11-25T00:14:03+08:00	49698	94548	144246	6902	151148	254106	59.48%	19.56%	170	189
14	高雄市三民區	2018-11-24T23:12:09+08:00	35847	67849	103696	5266	108962	182406	59.74%	19.65%	128	189
14	高雄市三民區	2018-11-25T06:08:45+08:00	56428	107656	164084	7746	171830	289519	59.35%	19.49%	189	189
14	高雄市三民區	2018-11-24T23:43:11+08:00	44257	83862	128119	6315	134434	225798	59.54%	19.6%	154	189
14	高雄市三民區	2018-11-25T00:09:27+08:00	47898	90984	138882	6762	145644	244536	59.56%	19.59%	165	189
14	高雄市三民區	2018-11-24T22:33:31+08:00	26624	50174	76798	3982	80780	136396	59.22%	19.52%	99	189
14	高雄市三民區	2018-11-25T01:12:36+08:00	55719	106308	162027	7656	169683	285904	59.35%	19.49%	187	189
14	高雄市三民區	2018-11-25T04:02:42+08:00	56428	107656	164084	7746	171830	289519	59.35%	19.49%	189	189
14	高雄市三民區	2018-11-25T01:07:20+08:00	55719	106308	162027	7656	169683	285904	59.35%	19.49%	187	189
14	高雄市三民區	2018-11-24T23:39:07+08:00	42449	80631	123080	6140	129220	216654	59.64%	19.59%	149	189
14	高雄市三民區	2018-11-24T23:31:03+08:00	40762	77305	118067	5962	124029	207904	59.66%	19.61%	144	189
14	高雄市三民區	2018-11-24T23:01:24+08:00	34618	65137	99755	5075	104830	175874	59.61%	19.68%	124	189
14	高雄市三民區	2018-11-25T03:44:15+08:00	56428	107656	164084	7746	171830	289519	59.35%	19.49%	189	189
14	高雄市三民區	2018-11-24T23:19:42+08:00	36448	69094	105542	5376	110918	185679	59.74%	19.63%	130	189
14	高雄市三民區	2018-11-24T22:13:20+08:00	21643	40573	62216	3272	65488	109448	59.83%	19.77%	83	189
14	高雄市三民區	2018-11-25T00:04:58+08:00	47512	90357	137869	6725	144594	242874	59.53%	19.56%	164	189
14	高雄市三民區	2018-11-24T23:55:41+08:00	46982	89287	136269	6678	142947	240041	59.55%	19.57%	162	189
14	高雄市三民區	2018-11-24T22:23:06+08:00	24568	46202	70770	3636	74406	125664	59.21%	19.55%	92	189
14	高雄市三民區	2018-11-25T01:17:44+08:00	55719	106308	162027	7656	169683	285904	59.35%	19.49%	187	189
14	高雄市三民區	2018-11-24T23:04:58+08:00	34949	65769	100718	5126	105844	177528	59.62%	19.69%	125	189
14	高雄市三民區	2018-11-25T06:18:51+08:00	56428	107656	164084	7746	171830	289519	59.35%	19.49%	189	189
14	高雄市三民區	2018-11-25T01:02:24+08:00	55404	105603	161007	7612	168619	283980	59.38%	19.51%	186	189
14	高雄市三民區	2018-11-25T03:38:49+08:00	56428	107656	164084	7746	171830	289519	59.35%	19.49%	189	189
14	高雄市三民區	2018-11-24T23:27:12+08:00	38534	73235	111769	5652	117421	196516	59.75%	19.61%	137	189
14	高雄市三民區	2018-11-24T22:54:20+08:00	32443	60856	93299	4825	98124	165020	59.46%	19.66%	117	189
14	高雄市三民區	2018-11-25T00:18:23+08:00	49975	95131	145106	6932	152038	255612	59.48%	19.55%	171	189
14	高雄市三民區	2018-11-25T06:13:46+08:00	56428	107656	164084	7746	171830	289519	59.35%	19.49%	189	189
14	高雄市三民區	2018-11-25T00:22:57+08:00	50295	95784	146079	6965	153044	257501	59.43%	19.53%	172	189
14	高雄市三民區	2018-11-25T03:56:04+08:00	56428	107656	164084	7746	171830	289519	59.35%	19.49%	189	189
14	高雄市三民區	2018-11-24T22:41:29+08:00	28911	54714	83625	4352	87977	148356	59.3%	19.49%	107	189
14	高雄市三民區	2018-11-24T22:16:03+08:00	22880	42937	65817	3449	69266	117245	59.08%	19.51%	87	189
14	高雄市三民區	2018-11-24T22:29:59+08:00	25821	48553	74374	3839	78213	131986	59.26%	19.56%	96	189
14	高雄市三民區	2018-11-24T23:23:32+08:00	37938	72143	110081	5572	115653	193478	59.78%	19.61%	135	189
14	高雄市三民區	2018-11-24T23:51:28+08:00	46368	87979	134347	6590	140937	236755	59.53%	19.58%	160	189
14	高雄市三民區	2018-11-24T22:57:46+08:00	33933	63808	97741	5020	102761	172516	59.57%	19.67%	122	189
14	高雄市三民區	2018-11-25T00:00:01+08:00	47242	89812	137054	6698	143752	241447	59.54%	19.57%	163	189
14	高雄市三民區	2018-11-25T01:25:46+08:00	55719	106308	162027	7656	169683	285904	59.35%	19.49%	187	189
14	高雄市三民區	2018-11-24T22:19:31+08:00	24166	45430	69596	3615	73211	123630	59.22%	19.55%	91	189
14	高雄市三民區	2018-11-25T00:57:30+08:00	55404	105603	161007	7612	168619	283980	59.38%	19.51%	186	189
14	高雄市三民區	2018-11-24T22:40:22+08:00	28911	54714	83625	4352	87977	148356	59.3%	19.49%	107	189
14	高雄市三民區	2018-11-24T22:36:55+08:00	28033	53063	81096	4222	85318	144104	59.21%	19.45%	104	189
14	高雄市三民區	2018-11-24T23:08:29+08:00	35492	67153	102645	5210	107855	180722	59.68%	19.64%	127	189
14	高雄市三民區	2018-11-24T23:15:57+08:00	36091	68461	104552	5337	109889	183879	59.76%	19.63%	129	189
14	高雄市三民區	2018-11-25T03:32:28+08:00	56428	107656	164084	7746	171830	289519	59.35%	19.49%	189	189
14	高雄市三民區	2018-11-24T22:45:02+08:00	29909	56562	86471	4521	90992	153534	59.27%	19.48%	110	189
14	高雄市三民區	2018-11-25T03:49:45+08:00	56428	107656	164084	7746	171830	289519	59.35%	19.49%	189	189
14	高雄市三民區	2018-11-25T06:23:54+08:00	56428	107656	164084	7746	171830	289519	59.35%	19.49%	189	189
14	高雄市三民區	2018-11-24T22:26:31+08:00	25487	47956	73443	3783	77226	130362	59.24%	19.55%	95	189
14	高雄市三民區	2018-11-24T22:50:41+08:00	32443	60856	93299	4825	98124	165020	59.46%	19.66%	117	189
14	高雄市大樹區	2018-11-25T06:29:10+08:00	5867	13398	19265	1310	20575	36772	55.95%	15.96%	32	32
14	高雄市大樹區	2018-11-25T00:14:03+08:00	5867	13398	19265	1310	20575	36772	55.95%	15.96%	32	32
14	高雄市大樹區	2018-11-24T23:01:25+08:00	5529	12448	17977	1252	19229	34311	56.04%	16.11%	31	32
14	高雄市大樹區	2018-11-24T23:12:09+08:00	5529	12448	17977	1252	19229	34311	56.04%	16.11%	31	32
14	高雄市大樹區	2018-11-24T23:43:11+08:00	5867	13398	19265	1310	20575	36772	55.95%	15.96%	32	32
14	高雄市大樹區	2018-11-24T23:39:08+08:00	5867	13398	19265	1310	20575	36772	55.95%	15.96%	32	32
14	高雄市大樹區	2018-11-25T00:09:27+08:00	5867	13398	19265	1310	20575	36772	55.95%	15.96%	32	32
14	高雄市大樹區	2018-11-25T01:12:36+08:00	5867	13398	19265	1310	20575	36772	55.95%	15.96%	32	32
14	高雄市大樹區	2018-11-25T04:02:42+08:00	5867	13398	19265	1310	20575	36772	55.95%	15.96%	32	32
14	高雄市大樹區	2018-11-24T23:35:05+08:00	5867	13398	19265	1310	20575	36772	55.95%	15.96%	32	32
14	高雄市大樹區	2018-11-25T01:07:20+08:00	5867	13398	19265	1310	20575	36772	55.95%	15.96%	32	32
14	高雄市大樹區	2018-11-24T23:31:04+08:00	5867	13398	19265	1310	20575	36772	55.95%	15.96%	32	32
14	高雄市大樹區	2018-11-25T01:17:45+08:00	5867	13398	19265	1310	20575	36772	55.95%	15.96%	32	32
14	高雄市大樹區	2018-11-25T03:44:15+08:00	5867	13398	19265	1310	20575	36772	55.95%	15.96%	32	32
14	高雄市大樹區	2018-11-24T22:13:20+08:00	5461	12160	17621	1232	18853	33591	56.13%	16.26%	30	32
14	高雄市大樹區	2018-11-24T23:55:41+08:00	5867	13398	19265	1310	20575	36772	55.95%	15.96%	32	32
14	高雄市大樹區	2018-11-24T22:23:06+08:00	5461	12160	17621	1232	18853	33591	56.13%	16.26%	30	32
14	高雄市大樹區	2018-11-24T23:19:43+08:00	5529	12448	17977	1252	19229	34311	56.04%	16.11%	31	32
14	高雄市大樹區	2018-11-24T23:04:58+08:00	5529	12448	17977	1252	19229	34311	56.04%	16.11%	31	32
14	高雄市大樹區	2018-11-25T00:00:02+08:00	5867	13398	19265	1310	20575	36772	55.95%	15.96%	32	32
14	高雄市大樹區	2018-11-25T00:04:59+08:00	5867	13398	19265	1310	20575	36772	55.95%	15.96%	32	32
14	高雄市大樹區	2018-11-25T06:18:51+08:00	5867	13398	19265	1310	20575	36772	55.95%	15.96%	32	32
14	高雄市大樹區	2018-11-25T01:02:24+08:00	5867	13398	19265	1310	20575	36772	55.95%	15.96%	32	32
14	高雄市大樹區	2018-11-24T23:27:13+08:00	5867	13398	19265	1310	20575	36772	55.95%	15.96%	32	32
14	高雄市大樹區	2018-11-25T03:38:49+08:00	5867	13398	19265	1310	20575	36772	55.95%	15.96%	32	32
14	高雄市大樹區	2018-11-24T22:30:00+08:00	5529	12448	17977	1252	19229	34311	56.04%	16.11%	31	32
14	高雄市大樹區	2018-11-24T22:54:20+08:00	5529	12448	17977	1252	19229	34311	56.04%	16.11%	31	32
14	高雄市大樹區	2018-11-25T00:22:58+08:00	5867	13398	19265	1310	20575	36772	55.95%	15.96%	32	32
14	高雄市大樹區	2018-11-25T03:56:05+08:00	5867	13398	19265	1310	20575	36772	55.95%	15.96%	32	32
14	高雄市大樹區	2018-11-25T00:18:24+08:00	5867	13398	19265	1310	20575	36772	55.95%	15.96%	32	32
14	高雄市大樹區	2018-11-25T06:13:46+08:00	5867	13398	19265	1310	20575	36772	55.95%	15.96%	32	32
14	高雄市大樹區	2018-11-25T06:08:46+08:00	5867	13398	19265	1310	20575	36772	55.95%	15.96%	32	32
14	高雄市大樹區	2018-11-24T23:47:22+08:00	5867	13398	19265	1310	20575	36772	55.95%	15.96%	32	32
14	高雄市大樹區	2018-11-24T22:41:29+08:00	5529	12448	17977	1252	19229	34311	56.04%	16.11%	31	32
14	高雄市大樹區	2018-11-24T22:16:03+08:00	5461	12160	17621	1232	18853	33591	56.13%	16.26%	30	32
14	高雄市大樹區	2018-11-24T22:33:32+08:00	5529	12448	17977	1252	19229	34311	56.04%	16.11%	31	32
14	高雄市大樹區	2018-11-24T23:51:28+08:00	5867	13398	19265	1310	20575	36772	55.95%	15.96%	32	32
14	高雄市大樹區	2018-11-24T23:23:33+08:00	5529	12448	17977	1252	19229	34311	56.04%	16.11%	31	32
14	高雄市大樹區	2018-11-24T22:57:47+08:00	5529	12448	17977	1252	19229	34311	56.04%	16.11%	31	32
14	高雄市大樹區	2018-11-25T01:25:46+08:00	5867	13398	19265	1310	20575	36772	55.95%	15.96%	32	32
14	高雄市大樹區	2018-11-24T22:19:31+08:00	5461	12160	17621	1232	18853	33591	56.13%	16.26%	30	32
14	高雄市大樹區	2018-11-25T00:57:30+08:00	5867	13398	19265	1310	20575	36772	55.95%	15.96%	32	32
14	高雄市大樹區	2018-11-24T22:40:22+08:00	5529	12448	17977	1252	19229	34311	56.04%	16.11%	31	32
14	高雄市大樹區	2018-11-24T22:36:55+08:00	5529	12448	17977	1252	19229	34311	56.04%	16.11%	31	32
14	高雄市大樹區	2018-11-24T23:08:29+08:00	5529	12448	17977	1252	19229	34311	56.04%	16.11%	31	32
14	高雄市大樹區	2018-11-24T23:15:57+08:00	5529	12448	17977	1252	19229	34311	56.04%	16.11%	31	32
14	高雄市大樹區	2018-11-25T03:32:28+08:00	5867	13398	19265	1310	20575	36772	55.95%	15.96%	32	32
14	高雄市大樹區	2018-11-25T03:49:45+08:00	5867	13398	19265	1310	20575	36772	55.95%	15.96%	32	32
14	高雄市大樹區	2018-11-25T06:23:54+08:00	5867	13398	19265	1310	20575	36772	55.95%	15.96%	32	32
14	高雄市大樹區	2018-11-24T22:26:31+08:00	5529	12448	17977	1252	19229	34311	56.04%	16.11%	31	32
14	高雄市大樹區	2018-11-24T22:50:41+08:00	5529	12448	17977	1252	19229	34311	56.04%	16.11%	31	32
14	高雄市大樹區	2018-11-24T22:45:03+08:00	5529	12448	17977	1252	19229	34311	56.04%	16.11%	31	32
14	南投縣水里鄉	2018-11-24T23:16:00+08:00	2209	5887	8096	564	8660	15458	56.02%	14.29%	22	22
14	南投縣水里鄉	2018-11-24T22:16:07+08:00	2075	5520	7595	540	8135	14583	55.78%	14.23%	21	22
14	南投縣水里鄉	2018-11-24T22:23:09+08:00	2075	5520	7595	540	8135	14583	55.78%	14.23%	21	22
14	南投縣水里鄉	2018-11-25T03:32:31+08:00	2209	5887	8096	564	8660	15458	56.02%	14.29%	22	22
14	南投縣水里鄉	2018-11-25T00:23:01+08:00	2209	5887	8096	564	8660	15458	56.02%	14.29%	22	22
14	南投縣水里鄉	2018-11-25T03:38:52+08:00	2209	5887	8096	564	8660	15458	56.02%	14.29%	22	22
14	南投縣水里鄉	2018-11-25T00:00:05+08:00	2209	5887	8096	564	8660	15458	56.02%	14.29%	22	22
14	南投縣水里鄉	2018-11-24T22:36:57+08:00	2075	5520	7595	540	8135	14583	55.78%	14.23%	21	22
14	南投縣水里鄉	2018-11-24T22:57:50+08:00	2209	5887	8096	564	8660	15458	56.02%	14.29%	22	22
14	南投縣水里鄉	2018-11-25T00:57:33+08:00	2209	5887	8096	564	8660	15458	56.02%	14.29%	22	22
14	南投縣水里鄉	2018-11-24T23:27:15+08:00	2209	5887	8096	564	8660	15458	56.02%	14.29%	22	22
14	南投縣水里鄉	2018-11-24T22:19:34+08:00	2075	5520	7595	540	8135	14583	55.78%	14.23%	21	22
14	南投縣水里鄉	2018-11-24T22:50:44+08:00	2209	5887	8096	564	8660	15458	56.02%	14.29%	22	22
14	南投縣水里鄉	2018-11-24T23:12:12+08:00	2209	5887	8096	564	8660	15458	56.02%	14.29%	22	22
14	南投縣水里鄉	2018-11-25T06:13:49+08:00	2209	5887	8096	564	8660	15458	56.02%	14.29%	22	22
14	南投縣水里鄉	2018-11-25T01:12:40+08:00	2209	5887	8096	564	8660	15458	56.02%	14.29%	22	22
14	南投縣水里鄉	2018-11-24T22:26:34+08:00	2075	5520	7595	540	8135	14583	55.78%	14.23%	21	22
14	南投縣水里鄉	2018-11-25T06:23:57+08:00	2209	5887	8096	564	8660	15458	56.02%	14.29%	22	22
14	南投縣水里鄉	2018-11-24T23:39:12+08:00	2209	5887	8096	564	8660	15458	56.02%	14.29%	22	22
14	南投縣水里鄉	2018-11-25T03:49:48+08:00	2209	5887	8096	564	8660	15458	56.02%	14.29%	22	22
14	南投縣水里鄉	2018-11-24T23:01:28+08:00	2209	5887	8096	564	8660	15458	56.02%	14.29%	22	22
14	南投縣水里鄉	2018-11-24T23:47:25+08:00	2209	5887	8096	564	8660	15458	56.02%	14.29%	22	22
14	南投縣水里鄉	2018-11-25T06:29:13+08:00	2209	5887	8096	564	8660	15458	56.02%	14.29%	22	22
14	南投縣水里鄉	2018-11-24T23:35:07+08:00	2209	5887	8096	564	8660	15458	56.02%	14.29%	22	22
14	南投縣水里鄉	2018-11-25T01:07:23+08:00	2209	5887	8096	564	8660	15458	56.02%	14.29%	22	22
14	南投縣水里鄉	2018-11-24T23:43:14+08:00	2209	5887	8096	564	8660	15458	56.02%	14.29%	22	22
14	南投縣水里鄉	2018-11-24T23:31:07+08:00	2209	5887	8096	564	8660	15458	56.02%	14.29%	22	22
14	南投縣水里鄉	2018-11-25T06:08:49+08:00	2209	5887	8096	564	8660	15458	56.02%	14.29%	22	22
14	南投縣水里鄉	2018-11-24T22:33:35+08:00	2075	5520	7595	540	8135	14583	55.78%	14.23%	21	22
14	南投縣水里鄉	2018-11-25T00:14:06+08:00	2209	5887	8096	564	8660	15458	56.02%	14.29%	22	22
14	南投縣水里鄉	2018-11-25T04:02:46+08:00	2209	5887	8096	564	8660	15458	56.02%	14.29%	22	22
14	南投縣水里鄉	2018-11-24T23:23:35+08:00	2209	5887	8096	564	8660	15458	56.02%	14.29%	22	22
14	南投縣水里鄉	2018-11-24T22:13:23+08:00	2075	5520	7595	540	8135	14583	55.78%	14.23%	21	22
14	南投縣水里鄉	2018-11-25T01:17:48+08:00	2209	5887	8096	564	8660	15458	56.02%	14.29%	22	22
14	南投縣水里鄉	2018-11-24T23:55:44+08:00	2209	5887	8096	564	8660	15458	56.02%	14.29%	22	22
14	南投縣水里鄉	2018-11-24T23:08:32+08:00	2209	5887	8096	564	8660	15458	56.02%	14.29%	22	22
14	南投縣水里鄉	2018-11-24T23:19:47+08:00	2209	5887	8096	564	8660	15458	56.02%	14.29%	22	22
14	南投縣水里鄉	2018-11-25T03:44:19+08:00	2209	5887	8096	564	8660	15458	56.02%	14.29%	22	22
14	南投縣水里鄉	2018-11-25T01:02:27+08:00	2209	5887	8096	564	8660	15458	56.02%	14.29%	22	22
14	南投縣水里鄉	2018-11-24T22:40:25+08:00	2075	5520	7595	540	8135	14583	55.78%	14.23%	21	22
14	南投縣水里鄉	2018-11-24T22:30:03+08:00	2075	5520	7595	540	8135	14583	55.78%	14.23%	21	22
14	南投縣水里鄉	2018-11-25T01:25:49+08:00	2209	5887	8096	564	8660	15458	56.02%	14.29%	22	22
14	南投縣水里鄉	2018-11-25T06:18:54+08:00	2209	5887	8096	564	8660	15458	56.02%	14.29%	22	22
14	南投縣水里鄉	2018-11-24T23:51:32+08:00	2209	5887	8096	564	8660	15458	56.02%	14.29%	22	22
14	南投縣水里鄉	2018-11-25T03:56:08+08:00	2209	5887	8096	564	8660	15458	56.02%	14.29%	22	22
14	南投縣水里鄉	2018-11-25T00:05:02+08:00	2209	5887	8096	564	8660	15458	56.02%	14.29%	22	22
14	南投縣水里鄉	2018-11-24T22:41:32+08:00	2075	5520	7595	540	8135	14583	55.78%	14.23%	21	22
14	南投縣水里鄉	2018-11-25T00:09:31+08:00	2209	5887	8096	564	8660	15458	56.02%	14.29%	22	22
14	南投縣水里鄉	2018-11-24T22:54:23+08:00	2209	5887	8096	564	8660	15458	56.02%	14.29%	22	22
14	南投縣水里鄉	2018-11-24T22:45:05+08:00	2075	5520	7595	540	8135	14583	55.78%	14.23%	21	22
14	南投縣水里鄉	2018-11-24T23:05:02+08:00	2209	5887	8096	564	8660	15458	56.02%	14.29%	22	22
14	南投縣水里鄉	2018-11-25T00:18:27+08:00	2209	5887	8096	564	8660	15458	56.02%	14.29%	22	22
14	南投縣南投市	2018-11-25T01:12:39+08:00	13599	35060	48659	2561	51220	84328	60.74%	16.13%	84	84
14	南投縣南投市	2018-11-24T22:16:06+08:00	7813	20304	28117	1511	29628	48530	61.05%	16.1%	53	84
14	南投縣南投市	2018-11-25T04:02:45+08:00	13599	35060	48659	2561	51220	84328	60.74%	16.13%	84	84
14	南投縣南投市	2018-11-24T22:23:09+08:00	8374	21554	29928	1606	31534	51701	60.99%	16.2%	56	84
14	南投縣南投市	2018-11-25T03:32:31+08:00	13599	35060	48659	2561	51220	84328	60.74%	16.13%	84	84
14	南投縣南投市	2018-11-25T00:00:04+08:00	13435	34581	48016	2536	50552	83250	60.72%	16.14%	83	84
14	南投縣南投市	2018-11-25T03:38:52+08:00	13599	35060	48659	2561	51220	84328	60.74%	16.13%	84	84
14	南投縣南投市	2018-11-25T00:23:00+08:00	13599	35060	48659	2561	51220	84328	60.74%	16.13%	84	84
14	南投縣南投市	2018-11-24T22:36:57+08:00	9200	23595	32795	1818	34613	56738	61%	16.21%	61	84
14	南投縣南投市	2018-11-25T00:57:33+08:00	13599	35060	48659	2561	51220	84328	60.74%	16.13%	84	84
14	南投縣南投市	2018-11-24T23:51:31+08:00	13435	34581	48016	2536	50552	83250	60.72%	16.14%	83	84
14	南投縣南投市	2018-11-24T23:27:15+08:00	12698	32681	45379	2399	47778	78766	60.66%	16.12%	79	84
14	南投縣南投市	2018-11-24T22:19:33+08:00	8161	21072	29233	1586	30819	50408	61.14%	16.19%	55	84
14	南投縣南投市	2018-11-24T22:50:44+08:00	9900	25502	35402	1930	37332	61242	60.96%	16.17%	65	84
14	南投縣南投市	2018-11-24T23:12:12+08:00	11295	29101	40396	2151	42547	70191	60.62%	16.09%	72	84
14	南投縣南投市	2018-11-25T06:13:49+08:00	13599	35060	48659	2561	51220	84328	60.74%	16.13%	84	84
14	南投縣南投市	2018-11-24T22:26:33+08:00	8374	21554	29928	1606	31534	51701	60.99%	16.2%	56	84
14	南投縣南投市	2018-11-24T22:41:31+08:00	9546	24529	34075	1878	35953	58835	61.11%	16.23%	63	84
14	南投縣南投市	2018-11-25T00:05:01+08:00	13599	35060	48659	2561	51220	84328	60.74%	16.13%	84	84
14	南投縣南投市	2018-11-25T06:23:57+08:00	13599	35060	48659	2561	51220	84328	60.74%	16.13%	84	84
14	南投縣南投市	2018-11-25T03:49:48+08:00	13599	35060	48659	2561	51220	84328	60.74%	16.13%	84	84
14	南投縣南投市	2018-11-24T23:05:01+08:00	10727	27608	38335	2076	40411	66518	60.75%	16.13%	69	84
14	南投縣南投市	2018-11-24T23:47:25+08:00	13435	34581	48016	2536	50552	83250	60.72%	16.14%	83	84
14	南投縣南投市	2018-11-25T06:29:13+08:00	13599	35060	48659	2561	51220	84328	60.74%	16.13%	84	84
14	南投縣南投市	2018-11-24T23:35:07+08:00	13068	33712	46780	2481	49261	81156	60.7%	16.1%	81	84
14	南投縣南投市	2018-11-24T22:33:34+08:00	8987	23073	32060	1786	33846	55616	60.86%	16.16%	60	84
14	南投縣南投市	2018-11-25T01:07:23+08:00	13599	35060	48659	2561	51220	84328	60.74%	16.13%	84	84
14	南投縣南投市	2018-11-24T23:43:14+08:00	13435	34581	48016	2536	50552	83250	60.72%	16.14%	83	84
14	南投縣南投市	2018-11-24T23:01:27+08:00	10501	27046	37547	2046	39593	65066	60.85%	16.14%	68	84
14	南投縣南投市	2018-11-24T23:31:07+08:00	13068	33712	46780	2481	49261	81156	60.7%	16.1%	81	84
14	南投縣南投市	2018-11-25T06:08:49+08:00	13599	35060	48659	2561	51220	84328	60.74%	16.13%	84	84
14	南投縣南投市	2018-11-25T00:14:06+08:00	13599	35060	48659	2561	51220	84328	60.74%	16.13%	84	84
14	南投縣南投市	2018-11-24T23:23:35+08:00	12131	31217	43348	2304	45652	75189	60.72%	16.13%	76	84
14	南投縣南投市	2018-11-24T23:19:46+08:00	11919	30671	42590	2259	44849	73901	60.69%	16.13%	75	84
14	南投縣南投市	2018-11-24T22:13:23+08:00	7411	19304	26715	1445	28160	46180	60.98%	16.05%	51	84
14	南投縣南投市	2018-11-25T01:17:48+08:00	13599	35060	48659	2561	51220	84328	60.74%	16.13%	84	84
14	南投縣南投市	2018-11-24T23:55:43+08:00	13435	34581	48016	2536	50552	83250	60.72%	16.14%	83	84
14	南投縣南投市	2018-11-24T23:08:32+08:00	10970	28208	39178	2100	41278	68002	60.7%	16.13%	70	84
14	南投縣南投市	2018-11-24T22:57:49+08:00	10501	27046	37547	2046	39593	65066	60.85%	16.14%	68	84
14	南投縣南投市	2018-11-25T03:44:19+08:00	13599	35060	48659	2561	51220	84328	60.74%	16.13%	84	84
14	南投縣南投市	2018-11-24T22:30:02+08:00	8548	22007	30555	1645	32200	52822	60.96%	16.18%	57	84
14	南投縣南投市	2018-11-25T01:02:27+08:00	13599	35060	48659	2561	51220	84328	60.74%	16.13%	84	84
14	南投縣南投市	2018-11-24T22:40:24+08:00	9546	24529	34075	1878	35953	58835	61.11%	16.23%	63	84
14	南投縣南投市	2018-11-25T01:25:49+08:00	13599	35060	48659	2561	51220	84328	60.74%	16.13%	84	84
14	南投縣南投市	2018-11-24T23:15:59+08:00	11919	30671	42590	2259	44849	73901	60.69%	16.13%	75	84
14	南投縣南投市	2018-11-25T06:18:54+08:00	13599	35060	48659	2561	51220	84328	60.74%	16.13%	84	84
14	南投縣南投市	2018-11-25T03:56:08+08:00	13599	35060	48659	2561	51220	84328	60.74%	16.13%	84	84
14	南投縣南投市	2018-11-24T22:45:05+08:00	9668	24925	34593	1910	36503	59808	61.03%	16.17%	64	84
14	南投縣南投市	2018-11-25T00:18:26+08:00	13599	35060	48659	2561	51220	84328	60.74%	16.13%	84	84
14	南投縣南投市	2018-11-24T23:39:11+08:00	13245	34119	47364	2508	49872	82180	60.69%	16.12%	82	84
14	南投縣南投市	2018-11-25T00:09:30+08:00	13599	35060	48659	2561	51220	84328	60.74%	16.13%	84	84
14	南投縣南投市	2018-11-24T22:54:22+08:00	10065	26021	36086	1982	38068	62463	60.94%	16.11%	66	84
14	嘉義縣溪口鄉	2018-11-25T03:56:10+08:00	1945	4013	5958	710	6668	13105	50.88%	14.84%	17	17
14	嘉義縣溪口鄉	2018-11-24T23:47:26+08:00	1426	3099	4525	540	5065	9977	50.77%	14.29%	14	17
14	嘉義縣溪口鄉	2018-11-24T23:16:01+08:00	1319	2816	4135	500	4635	8974	51.65%	14.7%	13	17
14	嘉義縣溪口鄉	2018-11-24T22:16:08+08:00	924	2018	2942	355	3297	6441	51.19%	14.35%	10	17
14	嘉義縣溪口鄉	2018-11-25T01:25:50+08:00	1945	4013	5958	710	6668	13105	50.88%	14.84%	17	17
14	嘉義縣溪口鄉	2018-11-25T03:38:53+08:00	1945	4013	5958	710	6668	13105	50.88%	14.84%	17	17
14	嘉義縣溪口鄉	2018-11-25T00:23:01+08:00	1426	3099	4525	540	5065	9977	50.77%	14.29%	14	17
14	嘉義縣溪口鄉	2018-11-24T23:23:36+08:00	1319	2816	4135	500	4635	8974	51.65%	14.7%	13	17
14	嘉義縣溪口鄉	2018-11-24T22:19:35+08:00	924	2018	2942	355	3297	6441	51.19%	14.35%	10	17
14	嘉義縣溪口鄉	2018-11-25T00:57:34+08:00	1945	4013	5958	710	6668	13105	50.88%	14.84%	17	17
14	嘉義縣溪口鄉	2018-11-24T22:40:26+08:00	1014	2209	3223	402	3625	7149	50.71%	14.18%	11	17
14	嘉義縣溪口鄉	2018-11-24T22:36:58+08:00	1014	2209	3223	402	3625	7149	50.71%	14.18%	11	17
14	嘉義縣溪口鄉	2018-11-24T22:57:51+08:00	1141	2469	3610	448	4058	7935	51.14%	14.38%	12	17
14	嘉義縣溪口鄉	2018-11-25T00:09:32+08:00	1426	3099	4525	540	5065	9977	50.77%	14.29%	14	17
14	嘉義縣溪口鄉	2018-11-24T22:45:06+08:00	1141	2469	3610	448	4058	7935	51.14%	14.38%	12	17
14	嘉義縣溪口鄉	2018-11-25T06:08:50+08:00	1945	4013	5958	710	6668	13105	50.88%	14.84%	17	17
14	嘉義縣溪口鄉	2018-11-25T06:23:58+08:00	1945	4013	5958	710	6668	13105	50.88%	14.84%	17	17
14	嘉義縣溪口鄉	2018-11-24T23:39:13+08:00	1426	3099	4525	540	5065	9977	50.77%	14.29%	14	17
14	嘉義縣溪口鄉	2018-11-25T03:49:49+08:00	1945	4013	5958	710	6668	13105	50.88%	14.84%	17	17
14	嘉義縣溪口鄉	2018-11-25T01:12:41+08:00	1945	4013	5958	710	6668	13105	50.88%	14.84%	17	17
14	嘉義縣溪口鄉	2018-11-24T22:26:35+08:00	1014	2209	3223	402	3625	7149	50.71%	14.18%	11	17
14	嘉義縣溪口鄉	2018-11-24T22:50:45+08:00	1141	2469	3610	448	4058	7935	51.14%	14.38%	12	17
14	嘉義縣溪口鄉	2018-11-24T23:12:13+08:00	1319	2816	4135	500	4635	8974	51.65%	14.7%	13	17
14	嘉義縣溪口鄉	2018-11-25T04:02:50+08:00	1945	4013	5958	710	6668	13105	50.88%	14.84%	17	17
14	嘉義縣溪口鄉	2018-11-24T23:43:15+08:00	1426	3099	4525	540	5065	9977	50.77%	14.29%	14	17
14	嘉義縣溪口鄉	2018-11-25T06:29:14+08:00	1945	4013	5958	710	6668	13105	50.88%	14.84%	17	17
14	嘉義縣溪口鄉	2018-11-25T00:14:07+08:00	1426	3099	4525	540	5065	9977	50.77%	14.29%	14	17
14	嘉義縣溪口鄉	2018-11-24T23:01:29+08:00	1319	2816	4135	500	4635	8974	51.65%	14.7%	13	17
14	嘉義縣溪口鄉	2018-11-25T01:07:24+08:00	1945	4013	5958	710	6668	13105	50.88%	14.84%	17	17
14	嘉義縣溪口鄉	2018-11-24T23:31:09+08:00	1426	3099	4525	540	5065	9977	50.77%	14.29%	14	17
14	嘉義縣溪口鄉	2018-11-25T06:13:50+08:00	1945	4013	5958	710	6668	13105	50.88%	14.84%	17	17
14	嘉義縣溪口鄉	2018-11-24T23:35:08+08:00	1426	3099	4525	540	5065	9977	50.77%	14.29%	14	17
14	嘉義縣溪口鄉	2018-11-24T22:33:35+08:00	1014	2209	3223	402	3625	7149	50.71%	14.18%	11	17
14	嘉義縣溪口鄉	2018-11-24T23:08:33+08:00	1319	2816	4135	500	4635	8974	51.65%	14.7%	13	17
14	嘉義縣溪口鄉	2018-11-24T23:55:45+08:00	1426	3099	4525	540	5065	9977	50.77%	14.29%	14	17
14	嘉義縣溪口鄉	2018-11-25T03:32:32+08:00	1945	4013	5958	710	6668	13105	50.88%	14.84%	17	17
14	嘉義縣溪口鄉	2018-11-24T23:19:48+08:00	1319	2816	4135	500	4635	8974	51.65%	14.7%	13	17
14	嘉義縣溪口鄉	2018-11-25T03:44:20+08:00	1945	4013	5958	710	6668	13105	50.88%	14.84%	17	17
14	嘉義縣溪口鄉	2018-11-24T22:13:24+08:00	924	2018	2942	355	3297	6441	51.19%	14.35%	10	17
14	嘉義縣溪口鄉	2018-11-25T00:00:08+08:00	1426	3099	4525	540	5065	9977	50.77%	14.29%	14	17
14	嘉義縣溪口鄉	2018-11-25T01:17:49+08:00	1945	4013	5958	710	6668	13105	50.88%	14.84%	17	17
14	嘉義縣溪口鄉	2018-11-25T06:18:55+08:00	1945	4013	5958	710	6668	13105	50.88%	14.84%	17	17
14	嘉義縣溪口鄉	2018-11-25T01:02:28+08:00	1945	4013	5958	710	6668	13105	50.88%	14.84%	17	17
14	嘉義縣溪口鄉	2018-11-24T23:27:16+08:00	1319	2816	4135	500	4635	8974	51.65%	14.7%	13	17
14	嘉義縣溪口鄉	2018-11-24T22:30:04+08:00	1014	2209	3223	402	3625	7149	50.71%	14.18%	11	17
14	嘉義縣溪口鄉	2018-11-24T22:23:10+08:00	924	2018	2942	355	3297	6441	51.19%	14.35%	10	17
14	嘉義縣溪口鄉	2018-11-24T23:51:32+08:00	1426	3099	4525	540	5065	9977	50.77%	14.29%	14	17
14	嘉義縣溪口鄉	2018-11-24T22:54:24+08:00	1141	2469	3610	448	4058	7935	51.14%	14.38%	12	17
14	嘉義縣溪口鄉	2018-11-24T22:41:33+08:00	1014	2209	3223	402	3625	7149	50.71%	14.18%	11	17
14	嘉義縣溪口鄉	2018-11-25T00:05:03+08:00	1426	3099	4525	540	5065	9977	50.77%	14.29%	14	17
14	嘉義縣溪口鄉	2018-11-24T23:05:02+08:00	1319	2816	4135	500	4635	8974	51.65%	14.7%	13	17
14	嘉義縣溪口鄉	2018-11-25T00:18:27+08:00	1426	3099	4525	540	5065	9977	50.77%	14.29%	14	17
14	金門縣金城鎮	2018-11-24T22:33:39+08:00	2704	7777	10481	560	11041	31722	34.81%	8.52%	18	21
14	金門縣金城鎮	2018-11-25T03:49:52+08:00	3216	9370	12586	653	13239	37815	35.01%	8.5%	21	21
14	金門縣金城鎮	2018-11-24T23:43:18+08:00	3216	9370	12586	653	13239	37815	35.01%	8.5%	21	21
14	金門縣金城鎮	2018-11-24T23:47:29+08:00	3216	9370	12586	653	13239	37815	35.01%	8.5%	21	21
14	金門縣金城鎮	2018-11-25T06:29:18+08:00	3216	9370	12586	653	13239	37815	35.01%	8.5%	21	21
14	金門縣金城鎮	2018-11-25T01:07:27+08:00	3216	9370	12586	653	13239	37815	35.01%	8.5%	21	21
14	金門縣金城鎮	2018-11-25T06:13:53+08:00	3216	9370	12586	653	13239	37815	35.01%	8.5%	21	21
14	金門縣金城鎮	2018-11-25T00:18:31+08:00	3216	9370	12586	653	13239	37815	35.01%	8.5%	21	21
14	金門縣金城鎮	2018-11-25T03:44:24+08:00	3216	9370	12586	653	13239	37815	35.01%	8.5%	21	21
14	金門縣金城鎮	2018-11-24T23:08:37+08:00	3056	8779	11835	624	12459	35914	34.69%	8.51%	20	21
14	金門縣金城鎮	2018-11-25T03:32:36+08:00	3216	9370	12586	653	13239	37815	35.01%	8.5%	21	21
14	金門縣金城鎮	2018-11-24T23:55:48+08:00	3216	9370	12586	653	13239	37815	35.01%	8.5%	21	21
14	金門縣金城鎮	2018-11-24T22:13:28+08:00	2704	7777	10481	560	11041	31722	34.81%	8.52%	18	21
14	金門縣金城鎮	2018-11-24T23:23:39+08:00	3056	8779	11835	624	12459	35914	34.69%	8.51%	20	21
14	金門縣金城鎮	2018-11-25T06:18:58+08:00	3216	9370	12586	653	13239	37815	35.01%	8.5%	21	21
14	金門縣金城鎮	2018-11-24T22:40:29+08:00	2704	7777	10481	560	11041	31722	34.81%	8.52%	18	21
14	金門縣金城鎮	2018-11-24T23:51:36+08:00	3216	9370	12586	653	13239	37815	35.01%	8.5%	21	21
14	金門縣金城鎮	2018-11-24T22:23:14+08:00	2704	7777	10481	560	11041	31722	34.81%	8.52%	18	21
14	金門縣金城鎮	2018-11-25T00:09:35+08:00	3216	9370	12586	653	13239	37815	35.01%	8.5%	21	21
14	金門縣金城鎮	2018-11-24T22:54:27+08:00	2850	8141	10991	586	11577	33397	34.66%	8.53%	19	21
14	金門縣金城鎮	2018-11-25T00:14:11+08:00	3216	9370	12586	653	13239	37815	35.01%	8.5%	21	21
14	金門縣金城鎮	2018-11-25T00:05:06+08:00	3216	9370	12586	653	13239	37815	35.01%	8.5%	21	21
14	金門縣金城鎮	2018-11-24T22:41:36+08:00	2704	7777	10481	560	11041	31722	34.81%	8.52%	18	21
14	金門縣金城鎮	2018-11-24T22:16:12+08:00	2704	7777	10481	560	11041	31722	34.81%	8.52%	18	21
14	金門縣金城鎮	2018-11-24T22:45:10+08:00	2850	8141	10991	586	11577	33397	34.66%	8.53%	19	21
14	金門縣金城鎮	2018-11-25T03:56:14+08:00	3216	9370	12586	653	13239	37815	35.01%	8.5%	21	21
14	金門縣金城鎮	2018-11-24T22:37:02+08:00	2704	7777	10481	560	11041	31722	34.81%	8.52%	18	21
14	金門縣金城鎮	2018-11-24T23:16:04+08:00	3056	8779	11835	624	12459	35914	34.69%	8.51%	20	21
14	金門縣金城鎮	2018-11-25T00:23:05+08:00	3216	9370	12586	653	13239	37815	35.01%	8.5%	21	21
14	金門縣金城鎮	2018-11-25T01:25:54+08:00	3216	9370	12586	653	13239	37815	35.01%	8.5%	21	21
14	金門縣金城鎮	2018-11-25T01:02:32+08:00	3216	9370	12586	653	13239	37815	35.01%	8.5%	21	21
14	金門縣金城鎮	2018-11-24T22:30:10+08:00	2704	7777	10481	560	11041	31722	34.81%	8.52%	18	21
14	金門縣金城鎮	2018-11-25T06:24:01+08:00	3216	9370	12586	653	13239	37815	35.01%	8.5%	21	21
14	金門縣金城鎮	2018-11-25T03:38:56+08:00	3216	9370	12586	653	13239	37815	35.01%	8.5%	21	21
14	金門縣金城鎮	2018-11-24T23:27:19+08:00	3056	8779	11835	624	12459	35914	34.69%	8.51%	20	21
14	金門縣金城鎮	2018-11-24T22:19:38+08:00	2704	7777	10481	560	11041	31722	34.81%	8.52%	18	21
14	金門縣金城鎮	2018-11-24T23:19:53+08:00	3056	8779	11835	624	12459	35914	34.69%	8.51%	20	21
14	金門縣金城鎮	2018-11-25T01:17:54+08:00	3216	9370	12586	653	13239	37815	35.01%	8.5%	21	21
14	金門縣金城鎮	2018-11-25T00:00:12+08:00	3216	9370	12586	653	13239	37815	35.01%	8.5%	21	21
14	金門縣金城鎮	2018-11-24T22:57:55+08:00	2850	8141	10991	586	11577	33397	34.66%	8.53%	19	21
14	金門縣金城鎮	2018-11-25T00:57:38+08:00	3216	9370	12586	653	13239	37815	35.01%	8.5%	21	21
14	金門縣金城鎮	2018-11-24T23:35:12+08:00	3216	9370	12586	653	13239	37815	35.01%	8.5%	21	21
14	金門縣金城鎮	2018-11-25T06:08:54+08:00	3216	9370	12586	653	13239	37815	35.01%	8.5%	21	21
14	金門縣金城鎮	2018-11-24T23:39:17+08:00	3216	9370	12586	653	13239	37815	35.01%	8.5%	21	21
14	金門縣金城鎮	2018-11-24T22:50:49+08:00	2850	8141	10991	586	11577	33397	34.66%	8.53%	19	21
14	金門縣金城鎮	2018-11-25T04:02:53+08:00	3216	9370	12586	653	13239	37815	35.01%	8.5%	21	21
14	金門縣金城鎮	2018-11-24T23:05:05+08:00	3056	8779	11835	624	12459	35914	34.69%	8.51%	20	21
14	金門縣金城鎮	2018-11-24T23:31:12+08:00	3216	9370	12586	653	13239	37815	35.01%	8.5%	21	21
14	金門縣金城鎮	2018-11-24T23:01:32+08:00	3056	8779	11835	624	12459	35914	34.69%	8.51%	20	21
14	金門縣金城鎮	2018-11-25T01:12:45+08:00	3216	9370	12586	653	13239	37815	35.01%	8.5%	21	21
14	金門縣金城鎮	2018-11-24T22:26:38+08:00	2704	7777	10481	560	11041	31722	34.81%	8.52%	18	21
14	金門縣金城鎮	2018-11-24T23:12:17+08:00	3056	8779	11835	624	12459	35914	34.69%	8.51%	20	21
14	嘉義縣番路鄉	2018-11-25T03:56:10+08:00	1364	3923	5287	394	5681	10156	55.94%	13.43%	15	15
14	嘉義縣番路鄉	2018-11-24T23:47:26+08:00	1364	3923	5287	394	5681	10156	55.94%	13.43%	15	15
14	嘉義縣番路鄉	2018-11-24T23:16:01+08:00	1364	3923	5287	394	5681	10156	55.94%	13.43%	15	15
14	嘉義縣番路鄉	2018-11-24T22:16:08+08:00	1082	3266	4348	328	4676	8365	55.9%	12.93%	14	15
14	嘉義縣番路鄉	2018-11-24T22:33:36+08:00	1082	3266	4348	328	4676	8365	55.9%	12.93%	14	15
14	嘉義縣番路鄉	2018-11-25T03:38:53+08:00	1364	3923	5287	394	5681	10156	55.94%	13.43%	15	15
14	嘉義縣番路鄉	2018-11-24T23:23:36+08:00	1364	3923	5287	394	5681	10156	55.94%	13.43%	15	15
14	嘉義縣番路鄉	2018-11-25T01:25:51+08:00	1364	3923	5287	394	5681	10156	55.94%	13.43%	15	15
14	嘉義縣番路鄉	2018-11-24T22:19:35+08:00	1082	3266	4348	328	4676	8365	55.9%	12.93%	14	15
14	嘉義縣番路鄉	2018-11-25T01:17:50+08:00	1364	3923	5287	394	5681	10156	55.94%	13.43%	15	15
14	嘉義縣番路鄉	2018-11-24T22:40:26+08:00	1082	3266	4348	328	4676	8365	55.9%	12.93%	14	15
14	嘉義縣番路鄉	2018-11-25T00:57:35+08:00	1364	3923	5287	394	5681	10156	55.94%	13.43%	15	15
14	嘉義縣番路鄉	2018-11-24T22:36:58+08:00	1082	3266	4348	328	4676	8365	55.9%	12.93%	14	15
14	嘉義縣番路鄉	2018-11-24T22:57:51+08:00	1364	3923	5287	394	5681	10156	55.94%	13.43%	15	15
14	嘉義縣番路鄉	2018-11-25T00:09:32+08:00	1364	3923	5287	394	5681	10156	55.94%	13.43%	15	15
14	嘉義縣番路鄉	2018-11-25T06:23:58+08:00	1364	3923	5287	394	5681	10156	55.94%	13.43%	15	15
14	嘉義縣番路鄉	2018-11-24T23:39:13+08:00	1364	3923	5287	394	5681	10156	55.94%	13.43%	15	15
14	嘉義縣番路鄉	2018-11-25T03:49:49+08:00	1364	3923	5287	394	5681	10156	55.94%	13.43%	15	15
14	嘉義縣番路鄉	2018-11-25T01:12:41+08:00	1364	3923	5287	394	5681	10156	55.94%	13.43%	15	15
14	嘉義縣番路鄉	2018-11-24T22:26:35+08:00	1082	3266	4348	328	4676	8365	55.9%	12.93%	14	15
14	嘉義縣番路鄉	2018-11-24T23:12:14+08:00	1364	3923	5287	394	5681	10156	55.94%	13.43%	15	15
14	嘉義縣番路鄉	2018-11-24T22:45:07+08:00	1082	3266	4348	328	4676	8365	55.9%	12.93%	14	15
14	嘉義縣番路鄉	2018-11-25T06:08:51+08:00	1364	3923	5287	394	5681	10156	55.94%	13.43%	15	15
14	嘉義縣番路鄉	2018-11-25T04:02:50+08:00	1364	3923	5287	394	5681	10156	55.94%	13.43%	15	15
14	嘉義縣番路鄉	2018-11-24T23:43:15+08:00	1364	3923	5287	394	5681	10156	55.94%	13.43%	15	15
14	嘉義縣番路鄉	2018-11-25T00:14:07+08:00	1364	3923	5287	394	5681	10156	55.94%	13.43%	15	15
14	嘉義縣番路鄉	2018-11-24T23:35:09+08:00	1364	3923	5287	394	5681	10156	55.94%	13.43%	15	15
14	嘉義縣番路鄉	2018-11-24T23:01:29+08:00	1364	3923	5287	394	5681	10156	55.94%	13.43%	15	15
14	嘉義縣番路鄉	2018-11-25T01:07:24+08:00	1364	3923	5287	394	5681	10156	55.94%	13.43%	15	15
14	嘉義縣番路鄉	2018-11-24T23:31:09+08:00	1364	3923	5287	394	5681	10156	55.94%	13.43%	15	15
14	嘉義縣番路鄉	2018-11-25T06:13:50+08:00	1364	3923	5287	394	5681	10156	55.94%	13.43%	15	15
14	嘉義縣番路鄉	2018-11-25T06:29:15+08:00	1364	3923	5287	394	5681	10156	55.94%	13.43%	15	15
14	嘉義縣番路鄉	2018-11-24T23:55:45+08:00	1364	3923	5287	394	5681	10156	55.94%	13.43%	15	15
14	嘉義縣番路鄉	2018-11-24T23:08:34+08:00	1364	3923	5287	394	5681	10156	55.94%	13.43%	15	15
14	嘉義縣番路鄉	2018-11-25T00:00:09+08:00	1364	3923	5287	394	5681	10156	55.94%	13.43%	15	15
14	嘉義縣番路鄉	2018-11-25T00:23:02+08:00	1364	3923	5287	394	5681	10156	55.94%	13.43%	15	15
14	嘉義縣番路鄉	2018-11-24T23:19:48+08:00	1364	3923	5287	394	5681	10156	55.94%	13.43%	15	15
14	嘉義縣番路鄉	2018-11-25T03:32:33+08:00	1364	3923	5287	394	5681	10156	55.94%	13.43%	15	15
14	嘉義縣番路鄉	2018-11-25T03:44:21+08:00	1364	3923	5287	394	5681	10156	55.94%	13.43%	15	15
14	嘉義縣番路鄉	2018-11-24T22:13:25+08:00	1082	3266	4348	328	4676	8365	55.9%	12.93%	14	15
14	嘉義縣番路鄉	2018-11-24T22:23:11+08:00	1082	3266	4348	328	4676	8365	55.9%	12.93%	14	15
14	嘉義縣番路鄉	2018-11-24T23:27:17+08:00	1364	3923	5287	394	5681	10156	55.94%	13.43%	15	15
14	嘉義縣番路鄉	2018-11-24T23:51:33+08:00	1364	3923	5287	394	5681	10156	55.94%	13.43%	15	15
14	嘉義縣番路鄉	2018-11-25T06:18:55+08:00	1364	3923	5287	394	5681	10156	55.94%	13.43%	15	15
14	嘉義縣番路鄉	2018-11-25T01:02:28+08:00	1364	3923	5287	394	5681	10156	55.94%	13.43%	15	15
14	嘉義縣番路鄉	2018-11-24T22:30:04+08:00	1082	3266	4348	328	4676	8365	55.9%	12.93%	14	15
14	嘉義縣番路鄉	2018-11-24T23:05:03+08:00	1364	3923	5287	394	5681	10156	55.94%	13.43%	15	15
14	嘉義縣番路鄉	2018-11-24T22:54:24+08:00	1082	3266	4348	328	4676	8365	55.9%	12.93%	14	15
14	嘉義縣番路鄉	2018-11-25T00:18:28+08:00	1364	3923	5287	394	5681	10156	55.94%	13.43%	15	15
14	嘉義縣番路鄉	2018-11-24T22:41:33+08:00	1082	3266	4348	328	4676	8365	55.9%	12.93%	14	15
14	嘉義縣番路鄉	2018-11-25T00:05:03+08:00	1364	3923	5287	394	5681	10156	55.94%	13.43%	15	15
14	嘉義縣番路鄉	2018-11-24T22:50:46+08:00	1082	3266	4348	328	4676	8365	55.9%	12.93%	14	15
14	高雄市阿蓮區	2018-11-25T04:02:43+08:00	3946	8606	12552	756	13308	24534	54.24%	16.08%	21	21
14	高雄市阿蓮區	2018-11-25T00:14:03+08:00	3946	8606	12552	756	13308	24534	54.24%	16.08%	21	21
14	高雄市阿蓮區	2018-11-24T23:01:25+08:00	3946	8606	12552	756	13308	24534	54.24%	16.08%	21	21
14	高雄市阿蓮區	2018-11-24T23:12:09+08:00	3946	8606	12552	756	13308	24534	54.24%	16.08%	21	21
14	高雄市阿蓮區	2018-11-24T23:39:08+08:00	3946	8606	12552	756	13308	24534	54.24%	16.08%	21	21
14	高雄市阿蓮區	2018-11-25T00:09:27+08:00	3946	8606	12552	756	13308	24534	54.24%	16.08%	21	21
14	高雄市阿蓮區	2018-11-25T01:12:36+08:00	3946	8606	12552	756	13308	24534	54.24%	16.08%	21	21
14	高雄市阿蓮區	2018-11-24T23:35:05+08:00	3946	8606	12552	756	13308	24534	54.24%	16.08%	21	21
14	高雄市阿蓮區	2018-11-25T06:29:11+08:00	3946	8606	12552	756	13308	24534	54.24%	16.08%	21	21
14	高雄市阿蓮區	2018-11-25T01:07:20+08:00	3946	8606	12552	756	13308	24534	54.24%	16.08%	21	21
14	高雄市阿蓮區	2018-11-24T23:31:04+08:00	3946	8606	12552	756	13308	24534	54.24%	16.08%	21	21
14	高雄市阿蓮區	2018-11-25T01:17:45+08:00	3946	8606	12552	756	13308	24534	54.24%	16.08%	21	21
14	高雄市阿蓮區	2018-11-24T22:13:20+08:00	3946	8606	12552	756	13308	24534	54.24%	16.08%	21	21
14	高雄市阿蓮區	2018-11-24T23:55:41+08:00	3946	8606	12552	756	13308	24534	54.24%	16.08%	21	21
14	高雄市阿蓮區	2018-11-24T22:23:06+08:00	3946	8606	12552	756	13308	24534	54.24%	16.08%	21	21
14	高雄市阿蓮區	2018-11-24T23:19:43+08:00	3946	8606	12552	756	13308	24534	54.24%	16.08%	21	21
14	高雄市阿蓮區	2018-11-24T23:04:58+08:00	3946	8606	12552	756	13308	24534	54.24%	16.08%	21	21
14	高雄市阿蓮區	2018-11-25T00:00:02+08:00	3946	8606	12552	756	13308	24534	54.24%	16.08%	21	21
14	高雄市阿蓮區	2018-11-25T00:04:59+08:00	3946	8606	12552	756	13308	24534	54.24%	16.08%	21	21
14	高雄市阿蓮區	2018-11-24T23:27:13+08:00	3946	8606	12552	756	13308	24534	54.24%	16.08%	21	21
14	高雄市阿蓮區	2018-11-25T03:38:49+08:00	3946	8606	12552	756	13308	24534	54.24%	16.08%	21	21
14	高雄市阿蓮區	2018-11-24T22:30:00+08:00	3946	8606	12552	756	13308	24534	54.24%	16.08%	21	21
14	高雄市阿蓮區	2018-11-25T01:02:25+08:00	3946	8606	12552	756	13308	24534	54.24%	16.08%	21	21
14	高雄市阿蓮區	2018-11-25T06:13:47+08:00	3946	8606	12552	756	13308	24534	54.24%	16.08%	21	21
14	高雄市阿蓮區	2018-11-24T22:54:20+08:00	3946	8606	12552	756	13308	24534	54.24%	16.08%	21	21
14	高雄市阿蓮區	2018-11-25T00:22:58+08:00	3946	8606	12552	756	13308	24534	54.24%	16.08%	21	21
14	高雄市阿蓮區	2018-11-25T03:56:05+08:00	3946	8606	12552	756	13308	24534	54.24%	16.08%	21	21
14	高雄市阿蓮區	2018-11-24T22:26:32+08:00	3946	8606	12552	756	13308	24534	54.24%	16.08%	21	21
14	高雄市阿蓮區	2018-11-25T00:18:24+08:00	3946	8606	12552	756	13308	24534	54.24%	16.08%	21	21
14	高雄市阿蓮區	2018-11-24T22:41:30+08:00	3946	8606	12552	756	13308	24534	54.24%	16.08%	21	21
14	高雄市阿蓮區	2018-11-25T03:49:46+08:00	3946	8606	12552	756	13308	24534	54.24%	16.08%	21	21
14	高雄市阿蓮區	2018-11-25T06:08:46+08:00	3946	8606	12552	756	13308	24534	54.24%	16.08%	21	21
14	高雄市阿蓮區	2018-11-24T23:43:12+08:00	3946	8606	12552	756	13308	24534	54.24%	16.08%	21	21
14	高雄市阿蓮區	2018-11-24T23:47:22+08:00	3946	8606	12552	756	13308	24534	54.24%	16.08%	21	21
14	高雄市阿蓮區	2018-11-24T22:16:04+08:00	3946	8606	12552	756	13308	24534	54.24%	16.08%	21	21
14	高雄市阿蓮區	2018-11-24T22:33:32+08:00	3946	8606	12552	756	13308	24534	54.24%	16.08%	21	21
14	高雄市阿蓮區	2018-11-25T03:44:16+08:00	3946	8606	12552	756	13308	24534	54.24%	16.08%	21	21
14	高雄市阿蓮區	2018-11-24T23:23:33+08:00	3946	8606	12552	756	13308	24534	54.24%	16.08%	21	21
14	高雄市阿蓮區	2018-11-24T23:51:29+08:00	3946	8606	12552	756	13308	24534	54.24%	16.08%	21	21
14	高雄市阿蓮區	2018-11-24T22:57:47+08:00	3946	8606	12552	756	13308	24534	54.24%	16.08%	21	21
14	高雄市阿蓮區	2018-11-24T22:19:31+08:00	3946	8606	12552	756	13308	24534	54.24%	16.08%	21	21
14	高雄市阿蓮區	2018-11-24T22:40:23+08:00	3946	8606	12552	756	13308	24534	54.24%	16.08%	21	21
14	高雄市阿蓮區	2018-11-25T03:32:29+08:00	3946	8606	12552	756	13308	24534	54.24%	16.08%	21	21
14	高雄市阿蓮區	2018-11-25T06:18:52+08:00	3946	8606	12552	756	13308	24534	54.24%	16.08%	21	21
14	高雄市阿蓮區	2018-11-25T00:57:31+08:00	3946	8606	12552	756	13308	24534	54.24%	16.08%	21	21
14	高雄市阿蓮區	2018-11-25T01:25:47+08:00	3946	8606	12552	756	13308	24534	54.24%	16.08%	21	21
14	高雄市阿蓮區	2018-11-24T22:36:55+08:00	3946	8606	12552	756	13308	24534	54.24%	16.08%	21	21
14	高雄市阿蓮區	2018-11-24T23:08:29+08:00	3946	8606	12552	756	13308	24534	54.24%	16.08%	21	21
14	高雄市阿蓮區	2018-11-24T23:15:57+08:00	3946	8606	12552	756	13308	24534	54.24%	16.08%	21	21
14	高雄市阿蓮區	2018-11-25T06:23:54+08:00	3946	8606	12552	756	13308	24534	54.24%	16.08%	21	21
14	高雄市阿蓮區	2018-11-24T22:50:41+08:00	3946	8606	12552	756	13308	24534	54.24%	16.08%	21	21
14	高雄市阿蓮區	2018-11-24T22:45:03+08:00	3946	8606	12552	756	13308	24534	54.24%	16.08%	21	21
14	高雄市甲仙區	2018-11-25T04:02:43+08:00	681	1759	2440	245	2685	5417	49.57%	12.57%	7	7
14	高雄市甲仙區	2018-11-25T01:12:37+08:00	681	1759	2440	245	2685	5417	49.57%	12.57%	7	7
14	高雄市甲仙區	2018-11-25T00:14:04+08:00	681	1759	2440	245	2685	5417	49.57%	12.57%	7	7
14	高雄市甲仙區	2018-11-25T01:07:21+08:00	681	1759	2440	245	2685	5417	49.57%	12.57%	7	7
14	高雄市甲仙區	2018-11-24T23:35:05+08:00	681	1759	2440	245	2685	5417	49.57%	12.57%	7	7
14	高雄市甲仙區	2018-11-25T06:29:11+08:00	681	1759	2440	245	2685	5417	49.57%	12.57%	7	7
14	高雄市甲仙區	2018-11-24T23:39:09+08:00	681	1759	2440	245	2685	5417	49.57%	12.57%	7	7
14	高雄市甲仙區	2018-11-24T23:31:04+08:00	681	1759	2440	245	2685	5417	49.57%	12.57%	7	7
14	高雄市甲仙區	2018-11-25T00:09:28+08:00	681	1759	2440	245	2685	5417	49.57%	12.57%	7	7
14	高雄市甲仙區	2018-11-25T01:17:45+08:00	681	1759	2440	245	2685	5417	49.57%	12.57%	7	7
14	高雄市甲仙區	2018-11-24T22:23:07+08:00	481	1263	1744	147	1891	3836	49.3%	12.54%	6	7
14	高雄市甲仙區	2018-11-24T23:55:41+08:00	681	1759	2440	245	2685	5417	49.57%	12.57%	7	7
14	高雄市甲仙區	2018-11-24T23:08:30+08:00	681	1759	2440	245	2685	5417	49.57%	12.57%	7	7
14	高雄市甲仙區	2018-11-24T23:19:44+08:00	681	1759	2440	245	2685	5417	49.57%	12.57%	7	7
14	高雄市甲仙區	2018-11-24T22:13:21+08:00	481	1263	1744	147	1891	3836	49.3%	12.54%	6	7
14	高雄市甲仙區	2018-11-24T23:04:58+08:00	681	1759	2440	245	2685	5417	49.57%	12.57%	7	7
14	高雄市甲仙區	2018-11-25T00:00:02+08:00	681	1759	2440	245	2685	5417	49.57%	12.57%	7	7
14	高雄市甲仙區	2018-11-25T00:04:59+08:00	681	1759	2440	245	2685	5417	49.57%	12.57%	7	7
14	高雄市甲仙區	2018-11-24T23:27:13+08:00	681	1759	2440	245	2685	5417	49.57%	12.57%	7	7
14	高雄市甲仙區	2018-11-24T22:19:32+08:00	481	1263	1744	147	1891	3836	49.3%	12.54%	6	7
14	高雄市甲仙區	2018-11-24T22:30:00+08:00	481	1263	1744	147	1891	3836	49.3%	12.54%	6	7
14	高雄市甲仙區	2018-11-25T01:02:25+08:00	681	1759	2440	245	2685	5417	49.57%	12.57%	7	7
14	高雄市甲仙區	2018-11-25T06:13:47+08:00	681	1759	2440	245	2685	5417	49.57%	12.57%	7	7
14	高雄市甲仙區	2018-11-25T00:22:58+08:00	681	1759	2440	245	2685	5417	49.57%	12.57%	7	7
14	高雄市甲仙區	2018-11-24T22:26:32+08:00	481	1263	1744	147	1891	3836	49.3%	12.54%	6	7
14	高雄市甲仙區	2018-11-25T00:18:24+08:00	681	1759	2440	245	2685	5417	49.57%	12.57%	7	7
14	高雄市甲仙區	2018-11-24T22:50:42+08:00	481	1263	1744	147	1891	3836	49.3%	12.54%	6	7
14	高雄市甲仙區	2018-11-24T22:54:21+08:00	681	1759	2440	245	2685	5417	49.57%	12.57%	7	7
14	高雄市甲仙區	2018-11-24T22:41:30+08:00	481	1263	1744	147	1891	3836	49.3%	12.54%	6	7
14	高雄市甲仙區	2018-11-25T03:49:46+08:00	681	1759	2440	245	2685	5417	49.57%	12.57%	7	7
14	高雄市甲仙區	2018-11-24T23:01:26+08:00	681	1759	2440	245	2685	5417	49.57%	12.57%	7	7
14	高雄市甲仙區	2018-11-25T06:08:46+08:00	681	1759	2440	245	2685	5417	49.57%	12.57%	7	7
14	高雄市甲仙區	2018-11-24T23:43:12+08:00	681	1759	2440	245	2685	5417	49.57%	12.57%	7	7
14	高雄市甲仙區	2018-11-24T23:47:22+08:00	681	1759	2440	245	2685	5417	49.57%	12.57%	7	7
14	高雄市甲仙區	2018-11-24T22:16:04+08:00	481	1263	1744	147	1891	3836	49.3%	12.54%	6	7
14	高雄市甲仙區	2018-11-24T22:33:32+08:00	481	1263	1744	147	1891	3836	49.3%	12.54%	6	7
14	高雄市甲仙區	2018-11-25T03:44:16+08:00	681	1759	2440	245	2685	5417	49.57%	12.57%	7	7
14	高雄市甲仙區	2018-11-25T03:38:50+08:00	681	1759	2440	245	2685	5417	49.57%	12.57%	7	7
14	高雄市甲仙區	2018-11-24T23:23:33+08:00	681	1759	2440	245	2685	5417	49.57%	12.57%	7	7
14	高雄市甲仙區	2018-11-24T23:51:29+08:00	681	1759	2440	245	2685	5417	49.57%	12.57%	7	7
14	高雄市甲仙區	2018-11-24T22:57:47+08:00	681	1759	2440	245	2685	5417	49.57%	12.57%	7	7
14	高雄市甲仙區	2018-11-24T22:40:23+08:00	481	1263	1744	147	1891	3836	49.3%	12.54%	6	7
14	高雄市甲仙區	2018-11-25T03:32:29+08:00	681	1759	2440	245	2685	5417	49.57%	12.57%	7	7
14	高雄市甲仙區	2018-11-25T06:18:52+08:00	681	1759	2440	245	2685	5417	49.57%	12.57%	7	7
14	高雄市甲仙區	2018-11-24T23:15:58+08:00	681	1759	2440	245	2685	5417	49.57%	12.57%	7	7
14	高雄市甲仙區	2018-11-25T00:57:31+08:00	681	1759	2440	245	2685	5417	49.57%	12.57%	7	7
14	高雄市甲仙區	2018-11-25T01:25:47+08:00	681	1759	2440	245	2685	5417	49.57%	12.57%	7	7
14	高雄市甲仙區	2018-11-24T22:36:55+08:00	481	1263	1744	147	1891	3836	49.3%	12.54%	6	7
14	高雄市甲仙區	2018-11-25T03:56:06+08:00	681	1759	2440	245	2685	5417	49.57%	12.57%	7	7
14	高雄市甲仙區	2018-11-25T06:23:55+08:00	681	1759	2440	245	2685	5417	49.57%	12.57%	7	7
14	高雄市甲仙區	2018-11-24T23:12:10+08:00	681	1759	2440	245	2685	5417	49.57%	12.57%	7	7
14	高雄市甲仙區	2018-11-24T22:45:03+08:00	481	1263	1744	147	1891	3836	49.3%	12.54%	6	7
14	臺中市大里區	2018-11-24T23:35:03+08:00	26138	58199	84337	4508	88845	157447	56.43%	16.6%	98	106
14	臺中市大里區	2018-11-24T22:33:30+08:00	16177	35856	52033	2834	54867	96366	56.94%	16.79%	63	106
14	臺中市大里區	2018-11-24T22:16:01+08:00	13397	29609	43006	2403	45409	79858	56.86%	16.78%	53	106
14	臺中市大里區	2018-11-24T23:31:02+08:00	25903	57478	83381	4457	87838	155510	56.48%	16.66%	97	106
14	臺中市大里區	2018-11-24T23:12:07+08:00	22057	48344	70401	3763	74164	131211	56.52%	16.81%	83	106
14	臺中市大里區	2018-11-24T23:47:20+08:00	27367	60929	88296	4708	93004	164896	56.4%	16.6%	102	106
14	臺中市大里區	2018-11-25T01:07:18+08:00	28448	63477	91925	4937	96862	171769	56.39%	16.56%	106	106
14	臺中市大里區	2018-11-25T06:08:43+08:00	28448	63477	91925	4937	96862	171769	56.39%	16.56%	106	106
14	臺中市大里區	2018-11-24T23:01:23+08:00	19889	43974	63863	3464	67327	118814	56.67%	16.74%	76	106
14	臺中市大里區	2018-11-24T22:57:45+08:00	19275	42675	61950	3371	65321	115143	56.73%	16.74%	74	106
14	臺中市大里區	2018-11-25T01:17:42+08:00	28448	63477	91925	4937	96862	171769	56.39%	16.56%	106	106
14	臺中市大里區	2018-11-24T22:13:18+08:00	12482	27543	40025	2242	42267	73963	57.15%	16.88%	50	106
14	臺中市大里區	2018-11-24T22:19:29+08:00	14043	30896	44939	2506	47445	83386	56.9%	16.84%	55	106
14	臺中市大里區	2018-11-25T00:57:28+08:00	28448	63477	91925	4937	96862	171769	56.39%	16.56%	106	106
14	臺中市大里區	2018-11-24T23:23:31+08:00	24359	53976	78335	4193	82528	146172	56.46%	16.66%	92	106
14	臺中市大里區	2018-11-25T03:44:13+08:00	28448	63477	91925	4937	96862	171769	56.39%	16.56%	106	106
14	臺中市大里區	2018-11-25T00:04:57+08:00	27648	61562	89210	4766	93976	166693	56.38%	16.59%	103	106
14	臺中市大里區	2018-11-24T23:04:56+08:00	20824	45900	66724	3582	70306	124080	56.66%	16.78%	79	106
14	臺中市大里區	2018-11-24T23:15:55+08:00	23075	50836	73911	3958	77869	137765	56.52%	16.75%	87	106
14	臺中市大里區	2018-11-25T03:38:48+08:00	28448	63477	91925	4937	96862	171769	56.39%	16.56%	106	106
14	臺中市大里區	2018-11-25T06:18:50+08:00	28448	63477	91925	4937	96862	171769	56.39%	16.56%	106	106
14	臺中市大里區	2018-11-25T01:25:44+08:00	28448	63477	91925	4937	96862	171769	56.39%	16.56%	106	106
14	臺中市大里區	2018-11-24T22:40:21+08:00	16437	36378	52815	2868	55683	97796	56.94%	16.81%	64	106
14	臺中市大里區	2018-11-25T01:02:22+08:00	28448	63477	91925	4937	96862	171769	56.39%	16.56%	106	106
14	臺中市大里區	2018-11-24T23:55:39+08:00	27367	60929	88296	4708	93004	164896	56.4%	16.6%	102	106
14	臺中市大里區	2018-11-24T22:54:18+08:00	18655	41297	59952	3272	63224	111484	56.71%	16.73%	72	106
14	臺中市大里區	2018-11-24T22:45:01+08:00	16905	37529	54434	2960	57394	101024	56.81%	16.73%	66	106
14	臺中市大里區	2018-11-25T00:18:22+08:00	28222	62931	91153	4887	96040	170261	56.41%	16.58%	105	106
14	臺中市大里區	2018-11-25T00:22:56+08:00	28448	63477	91925	4937	96862	171769	56.39%	16.56%	106	106
14	臺中市大里區	2018-11-25T03:56:03+08:00	28448	63477	91925	4937	96862	171769	56.39%	16.56%	106	106
14	臺中市大里區	2018-11-24T23:39:05+08:00	26753	59663	86416	4646	91062	161186	56.49%	16.6%	100	106
14	臺中市大里區	2018-11-25T01:12:34+08:00	28448	63477	91925	4937	96862	171769	56.39%	16.56%	106	106
14	臺中市大里區	2018-11-25T04:02:40+08:00	28448	63477	91925	4937	96862	171769	56.39%	16.56%	106	106
14	臺中市大里區	2018-11-24T22:50:39+08:00	18416	40697	59113	3223	62336	109748	56.8%	16.78%	71	106
14	臺中市大里區	2018-11-25T00:09:25+08:00	27648	61562	89210	4766	93976	166693	56.38%	16.59%	103	106
14	臺中市大里區	2018-11-25T00:14:01+08:00	27919	62203	90122	4830	94952	168348	56.4%	16.58%	104	106
14	臺中市大里區	2018-11-24T22:41:28+08:00	16437	36378	52815	2868	55683	97796	56.94%	16.81%	64	106
14	臺中市大里區	2018-11-25T00:00:00+08:00	27648	61562	89210	4766	93976	166693	56.38%	16.59%	103	106
14	臺中市大里區	2018-11-24T22:23:04+08:00	14571	32101	46672	2602	49274	86429	57.01%	16.86%	57	106
14	臺中市大里區	2018-11-24T23:19:41+08:00	23470	51952	75422	4059	79481	140618	56.52%	16.69%	89	106
14	臺中市大里區	2018-11-24T23:51:27+08:00	27367	60929	88296	4708	93004	164896	56.4%	16.6%	102	106
14	臺中市大里區	2018-11-24T22:29:58+08:00	15615	34422	50037	2738	52775	92621	56.98%	16.86%	61	106
14	臺中市大里區	2018-11-24T22:36:53+08:00	16437	36378	52815	2868	55683	97796	56.94%	16.81%	64	106
14	臺中市大里區	2018-11-24T23:27:11+08:00	24627	54627	79254	4226	83480	148047	56.39%	16.63%	93	106
14	臺中市大里區	2018-11-24T23:08:27+08:00	21341	47260	68601	3667	72268	127788	56.55%	16.7%	81	106
14	臺中市大里區	2018-11-25T03:32:26+08:00	28448	63477	91925	4937	96862	171769	56.39%	16.56%	106	106
14	臺中市大里區	2018-11-25T06:29:08+08:00	28448	63477	91925	4937	96862	171769	56.39%	16.56%	106	106
14	臺中市大里區	2018-11-25T03:49:44+08:00	28448	63477	91925	4937	96862	171769	56.39%	16.56%	106	106
14	臺中市大里區	2018-11-24T22:26:30+08:00	15377	33833	49210	2711	51921	91051	57.02%	16.89%	60	106
14	臺中市大里區	2018-11-25T06:23:52+08:00	28448	63477	91925	4937	96862	171769	56.39%	16.56%	106	106
14	臺中市大里區	2018-11-24T23:43:09+08:00	27367	60929	88296	4708	93004	164896	56.4%	16.6%	102	106
14	臺中市大里區	2018-11-25T06:13:45+08:00	28448	63477	91925	4937	96862	171769	56.39%	16.56%	106	106
14	花蓮縣光復鄉	2018-11-25T06:29:17+08:00	1246	3966	5212	669	5881	11417	51.51%	10.91%	17	17
14	花蓮縣光復鄉	2018-11-24T23:47:28+08:00	1070	3439	4509	597	5106	9634	53%	11.11%	15	17
14	花蓮縣光復鄉	2018-11-25T00:18:30+08:00	1246	3966	5212	669	5881	11417	51.51%	10.91%	17	17
14	花蓮縣光復鄉	2018-11-25T01:07:26+08:00	1246	3966	5212	669	5881	11417	51.51%	10.91%	17	17
14	花蓮縣光復鄉	2018-11-25T06:13:52+08:00	1246	3966	5212	669	5881	11417	51.51%	10.91%	17	17
14	花蓮縣光復鄉	2018-11-24T22:33:38+08:00	488	1543	2031	227	2258	4689	48.16%	10.41%	10	17
14	花蓮縣光復鄉	2018-11-24T23:43:17+08:00	1070	3439	4509	597	5106	9634	53%	11.11%	15	17
14	花蓮縣光復鄉	2018-11-24T22:37:01+08:00	488	1543	2031	227	2258	4689	48.16%	10.41%	10	17
14	花蓮縣光復鄉	2018-11-25T03:44:23+08:00	1246	3966	5212	669	5881	11417	51.51%	10.91%	17	17
14	花蓮縣光復鄉	2018-11-24T22:13:27+08:00	426	1352	1778	210	1988	4218	47.13%	10.1%	9	17
14	花蓮縣光復鄉	2018-11-25T01:02:31+08:00	1246	3966	5212	669	5881	11417	51.51%	10.91%	17	17
14	花蓮縣光復鄉	2018-11-24T23:23:38+08:00	968	3073	4041	495	4536	8676	52.28%	11.16%	14	17
14	花蓮縣光復鄉	2018-11-25T03:38:55+08:00	1246	3966	5212	669	5881	11417	51.51%	10.91%	17	17
14	花蓮縣光復鄉	2018-11-24T23:55:47+08:00	1070	3439	4509	597	5106	9634	53%	11.11%	15	17
14	花蓮縣光復鄉	2018-11-24T23:08:36+08:00	847	2660	3507	426	3933	7635	51.51%	11.09%	13	17
14	花蓮縣光復鄉	2018-11-25T00:00:11+08:00	1070	3439	4509	597	5106	9634	53%	11.11%	15	17
14	花蓮縣光復鄉	2018-11-25T06:18:57+08:00	1246	3966	5212	669	5881	11417	51.51%	10.91%	17	17
14	花蓮縣光復鄉	2018-11-24T22:30:09+08:00	488	1543	2031	227	2258	4689	48.16%	10.41%	10	17
14	花蓮縣光復鄉	2018-11-24T22:40:28+08:00	488	1543	2031	227	2258	4689	48.16%	10.41%	10	17
14	花蓮縣光復鄉	2018-11-24T22:23:13+08:00	488	1543	2031	227	2258	4689	48.16%	10.41%	10	17
14	花蓮縣光復鄉	2018-11-24T23:19:51+08:00	968	3073	4041	495	4536	8676	52.28%	11.16%	14	17
14	花蓮縣光復鄉	2018-11-24T23:35:11+08:00	968	3073	4041	495	4536	8676	52.28%	11.16%	14	17
14	花蓮縣光復鄉	2018-11-24T23:01:31+08:00	847	2660	3507	426	3933	7635	51.51%	11.09%	13	17
14	花蓮縣光復鄉	2018-11-24T22:45:09+08:00	488	1543	2031	227	2258	4689	48.16%	10.41%	10	17
14	花蓮縣光復鄉	2018-11-24T23:31:11+08:00	968	3073	4041	495	4536	8676	52.28%	11.16%	14	17
14	花蓮縣光復鄉	2018-11-25T00:09:34+08:00	1148	3740	4888	649	5537	10485	52.81%	10.95%	16	17
14	花蓮縣光復鄉	2018-11-24T22:54:26+08:00	756	2432	3188	390	3578	6995	51.15%	10.81%	12	17
14	花蓮縣光復鄉	2018-11-25T00:14:09+08:00	1246	3966	5212	669	5881	11417	51.51%	10.91%	17	17
14	花蓮縣光復鄉	2018-11-25T03:49:51+08:00	1246	3966	5212	669	5881	11417	51.51%	10.91%	17	17
14	花蓮縣光復鄉	2018-11-24T23:16:03+08:00	847	2660	3507	426	3933	7635	51.51%	11.09%	13	17
14	花蓮縣光復鄉	2018-11-25T03:56:12+08:00	1246	3966	5212	669	5881	11417	51.51%	10.91%	17	17
14	花蓮縣光復鄉	2018-11-25T03:32:35+08:00	1246	3966	5212	669	5881	11417	51.51%	10.91%	17	17
14	花蓮縣光復鄉	2018-11-25T06:24:00+08:00	1246	3966	5212	669	5881	11417	51.51%	10.91%	17	17
14	花蓮縣光復鄉	2018-11-25T01:25:53+08:00	1246	3966	5212	669	5881	11417	51.51%	10.91%	17	17
14	花蓮縣光復鄉	2018-11-25T00:23:04+08:00	1246	3966	5212	669	5881	11417	51.51%	10.91%	17	17
14	花蓮縣光復鄉	2018-11-25T00:57:37+08:00	1246	3966	5212	669	5881	11417	51.51%	10.91%	17	17
14	花蓮縣光復鄉	2018-11-24T22:57:53+08:00	756	2432	3188	390	3578	6995	51.15%	10.81%	12	17
14	花蓮縣光復鄉	2018-11-24T22:19:37+08:00	426	1352	1778	210	1988	4218	47.13%	10.1%	9	17
14	花蓮縣光復鄉	2018-11-25T01:17:52+08:00	1246	3966	5212	669	5881	11417	51.51%	10.91%	17	17
14	花蓮縣光復鄉	2018-11-24T23:27:18+08:00	968	3073	4041	495	4536	8676	52.28%	11.16%	14	17
14	花蓮縣光復鄉	2018-11-24T23:51:35+08:00	1070	3439	4509	597	5106	9634	53%	11.11%	15	17
14	花蓮縣光復鄉	2018-11-24T23:05:04+08:00	847	2660	3507	426	3933	7635	51.51%	11.09%	13	17
14	花蓮縣光復鄉	2018-11-24T22:41:35+08:00	488	1543	2031	227	2258	4689	48.16%	10.41%	10	17
14	花蓮縣光復鄉	2018-11-25T00:05:05+08:00	1070	3439	4509	597	5106	9634	53%	11.11%	15	17
14	花蓮縣光復鄉	2018-11-25T04:02:52+08:00	1246	3966	5212	669	5881	11417	51.51%	10.91%	17	17
14	花蓮縣光復鄉	2018-11-24T23:12:16+08:00	847	2660	3507	426	3933	7635	51.51%	11.09%	13	17
14	花蓮縣光復鄉	2018-11-25T06:08:53+08:00	1246	3966	5212	669	5881	11417	51.51%	10.91%	17	17
14	花蓮縣光復鄉	2018-11-24T22:16:10+08:00	426	1352	1778	210	1988	4218	47.13%	10.1%	9	17
14	花蓮縣光復鄉	2018-11-25T01:12:43+08:00	1246	3966	5212	669	5881	11417	51.51%	10.91%	17	17
14	花蓮縣光復鄉	2018-11-24T22:26:37+08:00	488	1543	2031	227	2258	4689	48.16%	10.41%	10	17
14	花蓮縣光復鄉	2018-11-24T22:50:48+08:00	650	2038	2688	302	2990	5984	49.97%	10.86%	11	17
14	花蓮縣光復鄉	2018-11-24T23:39:16+08:00	968	3073	4041	495	4536	8676	52.28%	11.16%	14	17
14	臺東縣長濱鄉	2018-11-25T06:29:17+08:00	562	1793	2355	363	2718	6484	41.92%	8.67%	11	11
14	臺東縣長濱鄉	2018-11-25T03:49:52+08:00	562	1793	2355	363	2718	6484	41.92%	8.67%	11	11
14	臺東縣長濱鄉	2018-11-24T23:47:29+08:00	562	1793	2355	363	2718	6484	41.92%	8.67%	11	11
14	臺東縣長濱鄉	2018-11-24T22:33:38+08:00	457	1372	1829	280	2109	5154	40.92%	8.87%	9	11
14	臺東縣長濱鄉	2018-11-25T01:07:27+08:00	562	1793	2355	363	2718	6484	41.92%	8.67%	11	11
14	臺東縣長濱鄉	2018-11-25T06:13:53+08:00	562	1793	2355	363	2718	6484	41.92%	8.67%	11	11
14	臺東縣長濱鄉	2018-11-24T23:43:17+08:00	562	1793	2355	363	2718	6484	41.92%	8.67%	11	11
14	臺東縣長濱鄉	2018-11-25T00:18:31+08:00	562	1793	2355	363	2718	6484	41.92%	8.67%	11	11
14	臺東縣長濱鄉	2018-11-24T22:37:01+08:00	503	1562	2065	312	2377	5759	41.27%	8.73%	10	11
14	臺東縣長濱鄉	2018-11-24T22:13:27+08:00	349	1073	1422	195	1617	4241	38.13%	8.23%	8	11
14	臺東縣長濱鄉	2018-11-25T03:44:24+08:00	562	1793	2355	363	2718	6484	41.92%	8.67%	11	11
14	臺東縣長濱鄉	2018-11-25T01:02:31+08:00	562	1793	2355	363	2718	6484	41.92%	8.67%	11	11
14	臺東縣長濱鄉	2018-11-24T23:08:37+08:00	503	1562	2065	312	2377	5759	41.27%	8.73%	10	11
14	臺東縣長濱鄉	2018-11-25T03:38:55+08:00	562	1793	2355	363	2718	6484	41.92%	8.67%	11	11
14	臺東縣長濱鄉	2018-11-24T23:55:47+08:00	562	1793	2355	363	2718	6484	41.92%	8.67%	11	11
14	臺東縣長濱鄉	2018-11-24T23:23:39+08:00	503	1562	2065	312	2377	5759	41.27%	8.73%	10	11
14	臺東縣長濱鄉	2018-11-25T06:18:58+08:00	562	1793	2355	363	2718	6484	41.92%	8.67%	11	11
14	臺東縣長濱鄉	2018-11-25T00:00:11+08:00	562	1793	2355	363	2718	6484	41.92%	8.67%	11	11
14	臺東縣長濱鄉	2018-11-24T23:51:36+08:00	562	1793	2355	363	2718	6484	41.92%	8.67%	11	11
14	臺東縣長濱鄉	2018-11-24T22:30:09+08:00	457	1372	1829	280	2109	5154	40.92%	8.87%	9	11
14	臺東縣長濱鄉	2018-11-24T22:23:14+08:00	349	1073	1422	195	1617	4241	38.13%	8.23%	8	11
14	臺東縣長濱鄉	2018-11-24T22:40:28+08:00	503	1562	2065	312	2377	5759	41.27%	8.73%	10	11
14	臺東縣長濱鄉	2018-11-25T00:09:35+08:00	562	1793	2355	363	2718	6484	41.92%	8.67%	11	11
14	臺東縣長濱鄉	2018-11-25T00:05:06+08:00	562	1793	2355	363	2718	6484	41.92%	8.67%	11	11
14	臺東縣長濱鄉	2018-11-24T23:35:11+08:00	503	1562	2065	312	2377	5759	41.27%	8.73%	10	11
14	臺東縣長濱鄉	2018-11-24T23:01:31+08:00	503	1562	2065	312	2377	5759	41.27%	8.73%	10	11
14	臺東縣長濱鄉	2018-11-24T22:45:09+08:00	503	1562	2065	312	2377	5759	41.27%	8.73%	10	11
14	臺東縣長濱鄉	2018-11-24T22:54:26+08:00	503	1562	2065	312	2377	5759	41.27%	8.73%	10	11
14	臺東縣長濱鄉	2018-11-25T00:14:10+08:00	562	1793	2355	363	2718	6484	41.92%	8.67%	11	11
14	臺東縣長濱鄉	2018-11-25T03:56:13+08:00	562	1793	2355	363	2718	6484	41.92%	8.67%	11	11
14	臺東縣長濱鄉	2018-11-24T23:16:03+08:00	503	1562	2065	312	2377	5759	41.27%	8.73%	10	11
14	臺東縣長濱鄉	2018-11-25T03:32:35+08:00	562	1793	2355	363	2718	6484	41.92%	8.67%	11	11
14	臺東縣長濱鄉	2018-11-25T01:25:53+08:00	562	1793	2355	363	2718	6484	41.92%	8.67%	11	11
14	臺東縣長濱鄉	2018-11-25T00:23:04+08:00	562	1793	2355	363	2718	6484	41.92%	8.67%	11	11
14	臺東縣長濱鄉	2018-11-25T06:24:01+08:00	562	1793	2355	363	2718	6484	41.92%	8.67%	11	11
14	臺東縣長濱鄉	2018-11-24T23:27:19+08:00	503	1562	2065	312	2377	5759	41.27%	8.73%	10	11
14	臺東縣長濱鄉	2018-11-25T00:57:37+08:00	562	1793	2355	363	2718	6484	41.92%	8.67%	11	11
14	臺東縣長濱鄉	2018-11-24T22:57:54+08:00	503	1562	2065	312	2377	5759	41.27%	8.73%	10	11
14	臺東縣長濱鄉	2018-11-25T01:17:53+08:00	562	1793	2355	363	2718	6484	41.92%	8.67%	11	11
14	臺東縣長濱鄉	2018-11-24T22:19:37+08:00	349	1073	1422	195	1617	4241	38.13%	8.23%	8	11
14	臺東縣長濱鄉	2018-11-24T23:19:52+08:00	503	1562	2065	312	2377	5759	41.27%	8.73%	10	11
14	臺東縣長濱鄉	2018-11-24T22:41:35+08:00	503	1562	2065	312	2377	5759	41.27%	8.73%	10	11
14	臺東縣長濱鄉	2018-11-24T23:12:16+08:00	503	1562	2065	312	2377	5759	41.27%	8.73%	10	11
14	臺東縣長濱鄉	2018-11-25T06:08:53+08:00	562	1793	2355	363	2718	6484	41.92%	8.67%	11	11
14	臺東縣長濱鄉	2018-11-25T01:12:44+08:00	562	1793	2355	363	2718	6484	41.92%	8.67%	11	11
14	臺東縣長濱鄉	2018-11-24T22:50:49+08:00	503	1562	2065	312	2377	5759	41.27%	8.73%	10	11
14	臺東縣長濱鄉	2018-11-24T22:26:37+08:00	349	1073	1422	195	1617	4241	38.13%	8.23%	8	11
14	臺東縣長濱鄉	2018-11-25T04:02:53+08:00	562	1793	2355	363	2718	6484	41.92%	8.67%	11	11
14	臺東縣長濱鄉	2018-11-24T23:05:05+08:00	503	1562	2065	312	2377	5759	41.27%	8.73%	10	11
14	臺東縣長濱鄉	2018-11-24T23:31:12+08:00	503	1562	2065	312	2377	5759	41.27%	8.73%	10	11
14	臺東縣長濱鄉	2018-11-24T22:16:11+08:00	349	1073	1422	195	1617	4241	38.13%	8.23%	8	11
14	臺東縣長濱鄉	2018-11-24T23:39:16+08:00	503	1562	2065	312	2377	5759	41.27%	8.73%	10	11
14	臺南市將軍區	2018-11-24T23:47:21+08:00	2193	5225	7418	517	7935	17754	44.69%	12.35%	24	24
14	臺南市將軍區	2018-11-24T23:35:03+08:00	2193	5225	7418	517	7935	17754	44.69%	12.35%	24	24
14	臺南市將軍區	2018-11-24T22:33:30+08:00	2193	5225	7418	517	7935	17754	44.69%	12.35%	24	24
14	臺南市將軍區	2018-11-24T23:31:02+08:00	2193	5225	7418	517	7935	17754	44.69%	12.35%	24	24
14	臺南市將軍區	2018-11-24T23:39:06+08:00	2193	5225	7418	517	7935	17754	44.69%	12.35%	24	24
14	臺南市將軍區	2018-11-25T01:07:19+08:00	2193	5225	7418	517	7935	17754	44.69%	12.35%	24	24
14	臺南市將軍區	2018-11-25T00:14:02+08:00	2193	5225	7418	517	7935	17754	44.69%	12.35%	24	24
14	臺南市將軍區	2018-11-24T23:43:10+08:00	2193	5225	7418	517	7935	17754	44.69%	12.35%	24	24
14	臺南市將軍區	2018-11-25T06:08:44+08:00	2193	5225	7418	517	7935	17754	44.69%	12.35%	24	24
14	臺南市將軍區	2018-11-25T00:09:26+08:00	2193	5225	7418	517	7935	17754	44.69%	12.35%	24	24
14	臺南市將軍區	2018-11-24T23:01:23+08:00	2193	5225	7418	517	7935	17754	44.69%	12.35%	24	24
14	臺南市將軍區	2018-11-24T23:12:08+08:00	2193	5225	7418	517	7935	17754	44.69%	12.35%	24	24
14	臺南市將軍區	2018-11-24T22:57:45+08:00	2193	5225	7418	517	7935	17754	44.69%	12.35%	24	24
14	臺南市將軍區	2018-11-24T23:04:57+08:00	2193	5225	7418	517	7935	17754	44.69%	12.35%	24	24
14	臺南市將軍區	2018-11-24T23:23:31+08:00	2193	5225	7418	517	7935	17754	44.69%	12.35%	24	24
14	臺南市將軍區	2018-11-25T00:57:29+08:00	2193	5225	7418	517	7935	17754	44.69%	12.35%	24	24
14	臺南市將軍區	2018-11-24T22:13:19+08:00	2193	5225	7418	517	7935	17754	44.69%	12.35%	24	24
14	臺南市將軍區	2018-11-25T03:44:14+08:00	2193	5225	7418	517	7935	17754	44.69%	12.35%	24	24
14	臺南市將軍區	2018-11-25T01:17:43+08:00	2193	5225	7418	517	7935	17754	44.69%	12.35%	24	24
14	臺南市將軍區	2018-11-25T00:04:57+08:00	2193	5225	7418	517	7935	17754	44.69%	12.35%	24	24
14	臺南市將軍區	2018-11-24T23:55:40+08:00	2193	5225	7418	517	7935	17754	44.69%	12.35%	24	24
14	臺南市將軍區	2018-11-25T01:02:23+08:00	2193	5225	7418	517	7935	17754	44.69%	12.35%	24	24
14	臺南市將軍區	2018-11-25T01:25:45+08:00	2193	5225	7418	517	7935	17754	44.69%	12.35%	24	24
14	臺南市將軍區	2018-11-25T03:38:48+08:00	2193	5225	7418	517	7935	17754	44.69%	12.35%	24	24
14	臺南市將軍區	2018-11-25T06:18:50+08:00	2193	5225	7418	517	7935	17754	44.69%	12.35%	24	24
14	臺南市將軍區	2018-11-24T22:40:21+08:00	2193	5225	7418	517	7935	17754	44.69%	12.35%	24	24
14	臺南市將軍區	2018-11-24T23:27:12+08:00	2193	5225	7418	517	7935	17754	44.69%	12.35%	24	24
14	臺南市將軍區	2018-11-24T22:45:01+08:00	2193	5225	7418	517	7935	17754	44.69%	12.35%	24	24
14	臺南市將軍區	2018-11-25T00:18:22+08:00	2193	5225	7418	517	7935	17754	44.69%	12.35%	24	24
14	臺南市將軍區	2018-11-25T00:22:56+08:00	2193	5225	7418	517	7935	17754	44.69%	12.35%	24	24
14	臺南市將軍區	2018-11-24T22:54:19+08:00	2193	5225	7418	517	7935	17754	44.69%	12.35%	24	24
14	臺南市將軍區	2018-11-25T03:56:03+08:00	2193	5225	7418	517	7935	17754	44.69%	12.35%	24	24
14	臺南市將軍區	2018-11-24T22:16:02+08:00	2193	5225	7418	517	7935	17754	44.69%	12.35%	24	24
14	臺南市將軍區	2018-11-24T22:50:39+08:00	2193	5225	7418	517	7935	17754	44.69%	12.35%	24	24
14	臺南市將軍區	2018-11-24T22:41:28+08:00	2193	5225	7418	517	7935	17754	44.69%	12.35%	24	24
14	臺南市將軍區	2018-11-25T04:02:41+08:00	2193	5225	7418	517	7935	17754	44.69%	12.35%	24	24
14	臺南市將軍區	2018-11-25T01:12:35+08:00	2193	5225	7418	517	7935	17754	44.69%	12.35%	24	24
14	臺南市將軍區	2018-11-25T00:00:00+08:00	2193	5225	7418	517	7935	17754	44.69%	12.35%	24	24
14	臺南市將軍區	2018-11-24T23:19:41+08:00	2193	5225	7418	517	7935	17754	44.69%	12.35%	24	24
14	臺南市將軍區	2018-11-24T23:51:27+08:00	2193	5225	7418	517	7935	17754	44.69%	12.35%	24	24
14	臺南市將軍區	2018-11-24T22:29:58+08:00	2193	5225	7418	517	7935	17754	44.69%	12.35%	24	24
14	臺南市將軍區	2018-11-24T22:23:05+08:00	2193	5225	7418	517	7935	17754	44.69%	12.35%	24	24
14	臺南市將軍區	2018-11-24T22:36:54+08:00	2193	5225	7418	517	7935	17754	44.69%	12.35%	24	24
14	臺南市將軍區	2018-11-24T23:15:56+08:00	2193	5225	7418	517	7935	17754	44.69%	12.35%	24	24
14	臺南市將軍區	2018-11-24T23:08:28+08:00	2193	5225	7418	517	7935	17754	44.69%	12.35%	24	24
14	臺南市將軍區	2018-11-25T03:32:27+08:00	2193	5225	7418	517	7935	17754	44.69%	12.35%	24	24
14	臺南市將軍區	2018-11-24T22:19:30+08:00	2193	5225	7418	517	7935	17754	44.69%	12.35%	24	24
14	臺南市將軍區	2018-11-25T03:49:44+08:00	2193	5225	7418	517	7935	17754	44.69%	12.35%	24	24
14	臺南市將軍區	2018-11-24T22:26:30+08:00	2193	5225	7418	517	7935	17754	44.69%	12.35%	24	24
14	臺南市將軍區	2018-11-25T06:29:09+08:00	2193	5225	7418	517	7935	17754	44.69%	12.35%	24	24
14	臺南市將軍區	2018-11-25T06:23:53+08:00	2193	5225	7418	517	7935	17754	44.69%	12.35%	24	24
14	臺南市將軍區	2018-11-25T06:13:45+08:00	2193	5225	7418	517	7935	17754	44.69%	12.35%	24	24
14	屏東縣獅子鄉	2018-11-24T22:33:37+08:00	408	1296	1704	85	1789	3173	56.38%	12.86%	6	8
14	屏東縣獅子鄉	2018-11-24T23:47:28+08:00	515	1674	2189	100	2289	4230	54.11%	12.17%	8	8
14	屏東縣獅子鄉	2018-11-24T22:37:00+08:00	408	1296	1704	85	1789	3173	56.38%	12.86%	6	8
14	屏東縣獅子鄉	2018-11-24T23:43:16+08:00	515	1674	2189	100	2289	4230	54.11%	12.17%	8	8
14	屏東縣獅子鄉	2018-11-25T06:13:52+08:00	515	1674	2189	100	2289	4230	54.11%	12.17%	8	8
14	屏東縣獅子鄉	2018-11-25T03:56:11+08:00	515	1674	2189	100	2289	4230	54.11%	12.17%	8	8
14	屏東縣獅子鄉	2018-11-25T06:29:16+08:00	515	1674	2189	100	2289	4230	54.11%	12.17%	8	8
14	屏東縣獅子鄉	2018-11-25T03:38:54+08:00	515	1674	2189	100	2289	4230	54.11%	12.17%	8	8
14	屏東縣獅子鄉	2018-11-24T23:55:46+08:00	515	1674	2189	100	2289	4230	54.11%	12.17%	8	8
14	屏東縣獅子鄉	2018-11-25T01:02:30+08:00	515	1674	2189	100	2289	4230	54.11%	12.17%	8	8
14	屏東縣獅子鄉	2018-11-25T03:44:22+08:00	515	1674	2189	100	2289	4230	54.11%	12.17%	8	8
14	屏東縣獅子鄉	2018-11-24T22:13:26+08:00	324	1020	1344	77	1421	2571	55.27%	12.6%	5	8
14	屏東縣獅子鄉	2018-11-24T23:23:37+08:00	515	1674	2189	100	2289	4230	54.11%	12.17%	8	8
14	屏東縣獅子鄉	2018-11-24T22:23:12+08:00	324	1020	1344	77	1421	2571	55.27%	12.6%	5	8
14	屏東縣獅子鄉	2018-11-24T22:30:08+08:00	324	1020	1344	77	1421	2571	55.27%	12.6%	5	8
14	屏東縣獅子鄉	2018-11-24T22:40:27+08:00	408	1296	1704	85	1789	3173	56.38%	12.86%	6	8
14	屏東縣獅子鄉	2018-11-25T00:00:10+08:00	515	1674	2189	100	2289	4230	54.11%	12.17%	8	8
14	屏東縣獅子鄉	2018-11-25T06:18:57+08:00	515	1674	2189	100	2289	4230	54.11%	12.17%	8	8
14	屏東縣獅子鄉	2018-11-25T01:17:51+08:00	515	1674	2189	100	2289	4230	54.11%	12.17%	8	8
14	屏東縣獅子鄉	2018-11-24T23:19:51+08:00	515	1674	2189	100	2289	4230	54.11%	12.17%	8	8
14	屏東縣獅子鄉	2018-11-24T23:12:15+08:00	515	1674	2189	100	2289	4230	54.11%	12.17%	8	8
14	屏東縣獅子鄉	2018-11-24T22:45:08+08:00	408	1296	1704	85	1789	3173	56.38%	12.86%	6	8
14	屏東縣獅子鄉	2018-11-24T23:31:10+08:00	515	1674	2189	100	2289	4230	54.11%	12.17%	8	8
14	屏東縣獅子鄉	2018-11-24T23:01:30+08:00	452	1412	1864	92	1956	3519	55.58%	12.84%	7	8
14	屏東縣獅子鄉	2018-11-25T04:02:51+08:00	515	1674	2189	100	2289	4230	54.11%	12.17%	8	8
14	屏東縣獅子鄉	2018-11-24T23:39:15+08:00	515	1674	2189	100	2289	4230	54.11%	12.17%	8	8
14	屏東縣獅子鄉	2018-11-25T06:23:59+08:00	515	1674	2189	100	2289	4230	54.11%	12.17%	8	8
14	屏東縣獅子鄉	2018-11-25T00:09:33+08:00	515	1674	2189	100	2289	4230	54.11%	12.17%	8	8
14	屏東縣獅子鄉	2018-11-24T23:35:10+08:00	515	1674	2189	100	2289	4230	54.11%	12.17%	8	8
14	屏東縣獅子鄉	2018-11-25T01:07:25+08:00	515	1674	2189	100	2289	4230	54.11%	12.17%	8	8
14	屏東縣獅子鄉	2018-11-25T00:14:09+08:00	515	1674	2189	100	2289	4230	54.11%	12.17%	8	8
14	屏東縣獅子鄉	2018-11-24T23:16:02+08:00	515	1674	2189	100	2289	4230	54.11%	12.17%	8	8
14	屏東縣獅子鄉	2018-11-25T03:49:50+08:00	515	1674	2189	100	2289	4230	54.11%	12.17%	8	8
14	屏東縣獅子鄉	2018-11-25T00:23:03+08:00	515	1674	2189	100	2289	4230	54.11%	12.17%	8	8
14	屏東縣獅子鄉	2018-11-24T23:08:35+08:00	515	1674	2189	100	2289	4230	54.11%	12.17%	8	8
14	屏東縣獅子鄉	2018-11-25T03:32:34+08:00	515	1674	2189	100	2289	4230	54.11%	12.17%	8	8
14	屏東縣獅子鄉	2018-11-25T01:25:52+08:00	515	1674	2189	100	2289	4230	54.11%	12.17%	8	8
14	屏東縣獅子鄉	2018-11-24T22:19:36+08:00	324	1020	1344	77	1421	2571	55.27%	12.6%	5	8
14	屏東縣獅子鄉	2018-11-24T22:57:52+08:00	452	1412	1864	92	1956	3519	55.58%	12.84%	7	8
14	屏東縣獅子鄉	2018-11-25T00:57:36+08:00	515	1674	2189	100	2289	4230	54.11%	12.17%	8	8
14	屏東縣獅子鄉	2018-11-24T23:27:18+08:00	515	1674	2189	100	2289	4230	54.11%	12.17%	8	8
14	屏東縣獅子鄉	2018-11-24T23:51:35+08:00	515	1674	2189	100	2289	4230	54.11%	12.17%	8	8
14	屏東縣獅子鄉	2018-11-24T23:05:04+08:00	515	1674	2189	100	2289	4230	54.11%	12.17%	8	8
14	屏東縣獅子鄉	2018-11-24T22:50:47+08:00	452	1412	1864	92	1956	3519	55.58%	12.84%	7	8
14	屏東縣獅子鄉	2018-11-24T22:16:10+08:00	324	1020	1344	77	1421	2571	55.27%	12.6%	5	8
14	屏東縣獅子鄉	2018-11-25T01:12:43+08:00	515	1674	2189	100	2289	4230	54.11%	12.17%	8	8
14	屏東縣獅子鄉	2018-11-25T00:05:04+08:00	515	1674	2189	100	2289	4230	54.11%	12.17%	8	8
14	屏東縣獅子鄉	2018-11-24T22:41:34+08:00	408	1296	1704	85	1789	3173	56.38%	12.86%	6	8
14	屏東縣獅子鄉	2018-11-24T22:26:36+08:00	324	1020	1344	77	1421	2571	55.27%	12.6%	5	8
14	屏東縣獅子鄉	2018-11-25T00:18:29+08:00	515	1674	2189	100	2289	4230	54.11%	12.17%	8	8
14	屏東縣獅子鄉	2018-11-25T06:08:52+08:00	515	1674	2189	100	2289	4230	54.11%	12.17%	8	8
14	屏東縣獅子鄉	2018-11-24T22:54:25+08:00	452	1412	1864	92	1956	3519	55.58%	12.84%	7	8
14	臺南市東山區	2018-11-24T23:35:03+08:00	1904	4405	6309	668	6977	18471	37.77%	10.31%	23	23
14	臺南市東山區	2018-11-24T22:33:30+08:00	1904	4405	6309	668	6977	18471	37.77%	10.31%	23	23
14	臺南市東山區	2018-11-24T23:31:02+08:00	1904	4405	6309	668	6977	18471	37.77%	10.31%	23	23
14	臺南市東山區	2018-11-24T23:39:06+08:00	1904	4405	6309	668	6977	18471	37.77%	10.31%	23	23
14	臺南市東山區	2018-11-24T23:12:07+08:00	1904	4405	6309	668	6977	18471	37.77%	10.31%	23	23
14	臺南市東山區	2018-11-24T23:47:20+08:00	1904	4405	6309	668	6977	18471	37.77%	10.31%	23	23
14	臺南市東山區	2018-11-25T06:08:44+08:00	1904	4405	6309	686	6995	18471	37.87%	10.31%	23	23
14	臺南市東山區	2018-11-25T01:07:18+08:00	1904	4405	6309	668	6977	18471	37.77%	10.31%	23	23
14	臺南市東山區	2018-11-24T23:01:23+08:00	1904	4405	6309	668	6977	18471	37.77%	10.31%	23	23
14	臺南市東山區	2018-11-24T22:57:45+08:00	1904	4405	6309	668	6977	18471	37.77%	10.31%	23	23
14	臺南市東山區	2018-11-25T01:17:42+08:00	1904	4405	6309	668	6977	18471	37.77%	10.31%	23	23
14	臺南市東山區	2018-11-24T22:13:18+08:00	1904	4405	6309	668	6977	18471	37.77%	10.31%	23	23
14	臺南市東山區	2018-11-24T22:19:29+08:00	1804	4223	6027	632	6659	17831	37.35%	10.12%	22	23
14	臺南市東山區	2018-11-25T00:57:28+08:00	1904	4405	6309	668	6977	18471	37.77%	10.31%	23	23
14	臺南市東山區	2018-11-24T23:23:31+08:00	1904	4405	6309	668	6977	18471	37.77%	10.31%	23	23
14	臺南市東山區	2018-11-25T03:44:13+08:00	1904	4405	6309	686	6995	18471	37.87%	10.31%	23	23
14	臺南市東山區	2018-11-25T00:04:57+08:00	1904	4405	6309	668	6977	18471	37.77%	10.31%	23	23
14	臺南市東山區	2018-11-24T23:04:56+08:00	1904	4405	6309	668	6977	18471	37.77%	10.31%	23	23
14	臺南市東山區	2018-11-24T23:15:55+08:00	1904	4405	6309	668	6977	18471	37.77%	10.31%	23	23
14	臺南市東山區	2018-11-25T01:02:23+08:00	1904	4405	6309	668	6977	18471	37.77%	10.31%	23	23
14	臺南市東山區	2018-11-25T01:25:45+08:00	1812	4198	6010	662	6672	17370	38.41%	10.43%	22	23
14	臺南市東山區	2018-11-25T03:38:48+08:00	1904	4405	6309	686	6995	18471	37.87%	10.31%	23	23
14	臺南市東山區	2018-11-25T06:18:50+08:00	1904	4405	6309	686	6995	18471	37.87%	10.31%	23	23
14	臺南市東山區	2018-11-24T22:40:21+08:00	1904	4405	6309	668	6977	18471	37.77%	10.31%	23	23
14	臺南市東山區	2018-11-24T23:55:39+08:00	1904	4405	6309	668	6977	18471	37.77%	10.31%	23	23
14	臺南市東山區	2018-11-24T22:45:01+08:00	1904	4405	6309	668	6977	18471	37.77%	10.31%	23	23
14	臺南市東山區	2018-11-25T00:18:22+08:00	1904	4405	6309	668	6977	18471	37.77%	10.31%	23	23
14	臺南市東山區	2018-11-25T00:22:56+08:00	1904	4405	6309	668	6977	18471	37.77%	10.31%	23	23
14	臺南市東山區	2018-11-24T22:54:19+08:00	1904	4405	6309	668	6977	18471	37.77%	10.31%	23	23
14	臺南市東山區	2018-11-25T03:56:03+08:00	1904	4405	6309	686	6995	18471	37.87%	10.31%	23	23
14	臺南市東山區	2018-11-24T22:16:02+08:00	1804	4223	6027	632	6659	17831	37.35%	10.12%	22	23
14	臺南市東山區	2018-11-25T01:12:34+08:00	1904	4405	6309	668	6977	18471	37.77%	10.31%	23	23
14	臺南市東山區	2018-11-24T22:50:39+08:00	1904	4405	6309	668	6977	18471	37.77%	10.31%	23	23
14	臺南市東山區	2018-11-25T00:09:25+08:00	1904	4405	6309	668	6977	18471	37.77%	10.31%	23	23
14	臺南市東山區	2018-11-25T00:14:01+08:00	1904	4405	6309	668	6977	18471	37.77%	10.31%	23	23
14	臺南市東山區	2018-11-24T22:41:28+08:00	1904	4405	6309	668	6977	18471	37.77%	10.31%	23	23
14	臺南市東山區	2018-11-25T04:02:41+08:00	1904	4405	6309	686	6995	18471	37.87%	10.31%	23	23
14	臺南市東山區	2018-11-25T00:00:00+08:00	1904	4405	6309	668	6977	18471	37.77%	10.31%	23	23
14	臺南市東山區	2018-11-24T22:23:04+08:00	1804	4223	6027	632	6659	17831	37.35%	10.12%	22	23
14	臺南市東山區	2018-11-24T23:19:41+08:00	1904	4405	6309	668	6977	18471	37.77%	10.31%	23	23
14	臺南市東山區	2018-11-24T23:51:27+08:00	1904	4405	6309	668	6977	18471	37.77%	10.31%	23	23
14	臺南市東山區	2018-11-24T22:29:58+08:00	1904	4405	6309	668	6977	18471	37.77%	10.31%	23	23
14	臺南市東山區	2018-11-24T22:36:53+08:00	1904	4405	6309	668	6977	18471	37.77%	10.31%	23	23
14	臺南市東山區	2018-11-25T03:32:27+08:00	1904	4405	6309	686	6995	18471	37.87%	10.31%	23	23
14	臺南市東山區	2018-11-24T23:27:11+08:00	1904	4405	6309	668	6977	18471	37.77%	10.31%	23	23
14	臺南市東山區	2018-11-24T23:08:27+08:00	1904	4405	6309	668	6977	18471	37.77%	10.31%	23	23
14	臺南市東山區	2018-11-25T06:29:08+08:00	1904	4405	6309	686	6995	18471	37.87%	10.31%	23	23
14	臺南市東山區	2018-11-25T03:49:44+08:00	1904	4405	6309	686	6995	18471	37.87%	10.31%	23	23
14	臺南市東山區	2018-11-24T22:26:30+08:00	1904	4405	6309	668	6977	18471	37.77%	10.31%	23	23
14	臺南市東山區	2018-11-25T06:23:52+08:00	1904	4405	6309	686	6995	18471	37.87%	10.31%	23	23
14	臺南市東山區	2018-11-24T23:43:09+08:00	1904	4405	6309	668	6977	18471	37.77%	10.31%	23	23
14	臺南市東山區	2018-11-25T06:13:45+08:00	1904	4405	6309	686	6995	18471	37.87%	10.31%	23	23
14	屏東縣琉球鄉	2018-11-24T22:33:37+08:00	1062	3341	4403	345	4748	10706	44.35%	9.92%	9	9
14	屏東縣琉球鄉	2018-11-24T22:37:00+08:00	1062	3341	4403	345	4748	10706	44.35%	9.92%	9	9
14	屏東縣琉球鄉	2018-11-24T23:43:16+08:00	1062	3341	4403	345	4748	10706	44.35%	9.92%	9	9
14	屏東縣琉球鄉	2018-11-25T03:56:11+08:00	1062	3341	4403	345	4748	10706	44.35%	9.92%	9	9
14	屏東縣琉球鄉	2018-11-25T06:29:16+08:00	1062	3341	4403	345	4748	10706	44.35%	9.92%	9	9
14	屏東縣琉球鄉	2018-11-24T23:47:27+08:00	1062	3341	4403	345	4748	10706	44.35%	9.92%	9	9
14	屏東縣琉球鄉	2018-11-24T22:16:09+08:00	1062	3341	4403	345	4748	10706	44.35%	9.92%	9	9
14	屏東縣琉球鄉	2018-11-25T03:38:54+08:00	1062	3341	4403	345	4748	10706	44.35%	9.92%	9	9
14	屏東縣琉球鄉	2018-11-24T23:55:46+08:00	1062	3341	4403	345	4748	10706	44.35%	9.92%	9	9
14	屏東縣琉球鄉	2018-11-25T03:44:22+08:00	1062	3341	4403	345	4748	10706	44.35%	9.92%	9	9
14	屏東縣琉球鄉	2018-11-24T22:13:26+08:00	1062	3341	4403	345	4748	10706	44.35%	9.92%	9	9
14	屏東縣琉球鄉	2018-11-24T23:23:37+08:00	1062	3341	4403	345	4748	10706	44.35%	9.92%	9	9
14	屏東縣琉球鄉	2018-11-25T06:18:56+08:00	1062	3341	4403	345	4748	10706	44.35%	9.92%	9	9
14	屏東縣琉球鄉	2018-11-24T22:23:12+08:00	1062	3341	4403	345	4748	10706	44.35%	9.92%	9	9
14	屏東縣琉球鄉	2018-11-24T22:40:27+08:00	1062	3341	4403	345	4748	10706	44.35%	9.92%	9	9
14	屏東縣琉球鄉	2018-11-25T00:00:10+08:00	1062	3341	4403	345	4748	10706	44.35%	9.92%	9	9
14	屏東縣琉球鄉	2018-11-25T01:17:51+08:00	1062	3341	4403	345	4748	10706	44.35%	9.92%	9	9
14	屏東縣琉球鄉	2018-11-24T22:30:07+08:00	1062	3341	4403	345	4748	10706	44.35%	9.92%	9	9
14	屏東縣琉球鄉	2018-11-24T23:12:15+08:00	1062	3341	4403	345	4748	10706	44.35%	9.92%	9	9
14	屏東縣琉球鄉	2018-11-24T23:31:10+08:00	1062	3341	4403	345	4748	10706	44.35%	9.92%	9	9
14	屏東縣琉球鄉	2018-11-24T23:39:14+08:00	1062	3341	4403	345	4748	10706	44.35%	9.92%	9	9
14	屏東縣琉球鄉	2018-11-24T23:01:30+08:00	1062	3341	4403	345	4748	10706	44.35%	9.92%	9	9
14	屏東縣琉球鄉	2018-11-25T04:02:51+08:00	1062	3341	4403	345	4748	10706	44.35%	9.92%	9	9
14	屏東縣琉球鄉	2018-11-25T06:23:59+08:00	1062	3341	4403	345	4748	10706	44.35%	9.92%	9	9
14	屏東縣琉球鄉	2018-11-25T00:09:33+08:00	1062	3341	4403	345	4748	10706	44.35%	9.92%	9	9
14	屏東縣琉球鄉	2018-11-24T22:45:07+08:00	1062	3341	4403	345	4748	10706	44.35%	9.92%	9	9
14	屏東縣琉球鄉	2018-11-25T01:07:25+08:00	1062	3341	4403	345	4748	10706	44.35%	9.92%	9	9
14	屏東縣琉球鄉	2018-11-25T06:13:51+08:00	1062	3341	4403	345	4748	10706	44.35%	9.92%	9	9
14	屏東縣琉球鄉	2018-11-24T23:16:02+08:00	1062	3341	4403	345	4748	10706	44.35%	9.92%	9	9
14	屏東縣琉球鄉	2018-11-24T23:35:09+08:00	1062	3341	4403	345	4748	10706	44.35%	9.92%	9	9
14	屏東縣琉球鄉	2018-11-25T03:49:50+08:00	1062	3341	4403	345	4748	10706	44.35%	9.92%	9	9
14	屏東縣琉球鄉	2018-11-25T00:14:08+08:00	1062	3341	4403	345	4748	10706	44.35%	9.92%	9	9
14	屏東縣琉球鄉	2018-11-25T00:23:03+08:00	1062	3341	4403	345	4748	10706	44.35%	9.92%	9	9
14	屏東縣琉球鄉	2018-11-24T23:08:35+08:00	1062	3341	4403	345	4748	10706	44.35%	9.92%	9	9
14	屏東縣琉球鄉	2018-11-25T03:32:33+08:00	1062	3341	4403	345	4748	10706	44.35%	9.92%	9	9
14	屏東縣琉球鄉	2018-11-25T01:25:52+08:00	1062	3341	4403	345	4748	10706	44.35%	9.92%	9	9
14	屏東縣琉球鄉	2018-11-24T23:19:49+08:00	1062	3341	4403	345	4748	10706	44.35%	9.92%	9	9
14	屏東縣琉球鄉	2018-11-24T23:27:17+08:00	1062	3341	4403	345	4748	10706	44.35%	9.92%	9	9
14	屏東縣琉球鄉	2018-11-24T22:19:36+08:00	1062	3341	4403	345	4748	10706	44.35%	9.92%	9	9
14	屏東縣琉球鄉	2018-11-25T01:02:29+08:00	1062	3341	4403	345	4748	10706	44.35%	9.92%	9	9
14	屏東縣琉球鄉	2018-11-24T23:51:34+08:00	1062	3341	4403	345	4748	10706	44.35%	9.92%	9	9
14	屏東縣琉球鄉	2018-11-24T22:57:52+08:00	1062	3341	4403	345	4748	10706	44.35%	9.92%	9	9
14	屏東縣琉球鄉	2018-11-25T00:57:36+08:00	1062	3341	4403	345	4748	10706	44.35%	9.92%	9	9
14	屏東縣琉球鄉	2018-11-24T23:05:03+08:00	1062	3341	4403	345	4748	10706	44.35%	9.92%	9	9
14	屏東縣琉球鄉	2018-11-24T22:50:47+08:00	1062	3341	4403	345	4748	10706	44.35%	9.92%	9	9
14	屏東縣琉球鄉	2018-11-25T00:05:04+08:00	1062	3341	4403	345	4748	10706	44.35%	9.92%	9	9
14	屏東縣琉球鄉	2018-11-24T22:41:34+08:00	1062	3341	4403	345	4748	10706	44.35%	9.92%	9	9
14	屏東縣琉球鄉	2018-11-25T01:12:42+08:00	1062	3341	4403	345	4748	10706	44.35%	9.92%	9	9
14	屏東縣琉球鄉	2018-11-24T22:26:36+08:00	1062	3341	4403	345	4748	10706	44.35%	9.92%	9	9
14	屏東縣琉球鄉	2018-11-25T00:18:29+08:00	1062	3341	4403	345	4748	10706	44.35%	9.92%	9	9
14	屏東縣琉球鄉	2018-11-25T06:08:52+08:00	1062	3341	4403	345	4748	10706	44.35%	9.92%	9	9
14	屏東縣琉球鄉	2018-11-24T22:54:25+08:00	1062	3341	4403	345	4748	10706	44.35%	9.92%	9	9
14	嘉義市西區	2018-11-25T06:29:19+08:00	20019	43073	63092	3410	66502	120906	55%	16.56%	96	96
14	嘉義市西區	2018-11-25T01:07:28+08:00	20019	43073	63092	3410	66502	120906	55%	16.56%	96	96
14	嘉義市西區	2018-11-25T03:49:53+08:00	20019	43073	63092	3410	66502	120906	55%	16.56%	96	96
14	嘉義市西區	2018-11-24T22:50:50+08:00	16177	34381	50558	2707	53265	97323	54.73%	16.62%	78	96
14	嘉義市西區	2018-11-25T06:13:54+08:00	20019	43073	63092	3410	66502	120906	55%	16.56%	96	96
14	嘉義市西區	2018-11-24T23:43:19+08:00	18676	40194	58870	3192	62062	113019	54.91%	16.52%	90	96
14	嘉義市西區	2018-11-24T22:13:29+08:00	12571	26448	39019	2027	41046	75021	54.71%	16.76%	62	96
14	嘉義市西區	2018-11-25T03:32:36+08:00	20019	43073	63092	3410	66502	120906	55%	16.56%	96	96
14	嘉義市西區	2018-11-25T00:23:06+08:00	20019	43073	63092	3410	66502	120906	55%	16.56%	96	96
14	嘉義市西區	2018-11-25T03:44:25+08:00	20019	43073	63092	3410	66502	120906	55%	16.56%	96	96
14	嘉義市西區	2018-11-24T23:08:38+08:00	17728	37736	55464	2996	58460	106308	54.99%	16.68%	85	96
14	嘉義市西區	2018-11-24T23:55:49+08:00	19182	41327	60509	3288	63797	116004	55%	16.54%	92	96
14	嘉義市西區	2018-11-25T06:24:02+08:00	20019	43073	63092	3410	66502	120906	55%	16.56%	96	96
14	嘉義市西區	2018-11-24T23:51:37+08:00	19182	41327	60509	3288	63797	116004	55%	16.54%	92	96
14	嘉義市西區	2018-11-24T22:23:15+08:00	13855	29178	43033	2240	45273	82888	54.62%	16.72%	68	96
14	嘉義市西區	2018-11-24T22:40:29+08:00	15641	33125	48766	2633	51399	93924	54.72%	16.65%	76	96
14	嘉義市西區	2018-11-25T06:18:59+08:00	20019	43073	63092	3410	66502	120906	55%	16.56%	96	96
14	嘉義市西區	2018-11-24T22:57:56+08:00	17390	37034	54424	2946	57370	104644	54.82%	16.62%	84	96
14	嘉義市西區	2018-11-24T23:23:40+08:00	18429	39703	58132	3137	61269	111626	54.89%	16.51%	89	96
14	嘉義市西區	2018-11-24T22:33:40+08:00	15183	32164	47347	2523	49870	91269	54.64%	16.64%	74	96
14	嘉義市西區	2018-11-24T22:54:27+08:00	16769	35697	52466	2815	55281	101018	54.72%	16.6%	81	96
14	嘉義市西區	2018-11-24T22:16:13+08:00	13452	28268	41720	2179	43899	80388	54.61%	16.73%	66	96
14	嘉義市西區	2018-11-25T00:14:11+08:00	20019	43073	63092	3410	66502	120906	55%	16.56%	96	96
14	嘉義市西區	2018-11-25T01:12:46+08:00	20019	43073	63092	3410	66502	120906	55%	16.56%	96	96
14	嘉義市西區	2018-11-24T22:41:37+08:00	15641	33125	48766	2633	51399	93924	54.72%	16.65%	76	96
14	嘉義市西區	2018-11-25T00:05:07+08:00	19837	42668	62505	3406	65911	119723	55.05%	16.57%	95	96
14	嘉義市西區	2018-11-24T23:05:06+08:00	17884	38093	55977	3010	58987	107443	54.9%	16.65%	86	96
14	嘉義市西區	2018-11-24T22:45:10+08:00	15930	33813	49743	2661	52404	95778	54.71%	16.63%	77	96
14	嘉義市西區	2018-11-24T23:16:05+08:00	18028	38884	56912	3052	59964	109218	54.9%	16.51%	87	96
14	嘉義市西區	2018-11-24T22:37:02+08:00	15407	32599	48006	2561	50567	92564	54.63%	16.64%	75	96
14	嘉義市西區	2018-11-25T00:18:32+08:00	20019	43073	63092	3410	66502	120906	55%	16.56%	96	96
14	嘉義市西區	2018-11-25T03:56:15+08:00	20019	43073	63092	3410	66502	120906	55%	16.56%	96	96
14	嘉義市西區	2018-11-25T01:25:54+08:00	20019	43073	63092	3410	66502	120906	55%	16.56%	96	96
14	嘉義市西區	2018-11-25T03:38:57+08:00	20019	43073	63092	3410	66502	120906	55%	16.56%	96	96
14	嘉義市西區	2018-11-24T22:30:11+08:00	14762	31221	45983	2419	48402	88591	54.64%	16.66%	72	96
14	嘉義市西區	2018-11-25T01:02:33+08:00	20019	43073	63092	3410	66502	120906	55%	16.56%	96	96
14	嘉義市西區	2018-11-25T00:57:39+08:00	20019	43073	63092	3410	66502	120906	55%	16.56%	96	96
14	嘉義市西區	2018-11-24T23:19:53+08:00	18242	39345	57587	3077	60664	110517	54.89%	16.51%	88	96
14	嘉義市西區	2018-11-25T01:17:55+08:00	20019	43073	63092	3410	66502	120906	55%	16.56%	96	96
14	嘉義市西區	2018-11-24T22:19:39+08:00	13638	28665	42303	2205	44508	81608	54.54%	16.71%	67	96
14	嘉義市西區	2018-11-24T23:27:20+08:00	18429	39703	58132	3137	61269	111626	54.89%	16.51%	89	96
14	嘉義市西區	2018-11-25T00:00:13+08:00	19182	41327	60509	3288	63797	116004	55%	16.54%	92	96
14	嘉義市西區	2018-11-24T23:35:12+08:00	18676	40194	58870	3192	62062	113019	54.91%	16.52%	90	96
14	嘉義市西區	2018-11-24T23:47:30+08:00	18931	40702	59633	3233	62866	114377	54.96%	16.55%	91	96
14	嘉義市西區	2018-11-25T00:09:36+08:00	20019	43073	63092	3410	66502	120906	55%	16.56%	96	96
14	嘉義市西區	2018-11-24T23:01:33+08:00	17390	37034	54424	2946	57370	104644	54.82%	16.62%	84	96
14	嘉義市西區	2018-11-24T23:31:13+08:00	18429	39703	58132	3137	61269	111626	54.89%	16.51%	89	96
14	嘉義市西區	2018-11-25T04:02:54+08:00	20019	43073	63092	3410	66502	120906	55%	16.56%	96	96
14	嘉義市西區	2018-11-24T22:26:38+08:00	14494	30655	45149	2375	47524	86962	54.65%	16.67%	71	96
14	嘉義市西區	2018-11-24T23:12:17+08:00	17728	37736	55464	2996	58460	106308	54.99%	16.68%	85	96
14	嘉義市西區	2018-11-24T23:39:18+08:00	18676	40194	58870	3192	62062	113019	54.91%	16.52%	90	96
14	嘉義市西區	2018-11-25T06:08:55+08:00	20019	43073	63092	3410	66502	120906	55%	16.56%	96	96
14	新竹市	2018-11-25T06:29:19+08:00	65851	124511	190362	8887	199249	351775	56.64%	18.72%	299	299
14	新竹市	2018-11-25T01:07:28+08:00	65851	124511	190362	8887	199249	351775	56.64%	18.72%	299	299
14	新竹市	2018-11-25T03:49:53+08:00	65851	124511	190362	8887	199249	351775	56.64%	18.72%	299	299
14	新竹市	2018-11-24T22:50:50+08:00	40380	75782	116162	5491	121653	214216	56.79%	18.85%	194	299
14	新竹市	2018-11-25T06:13:54+08:00	65851	124511	190362	8887	199249	351775	56.64%	18.72%	299	299
14	新竹市	2018-11-24T23:43:19+08:00	58930	111125	170055	7921	177976	314263	56.63%	18.75%	271	299
14	新竹市	2018-11-24T22:13:29+08:00	30278	57555	87833	4208	92041	163371	56.34%	18.53%	151	299
14	新竹市	2018-11-25T03:32:36+08:00	65851	124511	190362	8887	199249	351775	56.64%	18.72%	299	299
14	新竹市	2018-11-25T03:44:25+08:00	65851	124511	190362	8887	199249	351775	56.64%	18.72%	299	299
14	新竹市	2018-11-24T23:08:38+08:00	47281	89097	136378	6392	142770	252092	56.63%	18.76%	223	299
14	新竹市	2018-11-24T23:55:49+08:00	61644	116209	177853	8269	186122	328922	56.59%	18.74%	282	299
14	新竹市	2018-11-25T06:24:02+08:00	65851	124511	190362	8887	199249	351775	56.64%	18.72%	299	299
14	新竹市	2018-11-24T23:51:37+08:00	61243	115446	176689	8217	184906	326701	56.6%	18.75%	280	299
14	新竹市	2018-11-24T22:23:15+08:00	33016	62246	95262	4515	99777	176828	56.43%	18.67%	162	299
14	新竹市	2018-11-24T22:40:29+08:00	38868	72864	111732	5275	117007	206326	56.71%	18.84%	187	299
14	新竹市	2018-11-25T06:18:59+08:00	65851	124511	190362	8887	199249	351775	56.64%	18.72%	299	299
14	新竹市	2018-11-24T23:23:40+08:00	53484	100781	154265	7196	161461	284778	56.7%	18.78%	248	299
14	新竹市	2018-11-24T22:33:40+08:00	37127	69596	106723	5033	111756	197399	56.61%	18.81%	179	299
14	新竹市	2018-11-24T22:54:27+08:00	41803	78489	120292	5637	125929	222653	56.56%	18.77%	200	299
14	新竹市	2018-11-25T00:14:11+08:00	64883	122590	187473	8753	196226	346640	56.61%	18.72%	295	299
14	新竹市	2018-11-24T22:16:12+08:00	31184	59269	90453	4317	94770	168271	56.32%	18.53%	155	299
14	新竹市	2018-11-24T22:41:37+08:00	38868	72864	111732	5275	117007	206326	56.71%	18.84%	187	299
14	新竹市	2018-11-25T00:05:07+08:00	63669	119974	183643	8561	192204	339821	56.56%	18.74%	290	299
14	新竹市	2018-11-24T23:05:06+08:00	45714	86031	131745	6174	137919	243562	56.63%	18.77%	217	299
14	新竹市	2018-11-24T22:45:10+08:00	39540	74199	113739	5377	119116	209874	56.76%	18.84%	190	299
14	新竹市	2018-11-25T03:56:14+08:00	65851	124511	190362	8887	199249	351775	56.64%	18.72%	299	299
14	新竹市	2018-11-24T22:37:02+08:00	38476	72080	110556	5177	115733	204302	56.65%	18.83%	185	299
14	新竹市	2018-11-25T00:18:32+08:00	65127	123073	188200	8782	196982	347957	56.61%	18.72%	296	299
14	新竹市	2018-11-24T23:16:04+08:00	51315	96391	147706	6870	154576	273125	56.6%	18.79%	239	299
14	新竹市	2018-11-25T00:23:05+08:00	65127	123073	188200	8782	196982	347957	56.61%	18.72%	296	299
14	新竹市	2018-11-25T01:25:54+08:00	65851	124511	190362	8887	199249	351775	56.64%	18.72%	299	299
14	新竹市	2018-11-25T03:38:57+08:00	65851	124511	190362	8887	199249	351775	56.64%	18.72%	299	299
14	新竹市	2018-11-24T22:30:11+08:00	34888	65510	100398	4738	105136	185864	56.57%	18.77%	170	299
14	新竹市	2018-11-25T01:02:33+08:00	65851	124511	190362	8887	199249	351775	56.64%	18.72%	299	299
14	新竹市	2018-11-24T23:19:53+08:00	52272	98286	150558	7009	157567	278271	56.62%	18.78%	243	299
14	新竹市	2018-11-25T00:00:12+08:00	62370	117617	179987	8386	188373	333046	56.56%	18.73%	285	299
14	新竹市	2018-11-25T01:17:55+08:00	65851	124511	190362	8887	199249	351775	56.64%	18.72%	299	299
14	新竹市	2018-11-24T22:57:55+08:00	43697	82296	125993	5872	131865	232759	56.65%	18.77%	208	299
14	新竹市	2018-11-24T22:19:39+08:00	32348	60944	93292	4430	97722	173298	56.39%	18.67%	159	299
14	新竹市	2018-11-24T23:27:20+08:00	54190	102123	156313	7286	163599	288575	56.69%	18.78%	251	299
14	新竹市	2018-11-25T00:57:38+08:00	65851	124511	190362	8887	199249	351775	56.64%	18.72%	299	299
14	新竹市	2018-11-24T23:35:12+08:00	56417	106120	162537	7588	170125	300247	56.66%	18.79%	260	299
14	新竹市	2018-11-24T23:47:30+08:00	59981	113012	172993	8072	181065	319782	56.62%	18.76%	275	299
14	新竹市	2018-11-25T00:09:36+08:00	64340	121597	185937	8692	194629	343863	56.6%	18.71%	293	299
14	新竹市	2018-11-24T23:01:33+08:00	44991	84826	129817	6073	135890	239973	56.63%	18.75%	214	299
14	新竹市	2018-11-24T23:31:13+08:00	55707	104841	160548	7490	168038	296256	56.72%	18.8%	257	299
14	新竹市	2018-11-25T04:02:54+08:00	65851	124511	190362	8887	199249	351775	56.64%	18.72%	299	299
14	新竹市	2018-11-25T01:12:45+08:00	65851	124511	190362	8887	199249	351775	56.64%	18.72%	299	299
14	新竹市	2018-11-24T22:26:38+08:00	33675	63513	97188	4610	101798	180323	56.45%	18.67%	165	299
14	新竹市	2018-11-24T23:12:17+08:00	48178	90766	138944	6504	145448	257006	56.59%	18.75%	227	299
14	新竹市	2018-11-24T23:39:18+08:00	57752	108871	166623	7759	174382	307727	56.67%	18.77%	266	299
14	新竹市	2018-11-25T06:08:55+08:00	65851	124511	190362	8887	199249	351775	56.64%	18.72%	299	299
14	新竹縣寶山鄉	2018-11-25T04:02:44+08:00	2262	4960	7222	347	7569	12973	58.34%	17.44%	12	12
14	新竹縣寶山鄉	2018-11-25T01:12:37+08:00	2262	4960	7222	347	7569	12973	58.34%	17.44%	12	12
14	新竹縣寶山鄉	2018-11-25T00:14:04+08:00	2016	4410	6426	304	6730	11503	58.51%	17.53%	11	12
14	新竹縣寶山鄉	2018-11-24T23:31:05+08:00	1637	3731	5368	261	5629	9603	58.62%	17.05%	10	12
14	新竹縣寶山鄉	2018-11-25T01:07:21+08:00	2262	4960	7222	347	7569	12973	58.34%	17.44%	12	12
14	新竹縣寶山鄉	2018-11-25T06:29:11+08:00	2262	4960	7222	347	7569	12973	58.34%	17.44%	12	12
14	新竹縣寶山鄉	2018-11-25T00:09:28+08:00	2016	4410	6426	304	6730	11503	58.51%	17.53%	11	12
14	新竹縣寶山鄉	2018-11-24T22:23:07+08:00	1236	2942	4178	196	4374	7377	59.29%	16.75%	8	12
14	新竹縣寶山鄉	2018-11-25T00:00:03+08:00	1637	3731	5368	261	5629	9603	58.62%	17.05%	10	12
14	新竹縣寶山鄉	2018-11-24T23:08:30+08:00	1236	2942	4178	196	4374	7377	59.29%	16.75%	8	12
14	新竹縣寶山鄉	2018-11-24T23:19:44+08:00	1637	3731	5368	261	5629	9603	58.62%	17.05%	10	12
14	新竹縣寶山鄉	2018-11-24T22:13:21+08:00	1060	2415	3475	143	3618	6172	58.62%	17.17%	7	12
14	新竹縣寶山鄉	2018-11-25T03:32:30+08:00	2262	4960	7222	347	7569	12973	58.34%	17.44%	12	12
14	新竹縣寶山鄉	2018-11-24T23:51:30+08:00	1637	3731	5368	261	5629	9603	58.62%	17.05%	10	12
14	新竹縣寶山鄉	2018-11-24T22:30:01+08:00	1236	2942	4178	196	4374	7377	59.29%	16.75%	8	12
14	新竹縣寶山鄉	2018-11-24T23:27:14+08:00	1637	3731	5368	261	5629	9603	58.62%	17.05%	10	12
14	新竹縣寶山鄉	2018-11-24T22:19:32+08:00	1236	2942	4178	196	4374	7377	59.29%	16.75%	8	12
14	新竹縣寶山鄉	2018-11-24T22:36:56+08:00	1236	2942	4178	196	4374	7377	59.29%	16.75%	8	12
14	新竹縣寶山鄉	2018-11-25T01:02:25+08:00	2262	4960	7222	347	7569	12973	58.34%	17.44%	12	12
14	新竹縣寶山鄉	2018-11-25T00:18:25+08:00	2016	4410	6426	304	6730	11503	58.51%	17.53%	11	12
14	新竹縣寶山鄉	2018-11-24T23:05:00+08:00	1236	2942	4178	196	4374	7377	59.29%	16.75%	8	12
14	新竹縣寶山鄉	2018-11-24T22:26:32+08:00	1236	2942	4178	196	4374	7377	59.29%	16.75%	8	12
14	新竹縣寶山鄉	2018-11-25T06:13:48+08:00	2262	4960	7222	347	7569	12973	58.34%	17.44%	12	12
14	新竹縣寶山鄉	2018-11-24T22:50:42+08:00	1236	2942	4178	196	4374	7377	59.29%	16.75%	8	12
14	新竹縣寶山鄉	2018-11-24T22:54:21+08:00	1236	2942	4178	196	4374	7377	59.29%	16.75%	8	12
14	新竹縣寶山鄉	2018-11-25T00:05:00+08:00	2016	4410	6426	304	6730	11503	58.51%	17.53%	11	12
14	新竹縣寶山鄉	2018-11-24T22:41:30+08:00	1236	2942	4178	196	4374	7377	59.29%	16.75%	8	12
14	新竹縣寶山鄉	2018-11-25T00:22:59+08:00	2016	4410	6426	304	6730	11503	58.51%	17.53%	11	12
14	新竹縣寶山鄉	2018-11-25T03:49:46+08:00	2262	4960	7222	347	7569	12973	58.34%	17.44%	12	12
14	新竹縣寶山鄉	2018-11-24T22:16:05+08:00	1060	2415	3475	143	3618	6172	58.62%	17.17%	7	12
14	新竹縣寶山鄉	2018-11-24T23:01:26+08:00	1236	2942	4178	196	4374	7377	59.29%	16.75%	8	12
14	新竹縣寶山鄉	2018-11-24T23:43:12+08:00	1637	3731	5368	261	5629	9603	58.62%	17.05%	10	12
14	新竹縣寶山鄉	2018-11-24T22:33:33+08:00	1236	2942	4178	196	4374	7377	59.29%	16.75%	8	12
14	新竹縣寶山鄉	2018-11-25T06:08:47+08:00	2262	4960	7222	347	7569	12973	58.34%	17.44%	12	12
14	新竹縣寶山鄉	2018-11-24T23:35:06+08:00	1637	3731	5368	261	5629	9603	58.62%	17.05%	10	12
14	新竹縣寶山鄉	2018-11-24T23:47:23+08:00	1637	3731	5368	261	5629	9603	58.62%	17.05%	10	12
14	新竹縣寶山鄉	2018-11-24T23:55:42+08:00	1637	3731	5368	261	5629	9603	58.62%	17.05%	10	12
14	新竹縣寶山鄉	2018-11-25T01:17:46+08:00	2262	4960	7222	347	7569	12973	58.34%	17.44%	12	12
14	新竹縣寶山鄉	2018-11-24T22:57:48+08:00	1236	2942	4178	196	4374	7377	59.29%	16.75%	8	12
14	新竹縣寶山鄉	2018-11-25T03:38:50+08:00	2262	4960	7222	347	7569	12973	58.34%	17.44%	12	12
14	新竹縣寶山鄉	2018-11-24T23:23:34+08:00	1637	3731	5368	261	5629	9603	58.62%	17.05%	10	12
14	新竹縣寶山鄉	2018-11-25T03:44:17+08:00	2262	4960	7222	347	7569	12973	58.34%	17.44%	12	12
14	新竹縣寶山鄉	2018-11-25T01:25:48+08:00	2262	4960	7222	347	7569	12973	58.34%	17.44%	12	12
14	新竹縣寶山鄉	2018-11-24T22:40:23+08:00	1236	2942	4178	196	4374	7377	59.29%	16.75%	8	12
14	新竹縣寶山鄉	2018-11-24T23:15:58+08:00	1637	3731	5368	261	5629	9603	58.62%	17.05%	10	12
14	新竹縣寶山鄉	2018-11-25T00:57:31+08:00	2016	4410	6426	304	6730	11503	58.51%	17.53%	11	12
14	新竹縣寶山鄉	2018-11-25T06:18:53+08:00	2262	4960	7222	347	7569	12973	58.34%	17.44%	12	12
14	新竹縣寶山鄉	2018-11-25T03:56:06+08:00	2262	4960	7222	347	7569	12973	58.34%	17.44%	12	12
14	新竹縣寶山鄉	2018-11-25T06:23:55+08:00	2262	4960	7222	347	7569	12973	58.34%	17.44%	12	12
14	新竹縣寶山鄉	2018-11-24T23:39:10+08:00	1637	3731	5368	261	5629	9603	58.62%	17.05%	10	12
14	新竹縣寶山鄉	2018-11-24T22:45:04+08:00	1236	2942	4178	196	4374	7377	59.29%	16.75%	8	12
14	新竹縣寶山鄉	2018-11-24T23:12:10+08:00	1236	2942	4178	196	4374	7377	59.29%	16.75%	8	12
14	新竹縣	2018-11-25T04:02:43+08:00	73718	166893	240611	11635	252246	445051	56.68%	16.56%	404	404
14	新竹縣	2018-11-25T01:12:37+08:00	72794	165099	237893	11542	249435	440224	56.66%	16.54%	401	404
14	新竹縣	2018-11-25T00:14:04+08:00	62329	143643	205972	10293	216265	383573	56.38%	16.25%	360	404
14	新竹縣	2018-11-24T23:31:05+08:00	52920	123248	176168	9025	185193	328649	56.35%	16.1%	319	404
14	新竹縣	2018-11-25T01:07:21+08:00	72552	164552	237104	11524	248628	438718	56.67%	16.54%	400	404
14	新竹縣	2018-11-24T23:35:05+08:00	53245	124039	177284	9109	186393	330720	56.36%	16.1%	321	404
14	新竹縣	2018-11-25T06:29:11+08:00	73718	166893	240611	11635	252246	445051	56.68%	16.56%	404	404
14	新竹縣	2018-11-24T23:39:09+08:00	54788	127512	182300	9323	191623	340219	56.32%	16.1%	327	404
14	新竹縣	2018-11-25T00:09:28+08:00	61996	142867	204863	10214	215077	381435	56.39%	16.25%	358	404
14	新竹縣	2018-11-24T22:23:07+08:00	27894	67760	95654	5268	100922	179896	56.1%	15.51%	193	404
14	新竹縣	2018-11-24T23:08:30+08:00	45834	107701	153535	8101	161636	286899	56.34%	15.98%	285	404
14	新竹縣	2018-11-24T23:19:44+08:00	49528	115585	165113	8626	173739	308072	56.4%	16.08%	302	404
14	新竹縣	2018-11-24T22:13:21+08:00	23051	56886	79937	4489	84426	150012	56.28%	15.37%	167	404
14	新竹縣	2018-11-25T00:00:02+08:00	58377	135288	193665	9798	203463	361093	56.35%	16.17%	343	404
14	新竹縣	2018-11-24T23:27:13+08:00	51166	119359	170525	8840	179365	317759	56.45%	16.1%	310	404
14	新竹縣	2018-11-24T22:19:32+08:00	26482	64842	91324	5085	96409	171465	56.23%	15.44%	186	404
14	新竹縣	2018-11-24T22:36:56+08:00	33343	80936	114279	6265	120544	214428	56.22%	15.55%	223	404
14	新竹縣	2018-11-24T22:30:00+08:00	29358	71005	100363	5498	105861	188485	56.16%	15.58%	200	404
14	新竹縣	2018-11-25T01:02:25+08:00	72258	164116	236374	11498	247872	437506	56.66%	16.52%	399	404
14	新竹縣	2018-11-25T06:13:47+08:00	73718	166893	240611	11635	252246	445051	56.68%	16.56%	404	404
14	新竹縣	2018-11-24T23:05:00+08:00	44807	105339	150146	7956	158102	280854	56.29%	15.95%	280	404
14	新竹縣	2018-11-25T00:22:58+08:00	63787	147076	210863	10498	221361	392364	56.42%	16.26%	366	404
14	新竹縣	2018-11-24T22:26:32+08:00	28326	68690	97016	5317	102333	182457	56.09%	15.52%	195	404
14	新竹縣	2018-11-25T00:18:24+08:00	63074	145420	208494	10377	218871	388259	56.37%	16.25%	363	404
14	新竹縣	2018-11-24T22:50:42+08:00	38410	92006	130416	7035	137451	244846	56.14%	15.69%	249	404
14	新竹縣	2018-11-24T22:54:21+08:00	39615	94870	134485	7265	141750	252216	56.2%	15.71%	256	404
14	新竹縣	2018-11-25T00:05:00+08:00	59951	138440	198391	9948	208339	369514	56.38%	16.22%	349	404
14	新竹縣	2018-11-24T22:41:30+08:00	34726	83590	118316	6433	124749	221876	56.22%	15.65%	229	404
14	新竹縣	2018-11-25T03:49:46+08:00	73718	166893	240611	11635	252246	445051	56.68%	16.56%	404	404
14	新竹縣	2018-11-24T23:01:26+08:00	43599	103015	146614	7816	154430	274451	56.27%	15.89%	274	404
14	新竹縣	2018-11-24T23:43:12+08:00	55486	128918	184404	9400	193804	344160	56.31%	16.12%	330	404
14	新竹縣	2018-11-25T06:08:47+08:00	73718	166893	240611	11635	252246	445051	56.68%	16.56%	404	404
14	新竹縣	2018-11-24T22:16:04+08:00	24778	60798	85576	4742	90318	161214	56.02%	15.37%	177	404
14	新竹縣	2018-11-24T22:33:32+08:00	31195	75437	106632	5811	112443	200312	56.13%	15.57%	210	404
14	新竹縣	2018-11-24T23:47:23+08:00	55728	129553	185281	9457	194738	345813	56.31%	16.12%	331	404
14	新竹縣	2018-11-24T23:55:42+08:00	57686	133829	191515	9677	201192	356896	56.37%	16.16%	340	404
14	新竹縣	2018-11-25T03:44:16+08:00	73718	166893	240611	11635	252246	445051	56.68%	16.56%	404	404
14	新竹縣	2018-11-25T01:17:46+08:00	73140	165659	238799	11566	250365	441869	56.66%	16.55%	402	404
14	新竹縣	2018-11-24T22:57:48+08:00	41848	99152	141000	7555	148555	264250	56.22%	15.84%	266	404
14	新竹縣	2018-11-25T03:38:50+08:00	73718	166893	240611	11635	252246	445051	56.68%	16.56%	404	404
14	新竹縣	2018-11-24T23:23:33+08:00	50412	117666	168078	8720	176798	313395	56.41%	16.09%	306	404
14	新竹縣	2018-11-24T23:51:29+08:00	57084	132514	189598	9595	199193	353346	56.37%	16.16%	337	404
14	新竹縣	2018-11-24T22:40:23+08:00	34726	83590	118316	6433	124749	221876	56.22%	15.65%	229	404
14	新竹縣	2018-11-25T03:32:29+08:00	73718	166893	240611	11635	252246	445051	56.68%	16.56%	404	404
14	新竹縣	2018-11-25T06:18:52+08:00	73718	166893	240611	11635	252246	445051	56.68%	16.56%	404	404
14	新竹縣	2018-11-24T23:15:58+08:00	48693	113585	162278	8473	170751	302784	56.39%	16.08%	298	404
14	新竹縣	2018-11-25T00:57:31+08:00	72012	163566	235578	11455	247033	436036	56.65%	16.52%	398	404
14	新竹縣	2018-11-25T01:25:47+08:00	73140	165659	238799	11566	250365	441869	56.66%	16.55%	402	404
14	新竹縣	2018-11-25T03:56:06+08:00	73718	166893	240611	11635	252246	445051	56.68%	16.56%	404	404
14	新竹縣	2018-11-25T06:23:55+08:00	73718	166893	240611	11635	252246	445051	56.68%	16.56%	404	404
14	新竹縣	2018-11-24T23:12:10+08:00	46497	109229	155726	8207	163933	290991	56.34%	15.98%	288	404
14	新竹縣	2018-11-24T22:45:03+08:00	35937	86637	122574	6659	129233	230273	56.12%	15.61%	237	404
14	基隆市暖暖區	2018-11-24T22:33:39+08:00	4418	8152	12570	530	13100	24623	53.2%	17.94%	22	28
14	基隆市暖暖區	2018-11-24T23:43:18+08:00	5920	11065	16985	713	17698	33225	53.27%	17.82%	28	28
14	基隆市暖暖區	2018-11-25T01:07:28+08:00	5920	11065	16985	713	17698	33225	53.27%	17.82%	28	28
14	基隆市暖暖區	2018-11-25T06:29:18+08:00	5920	11065	16985	713	17698	33225	53.27%	17.82%	28	28
14	基隆市暖暖區	2018-11-25T03:49:53+08:00	5920	11065	16985	713	17698	33225	53.27%	17.82%	28	28
14	基隆市暖暖區	2018-11-24T22:50:50+08:00	5205	9669	14874	624	15498	28899	53.63%	18.01%	25	28
14	基隆市暖暖區	2018-11-25T06:13:54+08:00	5920	11065	16985	713	17698	33225	53.27%	17.82%	28	28
14	基隆市暖暖區	2018-11-24T22:13:29+08:00	3904	7216	11120	482	11602	21635	53.63%	18.04%	20	28
14	基隆市暖暖區	2018-11-25T03:32:36+08:00	5920	11065	16985	713	17698	33225	53.27%	17.82%	28	28
14	基隆市暖暖區	2018-11-24T23:55:48+08:00	5920	11065	16985	713	17698	33225	53.27%	17.82%	28	28
14	基隆市暖暖區	2018-11-25T03:44:25+08:00	5920	11065	16985	713	17698	33225	53.27%	17.82%	28	28
14	基隆市暖暖區	2018-11-24T23:08:38+08:00	5422	10097	15519	654	16173	30224	53.51%	17.94%	26	28
14	基隆市暖暖區	2018-11-25T06:24:02+08:00	5920	11065	16985	713	17698	33225	53.27%	17.82%	28	28
14	基隆市暖暖區	2018-11-24T23:51:37+08:00	5920	11065	16985	713	17698	33225	53.27%	17.82%	28	28
14	基隆市暖暖區	2018-11-24T22:23:15+08:00	3904	7216	11120	482	11602	21635	53.63%	18.04%	20	28
14	基隆市暖暖區	2018-11-24T22:40:29+08:00	4926	9128	14054	600	14654	27399	53.48%	17.98%	24	28
14	基隆市暖暖區	2018-11-25T06:18:59+08:00	5920	11065	16985	713	17698	33225	53.27%	17.82%	28	28
14	基隆市暖暖區	2018-11-24T23:23:40+08:00	5694	10612	16306	682	16988	31794	53.43%	17.91%	27	28
14	基隆市暖暖區	2018-11-24T22:54:27+08:00	5205	9669	14874	624	15498	28899	53.63%	18.01%	25	28
14	基隆市暖暖區	2018-11-25T00:14:11+08:00	5920	11065	16985	713	17698	33225	53.27%	17.82%	28	28
14	基隆市暖暖區	2018-11-25T00:05:06+08:00	5920	11065	16985	713	17698	33225	53.27%	17.82%	28	28
14	基隆市暖暖區	2018-11-24T22:16:12+08:00	3904	7216	11120	482	11602	21635	53.63%	18.04%	20	28
14	基隆市暖暖區	2018-11-24T22:41:37+08:00	4926	9128	14054	600	14654	27399	53.48%	17.98%	24	28
14	基隆市暖暖區	2018-11-24T23:05:06+08:00	5205	9669	14874	624	15498	28899	53.63%	18.01%	25	28
14	基隆市暖暖區	2018-11-24T22:45:10+08:00	5205	9669	14874	624	15498	28899	53.63%	18.01%	25	28
14	基隆市暖暖區	2018-11-25T03:56:14+08:00	5920	11065	16985	713	17698	33225	53.27%	17.82%	28	28
14	基隆市暖暖區	2018-11-24T22:37:02+08:00	4719	8734	13453	583	14036	26226	53.52%	17.99%	23	28
14	基隆市暖暖區	2018-11-25T00:18:32+08:00	5920	11065	16985	713	17698	33225	53.27%	17.82%	28	28
14	基隆市暖暖區	2018-11-24T23:16:04+08:00	5422	10097	15519	654	16173	30224	53.51%	17.94%	26	28
14	基隆市暖暖區	2018-11-25T00:23:05+08:00	5920	11065	16985	713	17698	33225	53.27%	17.82%	28	28
14	基隆市暖暖區	2018-11-25T01:25:54+08:00	5920	11065	16985	713	17698	33225	53.27%	17.82%	28	28
14	基隆市暖暖區	2018-11-24T22:30:11+08:00	4169	7737	11906	515	12421	23245	53.44%	17.94%	21	28
14	基隆市暖暖區	2018-11-25T03:38:56+08:00	5920	11065	16985	713	17698	33225	53.27%	17.82%	28	28
14	基隆市暖暖區	2018-11-25T01:02:33+08:00	5920	11065	16985	713	17698	33225	53.27%	17.82%	28	28
14	基隆市暖暖區	2018-11-24T22:19:38+08:00	3904	7216	11120	482	11602	21635	53.63%	18.04%	20	28
14	基隆市暖暖區	2018-11-24T23:19:53+08:00	5694	10612	16306	682	16988	31794	53.43%	17.91%	27	28
14	基隆市暖暖區	2018-11-25T01:17:54+08:00	5920	11065	16985	713	17698	33225	53.27%	17.82%	28	28
14	基隆市暖暖區	2018-11-25T00:00:12+08:00	5920	11065	16985	713	17698	33225	53.27%	17.82%	28	28
14	基隆市暖暖區	2018-11-24T22:57:55+08:00	5205	9669	14874	624	15498	28899	53.63%	18.01%	25	28
14	基隆市暖暖區	2018-11-24T23:27:20+08:00	5920	11065	16985	713	17698	33225	53.27%	17.82%	28	28
14	基隆市暖暖區	2018-11-25T00:57:38+08:00	5920	11065	16985	713	17698	33225	53.27%	17.82%	28	28
14	基隆市暖暖區	2018-11-24T23:35:12+08:00	5920	11065	16985	713	17698	33225	53.27%	17.82%	28	28
14	基隆市暖暖區	2018-11-24T23:47:30+08:00	5920	11065	16985	713	17698	33225	53.27%	17.82%	28	28
14	基隆市暖暖區	2018-11-25T00:09:36+08:00	5920	11065	16985	713	17698	33225	53.27%	17.82%	28	28
14	基隆市暖暖區	2018-11-24T23:01:33+08:00	5205	9669	14874	624	15498	28899	53.63%	18.01%	25	28
14	基隆市暖暖區	2018-11-24T23:31:13+08:00	5920	11065	16985	713	17698	33225	53.27%	17.82%	28	28
14	基隆市暖暖區	2018-11-25T04:02:54+08:00	5920	11065	16985	713	17698	33225	53.27%	17.82%	28	28
14	基隆市暖暖區	2018-11-25T01:12:45+08:00	5920	11065	16985	713	17698	33225	53.27%	17.82%	28	28
14	基隆市暖暖區	2018-11-24T22:26:38+08:00	4169	7737	11906	515	12421	23245	53.44%	17.94%	21	28
14	基隆市暖暖區	2018-11-24T23:12:17+08:00	5422	10097	15519	654	16173	30224	53.51%	17.94%	26	28
14	基隆市暖暖區	2018-11-24T23:39:18+08:00	5920	11065	16985	713	17698	33225	53.27%	17.82%	28	28
14	基隆市暖暖區	2018-11-25T06:08:55+08:00	5920	11065	16985	713	17698	33225	53.27%	17.82%	28	28
14	南投縣中寮鄉	2018-11-25T01:12:39+08:00	1881	5238	7119	518	7637	13181	57.94%	14.27%	24	24
14	南投縣中寮鄉	2018-11-24T23:16:00+08:00	1881	5238	7119	518	7637	13181	57.94%	14.27%	24	24
14	南投縣中寮鄉	2018-11-25T04:02:45+08:00	1881	5238	7119	518	7637	13181	57.94%	14.27%	24	24
14	南投縣中寮鄉	2018-11-24T22:16:07+08:00	1881	5238	7119	518	7637	13181	57.94%	14.27%	24	24
14	南投縣中寮鄉	2018-11-24T22:23:09+08:00	1881	5238	7119	518	7637	13181	57.94%	14.27%	24	24
14	南投縣中寮鄉	2018-11-25T03:32:31+08:00	1881	5238	7119	518	7637	13181	57.94%	14.27%	24	24
14	南投縣中寮鄉	2018-11-25T00:00:04+08:00	1881	5238	7119	518	7637	13181	57.94%	14.27%	24	24
14	南投縣中寮鄉	2018-11-25T03:38:52+08:00	1881	5238	7119	518	7637	13181	57.94%	14.27%	24	24
14	南投縣中寮鄉	2018-11-25T00:23:00+08:00	1881	5238	7119	518	7637	13181	57.94%	14.27%	24	24
14	南投縣中寮鄉	2018-11-24T22:36:57+08:00	1881	5238	7119	518	7637	13181	57.94%	14.27%	24	24
14	南投縣中寮鄉	2018-11-24T22:57:50+08:00	1881	5238	7119	518	7637	13181	57.94%	14.27%	24	24
14	南投縣中寮鄉	2018-11-25T00:57:33+08:00	1881	5238	7119	518	7637	13181	57.94%	14.27%	24	24
14	南投縣中寮鄉	2018-11-24T23:51:31+08:00	1881	5238	7119	518	7637	13181	57.94%	14.27%	24	24
14	南投縣中寮鄉	2018-11-24T23:27:15+08:00	1881	5238	7119	518	7637	13181	57.94%	14.27%	24	24
14	南投縣中寮鄉	2018-11-24T22:19:34+08:00	1881	5238	7119	518	7637	13181	57.94%	14.27%	24	24
14	南投縣中寮鄉	2018-11-24T22:50:44+08:00	1881	5238	7119	518	7637	13181	57.94%	14.27%	24	24
14	南投縣中寮鄉	2018-11-24T23:12:12+08:00	1881	5238	7119	518	7637	13181	57.94%	14.27%	24	24
14	南投縣中寮鄉	2018-11-25T06:13:49+08:00	1881	5238	7119	518	7637	13181	57.94%	14.27%	24	24
14	南投縣中寮鄉	2018-11-24T22:26:34+08:00	1881	5238	7119	518	7637	13181	57.94%	14.27%	24	24
14	南投縣中寮鄉	2018-11-25T06:23:57+08:00	1881	5238	7119	518	7637	13181	57.94%	14.27%	24	24
14	南投縣中寮鄉	2018-11-24T23:39:12+08:00	1881	5238	7119	518	7637	13181	57.94%	14.27%	24	24
14	南投縣中寮鄉	2018-11-25T03:49:48+08:00	1881	5238	7119	518	7637	13181	57.94%	14.27%	24	24
14	南投縣中寮鄉	2018-11-24T23:05:01+08:00	1881	5238	7119	518	7637	13181	57.94%	14.27%	24	24
14	南投縣中寮鄉	2018-11-24T23:01:28+08:00	1881	5238	7119	518	7637	13181	57.94%	14.27%	24	24
14	南投縣中寮鄉	2018-11-24T23:47:25+08:00	1881	5238	7119	518	7637	13181	57.94%	14.27%	24	24
14	南投縣中寮鄉	2018-11-25T06:29:13+08:00	1881	5238	7119	518	7637	13181	57.94%	14.27%	24	24
14	南投縣中寮鄉	2018-11-24T23:35:07+08:00	1881	5238	7119	518	7637	13181	57.94%	14.27%	24	24
14	南投縣中寮鄉	2018-11-24T22:33:34+08:00	1881	5238	7119	518	7637	13181	57.94%	14.27%	24	24
14	南投縣中寮鄉	2018-11-25T01:07:23+08:00	1881	5238	7119	518	7637	13181	57.94%	14.27%	24	24
14	南投縣中寮鄉	2018-11-24T23:43:14+08:00	1783	4973	6756	500	7256	12567	57.74%	14.19%	23	24
14	南投縣中寮鄉	2018-11-24T23:31:07+08:00	1881	5238	7119	518	7637	13181	57.94%	14.27%	24	24
14	南投縣中寮鄉	2018-11-25T06:08:49+08:00	1881	5238	7119	518	7637	13181	57.94%	14.27%	24	24
14	南投縣中寮鄉	2018-11-25T00:14:06+08:00	1881	5238	7119	518	7637	13181	57.94%	14.27%	24	24
14	南投縣中寮鄉	2018-11-24T23:23:35+08:00	1881	5238	7119	518	7637	13181	57.94%	14.27%	24	24
14	南投縣中寮鄉	2018-11-24T22:13:23+08:00	1881	5238	7119	518	7637	13181	57.94%	14.27%	24	24
14	南投縣中寮鄉	2018-11-25T01:17:48+08:00	1881	5238	7119	518	7637	13181	57.94%	14.27%	24	24
14	南投縣中寮鄉	2018-11-24T23:55:43+08:00	1881	5238	7119	518	7637	13181	57.94%	14.27%	24	24
14	南投縣中寮鄉	2018-11-24T23:08:32+08:00	1881	5238	7119	518	7637	13181	57.94%	14.27%	24	24
14	南投縣中寮鄉	2018-11-24T23:19:47+08:00	1881	5238	7119	518	7637	13181	57.94%	14.27%	24	24
14	南投縣中寮鄉	2018-11-25T03:44:19+08:00	1881	5238	7119	518	7637	13181	57.94%	14.27%	24	24
14	南投縣中寮鄉	2018-11-25T01:02:27+08:00	1881	5238	7119	518	7637	13181	57.94%	14.27%	24	24
14	南投縣中寮鄉	2018-11-24T22:40:25+08:00	1881	5238	7119	518	7637	13181	57.94%	14.27%	24	24
14	南投縣中寮鄉	2018-11-24T22:30:03+08:00	1881	5238	7119	518	7637	13181	57.94%	14.27%	24	24
14	南投縣中寮鄉	2018-11-25T01:25:49+08:00	1881	5238	7119	518	7637	13181	57.94%	14.27%	24	24
14	南投縣中寮鄉	2018-11-25T06:18:54+08:00	1881	5238	7119	518	7637	13181	57.94%	14.27%	24	24
14	南投縣中寮鄉	2018-11-25T03:56:08+08:00	1881	5238	7119	518	7637	13181	57.94%	14.27%	24	24
14	南投縣中寮鄉	2018-11-25T00:05:02+08:00	1881	5238	7119	518	7637	13181	57.94%	14.27%	24	24
14	南投縣中寮鄉	2018-11-24T22:41:32+08:00	1881	5238	7119	518	7637	13181	57.94%	14.27%	24	24
14	南投縣中寮鄉	2018-11-25T00:09:31+08:00	1749	4826	6575	487	7062	12191	57.93%	14.35%	23	24
14	南投縣中寮鄉	2018-11-24T22:54:23+08:00	1881	5238	7119	518	7637	13181	57.94%	14.27%	24	24
14	南投縣中寮鄉	2018-11-24T22:45:05+08:00	1881	5238	7119	518	7637	13181	57.94%	14.27%	24	24
14	南投縣中寮鄉	2018-11-25T00:18:26+08:00	1881	5238	7119	518	7637	13181	57.94%	14.27%	24	24
14	雲林縣元長鄉	2018-11-24T23:47:26+08:00	2580	6422	9002	848	9850	22830	43.14%	11.3%	25	25
14	雲林縣元長鄉	2018-11-24T23:16:00+08:00	2580	6422	9002	848	9850	22830	43.14%	11.3%	25	25
14	雲林縣元長鄉	2018-11-24T22:16:07+08:00	2580	6422	9002	848	9850	22830	43.14%	11.3%	25	25
14	雲林縣元長鄉	2018-11-25T01:25:50+08:00	2580	6422	9002	848	9850	22830	43.14%	11.3%	25	25
14	雲林縣元長鄉	2018-11-25T03:38:53+08:00	2580	6422	9002	848	9850	22830	43.14%	11.3%	25	25
14	雲林縣元長鄉	2018-11-25T00:23:01+08:00	2580	6422	9002	848	9850	22830	43.14%	11.3%	25	25
14	雲林縣元長鄉	2018-11-24T23:23:36+08:00	2580	6422	9002	848	9850	22830	43.14%	11.3%	25	25
14	雲林縣元長鄉	2018-11-25T00:57:34+08:00	2580	6422	9002	848	9850	22830	43.14%	11.3%	25	25
14	雲林縣元長鄉	2018-11-24T22:36:58+08:00	2580	6422	9002	848	9850	22830	43.14%	11.3%	25	25
14	雲林縣元長鄉	2018-11-24T22:57:51+08:00	2580	6422	9002	848	9850	22830	43.14%	11.3%	25	25
14	雲林縣元長鄉	2018-11-24T22:19:34+08:00	2580	6422	9002	848	9850	22830	43.14%	11.3%	25	25
14	雲林縣元長鄉	2018-11-24T22:45:06+08:00	2580	6422	9002	848	9850	22830	43.14%	11.3%	25	25
14	雲林縣元長鄉	2018-11-25T06:08:50+08:00	2580	6422	9002	848	9850	22830	43.14%	11.3%	25	25
14	雲林縣元長鄉	2018-11-25T06:23:58+08:00	2580	6422	9002	848	9850	22830	43.14%	11.3%	25	25
14	雲林縣元長鄉	2018-11-25T01:12:40+08:00	2580	6422	9002	848	9850	22830	43.14%	11.3%	25	25
14	雲林縣元長鄉	2018-11-24T22:26:34+08:00	2580	6422	9002	848	9850	22830	43.14%	11.3%	25	25
14	雲林縣元長鄉	2018-11-25T03:49:49+08:00	2580	6422	9002	848	9850	22830	43.14%	11.3%	25	25
14	雲林縣元長鄉	2018-11-24T23:39:12+08:00	2580	6422	9002	848	9850	22830	43.14%	11.3%	25	25
14	雲林縣元長鄉	2018-11-24T22:50:45+08:00	2580	6422	9002	848	9850	22830	43.14%	11.3%	25	25
14	雲林縣元長鄉	2018-11-24T23:12:13+08:00	2580	6422	9002	848	9850	22830	43.14%	11.3%	25	25
14	雲林縣元長鄉	2018-11-24T23:31:08+08:00	2580	6422	9002	848	9850	22830	43.14%	11.3%	25	25
14	雲林縣元長鄉	2018-11-24T23:43:15+08:00	2580	6422	9002	848	9850	22830	43.14%	11.3%	25	25
14	雲林縣元長鄉	2018-11-24T23:01:28+08:00	2580	6422	9002	848	9850	22830	43.14%	11.3%	25	25
14	雲林縣元長鄉	2018-11-25T06:29:14+08:00	2580	6422	9002	848	9850	22830	43.14%	11.3%	25	25
14	雲林縣元長鄉	2018-11-25T00:14:07+08:00	2580	6422	9002	848	9850	22830	43.14%	11.3%	25	25
14	雲林縣元長鄉	2018-11-25T04:02:49+08:00	2580	6422	9002	848	9850	22830	43.14%	11.3%	25	25
14	雲林縣元長鄉	2018-11-25T01:07:23+08:00	2580	6422	9002	848	9850	22830	43.14%	11.3%	25	25
14	雲林縣元長鄉	2018-11-25T06:13:50+08:00	2580	6422	9002	848	9850	22830	43.14%	11.3%	25	25
14	雲林縣元長鄉	2018-11-24T23:35:08+08:00	2580	6422	9002	848	9850	22830	43.14%	11.3%	25	25
14	雲林縣元長鄉	2018-11-24T22:33:35+08:00	2580	6422	9002	848	9850	22830	43.14%	11.3%	25	25
14	雲林縣元長鄉	2018-11-24T23:08:33+08:00	2580	6422	9002	848	9850	22830	43.14%	11.3%	25	25
14	雲林縣元長鄉	2018-11-25T03:32:32+08:00	2580	6422	9002	848	9850	22830	43.14%	11.3%	25	25
14	雲林縣元長鄉	2018-11-25T03:44:20+08:00	2580	6422	9002	848	9850	22830	43.14%	11.3%	25	25
14	雲林縣元長鄉	2018-11-24T22:13:24+08:00	2408	5963	8371	817	9188	21303	43.13%	11.3%	24	25
14	雲林縣元長鄉	2018-11-25T00:00:08+08:00	2580	6422	9002	848	9850	22830	43.14%	11.3%	25	25
14	雲林縣元長鄉	2018-11-24T23:55:44+08:00	2580	6422	9002	848	9850	22830	43.14%	11.3%	25	25
14	雲林縣元長鄉	2018-11-25T01:17:49+08:00	2580	6422	9002	848	9850	22830	43.14%	11.3%	25	25
14	雲林縣元長鄉	2018-11-24T23:19:47+08:00	2580	6422	9002	848	9850	22830	43.14%	11.3%	25	25
14	雲林縣元長鄉	2018-11-25T06:18:55+08:00	2580	6422	9002	848	9850	22830	43.14%	11.3%	25	25
14	雲林縣元長鄉	2018-11-25T01:02:28+08:00	2580	6422	9002	848	9850	22830	43.14%	11.3%	25	25
14	雲林縣元長鄉	2018-11-24T23:27:16+08:00	2580	6422	9002	848	9850	22830	43.14%	11.3%	25	25
14	雲林縣元長鄉	2018-11-24T22:40:25+08:00	2580	6422	9002	848	9850	22830	43.14%	11.3%	25	25
14	雲林縣元長鄉	2018-11-24T22:23:10+08:00	2580	6422	9002	848	9850	22830	43.14%	11.3%	25	25
14	雲林縣元長鄉	2018-11-24T22:30:03+08:00	2580	6422	9002	848	9850	22830	43.14%	11.3%	25	25
14	雲林縣元長鄉	2018-11-24T23:51:32+08:00	2580	6422	9002	848	9850	22830	43.14%	11.3%	25	25
14	雲林縣元長鄉	2018-11-25T00:05:02+08:00	2580	6422	9002	848	9850	22830	43.14%	11.3%	25	25
14	雲林縣元長鄉	2018-11-24T22:41:32+08:00	2580	6422	9002	848	9850	22830	43.14%	11.3%	25	25
14	雲林縣元長鄉	2018-11-25T00:09:31+08:00	2580	6422	9002	848	9850	22830	43.14%	11.3%	25	25
14	雲林縣元長鄉	2018-11-24T22:54:23+08:00	2580	6422	9002	848	9850	22830	43.14%	11.3%	25	25
14	雲林縣元長鄉	2018-11-24T23:05:02+08:00	2580	6422	9002	848	9850	22830	43.14%	11.3%	25	25
14	雲林縣元長鄉	2018-11-25T03:56:09+08:00	2580	6422	9002	848	9850	22830	43.14%	11.3%	25	25
14	雲林縣元長鄉	2018-11-25T00:18:27+08:00	2580	6422	9002	848	9850	22830	43.14%	11.3%	25	25
14	雲林縣古坑鄉	2018-11-24T23:16:00+08:00	3445	8581	12026	938	12964	24536	52.84%	14.04%	25	27
14	雲林縣古坑鄉	2018-11-24T22:16:07+08:00	2437	6189	8626	684	9310	17894	52.03%	13.62%	19	27
14	雲林縣古坑鄉	2018-11-25T01:25:50+08:00	3823	9653	13476	1066	14542	27477	52.92%	13.91%	27	27
14	雲林縣古坑鄉	2018-11-25T00:23:01+08:00	3823	9653	13476	1066	14542	27477	52.92%	13.91%	27	27
14	雲林縣古坑鄉	2018-11-25T03:38:52+08:00	3823	9653	13476	1066	14542	27477	52.92%	13.91%	27	27
14	雲林縣古坑鄉	2018-11-24T22:57:50+08:00	3445	8581	12026	938	12964	24536	52.84%	14.04%	25	27
14	雲林縣古坑鄉	2018-11-25T00:57:33+08:00	3823	9653	13476	1066	14542	27477	52.92%	13.91%	27	27
14	雲林縣古坑鄉	2018-11-24T22:36:58+08:00	2608	6593	9201	734	9935	19020	52.23%	13.71%	20	27
14	雲林縣古坑鄉	2018-11-24T22:19:34+08:00	2437	6189	8626	684	9310	17894	52.03%	13.62%	19	27
14	雲林縣古坑鄉	2018-11-24T22:45:06+08:00	2782	7106	9888	772	10660	20322	52.46%	13.69%	21	27
14	雲林縣古坑鄉	2018-11-25T06:13:49+08:00	3823	9653	13476	1066	14542	27477	52.92%	13.91%	27	27
14	雲林縣古坑鄉	2018-11-25T01:12:40+08:00	3823	9653	13476	1066	14542	27477	52.92%	13.91%	27	27
14	雲林縣古坑鄉	2018-11-24T22:26:34+08:00	2437	6189	8626	684	9310	17894	52.03%	13.62%	19	27
14	雲林縣古坑鄉	2018-11-25T06:23:57+08:00	3823	9653	13476	1066	14542	27477	52.92%	13.91%	27	27
14	雲林縣古坑鄉	2018-11-24T23:39:12+08:00	3445	8581	12026	938	12964	24536	52.84%	14.04%	25	27
14	雲林縣古坑鄉	2018-11-24T22:50:45+08:00	2929	7431	10360	805	11165	21320	52.37%	13.74%	22	27
14	雲林縣古坑鄉	2018-11-24T23:12:13+08:00	3445	8581	12026	938	12964	24536	52.84%	14.04%	25	27
14	雲林縣古坑鄉	2018-11-25T03:49:48+08:00	3823	9653	13476	1066	14542	27477	52.92%	13.91%	27	27
14	雲林縣古坑鄉	2018-11-24T23:31:08+08:00	3445	8581	12026	938	12964	24536	52.84%	14.04%	25	27
14	雲林縣古坑鄉	2018-11-24T23:01:28+08:00	3445	8581	12026	938	12964	24536	52.84%	14.04%	25	27
14	雲林縣古坑鄉	2018-11-24T23:47:25+08:00	3683	9189	12872	986	13858	26308	52.68%	14%	26	27
14	雲林縣古坑鄉	2018-11-25T06:29:14+08:00	3823	9653	13476	1066	14542	27477	52.92%	13.91%	27	27
14	雲林縣古坑鄉	2018-11-24T23:35:07+08:00	3445	8581	12026	938	12964	24536	52.84%	14.04%	25	27
14	雲林縣古坑鄉	2018-11-25T01:07:23+08:00	3823	9653	13476	1066	14542	27477	52.92%	13.91%	27	27
14	雲林縣古坑鄉	2018-11-24T23:43:14+08:00	3683	9189	12872	986	13858	26308	52.68%	14%	26	27
14	雲林縣古坑鄉	2018-11-25T06:08:49+08:00	3823	9653	13476	1066	14542	27477	52.92%	13.91%	27	27
14	雲林縣古坑鄉	2018-11-24T22:33:35+08:00	2608	6593	9201	734	9935	19020	52.23%	13.71%	20	27
14	雲林縣古坑鄉	2018-11-25T00:14:06+08:00	3823	9653	13476	1066	14542	27477	52.92%	13.91%	27	27
14	雲林縣古坑鄉	2018-11-25T04:02:48+08:00	3823	9653	13476	1066	14542	27477	52.92%	13.91%	27	27
14	雲林縣古坑鄉	2018-11-25T00:00:07+08:00	3823	9653	13476	1066	14542	27477	52.92%	13.91%	27	27
14	雲林縣古坑鄉	2018-11-24T23:08:33+08:00	3445	8581	12026	938	12964	24536	52.84%	14.04%	25	27
14	雲林縣古坑鄉	2018-11-25T03:32:32+08:00	3823	9653	13476	1066	14542	27477	52.92%	13.91%	27	27
14	雲林縣古坑鄉	2018-11-24T23:23:35+08:00	3445	8581	12026	938	12964	24536	52.84%	14.04%	25	27
14	雲林縣古坑鄉	2018-11-25T01:17:48+08:00	3823	9653	13476	1066	14542	27477	52.92%	13.91%	27	27
14	雲林縣古坑鄉	2018-11-24T22:13:24+08:00	2437	6189	8626	684	9310	17894	52.03%	13.62%	19	27
14	雲林縣古坑鄉	2018-11-24T23:55:44+08:00	3823	9653	13476	1066	14542	27477	52.92%	13.91%	27	27
14	雲林縣古坑鄉	2018-11-24T23:19:47+08:00	3445	8581	12026	938	12964	24536	52.84%	14.04%	25	27
14	雲林縣古坑鄉	2018-11-25T03:44:19+08:00	3823	9653	13476	1066	14542	27477	52.92%	13.91%	27	27
14	雲林縣古坑鄉	2018-11-25T01:02:27+08:00	3823	9653	13476	1066	14542	27477	52.92%	13.91%	27	27
14	雲林縣古坑鄉	2018-11-24T23:27:16+08:00	3445	8581	12026	938	12964	24536	52.84%	14.04%	25	27
14	雲林縣古坑鄉	2018-11-24T22:40:25+08:00	2782	7106	9888	772	10660	20322	52.46%	13.69%	21	27
14	雲林縣古坑鄉	2018-11-24T22:23:10+08:00	2437	6189	8626	684	9310	17894	52.03%	13.62%	19	27
14	雲林縣古坑鄉	2018-11-24T22:30:03+08:00	2437	6189	8626	684	9310	17894	52.03%	13.62%	19	27
14	雲林縣古坑鄉	2018-11-25T06:18:54+08:00	3823	9653	13476	1066	14542	27477	52.92%	13.91%	27	27
14	雲林縣古坑鄉	2018-11-24T23:51:32+08:00	3823	9653	13476	1066	14542	27477	52.92%	13.91%	27	27
14	雲林縣古坑鄉	2018-11-25T00:05:02+08:00	3823	9653	13476	1066	14542	27477	52.92%	13.91%	27	27
14	雲林縣古坑鄉	2018-11-24T22:41:32+08:00	2782	7106	9888	772	10660	20322	52.46%	13.69%	21	27
14	雲林縣古坑鄉	2018-11-25T00:09:31+08:00	3823	9653	13476	1066	14542	27477	52.92%	13.91%	27	27
14	雲林縣古坑鄉	2018-11-24T22:54:23+08:00	3126	7845	10971	847	11818	22398	52.76%	13.96%	23	27
14	雲林縣古坑鄉	2018-11-24T23:05:02+08:00	3445	8581	12026	938	12964	24536	52.84%	14.04%	25	27
14	雲林縣古坑鄉	2018-11-25T03:56:09+08:00	3823	9653	13476	1066	14542	27477	52.92%	13.91%	27	27
14	雲林縣古坑鄉	2018-11-25T00:18:27+08:00	3823	9653	13476	1066	14542	27477	52.92%	13.91%	27	27
14	臺南市關廟區	2018-11-24T23:35:04+08:00	4616	10284	14900	1039	15939	29913	53.28%	15.43%	32	32
14	臺南市關廟區	2018-11-24T23:47:21+08:00	4616	10284	14900	1039	15939	29913	53.28%	15.43%	32	32
14	臺南市關廟區	2018-11-25T06:08:45+08:00	4616	10284	14900	1039	15939	29913	53.28%	15.43%	32	32
14	臺南市關廟區	2018-11-25T01:07:19+08:00	4616	10284	14900	1039	15939	29913	53.28%	15.43%	32	32
14	臺南市關廟區	2018-11-24T22:33:31+08:00	4616	10284	14900	1039	15939	29913	53.28%	15.43%	32	32
14	臺南市關廟區	2018-11-25T00:14:02+08:00	4616	10284	14900	1039	15939	29913	53.28%	15.43%	32	32
14	臺南市關廟區	2018-11-25T04:02:42+08:00	4616	10284	14900	1039	15939	29913	53.28%	15.43%	32	32
14	臺南市關廟區	2018-11-24T23:43:10+08:00	4616	10284	14900	1039	15939	29913	53.28%	15.43%	32	32
14	臺南市關廟區	2018-11-25T00:09:26+08:00	4616	10284	14900	1039	15939	29913	53.28%	15.43%	32	32
14	臺南市關廟區	2018-11-24T23:12:08+08:00	4616	10284	14900	1039	15939	29913	53.28%	15.43%	32	32
14	臺南市關廟區	2018-11-24T23:39:07+08:00	4616	10284	14900	1039	15939	29913	53.28%	15.43%	32	32
14	臺南市關廟區	2018-11-24T23:31:03+08:00	4616	10284	14900	1039	15939	29913	53.28%	15.43%	32	32
14	臺南市關廟區	2018-11-24T23:01:24+08:00	4616	10284	14900	1039	15939	29913	53.28%	15.43%	32	32
14	臺南市關廟區	2018-11-24T23:19:42+08:00	4616	10284	14900	1039	15939	29913	53.28%	15.43%	32	32
14	臺南市關廟區	2018-11-25T00:04:58+08:00	4616	10284	14900	1039	15939	29913	53.28%	15.43%	32	32
14	臺南市關廟區	2018-11-24T23:04:57+08:00	4616	10284	14900	1039	15939	29913	53.28%	15.43%	32	32
14	臺南市關廟區	2018-11-25T00:57:29+08:00	4616	10284	14900	1039	15939	29913	53.28%	15.43%	32	32
14	臺南市關廟區	2018-11-24T22:13:19+08:00	4616	10284	14900	1039	15939	29913	53.28%	15.43%	32	32
14	臺南市關廟區	2018-11-25T03:44:14+08:00	4616	10284	14900	1039	15939	29913	53.28%	15.43%	32	32
14	臺南市關廟區	2018-11-25T01:17:43+08:00	4616	10284	14900	1039	15939	29913	53.28%	15.43%	32	32
14	臺南市關廟區	2018-11-24T23:55:40+08:00	4616	10284	14900	1039	15939	29913	53.28%	15.43%	32	32
14	臺南市關廟區	2018-11-25T06:18:51+08:00	4616	10284	14900	1039	15939	29913	53.28%	15.43%	32	32
14	臺南市關廟區	2018-11-25T01:02:23+08:00	4616	10284	14900	1039	15939	29913	53.28%	15.43%	32	32
14	臺南市關廟區	2018-11-25T01:25:45+08:00	4616	10284	14900	1039	15939	29913	53.28%	15.43%	32	32
14	臺南市關廟區	2018-11-25T03:38:48+08:00	4616	10284	14900	1039	15939	29913	53.28%	15.43%	32	32
14	臺南市關廟區	2018-11-24T23:27:12+08:00	4616	10284	14900	1039	15939	29913	53.28%	15.43%	32	32
14	臺南市關廟區	2018-11-25T00:18:23+08:00	4616	10284	14900	1039	15939	29913	53.28%	15.43%	32	32
14	臺南市關廟區	2018-11-24T22:54:19+08:00	4616	10284	14900	1039	15939	29913	53.28%	15.43%	32	32
14	臺南市關廟區	2018-11-25T06:13:46+08:00	4616	10284	14900	1039	15939	29913	53.28%	15.43%	32	32
14	臺南市關廟區	2018-11-25T00:22:57+08:00	4616	10284	14900	1039	15939	29913	53.28%	15.43%	32	32
14	臺南市關廟區	2018-11-25T03:56:04+08:00	4616	10284	14900	1039	15939	29913	53.28%	15.43%	32	32
14	臺南市關廟區	2018-11-24T22:41:29+08:00	4616	10284	14900	1039	15939	29913	53.28%	15.43%	32	32
14	臺南市關廟區	2018-11-24T22:16:03+08:00	4616	10284	14900	1039	15939	29913	53.28%	15.43%	32	32
14	臺南市關廟區	2018-11-25T01:12:35+08:00	4616	10284	14900	1039	15939	29913	53.28%	15.43%	32	32
14	臺南市關廟區	2018-11-24T22:29:59+08:00	4616	10284	14900	1039	15939	29913	53.28%	15.43%	32	32
14	臺南市關廟區	2018-11-24T23:23:32+08:00	4616	10284	14900	1039	15939	29913	53.28%	15.43%	32	32
14	臺南市關廟區	2018-11-24T23:51:28+08:00	4616	10284	14900	1039	15939	29913	53.28%	15.43%	32	32
14	臺南市關廟區	2018-11-24T22:57:46+08:00	4616	10284	14900	1039	15939	29913	53.28%	15.43%	32	32
14	臺南市關廟區	2018-11-25T00:00:01+08:00	4616	10284	14900	1039	15939	29913	53.28%	15.43%	32	32
14	臺南市關廟區	2018-11-24T22:23:05+08:00	4616	10284	14900	1039	15939	29913	53.28%	15.43%	32	32
14	臺南市關廟區	2018-11-24T22:36:54+08:00	4616	10284	14900	1039	15939	29913	53.28%	15.43%	32	32
14	臺南市關廟區	2018-11-24T23:15:56+08:00	4616	10284	14900	1039	15939	29913	53.28%	15.43%	32	32
14	臺南市關廟區	2018-11-24T23:08:28+08:00	4616	10284	14900	1039	15939	29913	53.28%	15.43%	32	32
14	臺南市關廟區	2018-11-25T03:32:27+08:00	4616	10284	14900	1039	15939	29913	53.28%	15.43%	32	32
14	臺南市關廟區	2018-11-24T22:40:22+08:00	4616	10284	14900	1039	15939	29913	53.28%	15.43%	32	32
14	臺南市關廟區	2018-11-24T22:19:30+08:00	4616	10284	14900	1039	15939	29913	53.28%	15.43%	32	32
14	臺南市關廟區	2018-11-24T22:45:02+08:00	4616	10284	14900	1039	15939	29913	53.28%	15.43%	32	32
14	臺南市關廟區	2018-11-24T22:50:40+08:00	4616	10284	14900	1039	15939	29913	53.28%	15.43%	32	32
14	臺南市關廟區	2018-11-25T03:49:45+08:00	4616	10284	14900	1039	15939	29913	53.28%	15.43%	32	32
14	臺南市關廟區	2018-11-25T06:29:09+08:00	4616	10284	14900	1039	15939	29913	53.28%	15.43%	32	32
14	臺南市關廟區	2018-11-25T06:23:53+08:00	4616	10284	14900	1039	15939	29913	53.28%	15.43%	32	32
14	臺南市關廟區	2018-11-24T22:26:31+08:00	4616	10284	14900	1039	15939	29913	53.28%	15.43%	32	32
14	臺北市中正區	2018-11-24T23:47:17+08:00	21794	36840	58634	2521	61155	104024	58.79%	20.95%	79	96
14	臺北市中正區	2018-11-24T22:26:28+08:00	14672	24633	39305	1694	40999	70215	58.39%	20.9%	55	96
14	臺北市中正區	2018-11-24T22:50:35+08:00	16808	28193	45001	1957	46958	80298	58.48%	20.93%	62	96
14	臺北市中正區	2018-11-25T01:12:31+08:00	26803	45286	72089	3086	75175	128292	58.6%	20.89%	96	96
14	臺北市中正區	2018-11-25T01:07:16+08:00	26803	45286	72089	3086	75175	128292	58.6%	20.89%	96	96
14	臺北市中正區	2018-11-24T22:19:27+08:00	13709	23032	36741	1565	38306	65590	58.4%	20.9%	52	96
14	臺北市中正區	2018-11-24T22:13:16+08:00	12934	21807	34741	1496	36237	62229	58.23%	20.78%	49	96
14	臺北市中正區	2018-11-24T22:57:42+08:00	17057	28592	45649	1998	47647	81481	58.48%	20.93%	63	96
14	臺北市中正區	2018-11-25T00:57:26+08:00	26803	45286	72089	3086	75175	128292	58.6%	20.89%	96	96
14	臺北市中正區	2018-11-24T23:51:25+08:00	21794	36840	58634	2521	61155	104024	58.79%	20.95%	79	96
14	臺北市中正區	2018-11-24T22:29:54+08:00	14933	25044	39977	1730	41707	71384	58.43%	20.92%	56	96
14	臺北市中正區	2018-11-24T23:27:09+08:00	20952	35337	56289	2393	58682	99863	58.76%	20.98%	76	96
14	臺北市中正區	2018-11-24T22:44:59+08:00	16450	27665	44115	1925	46040	78747	58.47%	20.89%	61	96
14	臺北市中正區	2018-11-24T22:23:01+08:00	14367	24147	38514	1662	40176	68804	58.39%	20.88%	54	96
14	臺北市中正區	2018-11-24T23:51:24+08:00	21794	36840	58634	2521	61155	104024	58.79%	20.95%	79	96
14	臺北市中正區	2018-11-24T23:15:52+08:00	20636	34790	55426	2364	57790	98419	58.72%	20.97%	75	96
14	臺北市中正區	2018-11-25T03:32:24+08:00	26803	45286	72089	3086	75175	128292	58.6%	20.89%	96	96
14	臺北市中正區	2018-11-25T03:38:46+08:00	26803	45286	72089	3086	75175	128292	58.6%	20.89%	96	96
14	臺北市中正區	2018-11-25T01:25:42+08:00	26803	45286	72089	3086	75175	128292	58.6%	20.89%	96	96
14	臺北市中正區	2018-11-24T23:55:36+08:00	23153	39212	62365	2698	65063	111139	58.54%	20.83%	84	96
14	臺北市中正區	2018-11-24T22:40:18+08:00	16450	27665	44115	1925	46040	78747	58.47%	20.89%	61	96
14	臺北市中正區	2018-11-24T23:08:24+08:00	19252	32245	51497	2226	53723	91749	58.55%	20.98%	70	96
14	臺北市中正區	2018-11-24T23:15:53+08:00	20636	34790	55426	2364	57790	98419	58.72%	20.97%	75	96
14	臺北市中正區	2018-11-24T23:59:57+08:00	23768	40245	64013	2751	66764	114047	58.54%	20.84%	86	96
14	臺北市中正區	2018-11-24T22:40:19+08:00	16450	27665	44115	1925	46040	78747	58.47%	20.89%	61	96
14	臺北市中正區	2018-11-24T23:55:37+08:00	23153	39212	62365	2698	65063	111139	58.54%	20.83%	84	96
14	臺北市中正區	2018-11-25T00:13:59+08:00	24044	40692	64736	2799	67535	115357	58.54%	20.84%	87	96
14	臺北市中正區	2018-11-24T22:36:51+08:00	15535	26143	41678	1821	43499	74325	58.53%	20.9%	58	96
14	臺北市中正區	2018-11-24T22:54:16+08:00	16808	28193	45001	1957	46958	80298	58.48%	20.93%	62	96
14	臺北市中正區	2018-11-25T06:29:05+08:00	26803	45286	72089	3086	75175	128292	58.6%	20.89%	96	96
14	臺北市中正區	2018-11-24T22:54:17+08:00	16808	28193	45001	1957	46958	80298	58.48%	20.93%	62	96
14	臺北市中正區	2018-11-25T06:23:50+08:00	26803	45286	72089	3086	75175	128292	58.6%	20.89%	96	96
14	臺北市中正區	2018-11-25T03:49:41+08:00	26803	45286	72089	3086	75175	128292	58.6%	20.89%	96	96
14	臺北市中正區	2018-11-24T23:39:02+08:00	21487	36348	57835	2490	60325	102666	58.76%	20.93%	78	96
14	臺北市中正區	2018-11-24T23:12:04+08:00	20097	33753	53850	2300	56150	95643	58.71%	21.01%	73	96
14	臺北市中正區	2018-11-25T06:08:41+08:00	26803	45286	72089	3086	75175	128292	58.6%	20.89%	96	96
14	臺北市中正區	2018-11-25T06:08:40+08:00	26803	45286	72089	3086	75175	128292	58.6%	20.89%	96	96
14	臺北市中正區	2018-11-25T00:09:22+08:00	24044	40692	64736	2799	67535	115357	58.54%	20.84%	87	96
14	臺北市中正區	2018-11-24T23:31:00+08:00	21487	36348	57835	2490	60325	102666	58.76%	20.93%	78	96
14	臺北市中正區	2018-11-24T23:39:03+08:00	21487	36348	57835	2490	60325	102666	58.76%	20.93%	78	96
14	臺北市中正區	2018-11-24T23:01:20+08:00	18248	30508	48756	2147	50903	86875	58.59%	21%	67	96
14	臺北市中正區	2018-11-24T22:50:36+08:00	16808	28193	45001	1957	46958	80298	58.48%	20.93%	62	96
14	臺北市中正區	2018-11-25T01:12:32+08:00	26803	45286	72089	3086	75175	128292	58.6%	20.89%	96	96
14	臺北市中正區	2018-11-24T22:41:26+08:00	16450	27665	44115	1925	46040	78747	58.47%	20.89%	61	96
14	臺北市中正區	2018-11-24T23:35:01+08:00	21487	36348	57835	2490	60325	102666	58.76%	20.93%	78	96
14	臺北市中正區	2018-11-24T23:04:54+08:00	18621	31106	49727	2175	51902	88644	58.55%	21.01%	68	96
14	臺北市中正區	2018-11-25T06:18:47+08:00	26803	45286	72089	3086	75175	128292	58.6%	20.89%	96	96
14	臺北市中正區	2018-11-25T00:04:55+08:00	23768	40245	64013	2751	66764	114047	58.54%	20.84%	86	96
14	臺北市中正區	2018-11-24T22:13:15+08:00	12934	21807	34741	1496	36237	62229	58.23%	20.78%	49	96
14	臺北市中正區	2018-11-25T06:18:48+08:00	26803	45286	72089	3086	75175	128292	58.6%	20.89%	96	96
14	臺北市中正區	2018-11-24T22:23:02+08:00	14367	24147	38514	1662	40176	68804	58.39%	20.88%	54	96
14	臺北市中正區	2018-11-25T03:44:10+08:00	26803	45286	72089	3086	75175	128292	58.6%	20.89%	96	96
14	臺北市中正區	2018-11-25T01:02:20+08:00	26803	45286	72089	3086	75175	128292	58.6%	20.89%	96	96
14	臺北市中正區	2018-11-25T03:38:45+08:00	26803	45286	72089	3086	75175	128292	58.6%	20.89%	96	96
14	臺北市中正區	2018-11-24T23:19:38+08:00	20952	35337	56289	2393	58682	99863	58.76%	20.98%	76	96
14	臺北市中正區	2018-11-24T23:23:29+08:00	20952	35337	56289	2393	58682	99863	58.76%	20.98%	76	96
14	臺北市中正區	2018-11-24T22:15:59+08:00	13401	22555	35956	1541	37497	64325	58.29%	20.83%	51	96
14	臺北市中正區	2018-11-25T01:17:39+08:00	26803	45286	72089	3086	75175	128292	58.6%	20.89%	96	96
14	臺北市中正區	2018-11-25T06:29:06+08:00	26803	45286	72089	3086	75175	128292	58.6%	20.89%	96	96
14	臺北市中正區	2018-11-24T22:33:28+08:00	15535	26143	41678	1821	43499	74325	58.53%	20.9%	58	96
14	臺北市中正區	2018-11-25T06:13:43+08:00	26803	45286	72089	3086	75175	128292	58.6%	20.89%	96	96
14	臺北市中正區	2018-11-24T23:43:07+08:00	21487	36348	57835	2490	60325	102666	58.76%	20.93%	78	96
14	臺北市中正區	2018-11-25T00:22:53+08:00	24976	42232	67208	2916	70124	119771	58.55%	20.85%	90	96
14	臺北市中正區	2018-11-25T03:56:00+08:00	26803	45286	72089	3086	75175	128292	58.6%	20.89%	96	96
14	臺北市中正區	2018-11-24T22:33:27+08:00	14933	25044	39977	1730	41707	71384	58.43%	20.92%	56	96
14	臺北市中正區	2018-11-25T03:49:42+08:00	26803	45286	72089	3086	75175	128292	58.6%	20.89%	96	96
14	臺北市中正區	2018-11-25T00:18:20+08:00	24044	40692	64736	2799	67535	115357	58.54%	20.84%	87	96
14	臺北市中正區	2018-11-25T06:13:42+08:00	26803	45286	72089	3086	75175	128292	58.6%	20.89%	96	96
14	臺北市中正區	2018-11-25T04:02:38+08:00	26803	45286	72089	3086	75175	128292	58.6%	20.89%	96	96
14	臺中市南屯區	2018-11-24T23:47:19+08:00	25181	49769	74950	3606	78556	129536	60.64%	19.44%	97	101
14	臺中市南屯區	2018-11-24T22:16:01+08:00	18178	35463	53641	2589	56230	92601	60.72%	19.63%	71	101
14	臺中市南屯區	2018-11-25T01:07:17+08:00	26220	52042	78262	3769	82031	135448	60.56%	19.36%	101	101
14	臺中市南屯區	2018-11-24T23:01:22+08:00	24099	47657	71756	3481	75237	124038	60.66%	19.43%	93	101
14	臺中市南屯區	2018-11-25T06:08:42+08:00	26220	52042	78262	3769	82031	135448	60.56%	19.36%	101	101
14	臺中市南屯區	2018-11-24T23:35:02+08:00	24684	48752	73436	3540	76976	127026	60.6%	19.43%	95	101
14	臺中市南屯區	2018-11-24T23:12:06+08:00	24099	47657	71756	3481	75237	124038	60.66%	19.43%	93	101
14	臺中市南屯區	2018-11-24T22:26:29+08:00	19484	37862	57346	2733	60079	98855	60.77%	19.71%	75	101
14	臺中市南屯區	2018-11-25T03:44:12+08:00	26220	52042	78262	3769	82031	135448	60.56%	19.36%	101	101
14	臺中市南屯區	2018-11-24T22:19:29+08:00	18178	35463	53641	2589	56230	92601	60.72%	19.63%	71	101
14	臺中市南屯區	2018-11-25T00:04:56+08:00	25185	49811	74996	3590	78586	129604	60.64%	19.43%	97	101
14	臺中市南屯區	2018-11-24T22:57:44+08:00	24099	47657	71756	3481	75237	124038	60.66%	19.43%	93	101
14	臺中市南屯區	2018-11-25T00:57:27+08:00	26220	52042	78262	3769	82031	135448	60.56%	19.36%	101	101
14	臺中市南屯區	2018-11-24T22:13:17+08:00	17848	34779	52627	2551	55178	90971	60.65%	19.62%	70	101
14	臺中市南屯區	2018-11-24T23:23:30+08:00	24099	47657	71756	3481	75237	124038	60.66%	19.43%	93	101
14	臺中市南屯區	2018-11-24T23:55:38+08:00	25181	49769	74950	3606	78556	129536	60.64%	19.44%	97	101
14	臺中市南屯區	2018-11-24T22:40:20+08:00	21741	42854	64595	3090	67685	111508	60.7%	19.5%	84	101
14	臺中市南屯區	2018-11-24T23:15:54+08:00	24099	47657	71756	3481	75237	124038	60.66%	19.43%	93	101
14	臺中市南屯區	2018-11-25T01:25:43+08:00	26220	52042	78262	3769	82031	135448	60.56%	19.36%	101	101
14	臺中市南屯區	2018-11-24T23:59:59+08:00	25181	49769	74950	3606	78556	129536	60.64%	19.44%	97	101
14	臺中市南屯區	2018-11-25T01:02:22+08:00	26220	52042	78262	3769	82031	135448	60.56%	19.36%	101	101
14	臺中市南屯區	2018-11-25T03:38:47+08:00	26220	52042	78262	3769	82031	135448	60.56%	19.36%	101	101
14	臺中市南屯區	2018-11-24T22:54:18+08:00	23556	46559	70115	3354	73469	121085	60.68%	19.45%	91	101
14	臺中市南屯區	2018-11-25T03:56:02+08:00	26220	52042	78262	3769	82031	135448	60.56%	19.36%	101	101
14	臺中市南屯區	2018-11-24T22:45:00+08:00	22245	43837	66082	3173	69255	114219	60.63%	19.48%	86	101
14	臺中市南屯區	2018-11-24T23:39:05+08:00	24910	49257	74167	3571	77738	128242	60.62%	19.42%	96	101
14	臺中市南屯區	2018-11-24T23:31:01+08:00	24099	47657	71756	3481	75237	124038	60.66%	19.43%	93	101
14	臺中市南屯區	2018-11-25T00:09:24+08:00	25185	49811	74996	3590	78586	129604	60.64%	19.43%	97	101
14	臺中市南屯區	2018-11-24T22:41:27+08:00	21741	42854	64595	3090	67685	111508	60.7%	19.5%	84	101
14	臺中市南屯區	2018-11-25T04:02:40+08:00	26220	52042	78262	3769	82031	135448	60.56%	19.36%	101	101
14	臺中市南屯區	2018-11-25T01:12:33+08:00	26220	52042	78262	3769	82031	135448	60.56%	19.36%	101	101
14	臺中市南屯區	2018-11-25T00:14:01+08:00	25471	50391	75862	3631	79493	131012	60.68%	19.44%	98	101
14	臺中市南屯區	2018-11-24T22:50:38+08:00	23222	45972	69194	3317	72511	119538	60.66%	19.43%	90	101
14	臺中市南屯區	2018-11-24T23:51:26+08:00	25181	49769	74950	3606	78556	129536	60.64%	19.44%	97	101
14	臺中市南屯區	2018-11-25T06:18:49+08:00	26220	52042	78262	3769	82031	135448	60.56%	19.36%	101	101
14	臺中市南屯區	2018-11-25T01:17:41+08:00	26220	52042	78262	3769	82031	135448	60.56%	19.36%	101	101
14	臺中市南屯區	2018-11-24T22:23:03+08:00	18794	36632	55426	2658	58084	95654	60.72%	19.65%	73	101
14	臺中市南屯區	2018-11-24T22:29:56+08:00	19779	38381	58160	2768	60928	100435	60.66%	19.69%	76	101
14	臺中市南屯區	2018-11-24T23:04:55+08:00	24099	47657	71756	3481	75237	124038	60.66%	19.43%	93	101
14	臺中市南屯區	2018-11-24T23:19:40+08:00	24099	47657	71756	3481	75237	124038	60.66%	19.43%	93	101
14	臺中市南屯區	2018-11-24T22:36:53+08:00	21223	41763	62986	2997	65983	108779	60.66%	19.51%	82	101
14	臺中市南屯區	2018-11-24T23:27:10+08:00	24099	47657	71756	3481	75237	124038	60.66%	19.43%	93	101
14	臺中市南屯區	2018-11-24T23:08:26+08:00	24099	47657	71756	3481	75237	124038	60.66%	19.43%	93	101
14	臺中市南屯區	2018-11-25T03:32:26+08:00	26220	52042	78262	3769	82031	135448	60.56%	19.36%	101	101
14	臺中市南屯區	2018-11-25T03:49:43+08:00	26220	52042	78262	3769	82031	135448	60.56%	19.36%	101	101
14	臺中市南屯區	2018-11-25T00:22:55+08:00	25757	50973	76730	3685	80415	132526	60.68%	19.44%	99	101
14	臺中市南屯區	2018-11-25T06:13:44+08:00	26220	52042	78262	3769	82031	135448	60.56%	19.36%	101	101
14	臺中市南屯區	2018-11-25T00:18:21+08:00	25757	50973	76730	3685	80415	132526	60.68%	19.44%	99	101
14	臺中市南屯區	2018-11-25T06:23:52+08:00	26220	52042	78262	3769	82031	135448	60.56%	19.36%	101	101
14	臺中市南屯區	2018-11-24T22:33:29+08:00	20039	38876	58915	2803	61718	101707	60.68%	19.7%	77	101
14	臺中市南屯區	2018-11-25T06:29:07+08:00	26220	52042	78262	3769	82031	135448	60.56%	19.36%	101	101
14	臺中市南屯區	2018-11-24T23:43:08+08:00	25181	49769	74950	3606	78556	129536	60.64%	19.44%	97	101
14	臺中市潭子區	2018-11-24T23:47:19+08:00	14794	31570	46364	2445	48809	84399	57.83%	17.53%	52	55
14	臺中市潭子區	2018-11-24T23:35:03+08:00	13488	30377	43865	2358	46223	79805	57.92%	16.9%	49	55
14	臺中市潭子區	2018-11-24T22:16:01+08:00	8063	17782	25845	1348	27193	46838	58.06%	17.21%	30	55
14	臺中市潭子區	2018-11-24T23:01:22+08:00	12557	28201	40758	2199	42957	74133	57.95%	16.94%	46	55
14	臺中市潭子區	2018-11-24T23:12:07+08:00	12837	28807	41644	2235	43879	75755	57.92%	16.95%	47	55
14	臺中市潭子區	2018-11-25T01:07:18+08:00	15517	33540	49057	2556	51613	89487	57.68%	17.34%	55	55
14	臺中市潭子區	2018-11-25T06:08:43+08:00	15517	33540	49057	2556	51613	89487	57.68%	17.34%	55	55
14	臺中市潭子區	2018-11-24T22:26:29+08:00	8838	19734	28572	1510	30082	51864	58%	17.04%	33	55
14	臺中市潭子區	2018-11-25T01:17:42+08:00	15517	33540	49057	2556	51613	89487	57.68%	17.34%	55	55
14	臺中市潭子區	2018-11-24T22:13:18+08:00	8063	17782	25845	1348	27193	46838	58.06%	17.21%	30	55
14	臺中市潭子區	2018-11-24T22:19:29+08:00	8308	18481	26789	1406	28195	48699	57.9%	17.06%	31	55
14	臺中市潭子區	2018-11-25T00:57:28+08:00	15517	33540	49057	2556	51613	89487	57.68%	17.34%	55	55
14	臺中市潭子區	2018-11-24T23:23:31+08:00	13488	30377	43865	2358	46223	79805	57.92%	16.9%	49	55
14	臺中市潭子區	2018-11-24T22:57:44+08:00	12221	27493	39714	2169	41883	72239	57.98%	16.92%	45	55
14	臺中市潭子區	2018-11-25T03:44:13+08:00	15517	33540	49057	2556	51613	89487	57.68%	17.34%	55	55
14	臺中市潭子區	2018-11-25T00:04:57+08:00	15304	32912	48216	2516	50732	87902	57.71%	17.41%	54	55
14	臺中市潭子區	2018-11-24T23:04:56+08:00	12837	28807	41644	2235	43879	75755	57.92%	16.95%	47	55
14	臺中市潭子區	2018-11-24T23:15:55+08:00	13488	30377	43865	2358	46223	79805	57.92%	16.9%	49	55
14	臺中市潭子區	2018-11-24T22:40:20+08:00	10580	23525	34105	1804	35909	61813	58.09%	17.12%	39	55
14	臺中市潭子區	2018-11-25T01:25:44+08:00	15517	33540	49057	2556	51613	89487	57.68%	17.34%	55	55
14	臺中市潭子區	2018-11-24T23:59:59+08:00	15099	32374	47473	2489	49962	86495	57.76%	17.46%	53	55
14	臺中市潭子區	2018-11-25T01:02:22+08:00	15517	33540	49057	2556	51613	89487	57.68%	17.34%	55	55
14	臺中市潭子區	2018-11-25T03:38:47+08:00	15517	33540	49057	2556	51613	89487	57.68%	17.34%	55	55
14	臺中市潭子區	2018-11-24T23:55:39+08:00	15099	32374	47473	2489	49962	86495	57.76%	17.46%	53	55
14	臺中市潭子區	2018-11-24T22:54:18+08:00	11438	25681	37119	2002	39121	67370	58.07%	16.98%	42	55
14	臺中市潭子區	2018-11-24T22:45:01+08:00	10580	23525	34105	1804	35909	61813	58.09%	17.12%	39	55
14	臺中市潭子區	2018-11-25T03:56:02+08:00	15517	33540	49057	2556	51613	89487	57.68%	17.34%	55	55
14	臺中市潭子區	2018-11-24T23:39:05+08:00	13789	31019	44808	2390	47198	81582	57.85%	16.9%	50	55
14	臺中市潭子區	2018-11-24T23:31:01+08:00	13488	30377	43865	2358	46223	79805	57.92%	16.9%	49	55
14	臺中市潭子區	2018-11-25T00:09:24+08:00	15304	32912	48216	2516	50732	87902	57.71%	17.41%	54	55
14	臺中市潭子區	2018-11-24T22:41:27+08:00	10580	23525	34105	1804	35909	61813	58.09%	17.12%	39	55
14	臺中市潭子區	2018-11-25T04:02:40+08:00	15517	33540	49057	2556	51613	89487	57.68%	17.34%	55	55
14	臺中市潭子區	2018-11-25T01:12:33+08:00	15517	33540	49057	2556	51613	89487	57.68%	17.34%	55	55
14	臺中市潭子區	2018-11-25T00:14:01+08:00	15517	33540	49057	2556	51613	89487	57.68%	17.34%	55	55
14	臺中市潭子區	2018-11-24T22:50:38+08:00	11438	25681	37119	2002	39121	67370	58.07%	16.98%	42	55
14	臺中市潭子區	2018-11-24T23:51:26+08:00	14794	31570	46364	2445	48809	84399	57.83%	17.53%	52	55
14	臺中市潭子區	2018-11-25T06:18:49+08:00	15517	33540	49057	2556	51613	89487	57.68%	17.34%	55	55
14	臺中市潭子區	2018-11-24T22:23:04+08:00	8595	19129	27724	1477	29201	50329	58.02%	17.08%	32	55
14	臺中市潭子區	2018-11-24T22:29:56+08:00	9481	21059	30540	1595	32135	55301	58.11%	17.14%	35	55
14	臺中市潭子區	2018-11-24T23:19:40+08:00	13488	30377	43865	2358	46223	79805	57.92%	16.9%	49	55
14	臺中市潭子區	2018-11-24T22:36:53+08:00	10580	23525	34105	1804	35909	61813	58.09%	17.12%	39	55
14	臺中市潭子區	2018-11-24T23:08:26+08:00	12837	28807	41644	2235	43879	75755	57.92%	16.95%	47	55
14	臺中市潭子區	2018-11-24T23:27:11+08:00	13488	30377	43865	2358	46223	79805	57.92%	16.9%	49	55
14	臺中市潭子區	2018-11-25T03:32:26+08:00	15517	33540	49057	2556	51613	89487	57.68%	17.34%	55	55
14	臺中市潭子區	2018-11-25T03:49:43+08:00	15517	33540	49057	2556	51613	89487	57.68%	17.34%	55	55
14	臺中市潭子區	2018-11-25T06:29:08+08:00	15517	33540	49057	2556	51613	89487	57.68%	17.34%	55	55
14	臺中市潭子區	2018-11-25T00:22:55+08:00	15517	33540	49057	2556	51613	89487	57.68%	17.34%	55	55
14	臺中市潭子區	2018-11-25T06:13:44+08:00	15517	33540	49057	2556	51613	89487	57.68%	17.34%	55	55
14	臺中市潭子區	2018-11-25T00:18:21+08:00	15517	33540	49057	2556	51613	89487	57.68%	17.34%	55	55
14	臺中市潭子區	2018-11-25T06:23:52+08:00	15517	33540	49057	2556	51613	89487	57.68%	17.34%	55	55
14	臺中市潭子區	2018-11-24T23:43:09+08:00	14794	31570	46364	2445	48809	84399	57.83%	17.53%	52	55
14	臺中市潭子區	2018-11-24T22:33:29+08:00	10278	22881	33159	1714	34873	60018	58.1%	17.12%	38	55
